"date","geography","geography code","Rural Urban","Household Composition: count of Household; All households; measures: Value","Household Composition: No adults in employment in household; measures: Value","Household Composition: No adults in employment in household: With dependent children; measures: Value","Household Composition: No adults in employment in household: No dependent children; measures: Value","Household Composition: Dependent children in household: All ages; measures: Value","Household Composition: Dependent children in household: Age 0 to 4; measures: Value","Household Composition: One person in household with a long-term health problem or disability; measures: Value","Household Composition: One person in household with a long-term health problem or disability: With dependent children; measures: Value","Household Composition: One person in household with a long-term health problem or disability: No dependent children; measures: Value"
"2011","Darlington 001B","E01012334","Total",962,222,10,212,355,124,198,47,151
"2011","Darlington 001C","E01012335","Total",620,253,12,241,151,51,165,20,145
"2011","Darlington 001D","E01012366","Total",860,266,19,247,205,61,218,27,191
"2011","Darlington 001E","E01033481","Total",554,67,10,57,219,121,73,26,47
"2011","Darlington 001F","E01033482","Total",650,103,7,96,258,125,94,27,67
"2011","Darlington 002C","E01012323","Total",657,180,22,158,229,89,150,44,106
"2011","Darlington 002D","E01012324","Total",627,196,11,185,172,52,141,23,118
"2011","Darlington 002E","E01032545","Total",525,154,18,136,170,68,134,24,110
"2011","Darlington 002F","E01032546","Total",702,203,16,187,222,76,167,31,136
"2011","Darlington 003A","E01012328","Total",768,285,41,244,192,70,233,41,192
"2011","Darlington 003B","E01012329","Total",776,264,11,253,173,65,169,15,154
"2011","Darlington 003C","E01012330","Total",458,137,11,126,145,42,94,22,72
"2011","Darlington 003D","E01012331","Total",505,145,22,123,171,69,110,22,88
"2011","Darlington 004A","E01012349","Total",798,383,73,310,204,99,248,25,223
"2011","Darlington 004B","E01012350","Total",775,292,41,251,200,82,242,36,206
"2011","Darlington 004C","E01012351","Total",556,144,22,122,194,58,117,34,83
"2011","Darlington 004D","E01012352","Total",804,347,54,293,199,89,274,46,228
"2011","Darlington 005A","E01012325","Total",657,207,12,195,138,48,165,18,147
"2011","Darlington 005B","E01012326","Total",502,208,20,188,140,47,178,25,153
"2011","Darlington 005C","E01012332","Total",592,250,35,215,165,62,212,29,183
"2011","Darlington 005D","E01012333","Total",592,205,27,178,183,72,177,30,147
"2011","Darlington 006A","E01012309","Total",760,189,15,174,258,98,143,31,112
"2011","Darlington 006B","E01012310","Total",864,316,25,291,239,82,262,45,217
"2011","Darlington 006C","E01012311","Total",633,228,33,195,211,60,183,40,143
"2011","Darlington 006D","E01012312","Total",625,347,69,278,193,84,247,38,209
"2011","Darlington 006E","E01012313","Total",664,294,40,254,191,76,226,42,184
"2011","Darlington 006F","E01012314","Total",591,258,52,206,200,70,206,38,168
"2011","Darlington 007A","E01012362","Total",703,224,38,186,194,94,167,38,129
"2011","Darlington 007B","E01012363","Total",684,197,30,167,170,81,162,19,143
"2011","Darlington 007C","E01012364","Total",740,205,23,182,185,80,176,31,145
"2011","Darlington 007D","E01012365","Total",540,175,9,166,151,50,135,14,121
"2011","Darlington 008B","E01012353","Total",780,252,63,189,232,124,177,33,144
"2011","Darlington 008C","E01012354","Total",737,280,50,230,186,97,218,45,173
"2011","Darlington 008D","E01012355","Total",710,262,36,226,156,80,191,24,167
"2011","Darlington 008E","E01033483","Total",552,295,33,262,109,48,198,20,178
"2011","Darlington 008F","E01033484","Total",696,320,35,285,103,45,244,15,229
"2011","Darlington 009A","E01012307","Total",878,339,54,285,244,117,254,38,216
"2011","Darlington 009B","E01012327","Total",625,299,107,192,265,125,223,62,161
"2011","Darlington 009C","E01012342","Total",819,361,60,301,236,105,279,42,237
"2011","Darlington 009D","E01012343","Total",887,342,34,308,233,87,280,48,232
"2011","Darlington 010A","E01012315","Total",688,224,5,219,221,67,152,20,132
"2011","Darlington 010B","E01012316","Total",1163,361,14,347,287,84,244,31,213
"2011","Darlington 010C","E01012360","Total",783,348,6,342,189,69,211,17,194
"2011","Darlington 011A","E01012336","Total",725,321,6,315,189,38,182,23,159
"2011","Darlington 011B","E01012337","Total",709,286,6,280,179,45,192,31,161
"2011","Darlington 011C","E01012347","Total",765,329,8,321,191,50,199,22,177
"2011","Darlington 011D","E01012348","Total",915,471,7,464,194,59,261,24,237
"2011","Darlington 011E","E01012361","Total",798,293,14,279,228,67,183,25,158
"2011","Darlington 012A","E01012304","Total",649,322,39,283,135,62,245,28,217
"2011","Darlington 012B","E01012305","Total",622,201,44,157,162,75,145,20,125
"2011","Darlington 012C","E01012306","Total",601,176,20,156,168,64,169,36,133
"2011","Darlington 012D","E01012340","Total",1053,341,53,288,335,154,275,57,218
"2011","Darlington 012E","E01012341","Total",798,399,87,312,248,99,291,49,242
"2011","Darlington 013A","E01012317","Total",624,237,19,218,152,62,182,17,165
"2011","Darlington 013B","E01012318","Total",1015,392,90,302,364,193,294,58,236
"2011","Darlington 013C","E01012319","Total",1119,348,69,279,443,205,272,65,207
"2011","Darlington 014A","E01012356","Total",742,252,45,207,206,84,171,24,147
"2011","Darlington 014B","E01012357","Total",606,185,51,134,207,69,145,52,93
"2011","Darlington 014C","E01012358","Total",708,233,32,201,218,91,188,44,144
"2011","Darlington 014D","E01012359","Total",671,354,131,223,284,126,230,60,170
"2011","Darlington 015A","E01012338","Total",848,301,23,278,232,93,200,29,171
"2011","Darlington 015B","E01012339","Total",756,300,7,293,191,55,195,29,166
"2011","Darlington 015C","E01012344","Total",605,166,16,150,172,73,136,23,113
"2011","Darlington 015D","E01012345","Total",580,208,5,203,128,48,139,20,119
"2011","Darlington 015E","E01012346","Total",699,126,13,113,284,108,114,34,80
"2011","County Durham 002A","E01020613","Total",545,179,11,168,171,55,125,31,94
"2011","County Durham 002B","E01020614","Total",670,279,20,259,179,63,218,30,188
"2011","County Durham 002C","E01020622","Total",677,139,14,125,202,75,143,28,115
"2011","County Durham 002D","E01020623","Total",626,113,5,108,190,64,109,19,90
"2011","County Durham 005A","E01020606","Total",750,321,45,276,170,75,241,34,207
"2011","County Durham 005B","E01020615","Total",755,323,41,282,244,80,284,54,230
"2011","County Durham 005C","E01020616","Total",780,276,50,226,248,95,242,54,188
"2011","County Durham 005D","E01020617","Total",846,276,13,263,190,70,214,30,184
"2011","County Durham 007A","E01020596","Total",758,320,41,279,234,98,265,47,218
"2011","County Durham 007B","E01020597","Total",662,257,12,245,153,47,173,26,147
"2011","County Durham 007C","E01020598","Total",839,318,15,303,201,70,224,31,193
"2011","County Durham 007D","E01020611","Total",582,216,8,208,138,45,131,16,115
"2011","County Durham 007E","E01020612","Total",682,294,3,291,171,55,182,14,168
"2011","County Durham 011A","E01020592","Total",655,297,90,207,247,106,215,52,163
"2011","County Durham 011B","E01020593","Total",638,233,29,204,140,57,198,24,174
"2011","County Durham 011C","E01020599","Total",871,408,22,386,183,68,353,38,315
"2011","County Durham 011D","E01020601","Total",650,192,7,185,218,55,157,22,135
"2011","County Durham 011E","E01020602","Total",890,461,36,425,192,67,355,48,307
"2011","County Durham 011F","E01020618","Total",708,279,48,231,203,76,232,44,188
"2011","County Durham 013A","E01020594","Total",788,218,23,195,188,86,169,24,145
"2011","County Durham 013B","E01020595","Total",773,294,6,288,196,61,201,29,172
"2011","County Durham 013C","E01020600","Total",652,256,6,250,154,57,168,23,145
"2011","County Durham 013D","E01020603","Total",671,150,5,145,269,63,125,27,98
"2011","County Durham 013E","E01020605","Total",771,191,9,182,225,68,165,25,140
"2011","County Durham 015A","E01020590","Total",570,194,24,170,154,55,149,29,120
"2011","County Durham 015B","E01020591","Total",645,255,31,224,179,73,200,37,163
"2011","County Durham 015C","E01020608","Total",749,268,26,242,264,100,235,36,199
"2011","County Durham 015D","E01020609","Total",609,259,21,238,170,62,176,26,150
"2011","County Durham 015E","E01020610","Total",640,186,10,176,202,61,160,34,126
"2011","County Durham 019A","E01020604","Total",632,219,18,201,168,59,179,27,152
"2011","County Durham 019B","E01020607","Total",703,263,26,237,175,59,219,29,190
"2011","County Durham 019C","E01020619","Total",677,224,18,206,201,66,189,37,152
"2011","County Durham 019D","E01020620","Total",658,217,31,186,211,73,162,35,127
"2011","County Durham 019E","E01020621","Total",859,331,46,285,228,98,250,35,215
"2011","County Durham 001A","E01020634","Total",666,204,12,192,176,71,153,21,132
"2011","County Durham 001B","E01020635","Total",615,179,6,173,153,62,162,22,140
"2011","County Durham 001C","E01020636","Total",811,325,34,291,201,82,265,35,230
"2011","County Durham 001D","E01020654","Total",759,232,18,214,214,88,209,25,184
"2011","County Durham 001E","E01020676","Total",699,227,16,211,174,55,204,28,176
"2011","County Durham 003A","E01020627","Total",703,221,15,206,180,59,190,36,154
"2011","County Durham 003B","E01020628","Total",728,266,7,259,179,65,189,25,164
"2011","County Durham 003C","E01020629","Total",623,223,26,197,210,72,183,38,145
"2011","County Durham 003D","E01020655","Total",835,242,22,220,232,89,195,32,163
"2011","County Durham 003E","E01020656","Total",678,300,29,271,144,52,218,29,189
"2011","County Durham 003F","E01020657","Total",611,179,17,162,189,58,156,27,129
"2011","County Durham 004A","E01020661","Total",818,297,33,264,242,110,230,39,191
"2011","County Durham 004B","E01020662","Total",782,273,29,244,228,84,235,42,193
"2011","County Durham 004C","E01020663","Total",842,297,25,272,214,95,219,26,193
"2011","County Durham 004D","E01020674","Total",738,317,41,276,187,76,250,37,213
"2011","County Durham 004E","E01020678","Total",578,200,29,171,175,62,152,28,124
"2011","County Durham 006A","E01020626","Total",758,384,33,351,176,75,297,37,260
"2011","County Durham 006B","E01020638","Total",706,283,34,249,179,62,218,29,189
"2011","County Durham 006C","E01020639","Total",664,292,62,230,201,92,222,36,186
"2011","County Durham 006D","E01020653","Total",692,306,42,264,194,88,226,30,196
"2011","County Durham 006E","E01020677","Total",671,301,35,266,181,62,259,44,215
"2011","County Durham 008A","E01020647","Total",857,329,130,199,366,186,247,74,173
"2011","County Durham 008B","E01020648","Total",778,322,92,230,279,121,240,54,186
"2011","County Durham 008C","E01020649","Total",688,272,42,230,205,100,229,45,184
"2011","County Durham 008D","E01020673","Total",791,394,59,335,177,69,306,41,265
"2011","County Durham 008E","E01020675","Total",799,369,32,337,205,74,281,30,251
"2011","County Durham 009A","E01020624","Total",710,265,33,232,204,85,226,45,181
"2011","County Durham 009B","E01020625","Total",684,217,32,185,209,86,200,45,155
"2011","County Durham 009C","E01020670","Total",753,366,43,323,167,73,275,36,239
"2011","County Durham 009D","E01020671","Total",612,267,67,200,174,82,179,34,145
"2011","County Durham 009E","E01020672","Total",771,297,50,247,196,87,244,42,202
"2011","County Durham 010A","E01020632","Total",812,218,21,197,223,86,198,31,167
"2011","County Durham 010B","E01020640","Total",991,248,37,211,333,134,236,41,195
"2011","County Durham 010C","E01020641","Total",968,388,31,357,278,115,314,44,270
"2011","County Durham 010D","E01020642","Total",626,237,22,215,165,47,184,33,151
"2011","County Durham 010E","E01020643","Total",1051,369,37,332,287,126,324,50,274
"2011","County Durham 010F","E01020667","Total",805,366,27,339,155,68,277,20,257
"2011","County Durham 012A","E01020650","Total",927,285,51,234,317,138,246,49,197
"2011","County Durham 012B","E01020651","Total",801,342,21,321,201,79,254,35,219
"2011","County Durham 012C","E01020652","Total",849,341,40,301,261,109,312,51,261
"2011","County Durham 012D","E01020668","Total",683,261,43,218,183,84,221,30,191
"2011","County Durham 012E","E01020669","Total",636,238,41,197,177,63,193,48,145
"2011","County Durham 014A","E01020630","Total",597,226,35,191,201,79,180,34,146
"2011","County Durham 014B","E01020631","Total",782,363,29,334,196,77,312,33,279
"2011","County Durham 014C","E01020637","Total",730,262,8,254,190,63,226,30,196
"2011","County Durham 014D","E01020644","Total",1054,298,66,232,368,176,260,66,194
"2011","County Durham 014E","E01020645","Total",653,279,47,232,227,76,265,58,207
"2011","County Durham 020A","E01020633","Total",707,259,35,224,175,81,206,24,182
"2011","County Durham 020B","E01020664","Total",679,259,7,252,131,39,188,13,175
"2011","County Durham 020C","E01020665","Total",652,274,21,253,159,61,197,27,170
"2011","County Durham 020D","E01020666","Total",643,261,12,249,148,47,205,28,177
"2011","County Durham 024A","E01020646","Total",688,246,25,221,195,75,204,25,179
"2011","County Durham 024B","E01020658","Total",828,306,50,256,247,100,273,51,222
"2011","County Durham 024C","E01020659","Total",668,181,20,161,212,69,158,18,140
"2011","County Durham 024D","E01020660","Total",694,249,19,230,188,57,219,37,182
"2011","County Durham 022A","E01020709","Total",584,146,8,138,185,61,105,18,87
"2011","County Durham 022B","E01020717","Total",765,336,4,332,139,42,223,15,208
"2011","County Durham 022C","E01020718","Total",619,244,4,240,133,42,176,15,161
"2011","County Durham 022D","E01020719","Total",533,133,7,126,151,45,106,19,87
"2011","County Durham 022E","E01020721","Total",486,113,5,108,131,31,103,23,80
"2011","County Durham 023A","E01020708","Total",535,209,10,199,126,51,121,10,111
"2011","County Durham 023B","E01020710","Total",746,217,16,201,181,62,179,20,159
"2011","County Durham 023C","E01020711","Total",789,346,28,318,196,72,264,40,224
"2011","County Durham 023D","E01020720","Total",699,297,19,278,170,63,205,21,184
"2011","County Durham 026A","E01020679","Total",714,281,40,241,208,94,236,37,199
"2011","County Durham 026B","E01020680","Total",677,204,12,192,182,86,168,29,139
"2011","County Durham 026C","E01020681","Total",693,269,26,243,182,59,221,32,189
"2011","County Durham 026D","E01020714","Total",695,234,13,221,156,57,168,22,146
"2011","County Durham 026E","E01020716","Total",747,331,76,255,250,95,243,46,197
"2011","County Durham 027A","E01020725","Total",657,205,14,191,201,65,198,35,163
"2011","County Durham 027B","E01020726","Total",538,162,14,148,133,44,137,20,117
"2011","County Durham 027C","E01020727","Total",538,261,30,231,123,52,199,23,176
"2011","County Durham 027D","E01020729","Total",943,310,49,261,291,130,253,53,200
"2011","County Durham 027E","E01020730","Total",808,350,24,326,192,73,279,40,239
"2011","County Durham 027F","E01020731","Total",634,182,11,171,179,60,161,21,140
"2011","County Durham 028A","E01020682","Total",834,366,12,354,170,52,235,25,210
"2011","County Durham 028B","E01020683","Total",664,177,6,171,192,66,155,32,123
"2011","County Durham 028C","E01020690","Total",635,288,8,280,110,43,194,14,180
"2011","County Durham 028D","E01020691","Total",617,228,15,213,158,61,205,30,175
"2011","County Durham 028E","E01020692","Total",659,270,6,264,102,32,172,16,156
"2011","County Durham 029A","E01020693","Total",629,237,26,211,119,54,181,29,152
"2011","County Durham 029B","E01020722","Total",882,376,60,316,195,89,274,41,233
"2011","County Durham 029C","E01020723","Total",772,320,32,288,116,54,190,25,165
"2011","County Durham 029D","E01020724","Total",674,300,88,212,251,113,219,55,164
"2011","County Durham 030A","E01020703","Total",695,341,8,333,42,18,146,10,136
"2011","County Durham 030D","E01033164","Total",436,185,3,182,25,9,79,7,72
"2011","County Durham 030E","E01033195","Total",411,187,4,183,45,19,92,4,88
"2011","County Durham 030F","E01033197","Total",401,222,7,215,23,7,111,4,107
"2011","County Durham 030G","E01033221","Total",420,217,4,213,29,11,113,7,106
"2011","County Durham 033A","E01020684","Total",994,240,32,208,327,95,243,56,187
"2011","County Durham 033B","E01020702","Total",825,249,8,241,209,76,162,20,142
"2011","County Durham 033C","E01020704","Total",553,205,7,198,111,44,113,13,100
"2011","County Durham 033D","E01020712","Total",679,214,4,210,169,57,137,20,117
"2011","County Durham 033E","E01020713","Total",794,226,8,218,245,83,132,28,104
"2011","County Durham 031A","E01020705","Total",720,331,34,297,155,56,257,26,231
"2011","County Durham 031B","E01020706","Total",856,300,18,282,196,67,261,38,223
"2011","County Durham 031C","E01020715","Total",1068,351,56,295,297,143,299,54,245
"2011","County Durham 038A","E01020685","Total",714,256,17,239,169,51,202,27,175
"2011","County Durham 038B","E01020686","Total",797,390,38,352,187,67,293,35,258
"2011","County Durham 038C","E01020687","Total",719,288,11,277,145,50,262,22,240
"2011","County Durham 038D","E01020688","Total",681,222,29,193,215,93,195,36,159
"2011","County Durham 038E","E01020689","Total",643,284,56,228,189,71,207,37,170
"2011","County Durham 041A","E01020694","Total",687,310,38,272,169,64,256,38,218
"2011","County Durham 041B","E01020696","Total",609,215,20,195,126,42,185,22,163
"2011","County Durham 041C","E01020697","Total",631,173,34,139,195,82,142,30,112
"2011","County Durham 041D","E01020732","Total",739,247,21,226,216,72,164,26,138
"2011","County Durham 044A","E01020695","Total",807,274,30,244,221,87,223,40,183
"2011","County Durham 044B","E01020698","Total",654,157,12,145,222,70,142,30,112
"2011","County Durham 044C","E01020699","Total",516,222,38,184,161,60,182,38,144
"2011","County Durham 044D","E01020700","Total",712,325,40,285,196,68,281,58,223
"2011","County Durham 044E","E01020701","Total",604,206,13,193,161,61,181,27,154
"2011","County Durham 016A","E01020750","Total",534,178,6,172,131,38,152,19,133
"2011","County Durham 016B","E01020781","Total",492,209,11,198,108,29,172,22,150
"2011","County Durham 016D","E01020786","Total",669,211,9,202,180,44,171,26,145
"2011","County Durham 016E","E01020787","Total",812,350,46,304,229,83,330,55,275
"2011","County Durham 016F","E01033163","Total",820,150,11,139,298,164,158,28,130
"2011","County Durham 016G","E01033202","Total",524,199,22,177,163,70,172,27,145
"2011","County Durham 017A","E01020740","Total",561,168,21,147,179,66,163,26,137
"2011","County Durham 017B","E01020741","Total",534,187,35,152,157,76,156,23,133
"2011","County Durham 017C","E01020742","Total",723,243,55,188,242,117,213,44,169
"2011","County Durham 017D","E01020782","Total",514,200,10,190,116,28,158,21,137
"2011","County Durham 017E","E01020783","Total",593,227,30,197,161,69,179,29,150
"2011","County Durham 017F","E01020784","Total",737,366,38,328,145,63,299,34,265
"2011","County Durham 018A","E01020743","Total",560,234,85,149,248,122,174,50,124
"2011","County Durham 018B","E01020747","Total",492,239,85,154,209,90,166,48,118
"2011","County Durham 018C","E01020748","Total",508,192,42,150,190,60,166,52,114
"2011","County Durham 018D","E01020749","Total",758,491,35,456,111,47,333,30,303
"2011","County Durham 018E","E01020773","Total",658,319,33,286,161,60,259,37,222
"2011","County Durham 018F","E01020775","Total",793,430,84,346,239,113,324,58,266
"2011","County Durham 021C","E01020776","Total",805,322,19,303,192,54,277,33,244
"2011","County Durham 021D","E01033161","Total",616,170,27,143,209,103,171,23,148
"2011","County Durham 021E","E01033198","Total",639,250,43,207,161,79,160,20,140
"2011","County Durham 021F","E01033205","Total",625,213,29,184,190,88,194,33,161
"2011","County Durham 021G","E01033206","Total",652,237,44,193,227,94,205,45,160
"2011","County Durham 025A","E01020751","Total",819,317,57,260,252,118,277,66,211
"2011","County Durham 025B","E01020752","Total",580,313,74,239,166,85,207,37,170
"2011","County Durham 025C","E01020754","Total",633,310,22,288,135,48,251,29,222
"2011","County Durham 025D","E01020756","Total",556,153,7,146,166,50,133,27,106
"2011","County Durham 032A","E01020745","Total",588,298,51,247,167,64,241,44,197
"2011","County Durham 032B","E01020753","Total",864,414,52,362,256,95,348,57,291
"2011","County Durham 032C","E01020757","Total",469,217,51,166,158,70,167,36,131
"2011","County Durham 032D","E01020758","Total",624,287,85,202,239,93,224,69,155
"2011","County Durham 032E","E01020759","Total",462,223,72,151,175,86,186,50,136
"2011","County Durham 032F","E01020765","Total",715,306,78,228,253,103,289,77,212
"2011","County Durham 034A","E01020760","Total",692,294,23,271,188,63,242,42,200
"2011","County Durham 034B","E01020761","Total",548,229,37,192,167,84,187,32,155
"2011","County Durham 034C","E01020762","Total",648,336,63,273,211,90,281,47,234
"2011","County Durham 034D","E01020763","Total",825,326,40,286,228,89,291,52,239
"2011","County Durham 036A","E01020764","Total",686,407,71,336,165,65,310,46,264
"2011","County Durham 036B","E01020766","Total",692,350,19,331,141,51,270,29,241
"2011","County Durham 036C","E01020767","Total",873,469,99,370,253,100,374,73,301
"2011","County Durham 036D","E01020768","Total",662,253,38,215,228,86,207,47,160
"2011","County Durham 035A","E01020733","Total",507,209,48,161,190,77,147,29,118
"2011","County Durham 035B","E01020734","Total",513,193,42,151,187,74,154,38,116
"2011","County Durham 035C","E01020735","Total",626,254,15,239,186,69,222,31,191
"2011","County Durham 035D","E01020770","Total",502,181,29,152,171,54,164,47,117
"2011","County Durham 035E","E01020771","Total",457,199,33,166,139,39,184,35,149
"2011","County Durham 035F","E01020780","Total",510,229,37,192,153,57,171,30,141
"2011","County Durham 037A","E01020746","Total",489,194,12,182,121,33,170,22,148
"2011","County Durham 037B","E01020769","Total",476,164,29,135,184,56,148,48,100
"2011","County Durham 037C","E01020777","Total",673,308,39,269,192,72,253,46,207
"2011","County Durham 037D","E01020778","Total",511,165,10,155,116,33,143,13,130
"2011","County Durham 037E","E01020779","Total",658,174,10,164,196,42,162,40,122
"2011","County Durham 039A","E01020736","Total",521,240,42,198,156,56,172,33,139
"2011","County Durham 039B","E01020737","Total",598,237,20,217,162,40,196,34,162
"2011","County Durham 039C","E01020738","Total",488,227,13,214,93,31,195,23,172
"2011","County Durham 039D","E01020739","Total",686,375,48,327,157,69,277,44,233
"2011","County Durham 039E","E01020744","Total",449,188,7,181,106,34,167,27,140
"2011","County Durham 040A","E01020788","Total",664,295,52,243,183,73,232,41,191
"2011","County Durham 040B","E01020789","Total",634,278,32,246,162,68,236,31,205
"2011","County Durham 040C","E01020790","Total",590,297,61,236,190,68,244,47,197
"2011","County Durham 040D","E01020791","Total",588,268,36,232,149,64,217,26,191
"2011","County Durham 040E","E01020792","Total",608,245,29,216,182,77,212,40,172
"2011","County Durham 043A","E01020772","Total",854,277,29,248,231,75,246,29,217
"2011","County Durham 043B","E01020793","Total",762,340,47,293,220,90,304,49,255
"2011","County Durham 043C","E01020794","Total",738,238,22,216,242,78,214,37,177
"2011","County Durham 043D","E01020795","Total",759,285,59,226,246,123,252,48,204
"2011","County Durham 047A","E01020817","Total",542,150,5,145,137,38,128,17,111
"2011","County Durham 047B","E01020818","Total",667,294,26,268,165,53,218,31,187
"2011","County Durham 047C","E01020819","Total",507,260,34,226,131,41,207,33,174
"2011","County Durham 047D","E01020837","Total",751,251,8,243,196,69,193,25,168
"2011","County Durham 047E","E01020843","Total",728,252,15,237,194,64,180,25,155
"2011","County Durham 048A","E01020809","Total",635,277,48,229,202,64,238,40,198
"2011","County Durham 048B","E01020810","Total",551,186,19,167,173,53,154,30,124
"2011","County Durham 048C","E01020811","Total",559,233,33,200,178,61,186,30,156
"2011","County Durham 048D","E01020812","Total",669,255,21,234,178,62,214,26,188
"2011","County Durham 048E","E01020827","Total",778,300,37,263,231,92,289,54,235
"2011","County Durham 049A","E01020806","Total",622,255,27,228,161,58,236,31,205
"2011","County Durham 049B","E01020807","Total",668,339,62,277,164,80,241,31,210
"2011","County Durham 049C","E01020820","Total",732,375,52,323,202,80,278,45,233
"2011","County Durham 049D","E01020842","Total",907,383,79,304,264,126,287,51,236
"2011","County Durham 050A","E01020797","Total",1198,583,69,514,269,121,432,57,375
"2011","County Durham 050B","E01020798","Total",735,406,27,379,158,56,295,29,266
"2011","County Durham 050C","E01020799","Total",683,264,26,238,190,64,242,40,202
"2011","County Durham 050D","E01020808","Total",648,281,18,263,125,37,227,33,194
"2011","County Durham 052A","E01020821","Total",752,235,23,212,264,90,176,31,145
"2011","County Durham 052B","E01020822","Total",799,260,10,250,200,54,202,34,168
"2011","County Durham 052C","E01020823","Total",853,427,54,373,220,106,365,52,313
"2011","County Durham 052D","E01020835","Total",696,213,36,177,222,88,207,48,159
"2011","County Durham 052E","E01020836","Total",937,381,47,334,255,118,297,49,248
"2011","County Durham 053B","E01020803","Total",830,277,36,241,244,89,257,59,198
"2011","County Durham 053D","E01020805","Total",945,483,56,427,258,103,354,40,314
"2011","County Durham 053E","E01033203","Total",1254,445,75,370,362,133,370,63,307
"2011","County Durham 054A","E01020796","Total",559,183,9,174,142,47,151,21,130
"2011","County Durham 054B","E01020828","Total",667,221,5,216,168,38,161,20,141
"2011","County Durham 054C","E01020829","Total",1039,298,14,284,327,138,219,31,188
"2011","County Durham 054D","E01020830","Total",732,341,14,327,157,53,263,23,240
"2011","County Durham 059A","E01020801","Total",716,265,32,233,184,80,208,30,178
"2011","County Durham 059B","E01020802","Total",939,408,37,371,248,107,303,36,267
"2011","County Durham 059C","E01020838","Total",812,344,43,301,193,78,272,40,232
"2011","County Durham 059D","E01020839","Total",788,407,53,354,189,83,330,36,294
"2011","County Durham 059E","E01020840","Total",721,337,63,274,203,76,256,41,215
"2011","County Durham 059F","E01020841","Total",836,424,89,335,258,108,332,62,270
"2011","County Durham 060A","E01020813","Total",508,141,7,134,152,54,113,20,93
"2011","County Durham 060B","E01020814","Total",610,152,12,140,198,57,151,23,128
"2011","County Durham 060C","E01020815","Total",511,173,26,147,151,52,130,23,107
"2011","County Durham 060D","E01020848","Total",508,170,15,155,140,62,140,22,118
"2011","County Durham 060E","E01020850","Total",699,110,20,90,313,101,133,53,80
"2011","County Durham 060F","E01020851","Total",638,223,12,211,151,41,168,28,140
"2011","County Durham 061A","E01020816","Total",589,225,77,148,253,113,182,66,116
"2011","County Durham 061B","E01020844","Total",679,285,77,208,248,127,233,61,172
"2011","County Durham 061C","E01020847","Total",614,235,88,147,268,119,178,57,121
"2011","County Durham 061D","E01020849","Total",519,192,49,143,183,76,178,50,128
"2011","County Durham 062A","E01020825","Total",717,299,26,273,181,64,256,37,219
"2011","County Durham 062B","E01020831","Total",662,308,48,260,180,82,241,39,202
"2011","County Durham 062C","E01020833","Total",502,197,18,179,151,55,160,34,126
"2011","County Durham 062D","E01020834","Total",611,264,38,226,177,72,203,32,171
"2011","County Durham 063A","E01020824","Total",771,328,22,306,178,63,284,26,258
"2011","County Durham 063B","E01020826","Total",669,278,30,248,170,40,213,25,188
"2011","County Durham 063C","E01020832","Total",640,282,18,264,133,53,238,25,213
"2011","County Durham 063D","E01020845","Total",634,285,39,246,161,51,248,47,201
"2011","County Durham 063E","E01020846","Total",530,201,25,176,131,39,134,19,115
"2011","County Durham 064A","E01020856","Total",733,317,29,288,175,54,229,30,199
"2011","County Durham 064B","E01020858","Total",475,183,12,171,126,42,164,26,138
"2011","County Durham 064C","E01020859","Total",537,195,12,183,132,41,169,25,144
"2011","County Durham 064D","E01020860","Total",476,188,30,158,126,50,152,26,126
"2011","County Durham 064E","E01020861","Total",549,228,15,213,119,38,175,21,154
"2011","County Durham 064F","E01020862","Total",1107,401,23,378,256,70,295,42,253
"2011","County Durham 064G","E01020864","Total",922,305,10,295,196,76,270,31,239
"2011","County Durham 064H","E01020867","Total",956,332,19,313,283,101,254,53,201
"2011","County Durham 065A","E01020857","Total",641,216,19,197,176,52,155,27,128
"2011","County Durham 065B","E01020863","Total",589,129,7,122,144,43,119,12,107
"2011","County Durham 065C","E01020865","Total",642,255,8,247,124,44,173,13,160
"2011","County Durham 065D","E01020866","Total",472,159,5,154,85,41,109,8,101
"2011","County Durham 066A","E01020852","Total",817,392,17,375,129,45,283,21,262
"2011","County Durham 066B","E01020853","Total",649,247,11,236,168,54,194,24,170
"2011","County Durham 066C","E01020854","Total",991,340,23,317,231,60,250,37,213
"2011","County Durham 066D","E01020855","Total",555,243,11,232,122,25,164,21,143
"2011","County Durham 042A","E01020889","Total",705,263,8,255,133,39,184,15,169
"2011","County Durham 042B","E01020890","Total",799,328,23,305,196,69,223,34,189
"2011","County Durham 042C","E01020891","Total",759,280,19,261,155,47,216,25,191
"2011","County Durham 042D","E01020905","Total",717,294,18,276,179,56,200,21,179
"2011","County Durham 042E","E01020906","Total",720,233,6,227,185,64,199,27,172
"2011","County Durham 045A","E01020876","Total",773,315,38,277,228,80,243,43,200
"2011","County Durham 045B","E01020878","Total",734,341,60,281,247,91,253,53,200
"2011","County Durham 045C","E01020887","Total",830,297,33,264,227,96,224,33,191
"2011","County Durham 045D","E01020892","Total",497,217,28,189,128,40,181,26,155
"2011","County Durham 045E","E01020894","Total",518,213,27,186,166,80,176,34,142
"2011","County Durham 045F","E01020898","Total",729,402,85,317,201,82,287,47,240
"2011","County Durham 046A","E01020877","Total",740,306,34,272,162,57,235,43,192
"2011","County Durham 046B","E01020879","Total",983,337,15,322,262,109,249,34,215
"2011","County Durham 046C","E01020893","Total",741,269,32,237,205,91,225,38,187
"2011","County Durham 046D","E01020899","Total",640,259,17,242,123,44,204,19,185
"2011","County Durham 046E","E01020903","Total",512,156,13,143,146,51,133,20,113
"2011","County Durham 046F","E01020904","Total",762,261,24,237,237,102,209,46,163
"2011","County Durham 051A","E01020873","Total",678,335,62,273,202,83,271,43,228
"2011","County Durham 051B","E01020875","Total",570,189,25,164,151,49,168,24,144
"2011","County Durham 051C","E01020900","Total",582,217,32,185,193,62,188,40,148
"2011","County Durham 051D","E01020901","Total",648,349,48,301,152,69,275,36,239
"2011","County Durham 051E","E01020902","Total",657,333,79,254,202,82,263,53,210
"2011","County Durham 055A","E01020868","Total",875,345,21,324,183,69,262,23,239
"2011","County Durham 055B","E01020869","Total",631,217,28,189,169,76,184,22,162
"2011","County Durham 055C","E01020874","Total",643,289,42,247,179,78,204,35,169
"2011","County Durham 055D","E01020880","Total",679,320,57,263,200,81,231,55,176
"2011","County Durham 055E","E01020881","Total",581,213,24,189,153,59,156,20,136
"2011","County Durham 056A","E01020870","Total",605,284,6,278,129,32,184,19,165
"2011","County Durham 056B","E01020871","Total",638,225,30,195,187,81,179,32,147
"2011","County Durham 056C","E01020872","Total",816,332,19,313,194,74,254,28,226
"2011","County Durham 056D","E01020883","Total",692,188,8,180,229,47,150,27,123
"2011","County Durham 056E","E01020886","Total",562,191,23,168,175,64,157,30,127
"2011","County Durham 057A","E01020882","Total",645,205,22,183,174,55,187,27,160
"2011","County Durham 057B","E01020888","Total",844,237,25,212,250,93,204,26,178
"2011","County Durham 057C","E01020895","Total",697,301,49,252,182,78,226,35,191
"2011","County Durham 057D","E01020896","Total",624,273,29,244,155,59,218,42,176
"2011","County Durham 057E","E01020897","Total",1081,364,66,298,372,180,312,64,248
"2011","County Durham 058A","E01020884","Total",642,283,34,249,160,64,216,29,187
"2011","County Durham 058B","E01020885","Total",543,277,36,241,141,56,191,21,170
"2011","County Durham 058C","E01020907","Total",708,305,65,240,232,70,254,60,194
"2011","County Durham 058D","E01020908","Total",601,232,54,178,205,88,186,27,159
"2011","County Durham 058E","E01020909","Total",753,443,139,304,275,148,313,59,254
"2011","Hartlepool 001A","E01011954","Total",948,417,79,338,322,120,295,54,241
"2011","Hartlepool 001B","E01011969","Total",601,243,13,230,136,40,134,16,118
"2011","Hartlepool 001C","E01011970","Total",458,106,4,102,155,54,111,24,87
"2011","Hartlepool 001D","E01011971","Total",526,83,9,74,251,84,84,35,49
"2011","Hartlepool 001F","E01033465","Total",699,131,16,115,257,121,114,36,78
"2011","Hartlepool 001G","E01033467","Total",615,345,21,324,148,70,239,18,221
"2011","Hartlepool 002A","E01011952","Total",690,345,72,273,216,97,259,44,215
"2011","Hartlepool 002B","E01011953","Total",803,421,132,289,299,129,266,59,207
"2011","Hartlepool 002C","E01011991","Total",810,347,45,302,208,70,265,38,227
"2011","Hartlepool 002D","E01011992","Total",712,325,95,230,230,108,227,46,181
"2011","Hartlepool 002E","E01011993","Total",854,427,57,370,238,84,308,52,256
"2011","Hartlepool 002F","E01011994","Total",684,393,88,305,209,88,237,39,198
"2011","Hartlepool 003A","E01011955","Total",601,302,72,230,188,86,198,35,163
"2011","Hartlepool 003C","E01011957","Total",570,243,56,187,183,77,172,36,136
"2011","Hartlepool 003G","E01032540","Total",441,154,27,127,143,55,131,33,98
"2011","Hartlepool 003H","E01032541","Total",985,481,53,428,276,101,358,52,306
"2011","Hartlepool 003I","E01033466","Total",877,490,129,361,299,139,321,63,258
"2011","Hartlepool 005A","E01011973","Total",661,410,116,294,193,96,228,44,184
"2011","Hartlepool 005B","E01011974","Total",933,339,61,278,153,63,254,43,211
"2011","Hartlepool 005C","E01011975","Total",681,271,45,226,173,89,185,25,160
"2011","Hartlepool 005D","E01011976","Total",490,236,40,196,134,55,166,29,137
"2011","Hartlepool 006A","E01011965","Total",635,192,9,183,213,62,132,31,101
"2011","Hartlepool 006B","E01011966","Total",641,248,20,228,157,63,165,17,148
"2011","Hartlepool 006C","E01011983","Total",629,195,8,187,215,53,150,28,122
"2011","Hartlepool 006D","E01012002","Total",607,237,16,221,171,48,184,34,150
"2011","Hartlepool 007A","E01011951","Total",694,303,78,225,217,110,204,35,169
"2011","Hartlepool 007B","E01011964","Total",535,218,34,184,176,78,167,35,132
"2011","Hartlepool 007C","E01011967","Total",548,153,22,131,212,72,143,41,102
"2011","Hartlepool 007D","E01011999","Total",959,481,113,368,270,133,298,44,254
"2011","Hartlepool 007E","E01012000","Total",796,497,65,432,147,68,293,30,263
"2011","Hartlepool 008A","E01011950","Total",771,390,76,314,190,88,240,41,199
"2011","Hartlepool 008B","E01011986","Total",531,188,24,164,169,60,149,24,125
"2011","Hartlepool 008C","E01011987","Total",642,228,37,191,187,79,197,36,161
"2011","Hartlepool 008D","E01012001","Total",913,433,88,345,270,122,293,45,248
"2011","Hartlepool 009A","E01011949","Total",785,327,71,256,290,95,247,58,189
"2011","Hartlepool 009B","E01011980","Total",812,448,49,399,214,76,310,51,259
"2011","Hartlepool 009C","E01011981","Total",709,362,61,301,233,89,273,43,230
"2011","Hartlepool 009D","E01011984","Total",581,287,10,277,113,29,192,18,174
"2011","Hartlepool 010A","E01011985","Total",503,200,23,177,124,46,162,26,136
"2011","Hartlepool 010B","E01011988","Total",862,352,23,329,243,91,297,49,248
"2011","Hartlepool 010C","E01011989","Total",835,426,93,333,262,119,329,61,268
"2011","Hartlepool 010D","E01011990","Total",724,254,34,220,226,88,212,40,172
"2011","Hartlepool 011A","E01011995","Total",581,243,11,232,164,43,183,32,151
"2011","Hartlepool 011B","E01011996","Total",664,267,16,251,154,49,193,26,167
"2011","Hartlepool 011C","E01011997","Total",816,228,26,202,271,108,203,41,162
"2011","Hartlepool 011D","E01011998","Total",637,268,13,255,159,38,218,34,184
"2011","Hartlepool 012A","E01011961","Total",629,303,54,249,209,74,192,41,151
"2011","Hartlepool 012B","E01011962","Total",613,310,68,242,214,80,207,41,166
"2011","Hartlepool 012C","E01011977","Total",748,340,110,230,293,118,230,62,168
"2011","Hartlepool 012D","E01011978","Total",774,451,106,345,237,112,292,58,234
"2011","Hartlepool 012E","E01011979","Total",635,299,95,204,258,93,190,57,133
"2011","Hartlepool 014A","E01011959","Total",830,255,12,243,247,69,205,31,174
"2011","Hartlepool 014B","E01011960","Total",616,294,9,285,132,23,196,27,169
"2011","Hartlepool 014C","E01011963","Total",660,278,8,270,151,34,200,21,179
"2011","Hartlepool 014D","E01011968","Total",952,390,32,358,224,63,283,44,239
"2011","Hartlepool 014E","E01011982","Total",543,207,5,202,153,39,121,19,102
"2011","Hartlepool 014F","E01012003","Total",668,239,8,231,170,48,160,24,136
"2011","Hartlepool 014G","E01012005","Total",717,110,12,98,345,111,126,45,81
"2011","Middlesbrough 001A","E01012068","Total",804,414,89,325,187,109,202,32,170
"2011","Middlesbrough 001D","E01012092","Total",625,354,73,281,178,108,202,45,157
"2011","Middlesbrough 001E","E01012093","Total",711,342,94,248,254,147,193,64,129
"2011","Middlesbrough 001F","E01012094","Total",956,411,92,319,307,159,247,59,188
"2011","Middlesbrough 001G","E01033468","Total",1253,761,87,674,240,129,523,62,461
"2011","Middlesbrough 002A","E01012058","Total",774,395,112,283,223,113,248,48,200
"2011","Middlesbrough 002B","E01012059","Total",724,392,97,295,200,90,251,41,210
"2011","Middlesbrough 002C","E01012060","Total",698,362,122,240,286,149,232,63,169
"2011","Middlesbrough 002D","E01012061","Total",619,310,77,233,217,113,226,56,170
"2011","Middlesbrough 003A","E01012036","Total",608,283,78,205,162,96,157,26,131
"2011","Middlesbrough 003B","E01012037","Total",687,331,105,226,227,125,194,40,154
"2011","Middlesbrough 003C","E01012038","Total",661,283,85,198,208,110,166,29,137
"2011","Middlesbrough 003D","E01012039","Total",625,302,51,251,119,71,158,22,136
"2011","Middlesbrough 003E","E01012040","Total",626,311,90,221,208,111,153,48,105
"2011","Middlesbrough 003F","E01012041","Total",613,406,43,363,89,40,284,25,259
"2011","Middlesbrough 004A","E01012074","Total",634,275,65,210,232,103,218,38,180
"2011","Middlesbrough 004B","E01012075","Total",621,284,102,182,264,108,214,62,152
"2011","Middlesbrough 004C","E01012076","Total",615,332,135,197,287,122,203,64,139
"2011","Middlesbrough 004D","E01012077","Total",604,309,45,264,156,66,248,37,211
"2011","Middlesbrough 004E","E01012088","Total",531,267,104,163,242,102,166,50,116
"2011","Middlesbrough 005A","E01012078","Total",654,235,56,179,191,90,161,34,127
"2011","Middlesbrough 005B","E01012079","Total",503,152,14,138,174,68,117,33,84
"2011","Middlesbrough 005C","E01012080","Total",503,164,24,140,152,66,151,38,113
"2011","Middlesbrough 005D","E01012081","Total",679,240,39,201,219,101,198,48,150
"2011","Middlesbrough 006A","E01012026","Total",618,212,31,181,197,83,187,44,143
"2011","Middlesbrough 006B","E01012027","Total",799,390,62,328,242,97,280,41,239
"2011","Middlesbrough 006E","E01033469","Total",811,360,102,258,300,124,266,64,202
"2011","Middlesbrough 007A","E01012015","Total",710,384,54,330,174,63,296,44,252
"2011","Middlesbrough 007B","E01012016","Total",793,396,77,319,231,107,276,51,225
"2011","Middlesbrough 007C","E01012017","Total",727,341,29,312,162,55,252,24,228
"2011","Middlesbrough 007D","E01012089","Total",602,306,104,202,234,105,209,55,154
"2011","Middlesbrough 007E","E01012090","Total",718,412,101,311,212,95,269,44,225
"2011","Middlesbrough 007F","E01012091","Total",630,324,127,197,294,144,228,72,156
"2011","Middlesbrough 008A","E01012011","Total",770,366,103,263,312,103,286,74,212
"2011","Middlesbrough 008B","E01012012","Total",633,193,32,161,250,96,183,57,126
"2011","Middlesbrough 008C","E01012013","Total",547,202,41,161,179,69,179,35,144
"2011","Middlesbrough 008D","E01012014","Total",617,228,74,154,255,114,177,47,130
"2011","Middlesbrough 009A","E01012053","Total",621,184,9,175,204,80,149,32,117
"2011","Middlesbrough 009B","E01012054","Total",618,159,32,127,249,96,147,50,97
"2011","Middlesbrough 009C","E01012055","Total",734,257,25,232,213,90,183,30,153
"2011","Middlesbrough 009D","E01012056","Total",987,247,61,186,319,158,176,36,140
"2011","Middlesbrough 009E","E01012057","Total",759,223,45,178,277,116,193,45,148
"2011","Middlesbrough 010A","E01012082","Total",629,277,94,183,246,96,197,48,149
"2011","Middlesbrough 010B","E01012083","Total",620,272,97,175,264,124,213,57,156
"2011","Middlesbrough 010C","E01012084","Total",698,366,122,244,273,113,250,55,195
"2011","Middlesbrough 010D","E01012085","Total",584,262,81,181,228,76,183,50,133
"2011","Middlesbrough 011A","E01012018","Total",676,262,38,224,170,69,192,35,157
"2011","Middlesbrough 011B","E01012019","Total",583,364,106,258,229,103,239,51,188
"2011","Middlesbrough 011C","E01012020","Total",623,284,66,218,231,79,205,45,160
"2011","Middlesbrough 011D","E01012021","Total",544,268,87,181,236,87,186,45,141
"2011","Middlesbrough 012A","E01012007","Total",665,308,9,299,146,48,220,28,192
"2011","Middlesbrough 012B","E01012008","Total",535,163,14,149,198,56,140,30,110
"2011","Middlesbrough 012C","E01012009","Total",760,219,12,207,214,87,170,31,139
"2011","Middlesbrough 012D","E01012010","Total",538,189,8,181,152,51,137,21,116
"2011","Middlesbrough 013A","E01012046","Total",815,394,9,385,145,44,277,24,253
"2011","Middlesbrough 013B","E01012047","Total",582,188,11,177,224,67,154,30,124
"2011","Middlesbrough 013C","E01012048","Total",721,306,9,297,176,55,194,22,172
"2011","Middlesbrough 014A","E01012049","Total",637,221,17,204,159,56,161,21,140
"2011","Middlesbrough 014B","E01012050","Total",630,297,69,228,225,106,222,39,183
"2011","Middlesbrough 014C","E01012051","Total",534,233,65,168,203,87,159,36,123
"2011","Middlesbrough 014D","E01012052","Total",542,191,13,178,141,46,141,23,118
"2011","Middlesbrough 015A","E01012022","Total",631,161,13,148,184,60,158,33,125
"2011","Middlesbrough 015B","E01012023","Total",691,397,8,389,80,18,237,16,221
"2011","Middlesbrough 015C","E01012024","Total",643,267,14,253,168,63,195,28,167
"2011","Middlesbrough 015D","E01012025","Total",517,169,14,155,151,47,147,21,126
"2011","Middlesbrough 017A","E01012065","Total",761,310,14,296,187,60,166,30,136
"2011","Middlesbrough 017B","E01012066","Total",715,92,8,84,332,96,101,42,59
"2011","Middlesbrough 017C","E01012067","Total",729,343,7,336,136,48,214,20,194
"2011","Middlesbrough 018A","E01012042","Total",730,331,31,300,175,64,249,32,217
"2011","Middlesbrough 018B","E01012043","Total",625,266,21,245,158,58,183,28,155
"2011","Middlesbrough 018C","E01012044","Total",637,282,94,188,266,139,221,58,163
"2011","Middlesbrough 018D","E01012045","Total",603,302,94,208,246,108,203,58,145
"2011","Middlesbrough 018G","E01032552","Total",631,204,38,166,248,78,171,41,130
"2011","Middlesbrough 018H","E01032553","Total",598,270,7,263,102,33,170,19,151
"2011","Middlesbrough 019A","E01012030","Total",625,204,8,196,186,67,163,21,142
"2011","Middlesbrough 019B","E01012031","Total",771,328,26,302,185,66,257,26,231
"2011","Middlesbrough 019C","E01012032","Total",612,97,12,85,264,103,104,35,69
"2011","Middlesbrough 019D","E01012033","Total",647,333,24,309,126,49,268,27,241
"2011","Middlesbrough 019E","E01012034","Total",548,146,32,114,229,52,127,43,84
"2011","Middlesbrough 019F","E01012035","Total",624,296,41,255,154,64,244,37,207
"2011","Middlesbrough 020A","E01012062","Total",614,231,11,220,165,51,174,25,149
"2011","Middlesbrough 020B","E01012063","Total",638,258,7,251,146,53,179,20,159
"2011","Middlesbrough 020C","E01012064","Total",776,222,19,203,231,91,172,34,138
"2011","Middlesbrough 020D","E01012071","Total",574,228,8,220,158,34,126,18,108
"2011","Middlesbrough 020E","E01012073","Total",597,219,6,213,144,41,143,18,125
"2011","Middlesbrough 020F","E01032593","Total",728,243,15,228,234,69,175,30,145
"2011","Northumberland 004A","E01027356","Total",795,337,5,332,139,45,198,17,181
"2011","Northumberland 004B","E01027357","Total",515,199,2,197,123,33,103,6,97
"2011","Northumberland 004C","E01027366","Total",705,286,15,271,135,37,195,26,169
"2011","Northumberland 004D","E01027367","Total",675,168,15,153,271,113,152,33,119
"2011","Northumberland 005A","E01027358","Total",1012,390,13,377,184,60,298,21,277
"2011","Northumberland 005B","E01027359","Total",925,341,54,287,323,132,269,58,211
"2011","Northumberland 005D","E01033715","Total",577,252,16,236,92,22,161,15,146
"2011","Northumberland 005E","E01033717","Total",636,198,6,192,179,46,142,26,116
"2011","Northumberland 006A","E01027361","Total",974,381,37,344,234,79,299,39,260
"2011","Northumberland 006B","E01027362","Total",584,251,24,227,150,53,188,22,166
"2011","Northumberland 006C","E01027363","Total",508,250,44,206,152,63,178,26,152
"2011","Northumberland 006D","E01027364","Total",908,351,26,325,236,58,243,30,213
"2011","Northumberland 006E","E01027370","Total",787,269,13,256,179,42,201,32,169
"2011","Northumberland 006F","E01027371","Total",762,268,21,247,241,95,186,37,149
"2011","Northumberland 006G","E01027372","Total",985,426,15,411,167,53,276,25,251
"2011","Northumberland 007A","E01027365","Total",972,341,10,331,212,55,259,32,227
"2011","Northumberland 007B","E01027368","Total",789,269,11,258,183,67,210,30,180
"2011","Northumberland 007C","E01027369","Total",742,350,7,343,133,45,197,9,188
"2011","Northumberland 007D","E01027373","Total",904,257,7,250,193,63,202,23,179
"2011","Northumberland 001A","E01027376","Total",742,265,26,239,222,87,200,25,175
"2011","Northumberland 001B","E01027377","Total",908,359,18,341,123,58,278,25,253
"2011","Northumberland 001C","E01027385","Total",491,158,36,122,196,97,124,34,90
"2011","Northumberland 001D","E01027387","Total",863,334,28,306,175,79,249,24,225
"2011","Northumberland 001E","E01027388","Total",633,236,44,192,204,76,175,32,143
"2011","Northumberland 001F","E01027389","Total",692,221,23,198,188,74,176,23,153
"2011","Northumberland 002A","E01027378","Total",454,175,3,172,118,33,112,22,90
"2011","Northumberland 002B","E01027379","Total",624,251,7,244,135,45,159,17,142
"2011","Northumberland 002C","E01027380","Total",656,237,12,225,147,52,185,25,160
"2011","Northumberland 002D","E01027382","Total",796,321,9,312,155,49,200,19,181
"2011","Northumberland 002E","E01027386","Total",593,224,16,208,159,59,157,28,129
"2011","Northumberland 003A","E01027374","Total",976,391,16,375,187,59,293,40,253
"2011","Northumberland 003B","E01027375","Total",812,257,16,241,172,61,200,29,171
"2011","Northumberland 003C","E01027381","Total",852,304,19,285,171,55,224,28,196
"2011","Northumberland 003D","E01027383","Total",674,324,10,314,115,52,219,21,198
"2011","Northumberland 003E","E01027384","Total",725,298,9,289,118,29,172,15,157
"2011","Northumberland 003F","E01027390","Total",974,429,14,415,173,62,307,19,288
"2011","Northumberland 022A","E01027392","Total",781,407,69,338,212,82,315,51,264
"2011","Northumberland 022B","E01027393","Total",621,264,65,199,242,92,210,46,164
"2011","Northumberland 022C","E01027416","Total",759,435,110,325,237,106,293,42,251
"2011","Northumberland 022D","E01027424","Total",823,380,96,284,268,123,269,55,214
"2011","Northumberland 023A","E01027414","Total",649,217,33,184,185,76,180,30,150
"2011","Northumberland 023B","E01027415","Total",790,381,57,324,188,73,281,41,240
"2011","Northumberland 023C","E01027431","Total",897,396,56,340,217,94,264,25,239
"2011","Northumberland 023D","E01027441","Total",926,326,26,300,257,105,226,37,189
"2011","Northumberland 023E","E01027442","Total",805,335,15,320,149,67,244,28,216
"2011","Northumberland 024A","E01027391","Total",592,220,37,183,217,74,181,44,137
"2011","Northumberland 024B","E01027422","Total",845,372,57,315,249,91,288,48,240
"2011","Northumberland 024C","E01027423","Total",645,287,29,258,183,66,239,38,201
"2011","Northumberland 024D","E01027429","Total",886,432,55,377,234,86,325,42,283
"2011","Northumberland 024E","E01027430","Total",712,335,53,282,215,77,246,44,202
"2011","Northumberland 025A","E01027425","Total",922,245,14,231,297,97,197,43,154
"2011","Northumberland 025B","E01027426","Total",533,215,95,120,262,118,176,65,111
"2011","Northumberland 025C","E01027427","Total",827,375,60,315,194,84,265,40,225
"2011","Northumberland 025D","E01027428","Total",632,171,15,156,193,62,153,32,121
"2011","Northumberland 026A","E01027437","Total",760,244,14,230,193,68,197,28,169
"2011","Northumberland 026B","E01027438","Total",621,165,7,158,194,66,138,29,109
"2011","Northumberland 026C","E01027439","Total",759,151,3,148,279,90,144,32,112
"2011","Northumberland 026D","E01027440","Total",596,196,4,192,154,53,143,15,128
"2011","Northumberland 027A","E01027400","Total",488,56,4,52,259,89,72,30,42
"2011","Northumberland 027B","E01027401","Total",540,97,3,94,238,66,87,32,55
"2011","Northumberland 027C","E01027402","Total",491,98,7,91,207,53,92,24,68
"2011","Northumberland 027D","E01027403","Total",484,124,1,123,145,45,95,19,76
"2011","Northumberland 029A","E01027398","Total",894,273,77,196,344,130,222,72,150
"2011","Northumberland 029B","E01027409","Total",741,315,19,296,140,44,231,28,203
"2011","Northumberland 029C","E01027411","Total",624,304,24,280,135,64,211,21,190
"2011","Northumberland 029D","E01027412","Total",634,257,69,188,235,99,186,46,140
"2011","Northumberland 029E","E01027413","Total",821,289,46,243,236,85,218,46,172
"2011","Northumberland 028A","E01027395","Total",681,248,21,227,184,79,226,32,194
"2011","Northumberland 028B","E01027396","Total",568,185,32,153,197,76,161,40,121
"2011","Northumberland 028C","E01027397","Total",637,309,40,269,182,62,227,35,192
"2011","Northumberland 028D","E01027399","Total",595,78,11,67,194,78,106,30,76
"2011","Northumberland 028E","E01027404","Total",610,113,6,107,192,71,117,25,92
"2011","Northumberland 028F","E01027405","Total",641,199,6,193,156,50,154,27,127
"2011","Northumberland 030A","E01027417","Total",696,317,4,313,141,48,211,14,197
"2011","Northumberland 030B","E01027418","Total",788,222,12,210,237,90,198,37,161
"2011","Northumberland 030C","E01027419","Total",775,350,10,340,160,48,264,25,239
"2011","Northumberland 030D","E01027420","Total",611,218,5,213,130,43,164,17,147
"2011","Northumberland 030E","E01027421","Total",728,315,12,303,161,55,230,29,201
"2011","Northumberland 031A","E01027394","Total",536,180,9,171,117,46,156,23,133
"2011","Northumberland 031B","E01027406","Total",617,257,4,253,97,30,163,18,145
"2011","Northumberland 031C","E01027407","Total",618,201,2,199,108,34,138,16,122
"2011","Northumberland 031D","E01027408","Total",649,278,18,260,133,40,207,16,191
"2011","Northumberland 031E","E01027410","Total",665,226,10,216,194,61,157,33,124
"2011","Northumberland 032A","E01027432","Total",780,286,24,262,160,55,223,28,195
"2011","Northumberland 032B","E01027433","Total",773,272,28,244,211,78,226,40,186
"2011","Northumberland 032C","E01027434","Total",633,255,24,231,162,48,169,29,140
"2011","Northumberland 032D","E01027435","Total",671,259,19,240,145,48,178,25,153
"2011","Northumberland 032E","E01027436","Total",679,245,27,218,196,56,203,37,166
"2011","Northumberland 008A","E01027443","Total",675,320,56,264,194,90,214,39,175
"2011","Northumberland 008B","E01027444","Total",576,189,14,175,145,54,153,26,127
"2011","Northumberland 008C","E01027445","Total",682,236,17,219,167,61,183,26,157
"2011","Northumberland 008D","E01027446","Total",583,188,2,186,135,39,145,18,127
"2011","Northumberland 008E","E01027451","Total",814,386,76,310,247,106,286,59,227
"2011","Northumberland 008F","E01027474","Total",851,301,44,257,261,97,243,39,204
"2011","Northumberland 008G","E01027475","Total",641,221,9,212,142,33,162,25,137
"2011","Northumberland 011A","E01027457","Total",554,167,6,161,154,41,115,17,98
"2011","Northumberland 011B","E01027462","Total",883,385,49,336,245,106,281,39,242
"2011","Northumberland 011C","E01027463","Total",703,166,6,160,226,96,167,31,136
"2011","Northumberland 015A","E01027447","Total",768,168,11,157,201,52,164,23,141
"2011","Northumberland 015B","E01027448","Total",770,226,12,214,233,63,157,32,125
"2011","Northumberland 015C","E01027450","Total",696,202,5,197,192,50,164,35,129
"2011","Northumberland 015D","E01027473","Total",756,251,15,236,190,61,194,19,175
"2011","Northumberland 016A","E01027452","Total",651,223,10,213,154,49,164,23,141
"2011","Northumberland 016B","E01027453","Total",849,450,12,438,108,36,307,22,285
"2011","Northumberland 016E","E01027461","Total",614,290,45,245,168,68,208,35,173
"2011","Northumberland 016F","E01033718","Total",1010,453,28,425,245,83,306,39,267
"2011","Northumberland 018A","E01027455","Total",635,246,3,243,172,46,138,17,121
"2011","Northumberland 018B","E01027456","Total",525,190,3,187,137,32,118,14,104
"2011","Northumberland 018C","E01027458","Total",654,237,3,234,181,40,132,21,111
"2011","Northumberland 018D","E01027460","Total",734,283,6,277,192,60,197,27,170
"2011","Northumberland 033A","E01027464","Total",646,303,9,294,123,30,157,7,150
"2011","Northumberland 033B","E01027465","Total",644,246,6,240,169,46,154,22,132
"2011","Northumberland 033C","E01027466","Total",530,224,18,206,151,45,177,33,144
"2011","Northumberland 033F","E01033714","Total",972,382,9,373,255,73,204,29,175
"2011","Northumberland 034A","E01027449","Total",685,281,3,278,157,47,168,16,152
"2011","Northumberland 034B","E01027468","Total",516,231,8,223,125,32,116,13,103
"2011","Northumberland 034C","E01027469","Total",536,205,3,202,182,42,117,21,96
"2011","Northumberland 034D","E01027471","Total",642,231,4,227,188,50,117,20,97
"2011","Northumberland 034E","E01027472","Total",629,166,15,151,208,88,132,24,108
"2011","Northumberland 019A","E01027479","Total",1028,344,14,330,264,88,272,41,231
"2011","Northumberland 019B","E01027480","Total",520,128,6,122,130,38,132,25,107
"2011","Northumberland 019C","E01027503","Total",796,245,11,234,163,58,207,26,181
"2011","Northumberland 019D","E01027511","Total",495,146,2,144,94,37,119,10,109
"2011","Northumberland 037A","E01027484","Total",953,320,12,308,231,66,242,33,209
"2011","Northumberland 037B","E01027485","Total",696,274,16,258,154,64,210,25,185
"2011","Northumberland 037C","E01027486","Total",524,197,18,179,128,48,130,17,113
"2011","Northumberland 037D","E01027487","Total",531,214,12,202,120,40,149,14,135
"2011","Northumberland 037E","E01027512","Total",468,145,9,136,99,32,126,15,111
"2011","Northumberland 036A","E01027483","Total",559,151,6,145,130,43,123,13,110
"2011","Northumberland 036B","E01027496","Total",528,206,10,196,152,41,158,24,134
"2011","Northumberland 036C","E01027508","Total",482,153,7,146,129,47,130,28,102
"2011","Northumberland 036D","E01027513","Total",826,275,7,268,225,69,196,38,158
"2011","Northumberland 035A","E01027476","Total",1161,424,23,401,240,100,325,34,291
"2011","Northumberland 035B","E01027489","Total",650,209,20,189,202,50,173,29,144
"2011","Northumberland 035C","E01027490","Total",812,286,22,264,229,77,223,33,190
"2011","Northumberland 035D","E01027491","Total",642,251,8,243,163,37,141,26,115
"2011","Northumberland 035E","E01027492","Total",764,248,6,242,238,84,152,28,124
"2011","Northumberland 035F","E01027493","Total",677,288,47,241,188,77,240,53,187
"2011","Northumberland 035G","E01027494","Total",1019,394,18,376,219,56,256,28,228
"2011","Northumberland 038A","E01027497","Total",1013,236,36,200,418,145,213,46,167
"2011","Northumberland 038B","E01027498","Total",1167,442,45,397,361,145,348,59,289
"2011","Northumberland 038C","E01027499","Total",629,248,9,239,149,49,176,19,157
"2011","Northumberland 038D","E01027500","Total",763,276,32,244,196,86,232,35,197
"2011","Northumberland 038E","E01027501","Total",475,147,10,137,124,46,124,19,105
"2011","Northumberland 038F","E01027502","Total",486,126,6,120,156,46,115,32,83
"2011","Northumberland 039A","E01027481","Total",796,332,8,324,152,52,230,16,214
"2011","Northumberland 039B","E01027482","Total",685,279,5,274,147,53,180,22,158
"2011","Northumberland 039C","E01027504","Total",802,279,6,273,169,50,204,17,187
"2011","Northumberland 039D","E01027506","Total",468,115,5,110,132,43,85,11,74
"2011","Northumberland 039E","E01027507","Total",542,148,4,144,155,38,101,16,85
"2011","Northumberland 039F","E01027509","Total",612,254,3,251,141,40,159,18,141
"2011","Northumberland 040A","E01027477","Total",520,148,4,144,120,30,131,21,110
"2011","Northumberland 040B","E01027478","Total",502,198,6,192,101,28,154,20,134
"2011","Northumberland 040C","E01027488","Total",943,283,16,267,238,80,236,36,200
"2011","Northumberland 040D","E01027495","Total",459,155,6,149,124,39,125,25,100
"2011","Northumberland 040E","E01027505","Total",553,153,11,142,153,36,127,18,109
"2011","Northumberland 040F","E01027510","Total",510,153,7,146,134,38,114,13,101
"2011","Northumberland 009A","E01027541","Total",830,358,39,319,177,77,248,25,223
"2011","Northumberland 009B","E01027542","Total",843,472,90,382,239,119,296,35,261
"2011","Northumberland 009C","E01027543","Total",548,239,57,182,201,79,166,43,123
"2011","Northumberland 009D","E01027544","Total",632,282,24,258,133,49,197,24,173
"2011","Northumberland 010A","E01027528","Total",611,250,44,206,172,64,199,30,169
"2011","Northumberland 010B","E01027529","Total",482,138,9,129,130,36,126,16,110
"2011","Northumberland 010C","E01027539","Total",773,356,77,279,224,100,255,47,208
"2011","Northumberland 010D","E01027545","Total",927,434,126,308,297,139,322,62,260
"2011","Northumberland 010E","E01027546","Total",828,358,88,270,260,106,249,56,193
"2011","Northumberland 013A","E01027533","Total",902,492,66,426,203,107,350,44,306
"2011","Northumberland 013B","E01027540","Total",831,363,87,276,270,105,288,57,231
"2011","Northumberland 013E","E01027549","Total",586,92,7,85,229,91,117,40,77
"2011","Northumberland 013F","E01033716","Total",1050,496,83,413,269,105,353,63,290
"2011","Northumberland 012A","E01027524","Total",635,220,36,184,185,66,194,36,158
"2011","Northumberland 012B","E01027525","Total",859,394,6,388,172,59,324,32,292
"2011","Northumberland 012C","E01027526","Total",522,165,4,161,140,28,140,26,114
"2011","Northumberland 012D","E01027527","Total",605,294,54,240,183,67,260,44,216
"2011","Northumberland 012E","E01027536","Total",611,221,27,194,173,44,183,30,153
"2011","Northumberland 014A","E01027532","Total",837,250,22,228,229,76,227,41,186
"2011","Northumberland 014B","E01027537","Total",631,291,25,266,153,57,218,30,188
"2011","Northumberland 014C","E01027538","Total",720,207,14,193,234,79,163,26,137
"2011","Northumberland 017A","E01027530","Total",625,230,46,184,216,98,170,34,136
"2011","Northumberland 017B","E01027531","Total",715,215,39,176,225,86,174,31,143
"2011","Northumberland 017C","E01027534","Total",904,404,62,342,247,101,300,55,245
"2011","Northumberland 017D","E01027535","Total",658,286,5,281,132,33,167,21,146
"2011","Northumberland 017E","E01027553","Total",734,240,15,225,177,60,207,14,193
"2011","Northumberland 017F","E01027554","Total",621,271,13,258,130,42,174,19,155
"2011","Northumberland 020A","E01027515","Total",689,235,19,216,164,62,223,28,195
"2011","Northumberland 020B","E01027517","Total",879,274,18,256,222,85,247,44,203
"2011","Northumberland 020C","E01027518","Total",640,297,48,249,198,82,205,34,171
"2011","Northumberland 020D","E01027519","Total",635,266,68,198,226,92,188,41,147
"2011","Northumberland 020E","E01027550","Total",606,269,28,241,162,55,223,40,183
"2011","Northumberland 020F","E01027551","Total",631,265,48,217,191,80,183,32,151
"2011","Northumberland 020G","E01027552","Total",597,237,32,205,134,45,177,25,152
"2011","Northumberland 021A","E01027514","Total",709,294,20,274,172,51,203,33,170
"2011","Northumberland 021B","E01027516","Total",505,205,20,185,137,42,133,16,117
"2011","Northumberland 021C","E01027520","Total",594,186,12,174,183,65,139,23,116
"2011","Northumberland 021D","E01027521","Total",623,105,6,99,280,96,94,23,71
"2011","Northumberland 021E","E01027522","Total",624,288,39,249,163,62,201,28,173
"2011","Northumberland 021F","E01027523","Total",533,212,29,183,135,48,155,26,129
"2011","Redcar and Cleveland 001A","E01012100","Total",883,459,71,388,173,80,270,42,228
"2011","Redcar and Cleveland 001B","E01012101","Total",713,340,42,298,153,66,251,35,216
"2011","Redcar and Cleveland 001C","E01012102","Total",1038,361,95,266,343,158,248,49,199
"2011","Redcar and Cleveland 001D","E01012184","Total",636,238,25,213,196,70,202,36,166
"2011","Redcar and Cleveland 002A","E01012105","Total",567,224,20,204,182,59,177,19,158
"2011","Redcar and Cleveland 002B","E01012142","Total",724,309,30,279,226,70,263,47,216
"2011","Redcar and Cleveland 002C","E01012143","Total",529,306,95,211,212,78,207,59,148
"2011","Redcar and Cleveland 002D","E01012144","Total",612,224,18,206,143,52,179,20,159
"2011","Redcar and Cleveland 003C","E01012106","Total",604,246,25,221,155,57,193,29,164
"2011","Redcar and Cleveland 003D","E01012107","Total",666,361,38,323,174,56,278,45,233
"2011","Redcar and Cleveland 003E","E01032560","Total",457,187,5,182,107,25,134,18,116
"2011","Redcar and Cleveland 003F","E01032561","Total",659,285,104,181,264,115,205,63,142
"2011","Redcar and Cleveland 004A","E01012176","Total",661,316,12,304,142,47,214,22,192
"2011","Redcar and Cleveland 004B","E01012177","Total",615,171,12,159,217,58,146,33,113
"2011","Redcar and Cleveland 004C","E01012178","Total",605,207,13,194,180,54,155,29,126
"2011","Redcar and Cleveland 004D","E01012179","Total",635,224,7,217,181,62,158,26,132
"2011","Redcar and Cleveland 004E","E01012180","Total",613,96,8,88,304,81,100,39,61
"2011","Redcar and Cleveland 004F","E01012185","Total",633,242,31,211,195,66,170,29,141
"2011","Redcar and Cleveland 004G","E01012186","Total",748,312,14,298,179,58,236,30,206
"2011","Redcar and Cleveland 005A","E01012127","Total",517,319,62,257,142,63,247,34,213
"2011","Redcar and Cleveland 005B","E01012128","Total",542,301,53,248,147,50,213,31,182
"2011","Redcar and Cleveland 005C","E01012129","Total",854,312,37,275,264,118,213,40,173
"2011","Redcar and Cleveland 005D","E01012130","Total",588,239,20,219,132,41,186,22,164
"2011","Redcar and Cleveland 005E","E01012131","Total",652,415,74,341,181,74,291,52,239
"2011","Redcar and Cleveland 006A","E01012138","Total",1026,264,9,255,413,166,209,52,157
"2011","Redcar and Cleveland 006B","E01012139","Total",781,267,5,262,217,58,208,30,178
"2011","Redcar and Cleveland 006C","E01012140","Total",617,259,37,222,155,77,164,22,142
"2011","Redcar and Cleveland 006D","E01012141","Total",490,218,7,211,121,29,125,8,117
"2011","Redcar and Cleveland 006E","E01012154","Total",591,289,9,280,116,37,163,17,146
"2011","Redcar and Cleveland 006F","E01012155","Total",768,396,20,376,151,54,261,25,236
"2011","Redcar and Cleveland 006G","E01012156","Total",738,322,8,314,177,54,236,35,201
"2011","Redcar and Cleveland 006H","E01012157","Total",761,346,17,329,180,59,229,32,197
"2011","Redcar and Cleveland 007A","E01012158","Total",647,308,9,299,141,39,186,15,171
"2011","Redcar and Cleveland 007B","E01012159","Total",955,478,33,445,132,43,335,25,310
"2011","Redcar and Cleveland 007C","E01012160","Total",606,234,19,215,171,45,201,32,169
"2011","Redcar and Cleveland 007D","E01012161","Total",657,245,31,214,175,68,174,28,146
"2011","Redcar and Cleveland 009A","E01012113","Total",558,289,111,178,255,121,171,55,116
"2011","Redcar and Cleveland 009B","E01012114","Total",648,368,120,248,235,136,216,46,170
"2011","Redcar and Cleveland 009E","E01012175","Total",636,334,82,252,224,89,231,52,179
"2011","Redcar and Cleveland 009F","E01033471","Total",874,410,177,233,403,181,267,80,187
"2011","Redcar and Cleveland 010A","E01012095","Total",543,186,12,174,165,65,131,14,117
"2011","Redcar and Cleveland 010B","E01012097","Total",512,263,16,247,110,39,149,17,132
"2011","Redcar and Cleveland 010C","E01012098","Total",553,178,15,163,177,58,135,24,111
"2011","Redcar and Cleveland 010D","E01012099","Total",683,328,77,251,223,105,230,53,177
"2011","Redcar and Cleveland 011A","E01012108","Total",618,263,71,192,228,79,200,50,150
"2011","Redcar and Cleveland 011B","E01012109","Total",605,203,25,178,142,57,162,30,132
"2011","Redcar and Cleveland 011C","E01012110","Total",622,176,14,162,166,66,152,23,129
"2011","Redcar and Cleveland 011D","E01012111","Total",642,356,27,329,139,48,263,22,241
"2011","Redcar and Cleveland 011E","E01012171","Total",660,335,30,305,159,58,247,23,224
"2011","Redcar and Cleveland 011F","E01012172","Total",625,275,12,263,144,43,190,19,171
"2011","Redcar and Cleveland 012A","E01012162","Total",624,196,33,163,217,97,158,30,128
"2011","Redcar and Cleveland 012B","E01012163","Total",832,244,20,224,282,103,221,53,168
"2011","Redcar and Cleveland 012C","E01012164","Total",748,292,29,263,185,68,205,40,165
"2011","Redcar and Cleveland 012D","E01012165","Total",985,489,107,382,320,129,357,75,282
"2011","Redcar and Cleveland 013A","E01012096","Total",707,339,75,264,233,100,236,55,181
"2011","Redcar and Cleveland 013D","E01012136","Total",637,261,35,226,163,65,165,35,130
"2011","Redcar and Cleveland 013E","E01033473","Total",910,459,100,359,289,122,308,56,252
"2011","Redcar and Cleveland 015A","E01012112","Total",783,433,55,378,181,68,314,35,279
"2011","Redcar and Cleveland 015B","E01012145","Total",670,259,31,228,184,69,190,33,157
"2011","Redcar and Cleveland 015C","E01012147","Total",670,232,3,229,172,40,163,25,138
"2011","Redcar and Cleveland 015D","E01012149","Total",497,178,5,173,125,35,136,21,115
"2011","Redcar and Cleveland 016A","E01012132","Total",922,457,61,396,226,70,306,46,260
"2011","Redcar and Cleveland 016B","E01012134","Total",697,374,31,343,139,53,256,30,226
"2011","Redcar and Cleveland 016C","E01012137","Total",549,218,29,189,153,59,166,35,131
"2011","Redcar and Cleveland 016D","E01012181","Total",713,275,52,223,245,99,207,36,171
"2011","Redcar and Cleveland 018A","E01012117","Total",782,385,29,356,135,53,270,31,239
"2011","Redcar and Cleveland 018B","E01012118","Total",656,255,34,221,158,64,191,26,165
"2011","Redcar and Cleveland 018C","E01012119","Total",880,325,57,268,317,108,258,50,208
"2011","Redcar and Cleveland 018D","E01012121","Total",615,316,38,278,167,58,230,30,200
"2011","Redcar and Cleveland 019E","E01032548","Total",715,374,9,365,142,45,188,22,166
"2011","Redcar and Cleveland 019F","E01032549","Total",659,233,8,225,175,59,157,17,140
"2011","Redcar and Cleveland 019G","E01033472","Total",1063,312,51,261,357,147,230,40,190
"2011","Redcar and Cleveland 020A","E01012120","Total",631,313,5,308,115,32,173,15,158
"2011","Redcar and Cleveland 020B","E01012124","Total",620,244,7,237,141,43,123,14,109
"2011","Redcar and Cleveland 020C","E01012182","Total",598,241,3,238,125,29,151,16,135
"2011","Redcar and Cleveland 020D","E01012183","Total",620,158,5,153,199,69,117,23,94
"2011","Redcar and Cleveland 021A","E01012148","Total",672,318,63,255,195,66,222,44,178
"2011","Redcar and Cleveland 021B","E01012150","Total",711,355,74,281,229,77,247,45,202
"2011","Redcar and Cleveland 021C","E01012151","Total",650,293,14,279,149,48,184,23,161
"2011","Redcar and Cleveland 021D","E01012152","Total",684,269,19,250,162,52,197,21,176
"2011","Redcar and Cleveland 021E","E01032594","Total",637,308,16,292,136,43,196,20,176
"2011","Redcar and Cleveland 022A","E01012146","Total",516,198,8,190,117,40,143,17,126
"2011","Redcar and Cleveland 022B","E01012167","Total",590,182,33,149,204,72,159,32,127
"2011","Redcar and Cleveland 022C","E01012168","Total",819,345,64,281,281,115,255,45,210
"2011","Redcar and Cleveland 022D","E01012170","Total",568,329,105,224,206,94,187,40,147
"2011","Redcar and Cleveland 022E","E01012173","Total",518,220,14,206,118,34,167,21,146
"2011","Redcar and Cleveland 022F","E01012174","Total",481,211,7,204,115,35,145,21,124
"2011","Redcar and Cleveland 022G","E01033470","Total",809,382,73,309,240,85,277,55,222
"2011","Stockton-on-Tees 001A","E01012242","Total",627,221,9,212,164,61,156,23,133
"2011","Stockton-on-Tees 001B","E01012243","Total",665,169,15,154,208,75,120,18,102
"2011","Stockton-on-Tees 001C","E01012244","Total",620,175,8,167,166,50,149,26,123
"2011","Stockton-on-Tees 001D","E01012246","Total",574,107,6,101,179,55,105,28,77
"2011","Stockton-on-Tees 001E","E01012296","Total",598,224,8,216,152,64,174,25,149
"2011","Stockton-on-Tees 001F","E01012297","Total",978,198,14,184,391,123,200,60,140
"2011","Stockton-on-Tees 002A","E01012197","Total",809,287,86,201,349,149,222,63,159
"2011","Stockton-on-Tees 002B","E01012256","Total",630,304,10,294,103,30,195,14,181
"2011","Stockton-on-Tees 002C","E01012257","Total",632,265,12,253,152,42,207,31,176
"2011","Stockton-on-Tees 002D","E01012275","Total",625,250,47,203,217,88,191,38,153
"2011","Stockton-on-Tees 002E","E01012276","Total",839,418,27,391,159,64,318,37,281
"2011","Stockton-on-Tees 002F","E01012277","Total",704,281,49,232,243,96,207,47,160
"2011","Stockton-on-Tees 003A","E01012196","Total",674,246,48,198,236,89,210,46,164
"2011","Stockton-on-Tees 003B","E01012198","Total",610,265,68,197,220,94,189,49,140
"2011","Stockton-on-Tees 003C","E01012214","Total",643,227,60,167,248,111,194,54,140
"2011","Stockton-on-Tees 003D","E01012215","Total",498,222,69,153,185,82,160,45,115
"2011","Stockton-on-Tees 003E","E01012216","Total",519,195,49,146,195,73,145,33,112
"2011","Stockton-on-Tees 003F","E01012245","Total",729,371,70,301,206,101,231,35,196
"2011","Stockton-on-Tees 004A","E01012278","Total",501,162,38,124,191,73,134,34,100
"2011","Stockton-on-Tees 004B","E01012279","Total",637,127,23,104,261,111,146,37,109
"2011","Stockton-on-Tees 004C","E01012280","Total",649,246,22,224,192,75,192,37,155
"2011","Stockton-on-Tees 004D","E01012281","Total",642,335,49,286,173,75,257,43,214
"2011","Stockton-on-Tees 005A","E01012255","Total",646,331,6,325,119,40,190,15,175
"2011","Stockton-on-Tees 005B","E01012269","Total",668,194,5,189,185,55,147,17,130
"2011","Stockton-on-Tees 005D","E01012294","Total",481,144,4,140,134,42,124,17,107
"2011","Stockton-on-Tees 005E","E01012295","Total",495,148,21,127,171,64,129,29,100
"2011","Stockton-on-Tees 005F","E01033476","Total",597,87,10,77,255,98,85,26,59
"2011","Stockton-on-Tees 005G","E01033480","Total",630,155,5,150,175,44,114,21,93
"2011","Stockton-on-Tees 006A","E01012210","Total",640,187,6,181,164,71,153,30,123
"2011","Stockton-on-Tees 006B","E01012211","Total",750,205,15,190,264,95,147,35,112
"2011","Stockton-on-Tees 006C","E01012212","Total",683,233,10,223,140,52,163,22,141
"2011","Stockton-on-Tees 006D","E01012213","Total",735,418,14,404,102,33,280,17,263
"2011","Stockton-on-Tees 007A","E01012192","Total",748,302,28,274,182,70,226,31,195
"2011","Stockton-on-Tees 007B","E01012193","Total",605,215,58,157,229,98,152,35,117
"2011","Stockton-on-Tees 007C","E01012260","Total",814,316,10,306,146,65,230,11,219
"2011","Stockton-on-Tees 007D","E01012261","Total",703,202,15,187,197,81,173,37,136
"2011","Stockton-on-Tees 008A","E01012247","Total",508,197,43,154,182,76,184,47,137
"2011","Stockton-on-Tees 008B","E01012249","Total",640,270,47,223,211,98,241,40,201
"2011","Stockton-on-Tees 008C","E01012271","Total",575,244,85,159,254,124,183,59,124
"2011","Stockton-on-Tees 008D","E01012272","Total",493,214,6,208,89,22,153,15,138
"2011","Stockton-on-Tees 008E","E01012273","Total",642,263,86,177,274,113,210,65,145
"2011","Stockton-on-Tees 008F","E01012274","Total",500,182,52,130,207,74,159,45,114
"2011","Stockton-on-Tees 009D","E01012248","Total",647,290,37,253,174,62,207,28,179
"2011","Stockton-on-Tees 009E","E01012250","Total",635,347,56,291,186,84,250,48,202
"2011","Stockton-on-Tees 009F","E01032542","Total",446,193,66,127,191,105,151,41,110
"2011","Stockton-on-Tees 009G","E01032543","Total",877,408,121,287,354,159,282,64,218
"2011","Stockton-on-Tees 009H","E01032544","Total",751,174,48,126,346,176,163,57,106
"2011","Stockton-on-Tees 010A","E01012194","Total",647,213,65,148,237,125,164,44,120
"2011","Stockton-on-Tees 010B","E01012195","Total",684,353,106,247,265,131,240,66,174
"2011","Stockton-on-Tees 010C","E01012258","Total",529,259,45,214,147,60,190,33,157
"2011","Stockton-on-Tees 010D","E01012259","Total",776,245,26,219,223,87,202,47,155
"2011","Stockton-on-Tees 010E","E01012268","Total",755,348,79,269,234,113,241,56,185
"2011","Stockton-on-Tees 011A","E01012187","Total",538,111,8,103,174,72,143,29,114
"2011","Stockton-on-Tees 011B","E01012188","Total",491,110,10,100,145,47,109,13,96
"2011","Stockton-on-Tees 011C","E01012189","Total",631,260,5,255,128,43,200,20,180
"2011","Stockton-on-Tees 011D","E01012205","Total",634,243,11,232,148,52,188,28,160
"2011","Stockton-on-Tees 012A","E01012219","Total",693,197,28,169,226,72,176,34,142
"2011","Stockton-on-Tees 012B","E01012251","Total",648,226,76,150,279,127,187,62,125
"2011","Stockton-on-Tees 012C","E01012252","Total",634,345,134,211,288,137,213,65,148
"2011","Stockton-on-Tees 012D","E01012253","Total",484,172,20,152,176,55,191,36,155
"2011","Stockton-on-Tees 012E","E01012254","Total",644,291,90,201,227,96,163,43,120
"2011","Stockton-on-Tees 013A","E01012204","Total",625,289,5,284,95,24,197,19,178
"2011","Stockton-on-Tees 013B","E01012206","Total",716,369,22,347,137,51,281,24,257
"2011","Stockton-on-Tees 013C","E01012207","Total",782,294,12,282,241,94,225,40,185
"2011","Stockton-on-Tees 013D","E01012208","Total",642,201,4,197,200,56,142,26,116
"2011","Stockton-on-Tees 014A","E01012262","Total",810,297,77,220,278,146,233,79,154
"2011","Stockton-on-Tees 014C","E01012264","Total",1036,292,45,247,303,125,272,74,198
"2011","Stockton-on-Tees 014E","E01012266","Total",1149,683,130,553,317,145,404,60,344
"2011","Stockton-on-Tees 014F","E01012267","Total",855,499,73,426,175,83,328,38,290
"2011","Stockton-on-Tees 014G","E01033477","Total",1136,575,69,506,251,137,370,57,313
"2011","Stockton-on-Tees 015A","E01012190","Total",632,167,8,159,170,54,143,26,117
"2011","Stockton-on-Tees 015B","E01012191","Total",713,339,18,321,173,58,252,37,215
"2011","Stockton-on-Tees 015C","E01012224","Total",769,318,14,304,191,72,204,31,173
"2011","Stockton-on-Tees 015D","E01012225","Total",647,261,11,250,167,37,180,29,151
"2011","Stockton-on-Tees 015E","E01012226","Total",600,213,4,209,138,38,146,15,131
"2011","Stockton-on-Tees 016A","E01012209","Total",676,224,15,209,207,57,179,40,139
"2011","Stockton-on-Tees 016B","E01012217","Total",750,323,65,258,206,100,206,38,168
"2011","Stockton-on-Tees 016C","E01012218","Total",615,215,22,193,194,86,166,37,129
"2011","Stockton-on-Tees 016D","E01012223","Total",629,234,8,226,170,60,138,19,119
"2011","Stockton-on-Tees 017A","E01012286","Total",663,313,91,222,216,104,183,36,147
"2011","Stockton-on-Tees 017B","E01012287","Total",945,384,46,338,143,62,242,24,218
"2011","Stockton-on-Tees 017C","E01012288","Total",621,275,65,210,222,115,203,39,164
"2011","Stockton-on-Tees 017D","E01012289","Total",510,204,38,166,161,52,146,30,116
"2011","Stockton-on-Tees 018A","E01012238","Total",641,265,48,217,218,75,212,42,170
"2011","Stockton-on-Tees 018B","E01012239","Total",783,251,82,169,342,161,195,56,139
"2011","Stockton-on-Tees 018C","E01012240","Total",763,259,38,221,222,91,216,39,177
"2011","Stockton-on-Tees 018D","E01012241","Total",611,172,9,163,188,67,135,26,109
"2011","Stockton-on-Tees 019A","E01012290","Total",829,393,13,380,167,74,265,31,234
"2011","Stockton-on-Tees 019B","E01012291","Total",698,275,64,211,264,125,214,57,157
"2011","Stockton-on-Tees 019C","E01012292","Total",1058,393,39,354,319,155,315,49,266
"2011","Stockton-on-Tees 020A","E01012282","Total",539,215,52,163,194,72,153,34,119
"2011","Stockton-on-Tees 020B","E01012283","Total",547,234,60,174,199,79,182,35,147
"2011","Stockton-on-Tees 020C","E01012284","Total",649,331,71,260,184,77,239,50,189
"2011","Stockton-on-Tees 020D","E01012285","Total",620,275,28,247,129,59,203,24,179
"2011","Stockton-on-Tees 021A","E01012199","Total",614,204,10,194,159,49,100,17,83
"2011","Stockton-on-Tees 021B","E01012200","Total",889,306,19,287,231,85,201,23,178
"2011","Stockton-on-Tees 021C","E01012201","Total",737,280,6,274,227,82,160,20,140
"2011","Stockton-on-Tees 021D","E01012202","Total",624,193,19,174,181,74,153,23,130
"2011","Stockton-on-Tees 021E","E01012203","Total",687,133,11,122,282,98,113,28,85
"2011","Stockton-on-Tees 021F","E01012270","Total",586,196,18,178,180,65,152,27,125
"2011","Stockton-on-Tees 022A","E01012228","Total",529,90,7,83,221,67,89,29,60
"2011","Stockton-on-Tees 022B","E01012230","Total",599,104,15,89,247,79,99,29,70
"2011","Stockton-on-Tees 022C","E01012233","Total",564,156,11,145,187,61,115,24,91
"2011","Stockton-on-Tees 022D","E01012236","Total",538,124,8,116,175,71,104,28,76
"2011","Stockton-on-Tees 022E","E01012237","Total",496,99,6,93,184,50,92,23,69
"2011","Stockton-on-Tees 023A","E01012227","Total",590,65,14,51,283,116,99,38,61
"2011","Stockton-on-Tees 023C","E01012231","Total",685,64,10,54,385,140,72,37,35
"2011","Stockton-on-Tees 023D","E01012232","Total",545,68,6,62,236,82,83,27,56
"2011","Stockton-on-Tees 023E","E01012234","Total",580,77,8,69,280,90,96,38,58
"2011","Stockton-on-Tees 023F","E01033474","Total",619,41,16,25,295,159,60,30,30
"2011","Stockton-on-Tees 023G","E01033475","Total",575,30,13,17,365,173,61,32,29
"2011","Stockton-on-Tees 023H","E01033478","Total",582,35,5,30,369,138,71,37,34
"2011","Stockton-on-Tees 023I","E01033479","Total",616,83,13,70,317,138,89,36,53
"2011","Stockton-on-Tees 024A","E01012235","Total",461,162,1,161,105,28,103,17,86
"2011","Stockton-on-Tees 024B","E01012298","Total",544,164,4,160,155,43,97,14,83
"2011","Stockton-on-Tees 024C","E01012299","Total",736,168,8,160,170,71,119,19,100
"2011","Stockton-on-Tees 024D","E01012300","Total",747,356,20,336,174,68,244,23,221
"2011","Stockton-on-Tees 024E","E01012301","Total",564,133,4,129,166,49,93,14,79
"2011","Stockton-on-Tees 024F","E01012302","Total",487,123,7,116,143,40,97,23,74
"2011","Stockton-on-Tees 024G","E01012303","Total",606,151,8,143,151,58,111,20,91
"2011","Gateshead 001A","E01008246","Total",633,225,30,195,216,77,186,30,156
"2011","Gateshead 001B","E01008247","Total",761,358,36,322,194,72,258,37,221
"2011","Gateshead 001C","E01008248","Total",724,146,9,137,222,74,142,23,119
"2011","Gateshead 001D","E01008249","Total",721,341,7,334,119,47,218,20,198
"2011","Gateshead 001E","E01008250","Total",592,189,22,167,201,76,154,37,117
"2011","Gateshead 002A","E01008195","Total",881,264,39,225,277,119,254,49,205
"2011","Gateshead 002B","E01008197","Total",695,190,6,184,158,63,180,26,154
"2011","Gateshead 002C","E01008198","Total",600,242,29,213,179,75,182,42,140
"2011","Gateshead 002D","E01008199","Total",636,189,15,174,150,58,142,14,128
"2011","Gateshead 002E","E01008200","Total",558,161,13,148,166,40,132,21,111
"2011","Gateshead 002F","E01008245","Total",632,241,7,234,167,51,178,21,157
"2011","Gateshead 003A","E01008214","Total",746,382,109,273,255,114,266,63,203
"2011","Gateshead 003B","E01008215","Total",823,361,68,293,181,86,272,36,236
"2011","Gateshead 003C","E01008243","Total",733,290,18,272,146,60,230,31,199
"2011","Gateshead 003D","E01008244","Total",1009,280,50,230,261,126,253,42,211
"2011","Gateshead 004A","E01008178","Total",687,165,62,103,255,127,139,46,93
"2011","Gateshead 004B","E01008180","Total",636,292,74,218,234,96,216,57,159
"2011","Gateshead 004C","E01008182","Total",744,276,42,234,225,100,210,33,177
"2011","Gateshead 004D","E01008277","Total",668,320,30,290,173,63,231,36,195
"2011","Gateshead 004E","E01008280","Total",877,363,42,321,228,85,299,43,256
"2011","Gateshead 005A","E01008177","Total",609,205,31,174,155,66,156,21,135
"2011","Gateshead 005B","E01008179","Total",519,123,15,108,171,55,112,26,86
"2011","Gateshead 005C","E01008181","Total",644,237,20,217,169,66,181,26,155
"2011","Gateshead 005D","E01008276","Total",741,328,29,299,165,67,257,19,238
"2011","Gateshead 005E","E01008279","Total",655,266,7,259,118,31,210,19,191
"2011","Gateshead 007A","E01008209","Total",990,324,52,272,255,120,281,51,230
"2011","Gateshead 007B","E01008210","Total",617,230,51,179,197,82,183,37,146
"2011","Gateshead 007C","E01008258","Total",1154,404,112,292,307,171,289,55,234
"2011","Gateshead 007D","E01008259","Total",1038,491,53,438,204,98,354,36,318
"2011","Gateshead 008A","E01008167","Total",721,229,51,178,184,95,174,35,139
"2011","Gateshead 008B","E01008169","Total",416,98,29,69,201,124,111,42,69
"2011","Gateshead 008C","E01008170","Total",986,395,52,343,218,96,315,46,269
"2011","Gateshead 008D","E01008171","Total",559,216,45,171,146,90,145,18,127
"2011","Gateshead 008E","E01008257","Total",669,331,41,290,154,61,276,43,233
"2011","Gateshead 009A","E01008262","Total",789,228,42,186,231,117,194,40,154
"2011","Gateshead 009B","E01008263","Total",672,237,48,189,241,115,188,44,144
"2011","Gateshead 009C","E01008264","Total",599,222,4,218,164,57,139,17,122
"2011","Gateshead 009D","E01008265","Total",622,218,38,180,216,81,195,50,145
"2011","Gateshead 009E","E01008266","Total",643,272,8,264,142,63,199,22,177
"2011","Gateshead 010A","E01008251","Total",913,255,37,218,168,81,226,31,195
"2011","Gateshead 010B","E01008252","Total",729,228,38,190,194,118,200,30,170
"2011","Gateshead 010C","E01008253","Total",818,234,54,180,199,117,187,38,149
"2011","Gateshead 010D","E01008254","Total",663,224,46,178,165,79,175,33,142
"2011","Gateshead 010E","E01008255","Total",753,293,31,262,210,73,215,35,180
"2011","Gateshead 011A","E01008165","Total",594,235,61,174,179,67,199,51,148
"2011","Gateshead 011B","E01008201","Total",629,326,100,226,246,86,245,76,169
"2011","Gateshead 011C","E01008202","Total",803,230,54,176,291,118,202,49,153
"2011","Gateshead 011D","E01008204","Total",739,370,88,282,223,97,274,56,218
"2011","Gateshead 012A","E01008212","Total",694,315,57,258,179,75,232,31,201
"2011","Gateshead 012B","E01008213","Total",645,276,33,243,175,52,237,35,202
"2011","Gateshead 012C","E01008216","Total",743,382,47,335,164,78,310,42,268
"2011","Gateshead 012D","E01008228","Total",551,243,43,200,155,60,201,37,164
"2011","Gateshead 013A","E01008206","Total",741,247,20,227,225,82,223,39,184
"2011","Gateshead 013B","E01008207","Total",591,201,14,187,156,51,126,21,105
"2011","Gateshead 013C","E01008208","Total",739,279,32,247,214,72,242,43,199
"2011","Gateshead 013D","E01008211","Total",743,247,36,211,201,70,220,37,183
"2011","Gateshead 014A","E01008283","Total",604,170,4,166,114,32,142,17,125
"2011","Gateshead 014B","E01008284","Total",617,223,26,197,186,70,171,25,146
"2011","Gateshead 014C","E01008286","Total",661,277,39,238,187,71,223,39,184
"2011","Gateshead 014D","E01008287","Total",820,184,12,172,320,136,199,33,166
"2011","Gateshead 015A","E01008231","Total",689,303,67,236,233,86,236,52,184
"2011","Gateshead 015B","E01008240","Total",643,273,39,234,193,82,219,39,180
"2011","Gateshead 015C","E01008241","Total",710,314,48,266,204,74,235,40,195
"2011","Gateshead 015D","E01008242","Total",701,283,54,229,250,104,260,57,203
"2011","Gateshead 015E","E01008281","Total",657,299,46,253,201,74,267,56,211
"2011","Gateshead 015F","E01008282","Total",665,286,39,247,207,82,242,34,208
"2011","Gateshead 016A","E01008219","Total",725,245,30,215,224,78,210,43,167
"2011","Gateshead 016B","E01008235","Total",630,197,10,187,166,56,158,27,131
"2011","Gateshead 016C","E01008236","Total",761,310,16,294,151,69,238,16,222
"2011","Gateshead 016D","E01008237","Total",593,162,3,159,212,76,128,20,108
"2011","Gateshead 016E","E01008238","Total",677,169,6,163,203,83,121,12,109
"2011","Gateshead 017A","E01008267","Total",700,369,13,356,149,48,243,23,220
"2011","Gateshead 017B","E01008269","Total",645,259,4,255,157,51,168,18,150
"2011","Gateshead 017C","E01008270","Total",603,291,6,285,116,42,159,16,143
"2011","Gateshead 017D","E01008271","Total",606,201,5,196,148,43,142,18,124
"2011","Gateshead 017E","E01008275","Total",648,248,5,243,160,43,143,21,122
"2011","Gateshead 018A","E01008229","Total",635,304,12,292,118,34,209,25,184
"2011","Gateshead 018B","E01008230","Total",630,248,20,228,175,62,210,36,174
"2011","Gateshead 018C","E01008232","Total",589,262,56,206,206,93,192,39,153
"2011","Gateshead 018D","E01008233","Total",606,178,8,170,138,35,137,21,116
"2011","Gateshead 018E","E01008285","Total",664,301,62,239,198,69,245,48,197
"2011","Gateshead 019A","E01008256","Total",775,258,26,232,212,78,235,33,202
"2011","Gateshead 019B","E01008260","Total",629,134,7,127,205,63,151,28,123
"2011","Gateshead 019C","E01008261","Total",642,266,44,222,188,78,211,40,171
"2011","Gateshead 019D","E01008268","Total",628,198,20,178,188,54,160,32,128
"2011","Gateshead 019E","E01008272","Total",651,287,7,280,143,46,192,18,174
"2011","Gateshead 019F","E01008273","Total",628,160,11,149,190,79,151,23,128
"2011","Gateshead 019G","E01008274","Total",632,215,37,178,211,88,188,44,144
"2011","Gateshead 020A","E01008193","Total",493,180,5,175,137,36,133,18,115
"2011","Gateshead 020B","E01008194","Total",602,224,3,221,149,41,163,14,149
"2011","Gateshead 020C","E01008234","Total",1034,395,6,389,212,69,287,33,254
"2011","Gateshead 020D","E01008239","Total",634,175,9,166,176,66,159,24,135
"2011","Gateshead 021A","E01008218","Total",766,393,38,355,179,53,320,39,281
"2011","Gateshead 021B","E01008220","Total",576,304,66,238,185,78,218,41,177
"2011","Gateshead 021C","E01008221","Total",718,301,63,238,252,101,259,60,199
"2011","Gateshead 021D","E01008225","Total",800,338,25,313,174,45,261,42,219
"2011","Gateshead 021E","E01008227","Total",662,303,125,178,303,132,246,88,158
"2011","Gateshead 022A","E01008184","Total",641,273,4,269,133,31,178,20,158
"2011","Gateshead 022B","E01008185","Total",581,273,42,231,185,69,213,38,175
"2011","Gateshead 022C","E01008188","Total",610,225,11,214,185,47,169,33,136
"2011","Gateshead 022D","E01008278","Total",603,229,5,224,139,44,151,20,131
"2011","Gateshead 023A","E01008189","Total",645,281,29,252,155,48,249,39,210
"2011","Gateshead 023B","E01008190","Total",560,246,6,240,147,40,158,23,135
"2011","Gateshead 023C","E01008191","Total",767,351,37,314,179,58,291,47,244
"2011","Gateshead 023D","E01008192","Total",677,287,21,266,162,48,220,32,188
"2011","Gateshead 023E","E01008217","Total",731,322,39,283,196,64,233,26,207
"2011","Gateshead 024A","E01008183","Total",650,242,49,193,208,92,203,41,162
"2011","Gateshead 024B","E01008186","Total",938,371,63,308,237,103,298,51,247
"2011","Gateshead 024C","E01008187","Total",789,369,35,334,193,74,295,38,257
"2011","Gateshead 024D","E01008196","Total",823,306,29,277,205,66,235,31,204
"2011","Gateshead 025A","E01008222","Total",654,228,34,194,210,84,204,36,168
"2011","Gateshead 025B","E01008223","Total",800,362,85,277,272,109,288,59,229
"2011","Gateshead 025C","E01008224","Total",801,322,21,301,206,67,252,39,213
"2011","Gateshead 025D","E01008226","Total",669,272,37,235,175,59,213,36,177
"2011","Gateshead 026A","E01008172","Total",779,373,20,353,181,51,267,38,229
"2011","Gateshead 026B","E01008173","Total",615,239,69,170,241,101,198,52,146
"2011","Gateshead 026C","E01008174","Total",903,365,41,324,277,110,284,36,248
"2011","Gateshead 026D","E01008175","Total",681,216,26,190,172,73,196,32,164
"2011","Gateshead 026E","E01008176","Total",621,207,23,184,171,56,171,29,142
"2011","Gateshead 027A","E01008162","Total",1191,343,52,291,241,118,260,38,222
"2011","Gateshead 027B","E01008164","Total",638,244,44,200,125,73,174,27,147
"2011","Gateshead 027C","E01008166","Total",1023,511,29,482,72,44,336,15,321
"2011","Gateshead 027D","E01008168","Total",1097,391,28,363,105,48,264,20,244
"2011","Gateshead 028A","E01008163","Total",678,233,46,187,229,121,196,40,156
"2011","Gateshead 028B","E01008203","Total",877,314,55,259,194,107,240,34,206
"2011","Gateshead 028C","E01008205","Total",676,253,8,245,167,72,198,19,179
"2011","Newcastle upon Tyne 001A","E01008294","Total",618,148,26,122,181,84,115,23,92
"2011","Newcastle upon Tyne 001B","E01008306","Total",720,311,27,284,178,53,219,31,188
"2011","Newcastle upon Tyne 001C","E01008307","Total",500,196,25,171,128,48,140,21,119
"2011","Newcastle upon Tyne 001D","E01008308","Total",616,203,24,179,179,72,166,32,134
"2011","Newcastle upon Tyne 001E","E01008311","Total",689,153,17,136,226,96,124,27,97
"2011","Newcastle upon Tyne 001F","E01008312","Total",503,127,40,87,183,73,101,35,66
"2011","Newcastle upon Tyne 001G","E01008313","Total",476,110,13,97,156,69,108,29,79
"2011","Newcastle upon Tyne 002A","E01008309","Total",728,289,6,283,241,85,175,34,141
"2011","Newcastle upon Tyne 002C","E01008352","Total",612,205,24,181,191,75,170,29,141
"2011","Newcastle upon Tyne 002D","E01008357","Total",689,254,7,247,179,50,161,25,136
"2011","Newcastle upon Tyne 002E","E01008358","Total",759,269,18,251,161,73,186,19,167
"2011","Newcastle upon Tyne 002F","E01033550","Total",694,94,9,85,380,184,96,38,58
"2011","Newcastle upon Tyne 002G","E01033551","Total",736,249,3,246,200,73,171,27,144
"2011","Newcastle upon Tyne 003A","E01008336","Total",674,332,45,287,160,72,239,31,208
"2011","Newcastle upon Tyne 003B","E01008337","Total",578,253,62,191,204,81,195,51,144
"2011","Newcastle upon Tyne 003C","E01008338","Total",498,153,37,116,180,80,126,31,95
"2011","Newcastle upon Tyne 003D","E01008339","Total",663,279,54,225,180,49,254,52,202
"2011","Newcastle upon Tyne 003E","E01008340","Total",628,300,98,202,248,112,221,53,168
"2011","Newcastle upon Tyne 003F","E01008341","Total",618,240,42,198,189,65,215,42,173
"2011","Newcastle upon Tyne 003G","E01008342","Total",722,310,6,304,121,41,218,22,196
"2011","Newcastle upon Tyne 004A","E01008293","Total",639,174,24,150,189,70,154,24,130
"2011","Newcastle upon Tyne 004B","E01008456","Total",674,306,54,252,214,67,248,39,209
"2011","Newcastle upon Tyne 004C","E01008457","Total",787,352,58,294,197,89,320,55,265
"2011","Newcastle upon Tyne 004D","E01008458","Total",700,253,11,242,175,68,183,20,163
"2011","Newcastle upon Tyne 004E","E01008459","Total",724,346,148,198,340,166,236,80,156
"2011","Newcastle upon Tyne 004F","E01008460","Total",605,269,71,198,220,79,223,65,158
"2011","Newcastle upon Tyne 005A","E01008351","Total",620,218,21,197,175,73,160,27,133
"2011","Newcastle upon Tyne 005B","E01008354","Total",767,242,25,217,200,94,186,26,160
"2011","Newcastle upon Tyne 005C","E01008418","Total",869,234,6,228,223,77,167,23,144
"2011","Newcastle upon Tyne 005D","E01008420","Total",555,161,8,153,155,47,100,20,80
"2011","Newcastle upon Tyne 005E","E01008422","Total",644,163,5,158,178,68,120,28,92
"2011","Newcastle upon Tyne 005F","E01008424","Total",759,235,30,205,128,78,141,13,128
"2011","Newcastle upon Tyne 006A","E01008353","Total",696,307,42,265,193,80,217,34,183
"2011","Newcastle upon Tyne 006B","E01008355","Total",745,254,7,247,167,69,189,14,175
"2011","Newcastle upon Tyne 006C","E01008356","Total",587,193,18,175,171,52,146,26,120
"2011","Newcastle upon Tyne 006D","E01008378","Total",535,170,9,161,182,63,124,23,101
"2011","Newcastle upon Tyne 006E","E01008419","Total",632,113,7,106,197,79,91,14,77
"2011","Newcastle upon Tyne 006F","E01008421","Total",664,162,8,154,189,84,127,16,111
"2011","Newcastle upon Tyne 006G","E01008423","Total",530,155,6,149,174,52,119,22,97
"2011","Newcastle upon Tyne 007A","E01008317","Total",593,176,12,164,207,78,146,25,121
"2011","Newcastle upon Tyne 007B","E01008319","Total",685,114,3,111,283,97,103,29,74
"2011","Newcastle upon Tyne 007C","E01008320","Total",611,202,13,189,166,57,172,30,142
"2011","Newcastle upon Tyne 007D","E01008321","Total",725,200,9,191,199,75,146,25,121
"2011","Newcastle upon Tyne 007E","E01008322","Total",585,154,8,146,201,66,152,42,110
"2011","Newcastle upon Tyne 007F","E01008323","Total",702,166,13,153,153,71,168,29,139
"2011","Newcastle upon Tyne 008A","E01008295","Total",604,243,91,152,270,130,207,68,139
"2011","Newcastle upon Tyne 008B","E01008374","Total",632,194,28,166,198,81,164,33,131
"2011","Newcastle upon Tyne 008C","E01008375","Total",721,316,55,261,199,93,232,41,191
"2011","Newcastle upon Tyne 008D","E01008376","Total",468,126,9,117,149,59,121,21,100
"2011","Newcastle upon Tyne 008E","E01008377","Total",845,244,95,149,346,152,187,52,135
"2011","Newcastle upon Tyne 008F","E01008379","Total",703,337,38,299,174,85,226,33,193
"2011","Newcastle upon Tyne 008G","E01008380","Total",739,399,123,276,274,145,265,59,206
"2011","Newcastle upon Tyne 011A","E01008296","Total",690,289,29,260,148,56,248,24,224
"2011","Newcastle upon Tyne 011B","E01008297","Total",626,335,47,288,161,70,260,31,229
"2011","Newcastle upon Tyne 011C","E01008298","Total",584,218,35,183,221,97,195,44,151
"2011","Newcastle upon Tyne 011D","E01008299","Total",527,224,53,171,192,67,196,45,151
"2011","Newcastle upon Tyne 012A","E01008314","Total",473,151,9,142,135,51,115,25,90
"2011","Newcastle upon Tyne 012B","E01008315","Total",627,195,23,172,193,70,132,27,105
"2011","Newcastle upon Tyne 012C","E01008316","Total",650,168,5,163,197,62,137,24,113
"2011","Newcastle upon Tyne 012D","E01008318","Total",631,257,23,234,163,61,223,41,182
"2011","Newcastle upon Tyne 012E","E01008363","Total",806,284,14,270,125,54,216,15,201
"2011","Newcastle upon Tyne 012F","E01008365","Total",572,111,11,100,225,83,118,35,83
"2011","Newcastle upon Tyne 013A","E01008366","Total",636,195,2,193,70,28,78,11,67
"2011","Newcastle upon Tyne 013B","E01008369","Total",680,206,5,201,81,26,78,9,69
"2011","Newcastle upon Tyne 013C","E01008371","Total",572,205,5,200,149,39,124,13,111
"2011","Newcastle upon Tyne 013D","E01008372","Total",728,262,10,252,44,18,91,5,86
"2011","Newcastle upon Tyne 013E","E01008373","Total",727,227,10,217,36,16,66,7,59
"2011","Newcastle upon Tyne 014A","E01008400","Total",703,371,39,332,150,72,264,30,234
"2011","Newcastle upon Tyne 014B","E01008401","Total",607,280,50,230,192,52,217,51,166
"2011","Newcastle upon Tyne 014C","E01008402","Total",654,233,30,203,180,78,194,32,162
"2011","Newcastle upon Tyne 014D","E01008403","Total",632,260,13,247,145,43,187,25,162
"2011","Newcastle upon Tyne 014E","E01008404","Total",804,230,34,196,210,112,212,36,176
"2011","Newcastle upon Tyne 014F","E01008405","Total",639,245,43,202,204,83,197,33,164
"2011","Newcastle upon Tyne 014G","E01008443","Total",608,194,4,190,177,52,150,32,118
"2011","Newcastle upon Tyne 015A","E01008324","Total",547,260,46,214,178,82,183,46,137
"2011","Newcastle upon Tyne 015B","E01008325","Total",663,337,50,287,170,79,253,33,220
"2011","Newcastle upon Tyne 015C","E01008326","Total",582,171,10,161,188,58,151,28,123
"2011","Newcastle upon Tyne 015D","E01008327","Total",586,306,76,230,193,81,231,48,183
"2011","Newcastle upon Tyne 015E","E01008328","Total",576,275,2,273,112,27,194,16,178
"2011","Newcastle upon Tyne 015F","E01008329","Total",624,216,24,192,181,69,181,29,152
"2011","Newcastle upon Tyne 015G","E01008330","Total",617,283,62,221,218,103,198,31,167
"2011","Newcastle upon Tyne 016A","E01008300","Total",665,261,72,189,257,128,190,46,144
"2011","Newcastle upon Tyne 016B","E01008450","Total",574,248,77,171,241,93,183,56,127
"2011","Newcastle upon Tyne 016C","E01008451","Total",839,268,64,204,232,115,182,39,143
"2011","Newcastle upon Tyne 016D","E01008452","Total",497,151,13,138,176,60,138,39,99
"2011","Newcastle upon Tyne 017A","E01008367","Total",785,191,2,189,68,22,95,7,88
"2011","Newcastle upon Tyne 017B","E01008368","Total",554,201,3,198,48,18,68,6,62
"2011","Newcastle upon Tyne 017C","E01008370","Total",822,308,4,304,75,31,150,9,141
"2011","Newcastle upon Tyne 017D","E01008409","Total",718,202,8,194,85,31,143,17,126
"2011","Newcastle upon Tyne 017E","E01008411","Total",696,239,9,230,41,12,119,10,109
"2011","Newcastle upon Tyne 018A","E01008303","Total",1060,608,56,552,155,62,432,34,398
"2011","Newcastle upon Tyne 018B","E01008359","Total",577,145,14,131,84,30,121,11,110
"2011","Newcastle upon Tyne 018C","E01008360","Total",768,160,13,147,79,43,92,11,81
"2011","Newcastle upon Tyne 018D","E01008361","Total",686,186,32,154,96,25,122,25,97
"2011","Newcastle upon Tyne 018E","E01008362","Total",730,236,16,220,66,26,178,9,169
"2011","Newcastle upon Tyne 018F","E01008364","Total",715,145,11,134,82,45,109,10,99
"2011","Newcastle upon Tyne 019A","E01008343","Total",606,211,17,194,204,85,158,31,127
"2011","Newcastle upon Tyne 019B","E01008344","Total",701,293,42,251,206,83,241,39,202
"2011","Newcastle upon Tyne 019C","E01008345","Total",849,416,79,337,217,105,305,37,268
"2011","Newcastle upon Tyne 019D","E01008346","Total",520,174,30,144,131,51,146,32,114
"2011","Newcastle upon Tyne 019E","E01008347","Total",552,173,23,150,163,60,166,42,124
"2011","Newcastle upon Tyne 019F","E01008348","Total",406,163,48,115,179,75,120,37,83
"2011","Newcastle upon Tyne 019G","E01008349","Total",482,138,35,103,216,112,122,42,80
"2011","Newcastle upon Tyne 019H","E01008350","Total",571,205,36,169,202,80,179,35,144
"2011","Newcastle upon Tyne 020A","E01008430","Total",614,255,49,206,163,71,198,30,168
"2011","Newcastle upon Tyne 020B","E01008431","Total",616,206,15,191,162,70,160,25,135
"2011","Newcastle upon Tyne 020C","E01008433","Total",634,300,8,292,123,26,195,16,179
"2011","Newcastle upon Tyne 020D","E01008434","Total",603,224,11,213,170,37,206,32,174
"2011","Newcastle upon Tyne 020E","E01008435","Total",629,287,71,216,229,93,225,55,170
"2011","Newcastle upon Tyne 020F","E01008436","Total",781,380,42,338,168,68,297,40,257
"2011","Newcastle upon Tyne 021A","E01008381","Total",651,157,6,151,163,57,144,21,123
"2011","Newcastle upon Tyne 021B","E01008382","Total",504,237,66,171,198,87,190,46,144
"2011","Newcastle upon Tyne 021C","E01008383","Total",646,262,62,200,235,87,202,51,151
"2011","Newcastle upon Tyne 021D","E01008384","Total",597,233,24,209,172,58,180,32,148
"2011","Newcastle upon Tyne 021E","E01008385","Total",656,231,59,172,190,97,194,34,160
"2011","Newcastle upon Tyne 021F","E01008386","Total",570,211,25,186,176,61,149,26,123
"2011","Newcastle upon Tyne 021G","E01008387","Total",624,215,21,194,147,61,162,16,146
"2011","Newcastle upon Tyne 022B","E01008396","Total",683,268,73,195,227,142,150,35,115
"2011","Newcastle upon Tyne 022C","E01008398","Total",868,439,64,375,188,106,266,32,234
"2011","Newcastle upon Tyne 022D","E01008449","Total",575,204,50,154,157,88,123,30,93
"2011","Newcastle upon Tyne 022E","E01008453","Total",569,175,22,153,184,81,141,40,101
"2011","Newcastle upon Tyne 022G","E01008455","Total",500,165,49,116,218,127,115,46,69
"2011","Newcastle upon Tyne 022H","E01033556","Total",950,366,46,320,164,99,206,37,169
"2011","Newcastle upon Tyne 023A","E01008406","Total",766,423,41,382,104,48,260,27,233
"2011","Newcastle upon Tyne 023B","E01008407","Total",758,332,15,317,58,20,178,11,167
"2011","Newcastle upon Tyne 023D","E01008410","Total",708,279,23,256,108,45,145,23,122
"2011","Newcastle upon Tyne 023E","E01008412","Total",637,142,8,134,103,56,111,18,93
"2011","Newcastle upon Tyne 023F","E01008413","Total",614,233,12,221,69,37,166,18,148
"2011","Newcastle upon Tyne 023G","E01033548","Total",677,264,23,241,59,33,130,7,123
"2011","Newcastle upon Tyne 023H","E01033553","Total",675,270,13,257,32,17,106,4,102
"2011","Newcastle upon Tyne 024A","E01008394","Total",439,226,4,222,19,10,57,3,54
"2011","Newcastle upon Tyne 024B","E01008395","Total",765,459,30,429,74,41,285,15,270
"2011","Newcastle upon Tyne 024C","E01008397","Total",531,280,3,277,15,8,97,1,96
"2011","Newcastle upon Tyne 024D","E01008399","Total",800,411,106,305,257,128,285,57,228
"2011","Newcastle upon Tyne 024E","E01008439","Total",805,407,83,324,241,118,309,63,246
"2011","Newcastle upon Tyne 024G","E01033543","Total",751,344,6,338,17,13,47,2,45
"2011","Newcastle upon Tyne 024H","E01033545","Total",760,309,9,300,22,16,126,2,124
"2011","Newcastle upon Tyne 024I","E01033554","Total",736,294,8,286,42,22,126,13,113
"2011","Newcastle upon Tyne 025B","E01008415","Total",516,215,66,149,184,83,148,30,118
"2011","Newcastle upon Tyne 025C","E01008416","Total",728,244,22,222,196,68,225,42,183
"2011","Newcastle upon Tyne 025E","E01033547","Total",949,529,126,403,308,160,401,62,339
"2011","Newcastle upon Tyne 026A","E01008301","Total",913,286,54,232,169,74,209,36,173
"2011","Newcastle upon Tyne 026B","E01008302","Total",780,363,75,288,207,102,293,47,246
"2011","Newcastle upon Tyne 026C","E01008304","Total",1078,560,89,471,200,92,388,47,341
"2011","Newcastle upon Tyne 026D","E01008305","Total",921,442,129,313,306,156,317,69,248
"2011","Newcastle upon Tyne 026E","E01008391","Total",590,287,109,178,238,87,178,59,119
"2011","Newcastle upon Tyne 026F","E01008392","Total",764,330,62,268,189,72,237,32,205
"2011","Newcastle upon Tyne 026G","E01008432","Total",629,279,33,246,154,48,208,31,177
"2011","Newcastle upon Tyne 027A","E01008288","Total",626,244,32,212,146,51,169,20,149
"2011","Newcastle upon Tyne 027B","E01008289","Total",603,293,74,219,212,81,208,44,164
"2011","Newcastle upon Tyne 027C","E01008290","Total",543,247,54,193,182,75,173,27,146
"2011","Newcastle upon Tyne 027D","E01008291","Total",901,474,133,341,335,185,300,65,235
"2011","Newcastle upon Tyne 027E","E01008292","Total",560,175,9,166,150,54,141,23,118
"2011","Newcastle upon Tyne 028A","E01008388","Total",836,431,104,327,280,129,303,65,238
"2011","Newcastle upon Tyne 028B","E01008389","Total",788,392,112,280,286,133,311,62,249
"2011","Newcastle upon Tyne 028C","E01008426","Total",640,325,119,206,279,118,235,71,164
"2011","Newcastle upon Tyne 028D","E01008429","Total",620,302,62,240,192,80,249,43,206
"2011","Newcastle upon Tyne 029A","E01008331","Total",593,256,98,158,282,153,163,56,107
"2011","Newcastle upon Tyne 029B","E01008332","Total",906,443,126,317,342,187,264,48,216
"2011","Newcastle upon Tyne 029C","E01008333","Total",536,189,55,134,212,121,141,38,103
"2011","Newcastle upon Tyne 029D","E01008334","Total",833,329,75,254,286,168,232,56,176
"2011","Newcastle upon Tyne 029E","E01008335","Total",674,228,55,173,284,173,147,43,104
"2011","Newcastle upon Tyne 029F","E01008437","Total",567,326,55,271,130,78,222,27,195
"2011","Newcastle upon Tyne 029G","E01008438","Total",850,456,63,393,173,65,341,54,287
"2011","Newcastle upon Tyne 030A","E01008390","Total",814,415,133,282,309,134,255,49,206
"2011","Newcastle upon Tyne 030B","E01008425","Total",1030,603,54,549,159,69,374,33,341
"2011","Newcastle upon Tyne 030C","E01008427","Total",581,354,82,272,150,68,201,34,167
"2011","Newcastle upon Tyne 030D","E01008428","Total",543,226,51,175,177,73,179,35,144
"2011","Newcastle upon Tyne 031A","E01008441","Total",772,348,35,313,200,67,307,47,260
"2011","Newcastle upon Tyne 031B","E01008442","Total",620,272,4,268,141,51,175,22,153
"2011","Newcastle upon Tyne 031C","E01008444","Total",664,258,16,242,179,60,154,19,135
"2011","Newcastle upon Tyne 031D","E01008445","Total",800,291,27,264,229,88,257,42,215
"2011","Newcastle upon Tyne 031E","E01008446","Total",641,303,6,297,132,40,189,16,173
"2011","Newcastle upon Tyne 031F","E01008447","Total",609,302,9,293,132,31,191,22,169
"2011","Newcastle upon Tyne 031G","E01008448","Total",633,202,5,197,144,46,143,22,121
"2011","North Tyneside 001A","E01008547","Total",601,282,4,278,147,38,153,13,140
"2011","North Tyneside 001B","E01008548","Total",528,209,2,207,120,22,109,9,100
"2011","North Tyneside 001C","E01008549","Total",681,312,2,310,146,47,191,16,175
"2011","North Tyneside 001D","E01008551","Total",661,314,3,311,151,46,200,24,176
"2011","North Tyneside 002A","E01008478","Total",775,368,47,321,195,82,263,32,231
"2011","North Tyneside 002B","E01008480","Total",716,309,43,266,183,63,254,37,217
"2011","North Tyneside 002C","E01008504","Total",646,201,12,189,177,46,131,20,111
"2011","North Tyneside 002D","E01008578","Total",602,186,27,159,189,60,164,38,126
"2011","North Tyneside 002E","E01008583","Total",616,189,38,151,210,92,158,35,123
"2011","North Tyneside 003A","E01008520","Total",573,194,12,182,179,55,152,18,134
"2011","North Tyneside 003B","E01008523","Total",483,117,8,109,197,66,83,16,67
"2011","North Tyneside 003C","E01008546","Total",604,222,2,220,188,54,141,21,120
"2011","North Tyneside 003D","E01008550","Total",634,163,7,156,234,83,144,31,113
"2011","North Tyneside 004A","E01008577","Total",660,275,19,256,159,57,216,26,190
"2011","North Tyneside 004B","E01008579","Total",726,369,7,362,126,45,213,13,200
"2011","North Tyneside 004C","E01008580","Total",607,192,12,180,174,76,140,18,122
"2011","North Tyneside 004D","E01008581","Total",656,338,6,332,100,35,224,17,207
"2011","North Tyneside 004E","E01008582","Total",634,230,28,202,162,79,186,24,162
"2011","North Tyneside 005A","E01008517","Total",598,169,7,162,247,90,130,29,101
"2011","North Tyneside 005B","E01008519","Total",659,233,19,214,173,44,170,23,147
"2011","North Tyneside 005C","E01008521","Total",689,266,10,256,151,43,175,24,151
"2011","North Tyneside 005D","E01008522","Total",658,197,6,191,199,71,132,26,106
"2011","North Tyneside 006A","E01008584","Total",668,177,24,153,178,81,140,29,111
"2011","North Tyneside 006B","E01008585","Total",651,169,20,149,224,85,155,39,116
"2011","North Tyneside 006C","E01008587","Total",638,181,11,170,130,50,164,18,146
"2011","North Tyneside 006D","E01008588","Total",676,159,18,141,197,72,138,26,112
"2011","North Tyneside 006E","E01008589","Total",562,155,8,147,203,71,142,34,108
"2011","North Tyneside 007A","E01008518","Total",783,314,9,305,184,63,254,23,231
"2011","North Tyneside 007B","E01008564","Total",633,208,7,201,154,49,155,17,138
"2011","North Tyneside 007C","E01008565","Total",874,245,52,193,296,130,223,55,168
"2011","North Tyneside 007D","E01008567","Total",587,185,46,139,223,107,161,35,126
"2011","North Tyneside 008A","E01008475","Total",687,122,9,113,238,95,119,31,88
"2011","North Tyneside 008B","E01008476","Total",793,310,56,254,238,108,257,44,213
"2011","North Tyneside 008C","E01008477","Total",659,239,58,181,267,108,196,51,145
"2011","North Tyneside 008D","E01008479","Total",647,176,4,172,136,59,147,14,133
"2011","North Tyneside 009A","E01008552","Total",748,271,18,253,189,70,219,29,190
"2011","North Tyneside 009B","E01008553","Total",831,266,21,245,240,96,209,30,179
"2011","North Tyneside 009C","E01008554","Total",674,202,31,171,247,73,177,44,133
"2011","North Tyneside 009D","E01008555","Total",671,271,33,238,236,85,223,48,175
"2011","North Tyneside 009E","E01008586","Total",674,210,10,200,199,80,172,30,142
"2011","North Tyneside 010A","E01008495","Total",736,290,7,283,207,64,187,19,168
"2011","North Tyneside 010B","E01008496","Total",775,313,12,301,149,53,244,21,223
"2011","North Tyneside 010C","E01008497","Total",651,274,7,267,162,48,162,18,144
"2011","North Tyneside 010D","E01008498","Total",718,413,5,408,131,38,251,17,234
"2011","North Tyneside 011B","E01008568","Total",683,306,27,279,152,49,240,35,205
"2011","North Tyneside 011C","E01008569","Total",647,282,50,232,217,78,216,47,169
"2011","North Tyneside 011D","E01008570","Total",599,147,15,132,185,76,132,28,104
"2011","North Tyneside 011E","E01032647","Total",667,61,13,48,275,160,75,35,40
"2011","North Tyneside 011F","E01032648","Total",657,207,46,161,239,100,200,51,149
"2011","North Tyneside 012A","E01008500","Total",728,235,12,223,187,66,197,26,171
"2011","North Tyneside 012B","E01008505","Total",805,286,10,276,195,84,207,20,187
"2011","North Tyneside 012C","E01008506","Total",613,215,32,183,171,74,197,41,156
"2011","North Tyneside 012D","E01008507","Total",626,179,11,168,191,62,170,39,131
"2011","North Tyneside 013A","E01008493","Total",641,258,4,254,178,45,184,34,150
"2011","North Tyneside 013B","E01008494","Total",734,324,22,302,184,54,233,22,211
"2011","North Tyneside 013C","E01008556","Total",849,308,9,299,232,73,211,22,189
"2011","North Tyneside 013D","E01008557","Total",617,182,6,176,202,50,123,25,98
"2011","North Tyneside 014A","E01008470","Total",643,249,21,228,168,63,210,29,181
"2011","North Tyneside 014B","E01008499","Total",727,240,23,217,247,101,211,38,173
"2011","North Tyneside 014C","E01008502","Total",697,274,50,224,208,91,222,35,187
"2011","North Tyneside 014D","E01008516","Total",649,286,9,277,131,42,179,10,169
"2011","North Tyneside 015A","E01008488","Total",647,239,46,193,193,73,190,29,161
"2011","North Tyneside 015B","E01008489","Total",752,339,77,262,275,107,246,51,195
"2011","North Tyneside 015C","E01008490","Total",768,331,20,311,153,47,227,32,195
"2011","North Tyneside 015D","E01008491","Total",622,218,45,173,242,94,191,46,145
"2011","North Tyneside 016A","E01008558","Total",855,303,7,296,139,59,221,19,202
"2011","North Tyneside 016B","E01008560","Total",857,291,13,278,167,72,193,24,169
"2011","North Tyneside 016C","E01008561","Total",879,373,33,340,154,59,282,33,249
"2011","North Tyneside 016D","E01008562","Total",639,245,10,235,168,58,177,21,156
"2011","North Tyneside 017A","E01008525","Total",724,277,6,271,167,74,198,20,178
"2011","North Tyneside 017B","E01008527","Total",745,211,16,195,145,60,169,18,151
"2011","North Tyneside 017C","E01008559","Total",786,207,5,202,164,81,194,17,177
"2011","North Tyneside 017D","E01008563","Total",594,231,11,220,178,48,125,18,107
"2011","North Tyneside 018A","E01008469","Total",757,276,7,269,135,41,192,14,178
"2011","North Tyneside 018B","E01008472","Total",673,258,6,252,183,61,167,13,154
"2011","North Tyneside 018C","E01008473","Total",527,165,12,153,146,52,125,16,109
"2011","North Tyneside 018D","E01008501","Total",772,114,16,98,347,140,136,37,99
"2011","North Tyneside 018E","E01008503","Total",771,287,43,244,200,65,222,44,178
"2011","North Tyneside 019A","E01008471","Total",660,236,37,199,219,95,204,48,156
"2011","North Tyneside 019B","E01008474","Total",614,231,58,173,218,83,199,50,149
"2011","North Tyneside 019C","E01008513","Total",1137,389,46,343,263,145,317,43,274
"2011","North Tyneside 019D","E01008514","Total",774,300,49,251,253,97,240,51,189
"2011","North Tyneside 019F","E01032649","Total",612,216,29,187,114,56,154,13,141
"2011","North Tyneside 019G","E01032650","Total",594,232,36,196,107,55,175,18,157
"2011","North Tyneside 020A","E01008486","Total",661,273,45,228,199,75,211,46,165
"2011","North Tyneside 020B","E01008487","Total",692,311,32,279,147,49,217,29,188
"2011","North Tyneside 020C","E01008526","Total",617,179,6,173,185,58,145,23,122
"2011","North Tyneside 020D","E01008530","Total",783,375,16,359,143,40,243,21,222
"2011","North Tyneside 021A","E01008461","Total",623,240,40,200,198,77,169,29,140
"2011","North Tyneside 021B","E01008466","Total",559,143,3,140,127,30,119,8,111
"2011","North Tyneside 021C","E01008467","Total",635,164,23,141,190,82,147,37,110
"2011","North Tyneside 021D","E01008468","Total",633,224,46,178,205,96,169,40,129
"2011","North Tyneside 022A","E01008483","Total",757,196,35,161,196,87,199,32,167
"2011","North Tyneside 022B","E01008524","Total",1119,531,17,514,104,43,398,9,389
"2011","North Tyneside 022C","E01008528","Total",634,152,17,135,165,66,134,17,117
"2011","North Tyneside 022D","E01008529","Total",751,258,12,246,158,58,190,31,159
"2011","North Tyneside 023A","E01008481","Total",614,231,42,189,225,75,187,34,153
"2011","North Tyneside 023B","E01008482","Total",824,369,75,294,230,105,264,42,222
"2011","North Tyneside 023C","E01008484","Total",639,281,77,204,191,104,194,34,160
"2011","North Tyneside 023D","E01008485","Total",644,346,136,210,285,145,230,62,168
"2011","North Tyneside 023E","E01008492","Total",750,282,61,221,236,86,247,55,192
"2011","North Tyneside 024A","E01008462","Total",545,219,24,195,161,55,179,31,148
"2011","North Tyneside 024B","E01008463","Total",607,253,24,229,144,50,213,31,182
"2011","North Tyneside 024C","E01008464","Total",655,237,20,217,157,61,182,26,156
"2011","North Tyneside 024D","E01008465","Total",641,242,17,225,173,69,170,22,148
"2011","North Tyneside 025A","E01008531","Total",631,147,8,139,140,49,125,19,106
"2011","North Tyneside 025B","E01008532","Total",701,262,48,214,221,77,188,27,161
"2011","North Tyneside 025C","E01008534","Total",619,194,8,186,139,48,155,18,137
"2011","North Tyneside 025D","E01008538","Total",520,98,10,88,162,40,95,16,79
"2011","North Tyneside 026A","E01008508","Total",617,230,45,185,217,74,209,56,153
"2011","North Tyneside 026B","E01008509","Total",747,346,56,290,212,84,289,45,244
"2011","North Tyneside 026C","E01008510","Total",755,283,30,253,182,74,204,30,174
"2011","North Tyneside 026D","E01008512","Total",763,350,45,305,185,69,293,38,255
"2011","North Tyneside 027A","E01008539","Total",719,158,18,140,172,75,147,36,111
"2011","North Tyneside 027B","E01008540","Total",743,348,100,248,264,116,224,49,175
"2011","North Tyneside 027C","E01008541","Total",792,368,64,304,212,89,249,36,213
"2011","North Tyneside 027D","E01008544","Total",964,518,71,447,185,99,346,30,316
"2011","North Tyneside 027E","E01008545","Total",665,339,53,286,162,67,266,40,226
"2011","North Tyneside 028A","E01008511","Total",780,300,60,240,243,96,235,41,194
"2011","North Tyneside 028B","E01008542","Total",726,337,100,237,270,128,236,52,184
"2011","North Tyneside 028C","E01008543","Total",931,293,94,199,348,177,218,63,155
"2011","North Tyneside 028D","E01008571","Total",875,379,44,335,216,103,323,33,290
"2011","North Tyneside 029A","E01008572","Total",925,361,67,294,192,97,253,30,223
"2011","North Tyneside 029B","E01008573","Total",838,320,60,260,197,103,223,34,189
"2011","North Tyneside 029C","E01008574","Total",692,231,14,217,193,70,199,41,158
"2011","North Tyneside 029D","E01008576","Total",840,252,73,179,321,135,212,61,151
"2011","North Tyneside 030A","E01008533","Total",631,256,39,217,204,83,215,36,179
"2011","North Tyneside 030B","E01008535","Total",652,230,16,214,158,44,177,25,152
"2011","North Tyneside 030C","E01008536","Total",748,249,21,228,152,78,188,24,164
"2011","North Tyneside 030D","E01008537","Total",661,265,26,239,146,54,196,27,169
"2011","North Tyneside 030E","E01008575","Total",693,251,23,228,137,61,221,24,197
"2011","South Tyneside 001A","E01008595","Total",813,261,37,224,182,81,208,31,177
"2011","South Tyneside 001B","E01008596","Total",576,273,67,206,215,98,212,57,155
"2011","South Tyneside 001C","E01008597","Total",1046,269,31,238,279,123,207,35,172
"2011","South Tyneside 001D","E01008598","Total",648,207,30,177,172,77,183,35,148
"2011","South Tyneside 001E","E01008599","Total",729,352,51,301,165,65,264,41,223
"2011","South Tyneside 002A","E01008664","Total",696,281,44,237,166,73,192,37,155
"2011","South Tyneside 002B","E01008665","Total",762,300,44,256,178,83,227,37,190
"2011","South Tyneside 002C","E01008666","Total",803,489,77,412,171,68,337,40,297
"2011","South Tyneside 002D","E01008667","Total",899,437,54,383,151,65,316,30,286
"2011","South Tyneside 002E","E01008668","Total",813,357,48,309,172,61,274,45,229
"2011","South Tyneside 003A","E01008673","Total",524,168,9,159,140,47,117,21,96
"2011","South Tyneside 003B","E01008675","Total",757,250,29,221,164,73,169,16,153
"2011","South Tyneside 003C","E01008676","Total",538,158,12,146,144,54,150,26,124
"2011","South Tyneside 003D","E01008677","Total",590,228,8,220,142,36,145,17,128
"2011","South Tyneside 003E","E01008678","Total",626,232,20,212,123,39,162,20,142
"2011","South Tyneside 004A","E01008647","Total",659,289,5,284,143,37,196,17,179
"2011","South Tyneside 004B","E01008648","Total",668,333,12,321,125,35,231,22,209
"2011","South Tyneside 004C","E01008649","Total",701,338,50,288,209,68,262,37,225
"2011","South Tyneside 004D","E01008651","Total",778,373,144,229,350,152,253,79,174
"2011","South Tyneside 005A","E01008679","Total",625,247,13,234,141,47,190,26,164
"2011","South Tyneside 005B","E01008680","Total",604,244,10,234,145,45,178,22,156
"2011","South Tyneside 005C","E01008682","Total",509,251,64,187,190,65,176,42,134
"2011","South Tyneside 005D","E01008683","Total",729,243,43,200,162,75,172,24,148
"2011","South Tyneside 006A","E01008635","Total",633,315,27,288,154,45,205,27,178
"2011","South Tyneside 006B","E01008650","Total",599,195,12,183,170,45,157,24,133
"2011","South Tyneside 006C","E01008674","Total",512,164,6,158,149,48,132,20,112
"2011","South Tyneside 006D","E01008681","Total",637,272,7,265,134,26,186,19,167
"2011","South Tyneside 007A","E01008600","Total",623,274,52,222,174,70,223,35,188
"2011","South Tyneside 007B","E01008604","Total",769,361,70,291,202,97,250,39,211
"2011","South Tyneside 007C","E01008660","Total",655,214,18,196,157,59,171,20,151
"2011","South Tyneside 007D","E01008661","Total",512,222,24,198,119,44,175,17,158
"2011","South Tyneside 008A","E01008633","Total",603,257,60,197,207,78,194,39,155
"2011","South Tyneside 008B","E01008634","Total",622,335,46,289,178,65,264,32,232
"2011","South Tyneside 008C","E01008636","Total",596,260,29,231,180,55,213,31,182
"2011","South Tyneside 008D","E01008637","Total",629,253,26,227,193,60,206,31,175
"2011","South Tyneside 009A","E01008639","Total",848,270,76,194,312,129,220,67,153
"2011","South Tyneside 009B","E01008652","Total",514,211,28,183,114,42,147,26,121
"2011","South Tyneside 009C","E01008653","Total",526,204,56,148,213,72,157,42,115
"2011","South Tyneside 009D","E01008654","Total",600,176,25,151,147,67,162,27,135
"2011","South Tyneside 009E","E01008655","Total",663,310,41,269,170,64,245,28,217
"2011","South Tyneside 009F","E01008657","Total",578,188,8,180,163,53,144,16,128
"2011","South Tyneside 010A","E01008638","Total",612,96,19,77,238,88,107,33,74
"2011","South Tyneside 010B","E01008640","Total",889,296,38,258,263,103,220,42,178
"2011","South Tyneside 010C","E01008641","Total",818,410,43,367,172,66,309,32,277
"2011","South Tyneside 010D","E01008642","Total",578,182,11,171,148,47,145,20,125
"2011","South Tyneside 011A","E01008590","Total",749,344,49,295,189,70,271,41,230
"2011","South Tyneside 011B","E01008591","Total",763,312,49,263,186,84,215,29,186
"2011","South Tyneside 011C","E01008592","Total",689,224,42,182,181,83,170,27,143
"2011","South Tyneside 011D","E01008594","Total",738,306,59,247,261,96,244,56,188
"2011","South Tyneside 012A","E01008601","Total",635,277,59,218,200,81,231,36,195
"2011","South Tyneside 012B","E01008669","Total",649,333,53,280,172,67,249,40,209
"2011","South Tyneside 012C","E01008671","Total",647,306,45,261,147,71,211,25,186
"2011","South Tyneside 012D","E01008672","Total",588,261,33,228,150,36,194,27,167
"2011","South Tyneside 013A","E01008622","Total",713,340,23,317,137,41,223,21,202
"2011","South Tyneside 013C","E01008625","Total",718,411,61,350,191,75,293,44,249
"2011","South Tyneside 013E","E01033074","Total",887,352,59,293,276,88,292,64,228
"2011","South Tyneside 014A","E01008602","Total",631,247,53,194,218,87,220,37,183
"2011","South Tyneside 014B","E01008603","Total",648,323,41,282,150,56,229,31,198
"2011","South Tyneside 014C","E01008608","Total",544,290,61,229,176,78,210,46,164
"2011","South Tyneside 014D","E01008670","Total",744,365,46,319,183,79,277,36,241
"2011","South Tyneside 015A","E01008643","Total",620,229,23,206,173,62,173,28,145
"2011","South Tyneside 015B","E01008644","Total",753,391,37,354,167,62,265,41,224
"2011","South Tyneside 015C","E01008645","Total",668,294,50,244,209,78,228,45,183
"2011","South Tyneside 015D","E01008646","Total",609,272,18,254,145,46,191,26,165
"2011","South Tyneside 015E","E01008656","Total",604,255,29,226,162,44,219,38,181
"2011","South Tyneside 015F","E01008658","Total",581,255,59,196,222,84,214,50,164
"2011","South Tyneside 016A","E01008593","Total",569,264,60,204,200,78,194,43,151
"2011","South Tyneside 016B","E01008605","Total",508,163,23,140,152,53,141,23,118
"2011","South Tyneside 016C","E01008606","Total",651,331,81,250,207,90,241,58,183
"2011","South Tyneside 016D","E01008607","Total",604,303,104,199,244,104,219,61,158
"2011","South Tyneside 016E","E01008609","Total",648,312,73,239,222,88,227,47,180
"2011","South Tyneside 017A","E01008631","Total",614,236,33,203,185,65,207,35,172
"2011","South Tyneside 017B","E01008632","Total",571,243,28,215,155,51,192,31,161
"2011","South Tyneside 017C","E01008659","Total",634,283,41,242,189,65,236,42,194
"2011","South Tyneside 017D","E01008662","Total",514,212,34,178,172,54,206,44,162
"2011","South Tyneside 017E","E01008663","Total",637,314,39,275,180,67,220,42,178
"2011","South Tyneside 018A","E01008624","Total",590,219,37,182,232,62,183,47,136
"2011","South Tyneside 018B","E01008684","Total",589,297,23,274,121,48,212,18,194
"2011","South Tyneside 018C","E01008685","Total",806,326,44,282,235,80,257,44,213
"2011","South Tyneside 018D","E01008686","Total",726,309,21,288,189,68,222,26,196
"2011","South Tyneside 018E","E01008687","Total",844,425,19,406,166,61,281,28,253
"2011","South Tyneside 019A","E01008688","Total",654,299,44,255,185,66,224,40,184
"2011","South Tyneside 019B","E01008689","Total",769,419,45,374,171,68,289,36,253
"2011","South Tyneside 019C","E01008690","Total",646,269,43,226,204,71,223,41,182
"2011","South Tyneside 019D","E01008691","Total",494,136,11,125,138,40,112,22,90
"2011","South Tyneside 019E","E01008692","Total",615,257,32,225,167,45,212,26,186
"2011","South Tyneside 020A","E01008627","Total",611,204,9,195,130,51,147,17,130
"2011","South Tyneside 020B","E01008628","Total",624,321,75,246,213,65,221,55,166
"2011","South Tyneside 020C","E01008629","Total",595,179,12,167,175,63,166,26,140
"2011","South Tyneside 020D","E01008630","Total",627,275,66,209,231,97,222,54,168
"2011","South Tyneside 021A","E01008610","Total",637,339,71,268,225,85,251,46,205
"2011","South Tyneside 021B","E01008611","Total",602,118,7,111,187,61,130,28,102
"2011","South Tyneside 021C","E01008612","Total",640,180,11,169,173,53,132,24,108
"2011","South Tyneside 021D","E01008613","Total",757,343,55,288,201,91,235,34,201
"2011","South Tyneside 022A","E01008616","Total",643,186,13,173,201,70,154,28,126
"2011","South Tyneside 022B","E01008618","Total",512,198,3,195,136,38,125,27,98
"2011","South Tyneside 022C","E01008619","Total",712,318,4,314,146,32,208,18,190
"2011","South Tyneside 022D","E01008621","Total",604,224,4,220,151,46,139,17,122
"2011","South Tyneside 023A","E01008614","Total",676,265,29,236,201,78,209,31,178
"2011","South Tyneside 023B","E01008615","Total",679,261,28,233,165,61,206,24,182
"2011","South Tyneside 023C","E01008617","Total",621,223,6,217,191,55,147,22,125
"2011","South Tyneside 023D","E01008620","Total",657,282,8,274,165,54,190,22,168
"2011","Sunderland 001A","E01008713","Total",630,205,11,194,209,53,172,35,137
"2011","Sunderland 001B","E01008722","Total",644,267,10,257,164,49,208,23,185
"2011","Sunderland 001C","E01008724","Total",483,160,4,156,146,29,133,20,113
"2011","Sunderland 001D","E01008726","Total",670,266,13,253,170,58,181,34,147
"2011","Sunderland 002A","E01008723","Total",572,241,9,232,166,32,148,20,128
"2011","Sunderland 002B","E01008725","Total",619,262,5,257,154,42,184,21,163
"2011","Sunderland 002C","E01008727","Total",769,298,18,280,168,52,224,29,195
"2011","Sunderland 002D","E01008728","Total",583,180,10,170,188,42,165,34,131
"2011","Sunderland 002E","E01008792","Total",505,201,3,198,117,38,146,19,127
"2011","Sunderland 003A","E01008698","Total",724,368,41,327,178,79,258,28,230
"2011","Sunderland 003B","E01008837","Total",633,288,60,228,179,80,237,38,199
"2011","Sunderland 003C","E01008838","Total",680,288,51,237,238,105,220,48,172
"2011","Sunderland 003D","E01008839","Total",671,336,68,268,182,75,238,39,199
"2011","Sunderland 003E","E01008840","Total",586,229,50,179,214,77,184,39,145
"2011","Sunderland 003F","E01008841","Total",528,288,65,223,169,65,191,45,146
"2011","Sunderland 004A","E01008712","Total",774,375,59,316,202,74,298,54,244
"2011","Sunderland 004B","E01008817","Total",465,231,72,159,172,64,186,52,134
"2011","Sunderland 004C","E01008819","Total",630,294,37,257,185,73,217,31,186
"2011","Sunderland 004D","E01008821","Total",539,269,54,215,184,67,182,32,150
"2011","Sunderland 004E","E01008822","Total",732,326,71,255,241,105,272,61,211
"2011","Sunderland 004F","E01008842","Total",592,184,31,153,178,62,167,31,136
"2011","Sunderland 005A","E01008708","Total",695,330,33,297,162,57,272,32,240
"2011","Sunderland 005B","E01008709","Total",687,333,74,259,190,84,242,41,201
"2011","Sunderland 005D","E01008711","Total",687,260,20,240,164,66,196,22,174
"2011","Sunderland 005F","E01008820","Total",558,215,28,187,127,68,181,27,154
"2011","Sunderland 005G","E01033075","Total",950,469,80,389,278,121,356,62,294
"2011","Sunderland 006A","E01008786","Total",648,235,20,215,172,60,176,29,147
"2011","Sunderland 006B","E01008787","Total",710,270,24,246,161,64,189,30,159
"2011","Sunderland 006C","E01008788","Total",758,278,21,257,160,64,196,25,171
"2011","Sunderland 006D","E01008789","Total",642,203,9,194,141,56,154,18,136
"2011","Sunderland 006E","E01008790","Total",657,231,20,211,176,59,175,33,142
"2011","Sunderland 006F","E01008791","Total",1011,584,23,561,110,43,361,22,339
"2011","Sunderland 007A","E01008855","Total",644,167,11,156,204,65,151,27,124
"2011","Sunderland 007B","E01008856","Total",629,247,9,238,121,40,186,19,167
"2011","Sunderland 007C","E01008876","Total",579,187,14,173,161,49,130,24,106
"2011","Sunderland 007D","E01008877","Total",634,205,9,196,166,63,167,35,132
"2011","Sunderland 008A","E01008693","Total",555,228,19,209,140,43,203,30,173
"2011","Sunderland 008B","E01008694","Total",618,261,37,224,197,79,208,40,168
"2011","Sunderland 008C","E01008695","Total",606,218,54,164,222,96,182,45,137
"2011","Sunderland 008D","E01008696","Total",490,126,14,112,185,48,119,21,98
"2011","Sunderland 008E","E01008697","Total",571,270,20,250,151,54,212,27,185
"2011","Sunderland 008F","E01008699","Total",605,266,54,212,198,77,210,39,171
"2011","Sunderland 009A","E01008853","Total",619,250,58,192,202,94,216,38,178
"2011","Sunderland 009B","E01008854","Total",812,331,44,287,169,71,242,27,215
"2011","Sunderland 009C","E01008857","Total",630,254,38,216,190,81,214,38,176
"2011","Sunderland 009D","E01008858","Total",598,273,86,187,254,130,214,53,161
"2011","Sunderland 009E","E01008859","Total",534,191,68,123,223,103,181,55,126
"2011","Sunderland 009F","E01008860","Total",596,257,63,194,188,79,193,46,147
"2011","Sunderland 009G","E01008878","Total",635,243,32,211,225,76,191,41,150
"2011","Sunderland 010A","E01008873","Total",540,169,9,160,139,40,145,27,118
"2011","Sunderland 010B","E01008874","Total",671,229,63,166,272,97,201,58,143
"2011","Sunderland 010C","E01008875","Total",674,196,37,159,236,100,185,48,137
"2011","Sunderland 010D","E01008879","Total",617,193,20,173,166,58,176,24,152
"2011","Sunderland 010E","E01008880","Total",512,189,19,170,131,51,167,28,139
"2011","Sunderland 011A","E01008701","Total",650,229,58,171,215,103,195,38,157
"2011","Sunderland 011B","E01008704","Total",650,254,31,223,182,84,195,26,169
"2011","Sunderland 011C","E01008706","Total",668,265,46,219,210,92,193,31,162
"2011","Sunderland 011D","E01008707","Total",547,172,26,146,163,85,131,29,102
"2011","Sunderland 012A","E01008756","Total",652,294,47,247,177,74,257,48,209
"2011","Sunderland 012B","E01008762","Total",639,304,77,227,217,86,232,41,191
"2011","Sunderland 012C","E01008812","Total",751,291,80,211,288,131,223,49,174
"2011","Sunderland 012F","E01033076","Total",596,297,78,219,211,89,222,53,169
"2011","Sunderland 013A","E01008700","Total",516,212,34,178,117,53,168,25,143
"2011","Sunderland 013B","E01008703","Total",1089,607,16,591,67,33,397,12,385
"2011","Sunderland 013C","E01008705","Total",485,202,42,160,116,51,149,17,132
"2011","Sunderland 013D","E01008831","Total",1131,496,30,466,153,81,239,21,218
"2011","Sunderland 013E","E01008834","Total",967,328,27,301,138,54,241,21,220
"2011","Sunderland 014A","E01008810","Total",712,306,59,247,218,93,244,42,202
"2011","Sunderland 014B","E01008811","Total",690,251,25,226,209,80,208,36,172
"2011","Sunderland 014C","E01008813","Total",643,273,39,234,193,72,215,38,177
"2011","Sunderland 014D","E01008814","Total",661,230,27,203,183,74,194,30,164
"2011","Sunderland 015A","E01008757","Total",648,284,48,236,180,68,220,39,181
"2011","Sunderland 015B","E01008758","Total",601,234,18,216,166,40,187,33,154
"2011","Sunderland 015C","E01008759","Total",664,255,21,234,146,58,193,17,176
"2011","Sunderland 015D","E01008761","Total",588,224,13,211,140,44,167,20,147
"2011","Sunderland 016A","E01008702","Total",566,330,54,276,142,62,245,32,213
"2011","Sunderland 016B","E01008735","Total",1032,491,71,420,189,89,304,36,268
"2011","Sunderland 016C","E01008736","Total",609,314,74,240,174,86,221,35,186
"2011","Sunderland 016D","E01008737","Total",627,273,62,211,177,77,203,42,161
"2011","Sunderland 016E","E01008738","Total",605,270,56,214,160,71,199,36,163
"2011","Sunderland 016F","E01008836","Total",704,395,24,371,120,57,278,25,253
"2011","Sunderland 017A","E01008845","Total",672,238,10,228,138,55,188,26,162
"2011","Sunderland 017B","E01008846","Total",464,189,52,137,176,80,148,35,113
"2011","Sunderland 017C","E01008847","Total",513,187,59,128,221,98,167,43,124
"2011","Sunderland 017D","E01008850","Total",625,126,11,115,235,77,141,40,101
"2011","Sunderland 017E","E01008851","Total",753,253,19,234,182,66,214,27,187
"2011","Sunderland 018A","E01008760","Total",626,198,14,184,180,57,154,34,120
"2011","Sunderland 018B","E01008830","Total",573,172,21,151,161,75,136,29,107
"2011","Sunderland 018C","E01008832","Total",632,210,37,173,215,107,159,40,119
"2011","Sunderland 018D","E01008833","Total",637,259,8,251,145,71,169,17,152
"2011","Sunderland 019A","E01008843","Total",555,169,6,163,138,43,131,24,107
"2011","Sunderland 019B","E01008844","Total",688,309,15,294,137,53,218,18,200
"2011","Sunderland 019C","E01008848","Total",608,275,8,267,113,35,189,14,175
"2011","Sunderland 019D","E01008849","Total",499,195,56,139,211,84,173,48,125
"2011","Sunderland 019E","E01008852","Total",531,140,8,132,149,57,117,17,100
"2011","Sunderland 020A","E01008867","Total",803,275,65,210,220,111,222,41,181
"2011","Sunderland 020B","E01008868","Total",513,117,4,113,137,43,134,25,109
"2011","Sunderland 020C","E01008869","Total",523,148,10,138,156,63,142,26,116
"2011","Sunderland 020D","E01008870","Total",595,138,7,131,188,63,139,23,116
"2011","Sunderland 020E","E01008871","Total",602,193,27,166,201,62,172,37,135
"2011","Sunderland 020F","E01008872","Total",663,190,9,181,161,58,195,32,163
"2011","Sunderland 021A","E01008729","Total",462,212,53,159,158,65,182,35,147
"2011","Sunderland 021B","E01008730","Total",647,271,87,184,250,104,220,63,157
"2011","Sunderland 021C","E01008731","Total",519,244,58,186,181,76,181,42,139
"2011","Sunderland 021D","E01008732","Total",940,369,58,311,331,134,301,60,241
"2011","Sunderland 021E","E01008733","Total",882,449,44,405,192,71,359,38,321
"2011","Sunderland 021F","E01008734","Total",637,292,5,287,128,31,183,13,170
"2011","Sunderland 022A","E01008740","Total",609,241,9,232,148,52,197,22,175
"2011","Sunderland 022B","E01008781","Total",633,232,8,224,173,48,157,24,133
"2011","Sunderland 022C","E01008782","Total",607,252,8,244,144,42,169,24,145
"2011","Sunderland 022D","E01008783","Total",622,247,6,241,133,40,171,20,151
"2011","Sunderland 022E","E01008784","Total",648,248,6,242,182,53,175,28,147
"2011","Sunderland 022F","E01008785","Total",624,275,4,271,136,35,190,15,175
"2011","Sunderland 022G","E01008835","Total",611,166,14,152,168,58,151,36,115
"2011","Sunderland 023A","E01008823","Total",606,284,44,240,171,62,204,33,171
"2011","Sunderland 023B","E01008824","Total",625,259,70,189,251,97,197,50,147
"2011","Sunderland 023C","E01008825","Total",687,331,44,287,174,57,257,45,212
"2011","Sunderland 023D","E01008826","Total",606,240,44,196,193,66,188,43,145
"2011","Sunderland 023E","E01008827","Total",524,244,59,185,187,81,173,37,136
"2011","Sunderland 023F","E01008828","Total",643,289,86,203,254,109,225,57,168
"2011","Sunderland 023G","E01008829","Total",627,313,56,257,180,74,220,34,186
"2011","Sunderland 024A","E01008739","Total",606,221,57,164,225,72,189,50,139
"2011","Sunderland 024B","E01008741","Total",619,229,22,207,179,58,183,31,152
"2011","Sunderland 024C","E01008779","Total",689,296,23,273,174,60,244,30,214
"2011","Sunderland 024D","E01008780","Total",848,334,49,285,255,96,272,49,223
"2011","Sunderland 025A","E01008799","Total",641,143,8,135,226,86,145,29,116
"2011","Sunderland 025B","E01008861","Total",649,222,24,198,171,60,181,31,150
"2011","Sunderland 025C","E01008862","Total",567,134,2,132,155,47,119,17,102
"2011","Sunderland 025D","E01008863","Total",633,183,12,171,192,64,137,30,107
"2011","Sunderland 025E","E01008864","Total",540,185,10,175,123,44,136,21,115
"2011","Sunderland 025F","E01008865","Total",608,240,17,223,161,73,203,28,175
"2011","Sunderland 025G","E01008866","Total",606,181,17,164,179,70,170,32,138
"2011","Sunderland 026A","E01008773","Total",675,298,64,234,207,105,214,33,181
"2011","Sunderland 026B","E01008776","Total",494,185,35,150,180,59,170,37,133
"2011","Sunderland 026C","E01008777","Total",886,589,20,569,74,29,432,14,418
"2011","Sunderland 026D","E01008778","Total",609,251,35,216,204,78,183,33,150
"2011","Sunderland 026E","E01008809","Total",693,274,29,245,175,69,217,37,180
"2011","Sunderland 027A","E01008803","Total",650,299,31,268,164,70,240,26,214
"2011","Sunderland 027B","E01008804","Total",663,287,37,250,197,54,237,46,191
"2011","Sunderland 027C","E01008805","Total",660,252,32,220,188,67,225,39,186
"2011","Sunderland 027F","E01033077","Total",741,289,43,246,237,74,248,47,201
"2011","Sunderland 028A","E01008763","Total",607,233,41,192,219,86,177,33,144
"2011","Sunderland 028B","E01008764","Total",652,252,23,229,171,55,200,36,164
"2011","Sunderland 028C","E01008766","Total",911,342,52,290,338,109,274,55,219
"2011","Sunderland 028D","E01008768","Total",585,201,19,182,185,73,177,40,137
"2011","Sunderland 028E","E01008769","Total",775,330,68,262,227,95,268,47,221
"2011","Sunderland 029A","E01008772","Total",585,226,5,221,151,37,165,18,147
"2011","Sunderland 029B","E01008774","Total",591,278,15,263,142,39,198,25,173
"2011","Sunderland 029C","E01008775","Total",601,231,6,225,139,33,163,18,145
"2011","Sunderland 029D","E01008802","Total",643,266,9,257,137,42,200,14,186
"2011","Sunderland 029E","E01008808","Total",634,143,10,133,164,54,135,20,115
"2011","Sunderland 030A","E01008793","Total",823,438,78,360,227,121,339,49,290
"2011","Sunderland 030B","E01008795","Total",722,210,20,190,251,89,179,34,145
"2011","Sunderland 030C","E01008797","Total",833,312,14,298,254,92,215,39,176
"2011","Sunderland 030D","E01008800","Total",582,243,50,193,225,87,198,46,152
"2011","Sunderland 030E","E01008801","Total",658,197,8,189,207,65,145,25,120
"2011","Sunderland 031A","E01008765","Total",603,158,10,148,206,55,166,39,127
"2011","Sunderland 031B","E01008767","Total",632,251,22,229,185,62,208,28,180
"2011","Sunderland 031C","E01008770","Total",600,177,10,167,170,46,170,21,149
"2011","Sunderland 031D","E01008771","Total",618,203,19,184,207,70,183,37,146
"2011","Sunderland 032A","E01008720","Total",618,229,42,187,170,73,196,33,163
"2011","Sunderland 032B","E01008721","Total",626,160,13,147,233,90,147,36,111
"2011","Sunderland 032D","E01008796","Total",621,160,15,145,207,64,158,35,123
"2011","Sunderland 032F","E01032483","Total",728,269,48,221,217,85,217,46,171
"2011","Sunderland 032G","E01032484","Total",572,212,21,191,137,51,182,32,150
"2011","Sunderland 033A","E01008750","Total",762,222,12,210,249,83,205,39,166
"2011","Sunderland 033B","E01008751","Total",462,193,25,168,130,42,150,26,124
"2011","Sunderland 033C","E01008752","Total",692,283,62,221,236,113,240,52,188
"2011","Sunderland 033D","E01008753","Total",559,225,29,196,154,66,173,35,138
"2011","Sunderland 033E","E01008755","Total",589,235,35,200,161,63,195,36,159
"2011","Sunderland 034A","E01008714","Total",528,248,74,174,204,96,170,48,122
"2011","Sunderland 034B","E01008715","Total",587,224,35,189,167,53,174,39,135
"2011","Sunderland 034C","E01008716","Total",592,239,5,234,127,38,152,17,135
"2011","Sunderland 034D","E01008717","Total",683,262,49,213,241,100,223,45,178
"2011","Sunderland 034E","E01008749","Total",638,280,11,269,129,28,211,25,186
"2011","Sunderland 034F","E01008754","Total",694,349,28,321,159,67,282,29,253
"2011","Sunderland 035A","E01008718","Total",610,280,20,260,147,41,222,33,189
"2011","Sunderland 035B","E01008719","Total",557,249,25,224,135,55,213,24,189
"2011","Sunderland 035C","E01008742","Total",754,289,39,250,205,75,235,35,200
"2011","Sunderland 035D","E01008747","Total",656,275,20,255,136,51,198,24,174
"2011","Sunderland 035E","E01008748","Total",655,339,15,324,108,24,239,23,216
"2011","Sunderland 036A","E01008743","Total",725,365,81,284,249,94,296,71,225
"2011","Sunderland 036B","E01008744","Total",750,342,52,290,219,80,298,47,251
"2011","Sunderland 036C","E01008745","Total",728,273,11,262,175,65,201,23,178
"2011","Sunderland 036D","E01008746","Total",714,356,81,275,234,93,260,51,209
"2011","Blackburn with Darwen 001A","E01012607","Total",640,260,31,229,168,69,185,37,148
"2011","Blackburn with Darwen 001B","E01012608","Total",731,280,53,227,239,114,226,53,173
"2011","Blackburn with Darwen 001C","E01012633","Total",729,245,16,229,184,72,236,27,209
"2011","Blackburn with Darwen 001D","E01012634","Total",590,189,22,167,185,89,156,30,126
"2011","Blackburn with Darwen 001E","E01012635","Total",589,193,31,162,234,104,149,40,109
"2011","Blackburn with Darwen 001F","E01012636","Total",673,287,13,274,152,51,187,26,161
"2011","Blackburn with Darwen 002A","E01012581","Total",495,168,9,159,141,57,119,26,93
"2011","Blackburn with Darwen 002B","E01012582","Total",525,116,7,109,212,70,105,31,74
"2011","Blackburn with Darwen 002C","E01012583","Total",643,214,11,203,191,68,181,36,145
"2011","Blackburn with Darwen 002D","E01012587","Total",661,184,30,154,260,133,180,50,130
"2011","Blackburn with Darwen 002E","E01012588","Total",617,133,35,98,337,164,149,69,80
"2011","Blackburn with Darwen 003A","E01012574","Total",563,285,59,226,203,99,227,52,175
"2011","Blackburn with Darwen 003B","E01012577","Total",516,169,69,100,290,146,146,65,81
"2011","Blackburn with Darwen 003C","E01012578","Total",528,167,64,103,311,142,154,79,75
"2011","Blackburn with Darwen 003D","E01012605","Total",578,206,44,162,287,126,206,71,135
"2011","Blackburn with Darwen 003E","E01012606","Total",483,147,48,99,268,142,148,59,89
"2011","Blackburn with Darwen 004A","E01012579","Total",542,218,39,179,230,112,186,38,148
"2011","Blackburn with Darwen 004B","E01012580","Total",537,136,45,91,300,146,166,75,91
"2011","Blackburn with Darwen 004C","E01012642","Total",482,147,41,106,233,117,145,53,92
"2011","Blackburn with Darwen 004D","E01012645","Total",582,149,29,120,289,136,138,56,82
"2011","Blackburn with Darwen 005A","E01012585","Total",466,155,22,133,189,91,128,36,92
"2011","Blackburn with Darwen 005B","E01012586","Total",490,165,31,134,198,97,145,44,101
"2011","Blackburn with Darwen 005C","E01012656","Total",627,231,43,188,234,122,211,50,161
"2011","Blackburn with Darwen 005D","E01012657","Total",718,316,71,245,299,172,225,63,162
"2011","Blackburn with Darwen 005E","E01012658","Total",756,270,49,221,250,121,213,36,177
"2011","Blackburn with Darwen 006A","E01012629","Total",479,117,36,81,179,98,107,32,75
"2011","Blackburn with Darwen 006B","E01012631","Total",579,294,45,249,168,93,249,43,206
"2011","Blackburn with Darwen 006C","E01012643","Total",627,319,59,260,198,96,269,52,217
"2011","Blackburn with Darwen 006D","E01012644","Total",661,170,32,138,316,135,163,52,111
"2011","Blackburn with Darwen 006E","E01012655","Total",879,541,97,444,212,98,373,58,315
"2011","Blackburn with Darwen 007A","E01012571","Total",457,168,54,114,223,123,145,57,88
"2011","Blackburn with Darwen 007B","E01012572","Total",522,243,52,191,217,94,228,69,159
"2011","Blackburn with Darwen 007C","E01012573","Total",484,129,44,85,266,128,140,60,80
"2011","Blackburn with Darwen 007D","E01012575","Total",546,296,40,256,154,79,250,44,206
"2011","Blackburn with Darwen 007E","E01012630","Total",601,145,49,96,338,163,122,66,56
"2011","Blackburn with Darwen 008A","E01012576","Total",569,273,32,241,184,90,239,35,204
"2011","Blackburn with Darwen 008B","E01012637","Total",637,331,106,225,265,122,220,68,152
"2011","Blackburn with Darwen 008C","E01012638","Total",703,356,92,264,257,115,269,67,202
"2011","Blackburn with Darwen 008D","E01012639","Total",722,361,123,238,297,135,289,81,208
"2011","Blackburn with Darwen 008E","E01012640","Total",722,295,68,227,243,126,220,42,178
"2011","Blackburn with Darwen 008F","E01012641","Total",550,228,97,131,275,150,153,63,90
"2011","Blackburn with Darwen 009A","E01012595","Total",860,323,62,261,265,119,266,41,225
"2011","Blackburn with Darwen 009B","E01012596","Total",794,262,66,196,268,124,215,46,169
"2011","Blackburn with Darwen 009C","E01012622","Total",780,392,96,296,246,132,296,52,244
"2011","Blackburn with Darwen 009D","E01012623","Total",636,189,34,155,213,87,177,48,129
"2011","Blackburn with Darwen 009E","E01012624","Total",715,282,37,245,227,88,248,41,207
"2011","Blackburn with Darwen 009F","E01012625","Total",774,277,45,232,230,113,223,44,179
"2011","Blackburn with Darwen 010A","E01012584","Total",521,128,5,123,175,69,120,22,98
"2011","Blackburn with Darwen 010B","E01012609","Total",654,244,6,238,167,44,184,26,158
"2011","Blackburn with Darwen 010C","E01012610","Total",506,147,13,134,170,50,145,27,118
"2011","Blackburn with Darwen 010D","E01012611","Total",482,161,2,159,109,27,101,13,88
"2011","Blackburn with Darwen 010E","E01012612","Total",625,272,5,267,150,45,185,27,158
"2011","Blackburn with Darwen 010F","E01012613","Total",558,185,4,181,159,37,142,17,125
"2011","Blackburn with Darwen 011A","E01012600","Total",635,313,53,260,172,63,257,47,210
"2011","Blackburn with Darwen 011B","E01012601","Total",593,297,109,188,249,104,215,63,152
"2011","Blackburn with Darwen 011C","E01012602","Total",651,102,15,87,249,104,124,36,88
"2011","Blackburn with Darwen 011D","E01012603","Total",649,265,85,180,261,109,227,61,166
"2011","Blackburn with Darwen 011E","E01012604","Total",599,150,41,109,272,110,149,50,99
"2011","Blackburn with Darwen 011F","E01012632","Total",808,268,38,230,281,116,261,61,200
"2011","Blackburn with Darwen 012A","E01012594","Total",626,290,72,218,227,89,238,57,181
"2011","Blackburn with Darwen 012B","E01012618","Total",647,217,11,206,158,43,166,19,147
"2011","Blackburn with Darwen 012C","E01012619","Total",554,260,78,182,214,87,205,55,150
"2011","Blackburn with Darwen 012D","E01012620","Total",639,283,18,265,128,45,183,23,160
"2011","Blackburn with Darwen 012E","E01012621","Total",625,200,45,155,225,83,188,51,137
"2011","Blackburn with Darwen 013A","E01012593","Total",742,191,25,166,251,101,175,41,134
"2011","Blackburn with Darwen 013B","E01012597","Total",679,121,6,115,264,91,141,38,103
"2011","Blackburn with Darwen 013C","E01012598","Total",1050,112,17,95,521,196,167,64,103
"2011","Blackburn with Darwen 013D","E01012599","Total",498,119,7,112,132,58,105,14,91
"2011","Blackburn with Darwen 014A","E01012589","Total",653,249,52,197,188,93,200,38,162
"2011","Blackburn with Darwen 014B","E01012590","Total",630,270,43,227,174,69,211,36,175
"2011","Blackburn with Darwen 014C","E01012591","Total",666,279,23,256,186,64,250,46,204
"2011","Blackburn with Darwen 014D","E01012648","Total",531,184,42,142,169,83,156,37,119
"2011","Blackburn with Darwen 014E","E01012652","Total",652,243,7,236,155,39,167,26,141
"2011","Blackburn with Darwen 015A","E01012617","Total",602,170,30,140,203,77,175,42,133
"2011","Blackburn with Darwen 015B","E01012646","Total",744,350,77,273,246,113,295,61,234
"2011","Blackburn with Darwen 015C","E01012647","Total",646,338,53,285,157,64,245,45,200
"2011","Blackburn with Darwen 015D","E01012650","Total",596,246,52,194,199,95,180,40,140
"2011","Blackburn with Darwen 016A","E01012649","Total",633,282,58,224,188,79,220,38,182
"2011","Blackburn with Darwen 016B","E01012651","Total",686,222,46,176,247,89,169,47,122
"2011","Blackburn with Darwen 016C","E01012653","Total",580,182,33,149,184,59,141,33,108
"2011","Blackburn with Darwen 016D","E01012654","Total",762,280,48,232,215,108,227,37,190
"2011","Blackburn with Darwen 017A","E01012614","Total",673,165,16,149,241,88,156,40,116
"2011","Blackburn with Darwen 017B","E01012615","Total",748,359,30,329,166,61,269,31,238
"2011","Blackburn with Darwen 017C","E01012616","Total",761,218,18,200,254,81,206,38,168
"2011","Blackburn with Darwen 017D","E01012659","Total",593,162,10,152,178,56,154,30,124
"2011","Blackburn with Darwen 017E","E01012660","Total",463,139,13,126,141,39,93,17,76
"2011","Blackburn with Darwen 017F","E01012661","Total",687,208,23,185,192,81,184,33,151
"2011","Blackburn with Darwen 018A","E01012592","Total",826,241,8,233,196,70,212,30,182
"2011","Blackburn with Darwen 018D","E01012628","Total",497,112,2,110,128,31,94,19,75
"2011","Blackburn with Darwen 018E","E01032485","Total",719,162,4,158,223,75,116,24,92
"2011","Blackburn with Darwen 018F","E01032486","Total",606,190,4,186,172,43,141,18,123
"2011","Blackpool 001A","E01012663","Total",751,351,26,325,172,70,253,30,223
"2011","Blackpool 001B","E01012664","Total",714,264,25,239,208,84,201,31,170
"2011","Blackpool 001C","E01012665","Total",863,477,20,457,137,40,349,36,313
"2011","Blackpool 001D","E01012716","Total",642,265,20,245,169,50,189,29,160
"2011","Blackpool 001E","E01012719","Total",625,265,11,254,164,59,179,26,153
"2011","Blackpool 002A","E01012662","Total",832,469,12,457,110,40,334,23,311
"2011","Blackpool 002B","E01012703","Total",706,334,22,312,163,56,238,29,209
"2011","Blackpool 002C","E01012704","Total",1078,590,65,525,244,92,468,58,410
"2011","Blackpool 002D","E01012706","Total",709,216,23,193,230,72,191,44,147
"2011","Blackpool 002E","E01012717","Total",715,304,15,289,175,44,231,34,197
"2011","Blackpool 003A","E01012666","Total",667,287,24,263,135,48,225,25,200
"2011","Blackpool 003B","E01012667","Total",642,254,18,236,188,66,196,32,164
"2011","Blackpool 003C","E01012668","Total",728,312,14,298,172,45,215,25,190
"2011","Blackpool 003D","E01012669","Total",875,364,10,354,163,65,262,26,236
"2011","Blackpool 003E","E01012718","Total",771,391,8,383,152,47,291,24,267
"2011","Blackpool 004A","E01012690","Total",740,203,21,182,228,85,183,31,152
"2011","Blackpool 004B","E01012691","Total",790,288,37,251,254,97,241,48,193
"2011","Blackpool 004C","E01012692","Total",827,372,50,322,216,96,322,43,279
"2011","Blackpool 004D","E01012705","Total",727,306,43,263,220,83,267,48,219
"2011","Blackpool 004E","E01012723","Total",654,212,23,189,174,65,172,30,142
"2011","Blackpool 005A","E01012693","Total",725,271,16,255,178,77,206,29,177
"2011","Blackpool 005B","E01012711","Total",602,224,36,188,184,58,192,40,152
"2011","Blackpool 005C","E01012747","Total",611,215,9,206,170,53,171,22,149
"2011","Blackpool 005D","E01012750","Total",735,263,29,234,212,70,205,34,171
"2011","Blackpool 006A","E01012681","Total",762,422,46,376,100,52,284,13,271
"2011","Blackpool 006B","E01012683","Total",715,376,48,328,144,54,297,30,267
"2011","Blackpool 006C","E01012748","Total",715,318,34,284,159,76,270,45,225
"2011","Blackpool 006D","E01012749","Total",715,289,24,265,166,65,237,25,212
"2011","Blackpool 007A","E01012707","Total",640,300,39,261,153,61,238,23,215
"2011","Blackpool 007B","E01012720","Total",649,352,113,239,265,103,259,71,188
"2011","Blackpool 007C","E01012721","Total",835,546,126,420,235,88,395,57,338
"2011","Blackpool 007D","E01012724","Total",621,315,51,264,158,53,270,33,237
"2011","Blackpool 008A","E01012678","Total",738,433,67,366,152,73,339,50,289
"2011","Blackpool 008B","E01012679","Total",637,342,106,236,223,109,232,52,180
"2011","Blackpool 008C","E01012680","Total",684,285,74,211,233,113,253,56,197
"2011","Blackpool 008D","E01012682","Total",745,419,69,350,170,89,300,45,255
"2011","Blackpool 008E","E01012684","Total",689,311,75,236,205,108,237,43,194
"2011","Blackpool 009A","E01012676","Total",611,224,41,183,176,57,189,39,150
"2011","Blackpool 009B","E01012677","Total",614,219,27,192,153,54,169,27,142
"2011","Blackpool 009C","E01012708","Total",607,185,24,161,193,64,170,31,139
"2011","Blackpool 009D","E01012709","Total",744,246,69,177,271,138,199,51,148
"2011","Blackpool 009E","E01012710","Total",480,167,19,148,151,46,139,24,115
"2011","Blackpool 009F","E01012722","Total",514,120,10,110,155,56,105,20,85
"2011","Blackpool 010A","E01012673","Total",712,432,78,354,150,70,276,34,242
"2011","Blackpool 010B","E01012675","Total",697,333,101,232,225,116,248,46,202
"2011","Blackpool 010C","E01012735","Total",700,348,17,331,89,42,269,24,245
"2011","Blackpool 010D","E01012736","Total",468,238,9,229,35,16,147,8,139
"2011","Blackpool 010E","E01012737","Total",805,445,50,395,114,52,305,31,274
"2011","Blackpool 011A","E01012670","Total",574,266,81,185,195,93,185,37,148
"2011","Blackpool 011B","E01012733","Total",471,180,34,146,128,57,153,34,119
"2011","Blackpool 011C","E01012734","Total",631,216,33,183,197,96,169,37,132
"2011","Blackpool 011D","E01012738","Total",563,251,53,198,162,67,169,29,140
"2011","Blackpool 011E","E01012739","Total",578,251,60,191,205,79,193,53,140
"2011","Blackpool 011F","E01012742","Total",541,193,18,175,125,47,141,20,121
"2011","Blackpool 012A","E01012712","Total",695,200,21,179,233,85,173,32,141
"2011","Blackpool 012B","E01012713","Total",826,224,37,187,278,110,225,46,179
"2011","Blackpool 012C","E01012715","Total",698,224,24,200,206,70,199,41,158
"2011","Blackpool 012D","E01012740","Total",685,272,17,255,156,42,220,28,192
"2011","Blackpool 012E","E01012741","Total",608,233,19,214,160,52,198,29,169
"2011","Blackpool 013A","E01012671","Total",586,312,50,262,107,51,222,26,196
"2011","Blackpool 013B","E01012672","Total",540,283,26,257,85,31,227,21,206
"2011","Blackpool 013C","E01012674","Total",720,308,66,242,201,71,256,51,205
"2011","Blackpool 013D","E01012751","Total",735,382,30,352,79,38,288,24,264
"2011","Blackpool 014A","E01012686","Total",636,311,86,225,224,97,250,53,197
"2011","Blackpool 014B","E01012687","Total",632,308,67,241,194,73,251,40,211
"2011","Blackpool 014C","E01012688","Total",658,356,24,332,123,41,253,18,235
"2011","Blackpool 014D","E01012689","Total",630,265,27,238,134,61,216,21,195
"2011","Blackpool 014E","E01012714","Total",796,300,20,280,184,78,243,37,206
"2011","Blackpool 015A","E01012695","Total",616,228,58,170,213,79,205,51,154
"2011","Blackpool 015B","E01012743","Total",742,320,65,255,224,90,260,52,208
"2011","Blackpool 015C","E01012744","Total",746,329,52,277,224,99,272,50,222
"2011","Blackpool 015D","E01012745","Total",755,312,49,263,221,86,258,53,205
"2011","Blackpool 015E","E01012746","Total",796,340,70,270,260,107,283,61,222
"2011","Blackpool 016A","E01012685","Total",638,197,54,143,240,118,169,44,125
"2011","Blackpool 016B","E01012694","Total",645,253,40,213,185,75,205,41,164
"2011","Blackpool 016C","E01012696","Total",667,236,66,170,248,120,205,50,155
"2011","Blackpool 016D","E01012697","Total",680,314,16,298,150,55,257,31,226
"2011","Blackpool 016E","E01012698","Total",637,263,76,187,231,97,212,59,153
"2011","Blackpool 017A","E01012726","Total",757,330,28,302,205,72,254,29,225
"2011","Blackpool 017B","E01012728","Total",736,315,29,286,187,71,230,24,206
"2011","Blackpool 017C","E01012752","Total",583,261,18,243,116,41,211,31,180
"2011","Blackpool 017D","E01012753","Total",469,139,7,132,153,38,141,29,112
"2011","Blackpool 017E","E01012754","Total",522,227,37,190,147,63,179,23,156
"2011","Blackpool 017F","E01012755","Total",608,209,12,197,167,63,175,31,144
"2011","Blackpool 018A","E01012701","Total",619,214,21,193,196,67,170,36,134
"2011","Blackpool 018B","E01012729","Total",749,345,24,321,165,58,237,30,207
"2011","Blackpool 018C","E01012730","Total",685,197,15,182,192,50,180,28,152
"2011","Blackpool 018D","E01012731","Total",728,262,30,232,206,71,225,37,188
"2011","Blackpool 018E","E01012732","Total",829,393,38,355,184,68,318,43,275
"2011","Blackpool 019A","E01012699","Total",759,281,37,244,220,79,229,51,178
"2011","Blackpool 019B","E01012700","Total",758,257,23,234,238,91,222,40,182
"2011","Blackpool 019C","E01012702","Total",766,450,24,426,132,56,328,27,301
"2011","Blackpool 019D","E01012725","Total",595,208,10,198,155,39,174,19,155
"2011","Blackpool 019E","E01012727","Total",653,223,10,213,178,59,177,23,154
"2011","Cheshire East 022A","E01018393","Total",839,229,9,220,219,68,194,29,165
"2011","Cheshire East 022B","E01018411","Total",934,313,5,308,284,79,185,27,158
"2011","Cheshire East 022C","E01018412","Total",660,264,8,256,146,46,182,21,161
"2011","Cheshire East 023A","E01018413","Total",503,131,7,124,186,50,94,20,74
"2011","Cheshire East 023B","E01018414","Total",624,248,2,246,134,35,151,15,136
"2011","Cheshire East 023C","E01018415","Total",774,345,17,328,183,71,235,21,214
"2011","Cheshire East 023D","E01018416","Total",518,137,3,134,162,38,84,11,73
"2011","Cheshire East 024A","E01018424","Total",731,184,8,176,213,66,141,20,121
"2011","Cheshire East 024B","E01018425","Total",748,287,10,277,152,59,241,29,212
"2011","Cheshire East 024C","E01018426","Total",727,309,18,291,174,56,220,21,199
"2011","Cheshire East 024D","E01018427","Total",504,113,9,104,153,41,102,16,86
"2011","Cheshire East 025A","E01018419","Total",535,84,9,75,204,64,110,25,85
"2011","Cheshire East 025B","E01018420","Total",716,117,11,106,324,124,140,43,97
"2011","Cheshire East 025C","E01018421","Total",539,114,18,96,195,84,95,18,77
"2011","Cheshire East 025D","E01018422","Total",542,180,20,160,188,63,120,24,96
"2011","Cheshire East 025E","E01018423","Total",629,256,30,226,184,81,212,35,177
"2011","Cheshire East 026A","E01018395","Total",701,232,16,216,174,72,168,23,145
"2011","Cheshire East 026B","E01018396","Total",609,242,28,214,196,64,197,33,164
"2011","Cheshire East 026C","E01018400","Total",977,391,64,327,280,128,329,51,278
"2011","Cheshire East 026D","E01018401","Total",610,198,45,153,216,101,157,38,119
"2011","Cheshire East 027A","E01018398","Total",735,299,24,275,171,74,246,24,222
"2011","Cheshire East 027B","E01018399","Total",690,218,9,209,183,68,173,18,155
"2011","Cheshire East 027C","E01018402","Total",942,294,33,261,184,75,239,33,206
"2011","Cheshire East 027D","E01018403","Total",825,259,12,247,217,80,190,31,159
"2011","Cheshire East 028A","E01018397","Total",726,162,10,152,265,108,121,26,95
"2011","Cheshire East 028B","E01018408","Total",756,258,4,254,197,64,180,18,162
"2011","Cheshire East 028C","E01018409","Total",870,404,12,392,191,67,278,23,255
"2011","Cheshire East 028D","E01018410","Total",653,259,6,253,166,48,172,16,156
"2011","Cheshire East 029A","E01018404","Total",611,206,4,202,162,55,152,23,129
"2011","Cheshire East 029B","E01018405","Total",600,131,7,124,162,75,112,12,100
"2011","Cheshire East 029C","E01018406","Total",613,217,7,210,174,53,126,18,108
"2011","Cheshire East 029D","E01018407","Total",643,215,5,210,165,53,146,15,131
"2011","Cheshire East 030A","E01018436","Total",611,239,4,235,140,36,140,8,132
"2011","Cheshire East 030B","E01018437","Total",753,274,27,247,181,79,196,22,174
"2011","Cheshire East 030C","E01018438","Total",619,256,7,249,139,35,171,25,146
"2011","Cheshire East 030D","E01018439","Total",557,245,3,242,139,38,133,13,120
"2011","Cheshire East 031A","E01018440","Total",724,146,12,134,269,109,127,28,99
"2011","Cheshire East 031B","E01018441","Total",654,94,14,80,300,110,110,32,78
"2011","Cheshire East 031C","E01018442","Total",753,217,21,196,257,87,170,39,131
"2011","Cheshire East 031D","E01018443","Total",639,193,1,192,176,53,158,28,130
"2011","Cheshire East 032A","E01018432","Total",648,245,14,231,179,56,184,29,155
"2011","Cheshire East 032B","E01018433","Total",586,252,5,247,112,27,167,12,155
"2011","Cheshire East 032C","E01018434","Total",623,224,13,211,137,51,140,17,123
"2011","Cheshire East 032D","E01018435","Total",673,301,29,272,168,54,237,30,207
"2011","Cheshire East 033A","E01018394","Total",815,210,14,196,238,87,185,35,150
"2011","Cheshire East 033B","E01018417","Total",734,320,11,309,139,45,213,16,197
"2011","Cheshire East 033C","E01018418","Total",661,215,14,201,149,43,180,22,158
"2011","Cheshire East 033D","E01018428","Total",625,234,14,220,166,59,184,28,156
"2011","Cheshire East 033E","E01018429","Total",660,249,15,234,166,46,210,27,183
"2011","Cheshire East 033F","E01018430","Total",577,157,13,144,170,53,133,25,108
"2011","Cheshire East 033G","E01018431","Total",512,126,5,121,134,29,107,14,93
"2011","Cheshire East 040A","E01018387","Total",736,346,6,340,166,35,184,21,163
"2011","Cheshire East 040B","E01018388","Total",745,338,39,299,189,66,252,41,211
"2011","Cheshire East 040C","E01018389","Total",729,290,9,281,197,59,213,27,186
"2011","Cheshire East 040D","E01018390","Total",757,321,13,308,178,61,228,37,191
"2011","Cheshire East 042A","E01018386","Total",629,278,8,270,133,48,194,22,172
"2011","Cheshire East 042B","E01018391","Total",812,276,25,251,274,108,196,31,165
"2011","Cheshire East 042C","E01018392","Total",775,240,9,231,235,65,174,37,137
"2011","Cheshire East 034A","E01018472","Total",659,168,18,150,151,72,166,27,139
"2011","Cheshire East 034B","E01018473","Total",657,91,15,76,262,99,110,24,86
"2011","Cheshire East 034C","E01018474","Total",670,79,10,69,280,96,122,38,84
"2011","Cheshire East 034D","E01018475","Total",632,40,3,37,314,103,98,44,54
"2011","Cheshire East 035A","E01018463","Total",627,208,39,169,199,89,193,39,154
"2011","Cheshire East 035B","E01018476","Total",513,218,84,134,226,113,160,50,110
"2011","Cheshire East 035C","E01018477","Total",627,267,41,226,201,84,214,39,175
"2011","Cheshire East 035D","E01018478","Total",527,192,57,135,217,86,166,38,128
"2011","Cheshire East 035E","E01018479","Total",704,228,17,211,202,94,189,29,160
"2011","Cheshire East 036A","E01018459","Total",510,211,74,137,228,109,145,35,110
"2011","Cheshire East 036B","E01018460","Total",622,271,26,245,159,66,181,25,156
"2011","Cheshire East 036C","E01018461","Total",628,267,36,231,173,70,207,31,176
"2011","Cheshire East 036D","E01018466","Total",1126,473,94,379,315,174,336,49,287
"2011","Cheshire East 036E","E01018467","Total",996,308,80,228,312,170,229,39,190
"2011","Cheshire East 037A","E01018482","Total",639,268,29,239,159,65,221,30,191
"2011","Cheshire East 037B","E01018483","Total",631,248,23,225,129,63,189,18,171
"2011","Cheshire East 037C","E01018484","Total",901,334,116,218,403,204,248,74,174
"2011","Cheshire East 037D","E01018485","Total",633,248,62,186,227,103,186,53,133
"2011","Cheshire East 038A","E01018499","Total",711,215,8,207,199,87,167,25,142
"2011","Cheshire East 038B","E01018500","Total",529,179,3,176,123,48,135,21,114
"2011","Cheshire East 038C","E01018501","Total",766,354,8,346,145,49,248,17,231
"2011","Cheshire East 038D","E01018502","Total",543,231,4,227,92,18,145,17,128
"2011","Cheshire East 039A","E01018462","Total",715,278,52,226,190,103,203,32,171
"2011","Cheshire East 039B","E01018464","Total",650,189,18,171,157,73,149,19,130
"2011","Cheshire East 039C","E01018496","Total",681,209,26,183,243,88,178,47,131
"2011","Cheshire East 039D","E01018497","Total",526,151,26,125,153,71,133,25,108
"2011","Cheshire East 039E","E01018498","Total",641,174,56,118,248,110,142,47,95
"2011","Cheshire East 041A","E01018465","Total",1172,340,25,315,339,116,269,46,223
"2011","Cheshire East 041B","E01018468","Total",640,172,10,162,215,62,130,31,99
"2011","Cheshire East 041C","E01018469","Total",646,224,5,219,180,60,192,28,164
"2011","Cheshire East 041D","E01018470","Total",576,136,4,132,198,45,118,20,98
"2011","Cheshire East 041E","E01018471","Total",626,173,4,169,177,46,140,15,125
"2011","Cheshire East 043A","E01018486","Total",702,266,24,242,134,65,216,22,194
"2011","Cheshire East 043B","E01018487","Total",653,158,29,129,225,122,148,32,116
"2011","Cheshire East 043C","E01018488","Total",599,159,9,150,201,68,157,32,125
"2011","Cheshire East 043D","E01018489","Total",534,137,18,119,172,81,113,23,90
"2011","Cheshire East 044A","E01018510","Total",623,137,15,122,240,80,128,28,100
"2011","Cheshire East 044B","E01018511","Total",644,249,27,222,173,77,223,31,192
"2011","Cheshire East 044C","E01018512","Total",713,280,36,244,225,84,221,39,182
"2011","Cheshire East 044D","E01018513","Total",660,214,11,203,208,58,169,30,139
"2011","Cheshire East 045A","E01018445","Total",828,311,85,226,299,149,235,67,168
"2011","Cheshire East 045B","E01018446","Total",502,147,35,112,188,54,120,36,84
"2011","Cheshire East 045C","E01018447","Total",727,176,39,137,246,99,154,37,117
"2011","Cheshire East 045D","E01018448","Total",729,221,16,205,218,85,173,32,141
"2011","Cheshire East 046A","E01018490","Total",637,288,8,280,137,47,167,18,149
"2011","Cheshire East 046B","E01018491","Total",625,209,4,205,157,51,118,16,102
"2011","Cheshire East 046C","E01018492","Total",513,238,4,234,99,30,167,13,154
"2011","Cheshire East 046D","E01018505","Total",436,137,2,135,123,22,93,12,81
"2011","Cheshire East 046E","E01018506","Total",533,134,3,131,168,46,120,21,99
"2011","Cheshire East 046F","E01018507","Total",559,207,5,202,148,37,136,23,113
"2011","Cheshire East 047A","E01018451","Total",758,404,11,393,114,46,299,19,280
"2011","Cheshire East 047B","E01018454","Total",708,243,29,214,171,74,178,33,145
"2011","Cheshire East 047C","E01018455","Total",607,254,5,249,134,52,188,23,165
"2011","Cheshire East 047D","E01018456","Total",587,301,4,297,96,20,173,12,161
"2011","Cheshire East 047E","E01018457","Total",759,254,13,241,142,54,187,15,172
"2011","Cheshire East 049A","E01018444","Total",866,246,16,230,252,81,204,31,173
"2011","Cheshire East 049B","E01018480","Total",821,237,17,220,216,69,185,29,156
"2011","Cheshire East 049C","E01018515","Total",897,217,11,206,306,92,189,39,150
"2011","Cheshire East 049D","E01018516","Total",608,205,10,195,171,60,143,18,125
"2011","Cheshire East 049F","E01033375","Total",444,41,6,35,255,106,49,26,23
"2011","Cheshire East 049G","E01033376","Total",447,38,15,23,210,94,42,17,25
"2011","Cheshire East 049H","E01033378","Total",529,150,5,145,191,58,123,17,106
"2011","Cheshire East 048A","E01018493","Total",622,285,7,278,113,38,189,15,174
"2011","Cheshire East 048B","E01018494","Total",597,222,4,218,140,36,139,20,119
"2011","Cheshire East 048C","E01018495","Total",538,162,8,154,132,50,144,19,125
"2011","Cheshire East 048D","E01018508","Total",493,173,4,169,142,36,120,20,100
"2011","Cheshire East 048E","E01018509","Total",514,165,9,156,136,45,124,18,106
"2011","Cheshire East 050A","E01018452","Total",511,226,18,208,141,51,180,36,144
"2011","Cheshire East 050C","E01018503","Total",689,291,9,282,164,54,183,23,160
"2011","Cheshire East 050D","E01018504","Total",855,344,23,321,173,74,234,30,204
"2011","Cheshire East 050E","E01033372","Total",605,144,9,135,162,74,99,14,85
"2011","Cheshire East 050F","E01033373","Total",631,253,23,230,160,60,194,31,163
"2011","Cheshire East 051A","E01018449","Total",746,307,6,301,168,52,211,18,193
"2011","Cheshire East 051B","E01018450","Total",912,286,16,270,233,71,214,33,181
"2011","Cheshire East 051C","E01018458","Total",869,268,15,253,251,75,204,36,168
"2011","Cheshire East 051D","E01018481","Total",803,245,6,239,219,66,188,24,164
"2011","Cheshire East 051E","E01018514","Total",810,241,9,232,207,58,195,30,165
"2011","Cheshire East 001A","E01018585","Total",617,212,10,202,159,40,162,23,139
"2011","Cheshire East 001B","E01018586","Total",686,193,8,185,164,58,172,26,146
"2011","Cheshire East 001C","E01018587","Total",653,209,9,200,159,57,145,21,124
"2011","Cheshire East 001D","E01018661","Total",516,185,6,179,134,37,126,20,106
"2011","Cheshire East 002A","E01018657","Total",487,188,10,178,140,47,159,23,136
"2011","Cheshire East 002B","E01018662","Total",477,122,9,113,162,52,86,23,63
"2011","Cheshire East 002C","E01018663","Total",660,277,7,270,173,49,196,20,176
"2011","Cheshire East 002D","E01018664","Total",589,198,7,191,166,29,152,27,125
"2011","Cheshire East 002E","E01018665","Total",484,160,8,152,144,43,134,23,111
"2011","Cheshire East 003A","E01018655","Total",748,322,5,317,137,50,226,12,214
"2011","Cheshire East 003B","E01018656","Total",647,265,11,254,167,51,165,15,150
"2011","Cheshire East 003C","E01018658","Total",489,131,9,122,181,68,104,27,77
"2011","Cheshire East 003D","E01018659","Total",521,209,3,206,109,27,118,16,102
"2011","Cheshire East 003E","E01018660","Total",406,139,4,135,114,27,108,21,87
"2011","Cheshire East 004A","E01018582","Total",806,184,14,170,201,66,151,25,126
"2011","Cheshire East 004B","E01018592","Total",731,236,5,231,225,75,179,34,145
"2011","Cheshire East 004C","E01018593","Total",767,279,12,267,180,67,199,24,175
"2011","Cheshire East 004D","E01018594","Total",829,337,20,317,179,67,292,35,257
"2011","Cheshire East 004E","E01018595","Total",729,266,13,253,184,67,220,34,186
"2011","Cheshire East 004F","E01018596","Total",916,324,69,255,269,117,270,49,221
"2011","Cheshire East 005A","E01018583","Total",793,163,19,144,245,100,130,27,103
"2011","Cheshire East 005B","E01018584","Total",716,154,9,145,252,82,117,37,80
"2011","Cheshire East 005C","E01018612","Total",520,155,16,139,167,65,128,23,105
"2011","Cheshire East 005D","E01018613","Total",706,237,21,216,178,66,195,30,165
"2011","Cheshire East 006A","E01018600","Total",639,209,8,201,189,55,106,19,87
"2011","Cheshire East 006B","E01018601","Total",836,297,11,286,183,75,210,17,193
"2011","Cheshire East 006C","E01018602","Total",833,292,10,282,184,78,195,15,180
"2011","Cheshire East 006D","E01018652","Total",603,163,8,155,218,65,89,19,70
"2011","Cheshire East 007A","E01018598","Total",649,161,6,155,195,85,128,23,105
"2011","Cheshire East 007B","E01018599","Total",488,174,7,167,119,32,100,10,90
"2011","Cheshire East 007C","E01018648","Total",929,287,13,274,219,76,201,27,174
"2011","Cheshire East 007D","E01018649","Total",586,229,1,228,110,37,142,11,131
"2011","Cheshire East 007E","E01018650","Total",738,174,7,167,192,98,138,12,126
"2011","Cheshire East 007F","E01018651","Total",501,149,3,146,134,47,123,17,106
"2011","Cheshire East 007G","E01018654","Total",910,299,9,290,222,66,186,22,164
"2011","Cheshire East 008A","E01018588","Total",633,154,8,146,213,72,105,26,79
"2011","Cheshire East 008B","E01018589","Total",622,189,2,187,220,71,106,13,93
"2011","Cheshire East 008C","E01018590","Total",746,224,11,213,261,108,162,25,137
"2011","Cheshire East 008D","E01018653","Total",888,341,9,332,250,86,207,22,185
"2011","Cheshire East 009A","E01018605","Total",494,206,12,194,138,53,117,13,104
"2011","Cheshire East 009B","E01018609","Total",754,345,16,329,171,62,214,22,192
"2011","Cheshire East 009C","E01018610","Total",899,283,27,256,248,105,236,40,196
"2011","Cheshire East 009D","E01018611","Total",749,238,48,190,244,103,192,45,147
"2011","Cheshire East 011A","E01018666","Total",715,263,13,250,218,47,144,17,127
"2011","Cheshire East 011B","E01018667","Total",727,301,7,294,169,44,171,18,153
"2011","Cheshire East 011C","E01018668","Total",651,222,4,218,168,47,160,17,143
"2011","Cheshire East 010A","E01018603","Total",512,186,5,181,150,52,103,8,95
"2011","Cheshire East 010B","E01018604","Total",617,214,13,201,176,80,148,18,130
"2011","Cheshire East 010C","E01018606","Total",818,357,13,344,138,69,259,16,243
"2011","Cheshire East 010D","E01018607","Total",516,179,7,172,151,53,98,12,86
"2011","Cheshire East 010E","E01018608","Total",551,176,14,162,190,72,110,13,97
"2011","Cheshire East 012A","E01018572","Total",746,263,9,254,199,70,178,32,146
"2011","Cheshire East 012B","E01018573","Total",674,223,11,212,174,59,122,18,104
"2011","Cheshire East 012C","E01018574","Total",988,329,14,315,221,75,254,19,235
"2011","Cheshire East 012D","E01018580","Total",658,215,12,203,140,45,147,15,132
"2011","Cheshire East 012E","E01018581","Total",558,228,5,223,128,38,135,14,121
"2011","Cheshire East 013A","E01018575","Total",473,124,9,115,148,55,106,27,79
"2011","Cheshire East 013B","E01018576","Total",872,205,8,197,208,86,168,24,144
"2011","Cheshire East 013C","E01018577","Total",1118,363,24,339,275,125,283,33,250
"2011","Cheshire East 013D","E01018578","Total",486,135,5,130,142,44,110,15,95
"2011","Cheshire East 013E","E01018579","Total",488,198,24,174,126,41,150,17,133
"2011","Cheshire East 014A","E01018641","Total",499,150,4,146,158,51,87,18,69
"2011","Cheshire East 014B","E01018642","Total",535,123,7,116,212,60,90,23,67
"2011","Cheshire East 014C","E01018643","Total",721,180,7,173,286,68,126,31,95
"2011","Cheshire East 014D","E01018644","Total",647,247,9,238,142,52,109,12,97
"2011","Cheshire East 015A","E01018614","Total",829,194,11,183,268,102,129,23,106
"2011","Cheshire East 015B","E01018618","Total",601,188,41,147,238,91,175,51,124
"2011","Cheshire East 015C","E01018619","Total",570,134,11,123,217,67,100,18,82
"2011","Cheshire East 015D","E01018620","Total",580,193,32,161,186,64,155,32,123
"2011","Cheshire East 015E","E01018621","Total",560,157,5,152,161,47,121,16,105
"2011","Cheshire East 016A","E01018626","Total",1064,332,27,305,240,113,256,38,218
"2011","Cheshire East 016B","E01018628","Total",652,199,9,190,180,58,153,25,128
"2011","Cheshire East 016C","E01018629","Total",842,303,54,249,257,106,251,41,210
"2011","Cheshire East 016D","E01018630","Total",629,217,13,204,152,58,154,19,135
"2011","Cheshire East 016E","E01018631","Total",714,310,23,287,154,66,250,30,220
"2011","Cheshire East 017A","E01018615","Total",515,110,7,103,136,57,99,14,85
"2011","Cheshire East 017B","E01018616","Total",508,147,4,143,145,37,90,14,76
"2011","Cheshire East 017C","E01018617","Total",692,266,10,256,133,48,198,14,184
"2011","Cheshire East 017D","E01018632","Total",661,169,6,163,196,72,130,22,108
"2011","Cheshire East 017E","E01018633","Total",616,232,0,232,152,40,163,17,146
"2011","Cheshire East 018A","E01018622","Total",732,248,20,228,147,75,199,18,181
"2011","Cheshire East 018B","E01018623","Total",699,202,17,185,184,85,157,18,139
"2011","Cheshire East 018C","E01018624","Total",996,202,21,181,189,99,203,22,181
"2011","Cheshire East 018D","E01018625","Total",657,151,28,123,184,92,119,22,97
"2011","Cheshire East 018E","E01018627","Total",817,204,18,186,161,74,172,22,150
"2011","Cheshire East 018F","E01018635","Total",589,162,11,151,128,51,137,14,123
"2011","Cheshire East 018G","E01018636","Total",589,175,9,166,195,64,150,31,119
"2011","Cheshire East 019A","E01018634","Total",766,234,15,219,234,70,172,32,140
"2011","Cheshire East 019B","E01018645","Total",887,442,47,395,213,72,343,40,303
"2011","Cheshire East 019C","E01018646","Total",733,256,45,211,257,81,223,53,170
"2011","Cheshire East 019D","E01018647","Total",672,249,20,229,197,60,208,36,172
"2011","Cheshire East 020A","E01018591","Total",1029,396,12,384,223,58,287,33,254
"2011","Cheshire East 020B","E01018597","Total",1026,348,11,337,232,66,219,22,197
"2011","Cheshire East 020C","E01018669","Total",1104,321,11,310,295,96,256,29,227
"2011","Cheshire East 020D","E01018670","Total",1029,373,15,358,239,84,269,34,235
"2011","Cheshire East 021A","E01018637","Total",693,204,57,147,283,126,193,47,146
"2011","Cheshire East 021B","E01018638","Total",674,259,33,226,202,75,219,48,171
"2011","Cheshire East 021C","E01018639","Total",674,167,27,140,192,97,127,16,111
"2011","Cheshire East 021D","E01018640","Total",624,273,29,244,175,82,224,31,193
"2011","Cheshire West and Chester 022A","E01018308","Total",782,264,24,240,227,68,196,17,179
"2011","Cheshire West and Chester 022B","E01018336","Total",525,149,13,136,144,49,156,36,120
"2011","Cheshire West and Chester 022C","E01018337","Total",555,156,6,150,133,53,157,23,134
"2011","Cheshire West and Chester 022D","E01018338","Total",779,213,16,197,238,108,181,41,140
"2011","Cheshire West and Chester 022E","E01018358","Total",475,129,8,121,153,47,105,27,78
"2011","Cheshire West and Chester 022F","E01018359","Total",415,123,0,123,126,36,82,14,68
"2011","Cheshire West and Chester 025A","E01018360","Total",771,215,13,202,282,130,161,45,116
"2011","Cheshire West and Chester 025B","E01018366","Total",647,213,8,205,150,51,167,14,153
"2011","Cheshire West and Chester 025C","E01018367","Total",793,276,21,255,217,72,250,44,206
"2011","Cheshire West and Chester 027A","E01018364","Total",755,330,65,265,234,101,253,40,213
"2011","Cheshire West and Chester 027B","E01018365","Total",857,359,8,351,190,63,235,17,218
"2011","Cheshire West and Chester 027C","E01018378","Total",524,200,35,165,180,72,150,29,121
"2011","Cheshire West and Chester 027D","E01018379","Total",605,274,13,261,150,57,160,20,140
"2011","Cheshire West and Chester 027E","E01018380","Total",513,232,11,221,136,47,145,20,125
"2011","Cheshire West and Chester 028A","E01018362","Total",635,191,8,183,186,71,139,15,124
"2011","Cheshire West and Chester 028B","E01018363","Total",479,211,9,202,109,39,121,18,103
"2011","Cheshire West and Chester 028C","E01018374","Total",785,194,4,190,204,73,128,13,115
"2011","Cheshire West and Chester 028D","E01018375","Total",802,169,9,160,148,77,118,16,102
"2011","Cheshire West and Chester 028E","E01018376","Total",630,222,17,205,212,77,150,27,123
"2011","Cheshire West and Chester 028F","E01018377","Total",659,206,11,195,236,86,157,27,130
"2011","Cheshire West and Chester 029A","E01018309","Total",657,222,43,179,220,75,182,34,148
"2011","Cheshire West and Chester 029B","E01018310","Total",598,222,60,162,233,103,213,50,163
"2011","Cheshire West and Chester 029C","E01018311","Total",649,280,54,226,204,98,245,46,199
"2011","Cheshire West and Chester 029D","E01018312","Total",584,191,43,148,227,98,171,40,131
"2011","Cheshire West and Chester 031A","E01018313","Total",581,210,14,196,156,45,232,45,187
"2011","Cheshire West and Chester 031B","E01018314","Total",699,265,49,216,221,98,247,49,198
"2011","Cheshire West and Chester 031C","E01018315","Total",490,187,16,171,122,37,150,32,118
"2011","Cheshire West and Chester 031D","E01018316","Total",589,241,64,177,230,99,192,54,138
"2011","Cheshire West and Chester 031E","E01018317","Total",744,352,50,302,192,98,292,40,252
"2011","Cheshire West and Chester 030A","E01018349","Total",677,221,9,212,181,62,156,20,136
"2011","Cheshire West and Chester 030B","E01018350","Total",790,291,8,283,218,60,191,18,173
"2011","Cheshire West and Chester 030C","E01018368","Total",602,204,12,192,168,63,158,26,132
"2011","Cheshire West and Chester 030D","E01018370","Total",534,187,6,181,171,55,116,18,98
"2011","Cheshire West and Chester 032A","E01018345","Total",512,146,15,131,182,67,109,22,87
"2011","Cheshire West and Chester 032B","E01018346","Total",542,165,5,160,171,70,86,12,74
"2011","Cheshire West and Chester 032C","E01018347","Total",612,233,28,205,146,47,201,32,169
"2011","Cheshire West and Chester 032D","E01018383","Total",601,198,12,186,207,75,165,25,140
"2011","Cheshire West and Chester 032E","E01018384","Total",621,232,7,225,158,59,142,18,124
"2011","Cheshire West and Chester 033B","E01018327","Total",1176,461,31,430,141,73,340,18,322
"2011","Cheshire West and Chester 033C","E01018343","Total",786,230,18,212,113,57,172,14,158
"2011","Cheshire West and Chester 033D","E01018361","Total",609,156,10,146,154,83,107,12,95
"2011","Cheshire West and Chester 033E","E01032930","Total",1122,405,16,389,79,42,286,11,275
"2011","Cheshire West and Chester 033F","E01032931","Total",581,133,4,129,61,28,107,11,96
"2011","Cheshire West and Chester 034A","E01018326","Total",1175,425,15,410,86,45,311,13,298
"2011","Cheshire West and Chester 034B","E01018328","Total",466,106,8,98,69,34,72,10,62
"2011","Cheshire West and Chester 034C","E01018329","Total",1055,343,18,325,65,35,224,7,217
"2011","Cheshire West and Chester 034D","E01018330","Total",459,111,2,109,84,29,90,13,77
"2011","Cheshire West and Chester 034E","E01018331","Total",714,139,6,133,78,42,96,10,86
"2011","Cheshire West and Chester 036A","E01018319","Total",993,292,32,260,248,122,238,39,199
"2011","Cheshire West and Chester 036B","E01018344","Total",919,143,21,122,237,120,129,23,106
"2011","Cheshire West and Chester 036C","E01018381","Total",517,145,3,142,133,65,105,18,87
"2011","Cheshire West and Chester 036D","E01018382","Total",788,363,14,349,151,62,265,16,249
"2011","Cheshire West and Chester 039A","E01018323","Total",562,180,12,168,148,41,145,31,114
"2011","Cheshire West and Chester 039B","E01018324","Total",532,180,9,171,163,45,104,17,87
"2011","Cheshire West and Chester 039C","E01018325","Total",586,199,7,192,178,41,136,22,114
"2011","Cheshire West and Chester 039D","E01018385","Total",855,354,6,348,211,65,221,24,197
"2011","Cheshire West and Chester 041A","E01018320","Total",616,242,9,233,184,56,161,31,130
"2011","Cheshire West and Chester 041B","E01018321","Total",531,162,4,158,136,52,124,21,103
"2011","Cheshire West and Chester 041C","E01018322","Total",506,204,1,203,141,48,136,9,127
"2011","Cheshire West and Chester 041D","E01018348","Total",894,206,7,199,278,113,178,29,149
"2011","Cheshire West and Chester 043A","E01018332","Total",476,167,4,163,134,55,129,18,111
"2011","Cheshire West and Chester 043B","E01018333","Total",663,284,6,278,137,38,146,10,136
"2011","Cheshire West and Chester 043C","E01018334","Total",651,294,9,285,150,51,168,18,150
"2011","Cheshire West and Chester 043D","E01018340","Total",659,258,12,246,158,47,182,25,157
"2011","Cheshire West and Chester 043E","E01018341","Total",517,213,3,210,106,37,135,5,130
"2011","Cheshire West and Chester 043F","E01018342","Total",866,271,17,254,144,69,193,21,172
"2011","Cheshire West and Chester 044A","E01018351","Total",656,305,59,246,211,88,276,47,229
"2011","Cheshire West and Chester 044B","E01018352","Total",844,182,15,167,234,105,164,28,136
"2011","Cheshire West and Chester 044C","E01018353","Total",628,201,27,174,211,67,159,36,123
"2011","Cheshire West and Chester 044D","E01018354","Total",648,232,71,161,238,107,163,46,117
"2011","Cheshire West and Chester 046A","E01018335","Total",874,269,12,257,253,73,197,28,169
"2011","Cheshire West and Chester 046B","E01018369","Total",606,159,5,154,195,51,123,22,101
"2011","Cheshire West and Chester 046C","E01018371","Total",760,249,10,239,218,73,194,31,163
"2011","Cheshire West and Chester 046D","E01018372","Total",821,239,3,236,187,60,190,21,169
"2011","Cheshire West and Chester 047A","E01018339","Total",893,322,13,309,227,80,214,26,188
"2011","Cheshire West and Chester 047B","E01018355","Total",571,243,16,227,101,42,190,19,171
"2011","Cheshire West and Chester 047C","E01018356","Total",599,131,13,118,184,43,125,27,98
"2011","Cheshire West and Chester 047D","E01018357","Total",539,168,11,157,137,30,136,19,117
"2011","Cheshire West and Chester 047E","E01018373","Total",843,237,6,231,221,64,184,22,162
"2011","Cheshire West and Chester 001A","E01018534","Total",1195,485,61,424,333,154,359,59,300
"2011","Cheshire West and Chester 001B","E01018535","Total",628,263,21,242,161,58,212,32,180
"2011","Cheshire West and Chester 001C","E01018536","Total",743,282,13,269,179,63,174,26,148
"2011","Cheshire West and Chester 001D","E01018537","Total",896,410,6,404,154,46,236,15,221
"2011","Cheshire West and Chester 004A","E01018518","Total",671,250,3,247,133,34,141,18,123
"2011","Cheshire West and Chester 004B","E01018569","Total",545,212,4,208,126,35,103,7,96
"2011","Cheshire West and Chester 004C","E01018570","Total",521,198,4,194,121,31,142,16,126
"2011","Cheshire West and Chester 004D","E01018571","Total",630,267,7,260,127,39,184,16,168
"2011","Cheshire West and Chester 005A","E01018546","Total",646,253,44,209,189,67,230,44,186
"2011","Cheshire West and Chester 005B","E01018547","Total",608,231,14,217,145,50,161,22,139
"2011","Cheshire West and Chester 005C","E01018548","Total",702,280,26,254,179,58,212,40,172
"2011","Cheshire West and Chester 005D","E01018549","Total",656,269,11,258,137,42,202,19,183
"2011","Cheshire West and Chester 006A","E01018532","Total",853,369,26,343,213,68,285,35,250
"2011","Cheshire West and Chester 006B","E01018533","Total",623,240,8,232,147,51,163,23,140
"2011","Cheshire West and Chester 006C","E01018544","Total",645,235,7,228,165,49,168,27,141
"2011","Cheshire West and Chester 006D","E01018545","Total",827,288,5,283,204,65,204,28,176
"2011","Cheshire West and Chester 007A","E01018519","Total",670,214,55,159,199,106,173,36,137
"2011","Cheshire West and Chester 007B","E01018520","Total",492,154,35,119,151,76,144,25,119
"2011","Cheshire West and Chester 007C","E01018525","Total",525,186,58,128,222,84,157,44,113
"2011","Cheshire West and Chester 007D","E01018563","Total",1040,453,67,386,259,125,358,47,311
"2011","Cheshire West and Chester 007E","E01018564","Total",1119,410,69,341,288,135,333,51,282
"2011","Cheshire West and Chester 008A","E01018523","Total",600,248,44,204,204,80,205,39,166
"2011","Cheshire West and Chester 008B","E01018524","Total",604,266,71,195,252,97,234,66,168
"2011","Cheshire West and Chester 008C","E01018541","Total",626,221,21,200,150,70,192,35,157
"2011","Cheshire West and Chester 008D","E01018542","Total",494,190,64,126,234,97,151,53,98
"2011","Cheshire West and Chester 008E","E01018543","Total",604,235,33,202,176,82,193,26,167
"2011","Cheshire West and Chester 009A","E01018528","Total",496,146,7,139,134,46,122,16,106
"2011","Cheshire West and Chester 009B","E01018529","Total",648,244,3,241,144,38,205,24,181
"2011","Cheshire West and Chester 009C","E01018530","Total",563,101,6,95,230,70,88,25,63
"2011","Cheshire West and Chester 009D","E01018531","Total",667,221,6,215,175,61,167,24,143
"2011","Cheshire West and Chester 009E","E01018560","Total",471,110,3,107,132,42,95,11,84
"2011","Cheshire West and Chester 009F","E01018561","Total",475,102,6,96,161,46,88,18,70
"2011","Cheshire West and Chester 009G","E01018562","Total",524,79,10,69,244,75,83,27,56
"2011","Cheshire West and Chester 010A","E01018522","Total",591,237,35,202,180,63,217,36,181
"2011","Cheshire West and Chester 010B","E01018538","Total",451,172,35,137,162,55,126,26,100
"2011","Cheshire West and Chester 010C","E01018539","Total",482,185,39,146,146,59,173,31,142
"2011","Cheshire West and Chester 010D","E01018540","Total",611,203,20,183,175,61,151,28,123
"2011","Cheshire West and Chester 011A","E01018521","Total",501,211,40,171,168,55,188,32,156
"2011","Cheshire West and Chester 011B","E01018550","Total",481,186,55,131,164,63,161,27,134
"2011","Cheshire West and Chester 011C","E01018551","Total",694,271,43,228,200,96,233,33,200
"2011","Cheshire West and Chester 011D","E01018552","Total",641,230,47,183,211,79,176,50,126
"2011","Cheshire West and Chester 011E","E01018553","Total",686,318,40,278,186,83,245,44,201
"2011","Cheshire West and Chester 013A","E01018556","Total",635,272,17,255,149,50,179,23,156
"2011","Cheshire West and Chester 013B","E01018557","Total",662,306,29,277,173,69,252,30,222
"2011","Cheshire West and Chester 013C","E01018558","Total",500,78,12,66,181,66,98,22,76
"2011","Cheshire West and Chester 013D","E01018559","Total",468,144,7,137,138,44,125,15,110
"2011","Cheshire West and Chester 014A","E01018565","Total",618,222,8,214,181,49,166,26,140
"2011","Cheshire West and Chester 014B","E01018566","Total",592,263,8,255,117,33,180,26,154
"2011","Cheshire West and Chester 014C","E01018567","Total",590,200,6,194,149,38,161,22,139
"2011","Cheshire West and Chester 014D","E01018568","Total",575,65,8,57,264,113,67,27,40
"2011","Cheshire West and Chester 016A","E01018526","Total",666,223,5,218,188,62,171,26,145
"2011","Cheshire West and Chester 016B","E01018527","Total",654,174,6,168,210,62,135,33,102
"2011","Cheshire West and Chester 016C","E01018554","Total",993,295,4,291,263,82,215,26,189
"2011","Cheshire West and Chester 016D","E01018555","Total",479,115,4,111,144,52,93,18,75
"2011","Cheshire West and Chester 002A","E01018685","Total",601,290,26,264,140,48,227,29,198
"2011","Cheshire West and Chester 002B","E01018686","Total",603,134,22,112,201,78,112,22,90
"2011","Cheshire West and Chester 002C","E01018687","Total",585,248,4,244,141,39,131,17,114
"2011","Cheshire West and Chester 002D","E01018688","Total",692,252,8,244,178,60,158,19,139
"2011","Cheshire West and Chester 002E","E01018689","Total",676,307,17,290,145,55,206,14,192
"2011","Cheshire West and Chester 002F","E01018690","Total",868,297,7,290,215,62,184,29,155
"2011","Cheshire West and Chester 003A","E01018675","Total",871,271,7,264,228,75,204,33,171
"2011","Cheshire West and Chester 003B","E01018708","Total",889,303,10,293,210,69,215,28,187
"2011","Cheshire West and Chester 003C","E01018721","Total",921,266,14,252,231,67,208,27,181
"2011","Cheshire West and Chester 012A","E01018671","Total",513,171,7,164,131,47,113,15,98
"2011","Cheshire West and Chester 012B","E01018672","Total",667,243,35,208,206,78,214,39,175
"2011","Cheshire West and Chester 012C","E01018673","Total",522,162,15,147,139,49,132,17,115
"2011","Cheshire West and Chester 012D","E01018674","Total",691,201,23,178,201,84,182,22,160
"2011","Cheshire West and Chester 015A","E01018684","Total",927,284,3,281,245,66,204,35,169
"2011","Cheshire West and Chester 015B","E01018695","Total",738,198,13,185,217,87,159,21,138
"2011","Cheshire West and Chester 015C","E01018696","Total",626,247,8,239,163,42,152,23,129
"2011","Cheshire West and Chester 015D","E01018697","Total",779,278,10,268,232,56,237,35,202
"2011","Cheshire West and Chester 015E","E01018698","Total",814,287,5,282,208,59,197,21,176
"2011","Cheshire West and Chester 017A","E01018704","Total",541,225,13,212,128,49,153,15,138
"2011","Cheshire West and Chester 017B","E01018705","Total",620,156,10,146,202,74,127,27,100
"2011","Cheshire West and Chester 017C","E01018706","Total",526,134,15,119,161,63,115,22,93
"2011","Cheshire West and Chester 017D","E01018718","Total",671,170,14,156,188,68,137,26,111
"2011","Cheshire West and Chester 017E","E01018722","Total",941,308,12,296,236,82,231,34,197
"2011","Cheshire West and Chester 018A","E01018713","Total",1144,317,38,279,382,174,268,41,227
"2011","Cheshire West and Chester 018B","E01018714","Total",890,351,51,300,217,110,275,34,241
"2011","Cheshire West and Chester 018C","E01018715","Total",766,219,46,173,248,121,175,29,146
"2011","Cheshire West and Chester 019A","E01018726","Total",613,237,32,205,182,60,187,38,149
"2011","Cheshire West and Chester 019B","E01018727","Total",749,302,14,288,145,40,206,19,187
"2011","Cheshire West and Chester 019C","E01018728","Total",636,199,16,183,208,75,201,38,163
"2011","Cheshire West and Chester 019D","E01018729","Total",757,330,24,306,202,80,269,41,228
"2011","Cheshire West and Chester 020A","E01018709","Total",669,165,27,138,194,97,147,27,120
"2011","Cheshire West and Chester 020B","E01018710","Total",579,181,41,140,193,68,179,43,136
"2011","Cheshire West and Chester 020C","E01018711","Total",730,192,15,177,171,64,145,21,124
"2011","Cheshire West and Chester 020D","E01018712","Total",752,255,19,236,169,66,223,29,194
"2011","Cheshire West and Chester 021A","E01018699","Total",653,185,17,168,232,84,152,36,116
"2011","Cheshire West and Chester 021B","E01018701","Total",622,268,37,231,198,78,218,51,167
"2011","Cheshire West and Chester 021C","E01018716","Total",641,278,43,235,190,88,225,40,185
"2011","Cheshire West and Chester 021D","E01018717","Total",766,201,38,163,237,110,184,36,148
"2011","Cheshire West and Chester 021E","E01018719","Total",639,201,22,179,207,74,199,40,159
"2011","Cheshire West and Chester 021F","E01018720","Total",668,254,31,223,212,74,223,39,184
"2011","Cheshire West and Chester 023A","E01018691","Total",700,278,17,261,196,70,199,28,171
"2011","Cheshire West and Chester 023B","E01018693","Total",626,172,5,167,196,59,125,21,104
"2011","Cheshire West and Chester 023C","E01018694","Total",635,215,5,210,196,54,145,21,124
"2011","Cheshire West and Chester 023D","E01018700","Total",761,103,8,95,353,112,77,30,47
"2011","Cheshire West and Chester 023E","E01018702","Total",481,82,9,73,212,68,64,19,45
"2011","Cheshire West and Chester 023F","E01018703","Total",828,165,10,155,213,78,136,19,117
"2011","Cheshire West and Chester 024A","E01018676","Total",642,264,2,262,134,42,169,19,150
"2011","Cheshire West and Chester 024B","E01018677","Total",648,244,4,240,121,31,157,9,148
"2011","Cheshire West and Chester 024C","E01018678","Total",510,209,6,203,135,31,99,18,81
"2011","Cheshire West and Chester 024D","E01018679","Total",725,244,21,223,221,78,203,34,169
"2011","Cheshire West and Chester 024E","E01018692","Total",793,234,2,232,236,64,175,24,151
"2011","Cheshire West and Chester 026A","E01018680","Total",647,170,4,166,203,61,136,25,111
"2011","Cheshire West and Chester 026B","E01018681","Total",627,212,18,194,173,80,179,31,148
"2011","Cheshire West and Chester 026C","E01018682","Total",491,196,9,187,132,44,139,18,121
"2011","Cheshire West and Chester 026D","E01018683","Total",643,218,8,210,161,66,149,17,132
"2011","Cheshire West and Chester 035A","E01018733","Total",611,218,12,206,142,48,176,19,157
"2011","Cheshire West and Chester 035B","E01018734","Total",530,203,24,179,145,57,176,26,150
"2011","Cheshire West and Chester 035C","E01018748","Total",507,227,99,128,255,110,160,53,107
"2011","Cheshire West and Chester 035D","E01018749","Total",951,153,42,111,422,182,166,70,96
"2011","Cheshire West and Chester 037A","E01018736","Total",657,173,27,146,233,94,163,30,133
"2011","Cheshire West and Chester 037B","E01018737","Total",534,109,7,102,191,66,106,23,83
"2011","Cheshire West and Chester 037C","E01018743","Total",625,181,13,168,175,62,171,28,143
"2011","Cheshire West and Chester 037D","E01018744","Total",680,219,33,186,271,89,204,56,148
"2011","Cheshire West and Chester 038A","E01018732","Total",554,161,21,140,161,73,141,29,112
"2011","Cheshire West and Chester 038B","E01018745","Total",708,317,59,258,220,87,251,57,194
"2011","Cheshire West and Chester 038C","E01018746","Total",708,259,24,235,193,62,221,35,186
"2011","Cheshire West and Chester 038D","E01018747","Total",657,211,25,186,190,66,200,27,173
"2011","Cheshire West and Chester 040A","E01018730","Total",635,270,22,248,170,64,230,43,187
"2011","Cheshire West and Chester 040B","E01018738","Total",560,305,109,196,267,129,217,62,155
"2011","Cheshire West and Chester 040C","E01018739","Total",575,212,62,150,234,114,174,45,129
"2011","Cheshire West and Chester 040D","E01018741","Total",527,194,9,185,122,42,151,19,132
"2011","Cheshire West and Chester 042A","E01018731","Total",676,192,37,155,229,93,157,39,118
"2011","Cheshire West and Chester 042B","E01018735","Total",540,129,18,111,169,68,110,16,94
"2011","Cheshire West and Chester 042C","E01018740","Total",608,248,69,179,241,108,176,47,129
"2011","Cheshire West and Chester 042D","E01018742","Total",630,168,8,160,166,51,164,27,137
"2011","Cheshire West and Chester 045A","E01018707","Total",736,258,8,250,184,55,181,23,158
"2011","Cheshire West and Chester 045B","E01018723","Total",510,192,8,184,128,39,133,15,118
"2011","Cheshire West and Chester 045C","E01018724","Total",666,245,6,239,156,51,163,10,153
"2011","Cheshire West and Chester 045D","E01018725","Total",543,169,4,165,143,46,122,20,102
"2011","Halton 001A","E01012392","Total",910,158,15,143,350,125,160,41,119
"2011","Halton 001B","E01012393","Total",865,263,9,254,217,72,205,29,176
"2011","Halton 001C","E01012395","Total",620,235,8,227,136,41,162,22,140
"2011","Halton 001D","E01012411","Total",591,234,15,219,139,46,176,22,154
"2011","Halton 002A","E01012374","Total",1075,236,20,216,386,151,207,47,160
"2011","Halton 002B","E01012375","Total",559,127,6,121,212,55,120,35,85
"2011","Halton 002C","E01012376","Total",922,92,17,75,445,150,147,61,86
"2011","Halton 002D","E01012421","Total",536,132,9,123,155,39,142,31,111
"2011","Halton 002E","E01012423","Total",640,185,9,176,158,57,160,27,133
"2011","Halton 003A","E01012368","Total",849,348,48,300,245,116,301,41,260
"2011","Halton 003B","E01012410","Total",533,137,10,127,145,52,140,19,121
"2011","Halton 003C","E01012412","Total",684,270,36,234,191,108,211,18,193
"2011","Halton 003D","E01012413","Total",663,302,42,260,205,85,243,44,199
"2011","Halton 003E","E01012414","Total",504,149,14,135,145,52,129,24,105
"2011","Halton 004A","E01012377","Total",745,289,39,250,215,94,247,43,204
"2011","Halton 004B","E01012390","Total",678,310,41,269,185,60,231,35,196
"2011","Halton 004C","E01012419","Total",486,181,47,134,185,83,157,43,114
"2011","Halton 004D","E01012420","Total",746,390,58,332,195,77,295,46,249
"2011","Halton 004E","E01012422","Total",632,276,77,199,244,101,228,61,167
"2011","Halton 005A","E01012369","Total",619,242,32,210,186,68,225,42,183
"2011","Halton 005B","E01012394","Total",675,299,34,265,166,52,241,29,212
"2011","Halton 005C","E01012425","Total",692,289,53,236,211,89,215,34,181
"2011","Halton 005D","E01012426","Total",572,199,10,189,158,46,160,27,133
"2011","Halton 005E","E01012427","Total",649,174,42,132,268,104,162,42,120
"2011","Halton 006A","E01012378","Total",640,261,14,247,160,53,184,30,154
"2011","Halton 006B","E01012379","Total",634,203,29,174,196,76,172,34,138
"2011","Halton 006C","E01012380","Total",571,242,44,198,194,94,189,37,152
"2011","Halton 006D","E01012388","Total",730,293,84,209,271,115,201,49,152
"2011","Halton 006E","E01012442","Total",618,251,86,165,266,107,201,51,150
"2011","Halton 007A","E01012367","Total",776,357,68,289,202,99,273,50,223
"2011","Halton 007B","E01012370","Total",811,265,53,212,228,116,215,33,182
"2011","Halton 007C","E01012424","Total",761,359,108,251,263,116,255,54,201
"2011","Halton 007D","E01012441","Total",1078,479,112,367,326,161,334,66,268
"2011","Halton 008A","E01012389","Total",745,289,5,284,176,57,198,27,171
"2011","Halton 008B","E01012391","Total",975,357,61,296,270,143,295,56,239
"2011","Halton 008C","E01012401","Total",787,286,13,273,179,56,242,38,204
"2011","Halton 008D","E01012443","Total",601,137,25,112,213,83,146,40,106
"2011","Halton 009A","E01012385","Total",575,113,10,103,193,81,105,16,89
"2011","Halton 009B","E01012386","Total",661,47,8,39,331,120,95,34,61
"2011","Halton 009C","E01012387","Total",507,179,4,175,127,38,127,17,110
"2011","Halton 009D","E01012434","Total",601,116,10,106,213,80,129,21,108
"2011","Halton 009E","E01012435","Total",759,127,19,108,309,111,139,35,104
"2011","Halton 010A","E01012381","Total",656,331,70,261,162,73,258,46,212
"2011","Halton 010B","E01012382","Total",709,355,79,276,210,97,293,45,248
"2011","Halton 010C","E01012384","Total",748,341,25,316,149,68,286,30,256
"2011","Halton 010D","E01012444","Total",427,208,72,136,184,76,164,50,114
"2011","Halton 010E","E01012445","Total",553,270,68,202,172,72,219,46,173
"2011","Halton 011A","E01012398","Total",513,189,10,179,151,53,160,25,135
"2011","Halton 011B","E01012400","Total",507,156,15,141,163,69,126,34,92
"2011","Halton 011C","E01012402","Total",656,267,66,201,220,82,205,48,157
"2011","Halton 011D","E01012404","Total",577,183,30,153,190,64,151,32,119
"2011","Halton 011E","E01012405","Total",836,296,39,257,254,88,235,43,192
"2011","Halton 012A","E01012416","Total",774,299,16,283,219,86,231,38,193
"2011","Halton 012B","E01012417","Total",577,187,44,143,180,70,155,38,117
"2011","Halton 012C","E01012428","Total",1024,298,46,252,277,142,258,40,218
"2011","Halton 012D","E01012429","Total",627,258,41,217,191,80,199,30,169
"2011","Halton 012E","E01012430","Total",884,372,96,276,236,127,284,44,240
"2011","Halton 012F","E01012431","Total",1011,277,50,227,264,122,232,33,199
"2011","Halton 013A","E01012383","Total",756,321,35,286,201,75,268,36,232
"2011","Halton 013B","E01012396","Total",600,283,66,217,216,82,215,44,171
"2011","Halton 013C","E01012397","Total",679,330,83,247,242,132,257,54,203
"2011","Halton 013D","E01012399","Total",639,291,49,242,203,90,233,44,189
"2011","Halton 013E","E01012403","Total",647,297,97,200,268,114,216,65,151
"2011","Halton 013F","E01012408","Total",739,333,135,198,335,139,270,99,171
"2011","Halton 014A","E01012432","Total",666,197,41,156,187,76,168,31,137
"2011","Halton 014B","E01012433","Total",690,286,87,199,247,131,213,57,156
"2011","Halton 014C","E01012436","Total",504,209,109,100,257,117,160,63,97
"2011","Halton 014D","E01012438","Total",535,279,79,200,168,74,216,43,173
"2011","Halton 014E","E01012440","Total",524,112,18,94,179,71,116,27,89
"2011","Halton 015A","E01012406","Total",673,283,51,232,224,89,266,56,210
"2011","Halton 015B","E01012407","Total",758,359,67,292,213,86,284,47,237
"2011","Halton 015C","E01012409","Total",633,294,48,246,179,70,216,31,185
"2011","Halton 015D","E01012437","Total",539,184,61,123,205,75,178,41,137
"2011","Halton 015E","E01012439","Total",642,274,71,203,210,91,229,47,182
"2011","Halton 016A","E01012371","Total",526,123,11,112,145,50,97,16,81
"2011","Halton 016B","E01012372","Total",507,142,4,138,103,31,101,15,86
"2011","Halton 016C","E01012373","Total",538,163,3,160,118,48,131,21,110
"2011","Halton 016D","E01012415","Total",545,137,10,127,152,57,151,23,128
"2011","Halton 016E","E01012418","Total",618,278,5,273,130,28,165,20,145
"2011","Warrington 001A","E01012471","Total",507,176,8,168,161,35,118,19,99
"2011","Warrington 001B","E01012472","Total",740,244,14,230,220,71,145,24,121
"2011","Warrington 001C","E01012476","Total",668,211,11,200,173,64,163,19,144
"2011","Warrington 001D","E01012477","Total",610,192,5,187,219,57,127,25,102
"2011","Warrington 002A","E01012473","Total",678,306,8,298,177,52,185,25,160
"2011","Warrington 002B","E01012474","Total",611,239,24,215,179,67,178,27,151
"2011","Warrington 002C","E01012475","Total",643,213,18,195,214,63,166,27,139
"2011","Warrington 002D","E01012554","Total",840,245,19,226,229,65,179,28,151
"2011","Warrington 003A","E01012467","Total",522,215,4,211,102,31,170,25,145
"2011","Warrington 003B","E01012468","Total",914,245,11,234,341,136,191,44,147
"2011","Warrington 003C","E01012469","Total",624,178,8,170,184,61,153,32,121
"2011","Warrington 003D","E01012470","Total",497,208,27,181,141,44,180,27,153
"2011","Warrington 004A","E01012460","Total",629,194,44,150,196,89,184,39,145
"2011","Warrington 004B","E01012462","Total",633,169,8,161,153,48,156,15,141
"2011","Warrington 004C","E01012463","Total",506,194,2,192,92,27,132,18,114
"2011","Warrington 004D","E01012464","Total",599,190,23,167,175,73,169,32,137
"2011","Warrington 005A","E01012459","Total",622,217,35,182,172,71,180,27,153
"2011","Warrington 005B","E01012461","Total",535,104,4,100,171,60,106,23,83
"2011","Warrington 005C","E01012465","Total",608,151,13,138,160,63,148,24,124
"2011","Warrington 005D","E01012466","Total",707,251,53,198,225,102,233,50,183
"2011","Warrington 006A","E01012526","Total",654,258,98,160,297,139,204,69,135
"2011","Warrington 006B","E01012534","Total",655,256,65,191,235,109,222,45,177
"2011","Warrington 006C","E01012535","Total",701,251,68,183,271,119,195,47,148
"2011","Warrington 006D","E01012537","Total",702,310,53,257,220,90,237,39,198
"2011","Warrington 006E","E01012539","Total",697,276,35,241,227,88,208,40,168
"2011","Warrington 007A","E01012538","Total",619,109,4,105,161,55,129,16,113
"2011","Warrington 007B","E01012540","Total",587,179,3,176,170,49,161,34,127
"2011","Warrington 007C","E01012541","Total",516,122,16,106,169,67,138,38,100
"2011","Warrington 007D","E01012542","Total",633,246,19,227,132,49,175,21,154
"2011","Warrington 007E","E01012543","Total",595,206,7,199,137,49,142,17,125
"2011","Warrington 007F","E01012544","Total",588,192,20,172,151,59,163,30,133
"2011","Warrington 008A","E01012521","Total",654,229,30,199,188,66,186,32,154
"2011","Warrington 008B","E01012522","Total",613,250,32,218,177,71,205,31,174
"2011","Warrington 008C","E01012533","Total",554,237,94,143,246,128,152,52,100
"2011","Warrington 008D","E01012536","Total",631,229,36,193,196,81,195,30,165
"2011","Warrington 008E","E01012545","Total",703,311,77,234,255,107,225,37,188
"2011","Warrington 008F","E01012546","Total",682,267,73,194,271,117,201,50,151
"2011","Warrington 009A","E01012561","Total",678,154,10,144,215,95,161,18,143
"2011","Warrington 009B","E01012562","Total",610,72,8,64,277,81,107,33,74
"2011","Warrington 009C","E01012567","Total",641,63,8,55,309,98,81,35,46
"2011","Warrington 009D","E01012568","Total",963,89,6,83,424,165,100,39,61
"2011","Warrington 010A","E01012563","Total",635,119,5,114,241,59,142,31,111
"2011","Warrington 010B","E01012564","Total",526,93,8,85,173,46,105,18,87
"2011","Warrington 010C","E01012565","Total",932,177,24,153,404,162,200,59,141
"2011","Warrington 010D","E01012566","Total",729,96,13,83,371,154,110,41,69
"2011","Warrington 010E","E01012569","Total",703,113,11,102,299,105,108,34,74
"2011","Warrington 010F","E01012570","Total",604,269,24,245,135,51,216,17,199
"2011","Warrington 011A","E01012481","Total",714,184,32,152,238,96,167,47,120
"2011","Warrington 011B","E01012482","Total",869,428,34,394,185,77,321,27,294
"2011","Warrington 011C","E01012520","Total",638,287,54,233,201,89,236,48,188
"2011","Warrington 011D","E01012523","Total",621,192,27,165,189,79,162,32,130
"2011","Warrington 011E","E01012524","Total",627,196,9,187,177,49,157,26,131
"2011","Warrington 011F","E01012525","Total",635,188,32,156,221,102,167,39,128
"2011","Warrington 012A","E01012478","Total",617,195,14,181,177,60,174,28,146
"2011","Warrington 012B","E01012547","Total",682,198,10,188,218,78,180,27,153
"2011","Warrington 012C","E01012548","Total",703,172,4,168,235,77,166,28,138
"2011","Warrington 012D","E01012549","Total",639,279,5,274,131,39,188,12,176
"2011","Warrington 012E","E01012550","Total",702,271,6,265,181,60,175,20,155
"2011","Warrington 013A","E01012453","Total",654,266,85,181,273,116,224,61,163
"2011","Warrington 013B","E01012454","Total",859,230,46,184,298,147,212,52,160
"2011","Warrington 013C","E01012455","Total",876,397,109,288,327,168,303,71,232
"2011","Warrington 013D","E01012457","Total",777,235,41,194,214,120,186,29,157
"2011","Warrington 014A","E01012551","Total",598,131,5,126,204,63,129,26,103
"2011","Warrington 014B","E01012552","Total",619,247,11,236,144,57,192,23,169
"2011","Warrington 014C","E01012553","Total",499,77,0,77,182,49,91,21,70
"2011","Warrington 014D","E01012555","Total",525,136,5,131,168,44,111,20,91
"2011","Warrington 014E","E01012556","Total",621,223,7,216,155,47,165,21,144
"2011","Warrington 015A","E01012491","Total",621,241,11,230,170,49,202,31,171
"2011","Warrington 015B","E01012492","Total",609,236,6,230,166,40,153,13,140
"2011","Warrington 015C","E01012493","Total",669,156,4,152,240,106,131,22,109
"2011","Warrington 015D","E01012494","Total",649,112,10,102,247,72,117,34,83
"2011","Warrington 015E","E01012500","Total",593,188,4,184,131,39,135,21,114
"2011","Warrington 016A","E01012495","Total",643,98,4,94,259,86,101,25,76
"2011","Warrington 016B","E01012496","Total",585,185,8,177,161,54,164,26,138
"2011","Warrington 016C","E01012497","Total",516,161,21,140,155,58,155,30,125
"2011","Warrington 016D","E01012498","Total",656,209,23,186,192,76,198,32,166
"2011","Warrington 016E","E01012499","Total",739,114,12,102,300,134,145,35,110
"2011","Warrington 016F","E01012501","Total",603,158,10,148,184,78,142,26,116
"2011","Warrington 017A","E01012479","Total",793,305,49,256,209,101,224,35,189
"2011","Warrington 017B","E01012480","Total",921,278,26,252,188,104,202,27,175
"2011","Warrington 017D","E01012510","Total",868,304,29,275,193,87,256,40,216
"2011","Warrington 017E","E01012511","Total",786,205,42,163,214,99,158,35,123
"2011","Warrington 017F","E01033299","Total",971,155,49,106,296,176,118,34,84
"2011","Warrington 017G","E01033303","Total",591,184,37,147,164,84,148,21,127
"2011","Warrington 018B","E01012458","Total",1011,252,56,196,360,199,224,47,177
"2011","Warrington 018C","E01012483","Total",883,410,49,361,199,93,328,37,291
"2011","Warrington 018D","E01012509","Total",882,324,15,309,163,76,218,25,193
"2011","Warrington 018E","E01012512","Total",739,311,9,302,135,47,224,17,207
"2011","Warrington 018F","E01033300","Total",613,183,10,173,58,38,136,13,123
"2011","Warrington 018G","E01033302","Total",740,231,40,191,192,112,188,26,162
"2011","Warrington 019A","E01012527","Total",622,202,8,194,177,61,177,22,155
"2011","Warrington 019B","E01012528","Total",500,192,5,187,121,35,127,18,109
"2011","Warrington 019C","E01012529","Total",599,206,12,194,161,48,141,17,124
"2011","Warrington 019D","E01012530","Total",529,147,8,139,188,56,109,22,87
"2011","Warrington 019E","E01012531","Total",675,284,12,272,171,64,207,23,184
"2011","Warrington 019F","E01012532","Total",601,269,7,262,139,39,184,21,163
"2011","Warrington 020A","E01012504","Total",753,201,55,146,266,115,159,45,114
"2011","Warrington 020B","E01012505","Total",652,239,29,210,181,69,173,20,153
"2011","Warrington 020C","E01012506","Total",668,230,47,183,215,81,197,47,150
"2011","Warrington 020D","E01012507","Total",943,282,31,251,225,111,223,32,191
"2011","Warrington 020E","E01012508","Total",715,298,39,259,195,86,249,40,209
"2011","Warrington 021A","E01012513","Total",805,233,11,222,279,107,149,20,129
"2011","Warrington 021B","E01012514","Total",737,185,8,177,280,93,143,32,111
"2011","Warrington 021C","E01012515","Total",659,235,16,219,184,70,182,24,158
"2011","Warrington 021D","E01012516","Total",589,205,5,200,154,52,130,14,116
"2011","Warrington 021E","E01012517","Total",900,193,8,185,325,126,146,22,124
"2011","Warrington 021F","E01012518","Total",846,233,28,205,289,98,182,33,149
"2011","Warrington 021G","E01012519","Total",635,224,7,217,184,61,167,20,147
"2011","Warrington 022A","E01012485","Total",660,200,22,178,239,78,134,21,113
"2011","Warrington 022B","E01012486","Total",631,197,6,191,184,71,147,24,123
"2011","Warrington 022C","E01012487","Total",652,200,9,191,205,66,147,21,126
"2011","Warrington 022D","E01012489","Total",681,202,10,192,262,80,122,25,97
"2011","Warrington 022E","E01012490","Total",629,242,3,239,167,44,152,16,136
"2011","Warrington 023A","E01012450","Total",633,281,5,276,139,37,196,11,185
"2011","Warrington 023B","E01012451","Total",648,245,25,220,218,75,215,32,183
"2011","Warrington 023C","E01012557","Total",755,198,10,188,185,82,148,19,129
"2011","Warrington 023D","E01012558","Total",749,187,10,177,257,97,127,16,111
"2011","Warrington 023E","E01012559","Total",593,172,7,165,196,75,121,21,100
"2011","Warrington 023F","E01012560","Total",631,239,8,231,183,74,165,22,143
"2011","Warrington 024A","E01012448","Total",498,114,8,106,172,42,90,15,75
"2011","Warrington 024B","E01012488","Total",716,265,9,256,203,60,149,21,128
"2011","Warrington 024C","E01012502","Total",629,164,5,159,230,75,120,21,99
"2011","Warrington 024D","E01012503","Total",559,101,8,93,218,71,88,14,74
"2011","Warrington 025A","E01012446","Total",527,122,2,120,178,34,107,17,90
"2011","Warrington 025B","E01012447","Total",494,83,2,81,255,51,79,30,49
"2011","Warrington 025C","E01012449","Total",641,287,2,285,128,27,178,14,164
"2011","Warrington 025D","E01012452","Total",732,272,7,265,204,53,124,16,108
"2011","Allerdale 001A","E01019126","Total",755,335,42,293,178,61,233,30,203
"2011","Allerdale 001B","E01019127","Total",707,332,3,329,115,34,236,24,212
"2011","Allerdale 001C","E01019132","Total",728,203,11,192,179,51,171,25,146
"2011","Allerdale 001D","E01019134","Total",670,280,14,266,160,48,184,18,166
"2011","Allerdale 001E","E01019135","Total",676,266,32,234,202,67,223,39,184
"2011","Allerdale 001F","E01019136","Total",648,197,15,182,221,74,144,30,114
"2011","Allerdale 001G","E01019137","Total",521,221,14,207,112,47,183,22,161
"2011","Allerdale 002A","E01019083","Total",784,261,7,254,159,47,163,21,142
"2011","Allerdale 002B","E01019107","Total",683,234,13,221,169,54,183,26,157
"2011","Allerdale 002C","E01019130","Total",697,218,9,209,179,59,183,31,152
"2011","Allerdale 002D","E01019131","Total",781,217,4,213,202,49,181,25,156
"2011","Allerdale 003A","E01019081","Total",825,314,42,272,240,101,273,40,233
"2011","Allerdale 003B","E01019082","Total",677,256,14,242,155,65,209,21,188
"2011","Allerdale 003C","E01019102","Total",734,249,22,227,192,65,188,30,158
"2011","Allerdale 003D","E01019128","Total",681,212,14,198,175,54,199,36,163
"2011","Allerdale 003E","E01019133","Total",663,196,5,191,171,48,149,23,126
"2011","Allerdale 004A","E01019093","Total",646,203,24,179,191,79,162,22,140
"2011","Allerdale 004B","E01019094","Total",721,272,17,255,198,66,218,33,185
"2011","Allerdale 004C","E01019096","Total",979,387,17,370,239,91,248,31,217
"2011","Allerdale 004D","E01019114","Total",625,210,13,197,171,46,164,30,134
"2011","Allerdale 004E","E01019115","Total",784,324,19,305,156,54,263,22,241
"2011","Allerdale 005A","E01019095","Total",680,292,49,243,208,93,237,41,196
"2011","Allerdale 005B","E01019097","Total",758,376,75,301,248,96,270,51,219
"2011","Allerdale 005C","E01019098","Total",711,262,36,226,207,87,204,30,174
"2011","Allerdale 005D","E01019099","Total",749,303,42,261,202,88,252,39,213
"2011","Allerdale 006A","E01019084","Total",653,207,16,191,214,81,174,34,140
"2011","Allerdale 006B","E01019085","Total",616,160,8,152,195,53,157,33,124
"2011","Allerdale 006C","E01019086","Total",460,156,1,155,125,38,107,10,97
"2011","Allerdale 006D","E01019088","Total",949,369,12,357,149,51,269,14,255
"2011","Allerdale 006E","E01019091","Total",776,233,11,222,224,60,152,24,128
"2011","Allerdale 007A","E01019078","Total",659,234,3,231,173,61,180,27,153
"2011","Allerdale 007B","E01019079","Total",645,248,14,234,164,56,164,18,146
"2011","Allerdale 007C","E01019080","Total",835,301,37,264,236,86,234,46,188
"2011","Allerdale 007D","E01019087","Total",699,255,7,248,177,49,171,22,149
"2011","Allerdale 007E","E01019090","Total",675,216,5,211,134,33,153,14,139
"2011","Allerdale 008A","E01019116","Total",611,234,23,211,133,51,173,21,152
"2011","Allerdale 008B","E01019118","Total",661,183,18,165,173,81,140,14,126
"2011","Allerdale 008C","E01019122","Total",668,321,52,269,191,78,232,39,193
"2011","Allerdale 008D","E01019123","Total",667,263,22,241,203,85,210,33,177
"2011","Allerdale 008E","E01019124","Total",840,242,3,239,268,90,212,32,180
"2011","Allerdale 008F","E01019125","Total",694,250,9,241,177,59,182,20,162
"2011","Allerdale 009A","E01019111","Total",687,292,62,230,219,91,224,44,180
"2011","Allerdale 009B","E01019112","Total",760,368,69,299,224,98,286,50,236
"2011","Allerdale 009C","E01019113","Total",837,410,74,336,255,99,318,53,265
"2011","Allerdale 009D","E01019120","Total",812,246,23,223,217,83,218,35,183
"2011","Allerdale 009E","E01019121","Total",1036,441,39,402,219,78,354,36,318
"2011","Allerdale 010A","E01019108","Total",629,243,47,196,211,91,214,35,179
"2011","Allerdale 010B","E01019109","Total",752,301,57,244,245,101,211,42,169
"2011","Allerdale 010C","E01019110","Total",865,424,62,362,225,91,283,41,242
"2011","Allerdale 010D","E01019117","Total",579,165,8,157,138,64,142,16,126
"2011","Allerdale 010E","E01019119","Total",636,263,3,260,142,36,166,24,142
"2011","Allerdale 011A","E01019089","Total",710,254,18,236,176,78,219,42,177
"2011","Allerdale 011B","E01019100","Total",718,240,4,236,185,64,185,31,154
"2011","Allerdale 011C","E01019101","Total",619,230,5,225,149,46,158,21,137
"2011","Allerdale 011D","E01019129","Total",702,229,3,226,174,64,165,17,148
"2011","Allerdale 012A","E01019092","Total",642,238,0,238,142,41,152,17,135
"2011","Allerdale 012B","E01019103","Total",516,151,6,145,151,53,135,21,114
"2011","Allerdale 012C","E01019104","Total",699,343,14,329,109,39,227,14,213
"2011","Allerdale 012D","E01019105","Total",525,168,5,163,89,34,132,11,121
"2011","Allerdale 012E","E01019106","Total",630,268,10,258,137,44,164,29,135
"2011","Barrow-in-Furness 001A","E01019144","Total",590,220,15,205,171,44,177,31,146
"2011","Barrow-in-Furness 001B","E01019145","Total",837,256,15,241,264,87,244,54,190
"2011","Barrow-in-Furness 001C","E01019146","Total",583,188,7,181,156,51,159,24,135
"2011","Barrow-in-Furness 001D","E01019147","Total",670,200,26,174,222,76,185,45,140
"2011","Barrow-in-Furness 002A","E01019148","Total",603,203,4,199,148,44,147,19,128
"2011","Barrow-in-Furness 002B","E01019149","Total",653,190,15,175,189,59,169,23,146
"2011","Barrow-in-Furness 002C","E01019150","Total",739,284,20,264,197,72,226,31,195
"2011","Barrow-in-Furness 002D","E01019151","Total",623,265,26,239,170,54,192,32,160
"2011","Barrow-in-Furness 003A","E01019152","Total",461,182,3,179,121,36,118,12,106
"2011","Barrow-in-Furness 003B","E01019153","Total",460,175,1,174,127,28,129,19,110
"2011","Barrow-in-Furness 003C","E01019154","Total",615,342,6,336,85,18,222,10,212
"2011","Barrow-in-Furness 003D","E01019155","Total",680,400,2,398,78,26,237,12,225
"2011","Barrow-in-Furness 003E","E01019162","Total",630,232,6,226,181,56,184,26,158
"2011","Barrow-in-Furness 003F","E01019163","Total",504,170,3,167,157,41,119,20,99
"2011","Barrow-in-Furness 004A","E01019156","Total",766,424,44,380,165,70,377,38,339
"2011","Barrow-in-Furness 004B","E01019159","Total",505,180,30,150,142,51,156,28,128
"2011","Barrow-in-Furness 004C","E01019164","Total",609,305,105,200,247,90,243,72,171
"2011","Barrow-in-Furness 004D","E01019165","Total",659,267,37,230,169,72,245,37,208
"2011","Barrow-in-Furness 004E","E01019166","Total",650,247,26,221,169,70,241,38,203
"2011","Barrow-in-Furness 005A","E01019167","Total",723,209,22,187,192,67,182,24,158
"2011","Barrow-in-Furness 005B","E01019168","Total",613,226,8,218,160,41,197,27,170
"2011","Barrow-in-Furness 005C","E01019169","Total",515,153,6,147,167,53,136,28,108
"2011","Barrow-in-Furness 005D","E01019170","Total",506,131,18,113,198,43,117,30,87
"2011","Barrow-in-Furness 005E","E01019171","Total",633,199,32,167,174,72,166,35,131
"2011","Barrow-in-Furness 006A","E01019161","Total",694,254,29,225,243,92,195,45,150
"2011","Barrow-in-Furness 006B","E01019176","Total",708,265,7,258,180,49,211,31,180
"2011","Barrow-in-Furness 006C","E01019177","Total",598,233,49,184,207,84,190,41,149
"2011","Barrow-in-Furness 006D","E01019178","Total",704,222,6,216,165,67,194,21,173
"2011","Barrow-in-Furness 006E","E01019179","Total",520,163,6,157,137,35,134,11,123
"2011","Barrow-in-Furness 007A","E01019140","Total",483,228,62,166,168,82,181,43,138
"2011","Barrow-in-Furness 007B","E01019160","Total",617,294,42,252,189,63,277,54,223
"2011","Barrow-in-Furness 007C","E01019172","Total",641,231,43,188,171,71,190,49,141
"2011","Barrow-in-Furness 007D","E01019173","Total",619,238,38,200,179,80,204,36,168
"2011","Barrow-in-Furness 007E","E01019174","Total",472,186,49,137,160,54,153,39,114
"2011","Barrow-in-Furness 007F","E01019175","Total",594,227,36,191,181,50,200,35,165
"2011","Barrow-in-Furness 008A","E01019141","Total",692,369,58,311,148,69,277,37,240
"2011","Barrow-in-Furness 008B","E01019142","Total",701,284,71,213,204,114,237,46,191
"2011","Barrow-in-Furness 008C","E01019143","Total",718,342,62,280,186,84,271,51,220
"2011","Barrow-in-Furness 008D","E01019157","Total",743,332,63,269,186,86,253,43,210
"2011","Barrow-in-Furness 008E","E01019158","Total",568,227,53,174,176,95,178,34,144
"2011","Barrow-in-Furness 009A","E01019180","Total",942,497,13,484,152,46,367,29,338
"2011","Barrow-in-Furness 009C","E01019182","Total",625,216,13,203,158,59,189,20,169
"2011","Barrow-in-Furness 009E","E01019184","Total",633,236,24,212,170,69,202,39,163
"2011","Barrow-in-Furness 009F","E01033160","Total",888,370,43,327,275,115,358,64,294
"2011","Barrow-in-Furness 010A","E01019138","Total",609,236,19,217,140,56,203,23,180
"2011","Barrow-in-Furness 010B","E01019139","Total",856,446,49,397,132,54,355,27,328
"2011","Barrow-in-Furness 010C","E01019185","Total",614,236,9,227,160,58,184,28,156
"2011","Barrow-in-Furness 010D","E01019186","Total",601,226,22,204,156,69,184,19,165
"2011","Barrow-in-Furness 010E","E01019187","Total",557,226,20,206,151,50,187,27,160
"2011","Carlisle 001A","E01019226","Total",481,125,11,114,121,38,140,19,121
"2011","Carlisle 001B","E01019227","Total",674,283,16,267,129,54,230,17,213
"2011","Carlisle 001C","E01019228","Total",658,187,14,173,154,51,174,20,154
"2011","Carlisle 001D","E01019229","Total",816,231,11,220,182,46,252,46,206
"2011","Carlisle 002A","E01019200","Total",727,284,11,273,157,42,192,23,169
"2011","Carlisle 002B","E01019201","Total",668,278,15,263,155,47,199,31,168
"2011","Carlisle 002C","E01019202","Total",710,251,23,228,209,82,189,30,159
"2011","Carlisle 002D","E01019225","Total",843,228,12,216,216,55,209,27,182
"2011","Carlisle 003A","E01019188","Total",651,222,26,196,187,73,183,36,147
"2011","Carlisle 003B","E01019189","Total",666,173,26,147,225,89,171,42,129
"2011","Carlisle 003C","E01019190","Total",693,296,5,291,145,45,190,22,168
"2011","Carlisle 003D","E01019191","Total",689,245,6,239,158,53,186,22,164
"2011","Carlisle 003E","E01019244","Total",636,227,5,222,169,67,167,23,144
"2011","Carlisle 004A","E01019196","Total",837,255,24,231,214,97,212,30,182
"2011","Carlisle 004B","E01019238","Total",595,197,1,196,146,51,143,20,123
"2011","Carlisle 004C","E01019240","Total",715,203,9,194,210,75,172,35,137
"2011","Carlisle 004D","E01019241","Total",679,244,8,236,184,64,155,28,127
"2011","Carlisle 004E","E01019243","Total",637,219,3,216,174,57,155,22,133
"2011","Carlisle 004F","E01019251","Total",754,253,6,247,186,67,167,25,142
"2011","Carlisle 005A","E01019192","Total",621,223,4,219,169,54,135,19,116
"2011","Carlisle 005B","E01019195","Total",551,150,14,136,162,69,128,24,104
"2011","Carlisle 005C","E01019203","Total",871,264,8,256,220,65,209,24,185
"2011","Carlisle 005D","E01019254","Total",601,203,4,199,138,38,169,16,153
"2011","Carlisle 005E","E01019255","Total",553,136,5,131,157,49,125,19,106
"2011","Carlisle 006A","E01019204","Total",618,159,11,148,82,37,140,15,125
"2011","Carlisle 006B","E01019206","Total",785,232,10,222,107,36,192,18,174
"2011","Carlisle 006C","E01019234","Total",899,405,20,385,111,44,310,17,293
"2011","Carlisle 006D","E01019235","Total",674,196,11,185,170,77,156,26,130
"2011","Carlisle 006E","E01019237","Total",610,179,15,164,157,59,144,22,122
"2011","Carlisle 006F","E01019242","Total",615,238,11,227,134,48,194,27,167
"2011","Carlisle 007A","E01019219","Total",940,278,5,273,221,63,207,23,184
"2011","Carlisle 007B","E01019224","Total",897,302,17,285,226,59,237,35,202
"2011","Carlisle 007C","E01019239","Total",623,145,7,138,191,68,143,24,119
"2011","Carlisle 007D","E01019249","Total",672,262,4,258,132,38,146,9,137
"2011","Carlisle 007E","E01019250","Total",588,165,5,160,134,41,125,15,110
"2011","Carlisle 008A","E01019205","Total",834,286,42,244,214,108,214,35,179
"2011","Carlisle 008B","E01019207","Total",689,233,46,187,192,80,185,32,153
"2011","Carlisle 008C","E01019215","Total",742,257,33,224,160,71,204,25,179
"2011","Carlisle 008D","E01019218","Total",617,185,41,144,203,82,152,46,106
"2011","Carlisle 008E","E01019233","Total",637,301,10,291,125,48,178,11,167
"2011","Carlisle 009A","E01019193","Total",662,312,79,233,231,110,229,48,181
"2011","Carlisle 009B","E01019194","Total",864,224,51,173,314,147,188,52,136
"2011","Carlisle 009C","E01019230","Total",799,372,31,341,164,68,265,26,239
"2011","Carlisle 009D","E01019231","Total",826,434,19,415,141,56,344,33,311
"2011","Carlisle 009E","E01019232","Total",651,244,16,228,162,60,197,24,173
"2011","Carlisle 009F","E01019252","Total",673,311,20,291,132,55,227,22,205
"2011","Carlisle 010A","E01019209","Total",683,216,15,201,178,76,191,32,159
"2011","Carlisle 010B","E01019211","Total",850,149,18,131,224,110,155,23,132
"2011","Carlisle 010C","E01019216","Total",848,261,20,241,156,82,207,27,180
"2011","Carlisle 010D","E01019217","Total",915,234,24,210,208,90,183,22,161
"2011","Carlisle 010E","E01019220","Total",708,187,10,177,176,79,168,19,149
"2011","Carlisle 010F","E01019236","Total",752,200,31,169,178,95,168,31,137
"2011","Carlisle 011A","E01019197","Total",887,408,90,318,301,155,321,53,268
"2011","Carlisle 011B","E01019198","Total",637,216,30,186,186,76,181,24,157
"2011","Carlisle 011C","E01019199","Total",494,197,44,153,151,92,155,32,123
"2011","Carlisle 011D","E01019221","Total",862,273,56,217,292,131,226,47,179
"2011","Carlisle 011E","E01019222","Total",734,286,35,251,230,117,232,43,189
"2011","Carlisle 011F","E01019245","Total",666,310,69,241,222,101,216,49,167
"2011","Carlisle 012A","E01019208","Total",624,217,53,164,238,98,168,40,128
"2011","Carlisle 012B","E01019210","Total",588,229,67,162,234,91,159,48,111
"2011","Carlisle 012C","E01019246","Total",621,310,23,287,143,63,239,32,207
"2011","Carlisle 012D","E01019247","Total",656,261,21,240,169,63,209,32,177
"2011","Carlisle 012E","E01019248","Total",518,218,45,173,187,79,172,37,135
"2011","Carlisle 013A","E01019212","Total",640,230,6,224,147,34,152,20,132
"2011","Carlisle 013B","E01019213","Total",1155,295,7,288,329,125,253,32,221
"2011","Carlisle 013C","E01019214","Total",826,336,7,329,170,56,256,23,233
"2011","Carlisle 013D","E01019223","Total",669,256,13,243,148,45,183,22,161
"2011","Carlisle 013E","E01019253","Total",768,246,6,240,208,76,179,29,150
"2011","Copeland 001A","E01019268","Total",489,190,12,178,109,43,138,23,115
"2011","Copeland 001B","E01019269","Total",680,282,49,233,201,90,232,36,196
"2011","Copeland 001C","E01019270","Total",594,202,29,173,173,78,162,25,137
"2011","Copeland 001D","E01019297","Total",546,152,14,138,180,57,121,25,96
"2011","Copeland 002A","E01019260","Total",635,175,24,151,183,64,171,28,143
"2011","Copeland 002B","E01019280","Total",1030,584,14,570,74,35,426,10,416
"2011","Copeland 002C","E01019281","Total",569,254,14,240,111,38,182,23,159
"2011","Copeland 002D","E01019282","Total",501,144,11,133,151,49,159,27,132
"2011","Copeland 003A","E01019261","Total",686,189,4,185,210,71,127,28,99
"2011","Copeland 003B","E01019262","Total",726,172,6,166,207,84,141,13,128
"2011","Copeland 003C","E01019284","Total",582,255,22,233,160,68,190,27,163
"2011","Copeland 003D","E01019285","Total",645,206,47,159,224,92,170,43,127
"2011","Copeland 003E","E01019286","Total",630,266,7,259,135,50,195,20,175
"2011","Copeland 003F","E01019287","Total",510,159,1,158,143,56,118,17,101
"2011","Copeland 003G","E01019288","Total",546,134,5,129,202,63,86,15,71
"2011","Copeland 004A","E01019256","Total",660,188,10,178,163,55,152,27,125
"2011","Copeland 004B","E01019263","Total",491,224,36,188,135,53,156,25,131
"2011","Copeland 004C","E01019264","Total",701,228,17,211,230,77,180,36,144
"2011","Copeland 004D","E01019265","Total",612,274,22,252,129,43,218,29,189
"2011","Copeland 004E","E01019266","Total",642,202,24,178,178,64,166,26,140
"2011","Copeland 004F","E01019267","Total",603,283,34,249,175,64,227,34,193
"2011","Copeland 004G","E01019276","Total",447,147,8,139,105,27,117,15,102
"2011","Copeland 004H","E01019277","Total",552,278,47,231,154,53,203,24,179
"2011","Copeland 004I","E01019278","Total",570,193,12,181,157,46,159,28,131
"2011","Copeland 005A","E01019291","Total",599,213,29,184,166,71,222,42,180
"2011","Copeland 005B","E01019292","Total",504,187,16,171,115,33,152,21,131
"2011","Copeland 005C","E01019294","Total",619,245,29,216,165,64,209,28,181
"2011","Copeland 005D","E01019295","Total",609,258,84,174,262,131,182,56,126
"2011","Copeland 005E","E01019296","Total",595,226,21,205,170,67,193,29,164
"2011","Copeland 005F","E01019301","Total",634,326,101,225,232,120,238,62,176
"2011","Copeland 005G","E01019302","Total",423,137,19,118,124,46,120,25,95
"2011","Copeland 006A","E01019271","Total",582,240,41,199,185,67,195,35,160
"2011","Copeland 006B","E01019272","Total",609,230,46,184,208,82,185,41,144
"2011","Copeland 006C","E01019273","Total",687,202,13,189,189,56,177,30,147
"2011","Copeland 006D","E01019274","Total",790,322,28,294,166,66,223,24,199
"2011","Copeland 006E","E01019275","Total",937,344,21,323,255,74,249,41,208
"2011","Copeland 007A","E01019257","Total",643,264,21,243,163,53,181,27,154
"2011","Copeland 007B","E01019258","Total",666,207,8,199,153,46,136,20,116
"2011","Copeland 007C","E01019279","Total",644,248,4,244,118,43,165,18,147
"2011","Copeland 007D","E01019300","Total",737,215,9,206,213,67,160,29,131
"2011","Copeland 007E","E01019303","Total",654,229,9,220,171,58,175,33,142
"2011","Copeland 007F","E01019304","Total",582,221,5,216,110,34,180,16,164
"2011","Copeland 008A","E01019259","Total",584,206,10,196,112,42,158,13,145
"2011","Copeland 008B","E01019283","Total",574,233,9,224,126,45,188,17,171
"2011","Copeland 008C","E01019289","Total",598,252,19,233,171,47,175,32,143
"2011","Copeland 008D","E01019290","Total",463,153,20,133,138,51,120,20,100
"2011","Copeland 008E","E01019293","Total",571,212,2,210,109,36,148,17,131
"2011","Copeland 008F","E01019298","Total",682,287,17,270,169,55,190,28,162
"2011","Copeland 008G","E01019299","Total",903,357,42,315,236,98,276,41,235
"2011","Eden 001A","E01019305","Total",996,356,27,329,220,66,286,36,250
"2011","Eden 001B","E01019314","Total",531,171,11,160,127,36,127,10,117
"2011","Eden 001C","E01019320","Total",600,156,4,152,169,52,152,29,123
"2011","Eden 001D","E01019321","Total",644,169,4,165,174,52,157,27,130
"2011","Eden 002A","E01019315","Total",732,226,5,221,179,43,192,33,159
"2011","Eden 002B","E01019316","Total",528,129,5,124,153,46,120,20,100
"2011","Eden 002C","E01019322","Total",625,219,7,212,156,45,158,25,133
"2011","Eden 002D","E01019338","Total",608,154,4,150,162,40,146,21,125
"2011","Eden 003A","E01019327","Total",667,238,12,226,159,73,189,29,160
"2011","Eden 003B","E01019332","Total",663,287,11,276,140,56,233,25,208
"2011","Eden 003C","E01019333","Total",536,193,22,171,124,55,140,21,119
"2011","Eden 003D","E01019335","Total",656,154,8,146,201,65,184,27,157
"2011","Eden 003E","E01019336","Total",832,204,18,186,194,85,197,27,170
"2011","Eden 004A","E01019312","Total",635,249,2,247,131,50,169,15,154
"2011","Eden 004B","E01019326","Total",696,237,11,226,179,58,163,21,142
"2011","Eden 004C","E01019328","Total",533,177,11,166,153,50,126,18,108
"2011","Eden 004D","E01019329","Total",501,181,4,177,112,30,111,11,100
"2011","Eden 004E","E01019330","Total",656,186,4,182,154,59,156,21,135
"2011","Eden 004F","E01019331","Total",666,209,8,201,174,70,169,23,146
"2011","Eden 004G","E01019334","Total",624,250,3,247,141,53,159,15,144
"2011","Eden 005A","E01019308","Total",620,203,8,195,150,50,150,18,132
"2011","Eden 005B","E01019311","Total",637,217,4,213,144,47,146,16,130
"2011","Eden 005C","E01019313","Total",639,230,1,229,121,40,155,16,139
"2011","Eden 005D","E01019339","Total",595,190,6,184,121,43,115,14,101
"2011","Eden 006A","E01019306","Total",651,294,13,281,111,45,196,12,184
"2011","Eden 006B","E01019307","Total",764,244,9,235,207,63,176,27,149
"2011","Eden 006C","E01019310","Total",574,165,6,159,136,38,125,15,110
"2011","Eden 006D","E01019319","Total",640,174,13,161,191,63,161,36,125
"2011","Eden 006E","E01019323","Total",538,162,4,158,119,31,148,20,128
"2011","Eden 006F","E01019324","Total",532,155,3,152,140,52,109,16,93
"2011","Eden 006G","E01019337","Total",620,210,7,203,147,46,156,23,133
"2011","Eden 007A","E01019309","Total",982,279,10,269,247,74,228,38,190
"2011","Eden 007B","E01019317","Total",549,181,5,176,121,50,139,16,123
"2011","Eden 007C","E01019318","Total",621,248,26,222,143,53,200,26,174
"2011","Eden 007D","E01019325","Total",589,160,9,151,149,50,167,27,140
"2011","Eden 007E","E01019340","Total",563,166,3,163,129,34,127,19,108
"2011","South Lakeland 001A","E01019374","Total",708,226,12,214,159,58,173,17,156
"2011","South Lakeland 001B","E01019375","Total",690,335,3,332,79,18,204,8,196
"2011","South Lakeland 001C","E01019376","Total",576,200,6,194,99,40,139,14,125
"2011","South Lakeland 001D","E01019395","Total",950,462,10,452,135,48,291,21,270
"2011","South Lakeland 002A","E01019387","Total",960,361,14,347,211,66,243,30,213
"2011","South Lakeland 002B","E01019396","Total",937,357,10,347,204,59,257,39,218
"2011","South Lakeland 002C","E01019397","Total",899,307,12,295,188,81,166,22,144
"2011","South Lakeland 002D","E01019398","Total",481,131,18,113,160,61,129,25,104
"2011","South Lakeland 002E","E01019399","Total",461,172,7,165,133,27,121,19,102
"2011","South Lakeland 003A","E01019346","Total",849,288,17,271,181,69,231,27,204
"2011","South Lakeland 003B","E01019359","Total",953,332,25,307,242,94,280,35,245
"2011","South Lakeland 003C","E01019365","Total",1006,285,7,278,235,80,241,38,203
"2011","South Lakeland 003D","E01019370","Total",1057,325,11,314,261,105,233,34,199
"2011","South Lakeland 004A","E01019360","Total",1059,354,14,340,179,72,234,22,212
"2011","South Lakeland 004B","E01019363","Total",949,333,26,307,205,98,254,26,228
"2011","South Lakeland 004C","E01019364","Total",841,266,28,238,256,97,248,46,202
"2011","South Lakeland 004D","E01019371","Total",934,289,42,247,296,129,238,46,192
"2011","South Lakeland 005A","E01019358","Total",790,275,5,270,201,75,183,17,166
"2011","South Lakeland 005B","E01019362","Total",900,333,5,328,217,62,250,34,216
"2011","South Lakeland 005C","E01019366","Total",781,274,6,268,192,70,184,20,164
"2011","South Lakeland 005D","E01019394","Total",926,220,2,218,248,59,198,42,156
"2011","South Lakeland 006A","E01019361","Total",797,261,5,256,216,75,183,28,155
"2011","South Lakeland 006B","E01019367","Total",1091,326,21,305,307,126,250,36,214
"2011","South Lakeland 006C","E01019368","Total",840,194,3,191,290,98,164,42,122
"2011","South Lakeland 006D","E01019369","Total",869,372,6,366,178,55,248,21,227
"2011","South Lakeland 007A","E01019356","Total",684,249,5,244,110,38,180,20,160
"2011","South Lakeland 007B","E01019381","Total",923,276,11,265,199,75,196,23,173
"2011","South Lakeland 007C","E01019386","Total",797,283,8,275,141,42,190,14,176
"2011","South Lakeland 008A","E01019344","Total",468,156,4,152,100,33,121,6,115
"2011","South Lakeland 008B","E01019345","Total",530,192,0,192,107,32,160,17,143
"2011","South Lakeland 008C","E01019350","Total",735,263,4,259,127,39,190,15,175
"2011","South Lakeland 008D","E01019351","Total",760,231,7,224,173,38,160,22,138
"2011","South Lakeland 009A","E01019372","Total",557,231,3,228,89,33,150,11,139
"2011","South Lakeland 009B","E01019373","Total",543,189,7,182,122,37,114,19,95
"2011","South Lakeland 009C","E01019384","Total",973,319,3,316,193,59,238,19,219
"2011","South Lakeland 009D","E01019385","Total",588,208,8,200,113,44,167,17,150
"2011","South Lakeland 010A","E01019348","Total",518,181,3,178,139,50,119,15,104
"2011","South Lakeland 010B","E01019352","Total",902,227,9,218,242,76,185,34,151
"2011","South Lakeland 010C","E01019377","Total",805,339,6,333,144,43,202,13,189
"2011","South Lakeland 010D","E01019383","Total",882,381,7,374,173,49,254,27,227
"2011","South Lakeland 011A","E01019341","Total",752,372,1,371,94,31,200,12,188
"2011","South Lakeland 011B","E01019342","Total",508,273,3,270,87,25,173,10,163
"2011","South Lakeland 011C","E01019343","Total",668,287,4,283,119,30,188,18,170
"2011","South Lakeland 011D","E01019347","Total",781,236,17,219,207,83,188,27,161
"2011","South Lakeland 011E","E01019382","Total",947,316,23,293,254,84,270,44,226
"2011","South Lakeland 012A","E01019388","Total",774,313,19,294,200,58,237,31,206
"2011","South Lakeland 012B","E01019389","Total",1005,317,59,258,325,129,280,62,218
"2011","South Lakeland 012C","E01019390","Total",960,341,12,329,211,72,247,30,217
"2011","South Lakeland 012D","E01019392","Total",1006,420,15,405,181,70,336,25,311
"2011","South Lakeland 013A","E01019349","Total",822,314,9,305,166,46,211,20,191
"2011","South Lakeland 013B","E01019353","Total",695,302,11,291,146,42,208,24,184
"2011","South Lakeland 013C","E01019354","Total",737,439,5,434,73,22,261,6,255
"2011","South Lakeland 013D","E01019355","Total",659,407,3,404,56,14,210,8,202
"2011","South Lakeland 013E","E01019357","Total",831,294,9,285,193,72,245,33,212
"2011","South Lakeland 014A","E01019378","Total",688,232,9,223,188,60,199,27,172
"2011","South Lakeland 014B","E01019379","Total",633,267,7,260,124,41,180,21,159
"2011","South Lakeland 014C","E01019380","Total",474,178,7,171,102,37,123,13,110
"2011","South Lakeland 014D","E01019391","Total",739,277,11,266,200,62,209,30,179
"2011","South Lakeland 014E","E01019393","Total",904,419,6,413,163,53,240,24,216
"2011","Bolton 001A","E01004768","Total",605,153,4,149,218,73,106,27,79
"2011","Bolton 001B","E01004803","Total",709,211,7,204,195,65,154,33,121
"2011","Bolton 001C","E01004804","Total",602,171,3,168,171,52,124,25,99
"2011","Bolton 001D","E01004807","Total",543,90,9,81,223,55,92,36,56
"2011","Bolton 001E","E01004808","Total",687,185,7,178,199,69,131,19,112
"2011","Bolton 002A","E01004788","Total",609,252,4,248,145,44,148,18,130
"2011","Bolton 002B","E01004790","Total",644,237,12,225,165,56,172,20,152
"2011","Bolton 002C","E01004805","Total",676,230,12,218,206,53,141,22,119
"2011","Bolton 002D","E01004806","Total",650,282,9,273,180,45,202,30,172
"2011","Bolton 002E","E01004810","Total",626,159,10,149,228,56,125,25,100
"2011","Bolton 003A","E01004769","Total",685,205,1,204,183,67,153,26,127
"2011","Bolton 003B","E01004770","Total",616,244,7,237,164,64,170,23,147
"2011","Bolton 003C","E01004771","Total",636,187,4,183,211,78,160,29,131
"2011","Bolton 003D","E01004773","Total",852,239,18,221,239,92,188,45,143
"2011","Bolton 003E","E01004809","Total",893,325,19,306,205,70,250,22,228
"2011","Bolton 004A","E01004777","Total",705,240,38,202,210,92,194,36,158
"2011","Bolton 004B","E01004881","Total",748,363,21,342,144,77,266,18,248
"2011","Bolton 004C","E01004888","Total",554,163,13,150,181,46,157,37,120
"2011","Bolton 004D","E01004889","Total",608,224,28,196,203,69,181,42,139
"2011","Bolton 004E","E01004890","Total",673,227,14,213,155,54,170,23,147
"2011","Bolton 005A","E01004766","Total",795,320,25,295,188,78,259,36,223
"2011","Bolton 005B","E01004767","Total",768,255,16,239,181,85,187,30,157
"2011","Bolton 005C","E01004772","Total",731,275,68,207,274,110,224,58,166
"2011","Bolton 005D","E01004774","Total",706,214,42,172,234,98,190,48,142
"2011","Bolton 005E","E01004824","Total",496,151,40,111,259,120,142,51,91
"2011","Bolton 006A","E01004784","Total",508,174,4,170,136,46,124,16,108
"2011","Bolton 006B","E01004785","Total",641,243,17,226,158,63,187,23,164
"2011","Bolton 006C","E01004786","Total",648,266,14,252,180,53,204,37,167
"2011","Bolton 006D","E01004789","Total",591,207,4,203,154,54,151,24,127
"2011","Bolton 006E","E01004791","Total",607,250,8,242,133,49,173,19,154
"2011","Bolton 006F","E01004792","Total",642,276,1,275,142,47,166,22,144
"2011","Bolton 007A","E01004779","Total",588,125,24,101,230,93,132,38,94
"2011","Bolton 007B","E01004781","Total",792,187,21,166,253,128,163,34,129
"2011","Bolton 007C","E01004882","Total",594,191,13,178,180,46,198,41,157
"2011","Bolton 007D","E01004883","Total",627,164,19,145,187,61,141,27,114
"2011","Bolton 007E","E01004884","Total",685,265,4,261,127,45,171,25,146
"2011","Bolton 008A","E01004864","Total",697,226,19,207,194,77,184,26,158
"2011","Bolton 008B","E01004867","Total",632,202,44,158,222,109,160,43,117
"2011","Bolton 008C","E01004921","Total",737,273,21,252,181,65,209,35,174
"2011","Bolton 008D","E01004924","Total",604,170,4,166,198,49,130,20,110
"2011","Bolton 008E","E01004925","Total",646,214,5,209,186,67,175,29,146
"2011","Bolton 009A","E01004778","Total",517,197,4,193,117,37,135,19,116
"2011","Bolton 009B","E01004780","Total",871,224,14,210,255,97,187,30,157
"2011","Bolton 009C","E01004782","Total",494,190,10,180,130,54,159,21,138
"2011","Bolton 009D","E01004783","Total",636,203,5,198,166,48,171,26,145
"2011","Bolton 010A","E01004802","Total",750,344,88,256,293,108,246,59,187
"2011","Bolton 010B","E01004926","Total",510,218,73,145,216,75,185,52,133
"2011","Bolton 010C","E01004927","Total",1008,477,98,379,279,145,320,52,268
"2011","Bolton 010D","E01004929","Total",867,324,52,272,267,110,251,46,205
"2011","Bolton 011A","E01004820","Total",645,310,71,239,237,107,248,54,194
"2011","Bolton 011B","E01004825","Total",631,285,59,226,225,129,210,45,165
"2011","Bolton 011C","E01004826","Total",634,236,65,171,255,130,209,66,143
"2011","Bolton 011D","E01004865","Total",653,256,21,235,163,79,218,34,184
"2011","Bolton 011E","E01004866","Total",780,413,76,337,244,119,327,53,274
"2011","Bolton 012A","E01004840","Total",715,253,24,229,201,58,173,28,145
"2011","Bolton 012B","E01004841","Total",669,304,88,216,283,122,241,69,172
"2011","Bolton 012C","E01004842","Total",732,298,8,290,199,67,205,22,183
"2011","Bolton 012D","E01004919","Total",656,220,13,207,187,64,170,25,145
"2011","Bolton 012E","E01004920","Total",658,263,36,227,196,71,211,31,180
"2011","Bolton 013A","E01004787","Total",778,362,72,290,243,108,258,48,210
"2011","Bolton 013B","E01004793","Total",658,333,81,252,215,89,244,54,190
"2011","Bolton 013C","E01004794","Total",678,303,102,201,294,140,214,60,154
"2011","Bolton 013D","E01004795","Total",700,317,37,280,167,71,225,25,200
"2011","Bolton 013E","E01004797","Total",507,208,63,145,222,86,167,54,113
"2011","Bolton 014A","E01004775","Total",614,182,7,175,161,54,131,14,117
"2011","Bolton 014B","E01004885","Total",530,159,4,155,175,62,98,21,77
"2011","Bolton 014C","E01004886","Total",610,229,31,198,201,70,201,38,163
"2011","Bolton 014D","E01004887","Total",618,242,23,219,170,46,197,31,166
"2011","Bolton 015A","E01004868","Total",692,216,48,168,229,99,180,47,133
"2011","Bolton 015B","E01004869","Total",848,392,76,316,234,135,289,41,248
"2011","Bolton 015C","E01004870","Total",794,335,31,304,184,90,246,49,197
"2011","Bolton 015D","E01004871","Total",545,179,48,131,215,125,161,50,111
"2011","Bolton 015E","E01004922","Total",775,270,50,220,254,96,200,49,151
"2011","Bolton 016B","E01004822","Total",625,318,61,257,228,100,247,61,186
"2011","Bolton 016C","E01004823","Total",838,465,65,400,214,91,347,49,298
"2011","Bolton 016D","E01004848","Total",714,395,48,347,151,82,291,31,260
"2011","Bolton 016E","E01033217","Total",658,318,23,295,85,35,230,17,213
"2011","Bolton 016F","E01033220","Total",745,414,44,370,126,66,289,23,266
"2011","Bolton 017A","E01004818","Total",713,278,25,253,166,76,234,36,198
"2011","Bolton 017B","E01004819","Total",596,225,14,211,140,45,145,21,124
"2011","Bolton 017C","E01004928","Total",684,263,43,220,192,96,191,30,161
"2011","Bolton 017D","E01004930","Total",646,231,22,209,181,66,172,26,146
"2011","Bolton 017E","E01004931","Total",767,352,44,308,195,89,275,40,235
"2011","Bolton 017F","E01004932","Total",717,197,29,168,204,94,174,28,146
"2011","Bolton 018A","E01004834","Total",579,184,28,156,206,100,184,45,139
"2011","Bolton 018B","E01004838","Total",642,242,70,172,249,129,203,52,151
"2011","Bolton 018C","E01004843","Total",621,196,8,188,189,58,137,25,112
"2011","Bolton 018D","E01004845","Total",692,182,16,166,222,63,136,28,108
"2011","Bolton 018E","E01004923","Total",663,149,21,128,203,88,128,27,101
"2011","Bolton 019A","E01004796","Total",643,181,18,163,185,73,149,31,118
"2011","Bolton 019B","E01004798","Total",689,279,55,224,244,96,233,48,185
"2011","Bolton 019C","E01004799","Total",598,231,11,220,122,53,185,21,164
"2011","Bolton 019D","E01004800","Total",529,113,9,104,164,47,133,30,103
"2011","Bolton 019E","E01004801","Total",690,310,102,208,285,139,210,60,150
"2011","Bolton 019F","E01004917","Total",869,247,55,192,299,138,213,55,158
"2011","Bolton 020A","E01004835","Total",577,203,6,197,159,55,157,23,134
"2011","Bolton 020B","E01004836","Total",588,236,5,231,149,61,164,28,136
"2011","Bolton 020C","E01004837","Total",599,191,6,185,195,36,144,29,115
"2011","Bolton 020D","E01004844","Total",612,192,6,186,177,47,106,18,88
"2011","Bolton 020E","E01004897","Total",474,140,12,128,127,49,93,20,73
"2011","Bolton 021A","E01004827","Total",684,308,75,233,242,127,224,46,178
"2011","Bolton 021B","E01004849","Total",548,201,56,145,231,111,145,47,98
"2011","Bolton 021C","E01004850","Total",762,330,64,266,232,106,265,49,216
"2011","Bolton 021D","E01004851","Total",674,364,40,324,179,79,295,48,247
"2011","Bolton 021E","E01004853","Total",517,215,70,145,248,107,173,60,113
"2011","Bolton 022A","E01004811","Total",633,262,65,197,222,132,204,46,158
"2011","Bolton 022B","E01004812","Total",624,212,70,142,251,138,166,64,102
"2011","Bolton 022C","E01004813","Total",530,204,37,167,168,94,149,31,118
"2011","Bolton 022D","E01004815","Total",589,233,44,189,215,111,182,31,151
"2011","Bolton 022E","E01004817","Total",754,321,28,293,151,69,229,34,195
"2011","Bolton 023A","E01004828","Total",652,255,61,194,277,155,167,42,125
"2011","Bolton 023B","E01004829","Total",498,185,35,150,187,91,166,53,113
"2011","Bolton 023C","E01004832","Total",650,194,26,168,237,114,166,37,129
"2011","Bolton 023D","E01004854","Total",460,146,43,103,238,102,110,48,62
"2011","Bolton 023E","E01004878","Total",541,178,26,152,196,79,152,45,107
"2011","Bolton 024A","E01004911","Total",745,312,39,273,196,86,254,38,216
"2011","Bolton 024B","E01004912","Total",642,221,9,212,148,48,182,27,155
"2011","Bolton 024C","E01004913","Total",768,165,31,134,308,141,211,56,155
"2011","Bolton 024D","E01004914","Total",519,215,8,207,117,43,162,25,137
"2011","Bolton 024E","E01004915","Total",536,157,10,147,142,46,151,29,122
"2011","Bolton 024F","E01004916","Total",666,261,25,236,190,64,243,44,199
"2011","Bolton 024G","E01004918","Total",520,158,5,153,152,56,141,23,118
"2011","Bolton 025A","E01004846","Total",512,207,51,156,181,99,160,35,125
"2011","Bolton 025B","E01004847","Total",638,260,118,142,333,157,167,61,106
"2011","Bolton 025C","E01004852","Total",484,150,32,118,225,104,146,48,98
"2011","Bolton 025D","E01004877","Total",689,359,82,277,274,138,281,64,217
"2011","Bolton 025E","E01004879","Total",520,195,54,141,235,116,157,49,108
"2011","Bolton 026A","E01004830","Total",741,293,43,250,203,85,234,35,199
"2011","Bolton 026B","E01004831","Total",654,193,17,176,221,93,165,41,124
"2011","Bolton 026C","E01004833","Total",636,222,15,207,189,64,179,41,138
"2011","Bolton 026D","E01004839","Total",944,461,68,393,261,104,375,61,314
"2011","Bolton 027A","E01004814","Total",582,195,45,150,210,96,158,43,115
"2011","Bolton 027B","E01004855","Total",613,188,44,144,215,91,159,46,113
"2011","Bolton 027C","E01004856","Total",637,267,59,208,200,111,206,34,172
"2011","Bolton 027D","E01004857","Total",636,242,58,184,203,88,181,47,134
"2011","Bolton 028A","E01004891","Total",756,310,6,304,161,50,227,29,198
"2011","Bolton 028B","E01004893","Total",592,156,4,152,181,67,131,17,114
"2011","Bolton 028C","E01004894","Total",797,250,27,223,237,104,213,35,178
"2011","Bolton 028E","E01004901","Total",739,151,6,145,242,64,145,27,118
"2011","Bolton 028F","E01033218","Total",648,81,7,74,253,141,86,26,60
"2011","Bolton 028G","E01033219","Total",593,144,6,138,194,58,114,15,99
"2011","Bolton 029A","E01004816","Total",513,195,36,159,208,99,161,51,110
"2011","Bolton 029B","E01004872","Total",619,201,42,159,231,95,188,47,141
"2011","Bolton 029C","E01004873","Total",626,225,68,157,263,100,200,63,137
"2011","Bolton 029D","E01004875","Total",653,235,31,204,201,78,195,31,164
"2011","Bolton 029E","E01004880","Total",508,149,12,137,170,62,161,43,118
"2011","Bolton 030A","E01004892","Total",693,313,3,310,153,47,204,29,175
"2011","Bolton 030B","E01004896","Total",556,236,4,232,124,38,158,21,137
"2011","Bolton 030C","E01004899","Total",622,197,20,177,203,73,163,32,131
"2011","Bolton 030D","E01004900","Total",624,104,20,84,251,100,117,39,78
"2011","Bolton 031A","E01004776","Total",794,228,26,202,239,103,226,36,190
"2011","Bolton 031B","E01004895","Total",588,218,26,192,171,57,206,32,174
"2011","Bolton 031C","E01004936","Total",950,224,11,213,255,93,244,37,207
"2011","Bolton 031D","E01004938","Total",632,288,53,235,212,62,247,63,184
"2011","Bolton 031E","E01004939","Total",686,242,26,216,189,73,190,29,161
"2011","Bolton 032A","E01004858","Total",755,293,24,269,201,84,265,37,228
"2011","Bolton 032B","E01004859","Total",704,381,50,331,157,78,282,33,249
"2011","Bolton 032C","E01004860","Total",691,284,42,242,183,79,215,31,184
"2011","Bolton 032D","E01004902","Total",802,272,28,244,198,88,236,37,199
"2011","Bolton 032E","E01004906","Total",810,346,37,309,208,88,287,33,254
"2011","Bolton 033A","E01004861","Total",623,225,92,133,282,126,197,70,127
"2011","Bolton 033B","E01004862","Total",610,315,72,243,207,92,239,47,192
"2011","Bolton 033C","E01004863","Total",646,292,62,230,218,81,229,53,176
"2011","Bolton 033D","E01004874","Total",683,239,63,176,284,92,195,64,131
"2011","Bolton 033E","E01004876","Total",792,325,66,259,270,115,263,56,207
"2011","Bolton 034A","E01004903","Total",575,124,11,113,229,75,104,22,82
"2011","Bolton 034B","E01004904","Total",696,174,21,153,257,93,170,42,128
"2011","Bolton 034C","E01004905","Total",679,218,36,182,211,95,195,41,154
"2011","Bolton 034D","E01004907","Total",541,178,39,139,212,67,151,46,105
"2011","Bolton 034E","E01004908","Total",570,237,19,218,168,63,163,32,131
"2011","Bolton 034F","E01004909","Total",632,270,35,235,199,76,231,38,193
"2011","Bolton 034G","E01004910","Total",970,194,25,169,272,113,180,35,145
"2011","Bolton 035A","E01004933","Total",569,105,8,97,172,72,106,20,86
"2011","Bolton 035B","E01004934","Total",560,126,40,86,248,78,111,41,70
"2011","Bolton 035C","E01004935","Total",705,152,15,137,270,101,138,43,95
"2011","Bolton 035D","E01004937","Total",558,99,13,86,234,73,125,40,85
"2011","Bolton 035E","E01004940","Total",616,203,17,186,181,67,194,33,161
"2011","Bury 001A","E01005014","Total",746,221,21,200,153,54,192,35,157
"2011","Bury 001B","E01005015","Total",688,231,32,199,189,78,217,32,185
"2011","Bury 001C","E01005016","Total",718,172,14,158,166,67,158,25,133
"2011","Bury 001D","E01005017","Total",707,180,10,170,265,112,175,32,143
"2011","Bury 001E","E01005018","Total",713,229,24,205,214,79,182,29,153
"2011","Bury 001F","E01005021","Total",410,118,2,116,121,32,96,14,82
"2011","Bury 002A","E01005019","Total",620,212,15,197,195,60,146,27,119
"2011","Bury 002B","E01005023","Total",554,229,8,221,148,39,154,18,136
"2011","Bury 002C","E01005046","Total",643,270,0,270,145,37,177,14,163
"2011","Bury 002D","E01005048","Total",666,214,4,210,180,54,146,21,125
"2011","Bury 003A","E01005020","Total",507,59,2,57,242,59,78,22,56
"2011","Bury 003B","E01005022","Total",644,150,12,138,227,75,120,22,98
"2011","Bury 003C","E01005047","Total",568,156,0,156,157,46,124,13,111
"2011","Bury 003D","E01005049","Total",738,218,13,205,212,78,171,33,138
"2011","Bury 003E","E01005051","Total",658,180,5,175,215,72,156,17,139
"2011","Bury 004A","E01004976","Total",638,262,37,225,200,62,220,45,175
"2011","Bury 004B","E01004977","Total",767,296,15,281,173,58,225,21,204
"2011","Bury 004C","E01004978","Total",654,189,26,163,213,87,172,49,123
"2011","Bury 004D","E01004981","Total",632,226,15,211,162,65,177,31,146
"2011","Bury 004E","E01004982","Total",635,234,6,228,157,46,178,23,155
"2011","Bury 005A","E01004961","Total",647,204,37,167,227,81,186,48,138
"2011","Bury 005B","E01004965","Total",486,169,13,156,139,38,93,17,76
"2011","Bury 005C","E01004966","Total",719,249,54,195,286,134,188,63,125
"2011","Bury 005D","E01004967","Total",472,128,6,122,158,44,105,24,81
"2011","Bury 006A","E01004963","Total",673,250,12,238,168,57,193,30,163
"2011","Bury 006B","E01004968","Total",627,173,8,165,204,55,138,31,107
"2011","Bury 006C","E01005050","Total",819,180,21,159,330,117,190,52,138
"2011","Bury 006D","E01005052","Total",582,154,5,149,189,59,152,31,121
"2011","Bury 006E","E01005053","Total",640,162,14,148,211,71,153,29,124
"2011","Bury 007A","E01004954","Total",658,258,17,241,141,58,214,21,193
"2011","Bury 007B","E01004955","Total",550,171,33,138,193,74,145,34,111
"2011","Bury 007C","E01004956","Total",696,275,42,233,204,98,237,38,199
"2011","Bury 007D","E01004957","Total",813,387,89,298,252,112,303,50,253
"2011","Bury 007E","E01004960","Total",632,343,116,227,268,153,229,51,178
"2011","Bury 008A","E01004958","Total",661,246,48,198,171,73,206,36,170
"2011","Bury 008B","E01004959","Total",728,240,48,192,232,111,211,46,165
"2011","Bury 008C","E01004979","Total",630,235,47,188,216,103,198,40,158
"2011","Bury 008D","E01004980","Total",596,173,30,143,161,77,131,23,108
"2011","Bury 008E","E01005024","Total",511,209,55,154,209,112,168,45,123
"2011","Bury 008F","E01005026","Total",545,150,42,108,238,149,136,50,86
"2011","Bury 009A","E01004947","Total",653,192,39,153,199,95,184,45,139
"2011","Bury 009B","E01004948","Total",836,327,41,286,221,87,255,37,218
"2011","Bury 009C","E01004962","Total",708,153,21,132,236,107,148,27,121
"2011","Bury 009D","E01004964","Total",832,194,19,175,241,109,184,29,155
"2011","Bury 010A","E01004949","Total",596,225,7,218,188,50,145,29,116
"2011","Bury 010B","E01004950","Total",612,201,5,196,180,47,146,15,131
"2011","Bury 010C","E01004951","Total",653,245,6,239,161,49,183,33,150
"2011","Bury 010D","E01004952","Total",619,299,3,296,105,19,192,21,171
"2011","Bury 010E","E01004953","Total",628,207,2,205,192,63,172,27,145
"2011","Bury 011A","E01005025","Total",685,237,17,220,165,65,165,20,145
"2011","Bury 011B","E01005027","Total",732,231,36,195,208,85,193,41,152
"2011","Bury 011C","E01005028","Total",803,332,63,269,277,125,275,53,222
"2011","Bury 011D","E01005029","Total",660,201,30,171,245,119,177,44,133
"2011","Bury 012A","E01005000","Total",574,109,6,103,238,73,134,35,99
"2011","Bury 012B","E01005001","Total",493,73,12,61,202,58,97,28,69
"2011","Bury 012C","E01005005","Total",632,220,9,211,153,57,168,24,144
"2011","Bury 012D","E01005006","Total",647,240,18,222,174,49,186,27,159
"2011","Bury 013A","E01005030","Total",733,303,40,263,194,77,252,50,202
"2011","Bury 013B","E01005054","Total",641,187,16,171,177,57,147,29,118
"2011","Bury 013C","E01005059","Total",733,247,21,226,216,88,218,41,177
"2011","Bury 013D","E01005060","Total",734,235,15,220,204,90,168,24,144
"2011","Bury 014A","E01004997","Total",594,159,26,133,215,80,146,40,106
"2011","Bury 014B","E01004998","Total",641,260,10,250,150,54,192,28,164
"2011","Bury 014C","E01004999","Total",596,153,20,133,219,63,152,35,117
"2011","Bury 014D","E01005002","Total",635,189,20,169,205,69,166,27,139
"2011","Bury 014E","E01005003","Total",654,203,27,176,199,105,189,38,151
"2011","Bury 015A","E01004991","Total",588,163,34,129,220,95,127,31,96
"2011","Bury 015B","E01004992","Total",637,201,29,172,202,85,147,31,116
"2011","Bury 015C","E01004993","Total",551,180,39,141,211,83,149,33,116
"2011","Bury 015D","E01004994","Total",614,238,56,182,183,93,194,35,159
"2011","Bury 016A","E01004990","Total",634,198,21,177,204,95,194,50,144
"2011","Bury 016B","E01004996","Total",731,327,57,270,184,105,239,31,208
"2011","Bury 016C","E01005004","Total",849,526,46,480,147,69,396,34,362
"2011","Bury 016D","E01005008","Total",875,323,72,251,271,137,275,47,228
"2011","Bury 016E","E01005009","Total",742,275,51,224,188,84,211,43,168
"2011","Bury 017A","E01004945","Total",658,259,8,251,174,52,189,28,161
"2011","Bury 017B","E01005055","Total",584,178,8,170,168,61,150,25,125
"2011","Bury 017C","E01005056","Total",604,220,6,214,108,36,153,12,141
"2011","Bury 017D","E01005057","Total",630,176,28,148,252,89,118,35,83
"2011","Bury 017E","E01005058","Total",505,158,4,154,154,49,133,28,105
"2011","Bury 018A","E01004995","Total",640,218,10,208,170,58,162,25,137
"2011","Bury 018B","E01005010","Total",660,150,21,129,232,90,140,30,110
"2011","Bury 018C","E01005012","Total",755,248,62,186,256,101,192,55,137
"2011","Bury 018D","E01005013","Total",956,281,83,198,402,185,240,86,154
"2011","Bury 019A","E01004984","Total",573,215,5,210,160,65,173,25,148
"2011","Bury 019B","E01004985","Total",577,174,6,168,158,62,145,22,123
"2011","Bury 019C","E01004989","Total",567,159,12,147,178,72,130,20,110
"2011","Bury 019D","E01005007","Total",710,278,8,270,139,61,220,19,201
"2011","Bury 019E","E01005011","Total",589,153,6,147,174,77,127,20,107
"2011","Bury 020A","E01004983","Total",545,102,17,85,168,68,110,31,79
"2011","Bury 020B","E01004986","Total",806,295,46,249,204,87,234,42,192
"2011","Bury 020C","E01004987","Total",649,375,26,349,133,56,293,25,268
"2011","Bury 020D","E01004988","Total",637,201,26,175,178,74,173,29,144
"2011","Bury 021A","E01004941","Total",726,238,39,199,272,97,210,54,156
"2011","Bury 021B","E01004942","Total",639,274,78,196,254,109,231,64,167
"2011","Bury 021C","E01004943","Total",650,172,36,136,247,107,151,48,103
"2011","Bury 021D","E01004944","Total",630,147,15,132,227,80,130,29,101
"2011","Bury 021E","E01004946","Total",798,376,48,328,223,79,301,43,258
"2011","Bury 022A","E01004969","Total",705,250,12,238,144,55,203,28,175
"2011","Bury 022B","E01004970","Total",605,166,8,158,199,59,145,24,121
"2011","Bury 022C","E01004971","Total",598,188,10,178,180,68,123,25,98
"2011","Bury 022D","E01005034","Total",640,195,10,185,165,60,160,18,142
"2011","Bury 023A","E01004972","Total",573,188,47,141,224,81,174,53,121
"2011","Bury 023B","E01004973","Total",658,202,23,179,190,62,155,29,126
"2011","Bury 023C","E01004975","Total",757,244,26,218,180,93,193,21,172
"2011","Bury 023D","E01005039","Total",699,292,43,249,178,73,237,27,210
"2011","Bury 023E","E01005045","Total",682,213,33,180,224,97,188,46,142
"2011","Bury 024A","E01004974","Total",603,157,8,149,162,56,150,20,130
"2011","Bury 024B","E01005033","Total",614,161,9,152,188,84,152,22,130
"2011","Bury 024C","E01005036","Total",1030,399,15,384,168,68,309,31,278
"2011","Bury 024D","E01005037","Total",628,191,18,173,167,64,166,29,137
"2011","Bury 025A","E01005031","Total",627,217,29,188,196,83,194,36,158
"2011","Bury 025B","E01005032","Total",523,206,29,177,133,59,184,35,149
"2011","Bury 025C","E01005035","Total",626,184,13,171,186,75,178,32,146
"2011","Bury 025D","E01005038","Total",531,128,9,119,191,67,122,34,88
"2011","Bury 026A","E01005040","Total",696,180,23,157,237,96,193,42,151
"2011","Bury 026B","E01005041","Total",519,123,12,111,225,82,129,40,89
"2011","Bury 026C","E01005042","Total",608,167,14,153,250,132,125,26,99
"2011","Bury 026D","E01005043","Total",496,100,12,88,249,159,108,36,72
"2011","Bury 026E","E01005044","Total",471,102,18,84,247,179,125,39,86
"2011","Manchester 001A","E01005098","Total",777,391,68,323,193,77,314,49,265
"2011","Manchester 001B","E01005099","Total",726,357,133,224,326,149,255,82,173
"2011","Manchester 001C","E01005100","Total",658,265,62,203,202,97,232,50,182
"2011","Manchester 001D","E01005102","Total",626,217,31,186,172,64,164,32,132
"2011","Manchester 001E","E01005103","Total",835,458,73,385,205,93,343,35,308
"2011","Manchester 002A","E01005101","Total",723,290,66,224,253,95,258,60,198
"2011","Manchester 002B","E01005135","Total",624,279,86,193,259,97,209,64,145
"2011","Manchester 002C","E01005136","Total",637,234,25,209,168,53,228,35,193
"2011","Manchester 002D","E01005138","Total",787,438,128,310,283,130,300,78,222
"2011","Manchester 002E","E01005140","Total",1185,406,104,302,387,200,349,84,265
"2011","Manchester 003B","E01005139","Total",714,243,50,193,256,110,194,52,142
"2011","Manchester 003C","E01005141","Total",805,407,81,326,237,101,318,57,261
"2011","Manchester 003D","E01005251","Total",633,240,70,170,263,90,196,62,134
"2011","Manchester 003E","E01005252","Total",763,333,62,271,257,92,300,73,227
"2011","Manchester 003F","E01033685","Total",652,181,34,147,246,123,156,36,120
"2011","Manchester 003G","E01033687","Total",802,395,35,360,159,69,286,26,260
"2011","Manchester 004A","E01005104","Total",842,333,89,244,267,138,235,67,168
"2011","Manchester 004B","E01005160","Total",721,239,36,203,214,104,232,45,187
"2011","Manchester 004C","E01005161","Total",657,189,35,154,228,123,154,44,110
"2011","Manchester 004D","E01005162","Total",679,293,29,264,187,76,237,34,203
"2011","Manchester 004E","E01005163","Total",661,265,36,229,204,100,195,32,163
"2011","Manchester 005A","E01005247","Total",627,222,20,202,162,51,183,28,155
"2011","Manchester 005B","E01005248","Total",573,186,14,172,136,43,149,26,123
"2011","Manchester 005C","E01005249","Total",777,255,40,215,227,109,227,27,200
"2011","Manchester 005D","E01005250","Total",750,309,84,225,268,125,241,43,198
"2011","Manchester 005E","E01005253","Total",639,277,68,209,251,86,225,72,153
"2011","Manchester 005F","E01005254","Total",683,206,23,183,212,75,172,24,148
"2011","Manchester 006A","E01005164","Total",694,294,75,219,214,115,226,57,169
"2011","Manchester 006B","E01005205","Total",937,448,89,359,291,145,344,62,282
"2011","Manchester 006C","E01005206","Total",747,253,51,202,221,106,227,53,174
"2011","Manchester 006D","E01005207","Total",817,292,78,214,254,129,230,44,186
"2011","Manchester 007A","E01005223","Total",549,207,38,169,155,70,179,29,150
"2011","Manchester 007B","E01005224","Total",715,234,80,154,307,167,154,40,114
"2011","Manchester 007C","E01005225","Total",837,386,72,314,245,106,298,47,251
"2011","Manchester 007D","E01005226","Total",683,250,63,187,232,113,187,32,155
"2011","Manchester 007E","E01005229","Total",609,190,18,172,179,68,163,23,140
"2011","Manchester 008A","E01005145","Total",801,258,106,152,395,238,167,76,91
"2011","Manchester 008B","E01005146","Total",852,317,80,237,331,197,262,77,185
"2011","Manchester 008C","E01005149","Total",474,150,56,94,238,120,140,50,90
"2011","Manchester 008D","E01005165","Total",976,455,81,374,251,146,362,50,312
"2011","Manchester 008E","E01005166","Total",716,320,70,250,230,127,251,55,196
"2011","Manchester 008F","E01005167","Total",565,174,67,107,297,161,159,63,96
"2011","Manchester 009A","E01005202","Total",783,426,148,278,292,133,294,78,216
"2011","Manchester 009B","E01005203","Total",927,528,123,405,275,132,357,55,302
"2011","Manchester 009D","E01005227","Total",698,295,90,205,257,118,233,49,184
"2011","Manchester 009E","E01005228","Total",755,391,107,284,276,128,287,64,223
"2011","Manchester 009F","E01033678","Total",688,315,88,227,234,119,207,51,156
"2011","Manchester 009G","E01033679","Total",643,368,86,282,195,89,291,56,235
"2011","Manchester 011A","E01005256","Total",854,371,98,273,313,148,284,65,219
"2011","Manchester 011B","E01005257","Total",820,417,116,301,270,136,313,68,245
"2011","Manchester 011C","E01005258","Total",781,344,57,287,210,89,265,40,225
"2011","Manchester 011D","E01005259","Total",782,401,103,298,234,129,288,58,230
"2011","Manchester 011E","E01005260","Total",592,195,30,165,176,81,163,37,126
"2011","Manchester 012A","E01005093","Total",678,331,107,224,265,135,248,67,181
"2011","Manchester 012B","E01005094","Total",660,333,91,242,227,112,221,47,174
"2011","Manchester 012C","E01005097","Total",650,328,118,210,280,123,231,63,168
"2011","Manchester 012D","E01005255","Total",824,462,81,381,228,104,338,56,282
"2011","Manchester 012E","E01005261","Total",651,341,107,234,271,124,244,58,186
"2011","Manchester 013B","E01005129","Total",709,335,73,262,203,80,273,54,219
"2011","Manchester 013C","E01005132","Total",661,333,109,224,249,108,220,54,166
"2011","Manchester 013D","E01005133","Total",596,286,46,240,123,43,212,38,174
"2011","Manchester 013E","E01033663","Total",712,159,17,142,44,23,101,14,87
"2011","Manchester 013F","E01033684","Total",649,57,4,53,22,17,28,1,27
"2011","Manchester 013G","E01033688","Total",691,350,73,277,200,87,266,48,218
"2011","Manchester 015A","E01005092","Total",720,341,91,250,258,125,234,65,169
"2011","Manchester 015C","E01005105","Total",809,300,96,204,276,149,189,48,141
"2011","Manchester 015D","E01005106","Total",825,364,92,272,279,139,261,48,213
"2011","Manchester 015E","E01005107","Total",740,347,108,239,303,157,242,56,186
"2011","Manchester 015F","E01033668","Total",598,165,44,121,117,72,104,20,84
"2011","Manchester 015G","E01033669","Total",677,293,65,228,191,100,216,33,183
"2011","Manchester 017A","E01005108","Total",1053,507,178,329,435,205,351,87,264
"2011","Manchester 017D","E01005189","Total",826,455,93,362,230,121,341,53,288
"2011","Manchester 017E","E01005190","Total",881,380,105,275,322,161,270,58,212
"2011","Manchester 017F","E01033666","Total",1103,443,75,368,345,154,376,68,308
"2011","Manchester 018A","E01005061","Total",743,379,101,278,246,103,276,54,222
"2011","Manchester 018B","E01005062","Total",772,356,69,287,223,122,176,38,138
"2011","Manchester 018C","E01005063","Total",614,270,76,194,220,98,207,56,151
"2011","Manchester 018D","E01005065","Total",916,386,100,286,324,165,291,69,222
"2011","Manchester 018E","E01005066","Total",501,216,30,186,103,60,119,17,102
"2011","Manchester 019A","E01005208","Total",1110,355,74,281,251,143,223,38,185
"2011","Manchester 019B","E01005209","Total",868,390,63,327,184,100,209,27,182
"2011","Manchester 019C","E01005210","Total",638,378,50,328,105,42,164,21,143
"2011","Manchester 019D","E01005214","Total",1013,223,68,155,206,113,141,42,99
"2011","Manchester 020A","E01005067","Total",587,301,83,218,207,94,205,35,170
"2011","Manchester 020B","E01005186","Total",945,346,86,260,336,180,277,66,211
"2011","Manchester 020C","E01005232","Total",713,270,60,210,261,127,211,42,169
"2011","Manchester 020D","E01005235","Total",719,340,85,255,271,125,248,60,188
"2011","Manchester 020E","E01005239","Total",660,293,111,182,295,147,225,73,152
"2011","Manchester 021A","E01005187","Total",787,301,107,194,302,172,213,45,168
"2011","Manchester 021B","E01005188","Total",703,250,53,197,243,110,204,41,163
"2011","Manchester 021C","E01005191","Total",800,360,84,276,271,142,282,64,218
"2011","Manchester 021D","E01005192","Total",679,231,37,194,211,81,173,35,138
"2011","Manchester 021E","E01005193","Total",818,294,70,224,260,124,218,45,173
"2011","Manchester 022B","E01005230","Total",819,345,41,304,155,72,218,37,181
"2011","Manchester 022C","E01005231","Total",633,226,24,202,78,51,83,11,72
"2011","Manchester 022D","E01005236","Total",702,264,62,202,207,118,182,41,141
"2011","Manchester 022E","E01005237","Total",533,170,49,121,245,138,159,74,85
"2011","Manchester 022F","E01033652","Total",411,184,31,153,98,46,90,30,60
"2011","Manchester 022G","E01033657","Total",435,205,36,169,84,43,132,21,111
"2011","Manchester 023A","E01005195","Total",735,296,106,190,330,151,240,77,163
"2011","Manchester 023B","E01005196","Total",894,387,143,244,437,227,265,92,173
"2011","Manchester 023C","E01005197","Total",697,317,60,257,207,90,239,49,190
"2011","Manchester 023D","E01005198","Total",649,317,91,226,225,119,234,43,191
"2011","Manchester 023E","E01005201","Total",816,356,138,218,353,204,201,64,137
"2011","Manchester 024A","E01005240","Total",1003,413,170,243,416,237,263,94,169
"2011","Manchester 024B","E01005243","Total",1084,491,153,338,364,180,350,93,257
"2011","Manchester 024C","E01005245","Total",871,463,176,287,381,159,333,102,231
"2011","Manchester 024D","E01005246","Total",738,370,170,200,354,203,221,76,145
"2011","Manchester 025A","E01005241","Total",1009,298,88,210,302,184,203,48,155
"2011","Manchester 025B","E01005242","Total",1008,425,173,252,396,235,264,86,178
"2011","Manchester 025C","E01005244","Total",926,401,77,324,205,106,208,44,164
"2011","Manchester 025D","E01005285","Total",476,230,53,177,132,79,163,40,123
"2011","Manchester 025E","E01005288","Total",640,240,49,191,133,79,132,30,102
"2011","Manchester 026A","E01005280","Total",528,192,67,125,251,112,201,78,123
"2011","Manchester 026B","E01005281","Total",542,220,3,217,29,13,135,4,131
"2011","Manchester 026C","E01005284","Total",834,332,21,311,94,67,119,15,104
"2011","Manchester 026D","E01005286","Total",738,226,24,202,117,66,141,18,123
"2011","Manchester 026E","E01005287","Total",652,280,74,206,250,120,219,61,158
"2011","Manchester 027A","E01005194","Total",940,360,105,255,374,222,251,80,171
"2011","Manchester 027B","E01005199","Total",895,264,86,178,346,191,204,63,141
"2011","Manchester 027C","E01005200","Total",764,252,59,193,257,128,250,59,191
"2011","Manchester 027D","E01005233","Total",770,274,111,163,375,236,178,69,109
"2011","Manchester 027E","E01005234","Total",633,238,69,169,285,162,188,67,121
"2011","Manchester 027F","E01005238","Total",564,159,70,89,289,160,160,77,83
"2011","Manchester 028A","E01005297","Total",916,255,61,194,313,150,215,62,153
"2011","Manchester 028B","E01005298","Total",641,137,38,99,239,108,129,39,90
"2011","Manchester 028C","E01005302","Total",930,235,27,208,170,87,209,35,174
"2011","Manchester 028E","E01033680","Total",646,162,17,145,89,55,131,15,116
"2011","Manchester 028F","E01033686","Total",608,162,18,144,120,68,145,19,126
"2011","Manchester 029A","E01005150","Total",930,182,11,171,94,46,149,19,130
"2011","Manchester 029B","E01005151","Total",717,210,4,206,131,54,199,12,187
"2011","Manchester 029C","E01005152","Total",600,114,9,105,180,96,115,23,92
"2011","Manchester 029D","E01005159","Total",621,93,4,89,165,88,108,25,83
"2011","Manchester 029E","E01005296","Total",614,155,17,138,181,69,145,32,113
"2011","Manchester 029F","E01005299","Total",533,131,27,104,193,85,137,46,91
"2011","Manchester 030A","E01005178","Total",742,259,65,194,232,95,199,51,148
"2011","Manchester 030B","E01005179","Total",953,231,34,197,224,111,187,45,142
"2011","Manchester 030C","E01005180","Total",782,341,82,259,258,98,270,48,222
"2011","Manchester 030D","E01005181","Total",683,162,40,122,264,126,157,54,103
"2011","Manchester 030E","E01005182","Total",469,161,64,97,233,89,151,62,89
"2011","Manchester 030F","E01005183","Total",670,318,91,227,232,100,253,65,188
"2011","Manchester 031A","E01005219","Total",916,289,40,249,227,106,206,33,173
"2011","Manchester 031B","E01005220","Total",728,207,57,150,259,156,177,39,138
"2011","Manchester 031C","E01005221","Total",779,207,62,145,293,165,188,60,128
"2011","Manchester 031D","E01005222","Total",897,285,70,215,305,159,248,64,184
"2011","Manchester 032A","E01005184","Total",779,253,34,219,125,66,150,15,135
"2011","Manchester 032B","E01005185","Total",534,150,10,140,31,18,74,7,67
"2011","Manchester 032C","E01005271","Total",694,237,22,215,66,52,125,12,113
"2011","Manchester 032D","E01005282","Total",550,169,50,119,207,93,132,49,83
"2011","Manchester 032E","E01005283","Total",408,141,13,128,34,17,52,8,44
"2011","Manchester 033A","E01005154","Total",669,87,4,83,153,71,95,13,82
"2011","Manchester 033B","E01005156","Total",635,98,3,95,164,74,103,18,85
"2011","Manchester 033C","E01005158","Total",711,230,28,202,178,88,204,27,177
"2011","Manchester 033D","E01005300","Total",490,150,24,126,190,79,148,47,101
"2011","Manchester 033E","E01005301","Total",612,132,23,109,189,74,126,35,91
"2011","Manchester 034A","E01005118","Total",497,153,27,126,187,82,130,37,93
"2011","Manchester 034B","E01005120","Total",661,220,43,177,260,124,189,49,140
"2011","Manchester 034C","E01005215","Total",756,264,71,193,280,153,209,49,160
"2011","Manchester 034D","E01005216","Total",611,133,21,112,188,88,152,34,118
"2011","Manchester 034E","E01005217","Total",678,201,23,178,233,96,185,51,134
"2011","Manchester 034F","E01005218","Total",632,263,17,246,133,60,210,30,180
"2011","Manchester 035A","E01005270","Total",675,237,66,171,236,101,210,53,157
"2011","Manchester 035B","E01005272","Total",755,355,94,261,282,131,295,65,230
"2011","Manchester 035C","E01005273","Total",553,180,27,153,71,33,109,18,91
"2011","Manchester 035D","E01005278","Total",541,186,32,154,148,52,136,42,94
"2011","Manchester 035E","E01005279","Total",817,262,71,191,290,109,224,68,156
"2011","Manchester 036A","E01005305","Total",592,139,20,119,156,74,114,28,86
"2011","Manchester 036B","E01005309","Total",963,314,11,303,44,17,157,5,152
"2011","Manchester 036C","E01005310","Total",579,218,40,178,119,53,137,29,108
"2011","Manchester 036D","E01005311","Total",615,162,31,131,109,55,132,14,118
"2011","Manchester 036E","E01005312","Total",618,240,14,226,43,16,159,10,149
"2011","Manchester 037A","E01005082","Total",659,259,56,203,217,71,253,73,180
"2011","Manchester 037B","E01005153","Total",820,179,14,165,170,92,171,20,151
"2011","Manchester 037C","E01005155","Total",683,138,8,130,152,87,134,18,116
"2011","Manchester 037D","E01005157","Total",614,132,8,124,218,91,115,23,92
"2011","Manchester 038A","E01005274","Total",682,242,43,199,163,75,182,40,142
"2011","Manchester 038B","E01005275","Total",818,137,5,132,82,51,87,8,79
"2011","Manchester 038C","E01005276","Total",643,105,21,84,101,56,88,14,74
"2011","Manchester 038D","E01005277","Total",778,117,6,111,152,63,105,16,89
"2011","Manchester 039A","E01005076","Total",782,119,11,108,83,51,98,13,85
"2011","Manchester 039C","E01005081","Total",784,328,95,233,293,111,257,64,193
"2011","Manchester 039D","E01005083","Total",888,130,5,125,107,70,96,5,91
"2011","Manchester 039E","E01033670","Total",655,43,14,29,80,61,36,8,28
"2011","Manchester 039F","E01033671","Total",793,93,12,81,98,61,90,12,78
"2011","Manchester 040A","E01005125","Total",635,216,52,164,222,89,185,52,133
"2011","Manchester 040B","E01005304","Total",657,193,13,180,91,42,123,11,112
"2011","Manchester 040C","E01005306","Total",687,186,6,180,150,58,144,17,127
"2011","Manchester 040D","E01005307","Total",721,196,12,184,120,52,138,16,122
"2011","Manchester 040E","E01005308","Total",625,192,63,129,213,101,156,42,114
"2011","Manchester 041A","E01005119","Total",629,270,71,199,232,85,227,63,164
"2011","Manchester 041B","E01005121","Total",599,235,73,162,246,113,197,58,139
"2011","Manchester 041C","E01005122","Total",641,256,68,188,240,97,219,63,156
"2011","Manchester 041D","E01005123","Total",622,255,98,157,261,108,217,66,151
"2011","Manchester 041E","E01005124","Total",686,255,91,164,283,125,232,80,152
"2011","Manchester 042A","E01005077","Total",630,267,98,169,270,117,218,68,150
"2011","Manchester 042B","E01005078","Total",824,179,2,177,80,54,116,9,107
"2011","Manchester 042C","E01005079","Total",628,212,43,169,206,92,167,48,119
"2011","Manchester 042D","E01005084","Total",867,249,48,201,241,121,215,48,167
"2011","Manchester 043A","E01005172","Total",803,230,8,222,131,45,189,19,170
"2011","Manchester 043B","E01005173","Total",703,175,2,173,141,70,135,11,124
"2011","Manchester 043C","E01005174","Total",624,136,3,133,189,80,108,19,89
"2011","Manchester 043D","E01005175","Total",693,174,12,162,189,88,164,28,136
"2011","Manchester 043E","E01005176","Total",936,162,14,148,125,69,143,8,135
"2011","Manchester 043F","E01005177","Total",643,194,6,188,133,62,155,10,145
"2011","Manchester 044A","E01005115","Total",785,277,57,220,275,130,233,56,177
"2011","Manchester 044B","E01005262","Total",861,268,63,205,275,134,220,44,176
"2011","Manchester 044C","E01005264","Total",617,222,48,174,214,83,197,49,148
"2011","Manchester 044D","E01005265","Total",682,249,72,177,255,110,214,63,151
"2011","Manchester 044E","E01005266","Total",835,342,89,253,301,145,285,65,220
"2011","Manchester 045A","E01005126","Total",819,227,30,197,223,102,197,42,155
"2011","Manchester 045B","E01005168","Total",522,141,10,131,203,67,120,27,93
"2011","Manchester 045C","E01005169","Total",487,128,7,121,139,49,105,21,84
"2011","Manchester 045D","E01005170","Total",584,168,11,157,196,87,131,25,106
"2011","Manchester 045E","E01005171","Total",711,172,8,164,172,61,140,15,125
"2011","Manchester 046A","E01005263","Total",825,327,22,305,163,79,269,31,238
"2011","Manchester 046B","E01005267","Total",664,216,21,195,177,72,184,32,152
"2011","Manchester 046C","E01005268","Total",994,271,9,262,177,93,248,26,222
"2011","Manchester 046D","E01005269","Total",617,217,7,210,160,60,184,24,160
"2011","Manchester 047A","E01005069","Total",641,159,13,146,175,81,175,29,146
"2011","Manchester 047B","E01005111","Total",622,239,36,203,194,88,218,36,182
"2011","Manchester 047C","E01005113","Total",830,371,47,324,201,99,313,36,277
"2011","Manchester 047D","E01005114","Total",810,315,13,302,178,86,227,34,193
"2011","Manchester 047E","E01005116","Total",973,309,38,271,244,131,261,34,227
"2011","Manchester 048A","E01005071","Total",684,227,39,188,237,101,217,40,177
"2011","Manchester 048B","E01005072","Total",811,294,55,239,245,127,254,61,193
"2011","Manchester 048C","E01005073","Total",615,201,20,181,182,75,165,30,135
"2011","Manchester 048D","E01005112","Total",676,253,67,186,243,129,205,58,147
"2011","Manchester 048E","E01005117","Total",938,384,104,280,325,152,294,62,232
"2011","Manchester 049A","E01005085","Total",599,220,85,135,256,130,140,45,95
"2011","Manchester 049B","E01005086","Total",715,283,89,194,292,144,221,52,169
"2011","Manchester 049C","E01005089","Total",699,303,116,187,298,163,213,55,158
"2011","Manchester 049D","E01005289","Total",641,313,74,239,212,82,267,52,215
"2011","Manchester 049E","E01005295","Total",1124,209,46,163,311,167,192,45,147
"2011","Manchester 050A","E01005087","Total",792,330,147,183,378,183,228,77,151
"2011","Manchester 050B","E01005088","Total",687,328,113,215,295,143,270,79,191
"2011","Manchester 050C","E01005090","Total",745,415,89,326,221,114,312,55,257
"2011","Manchester 050D","E01005091","Total",867,343,118,225,363,203,257,72,185
"2011","Manchester 050E","E01005291","Total",714,390,67,323,200,97,294,40,254
"2011","Manchester 051A","E01005068","Total",704,299,73,226,242,99,264,56,208
"2011","Manchester 051B","E01005070","Total",740,296,63,233,247,123,254,47,207
"2011","Manchester 051C","E01005074","Total",644,252,45,207,216,87,234,38,196
"2011","Manchester 051D","E01005075","Total",612,218,36,182,198,83,220,45,175
"2011","Manchester 051E","E01005319","Total",880,320,91,229,309,158,269,70,199
"2011","Manchester 052A","E01005290","Total",675,288,70,218,224,95,226,53,173
"2011","Manchester 052B","E01005292","Total",696,278,55,223,209,105,231,39,192
"2011","Manchester 052C","E01005293","Total",521,121,17,104,168,66,110,27,83
"2011","Manchester 052D","E01005294","Total",645,241,18,223,163,63,193,32,161
"2011","Manchester 052E","E01005317","Total",774,325,55,270,202,85,277,46,231
"2011","Manchester 053A","E01005313","Total",618,263,66,197,194,90,221,49,172
"2011","Manchester 053B","E01005314","Total",635,252,54,198,209,77,219,43,176
"2011","Manchester 053C","E01005315","Total",715,311,55,256,205,94,244,39,205
"2011","Manchester 053D","E01005316","Total",702,194,32,162,203,107,159,34,125
"2011","Manchester 053E","E01005318","Total",782,280,71,209,272,129,243,60,183
"2011","Manchester 054A","E01005130","Total",767,362,79,283,185,99,271,40,231
"2011","Manchester 054B","E01033651","Total",630,118,11,107,41,23,49,8,41
"2011","Manchester 054C","E01033658","Total",711,132,9,123,32,28,58,3,55
"2011","Manchester 054D","E01033664","Total",607,57,3,54,23,17,27,3,24
"2011","Manchester 054E","E01033667","Total",653,132,5,127,19,15,84,0,84
"2011","Manchester 055A","E01005128","Total",766,299,3,296,26,18,48,1,47
"2011","Manchester 055B","E01033653","Total",1036,320,5,315,28,18,145,5,140
"2011","Manchester 055C","E01033654","Total",617,146,2,144,12,8,50,0,50
"2011","Manchester 055D","E01033659","Total",760,62,2,60,28,22,48,4,44
"2011","Manchester 055E","E01033661","Total",706,205,4,201,15,11,140,2,138
"2011","Manchester 056A","E01005143","Total",792,320,114,206,371,202,246,86,160
"2011","Manchester 056B","E01033655","Total",694,74,5,69,32,23,28,1,27
"2011","Manchester 056C","E01033665","Total",723,159,9,150,46,23,97,5,92
"2011","Manchester 056D","E01033676","Total",730,385,95,290,236,103,274,55,219
"2011","Manchester 057A","E01005212","Total",696,287,44,243,125,86,168,26,142
"2011","Manchester 057B","E01033656","Total",761,328,4,324,15,9,31,0,31
"2011","Manchester 057C","E01033662","Total",842,297,2,295,17,12,72,3,69
"2011","Manchester 058A","E01005142","Total",729,346,116,230,291,160,272,79,193
"2011","Manchester 058B","E01005147","Total",914,348,143,205,427,213,261,98,163
"2011","Manchester 058C","E01033674","Total",647,125,34,91,142,91,92,25,67
"2011","Manchester 058D","E01033675","Total",757,245,117,128,363,192,181,70,111
"2011","Manchester 059A","E01005213","Total",1178,474,67,407,218,123,315,34,281
"2011","Manchester 059B","E01033660","Total",698,40,4,36,17,11,36,2,34
"2011","Manchester 059C","E01033672","Total",725,294,54,240,131,73,186,11,175
"2011","Manchester 059D","E01033673","Total",673,36,2,34,12,9,22,1,21
"2011","Manchester 060A","E01033677","Total",699,276,4,272,25,19,38,2,36
"2011","Manchester 060B","E01033681","Total",844,107,4,103,30,21,41,2,39
"2011","Manchester 060C","E01033682","Total",797,99,1,98,18,15,51,1,50
"2011","Manchester 060D","E01033683","Total",747,162,9,153,33,26,39,2,37
"2011","Oldham 001A","E01005357","Total",616,243,10,233,144,47,151,21,130
"2011","Oldham 001B","E01005358","Total",735,245,32,213,219,97,233,39,194
"2011","Oldham 001C","E01005359","Total",757,320,7,313,148,47,219,25,194
"2011","Oldham 001D","E01005360","Total",648,311,23,288,146,52,219,28,191
"2011","Oldham 002A","E01005441","Total",792,347,34,313,206,84,274,29,245
"2011","Oldham 002B","E01005442","Total",588,153,8,145,167,55,132,27,105
"2011","Oldham 002C","E01005444","Total",672,220,35,185,225,102,183,39,144
"2011","Oldham 002D","E01005445","Total",672,215,29,186,227,117,193,34,159
"2011","Oldham 003A","E01005361","Total",728,291,12,279,176,49,202,32,170
"2011","Oldham 003B","E01005443","Total",552,133,2,131,163,46,114,21,93
"2011","Oldham 003C","E01005446","Total",605,188,26,162,191,68,156,28,128
"2011","Oldham 003D","E01005447","Total",701,313,32,281,209,98,245,37,208
"2011","Oldham 004A","E01005390","Total",604,174,16,158,191,74,131,21,110
"2011","Oldham 004B","E01005394","Total",654,228,14,214,188,54,188,23,165
"2011","Oldham 004C","E01005395","Total",610,181,16,165,183,60,145,30,115
"2011","Oldham 004D","E01005396","Total",589,200,23,177,161,59,154,29,125
"2011","Oldham 005A","E01005355","Total",630,191,18,173,209,89,151,33,118
"2011","Oldham 005B","E01005356","Total",503,89,8,81,203,55,118,34,84
"2011","Oldham 005C","E01005399","Total",698,215,9,206,168,49,196,31,165
"2011","Oldham 005D","E01005403","Total",644,133,13,120,263,107,134,42,92
"2011","Oldham 006A","E01005410","Total",599,135,5,130,202,55,141,27,114
"2011","Oldham 006B","E01005411","Total",721,276,5,271,166,51,226,24,202
"2011","Oldham 006C","E01005414","Total",525,125,6,119,155,48,107,26,81
"2011","Oldham 006D","E01005415","Total",508,222,16,206,138,42,145,22,123
"2011","Oldham 007C","E01005452","Total",543,109,7,102,181,47,149,32,117
"2011","Oldham 007D","E01005453","Total",537,141,11,130,171,52,127,26,101
"2011","Oldham 007E","E01032558","Total",641,286,90,196,248,121,212,55,157
"2011","Oldham 007F","E01032559","Total",1005,180,46,134,496,185,213,77,136
"2011","Oldham 008A","E01005391","Total",651,209,18,191,197,57,184,37,147
"2011","Oldham 008B","E01005392","Total",767,374,33,341,162,61,319,28,291
"2011","Oldham 008C","E01005393","Total",524,188,6,182,125,43,148,17,131
"2011","Oldham 008D","E01005401","Total",689,231,7,224,213,62,179,30,149
"2011","Oldham 009A","E01005397","Total",637,217,14,203,181,58,168,23,145
"2011","Oldham 009B","E01005398","Total",656,216,14,202,192,84,172,23,149
"2011","Oldham 009C","E01005400","Total",753,382,33,349,162,65,293,27,266
"2011","Oldham 009D","E01005402","Total",622,177,17,160,214,79,154,34,120
"2011","Oldham 010A","E01005335","Total",540,171,9,162,133,44,144,17,127
"2011","Oldham 010B","E01005337","Total",655,183,48,135,290,174,171,54,117
"2011","Oldham 010C","E01005339","Total",589,212,4,208,171,44,148,24,124
"2011","Oldham 010D","E01005340","Total",606,251,39,212,198,73,217,43,174
"2011","Oldham 011A","E01005421","Total",735,247,71,176,274,122,192,45,147
"2011","Oldham 011B","E01005422","Total",533,199,100,99,294,116,146,71,75
"2011","Oldham 011E","E01032920","Total",880,346,60,286,252,105,294,36,258
"2011","Oldham 012A","E01005448","Total",781,435,86,349,215,108,304,38,266
"2011","Oldham 012B","E01005449","Total",578,277,45,232,153,61,216,33,183
"2011","Oldham 012C","E01005454","Total",569,137,10,127,196,64,125,20,105
"2011","Oldham 012D","E01005455","Total",619,137,32,105,240,93,131,39,92
"2011","Oldham 012E","E01005456","Total",785,340,59,281,224,89,272,43,229
"2011","Oldham 013A","E01005407","Total",724,183,5,178,199,65,154,27,127
"2011","Oldham 013B","E01005412","Total",784,241,10,231,192,66,174,18,156
"2011","Oldham 013C","E01005416","Total",599,146,7,139,162,58,130,22,108
"2011","Oldham 013D","E01005417","Total",635,208,6,202,148,45,161,17,144
"2011","Oldham 014A","E01005348","Total",625,307,69,238,242,125,221,40,181
"2011","Oldham 014B","E01005350","Total",989,625,67,558,193,105,484,53,431
"2011","Oldham 014C","E01005432","Total",648,325,80,245,222,82,256,52,204
"2011","Oldham 014D","E01005433","Total",666,323,98,225,226,106,223,52,171
"2011","Oldham 015A","E01005329","Total",616,120,6,114,198,58,143,29,114
"2011","Oldham 015B","E01005330","Total",626,162,3,159,179,61,171,30,141
"2011","Oldham 015C","E01005333","Total",499,129,3,126,132,30,117,16,101
"2011","Oldham 015D","E01005336","Total",630,222,7,215,196,65,176,22,154
"2011","Oldham 016A","E01005349","Total",538,171,102,69,392,232,157,101,56
"2011","Oldham 016B","E01005351","Total",467,144,62,82,294,175,132,63,69
"2011","Oldham 016C","E01005352","Total",461,189,49,140,182,111,156,53,103
"2011","Oldham 016D","E01005353","Total",657,326,80,246,240,116,234,71,163
"2011","Oldham 016E","E01005354","Total",541,134,55,79,257,154,158,62,96
"2011","Oldham 017A","E01005327","Total",757,264,33,231,245,110,225,39,186
"2011","Oldham 017B","E01005328","Total",696,375,44,331,147,62,285,29,256
"2011","Oldham 017C","E01005331","Total",635,217,29,188,202,85,172,39,133
"2011","Oldham 017D","E01005334","Total",541,91,10,81,247,76,113,31,82
"2011","Oldham 017E","E01005338","Total",752,380,57,323,233,120,296,42,254
"2011","Oldham 018A","E01005387","Total",631,179,12,167,188,76,160,23,137
"2011","Oldham 018B","E01005388","Total",596,220,25,195,166,63,194,32,162
"2011","Oldham 018C","E01005389","Total",727,280,63,217,245,108,205,34,171
"2011","Oldham 018D","E01005418","Total",585,161,5,156,193,59,155,24,131
"2011","Oldham 019A","E01005428","Total",532,190,69,121,278,146,153,57,96
"2011","Oldham 019B","E01005431","Total",717,264,55,209,246,135,222,47,175
"2011","Oldham 019C","E01005450","Total",627,251,83,168,261,144,212,60,152
"2011","Oldham 019D","E01005451","Total",482,126,21,105,178,89,108,25,83
"2011","Oldham 020C","E01005408","Total",794,244,10,234,210,68,181,27,154
"2011","Oldham 020D","E01005409","Total",664,182,10,172,227,67,170,32,138
"2011","Oldham 020E","E01032922","Total",1071,429,19,410,280,96,315,44,271
"2011","Oldham 021A","E01005406","Total",594,187,5,182,170,54,124,19,105
"2011","Oldham 021B","E01005413","Total",654,178,7,171,226,78,122,21,101
"2011","Oldham 021C","E01005419","Total",638,152,6,146,194,49,140,21,119
"2011","Oldham 021D","E01005420","Total",716,248,19,229,207,64,225,36,189
"2011","Oldham 022A","E01005321","Total",596,241,54,187,219,115,194,44,150
"2011","Oldham 022B","E01005326","Total",554,139,59,80,374,203,180,108,72
"2011","Oldham 022C","E01005427","Total",497,196,97,99,310,175,181,102,79
"2011","Oldham 022D","E01005429","Total",479,153,72,81,299,157,157,75,82
"2011","Oldham 022E","E01005430","Total",714,233,82,151,362,185,213,79,134
"2011","Oldham 024A","E01005320","Total",631,240,68,172,283,155,201,53,148
"2011","Oldham 024B","E01005434","Total",657,306,35,271,165,93,233,30,203
"2011","Oldham 024C","E01005437","Total",529,124,42,82,270,149,128,57,71
"2011","Oldham 024D","E01005459","Total",407,211,66,145,197,104,177,57,120
"2011","Oldham 026A","E01005383","Total",718,277,70,207,302,146,229,66,163
"2011","Oldham 026D","E01005386","Total",626,301,73,228,203,88,211,37,174
"2011","Oldham 026E","E01032556","Total",662,203,14,189,174,76,178,26,152
"2011","Oldham 026F","E01032557","Total",745,391,103,288,276,142,280,59,221
"2011","Oldham 027A","E01005342","Total",662,320,43,277,170,65,268,37,231
"2011","Oldham 027B","E01005343","Total",547,200,43,157,202,85,168,40,128
"2011","Oldham 027C","E01005344","Total",656,233,69,164,235,106,204,51,153
"2011","Oldham 027D","E01005381","Total",642,317,65,252,208,88,260,43,217
"2011","Oldham 028A","E01005332","Total",979,352,65,287,303,137,300,68,232
"2011","Oldham 028B","E01005341","Total",602,163,17,146,206,76,137,31,106
"2011","Oldham 028C","E01005345","Total",620,201,18,183,182,62,183,38,145
"2011","Oldham 028D","E01005346","Total",610,231,9,222,144,41,168,12,156
"2011","Oldham 028E","E01005347","Total",540,146,25,121,193,76,132,43,89
"2011","Oldham 029A","E01005322","Total",523,253,89,164,215,98,189,53,136
"2011","Oldham 029B","E01005323","Total",621,246,52,194,205,92,236,57,179
"2011","Oldham 029C","E01005324","Total",612,280,89,191,238,95,211,42,169
"2011","Oldham 029D","E01005325","Total",419,213,64,149,165,81,136,35,101
"2011","Oldham 029E","E01005438","Total",966,305,70,235,331,181,261,71,190
"2011","Oldham 030A","E01005377","Total",498,224,80,144,230,82,178,57,121
"2011","Oldham 030B","E01005379","Total",507,230,99,131,256,118,181,59,122
"2011","Oldham 030C","E01005380","Total",533,204,90,114,288,105,161,64,97
"2011","Oldham 030D","E01005382","Total",598,262,61,201,189,69,221,46,175
"2011","Oldham 030E","E01005439","Total",654,260,31,229,182,75,183,26,157
"2011","Oldham 031A","E01005362","Total",612,185,17,168,186,53,160,30,130
"2011","Oldham 031B","E01005364","Total",709,255,18,237,210,67,172,32,140
"2011","Oldham 031C","E01005368","Total",729,246,51,195,242,116,202,40,162
"2011","Oldham 031D","E01005376","Total",558,218,56,162,201,95,178,45,133
"2011","Oldham 031E","E01005378","Total",663,225,45,180,197,76,190,28,162
"2011","Oldham 032A","E01005363","Total",699,235,38,197,207,95,214,27,187
"2011","Oldham 032B","E01005369","Total",655,232,61,171,219,99,178,45,133
"2011","Oldham 032C","E01005370","Total",714,364,37,327,171,71,295,35,260
"2011","Oldham 032D","E01005371","Total",554,151,42,109,197,104,154,41,113
"2011","Oldham 033A","E01005365","Total",624,187,11,176,181,64,141,25,116
"2011","Oldham 033B","E01005366","Total",699,319,33,286,179,55,240,32,208
"2011","Oldham 033C","E01005367","Total",572,177,11,166,197,52,150,27,123
"2011","Oldham 033D","E01005440","Total",625,245,15,230,137,40,210,23,187
"2011","Oldham 034A","E01005372","Total",518,189,28,161,169,64,162,24,138
"2011","Oldham 034B","E01005373","Total",507,200,6,194,130,43,150,15,135
"2011","Oldham 034C","E01005374","Total",621,237,21,216,192,61,189,34,155
"2011","Oldham 034D","E01005375","Total",652,264,8,256,160,42,197,22,175
"2011","Oldham 035A","E01005435","Total",490,118,43,75,281,145,111,58,53
"2011","Oldham 035B","E01005436","Total",520,157,35,122,233,107,145,51,94
"2011","Oldham 035C","E01005460","Total",753,255,82,173,357,205,216,83,133
"2011","Oldham 035D","E01005461","Total",536,169,64,105,329,150,170,87,83
"2011","Oldham 035E","E01005462","Total",552,170,40,130,255,115,163,50,113
"2011","Oldham 035F","E01005463","Total",406,163,45,118,166,95,135,33,102
"2011","Oldham 035G","E01032921","Total",771,308,77,231,354,210,254,91,163
"2011","Rochdale 001A","E01005518","Total",591,199,36,163,170,56,172,37,135
"2011","Rochdale 001B","E01005520","Total",811,285,31,254,235,85,226,47,179
"2011","Rochdale 001C","E01005522","Total",658,234,28,206,177,83,189,25,164
"2011","Rochdale 001D","E01005523","Total",800,222,16,206,260,102,191,30,161
"2011","Rochdale 002A","E01005519","Total",615,160,22,138,238,81,142,30,112
"2011","Rochdale 002B","E01005594","Total",582,175,19,156,196,62,148,31,117
"2011","Rochdale 002C","E01005597","Total",672,181,17,164,228,91,157,39,118
"2011","Rochdale 002D","E01005598","Total",675,220,7,213,179,73,172,25,147
"2011","Rochdale 003A","E01005516","Total",552,136,10,126,191,60,119,29,90
"2011","Rochdale 003B","E01005517","Total",651,240,11,229,148,49,181,23,158
"2011","Rochdale 003C","E01005521","Total",627,182,3,179,157,59,173,24,149
"2011","Rochdale 003D","E01005596","Total",753,177,20,157,265,111,177,36,141
"2011","Rochdale 004A","E01005578","Total",489,218,61,157,201,93,193,60,133
"2011","Rochdale 004B","E01005579","Total",538,230,86,144,281,145,170,59,111
"2011","Rochdale 004C","E01005586","Total",664,386,83,303,218,102,291,71,220
"2011","Rochdale 004D","E01005593","Total",569,194,68,126,259,98,176,64,112
"2011","Rochdale 004E","E01005595","Total",792,449,36,413,149,71,355,39,316
"2011","Rochdale 005A","E01005489","Total",503,179,26,153,149,63,130,26,104
"2011","Rochdale 005B","E01005490","Total",410,151,38,113,170,72,143,46,97
"2011","Rochdale 005C","E01005491","Total",697,261,28,233,182,64,225,34,191
"2011","Rochdale 005D","E01005493","Total",669,184,6,178,200,62,152,27,125
"2011","Rochdale 005E","E01005494","Total",704,208,26,182,255,100,175,50,125
"2011","Rochdale 005F","E01005495","Total",684,256,29,227,187,74,214,47,167
"2011","Rochdale 006A","E01005488","Total",581,91,14,77,266,99,101,24,77
"2011","Rochdale 006B","E01005492","Total",614,173,12,161,192,60,153,31,122
"2011","Rochdale 006C","E01005499","Total",649,183,15,168,176,74,152,23,129
"2011","Rochdale 006D","E01005571","Total",653,151,4,147,192,66,109,23,86
"2011","Rochdale 007A","E01005570","Total",572,206,4,202,131,41,140,16,124
"2011","Rochdale 007B","E01005572","Total",638,158,5,153,218,69,156,34,122
"2011","Rochdale 007C","E01005573","Total",561,165,3,162,205,63,130,23,107
"2011","Rochdale 007D","E01005574","Total",680,194,10,184,187,60,152,31,121
"2011","Rochdale 007E","E01005587","Total",508,79,5,74,239,61,109,43,66
"2011","Rochdale 007F","E01005588","Total",688,353,22,331,158,53,266,32,234
"2011","Rochdale 008A","E01005580","Total",585,191,49,142,231,109,160,50,110
"2011","Rochdale 008B","E01005581","Total",599,281,55,226,226,113,216,43,173
"2011","Rochdale 008D","E01005583","Total",464,188,45,143,205,108,191,62,129
"2011","Rochdale 008F","E01005585","Total",463,147,51,96,218,118,124,47,77
"2011","Rochdale 008G","E01033258","Total",795,261,107,154,436,203,275,126,149
"2011","Rochdale 009A","E01005496","Total",537,204,65,139,245,91,171,47,124
"2011","Rochdale 009B","E01005589","Total",653,183,25,158,207,94,163,36,127
"2011","Rochdale 009C","E01005590","Total",527,195,52,143,231,98,158,52,106
"2011","Rochdale 009D","E01005591","Total",626,224,10,214,162,68,199,31,168
"2011","Rochdale 009E","E01005592","Total",615,290,81,209,228,97,225,46,179
"2011","Rochdale 010A","E01005472","Total",663,280,72,208,230,119,212,51,161
"2011","Rochdale 010B","E01005473","Total",492,187,49,138,209,94,157,57,100
"2011","Rochdale 010C","E01005482","Total",1173,674,76,598,181,94,452,52,400
"2011","Rochdale 010D","E01005483","Total",812,401,66,335,217,126,303,48,255
"2011","Rochdale 010E","E01005484","Total",907,499,115,384,278,150,322,64,258
"2011","Rochdale 010F","E01005486","Total",566,220,81,139,271,140,168,65,103
"2011","Rochdale 010G","E01005487","Total",568,205,49,156,248,123,180,56,124
"2011","Rochdale 011A","E01005474","Total",480,176,14,162,142,50,124,24,100
"2011","Rochdale 011B","E01005575","Total",722,280,15,265,188,68,166,25,141
"2011","Rochdale 011C","E01005576","Total",557,192,5,187,164,62,120,24,96
"2011","Rochdale 011D","E01005577","Total",637,227,5,222,165,46,161,20,141
"2011","Rochdale 012A","E01005469","Total",716,217,25,192,248,85,198,46,152
"2011","Rochdale 012B","E01005563","Total",631,225,73,152,270,111,182,73,109
"2011","Rochdale 012C","E01005565","Total",558,197,55,142,241,78,188,60,128
"2011","Rochdale 012D","E01005566","Total",810,259,72,187,352,175,236,76,160
"2011","Rochdale 012E","E01005568","Total",632,362,110,252,255,135,260,74,186
"2011","Rochdale 012F","E01005569","Total",641,268,53,215,223,103,216,61,155
"2011","Rochdale 013A","E01005556","Total",669,175,18,157,209,76,161,29,132
"2011","Rochdale 013B","E01005559","Total",691,314,55,259,220,93,253,58,195
"2011","Rochdale 013C","E01005560","Total",695,260,21,239,181,62,198,32,166
"2011","Rochdale 013D","E01005567","Total",647,205,30,175,215,97,184,46,138
"2011","Rochdale 014A","E01005555","Total",525,119,9,110,192,60,101,22,79
"2011","Rochdale 014B","E01005557","Total",499,166,4,162,136,47,116,15,101
"2011","Rochdale 014C","E01005558","Total",711,228,24,204,208,94,221,40,181
"2011","Rochdale 014D","E01005561","Total",598,161,10,151,161,56,147,23,124
"2011","Rochdale 014E","E01005562","Total",691,226,22,204,209,80,209,39,170
"2011","Rochdale 015A","E01005470","Total",474,155,65,90,262,126,142,58,84
"2011","Rochdale 015B","E01005471","Total",562,207,63,144,242,123,185,70,115
"2011","Rochdale 015C","E01005475","Total",597,236,44,192,225,102,209,58,151
"2011","Rochdale 015D","E01005485","Total",622,242,55,187,275,114,236,86,150
"2011","Rochdale 015E","E01005564","Total",641,255,82,173,302,142,230,87,143
"2011","Rochdale 016A","E01005464","Total",643,277,96,181,299,125,231,79,152
"2011","Rochdale 016B","E01005465","Total",761,283,44,239,234,90,236,48,188
"2011","Rochdale 016C","E01005466","Total",1072,538,137,401,356,180,386,84,302
"2011","Rochdale 016D","E01005467","Total",800,420,90,330,270,129,331,72,259
"2011","Rochdale 016E","E01005468","Total",602,158,14,144,183,44,131,26,105
"2011","Rochdale 017A","E01005476","Total",708,213,17,196,226,92,194,25,169
"2011","Rochdale 017B","E01005477","Total",815,354,57,297,217,110,271,43,228
"2011","Rochdale 017C","E01005478","Total",682,266,42,224,205,87,198,42,156
"2011","Rochdale 017D","E01005479","Total",711,255,48,207,221,77,214,54,160
"2011","Rochdale 017E","E01005480","Total",739,347,33,314,176,55,278,44,234
"2011","Rochdale 017F","E01005481","Total",602,185,30,155,213,87,179,43,136
"2011","Rochdale 018A","E01005497","Total",682,294,71,223,261,118,229,47,182
"2011","Rochdale 018B","E01005501","Total",892,502,50,452,165,75,392,34,358
"2011","Rochdale 018C","E01005502","Total",715,282,27,255,186,76,220,25,195
"2011","Rochdale 018D","E01005504","Total",638,237,47,190,211,79,196,42,154
"2011","Rochdale 018E","E01005505","Total",780,281,51,230,238,111,228,44,184
"2011","Rochdale 018F","E01005509","Total",964,473,68,405,199,81,346,45,301
"2011","Rochdale 019A","E01005510","Total",440,105,13,92,150,49,103,27,76
"2011","Rochdale 019B","E01005511","Total",503,138,15,123,152,54,145,35,110
"2011","Rochdale 019C","E01005512","Total",685,267,38,229,174,73,216,17,199
"2011","Rochdale 019D","E01005513","Total",599,294,73,221,200,74,235,56,179
"2011","Rochdale 019E","E01005514","Total",658,262,56,206,205,86,205,40,165
"2011","Rochdale 019F","E01005515","Total",706,335,94,241,277,130,278,75,203
"2011","Rochdale 020A","E01005498","Total",587,177,40,137,223,94,157,41,116
"2011","Rochdale 020B","E01005500","Total",647,197,21,176,203,70,163,24,139
"2011","Rochdale 020C","E01005503","Total",522,155,4,151,161,42,136,20,116
"2011","Rochdale 020D","E01005506","Total",671,272,30,242,203,71,218,42,176
"2011","Rochdale 020E","E01005507","Total",711,192,36,156,226,93,172,40,132
"2011","Rochdale 020F","E01005508","Total",729,207,16,191,239,73,164,28,136
"2011","Rochdale 021A","E01005524","Total",638,209,27,182,185,74,170,32,138
"2011","Rochdale 021B","E01005525","Total",818,403,50,353,190,82,289,35,254
"2011","Rochdale 021C","E01005526","Total",678,236,50,186,217,90,202,50,152
"2011","Rochdale 021D","E01005528","Total",674,284,52,232,200,80,228,37,191
"2011","Rochdale 021E","E01005536","Total",653,201,56,145,228,96,185,38,147
"2011","Rochdale 021F","E01005543","Total",523,168,13,155,151,51,155,33,122
"2011","Rochdale 022A","E01005527","Total",636,313,73,240,206,83,252,54,198
"2011","Rochdale 022B","E01005529","Total",795,411,62,349,212,93,308,35,273
"2011","Rochdale 022C","E01005551","Total",797,408,93,315,255,128,279,48,231
"2011","Rochdale 022D","E01005552","Total",882,465,118,347,306,139,331,74,257
"2011","Rochdale 022E","E01005553","Total",759,322,71,251,247,101,249,55,194
"2011","Rochdale 022F","E01005554","Total",583,183,22,161,174,58,152,30,122
"2011","Rochdale 023A","E01005534","Total",642,226,40,186,212,56,211,36,175
"2011","Rochdale 023B","E01005535","Total",690,222,34,188,211,65,176,34,142
"2011","Rochdale 023C","E01005537","Total",566,123,8,115,167,55,125,26,99
"2011","Rochdale 023D","E01005538","Total",581,208,57,151,262,111,150,42,108
"2011","Rochdale 023E","E01005540","Total",581,141,17,124,169,66,151,28,123
"2011","Rochdale 023F","E01005541","Total",704,174,36,138,249,100,166,39,127
"2011","Rochdale 023G","E01005542","Total",623,287,35,252,172,79,239,36,203
"2011","Rochdale 024A","E01005533","Total",836,288,21,267,186,79,265,37,228
"2011","Rochdale 024B","E01005539","Total",694,294,41,253,146,64,237,22,215
"2011","Rochdale 024C","E01005546","Total",618,255,24,231,140,54,192,22,170
"2011","Rochdale 024D","E01005547","Total",630,206,31,175,203,95,183,37,146
"2011","Rochdale 024E","E01005548","Total",655,280,20,260,136,59,219,16,203
"2011","Rochdale 025A","E01005530","Total",645,271,5,266,150,39,193,23,170
"2011","Rochdale 025B","E01005531","Total",509,146,18,128,151,59,145,26,119
"2011","Rochdale 025C","E01005532","Total",669,307,71,236,207,77,230,45,185
"2011","Rochdale 025D","E01005544","Total",609,244,9,235,164,59,162,24,138
"2011","Rochdale 025E","E01005545","Total",481,160,7,153,150,42,117,16,101
"2011","Rochdale 025F","E01005549","Total",588,189,6,183,198,69,160,28,132
"2011","Rochdale 025G","E01005550","Total",630,274,8,266,153,55,178,20,158
"2011","Salford 001A","E01005659","Total",631,242,43,199,202,78,213,45,168
"2011","Salford 001B","E01005660","Total",675,363,90,273,227,100,271,62,209
"2011","Salford 001C","E01005663","Total",618,245,53,192,205,95,192,37,155
"2011","Salford 001D","E01005664","Total",630,323,102,221,247,129,237,65,172
"2011","Salford 001E","E01005665","Total",629,347,106,241,245,123,254,67,187
"2011","Salford 002A","E01005703","Total",704,352,85,267,230,91,250,44,206
"2011","Salford 002B","E01005704","Total",591,216,56,160,203,83,167,42,125
"2011","Salford 002C","E01005706","Total",655,295,71,224,222,102,239,49,190
"2011","Salford 002D","E01005708","Total",750,341,44,297,190,89,267,33,234
"2011","Salford 003A","E01005702","Total",927,315,50,265,283,119,232,43,189
"2011","Salford 003B","E01005705","Total",869,292,34,258,266,96,254,40,214
"2011","Salford 003C","E01005707","Total",783,332,76,256,259,120,257,56,201
"2011","Salford 004A","E01005661","Total",725,260,88,172,292,148,210,55,155
"2011","Salford 004B","E01005662","Total",617,305,106,199,257,131,213,62,151
"2011","Salford 004C","E01005709","Total",605,320,96,224,218,93,251,67,184
"2011","Salford 004D","E01005710","Total",608,239,31,208,178,67,180,35,145
"2011","Salford 005A","E01005670","Total",822,362,52,310,227,97,278,32,246
"2011","Salford 005B","E01005672","Total",608,154,34,120,190,81,150,33,117
"2011","Salford 005C","E01005676","Total",554,196,5,191,116,35,143,14,129
"2011","Salford 005D","E01005677","Total",696,243,24,219,197,72,192,27,165
"2011","Salford 006A","E01005686","Total",621,206,35,171,187,73,181,39,142
"2011","Salford 006B","E01005688","Total",657,242,47,195,233,96,172,33,139
"2011","Salford 006C","E01005691","Total",697,306,11,295,148,49,197,20,177
"2011","Salford 006D","E01005692","Total",734,368,43,325,143,71,302,29,273
"2011","Salford 007A","E01005711","Total",659,189,15,174,187,67,165,35,130
"2011","Salford 007B","E01005712","Total",728,246,36,210,199,84,195,37,158
"2011","Salford 007C","E01005713","Total",632,256,5,251,155,52,161,18,143
"2011","Salford 007D","E01005714","Total",617,249,39,210,194,69,205,34,171
"2011","Salford 007E","E01005715","Total",724,241,10,231,199,66,182,29,153
"2011","Salford 007F","E01005718","Total",822,313,18,295,178,70,284,31,253
"2011","Salford 008A","E01005673","Total",642,183,30,153,190,80,175,29,146
"2011","Salford 008B","E01005675","Total",712,154,46,108,273,142,138,49,89
"2011","Salford 008C","E01005678","Total",653,265,66,199,230,102,236,51,185
"2011","Salford 008D","E01005679","Total",670,315,108,207,270,145,215,50,165
"2011","Salford 009A","E01005687","Total",800,238,41,197,247,110,209,45,164
"2011","Salford 009B","E01005689","Total",575,268,89,179,247,125,223,50,173
"2011","Salford 009C","E01005690","Total",678,233,15,218,186,66,198,36,162
"2011","Salford 009D","E01005693","Total",611,186,22,164,179,68,168,33,135
"2011","Salford 010A","E01005646","Total",527,168,7,161,186,119,127,19,108
"2011","Salford 010B","E01005649","Total",682,262,21,241,202,125,192,26,166
"2011","Salford 010C","E01005650","Total",597,277,26,251,167,91,226,28,198
"2011","Salford 010D","E01005651","Total",537,168,61,107,308,179,154,57,97
"2011","Salford 011A","E01005647","Total",675,255,15,240,153,77,204,12,192
"2011","Salford 011B","E01005648","Total",861,243,24,219,197,106,194,28,166
"2011","Salford 011C","E01005652","Total",548,194,53,141,204,85,169,41,128
"2011","Salford 011D","E01005653","Total",626,281,100,181,242,120,194,49,145
"2011","Salford 012A","E01005671","Total",745,334,30,304,201,92,296,31,265
"2011","Salford 012B","E01005674","Total",574,186,23,163,176,73,196,39,157
"2011","Salford 012C","E01005694","Total",686,181,25,156,261,103,149,37,112
"2011","Salford 012D","E01005696","Total",626,184,28,156,203,92,172,40,132
"2011","Salford 012E","E01005698","Total",801,393,82,311,226,93,308,52,256
"2011","Salford 012F","E01005700","Total",661,214,35,179,206,90,178,36,142
"2011","Salford 013A","E01005716","Total",668,134,8,126,254,82,131,31,100
"2011","Salford 013B","E01005717","Total",543,75,4,71,270,107,80,27,53
"2011","Salford 013C","E01005734","Total",618,202,16,186,162,55,187,33,154
"2011","Salford 013D","E01005735","Total",579,164,4,160,174,60,136,21,115
"2011","Salford 013E","E01005736","Total",626,181,8,173,160,68,127,22,105
"2011","Salford 013F","E01005737","Total",604,187,14,173,190,65,143,24,119
"2011","Salford 013G","E01005739","Total",614,142,15,127,230,92,109,23,86
"2011","Salford 014A","E01005695","Total",620,179,8,171,209,83,130,28,102
"2011","Salford 014B","E01005697","Total",676,226,10,216,204,78,165,25,140
"2011","Salford 014C","E01005738","Total",768,264,10,254,182,79,186,23,163
"2011","Salford 014D","E01005740","Total",708,232,2,230,179,67,180,25,155
"2011","Salford 014E","E01005741","Total",685,221,5,216,198,68,164,16,148
"2011","Salford 014F","E01005742","Total",673,213,11,202,204,81,163,28,135
"2011","Salford 015A","E01005625","Total",601,209,12,197,161,64,174,18,156
"2011","Salford 015B","E01005627","Total",477,143,7,136,146,52,133,21,112
"2011","Salford 015C","E01005699","Total",639,220,7,213,177,58,172,21,151
"2011","Salford 015D","E01005701","Total",619,192,18,174,196,69,149,28,121
"2011","Salford 016A","E01005609","Total",852,287,75,212,207,102,214,52,162
"2011","Salford 016B","E01005611","Total",898,381,81,300,222,102,281,53,228
"2011","Salford 016C","E01005612","Total",1031,599,61,538,220,127,441,51,390
"2011","Salford 016D","E01005613","Total",984,504,102,402,311,165,318,66,252
"2011","Salford 016E","E01005614","Total",529,153,38,115,265,184,147,56,91
"2011","Salford 016F","E01005615","Total",695,305,62,243,200,115,192,33,159
"2011","Salford 017A","E01005624","Total",677,295,80,215,247,113,250,60,190
"2011","Salford 017B","E01005680","Total",723,388,72,316,178,82,273,37,236
"2011","Salford 017C","E01005683","Total",777,445,116,329,243,102,318,81,237
"2011","Salford 017F","E01032919","Total",976,456,144,312,292,152,300,64,236
"2011","Salford 018A","E01005622","Total",665,197,22,175,194,99,202,29,173
"2011","Salford 018B","E01005623","Total",498,135,10,125,141,43,119,22,97
"2011","Salford 018C","E01005626","Total",507,151,9,142,150,54,122,16,106
"2011","Salford 018D","E01005628","Total",692,213,13,200,144,69,177,28,149
"2011","Salford 019A","E01005725","Total",559,270,77,193,213,93,216,59,157
"2011","Salford 019B","E01005726","Total",615,195,42,153,213,86,183,37,146
"2011","Salford 019C","E01005727","Total",653,177,29,148,169,79,162,23,139
"2011","Salford 019D","E01005728","Total",584,201,10,191,164,55,182,32,150
"2011","Salford 019E","E01005733","Total",503,218,72,146,188,75,161,47,114
"2011","Salford 020A","E01005631","Total",1021,609,17,592,84,43,486,19,467
"2011","Salford 020B","E01005632","Total",916,253,39,214,256,153,240,47,193
"2011","Salford 020C","E01005633","Total",597,242,29,213,181,58,194,29,165
"2011","Salford 020D","E01005634","Total",601,126,7,119,184,72,107,17,90
"2011","Salford 020E","E01005635","Total",704,209,8,201,136,53,154,17,137
"2011","Salford 020F","E01005636","Total",680,212,9,203,166,67,177,16,161
"2011","Salford 020G","E01005637","Total",628,209,16,193,155,70,187,28,159
"2011","Salford 021A","E01005629","Total",618,261,13,248,131,41,204,17,187
"2011","Salford 021B","E01005630","Total",648,193,32,161,208,91,177,36,141
"2011","Salford 021C","E01005719","Total",915,388,32,356,146,74,297,28,269
"2011","Salford 021D","E01005720","Total",1121,362,95,267,297,152,274,54,220
"2011","Salford 021E","E01005722","Total",709,285,77,208,256,111,245,66,179
"2011","Salford 021F","E01005723","Total",639,259,61,198,215,103,226,42,184
"2011","Salford 021G","E01005724","Total",643,236,6,230,128,46,206,14,192
"2011","Salford 022D","E01005610","Total",472,275,73,202,151,70,218,44,174
"2011","Salford 022E","E01032684","Total",631,170,29,141,87,48,100,22,78
"2011","Salford 022F","E01032687","Total",716,109,5,104,31,20,71,5,66
"2011","Salford 022G","E01032906","Total",712,219,22,197,54,32,134,12,122
"2011","Salford 022H","E01032907","Total",659,205,27,178,83,30,155,19,136
"2011","Salford 022I","E01032909","Total",837,124,11,113,26,19,40,3,37
"2011","Salford 022J","E01032911","Total",731,115,17,98,45,26,56,6,50
"2011","Salford 022K","E01033330","Total",875,410,44,366,113,50,313,20,293
"2011","Salford 023A","E01005654","Total",754,208,64,144,150,81,159,32,127
"2011","Salford 023B","E01005656","Total",645,234,79,155,223,107,197,50,147
"2011","Salford 023C","E01005657","Total",709,324,40,284,153,52,240,36,204
"2011","Salford 023D","E01005721","Total",766,379,19,360,119,47,291,23,268
"2011","Salford 024A","E01005655","Total",716,362,68,294,143,80,217,35,182
"2011","Salford 024B","E01005658","Total",662,371,98,273,222,90,258,42,216
"2011","Salford 024C","E01005681","Total",568,350,24,326,52,22,268,11,257
"2011","Salford 024D","E01005682","Total",1035,595,51,544,111,43,458,24,434
"2011","Salford 025A","E01005729","Total",743,400,75,325,174,81,298,41,257
"2011","Salford 025B","E01005730","Total",711,193,33,160,233,98,194,54,140
"2011","Salford 025C","E01005731","Total",594,257,92,165,261,113,190,54,136
"2011","Salford 025D","E01005732","Total",558,270,47,223,136,49,221,34,187
"2011","Salford 026A","E01005599","Total",809,365,34,331,176,91,309,35,274
"2011","Salford 026B","E01005600","Total",612,188,51,137,220,104,163,49,114
"2011","Salford 026C","E01005601","Total",662,284,67,217,219,101,199,50,149
"2011","Salford 026D","E01005602","Total",775,368,57,311,182,82,256,33,223
"2011","Salford 027A","E01005603","Total",653,179,69,110,270,118,162,44,118
"2011","Salford 027B","E01005604","Total",702,240,35,205,205,92,202,41,161
"2011","Salford 027C","E01005605","Total",668,226,41,185,166,90,172,32,140
"2011","Salford 027D","E01005638","Total",759,276,61,215,226,103,220,37,183
"2011","Salford 028B","E01005667","Total",879,387,82,305,240,105,313,58,255
"2011","Salford 028E","E01032685","Total",945,137,12,125,52,41,81,4,77
"2011","Salford 028F","E01032686","Total",880,102,5,97,31,26,68,4,64
"2011","Salford 028G","E01032912","Total",779,357,60,297,177,82,279,40,239
"2011","Salford 028H","E01032914","Total",943,147,23,124,97,61,102,14,88
"2011","Salford 028I","E01032915","Total",693,284,91,193,215,105,217,46,171
"2011","Salford 028J","E01032917","Total",591,141,20,121,64,31,92,7,85
"2011","Salford 029A","E01005639","Total",605,296,117,179,286,144,216,64,152
"2011","Salford 029B","E01005640","Total",546,203,65,138,247,100,162,52,110
"2011","Salford 029C","E01005641","Total",640,268,31,237,177,67,215,20,195
"2011","Salford 029D","E01005642","Total",512,129,17,112,173,72,93,16,77
"2011","Salford 029E","E01005643","Total",671,316,13,303,134,47,235,17,218
"2011","Salford 029F","E01005644","Total",631,117,25,92,227,99,117,33,84
"2011","Salford 029G","E01005645","Total",603,224,6,218,155,46,167,20,147
"2011","Salford 030A","E01005616","Total",620,279,43,236,188,60,242,52,190
"2011","Salford 030B","E01005617","Total",611,180,17,163,203,78,147,35,112
"2011","Salford 030C","E01005618","Total",666,264,44,220,235,100,235,46,189
"2011","Salford 030D","E01005619","Total",528,180,39,141,168,51,155,31,124
"2011","Salford 030E","E01005620","Total",1060,230,40,190,388,201,232,64,168
"2011","Salford 030F","E01005621","Total",768,255,37,218,223,110,223,42,181
"2011","Stockport 001A","E01005886","Total",656,185,41,144,239,108,147,36,111
"2011","Stockport 001B","E01005888","Total",592,183,43,140,230,90,154,45,109
"2011","Stockport 001C","E01005889","Total",686,283,35,248,178,78,204,29,175
"2011","Stockport 001D","E01005891","Total",569,168,11,157,130,36,164,30,134
"2011","Stockport 001E","E01005894","Total",573,161,16,145,203,83,144,29,115
"2011","Stockport 002A","E01005887","Total",595,206,69,137,261,117,168,59,109
"2011","Stockport 002B","E01005890","Total",579,187,45,142,229,100,159,47,112
"2011","Stockport 002C","E01005893","Total",837,242,35,207,208,107,199,31,168
"2011","Stockport 002D","E01005896","Total",776,197,36,161,242,114,179,35,144
"2011","Stockport 002E","E01005919","Total",716,265,69,196,248,111,211,50,161
"2011","Stockport 003A","E01005862","Total",604,164,11,153,217,81,133,31,102
"2011","Stockport 003B","E01005892","Total",560,170,22,148,171,78,143,20,123
"2011","Stockport 003C","E01005895","Total",491,170,20,150,158,50,156,28,128
"2011","Stockport 003D","E01005920","Total",636,178,11,167,192,69,177,29,148
"2011","Stockport 003E","E01005921","Total",690,222,31,191,183,69,219,38,181
"2011","Stockport 003F","E01005922","Total",635,211,15,196,175,54,179,35,144
"2011","Stockport 004A","E01005753","Total",672,338,112,226,270,128,258,75,183
"2011","Stockport 004B","E01005754","Total",945,526,83,443,226,114,375,63,312
"2011","Stockport 004C","E01005755","Total",672,288,108,180,279,131,223,56,167
"2011","Stockport 004D","E01005756","Total",764,431,126,305,254,128,220,49,171
"2011","Stockport 005A","E01005745","Total",595,160,22,138,196,80,142,33,109
"2011","Stockport 005B","E01005746","Total",777,446,14,432,117,50,360,27,333
"2011","Stockport 005C","E01005747","Total",587,159,12,147,190,69,125,25,100
"2011","Stockport 005D","E01005748","Total",659,270,6,264,158,48,173,14,159
"2011","Stockport 006A","E01005863","Total",776,229,10,219,184,72,171,18,153
"2011","Stockport 006B","E01005864","Total",624,126,6,120,168,78,112,16,96
"2011","Stockport 006C","E01005866","Total",821,241,16,225,185,77,209,34,175
"2011","Stockport 006D","E01005869","Total",610,204,10,194,173,75,171,24,147
"2011","Stockport 007A","E01005914","Total",675,245,17,228,176,69,210,25,185
"2011","Stockport 007B","E01005915","Total",722,243,35,208,200,96,219,39,180
"2011","Stockport 007C","E01005916","Total",708,200,37,163,192,77,156,28,128
"2011","Stockport 007D","E01005917","Total",847,263,63,200,213,99,225,36,189
"2011","Stockport 008A","E01005859","Total",625,162,6,156,169,59,136,17,119
"2011","Stockport 008B","E01005865","Total",632,220,6,214,168,46,139,16,123
"2011","Stockport 008C","E01005867","Total",660,222,4,218,148,45,175,24,151
"2011","Stockport 008D","E01005868","Total",576,169,13,156,209,65,138,37,101
"2011","Stockport 009A","E01005743","Total",583,205,15,190,160,60,156,32,124
"2011","Stockport 009B","E01005744","Total",605,218,27,191,155,66,166,23,143
"2011","Stockport 009C","E01005749","Total",731,210,14,196,216,82,199,37,162
"2011","Stockport 009D","E01005750","Total",703,163,24,139,238,101,168,35,133
"2011","Stockport 009E","E01005751","Total",586,155,35,120,184,86,129,27,102
"2011","Stockport 010A","E01005897","Total",599,191,35,156,223,85,167,43,124
"2011","Stockport 010B","E01005898","Total",723,286,19,267,192,59,222,34,188
"2011","Stockport 010C","E01005900","Total",770,344,19,325,174,64,269,34,235
"2011","Stockport 010D","E01005903","Total",623,253,0,253,144,45,153,13,140
"2011","Stockport 010E","E01005904","Total",624,223,11,212,182,64,154,28,126
"2011","Stockport 011A","E01005853","Total",655,211,47,164,235,94,178,34,144
"2011","Stockport 011B","E01005856","Total",661,180,16,164,200,82,140,27,113
"2011","Stockport 011C","E01005860","Total",580,153,6,147,214,87,152,33,119
"2011","Stockport 011D","E01005861","Total",714,262,6,256,182,70,201,27,174
"2011","Stockport 012A","E01005752","Total",626,244,46,198,239,84,223,52,171
"2011","Stockport 012B","E01005899","Total",744,342,19,323,177,67,256,34,222
"2011","Stockport 012C","E01005901","Total",621,251,10,241,127,41,173,23,150
"2011","Stockport 012D","E01005902","Total",736,318,56,262,234,98,254,49,205
"2011","Stockport 012E","E01005905","Total",614,242,54,188,211,99,238,64,174
"2011","Stockport 013A","E01005852","Total",695,179,12,167,170,61,144,19,125
"2011","Stockport 013B","E01005854","Total",739,200,2,198,191,84,157,22,135
"2011","Stockport 013C","E01005855","Total",594,154,7,147,194,68,132,27,105
"2011","Stockport 013D","E01005857","Total",595,140,8,132,202,75,136,39,97
"2011","Stockport 013E","E01005858","Total",790,226,10,216,166,58,172,23,149
"2011","Stockport 014A","E01005757","Total",709,194,39,155,228,134,163,40,123
"2011","Stockport 014B","E01005758","Total",1148,580,53,527,150,65,485,51,434
"2011","Stockport 014C","E01005766","Total",695,252,40,212,159,72,210,36,174
"2011","Stockport 014D","E01005918","Total",894,529,77,452,164,81,370,39,331
"2011","Stockport 015A","E01005870","Total",600,155,35,120,220,95,141,39,102
"2011","Stockport 015B","E01005871","Total",597,156,30,126,181,92,149,27,122
"2011","Stockport 015C","E01005873","Total",578,159,10,149,219,63,152,31,121
"2011","Stockport 015D","E01005875","Total",656,178,14,164,209,92,154,34,120
"2011","Stockport 016A","E01005764","Total",777,223,45,178,247,142,199,49,150
"2011","Stockport 016B","E01005816","Total",699,165,43,122,253,136,125,24,101
"2011","Stockport 016C","E01005817","Total",636,155,27,128,171,85,141,34,107
"2011","Stockport 016D","E01005822","Total",886,386,55,331,165,85,324,39,285
"2011","Stockport 017A","E01005880","Total",643,223,5,218,176,75,177,25,152
"2011","Stockport 017B","E01005881","Total",506,158,3,155,143,50,95,15,80
"2011","Stockport 017C","E01005883","Total",663,234,4,230,161,51,143,17,126
"2011","Stockport 017D","E01005908","Total",575,171,6,165,180,62,97,16,81
"2011","Stockport 018A","E01005765","Total",578,135,8,127,193,79,116,21,95
"2011","Stockport 018B","E01005818","Total",557,153,45,108,220,95,144,50,94
"2011","Stockport 018C","E01005819","Total",651,164,16,148,180,80,142,25,117
"2011","Stockport 018D","E01005820","Total",642,174,27,147,170,80,148,24,124
"2011","Stockport 018E","E01005821","Total",679,206,22,184,206,99,177,40,137
"2011","Stockport 018F","E01005823","Total",696,201,37,164,238,113,184,34,150
"2011","Stockport 019A","E01005825","Total",692,197,10,187,184,76,198,28,170
"2011","Stockport 019B","E01005872","Total",802,236,44,192,257,124,192,39,153
"2011","Stockport 019C","E01005874","Total",924,373,42,331,193,84,326,32,294
"2011","Stockport 019D","E01005876","Total",610,174,16,158,201,54,148,36,112
"2011","Stockport 019E","E01005877","Total",617,199,26,173,200,77,181,39,142
"2011","Stockport 020A","E01005878","Total",637,293,35,258,185,70,240,37,203
"2011","Stockport 020B","E01005879","Total",592,230,21,209,159,56,190,32,158
"2011","Stockport 020C","E01005882","Total",489,156,4,152,153,41,86,17,69
"2011","Stockport 020D","E01005884","Total",585,193,8,185,180,40,151,27,124
"2011","Stockport 020E","E01005885","Total",637,248,8,240,136,47,190,20,170
"2011","Stockport 021A","E01005832","Total",623,212,9,203,179,65,190,33,157
"2011","Stockport 021B","E01005833","Total",464,183,7,176,123,39,151,21,130
"2011","Stockport 021C","E01005835","Total",564,169,9,160,160,52,144,26,118
"2011","Stockport 021D","E01005837","Total",672,162,18,144,211,87,143,25,118
"2011","Stockport 021E","E01005843","Total",619,158,8,150,174,70,134,20,114
"2011","Stockport 022A","E01005769","Total",663,167,20,147,157,66,114,21,93
"2011","Stockport 022B","E01005778","Total",641,194,5,189,186,71,170,24,146
"2011","Stockport 022C","E01005779","Total",580,162,15,147,192,70,150,31,119
"2011","Stockport 022D","E01005780","Total",557,115,16,99,218,95,122,30,92
"2011","Stockport 022E","E01005781","Total",820,396,55,341,197,89,314,41,273
"2011","Stockport 023A","E01005759","Total",690,150,34,116,239,112,169,54,115
"2011","Stockport 023B","E01005760","Total",848,236,57,179,283,147,189,44,145
"2011","Stockport 023C","E01005797","Total",670,170,22,148,180,87,151,25,126
"2011","Stockport 023D","E01005800","Total",693,201,12,189,201,76,181,26,155
"2011","Stockport 023E","E01005804","Total",481,160,19,141,155,67,140,26,114
"2011","Stockport 024A","E01005824","Total",610,197,13,184,190,60,165,29,136
"2011","Stockport 024B","E01005826","Total",597,251,44,207,201,75,220,51,169
"2011","Stockport 024C","E01005827","Total",598,231,9,222,141,48,172,27,145
"2011","Stockport 024D","E01005828","Total",586,268,71,197,206,90,223,50,173
"2011","Stockport 024E","E01005829","Total",498,181,46,135,192,79,155,41,114
"2011","Stockport 025A","E01005768","Total",615,202,12,190,190,74,145,25,120
"2011","Stockport 025B","E01005770","Total",629,244,8,236,175,81,189,22,167
"2011","Stockport 025C","E01005771","Total",545,137,5,132,195,67,125,23,102
"2011","Stockport 025D","E01005775","Total",624,203,5,198,209,91,137,20,117
"2011","Stockport 026A","E01005761","Total",550,184,42,142,215,83,169,49,120
"2011","Stockport 026B","E01005762","Total",664,346,95,251,255,113,259,75,184
"2011","Stockport 026C","E01005763","Total",648,231,75,156,256,110,201,65,136
"2011","Stockport 026D","E01005799","Total",701,236,94,142,335,153,204,77,127
"2011","Stockport 027A","E01005798","Total",787,333,15,318,156,57,254,24,230
"2011","Stockport 027B","E01005801","Total",634,167,19,148,207,78,157,39,118
"2011","Stockport 027C","E01005802","Total",597,133,8,125,215,79,112,29,83
"2011","Stockport 027D","E01005803","Total",602,190,4,186,192,63,144,23,121
"2011","Stockport 027E","E01005830","Total",707,249,14,235,187,63,207,29,178
"2011","Stockport 027F","E01005831","Total",664,178,18,160,210,90,147,29,118
"2011","Stockport 028A","E01005767","Total",591,256,7,249,141,45,178,34,144
"2011","Stockport 028B","E01005772","Total",573,216,12,204,170,59,146,27,119
"2011","Stockport 028C","E01005773","Total",635,212,8,204,207,80,174,19,155
"2011","Stockport 028D","E01005774","Total",684,339,27,312,163,66,281,36,245
"2011","Stockport 028E","E01005776","Total",598,205,9,196,193,68,135,22,113
"2011","Stockport 029A","E01005909","Total",645,252,12,240,175,59,152,28,124
"2011","Stockport 029B","E01005910","Total",707,290,26,264,179,71,228,28,200
"2011","Stockport 029C","E01005911","Total",540,188,4,184,141,50,127,15,112
"2011","Stockport 029D","E01005912","Total",610,195,5,190,143,51,138,16,122
"2011","Stockport 030A","E01005782","Total",552,186,7,179,120,41,137,15,122
"2011","Stockport 030B","E01005783","Total",654,235,16,219,179,69,163,24,139
"2011","Stockport 030C","E01005784","Total",529,180,8,172,173,54,134,31,103
"2011","Stockport 030D","E01005785","Total",641,195,5,190,190,71,144,29,115
"2011","Stockport 030E","E01005786","Total",610,181,7,174,204,68,149,29,120
"2011","Stockport 031A","E01005834","Total",631,203,28,175,205,78,183,40,143
"2011","Stockport 031B","E01005836","Total",851,342,19,323,190,88,217,26,191
"2011","Stockport 031C","E01005838","Total",852,258,27,231,226,113,184,35,149
"2011","Stockport 031D","E01005840","Total",732,262,24,238,180,91,210,23,187
"2011","Stockport 032A","E01005927","Total",491,128,7,121,197,63,106,23,83
"2011","Stockport 032B","E01005928","Total",674,213,30,183,213,77,184,29,155
"2011","Stockport 032C","E01005929","Total",610,229,6,223,151,49,126,15,111
"2011","Stockport 032D","E01005930","Total",600,213,4,209,190,47,115,19,96
"2011","Stockport 033A","E01005806","Total",495,173,3,170,149,48,117,18,99
"2011","Stockport 033B","E01005813","Total",612,182,4,178,166,40,127,19,108
"2011","Stockport 033C","E01005814","Total",547,219,3,216,142,44,174,32,142
"2011","Stockport 033D","E01005815","Total",586,199,9,190,199,68,141,26,115
"2011","Stockport 034A","E01005777","Total",682,247,23,224,177,62,210,25,185
"2011","Stockport 034B","E01005787","Total",474,138,3,135,156,36,87,18,69
"2011","Stockport 034C","E01005788","Total",603,170,5,165,201,71,136,30,106
"2011","Stockport 034D","E01005790","Total",511,165,15,150,170,65,154,30,124
"2011","Stockport 035A","E01005805","Total",591,174,2,172,212,63,137,25,112
"2011","Stockport 035B","E01005807","Total",623,225,1,224,183,51,154,26,128
"2011","Stockport 035C","E01005839","Total",522,171,6,165,142,38,118,22,96
"2011","Stockport 035D","E01005841","Total",625,218,14,204,190,75,150,29,121
"2011","Stockport 036A","E01005844","Total",553,211,11,200,148,49,151,24,127
"2011","Stockport 036B","E01005845","Total",604,206,12,194,180,65,168,31,137
"2011","Stockport 036C","E01005849","Total",607,193,5,188,175,56,143,21,122
"2011","Stockport 036D","E01005851","Total",611,220,8,212,165,55,147,22,125
"2011","Stockport 037A","E01005808","Total",526,181,10,171,184,54,118,20,98
"2011","Stockport 037B","E01005809","Total",498,145,8,137,165,53,112,16,96
"2011","Stockport 037C","E01005810","Total",658,265,11,254,176,57,167,13,154
"2011","Stockport 037D","E01005811","Total",636,184,7,177,156,44,138,21,117
"2011","Stockport 037E","E01005812","Total",479,157,10,147,163,40,86,10,76
"2011","Stockport 038A","E01005842","Total",673,232,9,223,187,65,167,30,137
"2011","Stockport 038B","E01005906","Total",646,293,5,288,135,36,172,23,149
"2011","Stockport 038C","E01005907","Total",609,297,8,289,111,43,177,11,166
"2011","Stockport 038D","E01005913","Total",649,258,7,251,150,44,183,19,164
"2011","Stockport 039A","E01005789","Total",655,189,6,183,207,90,150,32,118
"2011","Stockport 039B","E01005791","Total",647,210,10,200,194,69,173,29,144
"2011","Stockport 039C","E01005793","Total",621,213,8,205,163,67,174,22,152
"2011","Stockport 039D","E01005795","Total",527,170,7,163,157,43,129,17,112
"2011","Stockport 039E","E01005796","Total",497,136,6,130,168,54,85,13,72
"2011","Stockport 040A","E01005846","Total",614,204,15,189,204,89,155,30,125
"2011","Stockport 040B","E01005847","Total",619,166,12,154,195,75,154,28,126
"2011","Stockport 040C","E01005848","Total",730,236,6,230,202,67,173,32,141
"2011","Stockport 040D","E01005850","Total",759,260,28,232,214,91,224,40,184
"2011","Stockport 041A","E01005792","Total",603,213,1,212,160,52,142,21,121
"2011","Stockport 041B","E01005794","Total",504,166,2,164,152,34,133,20,113
"2011","Stockport 041C","E01005923","Total",626,232,2,230,181,65,132,17,115
"2011","Stockport 041D","E01005931","Total",643,271,8,263,164,56,150,12,138
"2011","Stockport 042A","E01005924","Total",528,182,5,177,167,52,121,18,103
"2011","Stockport 042B","E01005925","Total",612,271,5,266,159,50,162,23,139
"2011","Stockport 042C","E01005926","Total",485,138,5,133,151,40,100,16,84
"2011","Stockport 042D","E01005932","Total",535,187,3,184,168,40,94,19,75
"2011","Tameside 001A","E01006053","Total",818,166,13,153,231,114,140,28,112
"2011","Tameside 001B","E01006054","Total",759,349,34,315,178,71,295,40,255
"2011","Tameside 001C","E01006055","Total",639,124,10,114,168,69,126,20,106
"2011","Tameside 001D","E01006057","Total",644,159,23,136,195,73,147,30,117
"2011","Tameside 001E","E01006058","Total",945,251,24,227,223,104,191,25,166
"2011","Tameside 001F","E01006059","Total",612,142,15,127,185,75,123,22,101
"2011","Tameside 002A","E01005938","Total",670,245,33,212,210,84,196,37,159
"2011","Tameside 002B","E01005939","Total",494,176,14,162,140,39,131,27,104
"2011","Tameside 002C","E01005940","Total",596,236,16,220,160,54,200,31,169
"2011","Tameside 002D","E01005955","Total",632,146,9,137,236,75,150,32,118
"2011","Tameside 003A","E01006056","Total",507,219,63,156,199,83,190,56,134
"2011","Tameside 003B","E01006061","Total",962,320,69,251,377,156,266,56,210
"2011","Tameside 003C","E01006062","Total",813,194,12,182,299,103,156,27,129
"2011","Tameside 003D","E01006063","Total",564,127,13,114,195,70,136,36,100
"2011","Tameside 004A","E01005936","Total",637,218,14,204,168,67,160,22,138
"2011","Tameside 004B","E01005937","Total",692,299,53,246,233,87,209,40,169
"2011","Tameside 004C","E01005945","Total",743,312,96,216,304,145,249,73,176
"2011","Tameside 004D","E01005946","Total",676,210,35,175,238,107,177,29,148
"2011","Tameside 004E","E01005947","Total",756,291,56,235,240,119,263,53,210
"2011","Tameside 005A","E01005954","Total",777,387,13,374,133,41,293,21,272
"2011","Tameside 005B","E01005956","Total",578,179,4,175,152,56,159,24,135
"2011","Tameside 005C","E01005957","Total",589,177,16,161,194,95,141,19,122
"2011","Tameside 005D","E01005958","Total",659,276,48,228,210,92,228,50,178
"2011","Tameside 005E","E01005959","Total",655,268,84,184,267,95,229,71,158
"2011","Tameside 006A","E01005933","Total",548,230,82,148,241,93,177,64,113
"2011","Tameside 006B","E01005934","Total",614,219,50,169,203,67,165,43,122
"2011","Tameside 006C","E01005935","Total",656,327,73,254,214,90,254,52,202
"2011","Tameside 006D","E01005949","Total",715,269,30,239,177,72,228,33,195
"2011","Tameside 006E","E01005960","Total",723,264,46,218,232,116,225,46,179
"2011","Tameside 007A","E01005941","Total",731,294,56,238,231,111,243,50,193
"2011","Tameside 007B","E01005942","Total",701,192,19,173,220,78,181,45,136
"2011","Tameside 007C","E01005943","Total",828,226,31,195,221,101,207,22,185
"2011","Tameside 007D","E01005944","Total",554,149,10,139,177,70,134,27,107
"2011","Tameside 008A","E01006060","Total",687,274,57,217,185,92,211,37,174
"2011","Tameside 008B","E01006064","Total",724,386,57,329,195,81,287,35,252
"2011","Tameside 008C","E01006065","Total",500,193,85,108,233,97,154,48,106
"2011","Tameside 008D","E01006066","Total",598,177,37,140,197,101,151,30,121
"2011","Tameside 009A","E01006067","Total",727,135,12,123,254,101,162,34,128
"2011","Tameside 009B","E01006068","Total",834,313,29,284,173,74,247,31,216
"2011","Tameside 009C","E01006069","Total",650,246,72,174,263,107,195,48,147
"2011","Tameside 009D","E01006073","Total",721,224,68,156,275,112,182,58,124
"2011","Tameside 010A","E01005993","Total",615,226,14,212,163,54,201,39,162
"2011","Tameside 010B","E01005995","Total",508,102,10,92,198,55,107,33,74
"2011","Tameside 010C","E01005996","Total",804,239,38,201,285,116,226,63,163
"2011","Tameside 010D","E01005997","Total",673,239,24,215,176,69,221,29,192
"2011","Tameside 010E","E01006000","Total",822,453,42,411,145,45,360,33,327
"2011","Tameside 011A","E01005994","Total",605,177,26,151,230,97,152,30,122
"2011","Tameside 011B","E01005999","Total",840,326,77,249,272,131,245,53,192
"2011","Tameside 011C","E01006002","Total",560,213,32,181,190,61,186,53,133
"2011","Tameside 011D","E01006004","Total",603,185,17,168,192,55,181,44,137
"2011","Tameside 011E","E01006005","Total",634,253,42,211,184,69,250,37,213
"2011","Tameside 011F","E01006007","Total",655,202,31,171,222,82,177,37,140
"2011","Tameside 012A","E01005998","Total",729,219,33,186,225,89,185,30,155
"2011","Tameside 012B","E01006001","Total",647,222,36,186,214,83,189,42,147
"2011","Tameside 012C","E01006003","Total",617,202,27,175,185,74,171,36,135
"2011","Tameside 012D","E01006006","Total",604,188,18,170,181,51,164,30,134
"2011","Tameside 013A","E01005948","Total",959,395,50,345,192,91,332,34,298
"2011","Tameside 013B","E01005950","Total",584,175,64,111,299,165,168,69,99
"2011","Tameside 013C","E01005951","Total",731,261,63,198,227,114,210,47,163
"2011","Tameside 013D","E01005952","Total",1181,576,79,497,228,116,474,61,413
"2011","Tameside 013E","E01005953","Total",797,320,71,249,295,161,262,54,208
"2011","Tameside 014A","E01005961","Total",562,155,15,140,161,64,129,23,106
"2011","Tameside 014B","E01005962","Total",597,206,13,193,183,57,174,26,148
"2011","Tameside 014C","E01005968","Total",628,190,12,178,162,54,157,28,129
"2011","Tameside 014D","E01005969","Total",573,187,17,170,157,48,134,28,106
"2011","Tameside 015A","E01006022","Total",790,267,10,257,160,62,220,25,195
"2011","Tameside 015B","E01006023","Total",790,326,31,295,191,69,288,42,246
"2011","Tameside 015C","E01006070","Total",628,172,12,160,186,72,136,28,108
"2011","Tameside 015D","E01006071","Total",650,209,2,207,142,45,149,19,130
"2011","Tameside 015E","E01006072","Total",671,160,5,155,203,61,130,23,107
"2011","Tameside 016A","E01006009","Total",569,161,19,142,168,58,163,29,134
"2011","Tameside 016B","E01006017","Total",536,139,3,136,186,71,120,23,97
"2011","Tameside 016C","E01006018","Total",560,192,5,187,144,45,159,28,131
"2011","Tameside 016D","E01006021","Total",610,207,17,190,169,64,175,18,157
"2011","Tameside 017A","E01006008","Total",615,122,34,88,234,98,129,38,91
"2011","Tameside 017B","E01006010","Total",671,292,36,256,186,94,255,41,214
"2011","Tameside 017C","E01006012","Total",777,229,34,195,236,106,204,42,162
"2011","Tameside 017D","E01006015","Total",531,96,12,84,212,64,128,36,92
"2011","Tameside 017E","E01006016","Total",979,456,61,395,196,101,338,38,300
"2011","Tameside 018A","E01006011","Total",682,290,51,239,217,93,241,47,194
"2011","Tameside 018B","E01006013","Total",548,207,7,200,150,55,180,22,158
"2011","Tameside 018C","E01006014","Total",478,139,44,95,203,76,125,44,81
"2011","Tameside 018D","E01006019","Total",803,408,35,373,165,76,319,27,292
"2011","Tameside 018E","E01006020","Total",607,237,35,202,215,71,212,42,170
"2011","Tameside 019A","E01005963","Total",509,140,14,126,157,63,136,21,115
"2011","Tameside 019B","E01005964","Total",660,193,23,170,195,85,159,25,134
"2011","Tameside 019C","E01005965","Total",662,282,45,237,185,77,215,44,171
"2011","Tameside 019D","E01005966","Total",539,132,35,97,216,84,138,37,101
"2011","Tameside 019E","E01005967","Total",694,322,41,281,175,66,267,34,233
"2011","Tameside 020A","E01006031","Total",661,284,53,231,203,98,233,44,189
"2011","Tameside 020B","E01006032","Total",547,198,43,155,182,75,187,39,148
"2011","Tameside 020C","E01006033","Total",635,251,50,201,188,84,185,33,152
"2011","Tameside 020D","E01006034","Total",931,332,68,264,328,163,275,56,219
"2011","Tameside 020E","E01006035","Total",954,328,36,292,235,114,276,40,236
"2011","Tameside 020F","E01006036","Total",819,281,75,206,282,135,222,55,167
"2011","Tameside 021A","E01005970","Total",652,234,4,230,146,43,182,23,159
"2011","Tameside 021B","E01005972","Total",737,225,57,168,262,119,193,48,145
"2011","Tameside 021C","E01005974","Total",742,273,49,224,218,99,225,44,181
"2011","Tameside 021D","E01005975","Total",680,231,44,187,211,87,173,39,134
"2011","Tameside 022A","E01006024","Total",675,159,9,150,250,78,132,21,111
"2011","Tameside 022B","E01006026","Total",744,250,12,238,205,85,209,39,170
"2011","Tameside 022C","E01006037","Total",605,150,2,148,182,63,146,24,122
"2011","Tameside 022D","E01006038","Total",655,201,24,177,200,68,182,36,146
"2011","Tameside 023A","E01006047","Total",572,174,24,150,178,70,159,33,126
"2011","Tameside 023B","E01006048","Total",729,287,6,281,143,39,193,16,177
"2011","Tameside 023C","E01006049","Total",714,267,29,238,172,65,187,36,151
"2011","Tameside 023D","E01006051","Total",735,237,28,209,197,71,178,30,148
"2011","Tameside 024A","E01005985","Total",709,317,6,311,155,61,218,22,196
"2011","Tameside 024B","E01005987","Total",711,287,6,281,154,51,209,22,187
"2011","Tameside 024C","E01005988","Total",636,187,8,179,211,60,150,28,122
"2011","Tameside 024D","E01005990","Total",620,246,7,239,154,53,197,25,172
"2011","Tameside 024E","E01005991","Total",617,194,16,178,194,72,169,27,142
"2011","Tameside 025A","E01005971","Total",632,208,33,175,182,86,173,28,145
"2011","Tameside 025B","E01005986","Total",531,161,20,141,177,54,155,32,123
"2011","Tameside 025C","E01005989","Total",512,164,6,158,136,32,136,20,116
"2011","Tameside 025D","E01005992","Total",592,189,33,156,184,94,173,35,138
"2011","Tameside 026A","E01005973","Total",597,186,17,169,172,60,153,21,132
"2011","Tameside 026B","E01005976","Total",624,236,41,195,207,64,214,49,165
"2011","Tameside 026C","E01005977","Total",658,214,11,203,180,77,177,34,143
"2011","Tameside 026D","E01005978","Total",605,235,45,190,193,67,206,43,163
"2011","Tameside 027A","E01006025","Total",593,288,73,215,213,97,226,51,175
"2011","Tameside 027B","E01006027","Total",621,303,77,226,202,91,210,39,171
"2011","Tameside 027C","E01006050","Total",797,425,110,315,258,131,338,81,257
"2011","Tameside 027D","E01006052","Total",661,304,50,254,209,86,238,51,187
"2011","Tameside 028A","E01006028","Total",883,441,61,380,218,117,346,38,308
"2011","Tameside 028B","E01006029","Total",718,218,58,160,278,138,195,53,142
"2011","Tameside 028C","E01006030","Total",748,242,46,196,240,103,206,46,160
"2011","Tameside 028D","E01006039","Total",440,160,39,121,183,85,122,36,86
"2011","Tameside 028E","E01006040","Total",564,179,52,127,229,116,149,43,106
"2011","Tameside 028F","E01006041","Total",662,177,33,144,228,118,164,29,135
"2011","Tameside 029A","E01005979","Total",777,365,24,341,155,60,282,38,244
"2011","Tameside 029B","E01005980","Total",641,253,41,212,210,77,213,49,164
"2011","Tameside 029C","E01005981","Total",791,434,38,396,171,75,341,32,309
"2011","Tameside 029D","E01005982","Total",583,270,47,223,175,63,182,40,142
"2011","Tameside 029E","E01005983","Total",707,244,14,230,190,76,176,24,152
"2011","Tameside 029F","E01005984","Total",773,396,61,335,198,99,268,43,225
"2011","Tameside 030A","E01006042","Total",770,249,24,225,204,81,195,35,160
"2011","Tameside 030B","E01006043","Total",606,220,21,199,201,77,175,30,145
"2011","Tameside 030C","E01006044","Total",612,247,9,238,142,54,186,21,165
"2011","Tameside 030D","E01006045","Total",542,187,4,183,130,33,135,14,121
"2011","Tameside 030E","E01006046","Total",618,180,9,171,171,73,171,27,144
"2011","Trafford 001A","E01006109","Total",781,363,63,300,176,102,214,30,184
"2011","Trafford 001B","E01006110","Total",671,201,49,152,256,118,168,50,118
"2011","Trafford 001C","E01006111","Total",568,201,75,126,274,124,162,60,102
"2011","Trafford 001D","E01006112","Total",561,206,45,161,235,114,168,48,120
"2011","Trafford 001E","E01006185","Total",1015,376,56,320,200,105,288,41,247
"2011","Trafford 001F","E01006188","Total",566,141,32,109,226,112,138,44,94
"2011","Trafford 002A","E01006116","Total",536,144,9,135,200,80,118,24,94
"2011","Trafford 002B","E01006117","Total",637,199,14,185,224,84,147,23,124
"2011","Trafford 002C","E01006118","Total",608,241,22,219,203,69,193,27,166
"2011","Trafford 002D","E01006119","Total",636,192,8,184,204,68,172,27,145
"2011","Trafford 002E","E01006121","Total",614,155,18,137,218,74,152,42,110
"2011","Trafford 003A","E01006141","Total",585,166,33,133,233,92,162,41,121
"2011","Trafford 003B","E01006186","Total",792,216,57,159,255,112,208,51,157
"2011","Trafford 003C","E01006187","Total",1156,301,55,246,363,165,267,54,213
"2011","Trafford 003D","E01006189","Total",918,259,60,199,319,165,254,73,181
"2011","Trafford 004A","E01006113","Total",468,124,20,104,199,80,121,40,81
"2011","Trafford 004B","E01006114","Total",574,235,43,192,198,79,197,53,144
"2011","Trafford 004C","E01006115","Total",632,235,32,203,187,75,206,35,171
"2011","Trafford 004D","E01006145","Total",677,257,50,207,241,105,237,53,184
"2011","Trafford 004E","E01006146","Total",658,175,32,143,264,114,159,43,116
"2011","Trafford 005A","E01006122","Total",672,267,7,260,160,56,196,30,166
"2011","Trafford 005B","E01006123","Total",659,214,21,193,227,75,153,30,123
"2011","Trafford 005C","E01006124","Total",596,213,5,208,171,49,150,21,129
"2011","Trafford 005D","E01006128","Total",720,213,8,205,245,100,193,25,168
"2011","Trafford 005E","E01006131","Total",646,198,13,185,203,69,162,30,132
"2011","Trafford 006A","E01006155","Total",676,173,16,157,235,86,140,23,117
"2011","Trafford 006B","E01006157","Total",609,158,28,130,223,91,150,32,118
"2011","Trafford 006C","E01006159","Total",715,245,66,179,292,123,209,55,154
"2011","Trafford 006D","E01006182","Total",598,175,17,158,191,63,149,23,126
"2011","Trafford 006E","E01006183","Total",632,177,11,166,206,76,181,38,143
"2011","Trafford 007A","E01006125","Total",602,218,16,202,174,55,171,32,139
"2011","Trafford 007B","E01006126","Total",711,285,49,236,234,87,271,57,214
"2011","Trafford 007C","E01006127","Total",631,162,24,138,219,80,132,27,105
"2011","Trafford 007D","E01006130","Total",752,235,9,226,227,79,207,31,176
"2011","Trafford 007E","E01006132","Total",673,232,12,220,208,77,224,35,189
"2011","Trafford 008A","E01006156","Total",676,230,35,195,226,77,192,39,153
"2011","Trafford 008B","E01006158","Total",772,261,38,223,221,91,239,38,201
"2011","Trafford 008C","E01006179","Total",854,327,25,302,176,66,287,34,253
"2011","Trafford 008D","E01006184","Total",731,284,31,253,223,79,241,43,198
"2011","Trafford 009A","E01006198","Total",667,201,19,182,195,75,172,23,149
"2011","Trafford 009B","E01006199","Total",742,231,33,198,208,78,220,38,182
"2011","Trafford 009C","E01006200","Total",671,307,16,291,136,44,246,24,222
"2011","Trafford 009D","E01006201","Total",657,185,13,172,201,83,176,29,147
"2011","Trafford 009E","E01006202","Total",626,189,11,178,166,49,161,26,135
"2011","Trafford 010A","E01006120","Total",560,194,7,187,173,52,139,29,110
"2011","Trafford 010B","E01006129","Total",632,279,12,267,156,53,210,25,185
"2011","Trafford 010C","E01006133","Total",664,255,3,252,133,43,203,21,182
"2011","Trafford 010D","E01006197","Total",600,173,9,164,223,83,151,30,121
"2011","Trafford 010E","E01006203","Total",516,128,2,126,181,56,120,24,96
"2011","Trafford 011A","E01006142","Total",751,293,33,260,208,80,254,46,208
"2011","Trafford 011B","E01006143","Total",709,228,13,215,187,63,184,32,152
"2011","Trafford 011C","E01006144","Total",718,331,57,274,193,90,251,33,218
"2011","Trafford 011D","E01006180","Total",794,175,35,140,234,117,174,44,130
"2011","Trafford 011E","E01006181","Total",656,227,27,200,214,92,202,35,167
"2011","Trafford 012A","E01006147","Total",542,159,3,156,197,76,134,29,105
"2011","Trafford 012B","E01006149","Total",659,238,11,227,200,90,189,14,175
"2011","Trafford 012C","E01006150","Total",709,214,8,206,184,77,172,20,152
"2011","Trafford 012D","E01006154","Total",634,119,6,113,208,107,105,14,91
"2011","Trafford 012E","E01006165","Total",874,183,21,162,238,117,197,34,163
"2011","Trafford 013A","E01006166","Total",705,220,27,193,210,70,198,32,166
"2011","Trafford 013B","E01006169","Total",683,230,20,210,211,74,185,35,150
"2011","Trafford 013C","E01006170","Total",687,238,17,221,196,82,201,35,166
"2011","Trafford 013D","E01006171","Total",799,312,57,255,266,100,267,53,214
"2011","Trafford 014A","E01006098","Total",515,162,2,160,160,63,115,30,85
"2011","Trafford 014B","E01006099","Total",558,155,11,144,185,94,130,23,107
"2011","Trafford 014C","E01006164","Total",727,258,4,254,184,68,196,25,171
"2011","Trafford 014D","E01006174","Total",815,246,4,242,191,82,156,16,140
"2011","Trafford 014E","E01006178","Total",781,201,6,195,213,112,183,22,161
"2011","Trafford 015A","E01006097","Total",852,291,11,280,178,75,186,21,165
"2011","Trafford 015B","E01006160","Total",963,348,17,331,160,83,297,21,276
"2011","Trafford 015C","E01006161","Total",900,224,11,213,227,111,184,27,157
"2011","Trafford 015D","E01006162","Total",701,154,3,151,202,78,118,21,97
"2011","Trafford 015E","E01006163","Total",826,138,16,122,238,124,134,28,106
"2011","Trafford 016A","E01006148","Total",690,228,14,214,183,49,143,21,122
"2011","Trafford 016B","E01006151","Total",562,157,1,156,181,53,125,18,107
"2011","Trafford 016C","E01006152","Total",621,210,11,199,195,44,131,36,95
"2011","Trafford 016D","E01006153","Total",637,242,4,238,176,55,178,19,159
"2011","Trafford 016E","E01006172","Total",678,302,10,292,150,47,200,18,182
"2011","Trafford 017A","E01006104","Total",747,270,35,235,196,64,224,40,184
"2011","Trafford 017B","E01006105","Total",777,343,138,205,342,202,268,80,188
"2011","Trafford 017C","E01006106","Total",617,234,64,170,216,85,195,47,148
"2011","Trafford 017D","E01006107","Total",723,303,45,258,203,80,249,35,214
"2011","Trafford 017E","E01006108","Total",680,296,121,175,302,168,210,50,160
"2011","Trafford 018A","E01006102","Total",574,203,12,191,193,74,165,28,137
"2011","Trafford 018B","E01006173","Total",606,182,7,175,190,66,163,23,140
"2011","Trafford 018C","E01006175","Total",749,373,73,300,227,102,289,44,245
"2011","Trafford 018D","E01006176","Total",757,246,19,227,223,84,180,31,149
"2011","Trafford 018E","E01006177","Total",613,188,64,124,271,100,183,58,125
"2011","Trafford 019A","E01006091","Total",980,138,26,112,364,183,144,43,101
"2011","Trafford 019B","E01006092","Total",515,163,49,114,226,105,151,46,105
"2011","Trafford 019C","E01006095","Total",682,150,7,143,209,91,126,23,103
"2011","Trafford 019D","E01006167","Total",772,357,68,289,250,88,296,52,244
"2011","Trafford 019E","E01006168","Total",837,343,104,239,340,152,269,78,191
"2011","Trafford 020A","E01006090","Total",906,200,11,189,236,94,168,27,141
"2011","Trafford 020B","E01006094","Total",593,195,4,191,195,67,133,22,111
"2011","Trafford 020C","E01006096","Total",559,112,5,107,219,98,96,20,76
"2011","Trafford 020D","E01006100","Total",611,192,10,182,199,70,168,34,134
"2011","Trafford 020E","E01006103","Total",602,131,7,124,237,88,119,23,96
"2011","Trafford 021A","E01006101","Total",557,148,4,144,213,78,109,21,88
"2011","Trafford 021B","E01006190","Total",647,176,10,166,212,81,121,17,104
"2011","Trafford 021C","E01006195","Total",658,164,4,160,240,82,142,26,116
"2011","Trafford 021D","E01006196","Total",692,167,8,159,256,86,138,28,110
"2011","Trafford 021E","E01006210","Total",675,216,15,201,223,82,160,26,134
"2011","Trafford 022A","E01006204","Total",692,256,13,243,194,65,209,26,183
"2011","Trafford 022B","E01006206","Total",776,254,45,209,269,98,201,43,158
"2011","Trafford 022C","E01006207","Total",795,354,48,306,218,97,293,38,255
"2011","Trafford 022D","E01006208","Total",653,205,36,169,221,82,157,33,124
"2011","Trafford 022E","E01006211","Total",642,248,26,222,205,67,210,38,172
"2011","Trafford 023A","E01006093","Total",608,146,7,139,236,83,130,23,107
"2011","Trafford 023B","E01006191","Total",645,182,5,177,229,66,137,22,115
"2011","Trafford 023C","E01006192","Total",632,212,6,206,198,61,165,18,147
"2011","Trafford 023D","E01006205","Total",563,204,2,202,172,60,128,14,114
"2011","Trafford 023E","E01006209","Total",630,232,8,224,187,59,160,24,136
"2011","Trafford 024A","E01006078","Total",856,179,17,162,220,117,181,26,155
"2011","Trafford 024B","E01006080","Total",788,174,11,163,225,108,143,22,121
"2011","Trafford 024C","E01006089","Total",632,136,14,122,193,87,120,22,98
"2011","Trafford 024D","E01006193","Total",624,181,11,170,203,81,115,18,97
"2011","Trafford 024E","E01006194","Total",983,180,23,157,371,171,166,45,121
"2011","Trafford 025A","E01006074","Total",619,213,20,193,207,78,191,33,158
"2011","Trafford 025B","E01006075","Total",887,298,14,284,220,94,195,24,171
"2011","Trafford 025C","E01006076","Total",779,319,10,309,148,55,197,11,186
"2011","Trafford 025D","E01006079","Total",879,178,17,161,246,80,130,27,103
"2011","Trafford 025E","E01006087","Total",584,156,10,146,182,53,114,15,99
"2011","Trafford 026A","E01006083","Total",488,121,7,114,217,63,77,15,62
"2011","Trafford 026B","E01006084","Total",641,155,10,145,248,80,108,21,87
"2011","Trafford 026C","E01006088","Total",654,127,9,118,242,122,107,25,82
"2011","Trafford 026D","E01006139","Total",709,172,6,166,242,107,129,20,109
"2011","Trafford 026E","E01006140","Total",639,156,15,141,271,105,114,25,89
"2011","Trafford 027A","E01006077","Total",776,245,13,232,175,76,188,27,161
"2011","Trafford 027B","E01006081","Total",503,146,7,139,177,43,90,19,71
"2011","Trafford 027C","E01006082","Total",675,193,8,185,190,59,118,12,106
"2011","Trafford 027D","E01006085","Total",622,169,5,164,204,80,115,13,102
"2011","Trafford 027E","E01006086","Total",675,222,20,202,215,68,141,29,112
"2011","Trafford 028A","E01006134","Total",528,114,12,102,210,63,81,16,65
"2011","Trafford 028B","E01006135","Total",619,231,14,217,186,58,151,21,130
"2011","Trafford 028C","E01006136","Total",614,220,7,213,182,77,150,24,126
"2011","Trafford 028D","E01006137","Total",492,150,6,144,193,59,96,17,79
"2011","Trafford 028E","E01006138","Total",794,370,18,352,199,68,263,29,234
"2011","Wigan 001A","E01006315","Total",518,181,8,173,149,46,140,20,120
"2011","Wigan 001B","E01006316","Total",618,166,4,162,165,62,121,16,105
"2011","Wigan 001C","E01006317","Total",662,244,18,226,189,54,189,31,158
"2011","Wigan 001D","E01006319","Total",523,100,11,89,258,87,93,35,58
"2011","Wigan 002A","E01006229","Total",669,276,16,260,149,52,156,18,138
"2011","Wigan 002B","E01006230","Total",584,171,5,166,173,41,157,27,130
"2011","Wigan 002C","E01006233","Total",555,156,4,152,198,48,123,30,93
"2011","Wigan 002D","E01006237","Total",603,133,11,122,238,71,134,34,100
"2011","Wigan 002E","E01006238","Total",762,355,38,317,196,70,270,39,231
"2011","Wigan 003A","E01006259","Total",542,162,18,144,169,58,151,34,117
"2011","Wigan 003B","E01006312","Total",618,225,10,215,158,48,151,22,129
"2011","Wigan 003C","E01006313","Total",458,191,27,164,135,47,147,24,123
"2011","Wigan 003D","E01006314","Total",740,277,7,270,175,54,224,32,192
"2011","Wigan 003E","E01006318","Total",627,220,10,210,157,43,173,30,143
"2011","Wigan 003F","E01006320","Total",560,152,6,146,152,44,129,23,106
"2011","Wigan 003G","E01006321","Total",703,183,16,167,219,82,161,31,130
"2011","Wigan 004A","E01006231","Total",620,214,12,202,180,49,160,34,126
"2011","Wigan 004B","E01006232","Total",761,183,11,172,227,75,153,30,123
"2011","Wigan 004C","E01006234","Total",536,217,18,199,126,39,160,19,141
"2011","Wigan 004D","E01006235","Total",698,312,39,273,212,80,258,39,219
"2011","Wigan 005A","E01006253","Total",666,308,40,268,194,75,222,45,177
"2011","Wigan 005B","E01006254","Total",634,256,79,177,290,127,216,68,148
"2011","Wigan 005C","E01006255","Total",655,209,11,198,163,55,189,24,165
"2011","Wigan 005D","E01006256","Total",606,167,17,150,198,79,148,25,123
"2011","Wigan 005E","E01006260","Total",638,257,45,212,222,82,226,51,175
"2011","Wigan 006A","E01006370","Total",834,263,19,244,157,73,174,21,153
"2011","Wigan 006B","E01006372","Total",660,210,6,204,183,49,142,17,125
"2011","Wigan 006C","E01006373","Total",642,180,5,175,168,61,140,15,125
"2011","Wigan 006D","E01006374","Total",693,252,6,246,189,70,173,23,150
"2011","Wigan 006E","E01006390","Total",699,306,23,283,168,62,214,26,188
"2011","Wigan 007A","E01006236","Total",660,219,8,211,148,50,181,24,157
"2011","Wigan 007B","E01006388","Total",744,299,23,276,203,78,246,44,202
"2011","Wigan 007C","E01006389","Total",512,110,25,85,212,72,116,31,85
"2011","Wigan 007D","E01006391","Total",667,252,11,241,160,55,228,26,202
"2011","Wigan 008A","E01006257","Total",532,157,17,140,170,65,134,36,98
"2011","Wigan 008B","E01006258","Total",715,247,22,225,218,90,199,36,163
"2011","Wigan 008C","E01006369","Total",910,391,45,346,188,87,281,34,247
"2011","Wigan 008D","E01006371","Total",661,189,19,170,184,71,174,31,143
"2011","Wigan 008E","E01006375","Total",674,195,12,183,196,78,162,22,140
"2011","Wigan 009A","E01006306","Total",861,448,42,406,149,58,340,44,296
"2011","Wigan 009B","E01006307","Total",635,253,46,207,200,70,216,47,169
"2011","Wigan 009C","E01006386","Total",984,596,34,562,108,57,458,21,437
"2011","Wigan 009D","E01006387","Total",539,194,25,169,172,68,149,23,126
"2011","Wigan 009E","E01006392","Total",622,277,71,206,233,103,202,41,161
"2011","Wigan 010A","E01006350","Total",742,363,104,259,286,122,265,71,194
"2011","Wigan 010B","E01006351","Total",930,437,137,300,371,190,323,82,241
"2011","Wigan 010C","E01006357","Total",654,334,108,226,262,121,249,59,190
"2011","Wigan 010D","E01006360","Total",729,356,116,240,275,122,234,55,179
"2011","Wigan 010E","E01006361","Total",690,337,92,245,241,118,275,53,222
"2011","Wigan 011A","E01006356","Total",608,244,54,190,209,76,207,49,158
"2011","Wigan 011B","E01006396","Total",566,129,9,120,183,60,134,29,105
"2011","Wigan 011C","E01006397","Total",576,281,20,261,115,47,218,18,200
"2011","Wigan 011D","E01006398","Total",507,191,23,168,139,64,182,31,151
"2011","Wigan 011E","E01006399","Total",701,270,31,239,196,82,224,33,191
"2011","Wigan 012A","E01006305","Total",707,322,95,227,263,122,251,54,197
"2011","Wigan 012B","E01006308","Total",684,279,58,221,227,114,234,51,183
"2011","Wigan 012C","E01006309","Total",633,228,67,161,239,96,195,51,144
"2011","Wigan 012D","E01006310","Total",698,338,77,261,231,90,271,62,209
"2011","Wigan 012E","E01006311","Total",650,261,73,188,245,101,203,51,152
"2011","Wigan 013A","E01006269","Total",735,292,26,266,210,93,261,33,228
"2011","Wigan 013B","E01006271","Total",742,236,30,206,218,86,177,26,151
"2011","Wigan 013C","E01006272","Total",701,207,26,181,224,86,190,37,153
"2011","Wigan 013D","E01006273","Total",662,255,56,199,196,75,196,39,157
"2011","Wigan 013E","E01006276","Total",868,196,36,160,359,154,192,49,143
"2011","Wigan 014A","E01006353","Total",656,238,25,213,184,80,173,31,142
"2011","Wigan 014B","E01006354","Total",648,249,50,199,198,101,202,33,169
"2011","Wigan 014C","E01006355","Total",694,238,27,211,192,85,177,28,149
"2011","Wigan 014D","E01006358","Total",805,322,39,283,202,80,286,33,253
"2011","Wigan 014E","E01006359","Total",610,219,47,172,210,96,193,47,146
"2011","Wigan 015A","E01006349","Total",886,236,23,213,190,87,231,30,201
"2011","Wigan 015B","E01006352","Total",754,264,31,233,190,99,230,31,199
"2011","Wigan 015C","E01006404","Total",703,251,44,207,228,102,213,46,167
"2011","Wigan 015D","E01006405","Total",646,278,50,228,166,62,228,37,191
"2011","Wigan 015E","E01006411","Total",834,432,88,344,223,111,290,44,246
"2011","Wigan 016A","E01006270","Total",664,331,39,292,166,71,259,36,223
"2011","Wigan 016B","E01006274","Total",663,280,46,234,207,95,242,51,191
"2011","Wigan 016C","E01006275","Total",654,311,79,232,222,102,281,58,223
"2011","Wigan 016D","E01006277","Total",628,78,11,67,323,94,101,37,64
"2011","Wigan 016E","E01006286","Total",642,265,11,254,129,46,202,26,176
"2011","Wigan 017A","E01006239","Total",1008,528,64,464,233,94,395,49,346
"2011","Wigan 017B","E01006240","Total",629,276,92,184,268,124,226,62,164
"2011","Wigan 017C","E01006241","Total",762,286,97,189,305,140,221,56,165
"2011","Wigan 017D","E01006287","Total",478,127,10,117,148,48,112,17,95
"2011","Wigan 017E","E01006289","Total",863,417,69,348,243,110,327,56,271
"2011","Wigan 018A","E01006362","Total",748,256,9,247,218,77,186,23,163
"2011","Wigan 018B","E01006363","Total",725,369,10,359,145,37,264,18,246
"2011","Wigan 018C","E01006364","Total",814,297,21,276,241,81,266,36,230
"2011","Wigan 018D","E01006365","Total",820,181,22,159,354,135,169,44,125
"2011","Wigan 018E","E01006366","Total",798,317,12,305,171,41,245,23,222
"2011","Wigan 018F","E01006367","Total",699,256,9,247,167,65,192,21,171
"2011","Wigan 018G","E01006368","Total",716,278,26,252,207,69,209,39,170
"2011","Wigan 019A","E01006278","Total",697,272,22,250,184,64,223,34,189
"2011","Wigan 019B","E01006279","Total",613,151,11,140,213,83,154,41,113
"2011","Wigan 019C","E01006280","Total",627,263,24,239,168,60,191,27,164
"2011","Wigan 019D","E01006281","Total",725,167,14,153,229,82,179,38,141
"2011","Wigan 019E","E01006285","Total",714,205,11,194,214,56,181,38,143
"2011","Wigan 020A","E01006406","Total",626,230,10,220,142,54,183,21,162
"2011","Wigan 020B","E01006407","Total",591,122,11,111,196,61,136,30,106
"2011","Wigan 020C","E01006408","Total",644,241,52,189,217,84,203,42,161
"2011","Wigan 020D","E01006409","Total",590,213,3,210,147,41,179,26,153
"2011","Wigan 020E","E01006410","Total",538,134,3,131,165,48,141,34,107
"2011","Wigan 021A","E01006393","Total",605,147,8,139,176,63,129,29,100
"2011","Wigan 021B","E01006394","Total",648,214,5,209,160,42,146,18,128
"2011","Wigan 021C","E01006395","Total",859,88,6,82,429,156,122,42,80
"2011","Wigan 021D","E01006400","Total",504,71,6,65,207,89,99,33,66
"2011","Wigan 021E","E01006401","Total",565,154,6,148,179,66,114,20,94
"2011","Wigan 021F","E01006402","Total",471,129,4,125,136,51,120,14,106
"2011","Wigan 021G","E01006403","Total",682,213,5,208,189,65,181,31,150
"2011","Wigan 022A","E01006290","Total",619,218,8,210,135,51,169,23,146
"2011","Wigan 022B","E01006291","Total",676,241,34,207,186,78,196,32,164
"2011","Wigan 022C","E01006292","Total",648,225,21,204,179,70,196,33,163
"2011","Wigan 022D","E01006293","Total",729,281,26,255,195,75,246,37,209
"2011","Wigan 023A","E01006242","Total",760,274,22,252,179,78,222,26,196
"2011","Wigan 023B","E01006243","Total",876,223,16,207,262,109,193,32,161
"2011","Wigan 023C","E01006244","Total",848,383,29,354,173,75,314,34,280
"2011","Wigan 023D","E01006245","Total",1081,274,30,244,354,159,242,51,191
"2011","Wigan 024A","E01006213","Total",710,321,79,242,255,101,233,57,176
"2011","Wigan 024B","E01006215","Total",735,344,77,267,214,82,256,48,208
"2011","Wigan 024C","E01006217","Total",934,318,58,260,355,174,267,59,208
"2011","Wigan 024D","E01006218","Total",864,278,70,208,314,147,235,65,170
"2011","Wigan 024E","E01006219","Total",523,142,24,118,150,63,136,28,108
"2011","Wigan 025A","E01006288","Total",736,318,97,221,278,112,263,68,195
"2011","Wigan 025B","E01006294","Total",909,217,43,174,314,126,195,39,156
"2011","Wigan 025C","E01006295","Total",803,304,33,271,212,85,259,33,226
"2011","Wigan 025D","E01006377","Total",667,193,13,180,196,60,159,25,134
"2011","Wigan 025E","E01006378","Total",591,219,3,216,128,41,153,16,137
"2011","Wigan 026A","E01006212","Total",570,197,19,178,165,59,158,28,130
"2011","Wigan 026B","E01006214","Total",596,206,50,156,201,104,179,39,140
"2011","Wigan 026C","E01006216","Total",883,187,39,148,327,170,194,45,149
"2011","Wigan 026D","E01006322","Total",677,230,51,179,217,99,202,44,158
"2011","Wigan 026E","E01006329","Total",476,182,39,143,141,47,157,36,121
"2011","Wigan 027A","E01006282","Total",686,244,43,201,226,94,202,46,156
"2011","Wigan 027B","E01006283","Total",682,287,74,213,244,96,232,57,175
"2011","Wigan 027C","E01006284","Total",649,238,42,196,188,93,247,55,192
"2011","Wigan 027D","E01006336","Total",734,386,96,290,237,104,267,60,207
"2011","Wigan 027E","E01006337","Total",658,228,23,205,181,69,185,28,157
"2011","Wigan 028A","E01006376","Total",694,272,54,218,248,104,209,39,170
"2011","Wigan 028B","E01006381","Total",709,106,14,92,303,100,117,31,86
"2011","Wigan 028C","E01006382","Total",517,113,4,109,201,61,121,28,93
"2011","Wigan 028D","E01006383","Total",636,123,19,104,240,76,141,36,105
"2011","Wigan 028E","E01006384","Total",601,130,8,122,180,64,107,22,85
"2011","Wigan 029A","E01006250","Total",676,194,10,184,173,55,147,23,124
"2011","Wigan 029B","E01006251","Total",604,163,4,159,178,71,159,31,128
"2011","Wigan 029C","E01006379","Total",689,218,15,203,187,71,177,24,153
"2011","Wigan 029D","E01006380","Total",746,337,50,287,221,84,287,52,235
"2011","Wigan 029E","E01006385","Total",611,174,5,169,169,58,149,23,126
"2011","Wigan 030A","E01006328","Total",680,241,41,200,179,88,214,33,181
"2011","Wigan 030B","E01006333","Total",843,274,40,234,237,120,237,45,192
"2011","Wigan 030C","E01006334","Total",837,316,70,246,243,136,229,40,189
"2011","Wigan 030D","E01006338","Total",735,249,35,214,208,100,204,33,171
"2011","Wigan 031A","E01006248","Total",796,416,59,357,192,90,313,45,268
"2011","Wigan 031B","E01006249","Total",642,265,65,200,225,94,208,51,157
"2011","Wigan 031C","E01006330","Total",668,224,9,215,181,57,173,33,140
"2011","Wigan 031D","E01006331","Total",640,159,9,150,207,64,134,30,104
"2011","Wigan 031E","E01006332","Total",856,231,16,215,267,107,210,42,168
"2011","Wigan 032A","E01006262","Total",623,225,42,183,226,73,209,47,162
"2011","Wigan 032B","E01006263","Total",641,240,2,238,154,36,176,19,157
"2011","Wigan 032C","E01006266","Total",626,260,9,251,133,44,194,32,162
"2011","Wigan 032D","E01006267","Total",790,405,50,355,207,75,342,39,303
"2011","Wigan 032E","E01006268","Total",717,222,23,199,250,80,221,52,169
"2011","Wigan 033A","E01006323","Total",638,229,57,172,229,93,185,37,148
"2011","Wigan 033B","E01006324","Total",614,252,43,209,158,61,217,31,186
"2011","Wigan 033C","E01006325","Total",628,164,33,131,215,68,193,47,146
"2011","Wigan 033D","E01006326","Total",659,231,41,190,197,90,191,28,163
"2011","Wigan 033E","E01006327","Total",620,295,64,231,215,69,251,58,193
"2011","Wigan 034A","E01006246","Total",732,290,34,256,191,72,255,41,214
"2011","Wigan 034B","E01006247","Total",555,187,8,179,156,51,165,24,141
"2011","Wigan 034C","E01006252","Total",639,222,7,215,164,65,170,23,147
"2011","Wigan 034D","E01006297","Total",772,311,50,261,249,103,245,35,210
"2011","Wigan 034E","E01006335","Total",777,236,37,199,244,102,201,32,169
"2011","Wigan 035A","E01006220","Total",768,313,56,257,242,106,269,48,221
"2011","Wigan 035B","E01006221","Total",695,209,22,187,215,89,181,43,138
"2011","Wigan 035C","E01006222","Total",644,196,6,190,217,75,164,19,145
"2011","Wigan 035D","E01006224","Total",518,52,9,43,275,102,93,39,54
"2011","Wigan 035E","E01006226","Total",750,214,19,195,214,97,192,35,157
"2011","Wigan 036A","E01006223","Total",717,198,20,178,212,101,173,33,140
"2011","Wigan 036B","E01006225","Total",645,243,12,231,163,53,172,30,142
"2011","Wigan 036C","E01006261","Total",655,255,14,241,197,64,204,30,174
"2011","Wigan 036D","E01006264","Total",523,149,5,144,155,40,124,22,102
"2011","Wigan 036E","E01006265","Total",619,207,22,185,173,63,188,31,157
"2011","Wigan 037A","E01006296","Total",710,319,78,241,250,104,232,38,194
"2011","Wigan 037B","E01006298","Total",677,293,53,240,195,92,230,39,191
"2011","Wigan 037C","E01006299","Total",827,222,17,205,258,110,173,37,136
"2011","Wigan 037D","E01006300","Total",610,275,6,269,126,35,164,10,154
"2011","Wigan 037E","E01006301","Total",532,172,7,165,170,44,134,18,116
"2011","Wigan 038A","E01006227","Total",621,161,12,149,196,81,144,36,108
"2011","Wigan 038B","E01006228","Total",730,204,47,157,245,124,159,38,121
"2011","Wigan 038C","E01006342","Total",686,283,29,254,198,65,239,47,192
"2011","Wigan 038D","E01006344","Total",596,262,52,210,207,79,206,51,155
"2011","Wigan 038E","E01006346","Total",974,295,30,265,277,119,246,33,213
"2011","Wigan 039A","E01006339","Total",595,201,9,192,128,44,165,25,140
"2011","Wigan 039B","E01006340","Total",645,254,35,219,204,89,202,38,164
"2011","Wigan 039C","E01006343","Total",649,114,10,104,287,92,120,30,90
"2011","Wigan 039D","E01006345","Total",672,232,14,218,196,71,181,24,157
"2011","Wigan 039E","E01006348","Total",680,213,7,206,173,61,158,24,134
"2011","Wigan 040A","E01006302","Total",658,153,12,141,221,81,146,31,115
"2011","Wigan 040B","E01006303","Total",601,188,3,185,165,53,138,15,123
"2011","Wigan 040C","E01006304","Total",632,241,30,211,187,79,172,42,130
"2011","Wigan 040D","E01006341","Total",755,301,34,267,222,94,256,48,208
"2011","Wigan 040E","E01006347","Total",642,227,5,222,196,72,174,27,147
"2011","Burnley 001A","E01024859","Total",689,146,15,131,207,82,142,25,117
"2011","Burnley 001B","E01024861","Total",530,150,7,143,159,48,117,15,102
"2011","Burnley 001C","E01024862","Total",661,184,16,168,200,82,157,30,127
"2011","Burnley 001D","E01024891","Total",645,285,40,245,193,72,221,51,170
"2011","Burnley 001E","E01024892","Total",628,288,19,269,154,51,217,39,178
"2011","Burnley 001F","E01024894","Total",528,171,23,148,181,76,176,37,139
"2011","Burnley 002A","E01024893","Total",654,274,36,238,193,108,205,37,168
"2011","Burnley 002B","E01024896","Total",583,211,17,194,138,58,188,22,166
"2011","Burnley 002C","E01024897","Total",537,227,15,212,142,63,173,23,150
"2011","Burnley 002D","E01024898","Total",708,276,67,209,218,109,209,46,163
"2011","Burnley 003A","E01024856","Total",604,240,64,176,239,133,176,42,134
"2011","Burnley 003B","E01024875","Total",412,144,59,85,204,115,116,37,79
"2011","Burnley 003C","E01024876","Total",451,189,46,143,185,100,158,47,111
"2011","Burnley 003D","E01024877","Total",538,252,79,173,230,137,197,60,137
"2011","Burnley 003E","E01024878","Total",427,141,61,80,252,149,108,52,56
"2011","Burnley 003F","E01024895","Total",587,263,59,204,198,114,189,33,156
"2011","Burnley 004A","E01024883","Total",655,279,34,245,195,71,249,39,210
"2011","Burnley 004B","E01024884","Total",695,305,32,273,186,70,222,37,185
"2011","Burnley 004C","E01024885","Total",866,285,51,234,211,108,237,32,205
"2011","Burnley 004D","E01024886","Total",633,221,43,178,193,95,193,41,152
"2011","Burnley 004E","E01024889","Total",626,251,17,234,131,57,163,18,145
"2011","Burnley 004F","E01024890","Total",639,261,56,205,226,92,206,47,159
"2011","Burnley 005A","E01024879","Total",571,197,29,168,189,84,173,32,141
"2011","Burnley 005B","E01024880","Total",632,278,27,251,164,47,189,30,159
"2011","Burnley 005C","E01024912","Total",584,194,5,189,142,38,141,23,118
"2011","Burnley 005D","E01024913","Total",504,83,6,77,215,64,113,39,74
"2011","Burnley 005E","E01024914","Total",615,175,3,172,156,48,151,25,126
"2011","Burnley 006A","E01024881","Total",621,202,33,169,199,90,199,38,161
"2011","Burnley 006B","E01024882","Total",720,272,52,220,198,92,198,37,161
"2011","Burnley 006C","E01024902","Total",701,217,29,188,219,83,223,35,188
"2011","Burnley 006D","E01024911","Total",803,337,38,299,214,81,265,35,230
"2011","Burnley 007A","E01024855","Total",779,434,40,394,147,57,342,25,317
"2011","Burnley 007B","E01024857","Total",631,293,37,256,184,75,245,44,201
"2011","Burnley 007C","E01024858","Total",640,311,48,263,177,85,247,32,215
"2011","Burnley 007D","E01024864","Total",740,259,31,228,200,73,212,25,187
"2011","Burnley 008A","E01024863","Total",617,255,52,203,221,77,195,47,148
"2011","Burnley 008B","E01024865","Total",771,397,29,368,161,54,334,32,302
"2011","Burnley 008C","E01024866","Total",858,396,26,370,195,61,321,30,291
"2011","Burnley 008D","E01024867","Total",598,202,4,198,138,46,155,19,136
"2011","Burnley 009A","E01024860","Total",529,150,5,145,138,39,152,26,126
"2011","Burnley 009B","E01024868","Total",520,150,12,138,146,55,125,16,109
"2011","Burnley 009C","E01024869","Total",646,270,5,265,118,34,182,14,168
"2011","Burnley 009D","E01024870","Total",516,182,7,175,110,42,125,15,110
"2011","Burnley 010A","E01024872","Total",660,356,67,289,188,94,258,34,224
"2011","Burnley 010B","E01024899","Total",677,303,75,228,231,119,241,56,185
"2011","Burnley 010C","E01024900","Total",685,340,85,255,247,114,246,56,190
"2011","Burnley 010D","E01024907","Total",579,238,48,190,152,66,206,31,175
"2011","Burnley 010E","E01024908","Total",557,300,50,250,122,59,206,23,183
"2011","Burnley 010F","E01024909","Total",706,291,53,238,170,83,218,41,177
"2011","Burnley 011A","E01024874","Total",436,113,2,111,109,28,93,14,79
"2011","Burnley 011B","E01024887","Total",598,171,33,138,204,80,185,40,145
"2011","Burnley 011C","E01024888","Total",723,232,12,220,183,64,191,33,158
"2011","Burnley 011D","E01024901","Total",767,164,15,149,254,86,147,42,105
"2011","Burnley 014D","E01024871","Total",520,177,13,164,130,45,140,21,119
"2011","Burnley 014E","E01024873","Total",610,245,18,227,169,67,201,34,167
"2011","Burnley 014F","E01024903","Total",482,169,45,124,194,64,141,28,113
"2011","Burnley 014A","E01024904","Total",720,264,41,223,214,88,210,36,174
"2011","Burnley 014G","E01024905","Total",502,155,8,147,153,57,115,24,91
"2011","Burnley 014B","E01024906","Total",800,432,70,362,189,79,329,39,290
"2011","Burnley 014C","E01024910","Total",636,258,50,208,200,100,200,26,174
"2011","Chorley 001A","E01024951","Total",472,158,56,102,188,72,143,52,91
"2011","Chorley 001B","E01024952","Total",604,218,19,199,118,53,194,17,177
"2011","Chorley 001C","E01024953","Total",646,282,53,229,184,70,248,42,206
"2011","Chorley 001D","E01024954","Total",638,193,21,172,154,68,182,35,147
"2011","Chorley 002A","E01024921","Total",857,241,10,231,235,54,153,28,125
"2011","Chorley 002B","E01024978","Total",573,134,11,123,189,73,130,22,108
"2011","Chorley 002C","E01024979","Total",591,142,9,133,180,52,133,32,101
"2011","Chorley 002D","E01024980","Total",581,195,19,176,169,54,165,34,131
"2011","Chorley 003A","E01024946","Total",526,192,11,181,156,59,122,18,104
"2011","Chorley 003B","E01024947","Total",499,73,2,71,198,63,88,32,56
"2011","Chorley 003C","E01024955","Total",656,165,8,157,160,61,135,16,119
"2011","Chorley 003D","E01024956","Total",619,173,5,168,154,46,132,19,113
"2011","Chorley 003E","E01024957","Total",592,201,3,198,172,45,166,12,154
"2011","Chorley 003F","E01024958","Total",565,155,29,126,189,80,150,37,113
"2011","Chorley 004A","E01024948","Total",642,197,11,186,170,65,163,27,136
"2011","Chorley 004B","E01024949","Total",996,176,17,159,310,144,161,29,132
"2011","Chorley 004C","E01024950","Total",536,119,5,114,189,67,74,15,59
"2011","Chorley 004D","E01024977","Total",899,213,7,206,297,84,168,32,136
"2011","Chorley 005A","E01024967","Total",532,164,5,159,141,48,123,17,106
"2011","Chorley 005B","E01024968","Total",738,171,13,158,309,122,136,32,104
"2011","Chorley 005C","E01024969","Total",598,225,11,214,154,50,181,22,159
"2011","Chorley 005D","E01024970","Total",575,144,5,139,165,53,138,21,117
"2011","Chorley 005E","E01024971","Total",528,176,8,168,154,44,131,15,116
"2011","Chorley 005F","E01024972","Total",535,151,3,148,139,46,106,16,90
"2011","Chorley 006A","E01024929","Total",545,187,49,138,208,86,168,46,122
"2011","Chorley 006B","E01024930","Total",633,171,26,145,196,94,160,37,123
"2011","Chorley 006C","E01024931","Total",666,211,28,183,207,105,184,34,150
"2011","Chorley 006D","E01024932","Total",417,131,4,127,112,30,103,22,81
"2011","Chorley 006E","E01024933","Total",629,279,30,249,144,41,208,27,181
"2011","Chorley 006F","E01024937","Total",638,252,10,242,168,47,150,29,121
"2011","Chorley 007A","E01024964","Total",620,202,5,197,168,44,152,27,125
"2011","Chorley 007B","E01024974","Total",642,183,8,175,198,60,146,20,126
"2011","Chorley 007C","E01024975","Total",535,136,11,125,158,58,138,14,124
"2011","Chorley 007D","E01024976","Total",659,204,10,194,199,68,155,19,136
"2011","Chorley 008A","E01024919","Total",1113,281,58,223,371,139,255,54,201
"2011","Chorley 008B","E01024920","Total",920,365,9,356,170,62,265,26,239
"2011","Chorley 008C","E01024934","Total",621,239,3,236,155,49,156,15,141
"2011","Chorley 008D","E01024935","Total",627,283,7,276,128,46,175,15,160
"2011","Chorley 009A","E01024925","Total",761,327,65,262,248,116,273,50,223
"2011","Chorley 009B","E01024926","Total",854,311,48,263,269,123,263,41,222
"2011","Chorley 009C","E01024927","Total",732,226,17,209,218,108,195,27,168
"2011","Chorley 009D","E01024928","Total",656,198,19,179,183,71,175,23,152
"2011","Chorley 010A","E01024936","Total",754,240,19,221,162,75,196,18,178
"2011","Chorley 010B","E01024938","Total",699,217,10,207,190,70,169,29,140
"2011","Chorley 010C","E01024939","Total",701,236,5,231,199,65,180,28,152
"2011","Chorley 010D","E01024940","Total",851,300,34,266,202,103,258,38,220
"2011","Chorley 010E","E01024941","Total",742,315,34,281,198,91,272,44,228
"2011","Chorley 011A","E01024923","Total",523,184,5,179,125,40,121,19,102
"2011","Chorley 011B","E01024924","Total",600,196,2,194,144,51,157,19,138
"2011","Chorley 011C","E01024963","Total",673,245,13,232,173,69,175,20,155
"2011","Chorley 011D","E01024965","Total",570,171,3,168,159,30,127,17,110
"2011","Chorley 011E","E01024966","Total",657,176,8,168,210,71,145,26,119
"2011","Chorley 012A","E01024942","Total",779,353,54,299,221,97,302,42,260
"2011","Chorley 012B","E01024943","Total",946,262,99,163,400,194,199,57,142
"2011","Chorley 012C","E01024944","Total",636,101,20,81,298,109,114,47,67
"2011","Chorley 012D","E01024945","Total",1162,299,76,223,448,222,281,77,204
"2011","Chorley 013A","E01024922","Total",587,173,13,160,192,76,151,30,121
"2011","Chorley 013B","E01024959","Total",753,278,41,237,235,102,257,44,213
"2011","Chorley 013C","E01024960","Total",639,180,23,157,231,91,183,45,138
"2011","Chorley 013D","E01024961","Total",662,186,15,171,178,71,154,17,137
"2011","Chorley 013E","E01024962","Total",623,213,5,208,143,44,158,16,142
"2011","Chorley 014A","E01024915","Total",961,342,33,309,300,108,282,46,236
"2011","Chorley 014B","E01024916","Total",725,249,9,240,173,59,183,24,159
"2011","Chorley 014C","E01024917","Total",773,202,19,183,229,105,209,29,180
"2011","Chorley 014D","E01024918","Total",760,256,11,245,195,70,166,19,147
"2011","Chorley 014E","E01024973","Total",877,286,13,273,243,82,223,38,185
"2011","Fylde 001A","E01024993","Total",626,189,2,187,170,61,148,24,124
"2011","Fylde 001B","E01025026","Total",554,183,5,178,129,37,136,16,120
"2011","Fylde 001C","E01025027","Total",708,172,23,149,268,113,165,35,130
"2011","Fylde 001D","E01025028","Total",545,173,17,156,174,60,157,36,121
"2011","Fylde 001E","E01025031","Total",535,232,7,225,107,27,148,14,134
"2011","Fylde 002A","E01025007","Total",501,116,5,111,156,49,100,18,82
"2011","Fylde 002B","E01025008","Total",498,182,4,178,125,37,138,19,119
"2011","Fylde 002C","E01025009","Total",728,307,21,286,135,52,226,15,211
"2011","Fylde 002D","E01025011","Total",675,237,27,210,179,74,197,26,171
"2011","Fylde 002E","E01025012","Total",795,197,17,180,266,85,183,34,149
"2011","Fylde 002F","E01025013","Total",716,208,45,163,244,98,196,40,156
"2011","Fylde 002G","E01025019","Total",620,253,6,247,134,43,146,12,134
"2011","Fylde 003A","E01024998","Total",721,267,64,203,243,97,189,43,146
"2011","Fylde 003B","E01025010","Total",524,181,11,170,154,46,116,16,100
"2011","Fylde 003C","E01025014","Total",685,188,17,171,202,68,169,26,143
"2011","Fylde 003D","E01025015","Total",634,190,8,182,188,51,130,18,112
"2011","Fylde 004A","E01025004","Total",600,229,17,212,170,67,172,28,144
"2011","Fylde 004B","E01025006","Total",667,292,42,250,146,71,262,35,227
"2011","Fylde 004C","E01025023","Total",604,231,12,219,154,48,140,18,122
"2011","Fylde 004D","E01025024","Total",699,342,16,326,98,32,252,14,238
"2011","Fylde 004E","E01025025","Total",695,225,31,194,213,92,183,33,150
"2011","Fylde 005A","E01025001","Total",793,437,27,410,140,46,277,27,250
"2011","Fylde 005B","E01025002","Total",664,204,29,175,213,95,185,46,139
"2011","Fylde 005C","E01025005","Total",736,383,15,368,106,43,247,17,230
"2011","Fylde 005D","E01025016","Total",1024,386,10,376,265,83,234,31,203
"2011","Fylde 005E","E01025018","Total",565,257,10,247,120,38,178,26,152
"2011","Fylde 006A","E01024984","Total",670,297,9,288,126,43,221,20,201
"2011","Fylde 006B","E01024985","Total",627,265,11,254,146,44,196,28,168
"2011","Fylde 006C","E01024986","Total",916,471,14,457,87,33,333,18,315
"2011","Fylde 006D","E01024987","Total",753,299,29,270,132,63,265,29,236
"2011","Fylde 006E","E01024988","Total",844,457,27,430,119,50,277,22,255
"2011","Fylde 006F","E01024989","Total",656,244,21,223,182,66,179,29,150
"2011","Fylde 006G","E01024996","Total",639,297,14,283,103,34,209,12,197
"2011","Fylde 007A","E01024997","Total",671,236,6,230,141,32,185,23,162
"2011","Fylde 007B","E01024999","Total",691,268,7,261,163,55,219,34,185
"2011","Fylde 007C","E01025000","Total",596,231,6,225,121,36,174,14,160
"2011","Fylde 007D","E01025029","Total",924,402,14,388,181,59,254,22,232
"2011","Fylde 007E","E01025030","Total",683,186,50,136,265,110,142,34,108
"2011","Fylde 008A","E01024981","Total",685,342,5,337,102,34,192,8,184
"2011","Fylde 008B","E01024982","Total",622,297,13,284,107,34,166,17,149
"2011","Fylde 008C","E01024983","Total",625,187,17,170,210,74,130,26,104
"2011","Fylde 008D","E01024994","Total",722,304,12,292,154,52,181,15,166
"2011","Fylde 008E","E01024995","Total",664,294,7,287,135,30,187,19,168
"2011","Fylde 008F","E01025003","Total",792,393,16,377,167,53,234,24,210
"2011","Fylde 008G","E01025017","Total",813,486,9,477,117,35,364,23,341
"2011","Fylde 009A","E01024990","Total",815,332,23,309,155,61,188,13,175
"2011","Fylde 009B","E01024991","Total",517,259,10,249,71,28,150,10,140
"2011","Fylde 009C","E01024992","Total",734,441,16,425,84,37,225,12,213
"2011","Fylde 009D","E01025020","Total",559,179,33,146,186,71,140,27,113
"2011","Fylde 009E","E01025021","Total",681,256,5,251,155,52,165,11,154
"2011","Fylde 009F","E01025022","Total",874,237,17,220,264,112,170,26,144
"2011","Hyndburn 001A","E01025060","Total",602,177,41,136,221,88,162,44,118
"2011","Hyndburn 001B","E01025061","Total",682,339,4,335,131,39,225,24,201
"2011","Hyndburn 001C","E01025062","Total",715,287,58,229,228,108,216,45,171
"2011","Hyndburn 001D","E01025063","Total",694,293,11,282,174,49,247,29,218
"2011","Hyndburn 001E","E01025064","Total",689,259,7,252,158,49,182,27,155
"2011","Hyndburn 001F","E01025065","Total",764,222,36,186,216,88,201,32,169
"2011","Hyndburn 001G","E01025066","Total",642,152,15,137,233,94,124,31,93
"2011","Hyndburn 002A","E01025032","Total",617,231,39,192,191,67,207,43,164
"2011","Hyndburn 002B","E01025033","Total",807,95,11,84,388,165,124,39,85
"2011","Hyndburn 002C","E01025034","Total",719,233,34,199,206,100,179,31,148
"2011","Hyndburn 002D","E01025048","Total",689,241,10,231,184,59,183,27,156
"2011","Hyndburn 002E","E01025049","Total",780,323,48,275,210,102,235,36,199
"2011","Hyndburn 002F","E01025050","Total",638,184,17,167,195,58,162,27,135
"2011","Hyndburn 002G","E01025053","Total",641,173,19,154,217,86,175,35,140
"2011","Hyndburn 003A","E01025070","Total",493,184,41,143,179,60,150,41,109
"2011","Hyndburn 003B","E01025071","Total",616,205,17,188,173,58,203,36,167
"2011","Hyndburn 003C","E01025072","Total",641,249,51,198,198,84,180,32,148
"2011","Hyndburn 003D","E01025073","Total",591,204,23,181,145,49,160,13,147
"2011","Hyndburn 003E","E01025074","Total",571,206,5,201,157,39,158,25,133
"2011","Hyndburn 004A","E01025051","Total",602,253,38,215,163,51,218,38,180
"2011","Hyndburn 004B","E01025052","Total",638,183,16,167,178,51,182,28,154
"2011","Hyndburn 004C","E01025057","Total",692,254,16,238,198,66,212,35,177
"2011","Hyndburn 004D","E01025058","Total",655,305,27,278,160,62,242,29,213
"2011","Hyndburn 004E","E01025059","Total",672,316,47,269,181,72,263,44,219
"2011","Hyndburn 004F","E01025067","Total",709,254,49,205,215,104,207,38,169
"2011","Hyndburn 004G","E01025068","Total",738,345,67,278,215,105,259,44,215
"2011","Hyndburn 004H","E01025069","Total",632,193,41,152,232,105,162,39,123
"2011","Hyndburn 005A","E01025044","Total",500,178,44,134,175,67,138,37,101
"2011","Hyndburn 005B","E01025045","Total",514,255,75,180,196,83,180,46,134
"2011","Hyndburn 005C","E01025046","Total",628,325,42,283,149,65,272,28,244
"2011","Hyndburn 005D","E01025081","Total",662,167,13,154,221,66,161,35,126
"2011","Hyndburn 006A","E01025041","Total",660,325,64,261,231,131,256,53,203
"2011","Hyndburn 006B","E01025042","Total",619,230,78,152,313,176,190,75,115
"2011","Hyndburn 006E","E01025082","Total",664,302,85,217,279,122,242,64,178
"2011","Hyndburn 006F","E01025083","Total",811,362,100,262,311,158,261,66,195
"2011","Hyndburn 006G","E01025084","Total",551,205,60,145,240,116,193,67,126
"2011","Hyndburn 006H","E01033231","Total",880,310,96,214,426,228,285,112,173
"2011","Hyndburn 007A","E01025055","Total",708,254,35,219,210,105,207,33,174
"2011","Hyndburn 007B","E01025075","Total",779,237,23,214,240,110,208,35,173
"2011","Hyndburn 007C","E01025076","Total",637,256,19,237,188,68,212,27,185
"2011","Hyndburn 007D","E01025077","Total",632,288,23,265,145,52,218,26,192
"2011","Hyndburn 007E","E01025078","Total",631,168,11,157,190,63,145,32,113
"2011","Hyndburn 008A","E01025035","Total",647,247,19,228,169,40,236,32,204
"2011","Hyndburn 008B","E01025036","Total",783,346,50,296,173,82,287,37,250
"2011","Hyndburn 008C","E01025037","Total",624,242,51,191,201,92,204,49,155
"2011","Hyndburn 008D","E01025038","Total",600,233,10,223,157,49,174,17,157
"2011","Hyndburn 008E","E01025039","Total",492,124,9,115,158,41,112,22,90
"2011","Hyndburn 008F","E01025040","Total",624,176,13,163,182,55,125,28,97
"2011","Hyndburn 009A","E01025054","Total",769,286,18,268,198,61,243,29,214
"2011","Hyndburn 009B","E01025056","Total",606,238,6,232,128,39,166,26,140
"2011","Hyndburn 009C","E01025079","Total",723,271,12,259,182,48,218,30,188
"2011","Hyndburn 009D","E01025080","Total",668,185,10,175,179,66,183,30,153
"2011","Lancaster 001A","E01025088","Total",455,121,6,115,140,52,111,19,92
"2011","Lancaster 001B","E01025096","Total",675,158,12,146,208,85,175,37,138
"2011","Lancaster 001C","E01025097","Total",646,260,39,221,201,79,211,36,175
"2011","Lancaster 001D","E01025098","Total",596,201,10,191,131,51,144,17,127
"2011","Lancaster 001E","E01025148","Total",941,416,2,414,174,49,228,12,216
"2011","Lancaster 001F","E01025168","Total",523,172,10,162,128,47,129,21,108
"2011","Lancaster 001G","E01025169","Total",543,206,7,199,139,42,135,23,112
"2011","Lancaster 002A","E01025130","Total",956,333,10,323,215,63,229,25,204
"2011","Lancaster 002B","E01025132","Total",590,156,6,150,140,46,149,17,132
"2011","Lancaster 002C","E01025166","Total",541,228,11,217,109,33,138,22,116
"2011","Lancaster 002D","E01025167","Total",478,138,10,128,128,24,97,15,82
"2011","Lancaster 003A","E01025089","Total",627,231,11,220,140,44,172,22,150
"2011","Lancaster 003B","E01025090","Total",751,283,10,273,186,56,203,32,171
"2011","Lancaster 003C","E01025158","Total",620,286,6,280,128,40,176,17,159
"2011","Lancaster 003D","E01025159","Total",612,228,8,220,131,48,152,21,131
"2011","Lancaster 003E","E01025160","Total",554,232,2,230,124,22,147,21,126
"2011","Lancaster 004A","E01025085","Total",604,256,20,236,149,50,159,23,136
"2011","Lancaster 004B","E01025086","Total",656,336,3,333,112,31,200,7,193
"2011","Lancaster 004C","E01025087","Total",683,379,9,370,91,32,266,14,252
"2011","Lancaster 004D","E01025161","Total",627,391,7,384,66,16,234,9,225
"2011","Lancaster 005A","E01025108","Total",533,194,13,181,132,46,150,20,130
"2011","Lancaster 005B","E01025109","Total",447,161,2,159,123,43,120,19,101
"2011","Lancaster 005C","E01025131","Total",654,214,10,204,170,49,166,34,132
"2011","Lancaster 005D","E01025133","Total",676,280,3,277,143,51,188,18,170
"2011","Lancaster 006A","E01025112","Total",779,343,42,301,195,80,278,29,249
"2011","Lancaster 006B","E01025136","Total",715,305,79,226,252,105,260,47,213
"2011","Lancaster 006C","E01025138","Total",585,180,37,143,242,101,163,48,115
"2011","Lancaster 006D","E01025139","Total",853,351,47,304,192,84,298,48,250
"2011","Lancaster 006E","E01025140","Total",644,291,28,263,131,57,240,27,213
"2011","Lancaster 008A","E01025111","Total",728,237,37,200,254,92,211,49,162
"2011","Lancaster 008B","E01025113","Total",639,191,14,177,192,70,176,37,139
"2011","Lancaster 008C","E01025118","Total",478,171,25,146,152,58,149,26,123
"2011","Lancaster 008D","E01025119","Total",577,207,23,184,166,68,149,29,120
"2011","Lancaster 009A","E01025110","Total",697,310,45,265,181,81,235,31,204
"2011","Lancaster 009B","E01025116","Total",660,269,13,256,132,55,218,21,197
"2011","Lancaster 009C","E01025117","Total",646,258,62,196,198,98,198,39,159
"2011","Lancaster 009D","E01025120","Total",633,238,41,197,193,83,177,30,147
"2011","Lancaster 010A","E01025170","Total",834,378,28,350,184,79,248,33,215
"2011","Lancaster 010B","E01025171","Total",794,419,68,351,223,98,303,54,249
"2011","Lancaster 010C","E01025172","Total",656,203,26,177,213,74,164,35,129
"2011","Lancaster 010D","E01025173","Total",775,364,51,313,197,82,270,42,228
"2011","Lancaster 011A","E01025149","Total",970,256,30,226,287,153,237,43,194
"2011","Lancaster 011B","E01025150","Total",609,188,34,154,194,90,154,29,125
"2011","Lancaster 011C","E01025151","Total",777,324,49,275,175,91,264,29,235
"2011","Lancaster 011D","E01025152","Total",616,185,45,140,217,84,164,44,120
"2011","Lancaster 011E","E01025154","Total",633,335,51,284,182,89,268,36,232
"2011","Lancaster 013A","E01025091","Total",645,259,23,236,180,72,223,31,192
"2011","Lancaster 013B","E01025092","Total",513,200,39,161,175,58,167,40,127
"2011","Lancaster 013C","E01025095","Total",500,90,10,80,143,50,100,21,79
"2011","Lancaster 013D","E01025126","Total",763,160,5,155,242,95,137,35,102
"2011","Lancaster 014A","E01025093","Total",713,251,30,221,109,46,137,17,120
"2011","Lancaster 014B","E01025094","Total",616,215,15,200,124,49,184,15,169
"2011","Lancaster 014C","E01025099","Total",781,216,23,193,127,61,161,19,142
"2011","Lancaster 014E","E01033071","Total",572,157,5,152,55,34,103,9,94
"2011","Lancaster 014F","E01033073","Total",695,248,6,242,109,46,181,9,172
"2011","Lancaster 015A","E01025125","Total",379,110,7,103,68,31,78,17,61
"2011","Lancaster 015B","E01025128","Total",646,159,13,146,94,47,122,7,115
"2011","Lancaster 015C","E01025129","Total",473,115,10,105,95,44,79,12,67
"2011","Lancaster 015D","E01025147","Total",607,174,7,167,161,68,130,18,112
"2011","Lancaster 016A","E01025114","Total",681,293,14,279,156,63,227,30,197
"2011","Lancaster 016B","E01025115","Total",660,283,50,233,229,91,217,51,166
"2011","Lancaster 016C","E01025121","Total",739,218,23,195,225,89,177,33,144
"2011","Lancaster 016D","E01025122","Total",781,340,14,326,193,68,236,38,198
"2011","Lancaster 016E","E01025123","Total",905,204,23,181,343,135,176,47,129
"2011","Lancaster 016F","E01025124","Total",676,280,53,227,220,94,209,40,169
"2011","Lancaster 016I","E01033072","Total",1070,428,22,406,249,95,341,47,294
"2011","Lancaster 017A","E01025100","Total",668,167,20,147,190,91,137,27,110
"2011","Lancaster 017B","E01025101","Total",631,240,42,198,183,91,203,41,162
"2011","Lancaster 017C","E01025102","Total",533,153,6,147,148,69,128,28,100
"2011","Lancaster 017D","E01025103","Total",520,149,4,145,171,47,108,21,87
"2011","Lancaster 017E","E01025144","Total",797,262,16,246,172,71,213,22,191
"2011","Lancaster 017F","E01025146","Total",784,244,8,236,246,93,162,27,135
"2011","Lancaster 018A","E01025127","Total",600,217,5,212,150,53,145,16,129
"2011","Lancaster 018B","E01025141","Total",606,215,9,206,162,68,185,22,163
"2011","Lancaster 018C","E01025143","Total",639,298,36,262,167,62,233,42,191
"2011","Lancaster 018D","E01025145","Total",614,165,22,143,197,87,127,30,97
"2011","Lancaster 019A","E01025105","Total",517,116,7,109,154,60,107,23,84
"2011","Lancaster 019B","E01025106","Total",754,207,16,191,226,85,178,37,141
"2011","Lancaster 019C","E01025107","Total",679,180,10,170,166,61,141,16,125
"2011","Lancaster 019D","E01025142","Total",621,213,9,204,134,37,140,22,118
"2011","Lancaster 020A","E01025137","Total",604,201,11,190,201,59,169,27,142
"2011","Lancaster 020F","E01025153","Total",499,124,11,113,164,52,128,36,92
"2011","Lancaster 020G","E01025155","Total",510,149,8,141,149,51,122,22,100
"2011","Lancaster 020H","E01025156","Total",444,211,89,122,217,78,153,53,100
"2011","Lancaster 020I","E01025157","Total",572,283,26,257,145,46,228,21,207
"2011","Lancaster 020B","E01025162","Total",682,361,6,355,116,35,220,20,200
"2011","Lancaster 020C","E01025163","Total",628,275,7,268,139,46,166,16,150
"2011","Lancaster 020D","E01025164","Total",632,261,15,246,146,48,192,24,168
"2011","Lancaster 020E","E01025165","Total",587,115,7,108,237,83,119,32,87
"2011","Pendle 001A","E01025191","Total",530,159,11,148,156,55,133,14,119
"2011","Pendle 001B","E01025192","Total",604,168,30,138,208,92,141,42,99
"2011","Pendle 001C","E01025193","Total",609,256,19,237,162,48,201,24,177
"2011","Pendle 001D","E01025194","Total",623,208,22,186,186,85,167,27,140
"2011","Pendle 002A","E01025195","Total",518,139,5,134,141,52,116,20,96
"2011","Pendle 002B","E01025196","Total",810,241,16,225,169,70,219,28,191
"2011","Pendle 002C","E01025197","Total",569,207,7,200,138,46,173,20,153
"2011","Pendle 002D","E01025198","Total",602,223,18,205,165,69,184,29,155
"2011","Pendle 003A","E01025199","Total",733,219,13,206,190,81,174,26,148
"2011","Pendle 003B","E01025200","Total",661,224,19,205,180,78,184,25,159
"2011","Pendle 003C","E01025201","Total",689,250,21,229,195,81,217,39,178
"2011","Pendle 003D","E01025202","Total",595,176,10,166,156,55,157,29,128
"2011","Pendle 004A","E01025205","Total",606,192,50,142,219,94,158,30,128
"2011","Pendle 004B","E01025206","Total",511,204,13,191,123,34,153,20,133
"2011","Pendle 004C","E01025207","Total",681,289,27,262,130,53,225,24,201
"2011","Pendle 004D","E01025208","Total",664,347,20,327,116,47,266,14,252
"2011","Pendle 005A","E01025220","Total",655,296,96,200,273,119,212,60,152
"2011","Pendle 005B","E01025221","Total",521,166,40,126,211,73,152,50,102
"2011","Pendle 005C","E01025222","Total",616,189,15,174,174,67,159,25,134
"2011","Pendle 005D","E01025223","Total",621,234,30,204,163,81,185,29,156
"2011","Pendle 006A","E01025178","Total",793,231,8,223,208,70,187,27,160
"2011","Pendle 006B","E01025179","Total",701,202,19,183,193,74,165,24,141
"2011","Pendle 006C","E01025180","Total",774,209,7,202,240,89,179,34,145
"2011","Pendle 006D","E01025203","Total",748,229,4,225,168,55,175,29,146
"2011","Pendle 007A","E01025226","Total",784,325,58,267,195,91,243,34,209
"2011","Pendle 007B","E01025227","Total",977,416,75,341,251,122,364,60,304
"2011","Pendle 007C","E01025228","Total",648,160,19,141,214,78,144,22,122
"2011","Pendle 008A","E01025174","Total",613,214,5,209,150,58,161,22,139
"2011","Pendle 008B","E01025175","Total",661,203,6,197,188,64,155,26,129
"2011","Pendle 008C","E01025176","Total",1015,308,16,292,239,121,276,35,241
"2011","Pendle 008D","E01025177","Total",784,282,10,272,183,74,186,26,160
"2011","Pendle 008E","E01025204","Total",723,212,4,208,174,52,156,22,134
"2011","Pendle 008F","E01025211","Total",663,251,5,246,157,60,182,17,165
"2011","Pendle 009A","E01025181","Total",618,306,66,240,239,105,240,48,192
"2011","Pendle 009B","E01025182","Total",611,277,29,248,197,115,226,35,191
"2011","Pendle 009C","E01025183","Total",700,290,48,242,209,107,261,49,212
"2011","Pendle 009D","E01025184","Total",522,180,52,128,251,132,180,69,111
"2011","Pendle 010A","E01025188","Total",886,440,60,380,255,150,357,47,310
"2011","Pendle 010B","E01025189","Total",687,240,62,178,239,127,187,46,141
"2011","Pendle 010C","E01025210","Total",803,292,58,234,259,127,215,45,170
"2011","Pendle 010D","E01025217","Total",635,275,58,217,200,108,216,32,184
"2011","Pendle 010E","E01025218","Total",510,275,44,231,165,97,235,47,188
"2011","Pendle 010F","E01025219","Total",537,227,45,182,157,88,158,28,130
"2011","Pendle 011A","E01025224","Total",768,305,64,241,311,163,268,71,197
"2011","Pendle 011B","E01025225","Total",653,232,24,208,218,99,218,53,165
"2011","Pendle 011C","E01025229","Total",659,233,62,171,298,172,228,82,146
"2011","Pendle 011D","E01025230","Total",547,229,37,192,205,118,193,49,144
"2011","Pendle 012A","E01025187","Total",575,260,27,233,147,55,188,37,151
"2011","Pendle 012B","E01025190","Total",647,212,24,188,195,83,175,37,138
"2011","Pendle 012C","E01025209","Total",693,278,40,238,226,89,226,46,180
"2011","Pendle 012D","E01025216","Total",714,203,42,161,280,117,215,64,151
"2011","Pendle 013A","E01025185","Total",721,314,53,261,235,132,233,46,187
"2011","Pendle 013B","E01025186","Total",596,228,39,189,198,101,165,36,129
"2011","Pendle 013C","E01025212","Total",527,210,7,203,137,43,153,34,119
"2011","Pendle 013D","E01025213","Total",405,139,14,125,141,65,110,19,91
"2011","Pendle 013E","E01025214","Total",533,146,6,140,159,51,130,27,103
"2011","Pendle 013F","E01025215","Total",499,215,42,173,182,85,169,41,128
"2011","Preston 001A","E01025278","Total",1003,269,9,260,327,135,222,45,177
"2011","Preston 001B","E01025279","Total",722,177,3,174,214,60,164,28,136
"2011","Preston 001C","E01025282","Total",568,186,5,181,149,49,143,28,115
"2011","Preston 002A","E01025257","Total",505,151,3,148,171,40,102,19,83
"2011","Preston 002B","E01025277","Total",737,292,4,288,174,49,194,22,172
"2011","Preston 002C","E01025280","Total",703,163,8,155,211,57,142,27,115
"2011","Preston 002D","E01025281","Total",583,171,8,163,178,47,115,27,88
"2011","Preston 003A","E01025256","Total",636,263,6,257,178,62,184,24,160
"2011","Preston 003B","E01025258","Total",635,255,7,248,155,43,178,26,152
"2011","Preston 003C","E01025259","Total",874,308,9,299,256,73,196,21,175
"2011","Preston 003D","E01025299","Total",624,216,7,209,169,61,148,22,126
"2011","Preston 003E","E01025301","Total",469,76,4,72,158,60,69,18,51
"2011","Preston 003F","E01025302","Total",504,148,2,146,135,43,124,22,102
"2011","Preston 004A","E01025253","Total",692,52,4,48,272,117,71,26,45
"2011","Preston 004B","E01025254","Total",470,134,5,129,158,44,108,17,91
"2011","Preston 004C","E01025255","Total",588,70,7,63,257,104,103,33,70
"2011","Preston 004D","E01025300","Total",557,276,3,273,68,17,195,11,184
"2011","Preston 004E","E01025303","Total",608,152,2,150,151,59,133,20,113
"2011","Preston 005A","E01025260","Total",765,362,48,314,192,98,264,38,226
"2011","Preston 005B","E01025262","Total",719,300,20,280,163,66,259,31,228
"2011","Preston 005C","E01025263","Total",640,251,67,184,211,109,178,46,132
"2011","Preston 005D","E01025264","Total",652,233,55,178,197,94,203,40,163
"2011","Preston 006A","E01025239","Total",663,296,12,284,132,52,244,34,210
"2011","Preston 006B","E01025241","Total",666,232,11,221,178,66,192,33,159
"2011","Preston 006C","E01025242","Total",625,240,5,235,171,74,155,26,129
"2011","Preston 006D","E01025243","Total",786,239,16,223,222,72,209,33,176
"2011","Preston 006E","E01025251","Total",559,202,9,193,201,80,167,27,140
"2011","Preston 007A","E01025234","Total",563,186,32,154,200,73,161,33,128
"2011","Preston 007B","E01025235","Total",675,256,22,234,185,84,176,28,148
"2011","Preston 007C","E01025237","Total",653,252,36,216,198,86,211,44,167
"2011","Preston 007D","E01025238","Total",649,255,65,190,262,132,203,45,158
"2011","Preston 007E","E01025245","Total",928,345,97,248,415,199,314,93,221
"2011","Preston 007F","E01025252","Total",631,260,20,240,152,61,208,22,186
"2011","Preston 008A","E01025233","Total",523,134,8,126,186,72,110,23,87
"2011","Preston 008B","E01025240","Total",652,227,8,219,171,54,173,26,147
"2011","Preston 008C","E01025261","Total",651,248,11,237,129,50,191,23,168
"2011","Preston 008D","E01025266","Total",520,190,10,180,145,37,125,17,108
"2011","Preston 008E","E01025309","Total",514,183,19,164,138,62,160,22,138
"2011","Preston 009A","E01025236","Total",573,242,81,161,249,125,182,56,126
"2011","Preston 009B","E01025283","Total",627,287,125,162,306,159,195,56,139
"2011","Preston 009C","E01025284","Total",665,226,43,183,226,91,210,48,162
"2011","Preston 009D","E01025285","Total",513,192,44,148,184,80,164,44,120
"2011","Preston 009E","E01025286","Total",685,310,107,203,277,138,237,62,175
"2011","Preston 009F","E01025287","Total",991,468,76,392,260,128,344,54,290
"2011","Preston 010A","E01025270","Total",666,174,10,164,197,65,171,40,131
"2011","Preston 010B","E01025272","Total",616,111,11,100,219,79,105,28,77
"2011","Preston 010C","E01025273","Total",501,65,3,62,236,62,77,28,49
"2011","Preston 010D","E01025288","Total",899,218,35,183,148,76,150,27,123
"2011","Preston 011A","E01025246","Total",531,153,30,123,254,132,144,43,101
"2011","Preston 011B","E01025274","Total",818,257,43,214,175,84,203,31,172
"2011","Preston 011C","E01025275","Total",772,318,44,274,173,83,251,33,218
"2011","Preston 011D","E01025294","Total",667,186,42,144,243,135,155,53,102
"2011","Preston 012A","E01025276","Total",652,198,31,167,201,99,167,42,125
"2011","Preston 012B","E01025308","Total",741,166,36,130,219,101,127,28,99
"2011","Preston 012C","E01025310","Total",709,204,27,177,173,95,178,31,147
"2011","Preston 012D","E01025311","Total",666,186,32,154,174,96,157,21,136
"2011","Preston 012E","E01025312","Total",762,172,31,141,216,115,136,28,108
"2011","Preston 012F","E01025313","Total",652,288,23,265,104,61,216,17,199
"2011","Preston 012G","E01025314","Total",823,252,33,219,133,80,125,15,110
"2011","Preston 013A","E01025231","Total",591,197,7,190,159,59,147,28,119
"2011","Preston 013B","E01025232","Total",760,186,34,152,180,90,154,27,127
"2011","Preston 013C","E01025265","Total",648,176,23,153,197,75,150,21,129
"2011","Preston 013D","E01025267","Total",627,244,29,215,190,72,224,43,181
"2011","Preston 013E","E01025268","Total",811,342,43,299,216,100,308,49,259
"2011","Preston 013F","E01025269","Total",649,226,54,172,248,112,207,50,157
"2011","Preston 013G","E01025271","Total",620,237,36,201,203,74,199,41,158
"2011","Preston 014A","E01025295","Total",1090,517,56,461,211,124,361,37,324
"2011","Preston 014B","E01025296","Total",762,281,100,181,325,175,205,62,143
"2011","Preston 014C","E01025297","Total",829,312,92,220,329,189,224,58,166
"2011","Preston 014D","E01025298","Total",614,222,67,155,259,135,164,56,108
"2011","Preston 015A","E01025244","Total",511,148,45,103,255,127,139,54,85
"2011","Preston 015B","E01025292","Total",753,389,44,345,106,63,213,27,186
"2011","Preston 015C","E01025293","Total",924,493,76,417,221,98,341,41,300
"2011","Preston 016A","E01025247","Total",667,206,57,149,254,143,161,50,111
"2011","Preston 016B","E01025248","Total",509,200,70,130,231,115,155,48,107
"2011","Preston 016C","E01025249","Total",436,174,13,161,112,41,156,21,135
"2011","Preston 016D","E01025250","Total",642,210,68,142,262,130,177,50,127
"2011","Preston 016E","E01025304","Total",611,192,27,165,245,109,172,56,116
"2011","Preston 016F","E01025305","Total",664,257,57,200,204,97,207,47,160
"2011","Preston 017A","E01025289","Total",739,226,40,186,172,79,160,34,126
"2011","Preston 017B","E01025290","Total",785,259,33,226,139,62,189,31,158
"2011","Preston 017C","E01025291","Total",657,218,27,191,148,74,183,22,161
"2011","Preston 017D","E01025306","Total",854,214,18,196,132,62,156,21,135
"2011","Preston 017F","E01033223","Total",606,329,6,323,20,15,179,2,177
"2011","Preston 017G","E01033224","Total",600,281,24,257,88,47,190,27,163
"2011","Preston 017H","E01033226","Total",567,275,25,250,102,54,195,18,177
"2011","Ribble Valley 001A","E01025315","Total",544,130,3,127,163,44,122,19,103
"2011","Ribble Valley 001B","E01025320","Total",536,139,8,131,153,44,119,18,101
"2011","Ribble Valley 001C","E01025331","Total",563,143,6,137,169,44,126,18,108
"2011","Ribble Valley 001D","E01025348","Total",728,321,6,315,111,33,215,16,199
"2011","Ribble Valley 001E","E01025349","Total",573,151,8,143,159,39,123,13,110
"2011","Ribble Valley 002A","E01025334","Total",681,244,12,232,181,64,167,19,148
"2011","Ribble Valley 002B","E01025344","Total",624,237,8,229,171,65,183,21,162
"2011","Ribble Valley 002C","E01025345","Total",626,241,8,233,176,47,151,15,136
"2011","Ribble Valley 002D","E01025346","Total",652,173,19,154,219,89,133,27,106
"2011","Ribble Valley 002E","E01025347","Total",683,198,13,185,225,93,175,41,134
"2011","Ribble Valley 003A","E01025329","Total",614,245,11,234,165,55,191,30,161
"2011","Ribble Valley 003B","E01025330","Total",603,228,10,218,154,64,148,22,126
"2011","Ribble Valley 003C","E01025335","Total",706,350,24,326,151,65,257,26,231
"2011","Ribble Valley 003D","E01025338","Total",723,198,6,192,196,80,173,24,149
"2011","Ribble Valley 003E","E01025339","Total",649,228,9,219,172,60,193,26,167
"2011","Ribble Valley 004A","E01025322","Total",544,126,5,121,154,28,123,24,99
"2011","Ribble Valley 004B","E01025326","Total",629,212,17,195,156,58,142,13,129
"2011","Ribble Valley 004C","E01025327","Total",541,160,6,154,162,57,123,18,105
"2011","Ribble Valley 004D","E01025342","Total",667,191,9,182,181,75,129,19,110
"2011","Ribble Valley 005A","E01025321","Total",565,179,4,175,142,47,142,15,127
"2011","Ribble Valley 005B","E01025340","Total",609,174,17,157,179,49,129,22,107
"2011","Ribble Valley 005C","E01025341","Total",482,158,3,155,141,38,103,19,84
"2011","Ribble Valley 005D","E01025343","Total",614,189,11,178,188,61,170,23,147
"2011","Ribble Valley 005E","E01025354","Total",572,184,5,179,157,64,118,16,102
"2011","Ribble Valley 006A","E01025316","Total",567,134,9,125,181,60,114,17,97
"2011","Ribble Valley 006B","E01025317","Total",484,139,28,111,162,77,106,29,77
"2011","Ribble Valley 006C","E01025325","Total",737,263,22,241,173,67,214,27,187
"2011","Ribble Valley 006D","E01025328","Total",503,186,14,172,137,64,102,19,83
"2011","Ribble Valley 007A","E01025318","Total",454,146,13,133,132,55,112,12,100
"2011","Ribble Valley 007B","E01025319","Total",801,184,12,172,313,87,152,40,112
"2011","Ribble Valley 007C","E01025333","Total",536,169,4,165,134,43,112,18,94
"2011","Ribble Valley 007D","E01025350","Total",562,218,4,214,142,39,157,14,143
"2011","Ribble Valley 007E","E01025351","Total",979,269,14,255,362,115,211,34,177
"2011","Ribble Valley 008A","E01025323","Total",478,166,3,163,126,42,114,17,97
"2011","Ribble Valley 008B","E01025324","Total",593,185,8,177,188,61,123,22,101
"2011","Ribble Valley 008C","E01025332","Total",430,173,5,168,116,28,117,15,102
"2011","Ribble Valley 008D","E01025336","Total",489,154,5,149,129,27,99,14,85
"2011","Ribble Valley 008E","E01025337","Total",695,237,3,234,167,56,171,17,154
"2011","Ribble Valley 008F","E01025352","Total",554,197,6,191,184,42,117,14,103
"2011","Ribble Valley 008G","E01025353","Total",455,145,4,141,133,33,97,15,82
"2011","Rossendale 001A","E01025355","Total",837,160,7,153,309,103,183,40,143
"2011","Rossendale 001B","E01025361","Total",892,204,16,188,266,101,212,34,178
"2011","Rossendale 001C","E01025362","Total",822,220,7,213,259,103,212,41,171
"2011","Rossendale 001D","E01025393","Total",611,159,9,150,162,49,157,26,131
"2011","Rossendale 002A","E01025363","Total",551,215,7,208,162,55,186,30,156
"2011","Rossendale 002B","E01025364","Total",537,158,6,152,148,46,137,17,120
"2011","Rossendale 002C","E01025366","Total",594,183,43,140,239,113,154,49,105
"2011","Rossendale 002D","E01025395","Total",712,223,11,212,187,68,177,28,149
"2011","Rossendale 002E","E01025396","Total",660,312,45,267,164,80,233,33,200
"2011","Rossendale 002F","E01025397","Total",652,193,46,147,241,127,177,40,137
"2011","Rossendale 002G","E01025398","Total",557,170,46,124,227,99,162,40,122
"2011","Rossendale 003A","E01025367","Total",682,143,20,123,246,89,159,31,128
"2011","Rossendale 003B","E01025368","Total",701,257,39,218,202,87,212,47,165
"2011","Rossendale 003C","E01025369","Total",554,234,40,194,155,64,188,31,157
"2011","Rossendale 003D","E01025381","Total",618,248,56,192,208,87,200,45,155
"2011","Rossendale 003E","E01025382","Total",798,391,66,325,234,113,277,46,231
"2011","Rossendale 003F","E01025383","Total",928,235,29,206,330,135,233,55,178
"2011","Rossendale 004A","E01025356","Total",625,216,37,179,193,98,196,37,159
"2011","Rossendale 004C","E01025373","Total",678,230,10,220,182,66,178,27,151
"2011","Rossendale 004D","E01025385","Total",588,280,48,232,172,73,213,39,174
"2011","Rossendale 004F","E01025387","Total",501,151,21,130,170,63,138,27,111
"2011","Rossendale 004G","E01033281","Total",1111,365,47,318,319,133,321,71,250
"2011","Rossendale 007A","E01025377","Total",554,111,7,104,187,71,126,26,100
"2011","Rossendale 007B","E01025378","Total",647,151,4,147,196,71,128,20,108
"2011","Rossendale 007C","E01025379","Total",621,287,28,259,148,57,232,27,205
"2011","Rossendale 007D","E01025380","Total",583,183,5,178,175,45,119,20,99
"2011","Rossendale 008A","E01025357","Total",608,177,13,164,181,54,161,30,131
"2011","Rossendale 008B","E01025358","Total",943,218,10,208,263,97,174,26,148
"2011","Rossendale 008C","E01025365","Total",656,191,9,182,180,64,177,28,149
"2011","Rossendale 008D","E01025384","Total",533,205,8,197,131,49,182,23,159
"2011","Rossendale 009A","E01025359","Total",708,241,22,219,184,64,210,35,175
"2011","Rossendale 009B","E01025360","Total",919,342,29,313,226,93,274,27,247
"2011","Rossendale 009C","E01025375","Total",682,161,9,152,210,58,128,22,106
"2011","Rossendale 009D","E01025376","Total",983,399,85,314,344,163,310,59,251
"2011","Rossendale 010F","E01025370","Total",513,153,15,138,126,49,133,19,114
"2011","Rossendale 010A","E01025371","Total",648,247,31,216,183,79,239,41,198
"2011","Rossendale 010B","E01025374","Total",629,229,17,212,173,63,186,22,164
"2011","Rossendale 010G","E01025388","Total",657,227,23,204,178,79,187,36,151
"2011","Rossendale 010H","E01025389","Total",548,223,50,173,176,87,173,32,141
"2011","Rossendale 010I","E01025390","Total",517,228,30,198,130,53,178,25,153
"2011","Rossendale 010C","E01025391","Total",660,240,40,200,220,91,200,41,159
"2011","Rossendale 010D","E01025392","Total",573,190,16,174,135,46,163,23,140
"2011","Rossendale 010E","E01025394","Total",667,216,24,192,200,71,205,40,165
"2011","South Ribble 001A","E01025424","Total",505,146,4,142,162,52,112,18,94
"2011","South Ribble 001B","E01025425","Total",532,143,6,137,187,55,115,22,93
"2011","South Ribble 001C","E01025426","Total",502,173,4,169,147,41,97,11,86
"2011","South Ribble 001D","E01025466","Total",619,211,5,206,193,69,164,22,142
"2011","South Ribble 002A","E01025413","Total",770,276,13,263,196,69,213,21,192
"2011","South Ribble 002B","E01025414","Total",680,257,3,254,139,43,167,25,142
"2011","South Ribble 002C","E01025456","Total",472,131,10,121,129,45,120,22,98
"2011","South Ribble 002D","E01025458","Total",674,192,21,171,189,72,184,31,153
"2011","South Ribble 003A","E01025408","Total",651,244,4,240,141,36,163,10,153
"2011","South Ribble 003B","E01025409","Total",578,167,10,157,158,57,156,25,131
"2011","South Ribble 003C","E01025410","Total",512,124,5,119,200,48,123,25,98
"2011","South Ribble 003D","E01025467","Total",874,358,3,355,204,68,228,22,206
"2011","South Ribble 004A","E01025403","Total",786,110,5,105,309,124,120,29,91
"2011","South Ribble 004B","E01025457","Total",627,156,5,151,156,70,136,17,119
"2011","South Ribble 004C","E01025463","Total",574,138,8,130,179,70,130,22,108
"2011","South Ribble 004D","E01025464","Total",502,136,2,134,161,52,105,20,85
"2011","South Ribble 004E","E01025465","Total",503,158,9,149,128,57,127,22,105
"2011","South Ribble 005A","E01025411","Total",878,246,19,227,258,116,180,36,144
"2011","South Ribble 005B","E01025448","Total",700,193,15,178,187,84,165,23,142
"2011","South Ribble 005C","E01025449","Total",425,165,2,163,113,29,130,16,114
"2011","South Ribble 005D","E01025450","Total",415,129,28,101,158,61,120,29,91
"2011","South Ribble 006A","E01025412","Total",676,254,18,236,171,65,187,23,164
"2011","South Ribble 006B","E01025427","Total",741,294,26,268,163,64,222,31,191
"2011","South Ribble 006C","E01025428","Total",630,188,25,163,206,77,165,37,128
"2011","South Ribble 006D","E01025429","Total",617,202,48,154,215,85,182,43,139
"2011","South Ribble 007A","E01025404","Total",551,253,2,251,101,35,166,11,155
"2011","South Ribble 007B","E01025405","Total",560,240,16,224,119,49,181,21,160
"2011","South Ribble 007C","E01025406","Total",548,219,7,212,125,44,156,16,140
"2011","South Ribble 007D","E01025407","Total",862,259,48,211,274,116,237,46,191
"2011","South Ribble 008A","E01025399","Total",618,199,52,147,261,117,182,47,135
"2011","South Ribble 008B","E01025400","Total",715,210,23,187,244,93,173,45,128
"2011","South Ribble 008C","E01025401","Total",651,185,13,172,148,71,157,19,138
"2011","South Ribble 008D","E01025402","Total",605,142,28,114,228,104,126,28,98
"2011","South Ribble 009A","E01025442","Total",520,169,27,142,146,76,149,29,120
"2011","South Ribble 009B","E01025443","Total",603,199,12,187,139,49,144,18,126
"2011","South Ribble 009C","E01025444","Total",559,144,14,130,165,57,133,16,117
"2011","South Ribble 009D","E01025461","Total",737,174,8,166,278,100,164,39,125
"2011","South Ribble 009E","E01025462","Total",706,199,8,191,217,80,168,33,135
"2011","South Ribble 010A","E01025439","Total",579,228,5,223,145,55,141,14,127
"2011","South Ribble 010B","E01025453","Total",670,232,17,215,194,60,161,29,132
"2011","South Ribble 010C","E01025454","Total",506,183,7,176,152,46,129,16,113
"2011","South Ribble 010D","E01025455","Total",642,250,10,240,141,37,193,31,162
"2011","South Ribble 011A","E01025436","Total",912,244,9,235,269,79,239,42,197
"2011","South Ribble 011B","E01025437","Total",781,244,14,230,221,87,181,20,161
"2011","South Ribble 011C","E01025438","Total",523,145,5,140,149,38,104,14,90
"2011","South Ribble 011D","E01025440","Total",603,238,6,232,147,46,165,15,150
"2011","South Ribble 011E","E01025441","Total",662,297,5,292,142,34,180,20,160
"2011","South Ribble 012A","E01025417","Total",622,205,8,197,136,57,169,21,148
"2011","South Ribble 012B","E01025418","Total",611,176,7,169,181,83,165,38,127
"2011","South Ribble 012C","E01025419","Total",665,188,13,175,212,81,169,35,134
"2011","South Ribble 012D","E01025420","Total",1057,265,12,253,355,127,259,48,211
"2011","South Ribble 013A","E01025421","Total",912,173,41,132,355,154,173,58,115
"2011","South Ribble 013B","E01025422","Total",639,264,23,241,164,56,212,23,189
"2011","South Ribble 013C","E01025431","Total",772,160,29,131,250,123,157,44,113
"2011","South Ribble 013D","E01025433","Total",753,208,21,187,225,83,183,29,154
"2011","South Ribble 014A","E01025416","Total",610,169,9,160,174,67,157,27,130
"2011","South Ribble 014B","E01025451","Total",733,128,9,119,285,103,145,34,111
"2011","South Ribble 014C","E01025452","Total",738,213,48,165,238,97,193,41,152
"2011","South Ribble 015A","E01025415","Total",846,255,32,223,252,97,226,42,184
"2011","South Ribble 015B","E01025423","Total",604,256,52,204,211,67,230,63,167
"2011","South Ribble 015C","E01025435","Total",674,269,19,250,175,64,184,26,158
"2011","South Ribble 015D","E01025446","Total",663,236,8,228,169,61,171,25,146
"2011","South Ribble 016A","E01025430","Total",796,224,11,213,265,104,197,35,162
"2011","South Ribble 016C","E01025434","Total",827,351,5,346,184,48,208,22,186
"2011","South Ribble 016D","E01032928","Total",826,102,31,71,299,166,122,44,78
"2011","South Ribble 016E","E01032929","Total",497,192,10,182,111,47,160,26,134
"2011","South Ribble 017A","E01025445","Total",536,180,76,104,244,120,156,56,100
"2011","South Ribble 017B","E01025447","Total",533,278,54,224,182,70,194,31,163
"2011","South Ribble 017C","E01025459","Total",710,219,21,198,189,75,185,34,151
"2011","South Ribble 017D","E01025460","Total",922,315,44,271,260,106,279,40,239
"2011","West Lancashire 001A","E01025496","Total",481,129,10,119,146,57,128,26,102
"2011","West Lancashire 001B","E01025497","Total",563,118,4,114,215,73,119,28,91
"2011","West Lancashire 001C","E01025498","Total",520,153,10,143,138,54,148,25,123
"2011","West Lancashire 001D","E01025530","Total",620,177,2,175,149,39,149,23,126
"2011","West Lancashire 001E","E01025532","Total",600,197,5,192,193,64,153,28,125
"2011","West Lancashire 001F","E01025533","Total",709,253,3,250,175,61,202,17,185
"2011","West Lancashire 002A","E01025507","Total",678,213,12,201,177,49,161,23,138
"2011","West Lancashire 002B","E01025508","Total",616,238,21,217,144,45,201,26,175
"2011","West Lancashire 002C","E01025509","Total",553,221,17,204,124,41,189,25,164
"2011","West Lancashire 002D","E01025513","Total",822,274,13,261,231,72,224,39,185
"2011","West Lancashire 002E","E01025531","Total",488,168,2,166,93,29,146,16,130
"2011","West Lancashire 003A","E01025474","Total",458,135,7,128,121,37,125,20,105
"2011","West Lancashire 003B","E01025495","Total",867,292,9,283,201,59,232,19,213
"2011","West Lancashire 003C","E01025514","Total",966,310,17,293,248,86,281,48,233
"2011","West Lancashire 003D","E01025515","Total",680,271,6,265,136,35,210,25,185
"2011","West Lancashire 004A","E01025483","Total",958,358,36,322,272,107,276,49,227
"2011","West Lancashire 004B","E01025484","Total",791,249,12,237,239,92,219,42,177
"2011","West Lancashire 004C","E01025485","Total",702,192,13,179,224,84,186,36,150
"2011","West Lancashire 004D","E01025486","Total",654,172,17,155,223,89,170,32,138
"2011","West Lancashire 004E","E01025487","Total",624,191,18,173,205,68,165,30,135
"2011","West Lancashire 005A","E01025510","Total",514,183,5,178,145,40,122,17,105
"2011","West Lancashire 005B","E01025511","Total",469,154,7,147,128,46,112,11,101
"2011","West Lancashire 005C","E01025512","Total",563,172,9,163,161,51,153,27,126
"2011","West Lancashire 005D","E01025538","Total",660,235,5,230,160,58,177,27,150
"2011","West Lancashire 005E","E01025539","Total",560,168,9,159,168,61,145,25,120
"2011","West Lancashire 006A","E01025499","Total",596,219,10,209,141,44,159,20,139
"2011","West Lancashire 006B","E01025501","Total",493,230,1,229,92,22,153,21,132
"2011","West Lancashire 006C","E01025502","Total",639,238,8,230,176,58,175,27,148
"2011","West Lancashire 006D","E01025516","Total",631,214,11,203,176,57,177,39,138
"2011","West Lancashire 006E","E01025517","Total",595,194,35,159,192,82,174,36,138
"2011","West Lancashire 006F","E01025519","Total",505,194,5,189,115,36,138,19,119
"2011","West Lancashire 007A","E01025488","Total",743,274,13,261,132,49,199,16,183
"2011","West Lancashire 007B","E01025489","Total",505,150,6,144,144,50,133,17,116
"2011","West Lancashire 007C","E01025490","Total",495,180,8,172,113,50,107,12,95
"2011","West Lancashire 007D","E01025500","Total",664,259,11,248,127,41,178,15,163
"2011","West Lancashire 007E","E01025518","Total",629,272,16,256,112,46,214,17,197
"2011","West Lancashire 008A","E01025479","Total",837,264,7,257,190,44,246,35,211
"2011","West Lancashire 008B","E01025491","Total",575,222,3,219,129,42,141,18,123
"2011","West Lancashire 008C","E01025506","Total",842,300,8,292,190,55,215,20,195
"2011","West Lancashire 009A","E01025468","Total",595,89,10,79,261,73,122,32,90
"2011","West Lancashire 009B","E01025469","Total",761,324,26,298,188,61,284,37,247
"2011","West Lancashire 009C","E01025470","Total",542,94,12,82,213,63,133,31,102
"2011","West Lancashire 009D","E01025522","Total",507,216,16,200,111,36,152,16,136
"2011","West Lancashire 010A","E01025471","Total",574,195,66,129,247,113,161,54,107
"2011","West Lancashire 010B","E01025480","Total",503,139,53,86,235,83,129,58,71
"2011","West Lancashire 010C","E01025481","Total",640,261,61,200,199,87,191,40,151
"2011","West Lancashire 010D","E01025482","Total",578,274,95,179,237,103,198,50,148
"2011","West Lancashire 010E","E01025520","Total",522,225,35,190,157,72,162,35,127
"2011","West Lancashire 010F","E01025521","Total",659,242,65,177,264,116,193,58,135
"2011","West Lancashire 011A","E01025523","Total",685,193,31,162,230,88,161,33,128
"2011","West Lancashire 011B","E01025524","Total",746,315,43,272,187,62,245,31,214
"2011","West Lancashire 011C","E01025525","Total",629,197,23,174,224,73,178,30,148
"2011","West Lancashire 011D","E01025526","Total",774,290,23,267,204,85,204,31,173
"2011","West Lancashire 012A","E01025472","Total",543,187,6,181,164,55,136,27,109
"2011","West Lancashire 012B","E01025473","Total",607,228,15,213,148,44,175,22,153
"2011","West Lancashire 012C","E01025475","Total",606,250,7,243,157,38,164,24,140
"2011","West Lancashire 012D","E01025476","Total",547,225,7,218,131,39,154,18,136
"2011","West Lancashire 012E","E01025477","Total",478,143,4,139,135,44,116,17,99
"2011","West Lancashire 012F","E01025478","Total",478,186,7,179,133,29,108,21,87
"2011","West Lancashire 013A","E01025492","Total",503,156,34,122,181,60,145,31,114
"2011","West Lancashire 013B","E01025527","Total",621,312,60,252,191,86,235,36,199
"2011","West Lancashire 013C","E01025528","Total",685,278,118,160,334,154,176,53,123
"2011","West Lancashire 013D","E01025529","Total",709,246,74,172,308,156,195,53,142
"2011","West Lancashire 014A","E01025493","Total",660,304,128,176,308,147,195,54,141
"2011","West Lancashire 014B","E01025494","Total",676,337,104,233,222,97,253,59,194
"2011","West Lancashire 014C","E01025503","Total",499,169,71,98,237,100,129,46,83
"2011","West Lancashire 014D","E01025504","Total",472,234,73,161,180,75,159,41,118
"2011","West Lancashire 014E","E01025505","Total",632,217,30,187,188,67,166,30,136
"2011","West Lancashire 015A","E01025534","Total",686,216,9,207,219,80,174,20,154
"2011","West Lancashire 015B","E01025535","Total",582,160,12,148,164,43,163,28,135
"2011","West Lancashire 015C","E01025536","Total",646,255,43,212,218,76,205,41,164
"2011","West Lancashire 015D","E01025537","Total",683,257,16,241,159,46,186,33,153
"2011","West Lancashire 015E","E01025540","Total",488,161,8,153,116,33,144,21,123
"2011","Wyre 001A","E01025573","Total",590,199,12,187,161,64,166,32,134
"2011","Wyre 001B","E01025574","Total",741,356,51,305,205,99,285,37,248
"2011","Wyre 001C","E01025581","Total",587,204,20,184,166,68,196,22,174
"2011","Wyre 001D","E01025582","Total",581,237,48,189,171,84,187,27,160
"2011","Wyre 001E","E01025583","Total",602,237,35,202,178,77,212,42,170
"2011","Wyre 001F","E01025584","Total",851,456,31,425,115,53,310,22,288
"2011","Wyre 002A","E01025605","Total",565,198,13,185,153,44,172,25,147
"2011","Wyre 002B","E01025606","Total",516,221,55,166,184,77,183,47,136
"2011","Wyre 002C","E01025607","Total",630,231,11,220,172,53,184,26,158
"2011","Wyre 002D","E01025608","Total",658,219,11,208,189,65,181,28,153
"2011","Wyre 003A","E01025590","Total",622,304,86,218,236,94,227,54,173
"2011","Wyre 003B","E01025591","Total",748,384,11,373,116,38,274,26,248
"2011","Wyre 003C","E01025592","Total",638,321,103,218,237,110,227,59,168
"2011","Wyre 003D","E01025593","Total",654,333,11,322,103,30,194,13,181
"2011","Wyre 004A","E01025563","Total",455,174,2,172,84,28,134,14,120
"2011","Wyre 004B","E01025564","Total",719,286,15,271,166,52,210,22,188
"2011","Wyre 004C","E01025565","Total",642,263,6,257,138,39,196,27,169
"2011","Wyre 004D","E01025586","Total",715,368,8,360,153,52,243,32,211
"2011","Wyre 004E","E01025587","Total",694,318,13,305,141,48,232,21,211
"2011","Wyre 004F","E01025588","Total",704,430,7,423,82,21,270,10,260
"2011","Wyre 004G","E01025589","Total",489,153,11,142,145,47,126,26,100
"2011","Wyre 005A","E01025557","Total",683,247,21,226,193,59,201,43,158
"2011","Wyre 005B","E01025575","Total",551,307,45,262,139,65,225,27,198
"2011","Wyre 005C","E01025578","Total",629,260,46,214,200,94,211,38,173
"2011","Wyre 005D","E01025579","Total",513,187,55,132,212,101,161,38,123
"2011","Wyre 005E","E01025580","Total",497,192,10,182,123,31,134,15,119
"2011","Wyre 006A","E01025547","Total",669,196,4,192,168,51,164,23,141
"2011","Wyre 006B","E01025549","Total",842,212,9,203,259,83,167,32,135
"2011","Wyre 006C","E01025609","Total",826,243,15,228,217,69,204,30,174
"2011","Wyre 007A","E01025548","Total",747,380,2,378,113,40,232,15,217
"2011","Wyre 007B","E01025553","Total",1031,245,13,232,336,128,227,41,186
"2011","Wyre 007C","E01025558","Total",822,424,8,416,140,34,292,19,273
"2011","Wyre 007D","E01025559","Total",776,240,8,232,207,91,217,27,190
"2011","Wyre 007E","E01025560","Total",647,327,2,325,87,31,233,16,217
"2011","Wyre 008A","E01025554","Total",764,425,21,404,130,47,282,35,247
"2011","Wyre 008B","E01025556","Total",638,278,36,242,191,62,206,38,168
"2011","Wyre 008C","E01025570","Total",678,402,22,380,87,35,265,17,248
"2011","Wyre 008D","E01025571","Total",586,250,37,213,177,54,198,48,150
"2011","Wyre 008E","E01025572","Total",642,340,9,331,99,25,257,20,237
"2011","Wyre 008F","E01025604","Total",653,264,21,243,183,54,217,32,185
"2011","Wyre 009A","E01025561","Total",591,165,7,158,178,60,154,26,128
"2011","Wyre 009B","E01025562","Total",871,296,8,288,224,69,262,34,228
"2011","Wyre 009C","E01025585","Total",890,278,16,262,241,79,232,30,202
"2011","Wyre 010A","E01025542","Total",684,230,19,211,198,51,176,37,139
"2011","Wyre 010B","E01025555","Total",685,372,11,361,119,35,258,23,235
"2011","Wyre 010C","E01025601","Total",621,292,5,287,121,35,174,15,159
"2011","Wyre 010D","E01025602","Total",691,208,17,191,216,66,183,30,153
"2011","Wyre 010E","E01025603","Total",710,354,18,336,130,37,210,19,191
"2011","Wyre 011A","E01025541","Total",693,206,27,179,235,76,195,40,155
"2011","Wyre 011B","E01025543","Total",747,230,41,189,264,115,202,48,154
"2011","Wyre 011C","E01025544","Total",755,359,27,332,168,64,294,32,262
"2011","Wyre 011D","E01025576","Total",1069,426,21,405,249,91,302,21,281
"2011","Wyre 011E","E01025577","Total",646,263,22,241,193,75,231,25,206
"2011","Wyre 012A","E01025550","Total",671,281,3,278,151,52,191,19,172
"2011","Wyre 012B","E01025552","Total",497,129,5,124,156,56,126,21,105
"2011","Wyre 012C","E01025594","Total",744,370,13,357,127,31,259,27,232
"2011","Wyre 012D","E01025595","Total",628,271,7,264,140,45,163,24,139
"2011","Wyre 012E","E01025596","Total",820,220,12,208,302,100,190,41,149
"2011","Wyre 012F","E01025597","Total",480,189,7,182,132,44,140,22,118
"2011","Wyre 013A","E01025545","Total",789,302,9,293,166,38,190,13,177
"2011","Wyre 013B","E01025546","Total",716,239,22,217,179,74,210,31,179
"2011","Wyre 013C","E01025551","Total",552,168,6,162,145,48,132,21,111
"2011","Wyre 013D","E01025567","Total",756,327,15,312,158,46,247,26,221
"2011","Wyre 013E","E01025598","Total",765,332,10,322,136,39,233,15,218
"2011","Wyre 014A","E01025566","Total",847,352,5,347,215,51,225,31,194
"2011","Wyre 014B","E01025568","Total",792,325,15,310,180,66,239,32,207
"2011","Wyre 014C","E01025569","Total",877,395,7,388,170,55,244,16,228
"2011","Wyre 014D","E01025599","Total",432,148,7,141,102,25,135,14,121
"2011","Wyre 014E","E01025600","Total",667,223,6,217,181,62,161,27,134
"2011","Knowsley 001A","E01006448","Total",720,381,120,261,275,118,289,65,224
"2011","Knowsley 001B","E01006492","Total",515,162,37,125,178,70,174,35,139
"2011","Knowsley 001C","E01006493","Total",433,236,84,152,177,75,193,58,135
"2011","Knowsley 001D","E01006494","Total",526,269,135,134,240,96,206,74,132
"2011","Knowsley 001E","E01006495","Total",689,243,103,140,326,164,185,61,124
"2011","Knowsley 002A","E01006454","Total",512,193,15,178,121,34,164,19,145
"2011","Knowsley 002B","E01006456","Total",670,250,18,232,195,45,247,39,208
"2011","Knowsley 002C","E01006457","Total",522,239,3,236,85,26,186,21,165
"2011","Knowsley 002D","E01006458","Total",593,242,53,189,171,65,199,46,153
"2011","Knowsley 002E","E01006490","Total",1032,142,59,83,475,228,202,87,115
"2011","Knowsley 002F","E01006491","Total",761,135,33,102,318,150,144,50,94
"2011","Knowsley 003A","E01006415","Total",825,301,82,219,332,125,272,69,203
"2011","Knowsley 003B","E01006417","Total",711,438,64,374,146,51,296,37,259
"2011","Knowsley 003C","E01006436","Total",636,310,69,241,191,69,290,52,238
"2011","Knowsley 003D","E01006437","Total",618,299,57,242,178,70,257,52,205
"2011","Knowsley 003E","E01006447","Total",632,267,54,213,161,63,232,37,195
"2011","Knowsley 004A","E01006455","Total",701,341,104,237,252,99,269,49,220
"2011","Knowsley 004B","E01006506","Total",550,144,41,103,189,86,126,30,96
"2011","Knowsley 004C","E01006507","Total",636,286,59,227,211,72,251,52,199
"2011","Knowsley 004D","E01006508","Total",576,193,36,157,199,77,185,39,146
"2011","Knowsley 004E","E01006509","Total",695,341,102,239,265,104,268,63,205
"2011","Knowsley 004F","E01006510","Total",493,152,18,134,137,50,127,32,95
"2011","Knowsley 005A","E01006416","Total",665,333,85,248,204,94,276,53,223
"2011","Knowsley 005B","E01006418","Total",549,261,69,192,183,73,235,54,181
"2011","Knowsley 005C","E01006434","Total",631,280,81,199,241,99,205,52,153
"2011","Knowsley 005D","E01006435","Total",653,325,79,246,209,84,280,54,226
"2011","Knowsley 005E","E01006438","Total",510,218,12,206,121,52,163,24,139
"2011","Knowsley 005F","E01006439","Total",686,268,32,236,198,79,230,37,193
"2011","Knowsley 005G","E01006446","Total",566,261,66,195,191,77,208,45,163
"2011","Knowsley 006A","E01006412","Total",591,302,79,223,202,82,228,55,173
"2011","Knowsley 006B","E01006413","Total",866,528,66,462,156,67,363,37,326
"2011","Knowsley 006C","E01006414","Total",610,304,54,250,173,73,216,41,175
"2011","Knowsley 006D","E01006441","Total",993,362,55,307,326,151,336,65,271
"2011","Knowsley 007A","E01006460","Total",661,337,103,234,241,94,252,56,196
"2011","Knowsley 007B","E01006461","Total",619,281,76,205,233,83,238,64,174
"2011","Knowsley 007C","E01006463","Total",971,459,64,395,229,116,370,43,327
"2011","Knowsley 007D","E01006464","Total",727,374,26,348,156,47,265,30,235
"2011","Knowsley 007E","E01006466","Total",776,328,33,295,193,81,265,30,235
"2011","Knowsley 008A","E01006453","Total",515,253,82,171,209,78,176,48,128
"2011","Knowsley 008B","E01006467","Total",558,326,108,218,207,84,235,57,178
"2011","Knowsley 008E","E01006470","Total",585,305,63,242,184,69,254,58,196
"2011","Knowsley 008F","E01033228","Total",810,447,127,320,303,106,318,73,245
"2011","Knowsley 009A","E01006459","Total",614,161,30,131,208,64,147,32,115
"2011","Knowsley 009B","E01006462","Total",639,245,17,228,201,71,193,30,163
"2011","Knowsley 009C","E01006496","Total",606,268,25,243,161,51,238,30,208
"2011","Knowsley 009D","E01006498","Total",548,119,9,110,242,79,110,36,74
"2011","Knowsley 009E","E01006499","Total",681,245,28,217,214,95,184,33,151
"2011","Knowsley 010A","E01006440","Total",622,313,92,221,225,92,243,58,185
"2011","Knowsley 010B","E01006442","Total",614,358,77,281,181,80,269,55,214
"2011","Knowsley 010C","E01006443","Total",667,395,67,328,169,69,281,37,244
"2011","Knowsley 010D","E01006444","Total",521,277,94,183,208,85,169,48,121
"2011","Knowsley 010E","E01006445","Total",539,270,85,185,208,80,215,65,150
"2011","Knowsley 011A","E01006465","Total",635,158,7,151,227,81,183,35,148
"2011","Knowsley 011B","E01006482","Total",587,236,68,168,228,95,177,49,128
"2011","Knowsley 011C","E01006483","Total",614,290,47,243,183,69,223,37,186
"2011","Knowsley 011D","E01006484","Total",567,241,44,197,195,70,196,40,156
"2011","Knowsley 012A","E01006449","Total",623,259,29,230,186,64,222,36,186
"2011","Knowsley 012B","E01006450","Total",619,302,85,217,218,96,229,61,168
"2011","Knowsley 012C","E01006451","Total",606,248,49,199,194,75,202,53,149
"2011","Knowsley 012D","E01006452","Total",618,211,43,168,214,88,169,34,135
"2011","Knowsley 013A","E01006497","Total",472,178,14,164,120,39,147,20,127
"2011","Knowsley 013B","E01006500","Total",464,222,42,180,133,43,192,36,156
"2011","Knowsley 013C","E01006501","Total",562,158,30,128,245,115,132,34,98
"2011","Knowsley 013D","E01006504","Total",573,263,59,204,197,65,185,33,152
"2011","Knowsley 013E","E01006505","Total",700,314,69,245,261,99,275,58,217
"2011","Knowsley 014A","E01006472","Total",638,239,12,227,174,54,182,25,157
"2011","Knowsley 014B","E01006485","Total",615,218,19,199,207,59,185,31,154
"2011","Knowsley 014C","E01006486","Total",491,155,4,151,128,50,133,18,115
"2011","Knowsley 014D","E01006487","Total",630,220,20,200,180,51,160,34,126
"2011","Knowsley 014E","E01006488","Total",686,210,11,199,205,70,204,38,166
"2011","Knowsley 014F","E01006489","Total",581,210,20,190,176,63,166,32,134
"2011","Knowsley 015A","E01006477","Total",575,212,40,172,187,78,155,29,126
"2011","Knowsley 015B","E01006478","Total",613,279,48,231,185,67,210,38,172
"2011","Knowsley 015C","E01006479","Total",590,229,39,190,193,68,188,38,150
"2011","Knowsley 015D","E01006480","Total",613,338,74,264,183,69,266,56,210
"2011","Knowsley 015E","E01006481","Total",642,341,28,313,147,60,290,36,254
"2011","Knowsley 016A","E01006471","Total",624,225,13,212,171,52,181,30,151
"2011","Knowsley 016B","E01006473","Total",490,168,11,157,143,40,136,34,102
"2011","Knowsley 016C","E01006474","Total",637,275,9,266,147,39,215,22,193
"2011","Knowsley 016D","E01006475","Total",555,180,11,169,150,44,144,23,121
"2011","Knowsley 016E","E01006476","Total",568,184,5,179,169,33,151,23,128
"2011","Knowsley 017A","E01006420","Total",764,140,18,122,315,122,158,44,114
"2011","Knowsley 017B","E01006424","Total",803,192,19,173,276,84,208,53,155
"2011","Knowsley 017C","E01006502","Total",767,286,15,271,174,72,222,21,201
"2011","Knowsley 017D","E01006503","Total",544,233,3,230,113,34,166,22,144
"2011","Knowsley 018A","E01006421","Total",428,66,10,56,190,54,86,33,53
"2011","Knowsley 018B","E01006425","Total",559,180,14,166,175,56,151,22,129
"2011","Knowsley 018C","E01006430","Total",611,333,42,291,151,58,270,31,239
"2011","Knowsley 018D","E01006433","Total",633,269,32,237,178,62,222,37,185
"2011","Knowsley 019A","E01006419","Total",628,129,15,114,229,69,134,36,98
"2011","Knowsley 019B","E01006422","Total",528,208,16,192,139,41,147,25,122
"2011","Knowsley 019C","E01006423","Total",528,103,14,89,189,76,110,33,77
"2011","Knowsley 019D","E01006427","Total",618,256,7,249,158,45,168,27,141
"2011","Knowsley 020A","E01006426","Total",556,273,52,221,164,65,195,36,159
"2011","Knowsley 020B","E01006428","Total",630,224,48,176,224,116,198,44,154
"2011","Knowsley 020C","E01006429","Total",463,228,64,164,172,52,182,57,125
"2011","Knowsley 020D","E01006431","Total",765,287,33,254,208,86,233,36,197
"2011","Knowsley 020E","E01006432","Total",671,311,62,249,212,80,230,44,186
"2011","Liverpool 001A","E01006651","Total",592,88,19,69,279,104,117,40,77
"2011","Liverpool 001B","E01006653","Total",656,268,53,215,210,83,248,43,205
"2011","Liverpool 001C","E01006655","Total",706,279,44,235,231,90,223,39,184
"2011","Liverpool 001D","E01006658","Total",634,305,51,254,173,51,252,36,216
"2011","Liverpool 001E","E01006660","Total",616,267,35,232,198,77,252,44,208
"2011","Liverpool 002A","E01006652","Total",633,197,32,165,201,79,180,33,147
"2011","Liverpool 002B","E01006656","Total",669,219,34,185,192,94,186,31,155
"2011","Liverpool 002C","E01006657","Total",582,225,42,183,163,80,186,24,162
"2011","Liverpool 002D","E01006780","Total",619,207,29,178,189,73,181,38,143
"2011","Liverpool 002E","E01006783","Total",645,212,41,171,221,81,182,32,150
"2011","Liverpool 003A","E01006781","Total",600,160,15,145,191,62,178,40,138
"2011","Liverpool 003B","E01006782","Total",691,239,25,214,197,81,192,36,156
"2011","Liverpool 003C","E01006784","Total",586,149,18,131,177,79,149,27,122
"2011","Liverpool 003D","E01006785","Total",781,300,56,244,227,93,237,48,189
"2011","Liverpool 003E","E01006786","Total",764,227,20,207,233,83,220,48,172
"2011","Liverpool 004A","E01006661","Total",749,413,75,338,215,89,307,40,267
"2011","Liverpool 004B","E01006662","Total",785,406,64,342,227,128,312,39,273
"2011","Liverpool 004C","E01006663","Total",510,196,39,157,173,71,168,34,134
"2011","Liverpool 004D","E01006664","Total",822,410,79,331,253,103,330,61,269
"2011","Liverpool 004E","E01006669","Total",551,128,25,103,228,85,118,36,82
"2011","Liverpool 005A","E01006654","Total",627,220,26,194,199,78,188,31,157
"2011","Liverpool 005B","E01006659","Total",548,261,47,214,143,52,214,32,182
"2011","Liverpool 005C","E01006734","Total",625,320,103,217,244,102,234,61,173
"2011","Liverpool 005D","E01006735","Total",571,285,74,211,196,80,221,46,175
"2011","Liverpool 005E","E01006736","Total",582,250,69,181,208,73,193,55,138
"2011","Liverpool 005F","E01006737","Total",562,244,55,189,202,64,220,51,169
"2011","Liverpool 006A","E01006787","Total",691,277,44,233,191,66,194,46,148
"2011","Liverpool 006B","E01006788","Total",681,203,56,147,275,117,194,62,132
"2011","Liverpool 006C","E01006790","Total",801,394,89,305,243,104,290,45,245
"2011","Liverpool 006D","E01006791","Total",873,435,62,373,185,78,320,44,276
"2011","Liverpool 007A","E01006665","Total",630,130,16,114,232,97,151,35,116
"2011","Liverpool 007B","E01006666","Total",514,86,10,76,253,71,110,43,67
"2011","Liverpool 007C","E01006667","Total",618,231,34,197,173,62,214,40,174
"2011","Liverpool 007D","E01006668","Total",590,107,20,87,254,84,117,50,67
"2011","Liverpool 007E","E01006670","Total",607,157,26,131,231,77,152,34,118
"2011","Liverpool 008A","E01006607","Total",641,290,73,217,206,65,243,55,188
"2011","Liverpool 008B","E01006612","Total",740,399,59,340,180,66,305,44,261
"2011","Liverpool 008C","E01006729","Total",539,227,77,150,236,98,200,60,140
"2011","Liverpool 008F","E01032510","Total",776,245,39,206,250,105,234,50,184
"2011","Liverpool 008G","E01032511","Total",616,247,52,195,165,58,182,30,152
"2011","Liverpool 009A","E01006608","Total",563,227,33,194,155,69,172,30,142
"2011","Liverpool 009B","E01006609","Total",576,230,47,183,172,68,180,38,142
"2011","Liverpool 009C","E01006610","Total",669,329,72,257,195,71,278,56,222
"2011","Liverpool 009D","E01006613","Total",611,328,45,283,151,57,261,27,234
"2011","Liverpool 009E","E01006705","Total",689,265,54,211,181,87,203,47,156
"2011","Liverpool 010A","E01006598","Total",604,356,82,274,202,78,259,62,197
"2011","Liverpool 010B","E01006599","Total",482,239,94,145,202,96,152,48,104
"2011","Liverpool 010E","E01006672","Total",798,358,110,248,315,142,264,66,198
"2011","Liverpool 010F","E01033759","Total",480,191,51,140,168,73,160,36,124
"2011","Liverpool 011A","E01006600","Total",592,261,50,211,178,52,242,56,186
"2011","Liverpool 011B","E01006603","Total",594,270,43,227,166,55,237,41,196
"2011","Liverpool 011C","E01006730","Total",542,260,61,199,192,56,219,49,170
"2011","Liverpool 011D","E01006731","Total",486,229,58,171,171,60,182,40,142
"2011","Liverpool 011E","E01006732","Total",644,338,121,217,274,128,252,75,177
"2011","Liverpool 012A","E01006611","Total",742,384,79,305,179,86,260,30,230
"2011","Liverpool 012B","E01006614","Total",667,304,71,233,166,73,186,28,158
"2011","Liverpool 012C","E01006615","Total",663,279,68,211,195,84,189,32,157
"2011","Liverpool 012D","E01006698","Total",725,273,77,196,250,119,204,50,154
"2011","Liverpool 012E","E01006700","Total",653,292,63,229,184,71,223,51,172
"2011","Liverpool 013A","E01006623","Total",527,133,10,123,175,41,140,27,113
"2011","Liverpool 013B","E01006624","Total",702,282,35,247,188,73,223,31,192
"2011","Liverpool 013C","E01006627","Total",600,217,14,203,167,55,187,26,161
"2011","Liverpool 013D","E01006671","Total",499,163,30,133,178,58,149,33,116
"2011","Liverpool 014A","E01006699","Total",777,418,87,331,233,97,295,53,242
"2011","Liverpool 014B","E01006701","Total",671,301,42,259,151,63,250,24,226
"2011","Liverpool 014C","E01006702","Total",740,373,99,274,228,95,268,51,217
"2011","Liverpool 014D","E01006703","Total",818,440,55,385,160,53,359,48,311
"2011","Liverpool 014E","E01006778","Total",1124,553,109,444,273,109,431,77,354
"2011","Liverpool 015A","E01006541","Total",803,369,43,326,187,69,309,40,269
"2011","Liverpool 015B","E01006543","Total",509,181,19,162,147,44,140,15,125
"2011","Liverpool 015C","E01006544","Total",738,372,103,269,252,89,294,86,208
"2011","Liverpool 015D","E01006616","Total",613,267,39,228,168,52,216,38,178
"2011","Liverpool 015E","E01006762","Total",725,325,73,252,234,77,256,57,199
"2011","Liverpool 016A","E01006604","Total",571,222,35,187,162,45,209,45,164
"2011","Liverpool 016B","E01006605","Total",696,335,48,287,187,57,284,50,234
"2011","Liverpool 016C","E01006618","Total",692,302,37,265,177,51,256,39,217
"2011","Liverpool 016D","E01006625","Total",609,226,18,208,179,50,195,23,172
"2011","Liverpool 016E","E01006626","Total",593,221,12,209,161,43,199,33,166
"2011","Liverpool 017A","E01006637","Total",670,320,111,209,277,127,227,47,180
"2011","Liverpool 017B","E01006638","Total",518,270,80,190,199,91,208,41,167
"2011","Liverpool 017C","E01006639","Total",640,217,44,173,228,97,178,42,136
"2011","Liverpool 017D","E01006644","Total",963,418,73,345,281,116,338,66,272
"2011","Liverpool 017E","E01006645","Total",690,396,84,312,195,68,294,53,241
"2011","Liverpool 018A","E01006542","Total",583,245,42,203,174,62,213,41,172
"2011","Liverpool 018B","E01006558","Total",739,403,81,322,174,78,260,42,218
"2011","Liverpool 018E","E01006562","Total",714,394,110,284,236,105,270,49,221
"2011","Liverpool 018F","E01033747","Total",496,318,65,253,142,62,233,39,194
"2011","Liverpool 019A","E01006545","Total",646,237,69,168,239,98,179,37,142
"2011","Liverpool 019B","E01006546","Total",583,236,54,182,188,77,184,47,137
"2011","Liverpool 019C","E01006547","Total",718,359,80,279,197,80,234,45,189
"2011","Liverpool 019D","E01006548","Total",759,385,97,288,247,110,231,42,189
"2011","Liverpool 019E","E01006766","Total",574,243,69,174,196,88,167,47,120
"2011","Liverpool 019F","E01006767","Total",779,306,67,239,254,132,220,53,167
"2011","Liverpool 020A","E01006606","Total",723,303,50,253,186,72,238,38,200
"2011","Liverpool 020B","E01006761","Total",793,376,49,327,191,71,279,37,242
"2011","Liverpool 020C","E01006763","Total",652,256,61,195,208,84,191,35,156
"2011","Liverpool 020D","E01006764","Total",667,267,66,201,203,79,211,40,171
"2011","Liverpool 020E","E01006765","Total",659,282,48,234,199,54,216,46,170
"2011","Liverpool 020F","E01006768","Total",587,221,23,198,139,40,168,39,129
"2011","Liverpool 021A","E01006617","Total",650,185,16,169,170,53,158,21,137
"2011","Liverpool 021B","E01006619","Total",734,261,24,237,191,69,208,29,179
"2011","Liverpool 021C","E01006620","Total",625,302,19,283,146,43,205,15,190
"2011","Liverpool 021D","E01006621","Total",584,212,11,201,156,46,159,23,136
"2011","Liverpool 021E","E01006622","Total",586,178,8,170,182,56,152,19,133
"2011","Liverpool 021F","E01006640","Total",760,259,30,229,249,103,231,42,189
"2011","Liverpool 022B","E01006776","Total",844,395,45,350,179,64,332,56,276
"2011","Liverpool 022D","E01006779","Total",902,508,131,377,267,105,384,67,317
"2011","Liverpool 022E","E01033764","Total",1172,706,114,592,233,87,514,66,448
"2011","Liverpool 023A","E01006560","Total",996,625,80,545,211,76,459,58,401
"2011","Liverpool 023B","E01006564","Total",800,377,45,332,175,71,295,42,253
"2011","Liverpool 023C","E01006646","Total",1006,476,80,396,199,67,314,55,259
"2011","Liverpool 023D","E01006648","Total",1075,458,80,378,200,74,349,47,302
"2011","Liverpool 024A","E01006540","Total",771,423,85,338,198,90,262,39,223
"2011","Liverpool 024B","E01006563","Total",908,620,120,500,218,88,436,74,362
"2011","Liverpool 024C","E01006647","Total",636,398,111,287,227,75,292,62,230
"2011","Liverpool 024D","E01006693","Total",838,493,40,453,135,41,403,42,361
"2011","Liverpool 025A","E01006572","Total",501,247,80,167,186,79,195,51,144
"2011","Liverpool 025B","E01006574","Total",612,289,53,236,195,71,240,41,199
"2011","Liverpool 025C","E01006641","Total",633,84,26,58,295,168,115,44,71
"2011","Liverpool 025D","E01006642","Total",590,286,74,212,198,68,246,53,193
"2011","Liverpool 025E","E01006643","Total",740,293,102,191,308,123,256,91,165
"2011","Liverpool 026A","E01006567","Total",892,491,32,459,167,60,352,30,322
"2011","Liverpool 026B","E01006568","Total",629,192,36,156,212,77,168,41,127
"2011","Liverpool 026C","E01006570","Total",595,209,24,185,187,49,163,34,129
"2011","Liverpool 026D","E01006571","Total",612,294,48,246,178,50,229,48,181
"2011","Liverpool 027A","E01006711","Total",685,289,56,233,214,87,246,51,195
"2011","Liverpool 027D","E01006717","Total",576,188,23,165,182,56,157,29,128
"2011","Liverpool 027E","E01006718","Total",678,264,35,229,193,65,239,45,194
"2011","Liverpool 027F","E01006719","Total",638,206,52,154,226,90,191,49,142
"2011","Liverpool 027G","E01032508","Total",847,411,75,336,221,84,323,65,258
"2011","Liverpool 027H","E01032509","Total",665,264,67,197,224,108,206,45,161
"2011","Liverpool 028A","E01006690","Total",801,368,48,320,146,76,216,34,182
"2011","Liverpool 028B","E01006692","Total",989,446,89,357,278,127,365,74,291
"2011","Liverpool 028C","E01006695","Total",1029,546,67,479,188,71,350,34,316
"2011","Liverpool 028D","E01006759","Total",460,166,22,144,139,48,132,27,105
"2011","Liverpool 028E","E01006760","Total",826,392,34,358,126,51,267,28,239
"2011","Liverpool 029A","E01006565","Total",638,265,29,236,175,55,211,35,176
"2011","Liverpool 029B","E01006569","Total",613,309,36,273,144,38,241,44,197
"2011","Liverpool 029C","E01006573","Total",778,374,71,303,205,89,282,48,234
"2011","Liverpool 029D","E01006712","Total",569,200,44,156,191,87,152,36,116
"2011","Liverpool 029E","E01006713","Total",604,213,24,189,190,82,176,37,139
"2011","Liverpool 030A","E01006691","Total",647,292,88,204,200,99,193,45,148
"2011","Liverpool 030B","E01006694","Total",891,399,102,297,261,128,253,47,206
"2011","Liverpool 030C","E01006696","Total",768,364,90,274,234,96,265,56,209
"2011","Liverpool 030D","E01006697","Total",828,401,110,291,248,130,274,58,216
"2011","Liverpool 030E","E01006746","Total",655,351,57,294,146,50,250,46,204
"2011","Liverpool 031A","E01006512","Total",799,437,68,369,120,78,149,21,128
"2011","Liverpool 031B","E01006747","Total",857,437,30,407,104,46,194,18,176
"2011","Liverpool 031C","E01006748","Total",756,347,36,311,116,45,167,21,146
"2011","Liverpool 031F","E01006751","Total",831,461,99,362,235,90,314,68,246
"2011","Liverpool 031G","E01033763","Total",820,474,34,440,97,23,351,23,328
"2011","Liverpool 032A","E01006566","Total",577,185,18,167,190,71,159,24,135
"2011","Liverpool 032B","E01006585","Total",641,334,42,292,150,55,280,36,244
"2011","Liverpool 032C","E01006586","Total",921,370,38,332,214,82,286,50,236
"2011","Liverpool 032D","E01006587","Total",717,249,30,219,178,75,208,32,176
"2011","Liverpool 032E","E01006716","Total",701,257,57,200,221,110,217,46,171
"2011","Liverpool 034A","E01006575","Total",578,238,25,213,153,52,200,42,158
"2011","Liverpool 034B","E01006576","Total",713,220,18,202,213,81,177,28,149
"2011","Liverpool 034C","E01006577","Total",597,168,5,163,194,63,142,34,108
"2011","Liverpool 034D","E01006579","Total",618,204,10,194,209,78,175,27,148
"2011","Liverpool 034E","E01006584","Total",611,225,15,210,172,59,168,22,146
"2011","Liverpool 035A","E01006720","Total",905,392,109,283,259,129,237,58,179
"2011","Liverpool 035B","E01006725","Total",739,300,54,246,181,81,254,47,207
"2011","Liverpool 035C","E01006726","Total",659,243,59,184,152,64,164,31,133
"2011","Liverpool 035D","E01006727","Total",665,213,36,177,163,77,195,40,155
"2011","Liverpool 035E","E01006728","Total",855,394,85,309,218,93,268,41,227
"2011","Liverpool 035F","E01006752","Total",489,242,40,202,118,46,141,22,119
"2011","Liverpool 036A","E01006578","Total",554,149,17,132,181,75,143,39,104
"2011","Liverpool 036B","E01006580","Total",515,140,3,137,170,50,112,16,96
"2011","Liverpool 036C","E01006581","Total",607,175,9,166,199,70,130,17,113
"2011","Liverpool 036D","E01006773","Total",554,161,10,151,180,60,140,29,111
"2011","Liverpool 036E","E01006774","Total",552,148,19,129,201,58,124,29,95
"2011","Liverpool 037A","E01006514","Total",1115,492,27,465,80,32,251,22,229
"2011","Liverpool 037B","E01006515","Total",641,320,49,271,121,42,236,32,204
"2011","Liverpool 037D","E01006673","Total",954,468,112,356,249,115,303,62,241
"2011","Liverpool 037E","E01033757","Total",715,432,14,418,39,21,113,5,108
"2011","Liverpool 037F","E01033768","Total",835,397,19,378,78,34,262,13,249
"2011","Liverpool 038A","E01006550","Total",483,138,13,125,64,30,105,13,92
"2011","Liverpool 038B","E01006557","Total",635,202,24,178,87,35,113,16,97
"2011","Liverpool 038C","E01006721","Total",912,441,88,353,215,104,308,47,261
"2011","Liverpool 038D","E01006722","Total",608,191,28,163,115,54,119,16,103
"2011","Liverpool 038E","E01006723","Total",749,332,32,300,115,50,210,30,180
"2011","Liverpool 038F","E01006724","Total",554,162,21,141,83,33,99,20,79
"2011","Liverpool 039A","E01006552","Total",869,412,144,268,309,170,209,58,151
"2011","Liverpool 039B","E01006556","Total",1016,580,117,463,265,128,379,65,314
"2011","Liverpool 039C","E01006674","Total",826,476,134,342,264,134,356,83,273
"2011","Liverpool 039D","E01006679","Total",920,546,176,370,338,169,313,99,214
"2011","Liverpool 040A","E01006709","Total",685,320,38,282,165,62,270,32,238
"2011","Liverpool 040B","E01006769","Total",712,411,46,365,142,54,342,32,310
"2011","Liverpool 040C","E01006770","Total",445,202,31,171,135,56,169,36,133
"2011","Liverpool 040D","E01006771","Total",694,370,63,307,184,71,280,42,238
"2011","Liverpool 040E","E01006772","Total",480,199,16,183,119,38,174,24,150
"2011","Liverpool 040F","E01006775","Total",556,283,43,240,149,52,217,33,184
"2011","Liverpool 041A","E01006582","Total",585,148,7,141,225,69,116,28,88
"2011","Liverpool 041B","E01006589","Total",599,166,2,164,204,75,163,30,133
"2011","Liverpool 041C","E01006591","Total",671,174,16,158,185,69,150,28,122
"2011","Liverpool 041D","E01006592","Total",624,215,7,208,158,49,168,31,137
"2011","Liverpool 041E","E01006597","Total",683,206,12,194,184,68,159,28,131
"2011","Liverpool 042A","E01006553","Total",642,158,18,140,111,38,123,17,106
"2011","Liverpool 042C","E01006588","Total",702,196,13,183,118,50,186,21,165
"2011","Liverpool 042D","E01006590","Total",701,185,14,171,132,53,162,29,133
"2011","Liverpool 042E","E01006593","Total",662,159,11,148,143,70,131,14,117
"2011","Liverpool 042F","E01033749","Total",1039,868,7,861,26,12,43,8,35
"2011","Liverpool 042G","E01033766","Total",424,107,11,96,80,29,87,17,70
"2011","Liverpool 043A","E01006520","Total",1182,422,13,409,68,35,292,6,286
"2011","Liverpool 043B","E01006549","Total",949,342,15,327,80,38,244,12,232
"2011","Liverpool 043C","E01006675","Total",1132,424,29,395,101,49,290,19,271
"2011","Liverpool 043D","E01006677","Total",477,271,72,199,169,66,189,42,147
"2011","Liverpool 044A","E01006518","Total",835,443,71,372,194,72,333,55,278
"2011","Liverpool 044B","E01006630","Total",555,285,84,201,219,71,233,65,168
"2011","Liverpool 044C","E01006632","Total",884,434,96,338,247,105,331,70,261
"2011","Liverpool 044D","E01006676","Total",761,398,121,277,292,128,299,72,227
"2011","Liverpool 044E","E01006678","Total",1059,567,98,469,242,90,436,72,364
"2011","Liverpool 045A","E01006706","Total",582,307,67,240,185,50,256,59,197
"2011","Liverpool 045B","E01006707","Total",553,292,54,238,168,57,238,59,179
"2011","Liverpool 045C","E01006708","Total",754,299,51,248,238,88,245,52,193
"2011","Liverpool 045D","E01006710","Total",592,208,48,160,210,82,185,51,134
"2011","Liverpool 046A","E01006792","Total",557,212,6,206,147,48,154,16,138
"2011","Liverpool 046B","E01006794","Total",711,232,21,211,174,72,166,22,144
"2011","Liverpool 046C","E01006800","Total",679,320,7,313,115,44,204,19,185
"2011","Liverpool 046D","E01006801","Total",609,252,3,249,111,38,170,11,159
"2011","Liverpool 047A","E01006532","Total",617,207,6,201,182,47,165,26,139
"2011","Liverpool 047B","E01006539","Total",601,175,9,166,150,37,132,19,113
"2011","Liverpool 047C","E01006583","Total",467,139,6,133,153,53,91,14,77
"2011","Liverpool 047D","E01006594","Total",579,210,9,201,151,40,148,20,128
"2011","Liverpool 047E","E01006796","Total",581,178,8,170,188,53,156,27,129
"2011","Liverpool 048A","E01006522","Total",1094,367,47,320,107,48,283,28,255
"2011","Liverpool 048B","E01006524","Total",583,181,7,174,92,44,126,12,114
"2011","Liverpool 048C","E01006526","Total",654,222,13,209,138,61,171,23,148
"2011","Liverpool 048D","E01006529","Total",559,147,7,140,156,66,116,15,101
"2011","Liverpool 048E","E01006551","Total",751,461,22,439,54,21,339,16,323
"2011","Liverpool 048F","E01006554","Total",649,190,10,180,99,46,125,13,112
"2011","Liverpool 049A","E01006525","Total",486,146,8,138,129,50,137,14,123
"2011","Liverpool 049B","E01006595","Total",812,286,28,258,184,91,226,31,195
"2011","Liverpool 049C","E01006596","Total",597,183,9,174,149,45,154,24,130
"2011","Liverpool 049D","E01006689","Total",717,226,9,217,195,67,217,38,179
"2011","Liverpool 050B","E01006633","Total",699,415,67,348,190,71,324,53,271
"2011","Liverpool 050F","E01032505","Total",563,215,31,184,167,64,180,26,154
"2011","Liverpool 050G","E01032506","Total",656,243,35,208,146,68,192,27,165
"2011","Liverpool 050H","E01032507","Total",666,170,29,141,145,62,146,25,121
"2011","Liverpool 050I","E01033748","Total",772,127,22,105,66,48,71,7,64
"2011","Liverpool 050J","E01033767","Total",562,258,67,191,150,59,192,33,159
"2011","Liverpool 051A","E01006793","Total",759,331,35,296,155,74,245,15,230
"2011","Liverpool 051B","E01006795","Total",628,199,9,190,157,57,155,25,130
"2011","Liverpool 051C","E01006797","Total",707,312,34,278,179,66,263,51,212
"2011","Liverpool 051D","E01006798","Total",609,219,16,203,143,45,162,17,145
"2011","Liverpool 051E","E01006799","Total",1145,658,24,634,123,50,494,20,474
"2011","Liverpool 052A","E01006521","Total",928,395,24,371,112,44,290,21,269
"2011","Liverpool 052B","E01006523","Total",830,291,28,263,105,48,229,15,214
"2011","Liverpool 052C","E01006528","Total",613,172,14,158,148,68,132,20,112
"2011","Liverpool 052D","E01006628","Total",651,188,22,166,167,66,170,25,145
"2011","Liverpool 052E","E01006629","Total",573,214,17,197,118,38,189,24,165
"2011","Liverpool 053A","E01006527","Total",638,253,10,243,151,53,202,22,180
"2011","Liverpool 053B","E01006680","Total",605,197,8,189,184,59,172,27,145
"2011","Liverpool 053C","E01006682","Total",498,153,5,148,157,48,130,20,110
"2011","Liverpool 053D","E01006683","Total",594,190,6,184,182,58,164,31,133
"2011","Liverpool 053E","E01006686","Total",531,175,9,166,152,44,144,29,115
"2011","Liverpool 054A","E01006534","Total",649,252,36,216,202,47,222,52,170
"2011","Liverpool 054B","E01006535","Total",656,243,22,221,193,58,215,32,183
"2011","Liverpool 054C","E01006536","Total",815,334,42,292,229,68,289,50,239
"2011","Liverpool 054D","E01006681","Total",719,320,28,292,176,57,252,37,215
"2011","Liverpool 055A","E01006530","Total",616,249,11,238,151,52,177,18,159
"2011","Liverpool 055B","E01006531","Total",674,350,6,344,126,32,253,24,229
"2011","Liverpool 055C","E01006533","Total",614,273,17,256,132,47,220,24,196
"2011","Liverpool 055D","E01006537","Total",964,271,48,223,275,122,217,45,172
"2011","Liverpool 055E","E01006538","Total",527,178,17,161,168,41,153,29,124
"2011","Liverpool 056A","E01006519","Total",514,165,3,162,166,51,124,23,101
"2011","Liverpool 056B","E01006684","Total",999,249,17,232,249,103,192,30,162
"2011","Liverpool 056C","E01006685","Total",604,203,14,189,147,42,168,26,142
"2011","Liverpool 056D","E01006687","Total",933,333,16,317,205,100,248,29,219
"2011","Liverpool 056E","E01006688","Total",712,258,17,241,160,66,183,30,153
"2011","Liverpool 057A","E01006740","Total",604,342,85,257,173,60,266,57,209
"2011","Liverpool 057B","E01006742","Total",591,202,30,172,172,72,172,32,140
"2011","Liverpool 057C","E01006744","Total",739,264,46,218,190,93,200,31,169
"2011","Liverpool 057D","E01006745","Total",907,331,83,248,253,109,229,48,181
"2011","Liverpool 058A","E01006738","Total",662,296,74,222,218,90,246,49,197
"2011","Liverpool 058B","E01006739","Total",707,328,103,225,274,108,279,71,208
"2011","Liverpool 058C","E01006741","Total",778,352,71,281,245,83,287,54,233
"2011","Liverpool 058D","E01006743","Total",1008,333,73,260,318,137,293,67,226
"2011","Liverpool 059A","E01006753","Total",666,330,101,229,243,114,231,59,172
"2011","Liverpool 059B","E01006754","Total",781,395,74,321,225,92,302,50,252
"2011","Liverpool 059C","E01006755","Total",690,378,116,262,245,96,277,70,207
"2011","Liverpool 059D","E01006756","Total",757,361,117,244,313,143,240,61,179
"2011","Liverpool 059E","E01006757","Total",621,304,103,201,245,113,212,50,162
"2011","Liverpool 059F","E01006758","Total",639,288,89,199,235,110,246,57,189
"2011","Liverpool 060A","E01006513","Total",909,369,11,358,43,18,113,5,108
"2011","Liverpool 060B","E01033758","Total",475,264,10,254,34,9,82,6,76
"2011","Liverpool 060C","E01033760","Total",529,202,4,198,12,4,60,4,56
"2011","Liverpool 060D","E01033761","Total",832,188,5,183,17,11,51,3,48
"2011","Liverpool 060E","E01033762","Total",456,194,2,192,18,9,77,5,72
"2011","Liverpool 061A","E01033750","Total",905,157,12,145,62,42,78,6,72
"2011","Liverpool 061B","E01033754","Total",838,238,21,217,60,26,155,14,141
"2011","Liverpool 061C","E01033756","Total",733,214,11,203,28,18,45,2,43
"2011","Liverpool 061D","E01033765","Total",659,292,72,220,170,65,217,38,179
"2011","Liverpool 062A","E01033751","Total",603,180,29,151,69,22,127,23,104
"2011","Liverpool 062B","E01033752","Total",790,143,7,136,30,22,43,1,42
"2011","Liverpool 062C","E01033753","Total",714,133,10,123,24,19,29,2,27
"2011","Liverpool 062D","E01033755","Total",675,94,11,83,29,21,36,4,32
"2011","Sefton 001A","E01006946","Total",680,338,12,326,130,38,248,25,223
"2011","Sefton 001B","E01007028","Total",593,211,17,194,162,66,164,34,130
"2011","Sefton 001C","E01007029","Total",612,357,9,348,92,23,215,16,199
"2011","Sefton 001D","E01007030","Total",636,209,35,174,231,92,182,41,141
"2011","Sefton 001E","E01007036","Total",538,195,2,193,123,32,139,18,121
"2011","Sefton 002A","E01006947","Total",609,254,13,241,153,49,194,33,161
"2011","Sefton 002B","E01007031","Total",586,195,10,185,179,46,163,26,137
"2011","Sefton 002C","E01007032","Total",550,199,12,187,153,50,130,17,113
"2011","Sefton 002D","E01007033","Total",646,267,17,250,179,51,204,28,176
"2011","Sefton 002E","E01007035","Total",620,254,14,240,151,49,176,23,153
"2011","Sefton 003A","E01006944","Total",902,546,21,525,75,35,358,16,342
"2011","Sefton 003B","E01006948","Total",655,355,23,332,132,39,270,31,239
"2011","Sefton 003C","E01006949","Total",730,393,8,385,116,33,266,12,254
"2011","Sefton 003D","E01006951","Total",773,388,8,380,111,39,230,12,218
"2011","Sefton 003E","E01007034","Total",579,221,5,216,142,35,155,21,134
"2011","Sefton 004A","E01006945","Total",802,366,17,349,114,52,272,20,252
"2011","Sefton 004B","E01006950","Total",800,343,20,323,95,48,241,13,228
"2011","Sefton 004C","E01006968","Total",1052,499,36,463,152,86,382,27,355
"2011","Sefton 004D","E01006969","Total",667,224,22,202,188,81,181,31,150
"2011","Sefton 004F","E01033094","Total",565,244,14,230,78,46,170,3,167
"2011","Sefton 004G","E01033097","Total",600,264,13,251,95,61,216,20,196
"2011","Sefton 005A","E01007055","Total",580,233,66,167,237,93,184,51,133
"2011","Sefton 005B","E01007056","Total",672,166,22,144,244,106,164,36,128
"2011","Sefton 005C","E01007057","Total",656,211,36,175,209,93,146,32,114
"2011","Sefton 005D","E01007062","Total",597,168,11,157,189,58,154,29,125
"2011","Sefton 005E","E01007063","Total",635,195,27,168,226,76,174,47,127
"2011","Sefton 006A","E01007058","Total",630,182,30,152,186,82,152,33,119
"2011","Sefton 006B","E01007059","Total",608,176,26,150,212,82,147,28,119
"2011","Sefton 006C","E01007060","Total",590,204,34,170,193,87,192,40,152
"2011","Sefton 006D","E01007061","Total",567,129,25,104,227,87,133,47,86
"2011","Sefton 006E","E01007064","Total",473,118,8,110,165,54,102,25,77
"2011","Sefton 007A","E01006934","Total",648,197,23,174,195,66,208,39,169
"2011","Sefton 007B","E01006970","Total",770,281,36,245,178,88,214,30,184
"2011","Sefton 007C","E01006994","Total",649,202,50,152,226,112,190,42,148
"2011","Sefton 007D","E01006996","Total",645,215,31,184,192,76,195,30,165
"2011","Sefton 007E","E01006998","Total",699,209,37,172,252,115,189,43,146
"2011","Sefton 008A","E01006995","Total",488,135,9,126,172,53,151,38,113
"2011","Sefton 008B","E01006997","Total",613,147,25,122,211,89,137,32,105
"2011","Sefton 008C","E01006999","Total",685,256,26,230,203,70,202,41,161
"2011","Sefton 008D","E01007000","Total",517,168,30,138,179,68,143,33,110
"2011","Sefton 008E","E01007001","Total",670,192,36,156,241,111,175,38,137
"2011","Sefton 008F","E01007002","Total",585,228,13,215,139,43,183,22,161
"2011","Sefton 009A","E01006928","Total",583,201,8,193,188,50,153,31,122
"2011","Sefton 009B","E01006935","Total",688,225,10,215,215,73,195,40,155
"2011","Sefton 009C","E01006971","Total",807,433,6,427,93,28,268,17,251
"2011","Sefton 009D","E01006972","Total",907,576,11,565,100,28,331,14,317
"2011","Sefton 009E","E01006973","Total",643,328,17,311,130,41,178,14,164
"2011","Sefton 009F","E01006974","Total",681,261,10,251,158,35,163,15,148
"2011","Sefton 010A","E01006929","Total",616,163,19,144,204,74,153,27,126
"2011","Sefton 010B","E01006930","Total",620,207,24,183,196,73,184,31,153
"2011","Sefton 010C","E01006931","Total",642,198,9,189,195,57,173,26,147
"2011","Sefton 010D","E01006932","Total",592,186,7,179,174,46,148,23,125
"2011","Sefton 010E","E01006933","Total",595,178,28,150,207,84,186,45,141
"2011","Sefton 011A","E01006920","Total",699,293,21,272,207,69,219,31,188
"2011","Sefton 011B","E01006924","Total",681,344,41,303,188,79,253,37,216
"2011","Sefton 011C","E01006925","Total",598,208,36,172,200,72,173,40,133
"2011","Sefton 011D","E01006927","Total",755,337,25,312,193,63,262,36,226
"2011","Sefton 012A","E01006921","Total",596,301,6,295,103,27,190,22,168
"2011","Sefton 012B","E01006922","Total",605,262,4,258,121,35,146,21,125
"2011","Sefton 012C","E01006923","Total",682,354,5,349,108,34,211,13,198
"2011","Sefton 012D","E01006926","Total",717,328,9,319,133,30,220,31,189
"2011","Sefton 013A","E01006985","Total",599,221,6,215,170,47,149,24,125
"2011","Sefton 013B","E01006986","Total",515,231,5,226,103,30,136,12,124
"2011","Sefton 013C","E01006987","Total",540,245,9,236,115,39,131,12,119
"2011","Sefton 013D","E01006989","Total",557,259,6,253,114,33,147,15,132
"2011","Sefton 013E","E01006990","Total",477,163,3,160,136,38,123,19,104
"2011","Sefton 014A","E01006988","Total",625,287,13,274,128,50,203,17,186
"2011","Sefton 014B","E01007079","Total",650,267,14,253,185,55,159,22,137
"2011","Sefton 014C","E01007080","Total",612,233,16,217,164,66,164,27,137
"2011","Sefton 014D","E01007081","Total",722,349,3,346,140,55,235,14,221
"2011","Sefton 015A","E01006991","Total",603,269,9,260,162,36,155,33,122
"2011","Sefton 015B","E01006992","Total",444,171,5,166,127,36,135,21,114
"2011","Sefton 015C","E01006993","Total",586,220,5,215,163,50,145,25,120
"2011","Sefton 015D","E01007078","Total",646,280,5,275,177,52,177,31,146
"2011","Sefton 016A","E01007075","Total",615,267,12,255,145,41,169,27,142
"2011","Sefton 016B","E01007076","Total",575,231,11,220,165,53,166,28,138
"2011","Sefton 016C","E01007077","Total",593,197,11,186,201,60,154,30,124
"2011","Sefton 016D","E01007082","Total",614,226,13,213,167,64,193,34,159
"2011","Sefton 017A","E01007067","Total",591,183,10,173,140,43,150,16,134
"2011","Sefton 017B","E01007068","Total",481,122,7,115,150,46,113,23,90
"2011","Sefton 017C","E01007069","Total",660,279,18,261,156,56,220,31,189
"2011","Sefton 017D","E01007070","Total",602,231,5,226,140,39,181,21,160
"2011","Sefton 017E","E01007101","Total",608,261,2,259,133,37,165,20,145
"2011","Sefton 018C","E01007095","Total",706,316,7,309,169,51,235,24,211
"2011","Sefton 018D","E01007096","Total",567,229,4,225,127,26,153,23,130
"2011","Sefton 018E","E01007100","Total",593,209,6,203,166,62,159,23,136
"2011","Sefton 018F","E01033096","Total",989,351,12,339,268,78,280,36,244
"2011","Sefton 019A","E01007074","Total",622,235,23,212,202,49,211,35,176
"2011","Sefton 019B","E01007097","Total",654,260,8,252,166,46,178,19,159
"2011","Sefton 019C","E01007098","Total",624,251,10,241,131,39,175,17,158
"2011","Sefton 019D","E01007099","Total",655,319,7,312,124,31,241,19,222
"2011","Sefton 020A","E01007065","Total",501,118,11,107,167,66,134,21,113
"2011","Sefton 020B","E01007066","Total",601,176,24,152,204,72,156,30,126
"2011","Sefton 020C","E01007071","Total",503,184,4,180,134,37,147,15,132
"2011","Sefton 020D","E01007072","Total",685,379,6,373,103,21,242,15,227
"2011","Sefton 020E","E01007073","Total",499,143,4,139,160,48,132,20,112
"2011","Sefton 021A","E01007020","Total",580,214,20,194,187,56,195,33,162
"2011","Sefton 021B","E01007022","Total",597,238,18,220,142,57,216,32,184
"2011","Sefton 021C","E01007023","Total",529,160,1,159,141,41,133,24,109
"2011","Sefton 021D","E01007027","Total",892,311,9,302,191,51,223,27,196
"2011","Sefton 021E","E01007037","Total",656,268,11,257,144,28,207,20,187
"2011","Sefton 021F","E01007038","Total",611,253,33,220,166,61,185,27,158
"2011","Sefton 022A","E01006936","Total",765,338,9,329,106,29,190,15,175
"2011","Sefton 022B","E01006937","Total",482,129,3,126,167,51,110,17,93
"2011","Sefton 022C","E01006938","Total",535,239,7,232,98,24,134,15,119
"2011","Sefton 022D","E01006939","Total",663,226,18,208,185,74,192,38,154
"2011","Sefton 022E","E01006940","Total",599,221,6,215,140,41,165,21,144
"2011","Sefton 022F","E01006943","Total",479,156,5,151,141,37,105,17,88
"2011","Sefton 023A","E01007083","Total",476,178,19,159,145,50,153,28,125
"2011","Sefton 023B","E01007085","Total",580,292,66,226,191,73,203,48,155
"2011","Sefton 023C","E01007086","Total",501,235,41,194,144,58,186,30,156
"2011","Sefton 023D","E01007091","Total",607,278,24,254,136,39,226,31,195
"2011","Sefton 023E","E01007092","Total",459,214,27,187,124,52,170,26,144
"2011","Sefton 024A","E01006979","Total",619,319,84,235,216,80,223,48,175
"2011","Sefton 024B","E01006980","Total",656,325,87,238,245,96,260,57,203
"2011","Sefton 024C","E01007024","Total",478,206,40,166,142,55,184,45,139
"2011","Sefton 024D","E01007026","Total",515,254,34,220,137,47,201,31,170
"2011","Sefton 024E","E01007089","Total",603,292,59,233,185,64,227,53,174
"2011","Sefton 025A","E01007021","Total",541,212,3,209,119,27,163,15,148
"2011","Sefton 025B","E01007025","Total",534,199,6,193,151,35,139,15,124
"2011","Sefton 025C","E01007105","Total",709,259,22,237,228,75,212,31,181
"2011","Sefton 025D","E01007106","Total",630,225,13,212,186,60,213,36,177
"2011","Sefton 025E","E01007107","Total",485,142,8,134,179,55,121,37,84
"2011","Sefton 025F","E01007108","Total",599,150,12,138,218,61,156,36,120
"2011","Sefton 026A","E01007039","Total",512,155,17,138,175,70,120,22,98
"2011","Sefton 026B","E01007040","Total",747,196,21,175,255,93,214,51,163
"2011","Sefton 026C","E01007042","Total",546,216,13,203,140,50,184,26,158
"2011","Sefton 026D","E01007044","Total",621,322,4,318,110,32,221,19,202
"2011","Sefton 026E","E01007045","Total",486,174,11,163,134,40,135,22,113
"2011","Sefton 027A","E01007041","Total",570,198,22,176,178,55,174,36,138
"2011","Sefton 027B","E01007043","Total",611,263,11,252,123,39,209,29,180
"2011","Sefton 027C","E01007046","Total",637,201,23,178,214,80,191,45,146
"2011","Sefton 027D","E01007053","Total",556,180,16,164,187,61,179,42,137
"2011","Sefton 027E","E01007084","Total",539,115,6,109,180,60,107,18,89
"2011","Sefton 028A","E01006941","Total",696,267,25,242,187,67,206,36,170
"2011","Sefton 028B","E01006942","Total",640,175,20,155,188,63,164,28,136
"2011","Sefton 028C","E01006954","Total",680,256,19,237,157,49,212,30,182
"2011","Sefton 028D","E01007104","Total",563,159,10,149,167,70,154,32,122
"2011","Sefton 028E","E01007109","Total",675,230,22,208,206,80,192,29,163
"2011","Sefton 029A","E01007048","Total",635,246,77,169,275,122,204,66,138
"2011","Sefton 029B","E01007054","Total",613,283,42,241,151,57,217,29,188
"2011","Sefton 029C","E01007087","Total",614,295,47,248,162,61,223,31,192
"2011","Sefton 029D","E01007088","Total",575,223,32,191,175,61,206,36,170
"2011","Sefton 029E","E01007090","Total",543,263,45,218,155,75,220,37,183
"2011","Sefton 030A","E01006955","Total",621,142,23,119,227,86,147,39,108
"2011","Sefton 030B","E01006956","Total",679,198,28,170,195,86,174,37,137
"2011","Sefton 030C","E01006958","Total",718,270,21,249,165,72,241,28,213
"2011","Sefton 030D","E01007102","Total",579,148,21,127,208,82,157,39,118
"2011","Sefton 030E","E01007103","Total",614,203,7,196,162,54,164,23,141
"2011","Sefton 031A","E01006978","Total",569,172,15,157,170,45,162,23,139
"2011","Sefton 031B","E01006981","Total",618,284,65,219,197,89,222,44,178
"2011","Sefton 031C","E01006982","Total",557,198,21,177,165,60,186,34,152
"2011","Sefton 031D","E01006983","Total",686,204,28,176,232,90,177,47,130
"2011","Sefton 031E","E01006984","Total",498,221,97,124,242,99,165,59,106
"2011","Sefton 032A","E01006952","Total",627,285,31,254,171,72,236,42,194
"2011","Sefton 032B","E01006953","Total",666,278,44,234,187,76,229,44,185
"2011","Sefton 032C","E01006957","Total",857,400,32,368,122,52,347,22,325
"2011","Sefton 032D","E01006959","Total",666,234,26,208,169,74,186,33,153
"2011","Sefton 032E","E01006977","Total",880,519,36,483,173,64,420,39,381
"2011","Sefton 033A","E01006976","Total",594,177,21,156,198,76,160,28,132
"2011","Sefton 033B","E01007014","Total",650,239,17,222,195,67,202,34,168
"2011","Sefton 033E","E01007047","Total",655,289,28,261,184,71,237,39,198
"2011","Sefton 033F","E01033095","Total",747,273,22,251,226,72,199,35,164
"2011","Sefton 034A","E01007004","Total",654,317,73,244,215,92,231,43,188
"2011","Sefton 034B","E01007005","Total",602,309,101,208,212,93,221,60,161
"2011","Sefton 034C","E01007011","Total",666,339,64,275,189,66,285,60,225
"2011","Sefton 034D","E01007016","Total",738,287,93,194,266,109,229,68,161
"2011","Sefton 034E","E01007017","Total",746,344,64,280,229,105,246,45,201
"2011","Sefton 035A","E01007019","Total",530,255,91,164,225,100,195,53,142
"2011","Sefton 035B","E01007049","Total",652,272,25,247,188,71,244,43,201
"2011","Sefton 035C","E01007050","Total",488,164,18,146,166,62,153,41,112
"2011","Sefton 035D","E01007051","Total",509,234,55,179,163,64,203,51,152
"2011","Sefton 035E","E01007052","Total",548,226,68,158,210,81,193,55,138
"2011","Sefton 036A","E01006964","Total",645,240,54,186,212,86,207,54,153
"2011","Sefton 036B","E01007003","Total",568,283,75,208,190,91,188,42,146
"2011","Sefton 036C","E01007006","Total",605,299,81,218,211,92,217,49,168
"2011","Sefton 036D","E01007012","Total",600,205,46,159,189,96,175,45,130
"2011","Sefton 036E","E01007013","Total",684,290,59,231,196,93,226,32,194
"2011","Sefton 037A","E01006967","Total",753,372,47,325,158,58,306,44,262
"2011","Sefton 037B","E01007007","Total",635,355,54,301,146,59,271,42,229
"2011","Sefton 037C","E01007008","Total",644,325,64,261,177,93,250,44,206
"2011","Sefton 037D","E01007009","Total",654,313,31,282,91,43,273,28,245
"2011","Sefton 037E","E01007010","Total",519,271,63,208,165,84,193,37,156
"2011","Sefton 038A","E01006960","Total",445,148,14,134,122,31,130,18,112
"2011","Sefton 038B","E01006961","Total",632,248,56,192,198,87,191,39,152
"2011","Sefton 038C","E01006962","Total",647,276,22,254,156,67,211,22,189
"2011","Sefton 038D","E01006963","Total",633,292,97,195,227,116,216,57,159
"2011","Sefton 038E","E01006965","Total",580,247,73,174,215,80,207,58,149
"2011","Sefton 038F","E01006966","Total",640,213,31,182,204,80,204,37,167
"2011","St. Helens 001A","E01006882","Total",499,205,4,201,131,30,128,25,103
"2011","St. Helens 001B","E01006883","Total",607,262,11,251,131,40,192,23,169
"2011","St. Helens 001C","E01006884","Total",623,273,12,261,134,40,194,23,171
"2011","St. Helens 001D","E01006885","Total",546,202,8,194,123,41,160,18,142
"2011","St. Helens 001E","E01006886","Total",578,241,0,241,130,36,163,22,141
"2011","St. Helens 001F","E01006887","Total",592,220,21,199,164,60,173,34,139
"2011","St. Helens 002A","E01006802","Total",747,310,27,283,177,56,241,34,207
"2011","St. Helens 002B","E01006804","Total",660,268,26,242,181,59,186,36,150
"2011","St. Helens 002C","E01006806","Total",623,237,5,232,157,41,146,19,127
"2011","St. Helens 002D","E01006807","Total",587,243,4,239,131,42,151,15,136
"2011","St. Helens 003A","E01006803","Total",601,198,4,194,151,49,170,20,150
"2011","St. Helens 003B","E01006805","Total",620,207,29,178,214,85,185,42,143
"2011","St. Helens 003C","E01006808","Total",539,143,10,133,146,45,137,21,116
"2011","St. Helens 003D","E01006809","Total",608,219,7,212,154,48,156,21,135
"2011","St. Helens 004A","E01006849","Total",648,327,67,260,207,74,238,45,193
"2011","St. Helens 004B","E01006850","Total",738,410,63,347,185,65,294,43,251
"2011","St. Helens 004C","E01006851","Total",559,231,20,211,136,42,177,21,156
"2011","St. Helens 004D","E01006852","Total",525,148,9,139,157,57,138,19,119
"2011","St. Helens 004E","E01006853","Total",577,170,8,162,157,48,157,32,125
"2011","St. Helens 004F","E01006854","Total",640,212,31,181,186,75,198,41,157
"2011","St. Helens 004G","E01006855","Total",638,279,50,229,174,79,202,38,164
"2011","St. Helens 005A","E01006836","Total",600,262,31,231,167,67,206,37,169
"2011","St. Helens 005B","E01006839","Total",572,193,17,176,138,39,190,30,160
"2011","St. Helens 005C","E01006840","Total",669,232,17,215,150,65,217,35,182
"2011","St. Helens 005D","E01006842","Total",657,274,63,211,240,101,205,51,154
"2011","St. Helens 006A","E01006837","Total",614,212,27,185,204,84,181,37,144
"2011","St. Helens 006B","E01006838","Total",718,318,21,297,157,74,264,24,240
"2011","St. Helens 006C","E01006841","Total",645,181,10,171,245,65,144,23,121
"2011","St. Helens 006D","E01006843","Total",543,242,28,214,148,62,164,27,137
"2011","St. Helens 007A","E01006914","Total",527,206,5,201,136,45,133,22,111
"2011","St. Helens 007B","E01006915","Total",671,281,30,251,186,63,236,39,197
"2011","St. Helens 007C","E01006916","Total",660,216,22,194,186,72,180,30,150
"2011","St. Helens 007D","E01006917","Total",674,230,9,221,221,66,161,20,141
"2011","St. Helens 007E","E01006918","Total",511,135,10,125,174,54,112,29,83
"2011","St. Helens 007F","E01006919","Total",643,294,93,201,256,110,215,44,171
"2011","St. Helens 008A","E01006810","Total",493,150,2,148,153,43,148,33,115
"2011","St. Helens 008B","E01006811","Total",613,257,20,237,131,48,199,22,177
"2011","St. Helens 008C","E01006812","Total",593,249,75,174,236,92,202,47,155
"2011","St. Helens 008D","E01006813","Total",697,285,37,248,188,77,252,33,219
"2011","St. Helens 008E","E01006814","Total",602,156,17,139,189,62,151,23,128
"2011","St. Helens 008F","E01006815","Total",557,230,29,201,159,52,193,28,165
"2011","St. Helens 008G","E01006818","Total",530,134,10,124,134,50,151,21,130
"2011","St. Helens 009A","E01006822","Total",559,184,9,175,174,37,145,25,120
"2011","St. Helens 009B","E01006823","Total",570,309,3,306,117,36,186,21,165
"2011","St. Helens 009C","E01006824","Total",517,191,7,184,147,48,127,12,115
"2011","St. Helens 009D","E01006825","Total",607,238,5,233,158,50,137,18,119
"2011","St. Helens 010A","E01006866","Total",642,281,70,211,229,102,224,52,172
"2011","St. Helens 010B","E01006867","Total",784,164,21,143,309,129,149,34,115
"2011","St. Helens 010C","E01006868","Total",656,273,45,228,200,88,199,38,161
"2011","St. Helens 010D","E01006869","Total",655,265,47,218,191,71,218,42,176
"2011","St. Helens 011A","E01006819","Total",608,207,44,163,195,87,177,34,143
"2011","St. Helens 011B","E01006820","Total",611,282,87,195,219,102,208,54,154
"2011","St. Helens 011C","E01006821","Total",652,331,83,248,201,101,255,40,215
"2011","St. Helens 011D","E01006871","Total",669,321,79,242,220,91,245,41,204
"2011","St. Helens 012A","E01006832","Total",781,239,47,192,247,106,195,51,144
"2011","St. Helens 012B","E01006834","Total",610,248,49,199,141,76,202,37,165
"2011","St. Helens 012C","E01006877","Total",734,378,35,343,119,46,285,26,259
"2011","St. Helens 012D","E01006880","Total",763,383,69,314,186,73,289,36,253
"2011","St. Helens 012E","E01006881","Total",735,349,52,297,164,65,254,33,221
"2011","St. Helens 013A","E01006863","Total",829,366,44,322,210,89,298,40,258
"2011","St. Helens 013B","E01006864","Total",818,202,22,180,239,110,162,34,128
"2011","St. Helens 013C","E01006865","Total",840,428,69,359,234,114,319,46,273
"2011","St. Helens 014A","E01006845","Total",685,270,45,225,197,80,201,31,170
"2011","St. Helens 014B","E01006870","Total",648,263,48,215,174,79,212,45,167
"2011","St. Helens 014C","E01006872","Total",777,366,50,316,141,54,285,33,252
"2011","St. Helens 014D","E01006873","Total",495,282,79,203,181,74,194,39,155
"2011","St. Helens 014E","E01006874","Total",583,330,87,243,181,89,235,40,195
"2011","St. Helens 015A","E01006856","Total",614,157,10,147,172,70,136,28,108
"2011","St. Helens 015B","E01006857","Total",606,202,8,194,159,56,143,25,118
"2011","St. Helens 015C","E01006858","Total",597,217,59,158,226,100,168,42,126
"2011","St. Helens 015D","E01006859","Total",694,205,8,197,206,64,161,33,128
"2011","St. Helens 015E","E01006860","Total",625,208,37,171,174,68,193,40,153
"2011","St. Helens 015F","E01006861","Total",631,286,101,185,261,121,213,59,154
"2011","St. Helens 015G","E01006862","Total",581,254,44,210,171,63,185,31,154
"2011","St. Helens 016A","E01006831","Total",662,212,26,186,194,87,173,31,142
"2011","St. Helens 016B","E01006833","Total",754,233,26,207,210,85,209,31,178
"2011","St. Helens 016C","E01006835","Total",647,240,20,220,151,57,171,18,153
"2011","St. Helens 016D","E01006876","Total",679,253,37,216,175,56,206,36,170
"2011","St. Helens 016E","E01006878","Total",648,221,24,197,156,55,189,32,157
"2011","St. Helens 016F","E01006879","Total",598,244,56,188,237,72,202,55,147
"2011","St. Helens 016G","E01006904","Total",670,252,49,203,230,78,198,41,157
"2011","St. Helens 017A","E01006816","Total",706,295,98,197,259,101,237,52,185
"2011","St. Helens 017B","E01006817","Total",623,327,67,260,176,79,225,31,194
"2011","St. Helens 017C","E01006875","Total",509,237,75,162,191,77,191,54,137
"2011","St. Helens 017D","E01006899","Total",813,296,79,217,301,149,239,61,178
"2011","St. Helens 018A","E01006826","Total",648,342,22,320,127,37,257,30,227
"2011","St. Helens 018B","E01006827","Total",614,154,13,141,244,66,136,34,102
"2011","St. Helens 018C","E01006828","Total",877,330,16,314,237,60,241,30,211
"2011","St. Helens 018D","E01006829","Total",518,171,6,165,131,45,148,14,134
"2011","St. Helens 019A","E01006830","Total",538,262,67,195,197,89,222,56,166
"2011","St. Helens 019C","E01006903","Total",752,379,53,326,178,78,291,33,258
"2011","St. Helens 019D","E01006905","Total",584,262,56,206,161,62,209,41,168
"2011","St. Helens 019E","E01006906","Total",661,217,42,175,203,86,176,22,154
"2011","St. Helens 019F","E01006907","Total",668,258,44,214,202,73,208,33,175
"2011","St. Helens 019G","E01006912","Total",613,240,79,161,239,110,151,43,108
"2011","St. Helens 019H","E01006913","Total",525,233,54,179,183,69,170,36,134
"2011","St. Helens 019I","E01032904","Total",688,182,21,161,292,115,152,37,115
"2011","St. Helens 019J","E01032905","Total",671,238,12,226,211,91,196,25,171
"2011","St. Helens 020A","E01006844","Total",771,347,65,282,226,92,250,38,212
"2011","St. Helens 020B","E01006846","Total",616,237,11,226,147,60,188,23,165
"2011","St. Helens 020C","E01006847","Total",685,284,105,179,280,99,200,55,145
"2011","St. Helens 020D","E01006848","Total",629,225,18,207,150,59,192,28,164
"2011","St. Helens 020E","E01006896","Total",660,250,18,232,147,53,205,22,183
"2011","St. Helens 020F","E01006897","Total",629,204,18,186,155,37,198,28,170
"2011","St. Helens 020G","E01006901","Total",533,134,18,116,164,48,117,35,82
"2011","St. Helens 021A","E01006890","Total",616,207,18,189,189,66,164,35,129
"2011","St. Helens 021B","E01006892","Total",482,178,8,170,127,42,129,10,119
"2011","St. Helens 021C","E01006893","Total",617,222,22,200,168,65,202,34,168
"2011","St. Helens 021D","E01006894","Total",584,253,7,246,132,36,182,19,163
"2011","St. Helens 022A","E01006898","Total",744,350,40,310,184,67,247,29,218
"2011","St. Helens 022B","E01006900","Total",1066,203,40,163,436,189,202,59,143
"2011","St. Helens 022C","E01006908","Total",604,277,72,205,196,91,198,34,164
"2011","St. Helens 022D","E01006909","Total",497,256,106,150,224,110,173,46,127
"2011","St. Helens 022E","E01006910","Total",749,269,59,210,238,98,226,55,171
"2011","St. Helens 022F","E01006911","Total",616,218,7,211,147,41,183,23,160
"2011","St. Helens 023A","E01006888","Total",499,208,7,201,115,34,149,13,136
"2011","St. Helens 023B","E01006889","Total",570,174,8,166,182,47,138,22,116
"2011","St. Helens 023C","E01006891","Total",538,205,11,194,173,41,163,30,133
"2011","St. Helens 023D","E01006895","Total",645,319,6,313,97,23,173,13,160
"2011","Wirral 001A","E01007229","Total",699,220,42,178,235,95,178,40,138
"2011","Wirral 001B","E01007230","Total",566,219,27,192,142,44,167,24,143
"2011","Wirral 001C","E01007231","Total",728,246,17,229,167,67,208,25,183
"2011","Wirral 001D","E01007237","Total",866,456,33,423,130,59,314,34,280
"2011","Wirral 001E","E01007238","Total",873,425,49,376,153,69,342,28,314
"2011","Wirral 002A","E01007218","Total",654,223,52,171,217,88,195,44,151
"2011","Wirral 002B","E01007232","Total",619,221,29,192,168,67,175,31,144
"2011","Wirral 002C","E01007233","Total",765,300,37,263,229,105,246,37,209
"2011","Wirral 002D","E01007234","Total",715,253,33,220,196,67,236,45,191
"2011","Wirral 002E","E01007236","Total",593,220,31,189,192,62,173,31,142
"2011","Wirral 003A","E01007307","Total",700,197,18,179,197,62,168,30,138
"2011","Wirral 003B","E01007308","Total",731,308,13,295,131,43,209,20,189
"2011","Wirral 003C","E01007312","Total",662,279,20,259,166,56,216,36,180
"2011","Wirral 003D","E01007313","Total",761,332,22,310,164,51,261,33,228
"2011","Wirral 003E","E01007315","Total",611,196,14,182,204,65,174,35,139
"2011","Wirral 004A","E01007211","Total",502,181,13,168,136,35,135,22,113
"2011","Wirral 004B","E01007235","Total",607,206,28,178,201,77,180,43,137
"2011","Wirral 004C","E01007310","Total",528,170,15,155,172,48,132,21,111
"2011","Wirral 004D","E01007311","Total",616,232,6,226,145,45,183,22,161
"2011","Wirral 004E","E01007314","Total",605,172,18,154,205,73,181,37,144
"2011","Wirral 004F","E01007316","Total",598,198,19,179,179,57,145,28,117
"2011","Wirral 005A","E01007215","Total",784,412,68,344,201,82,295,38,257
"2011","Wirral 005B","E01007216","Total",661,234,50,184,230,104,216,56,160
"2011","Wirral 005C","E01007219","Total",628,225,31,194,199,73,214,48,166
"2011","Wirral 005D","E01007220","Total",548,243,64,179,190,95,198,45,153
"2011","Wirral 005E","E01007275","Total",680,246,64,182,224,100,204,39,165
"2011","Wirral 006A","E01007203","Total",860,202,25,177,252,105,197,38,159
"2011","Wirral 006B","E01007205","Total",619,249,41,208,210,78,211,52,159
"2011","Wirral 006C","E01007210","Total",869,339,78,261,266,115,301,72,229
"2011","Wirral 006D","E01007309","Total",621,220,11,209,184,53,169,28,141
"2011","Wirral 007A","E01007212","Total",618,230,23,207,169,56,194,28,166
"2011","Wirral 007B","E01007213","Total",648,228,18,210,171,61,175,35,140
"2011","Wirral 007C","E01007214","Total",691,301,32,269,172,69,252,30,222
"2011","Wirral 007D","E01007217","Total",790,309,59,250,211,103,245,29,216
"2011","Wirral 007E","E01007276","Total",605,199,45,154,229,94,183,55,128
"2011","Wirral 008A","E01007272","Total",605,265,71,194,210,92,202,46,156
"2011","Wirral 008B","E01007273","Total",667,359,96,263,220,102,257,55,202
"2011","Wirral 008C","E01007274","Total",670,380,118,262,231,84,313,70,243
"2011","Wirral 008D","E01007277","Total",648,293,75,218,215,77,248,60,188
"2011","Wirral 008E","E01007278","Total",658,316,78,238,218,103,231,49,182
"2011","Wirral 009A","E01007204","Total",677,356,142,214,303,127,275,98,177
"2011","Wirral 009B","E01007206","Total",730,197,36,161,266,123,192,48,144
"2011","Wirral 009C","E01007207","Total",685,431,68,363,162,59,338,39,299
"2011","Wirral 009D","E01007209","Total",685,420,34,386,129,49,330,39,291
"2011","Wirral 010C","E01007269","Total",815,338,104,234,270,107,284,79,205
"2011","Wirral 010D","E01007270","Total",778,324,73,251,254,114,261,61,200
"2011","Wirral 010E","E01007271","Total",745,294,68,226,254,106,247,59,188
"2011","Wirral 010F","E01032903","Total",1081,495,160,335,373,151,380,89,291
"2011","Wirral 011A","E01007120","Total",543,213,70,143,225,96,163,55,108
"2011","Wirral 011B","E01007121","Total",686,347,97,250,217,95,260,60,200
"2011","Wirral 011C","E01007122","Total",720,471,121,350,205,105,323,62,261
"2011","Wirral 011D","E01007123","Total",733,355,160,195,344,161,231,82,149
"2011","Wirral 011E","E01007124","Total",614,325,103,222,250,102,258,54,204
"2011","Wirral 012A","E01007208","Total",734,291,40,251,210,92,263,43,220
"2011","Wirral 012B","E01007221","Total",651,240,23,217,172,59,200,34,166
"2011","Wirral 012C","E01007225","Total",771,326,17,309,190,66,246,27,219
"2011","Wirral 012D","E01007227","Total",645,312,56,256,186,70,265,38,227
"2011","Wirral 012E","E01007228","Total",706,399,42,357,149,64,302,33,269
"2011","Wirral 013A","E01007195","Total",647,213,13,200,202,58,173,39,134
"2011","Wirral 013B","E01007199","Total",602,196,6,190,185,55,147,22,125
"2011","Wirral 013C","E01007222","Total",707,208,11,197,209,69,178,32,146
"2011","Wirral 013D","E01007223","Total",556,91,18,73,212,90,111,29,82
"2011","Wirral 014A","E01007193","Total",740,309,16,293,158,50,197,26,171
"2011","Wirral 014B","E01007194","Total",668,222,14,208,161,62,174,15,159
"2011","Wirral 014C","E01007200","Total",655,200,9,191,219,60,171,22,149
"2011","Wirral 014D","E01007201","Total",640,232,13,219,185,61,178,24,154
"2011","Wirral 014E","E01007202","Total",623,229,19,210,170,50,183,30,153
"2011","Wirral 015A","E01007125","Total",784,313,66,247,251,122,256,55,201
"2011","Wirral 015B","E01007156","Total",660,230,15,215,140,51,192,24,168
"2011","Wirral 015C","E01007157","Total",601,171,24,147,215,90,172,41,131
"2011","Wirral 015D","E01007158","Total",684,240,10,230,165,46,194,27,167
"2011","Wirral 015E","E01007159","Total",721,222,17,205,225,85,167,31,136
"2011","Wirral 016A","E01007126","Total",1170,578,82,496,186,95,398,50,348
"2011","Wirral 016B","E01007127","Total",670,367,135,232,263,123,275,70,205
"2011","Wirral 016C","E01007128","Total",926,564,77,487,188,69,424,52,372
"2011","Wirral 016D","E01007129","Total",761,381,79,302,201,86,296,50,246
"2011","Wirral 016E","E01007133","Total",679,473,52,421,111,45,340,33,307
"2011","Wirral 017A","E01007224","Total",610,188,8,180,171,47,143,20,123
"2011","Wirral 017B","E01007226","Total",746,312,18,294,171,49,240,32,208
"2011","Wirral 017C","E01007265","Total",531,151,14,137,194,57,154,37,117
"2011","Wirral 017D","E01007299","Total",589,189,11,178,160,55,170,32,138
"2011","Wirral 017E","E01007306","Total",726,222,15,207,191,79,185,35,150
"2011","Wirral 018A","E01007297","Total",618,316,43,273,191,86,222,43,179
"2011","Wirral 018B","E01007298","Total",598,226,6,220,155,42,162,18,144
"2011","Wirral 018C","E01007301","Total",707,262,22,240,208,82,206,29,177
"2011","Wirral 018D","E01007302","Total",711,293,35,258,164,57,255,43,212
"2011","Wirral 018E","E01007305","Total",734,253,13,240,179,56,223,28,195
"2011","Wirral 019A","E01007119","Total",614,291,70,221,205,70,226,55,171
"2011","Wirral 019B","E01007161","Total",646,264,17,247,175,55,192,39,153
"2011","Wirral 019C","E01007162","Total",556,245,83,162,242,77,180,53,127
"2011","Wirral 019D","E01007300","Total",794,324,66,258,283,114,269,62,207
"2011","Wirral 020A","E01007155","Total",919,431,33,398,145,59,338,27,311
"2011","Wirral 020B","E01007160","Total",822,288,22,266,188,67,217,27,190
"2011","Wirral 020C","E01007240","Total",861,331,16,315,126,44,260,18,242
"2011","Wirral 020D","E01007241","Total",703,315,4,311,116,37,217,12,205
"2011","Wirral 020E","E01007242","Total",864,340,10,330,148,40,241,20,221
"2011","Wirral 021A","E01007130","Total",716,249,73,176,278,146,209,46,163
"2011","Wirral 021B","E01007131","Total",724,334,99,235,258,138,271,60,211
"2011","Wirral 021C","E01007179","Total",612,272,78,194,185,90,204,40,164
"2011","Wirral 021D","E01007291","Total",917,463,95,368,241,120,304,53,251
"2011","Wirral 021E","E01007292","Total",679,329,100,229,237,111,263,57,206
"2011","Wirral 021F","E01007294","Total",673,236,78,158,261,135,182,34,148
"2011","Wirral 022A","E01007180","Total",685,276,30,246,164,53,240,36,204
"2011","Wirral 022B","E01007181","Total",640,198,39,159,196,91,175,33,142
"2011","Wirral 022C","E01007239","Total",781,276,68,208,232,99,238,52,186
"2011","Wirral 022D","E01007243","Total",824,337,16,321,159,51,236,28,208
"2011","Wirral 022E","E01007244","Total",913,294,85,209,331,159,243,82,161
"2011","Wirral 023A","E01007259","Total",496,163,4,159,140,36,128,15,113
"2011","Wirral 023B","E01007261","Total",615,273,11,262,123,31,195,21,174
"2011","Wirral 023C","E01007264","Total",656,247,4,243,137,53,163,15,148
"2011","Wirral 023D","E01007266","Total",617,219,9,210,179,55,165,19,146
"2011","Wirral 023E","E01007267","Total",622,213,6,207,172,41,173,35,138
"2011","Wirral 023F","E01007268","Total",581,261,13,248,122,40,167,20,147
"2011","Wirral 024A","E01007163","Total",907,248,45,203,333,140,226,52,174
"2011","Wirral 024B","E01007245","Total",639,230,16,214,166,56,167,21,146
"2011","Wirral 024C","E01007246","Total",592,164,11,153,192,66,154,32,122
"2011","Wirral 024D","E01007247","Total",658,161,14,147,239,91,150,35,115
"2011","Wirral 024E","E01007252","Total",655,217,17,200,179,73,192,26,166
"2011","Wirral 025A","E01007249","Total",592,265,51,214,194,75,219,38,181
"2011","Wirral 025B","E01007251","Total",542,196,7,189,120,45,171,28,143
"2011","Wirral 025C","E01007257","Total",626,295,52,243,185,67,264,35,229
"2011","Wirral 025D","E01007303","Total",700,373,62,311,182,75,319,48,271
"2011","Wirral 025E","E01007304","Total",641,298,85,213,245,87,232,61,171
"2011","Wirral 026A","E01007196","Total",749,368,11,357,171,59,236,20,216
"2011","Wirral 026B","E01007197","Total",662,226,14,212,217,77,167,32,135
"2011","Wirral 026C","E01007198","Total",836,349,15,334,191,65,254,20,234
"2011","Wirral 026D","E01007263","Total",627,299,29,270,165,46,239,47,192
"2011","Wirral 026E","E01007282","Total",665,253,15,238,176,74,162,21,141
"2011","Wirral 027A","E01007175","Total",844,392,81,311,242,92,314,51,263
"2011","Wirral 027B","E01007290","Total",835,420,79,341,228,108,342,58,284
"2011","Wirral 027C","E01007293","Total",713,431,115,316,243,98,354,77,277
"2011","Wirral 027D","E01007295","Total",522,233,70,163,181,80,156,47,109
"2011","Wirral 027E","E01007296","Total",813,361,90,271,277,150,256,43,213
"2011","Wirral 028A","E01007258","Total",624,213,15,198,158,55,136,20,116
"2011","Wirral 028B","E01007260","Total",643,245,10,235,192,48,180,29,151
"2011","Wirral 028C","E01007262","Total",637,250,6,244,171,40,164,24,140
"2011","Wirral 028D","E01007281","Total",594,269,3,266,140,52,174,18,156
"2011","Wirral 028E","E01007283","Total",492,190,5,185,127,31,105,22,83
"2011","Wirral 029A","E01007173","Total",590,206,20,186,176,61,183,30,153
"2011","Wirral 029B","E01007174","Total",646,216,32,184,213,93,183,35,148
"2011","Wirral 029C","E01007176","Total",739,304,41,263,213,85,217,33,184
"2011","Wirral 029D","E01007177","Total",684,302,28,274,183,58,251,43,208
"2011","Wirral 029E","E01007178","Total",711,269,30,239,179,66,234,29,205
"2011","Wirral 030A","E01007248","Total",577,194,10,184,174,53,163,25,138
"2011","Wirral 030B","E01007250","Total",559,185,5,180,169,53,151,30,121
"2011","Wirral 030C","E01007253","Total",727,322,37,285,188,69,319,49,270
"2011","Wirral 030D","E01007254","Total",607,209,6,203,160,40,155,22,133
"2011","Wirral 031A","E01007115","Total",673,235,34,201,213,71,200,54,146
"2011","Wirral 031B","E01007138","Total",782,362,66,296,211,108,307,53,254
"2011","Wirral 031C","E01007139","Total",683,236,44,192,213,79,213,47,166
"2011","Wirral 031D","E01007141","Total",861,369,32,337,166,70,275,29,246
"2011","Wirral 031E","E01007289","Total",664,356,145,211,287,128,236,74,162
"2011","Wirral 032A","E01007111","Total",593,174,12,162,201,52,146,32,114
"2011","Wirral 032B","E01007112","Total",655,226,24,202,187,64,188,30,158
"2011","Wirral 032C","E01007113","Total",586,209,4,205,165,46,168,19,149
"2011","Wirral 032D","E01007114","Total",591,201,58,143,256,109,177,46,131
"2011","Wirral 032E","E01007116","Total",683,258,18,240,180,74,178,22,156
"2011","Wirral 033A","E01007280","Total",741,271,13,258,216,67,201,35,166
"2011","Wirral 033B","E01007284","Total",691,253,5,248,163,57,172,20,152
"2011","Wirral 033C","E01007285","Total",638,254,14,240,160,51,172,30,142
"2011","Wirral 033D","E01007287","Total",871,418,12,406,161,46,287,24,263
"2011","Wirral 034A","E01007183","Total",527,160,9,151,152,51,134,20,114
"2011","Wirral 034B","E01007255","Total",655,255,15,240,171,55,203,32,171
"2011","Wirral 034C","E01007256","Total",746,370,16,354,136,38,235,26,209
"2011","Wirral 034D","E01007279","Total",667,221,20,201,212,64,171,32,139
"2011","Wirral 034E","E01007286","Total",639,235,16,219,170,58,187,24,163
"2011","Wirral 035A","E01007110","Total",706,267,18,249,181,49,186,24,162
"2011","Wirral 035B","E01007117","Total",640,173,12,161,252,75,167,40,127
"2011","Wirral 035C","E01007118","Total",656,263,33,230,198,62,247,35,212
"2011","Wirral 035D","E01007151","Total",636,226,14,212,209,69,186,32,154
"2011","Wirral 035E","E01007154","Total",621,213,7,206,190,50,166,21,145
"2011","Wirral 036A","E01007140","Total",787,247,33,214,241,110,211,46,165
"2011","Wirral 036B","E01007142","Total",761,237,10,227,167,60,164,19,145
"2011","Wirral 036C","E01007143","Total",703,180,29,151,249,118,156,35,121
"2011","Wirral 036D","E01007152","Total",771,345,15,330,186,66,275,31,244
"2011","Wirral 036E","E01007153","Total",643,312,19,293,165,51,256,28,228
"2011","Wirral 037A","E01007182","Total",736,341,9,332,132,47,226,17,209
"2011","Wirral 037B","E01007184","Total",642,242,12,230,183,62,170,22,148
"2011","Wirral 037C","E01007185","Total",699,223,20,203,219,74,167,28,139
"2011","Wirral 037D","E01007192","Total",611,315,6,309,123,38,218,17,201
"2011","Wirral 037E","E01007288","Total",746,384,22,362,171,59,271,32,239
"2011","Wirral 038A","E01007144","Total",545,208,8,200,124,36,137,17,120
"2011","Wirral 038B","E01007145","Total",537,224,8,216,121,30,131,17,114
"2011","Wirral 038C","E01007146","Total",714,267,7,260,155,54,189,13,176
"2011","Wirral 038D","E01007147","Total",606,251,8,243,150,40,161,20,141
"2011","Wirral 038E","E01007148","Total",664,273,4,269,163,44,147,21,126
"2011","Wirral 039A","E01007135","Total",635,238,11,227,172,56,165,23,142
"2011","Wirral 039B","E01007136","Total",699,265,48,217,249,96,240,58,182
"2011","Wirral 039C","E01007137","Total",779,332,31,301,195,77,259,43,216
"2011","Wirral 039D","E01007170","Total",634,242,10,232,178,60,170,25,145
"2011","Wirral 040A","E01007186","Total",660,246,4,242,199,45,150,22,128
"2011","Wirral 040B","E01007187","Total",653,286,5,281,124,35,158,22,136
"2011","Wirral 040C","E01007188","Total",616,251,6,245,170,47,161,25,136
"2011","Wirral 040D","E01007189","Total",717,325,7,318,147,40,185,16,169
"2011","Wirral 040E","E01007190","Total",641,275,3,272,155,39,139,12,127
"2011","Wirral 040F","E01007191","Total",534,225,5,220,143,38,112,16,96
"2011","Wirral 041A","E01007149","Total",621,256,4,252,153,42,158,27,131
"2011","Wirral 041B","E01007150","Total",593,190,12,178,175,52,124,21,103
"2011","Wirral 041C","E01007165","Total",570,225,7,218,138,53,159,17,142
"2011","Wirral 041D","E01007171","Total",617,194,9,185,190,68,162,17,145
"2011","Wirral 041E","E01007172","Total",608,224,3,221,150,50,145,13,132
"2011","Wirral 042A","E01007164","Total",737,221,18,203,225,103,206,35,171
"2011","Wirral 042B","E01007166","Total",636,246,9,237,147,57,157,18,139
"2011","Wirral 042C","E01007167","Total",615,246,36,210,199,59,196,38,158
"2011","Wirral 042D","E01007168","Total",777,367,38,329,185,82,297,34,263
"2011","Wirral 042E","E01007169","Total",761,300,28,272,217,76,242,33,209
"2011","East Riding of Yorkshire 001A","E01012933","Total",476,228,4,224,78,21,142,15,127
"2011","East Riding of Yorkshire 001B","E01012934","Total",711,314,17,297,143,48,235,24,211
"2011","East Riding of Yorkshire 001C","E01012938","Total",1095,538,32,506,224,104,338,28,310
"2011","East Riding of Yorkshire 001D","E01012939","Total",802,399,11,388,169,66,198,18,180
"2011","East Riding of Yorkshire 001E","E01012940","Total",837,446,8,438,124,29,263,16,247
"2011","East Riding of Yorkshire 001F","E01012941","Total",707,437,5,432,80,18,249,12,237
"2011","East Riding of Yorkshire 002A","E01012929","Total",794,251,55,196,284,117,169,36,133
"2011","East Riding of Yorkshire 002B","E01012930","Total",637,271,15,256,152,35,201,34,167
"2011","East Riding of Yorkshire 002C","E01012935","Total",610,338,4,334,91,22,194,11,183
"2011","East Riding of Yorkshire 002D","E01012937","Total",1045,566,25,541,150,38,335,25,310
"2011","East Riding of Yorkshire 002E","E01012942","Total",653,410,3,407,70,14,216,12,204
"2011","East Riding of Yorkshire 003A","E01012928","Total",719,382,92,290,256,117,263,53,210
"2011","East Riding of Yorkshire 003B","E01012931","Total",810,484,53,431,165,78,350,36,314
"2011","East Riding of Yorkshire 003C","E01012932","Total",713,344,83,261,228,83,220,42,178
"2011","East Riding of Yorkshire 003D","E01012946","Total",696,377,86,291,238,98,283,59,224
"2011","East Riding of Yorkshire 003E","E01012949","Total",633,322,32,290,145,56,224,28,196
"2011","East Riding of Yorkshire 004A","E01012936","Total",688,395,7,388,71,18,247,9,238
"2011","East Riding of Yorkshire 004B","E01012943","Total",701,276,28,248,189,76,209,33,176
"2011","East Riding of Yorkshire 004C","E01012945","Total",717,328,50,278,205,90,261,50,211
"2011","East Riding of Yorkshire 004D","E01012952","Total",653,308,27,281,148,56,208,24,184
"2011","East Riding of Yorkshire 005A","E01012944","Total",719,377,57,320,165,76,247,45,202
"2011","East Riding of Yorkshire 005B","E01012947","Total",578,229,25,204,156,47,181,32,149
"2011","East Riding of Yorkshire 005C","E01012948","Total",652,330,45,285,136,49,226,26,200
"2011","East Riding of Yorkshire 005D","E01012951","Total",574,284,33,251,114,36,184,22,162
"2011","East Riding of Yorkshire 006A","E01012950","Total",592,269,10,259,137,50,151,16,135
"2011","East Riding of Yorkshire 006B","E01012990","Total",600,192,9,183,143,43,156,24,132
"2011","East Riding of Yorkshire 006C","E01012991","Total",663,227,16,211,168,48,157,18,139
"2011","East Riding of Yorkshire 006D","E01012992","Total",656,258,23,235,145,39,194,27,167
"2011","East Riding of Yorkshire 008A","E01012978","Total",649,301,7,294,138,43,160,16,144
"2011","East Riding of Yorkshire 008B","E01012981","Total",611,193,14,179,139,48,154,21,133
"2011","East Riding of Yorkshire 008C","E01012983","Total",740,227,12,215,220,86,183,34,149
"2011","East Riding of Yorkshire 008D","E01012989","Total",751,295,13,282,182,56,179,32,147
"2011","East Riding of Yorkshire 008E","E01013125","Total",734,208,9,199,192,66,179,27,152
"2011","East Riding of Yorkshire 009A","E01013057","Total",614,168,5,163,192,54,141,27,114
"2011","East Riding of Yorkshire 009B","E01013059","Total",679,187,3,184,181,64,156,10,146
"2011","East Riding of Yorkshire 009C","E01013060","Total",795,279,3,276,224,69,161,20,141
"2011","East Riding of Yorkshire 009D","E01013061","Total",697,236,10,226,189,64,172,22,150
"2011","East Riding of Yorkshire 009E","E01013126","Total",599,122,7,115,204,70,107,23,84
"2011","East Riding of Yorkshire 010A","E01012986","Total",738,328,8,320,124,40,242,29,213
"2011","East Riding of Yorkshire 010B","E01012987","Total",704,211,7,204,197,60,177,31,146
"2011","East Riding of Yorkshire 010C","E01012988","Total",646,180,14,166,187,67,140,19,121
"2011","East Riding of Yorkshire 010D","E01013048","Total",866,294,22,272,229,76,250,45,205
"2011","East Riding of Yorkshire 011A","E01013052","Total",637,170,4,166,190,48,154,25,129
"2011","East Riding of Yorkshire 011B","E01013053","Total",654,304,3,301,104,39,166,8,158
"2011","East Riding of Yorkshire 011C","E01013054","Total",801,202,13,189,296,121,161,31,130
"2011","East Riding of Yorkshire 011D","E01013055","Total",671,230,19,211,178,53,159,22,137
"2011","East Riding of Yorkshire 011E","E01013056","Total",747,252,22,230,191,74,206,30,176
"2011","East Riding of Yorkshire 011F","E01013058","Total",599,214,10,204,145,41,166,23,143
"2011","East Riding of Yorkshire 011G","E01013119","Total",628,171,8,163,169,53,128,14,114
"2011","East Riding of Yorkshire 012A","E01013046","Total",767,364,17,347,135,40,229,25,204
"2011","East Riding of Yorkshire 012B","E01013047","Total",701,332,16,316,148,43,247,29,218
"2011","East Riding of Yorkshire 012C","E01013049","Total",754,352,19,333,152,44,269,28,241
"2011","East Riding of Yorkshire 012D","E01013050","Total",734,305,12,293,155,50,203,19,184
"2011","East Riding of Yorkshire 012E","E01013051","Total",670,292,43,249,206,81,199,35,164
"2011","East Riding of Yorkshire 013A","E01012922","Total",642,185,6,179,160,50,136,19,117
"2011","East Riding of Yorkshire 013B","E01012923","Total",603,150,8,142,205,85,117,30,87
"2011","East Riding of Yorkshire 013C","E01012925","Total",534,145,5,140,170,47,112,23,89
"2011","East Riding of Yorkshire 013D","E01012927","Total",648,220,4,216,167,45,165,16,149
"2011","East Riding of Yorkshire 014A","E01012924","Total",703,186,7,179,210,57,157,37,120
"2011","East Riding of Yorkshire 014B","E01012926","Total",1059,380,13,367,252,84,281,36,245
"2011","East Riding of Yorkshire 014C","E01013027","Total",736,287,15,272,150,37,201,17,184
"2011","East Riding of Yorkshire 014D","E01013034","Total",734,204,8,196,218,86,160,25,135
"2011","East Riding of Yorkshire 015A","E01013120","Total",834,273,13,260,194,76,169,25,144
"2011","East Riding of Yorkshire 015B","E01013121","Total",769,155,8,147,291,119,138,36,102
"2011","East Riding of Yorkshire 015C","E01013123","Total",663,179,11,168,180,72,136,16,120
"2011","East Riding of Yorkshire 015D","E01013124","Total",987,430,30,400,231,105,312,33,279
"2011","East Riding of Yorkshire 016A","E01013064","Total",526,92,13,79,232,67,79,38,41
"2011","East Riding of Yorkshire 016B","E01013065","Total",742,291,13,278,164,55,210,27,183
"2011","East Riding of Yorkshire 016C","E01013066","Total",691,236,5,231,201,67,144,19,125
"2011","East Riding of Yorkshire 016D","E01013067","Total",701,157,3,154,224,75,117,23,94
"2011","East Riding of Yorkshire 016E","E01013068","Total",630,286,4,282,129,30,162,17,145
"2011","East Riding of Yorkshire 016F","E01013070","Total",687,280,7,273,151,46,123,13,110
"2011","East Riding of Yorkshire 017A","E01013038","Total",612,238,65,173,243,113,187,51,136
"2011","East Riding of Yorkshire 017B","E01013045","Total",642,245,65,180,264,101,185,56,129
"2011","East Riding of Yorkshire 017C","E01013069","Total",702,233,18,215,174,84,168,22,146
"2011","East Riding of Yorkshire 017D","E01013071","Total",802,371,34,337,164,77,263,27,236
"2011","East Riding of Yorkshire 018A","E01013022","Total",754,171,10,161,215,81,152,24,128
"2011","East Riding of Yorkshire 018B","E01013023","Total",754,205,9,196,189,53,178,34,144
"2011","East Riding of Yorkshire 018C","E01013024","Total",751,208,14,194,234,94,172,25,147
"2011","East Riding of Yorkshire 018D","E01013122","Total",589,124,8,116,179,48,104,15,89
"2011","East Riding of Yorkshire 018E","E01013127","Total",608,142,6,136,181,67,119,24,95
"2011","East Riding of Yorkshire 019A","E01013036","Total",791,257,24,233,188,76,205,30,175
"2011","East Riding of Yorkshire 019B","E01013037","Total",656,138,10,128,186,69,108,17,91
"2011","East Riding of Yorkshire 019C","E01013040","Total",881,158,19,139,261,103,148,30,118
"2011","East Riding of Yorkshire 019D","E01013041","Total",883,424,9,415,113,40,267,16,251
"2011","East Riding of Yorkshire 019E","E01013062","Total",903,362,22,340,163,66,242,23,219
"2011","East Riding of Yorkshire 019F","E01013063","Total",684,243,12,231,172,51,155,21,134
"2011","East Riding of Yorkshire 020A","E01012919","Total",531,142,1,141,169,45,96,15,81
"2011","East Riding of Yorkshire 020B","E01012921","Total",486,147,2,145,151,49,102,22,80
"2011","East Riding of Yorkshire 020C","E01013039","Total",784,252,11,241,168,52,192,20,172
"2011","East Riding of Yorkshire 020D","E01013042","Total",655,175,8,167,256,63,121,38,83
"2011","East Riding of Yorkshire 020E","E01013043","Total",548,125,17,108,224,54,102,27,75
"2011","East Riding of Yorkshire 020F","E01013044","Total",659,162,5,157,220,59,115,24,91
"2011","East Riding of Yorkshire 021A","E01013029","Total",632,256,20,236,144,46,198,37,161
"2011","East Riding of Yorkshire 021B","E01013030","Total",654,237,6,231,140,37,165,16,149
"2011","East Riding of Yorkshire 021C","E01013031","Total",630,227,8,219,145,29,168,14,154
"2011","East Riding of Yorkshire 021D","E01013032","Total",622,231,5,226,140,48,149,12,137
"2011","East Riding of Yorkshire 021E","E01013035","Total",551,161,2,159,131,40,135,16,119
"2011","East Riding of Yorkshire 022A","E01012954","Total",543,208,14,194,123,37,131,17,114
"2011","East Riding of Yorkshire 022B","E01012956","Total",477,158,8,150,151,40,102,14,88
"2011","East Riding of Yorkshire 022C","E01012958","Total",486,224,2,222,86,20,123,9,114
"2011","East Riding of Yorkshire 022D","E01012961","Total",683,333,12,321,149,59,184,23,161
"2011","East Riding of Yorkshire 022E","E01012966","Total",576,220,7,213,102,29,144,11,133
"2011","East Riding of Yorkshire 023A","E01012953","Total",485,149,3,146,108,34,136,19,117
"2011","East Riding of Yorkshire 023B","E01012955","Total",666,238,12,226,165,46,152,15,137
"2011","East Riding of Yorkshire 023C","E01012959","Total",642,212,11,201,173,72,147,23,124
"2011","East Riding of Yorkshire 023D","E01012962","Total",471,169,4,165,115,31,120,15,105
"2011","East Riding of Yorkshire 023E","E01012964","Total",746,310,30,280,217,64,242,33,209
"2011","East Riding of Yorkshire 024A","E01012920","Total",622,166,9,157,174,59,108,17,91
"2011","East Riding of Yorkshire 024B","E01012965","Total",422,129,2,127,102,24,109,21,88
"2011","East Riding of Yorkshire 024C","E01012967","Total",660,231,8,223,175,51,151,19,132
"2011","East Riding of Yorkshire 024D","E01012968","Total",701,202,7,195,216,59,140,27,113
"2011","East Riding of Yorkshire 024E","E01012969","Total",476,139,8,131,142,39,106,16,90
"2011","East Riding of Yorkshire 025A","E01012957","Total",780,339,5,334,135,55,220,12,208
"2011","East Riding of Yorkshire 025B","E01012960","Total",703,256,7,249,168,49,187,21,166
"2011","East Riding of Yorkshire 025C","E01012963","Total",756,402,37,365,150,69,301,41,260
"2011","East Riding of Yorkshire 025D","E01013112","Total",647,314,5,309,122,30,175,18,157
"2011","East Riding of Yorkshire 026A","E01013018","Total",769,248,20,228,239,99,193,30,163
"2011","East Riding of Yorkshire 026B","E01013019","Total",496,122,6,116,131,40,110,19,91
"2011","East Riding of Yorkshire 026C","E01013021","Total",655,220,8,212,136,48,168,18,150
"2011","East Riding of Yorkshire 026D","E01013025","Total",589,203,6,197,147,42,134,20,114
"2011","East Riding of Yorkshire 026E","E01013026","Total",694,212,12,200,185,50,188,29,159
"2011","East Riding of Yorkshire 027A","E01013105","Total",611,225,30,195,191,72,163,36,127
"2011","East Riding of Yorkshire 027B","E01013110","Total",660,227,10,217,204,67,172,23,149
"2011","East Riding of Yorkshire 027C","E01013111","Total",606,206,8,198,182,58,138,19,119
"2011","East Riding of Yorkshire 027D","E01013115","Total",639,194,13,181,202,81,154,26,128
"2011","East Riding of Yorkshire 027E","E01013117","Total",590,190,2,188,178,58,121,18,103
"2011","East Riding of Yorkshire 028A","E01013108","Total",627,218,2,216,146,46,156,17,139
"2011","East Riding of Yorkshire 028B","E01013113","Total",663,253,3,250,150,49,174,21,153
"2011","East Riding of Yorkshire 028C","E01013114","Total",633,238,2,236,146,30,147,17,130
"2011","East Riding of Yorkshire 028D","E01013116","Total",611,207,3,204,168,44,148,23,125
"2011","East Riding of Yorkshire 028E","E01013118","Total",638,266,6,260,148,41,151,15,136
"2011","East Riding of Yorkshire 029A","E01013094","Total",566,209,15,194,151,42,144,21,123
"2011","East Riding of Yorkshire 029B","E01013095","Total",669,240,12,228,146,58,170,23,147
"2011","East Riding of Yorkshire 029C","E01013096","Total",700,223,20,203,213,79,157,32,125
"2011","East Riding of Yorkshire 029D","E01013097","Total",662,229,14,215,154,57,178,21,157
"2011","East Riding of Yorkshire 029E","E01013102","Total",660,216,6,210,135,45,161,20,141
"2011","East Riding of Yorkshire 031A","E01013028","Total",650,173,6,167,171,55,153,20,133
"2011","East Riding of Yorkshire 031B","E01013078","Total",594,212,12,200,151,41,145,26,119
"2011","East Riding of Yorkshire 031C","E01013081","Total",651,217,12,205,145,63,165,21,144
"2011","East Riding of Yorkshire 031D","E01013082","Total",665,260,15,245,159,63,195,23,172
"2011","East Riding of Yorkshire 031E","E01013085","Total",704,259,18,241,182,55,166,25,141
"2011","East Riding of Yorkshire 032A","E01012970","Total",634,195,1,194,160,39,128,13,115
"2011","East Riding of Yorkshire 032C","E01012972","Total",601,192,3,189,198,66,136,21,115
"2011","East Riding of Yorkshire 032D","E01012973","Total",1135,149,5,144,424,175,146,40,106
"2011","East Riding of Yorkshire 032E","E01012974","Total",661,227,8,219,198,71,162,27,135
"2011","East Riding of Yorkshire 032F","E01013092","Total",844,238,4,234,269,102,149,20,129
"2011","East Riding of Yorkshire 032G","E01033495","Total",580,47,6,41,239,120,57,22,35
"2011","East Riding of Yorkshire 032H","E01033496","Total",651,146,11,135,262,81,116,23,93
"2011","East Riding of Yorkshire 033A","E01013033","Total",643,174,15,159,203,75,135,20,115
"2011","East Riding of Yorkshire 033B","E01013098","Total",920,252,16,236,297,117,185,36,149
"2011","East Riding of Yorkshire 033C","E01013099","Total",638,299,29,270,150,44,208,29,179
"2011","East Riding of Yorkshire 033D","E01013100","Total",686,226,11,215,184,51,179,33,146
"2011","East Riding of Yorkshire 033E","E01013101","Total",717,238,10,228,199,64,179,35,144
"2011","East Riding of Yorkshire 034A","E01013008","Total",650,151,15,136,204,76,119,28,91
"2011","East Riding of Yorkshire 034B","E01013009","Total",753,317,28,289,176,62,247,34,213
"2011","East Riding of Yorkshire 034C","E01013013","Total",672,185,18,167,199,78,149,25,124
"2011","East Riding of Yorkshire 034D","E01013014","Total",608,202,19,183,204,71,173,31,142
"2011","East Riding of Yorkshire 034E","E01013107","Total",777,385,22,363,184,66,265,24,241
"2011","East Riding of Yorkshire 035A","E01013088","Total",688,267,6,261,190,47,158,19,139
"2011","East Riding of Yorkshire 035B","E01013089","Total",707,200,4,196,202,65,149,21,128
"2011","East Riding of Yorkshire 035C","E01013090","Total",587,192,6,186,172,49,134,15,119
"2011","East Riding of Yorkshire 035D","E01013091","Total",671,250,5,245,214,59,180,27,153
"2011","East Riding of Yorkshire 035E","E01013093","Total",630,229,7,222,165,45,136,17,119
"2011","East Riding of Yorkshire 036A","E01013005","Total",528,185,3,182,123,26,123,20,103
"2011","East Riding of Yorkshire 036B","E01013007","Total",663,196,10,186,197,68,156,26,130
"2011","East Riding of Yorkshire 036C","E01013011","Total",652,216,13,203,198,74,160,27,133
"2011","East Riding of Yorkshire 036D","E01013012","Total",520,115,1,114,171,53,98,18,80
"2011","East Riding of Yorkshire 037A","E01012996","Total",638,185,6,179,170,62,133,22,111
"2011","East Riding of Yorkshire 037B","E01012998","Total",884,246,15,231,278,105,203,37,166
"2011","East Riding of Yorkshire 037C","E01013015","Total",674,160,12,148,175,77,124,15,109
"2011","East Riding of Yorkshire 037D","E01013016","Total",704,208,1,207,171,60,154,18,136
"2011","East Riding of Yorkshire 038A","E01013003","Total",658,290,14,276,143,54,200,25,175
"2011","East Riding of Yorkshire 038B","E01013017","Total",731,276,23,253,187,63,215,29,186
"2011","East Riding of Yorkshire 038C","E01013020","Total",720,165,11,154,217,77,164,25,139
"2011","East Riding of Yorkshire 038D","E01013076","Total",630,209,16,193,178,61,165,29,136
"2011","East Riding of Yorkshire 039A","E01013079","Total",686,285,6,279,130,43,202,21,181
"2011","East Riding of Yorkshire 039B","E01013080","Total",580,275,58,217,194,76,191,37,154
"2011","East Riding of Yorkshire 039C","E01013083","Total",616,279,39,240,163,62,227,43,184
"2011","East Riding of Yorkshire 039D","E01013084","Total",678,410,63,347,170,63,255,30,225
"2011","East Riding of Yorkshire 039E","E01013086","Total",634,281,30,251,165,60,188,29,159
"2011","East Riding of Yorkshire 039F","E01013087","Total",572,218,26,192,145,45,203,30,173
"2011","East Riding of Yorkshire 040A","E01012993","Total",596,235,5,230,121,40,168,14,154
"2011","East Riding of Yorkshire 040B","E01012997","Total",850,282,39,243,241,125,205,34,171
"2011","East Riding of Yorkshire 040C","E01012999","Total",681,183,50,133,259,139,147,39,108
"2011","East Riding of Yorkshire 040D","E01013001","Total",756,257,22,235,222,98,169,22,147
"2011","East Riding of Yorkshire 040E","E01013074","Total",676,193,8,185,164,50,153,21,132
"2011","East Riding of Yorkshire 041A","E01012994","Total",781,309,21,288,208,82,242,44,198
"2011","East Riding of Yorkshire 041B","E01012995","Total",771,260,46,214,310,112,205,40,165
"2011","East Riding of Yorkshire 041C","E01013000","Total",915,374,54,320,223,105,262,36,226
"2011","East Riding of Yorkshire 041D","E01013002","Total",686,254,58,196,238,126,182,28,154
"2011","East Riding of Yorkshire 041E","E01013004","Total",658,226,56,170,248,121,168,39,129
"2011","East Riding of Yorkshire 042A","E01013072","Total",701,215,12,203,221,86,195,36,159
"2011","East Riding of Yorkshire 042B","E01013073","Total",673,197,8,189,191,52,163,19,144
"2011","East Riding of Yorkshire 042C","E01013075","Total",547,151,7,144,146,33,133,23,110
"2011","East Riding of Yorkshire 042D","E01013077","Total",819,264,11,253,245,77,200,27,173
"2011","East Riding of Yorkshire 043A","E01013006","Total",629,144,26,118,220,78,129,26,103
"2011","East Riding of Yorkshire 043B","E01013010","Total",631,203,15,188,175,65,153,14,139
"2011","East Riding of Yorkshire 043C","E01013103","Total",611,217,5,212,151,42,149,21,128
"2011","East Riding of Yorkshire 043D","E01013104","Total",567,205,7,198,121,44,137,18,119
"2011","East Riding of Yorkshire 043E","E01013106","Total",480,170,19,151,159,62,123,18,105
"2011","East Riding of Yorkshire 043F","E01032596","Total",599,180,9,171,181,51,158,33,125
"2011","East Riding of Yorkshire 044A","E01012975","Total",650,234,8,226,147,40,163,21,142
"2011","East Riding of Yorkshire 044B","E01012977","Total",1019,270,21,249,368,90,217,45,172
"2011","East Riding of Yorkshire 044C","E01012984","Total",706,216,10,206,194,62,142,22,120
"2011","East Riding of Yorkshire 044D","E01012985","Total",739,307,22,285,196,57,208,32,176
"2011","East Riding of Yorkshire 045A","E01012976","Total",613,236,41,195,174,86,199,27,172
"2011","East Riding of Yorkshire 045B","E01012979","Total",731,282,18,264,147,61,215,34,181
"2011","East Riding of Yorkshire 045C","E01012980","Total",837,312,36,276,211,95,235,34,201
"2011","East Riding of Yorkshire 045D","E01012982","Total",775,284,18,266,186,68,204,22,182
"2011","Kingston upon Hull 001A","E01012779","Total",487,206,96,110,230,115,137,45,92
"2011","Kingston upon Hull 001B","E01012780","Total",593,268,105,163,267,139,176,50,126
"2011","Kingston upon Hull 001C","E01012781","Total",471,228,78,150,191,89,170,50,120
"2011","Kingston upon Hull 001E","E01012832","Total",548,136,34,102,206,92,110,30,80
"2011","Kingston upon Hull 001F","E01033105","Total",556,55,12,43,213,75,61,22,39
"2011","Kingston upon Hull 001G","E01033106","Total",495,30,8,22,170,91,50,18,32
"2011","Kingston upon Hull 001H","E01033107","Total",492,37,12,25,189,97,56,19,37
"2011","Kingston upon Hull 001I","E01033108","Total",554,48,16,32,233,110,75,28,47
"2011","Kingston upon Hull 002A","E01012782","Total",576,313,85,228,231,92,203,47,156
"2011","Kingston upon Hull 002B","E01012785","Total",549,282,96,186,219,103,196,46,150
"2011","Kingston upon Hull 002C","E01012786","Total",507,230,31,199,146,58,158,22,136
"2011","Kingston upon Hull 002D","E01012787","Total",681,334,91,243,234,108,215,43,172
"2011","Kingston upon Hull 002E","E01012788","Total",578,275,85,190,227,93,187,42,145
"2011","Kingston upon Hull 002F","E01012789","Total",540,225,69,156,208,101,155,46,109
"2011","Kingston upon Hull 003A","E01012875","Total",645,376,103,273,239,124,230,48,182
"2011","Kingston upon Hull 003B","E01012876","Total",680,387,132,255,250,119,246,73,173
"2011","Kingston upon Hull 003C","E01012877","Total",499,250,108,142,243,120,169,59,110
"2011","Kingston upon Hull 003D","E01012878","Total",650,331,97,234,244,101,234,58,176
"2011","Kingston upon Hull 003E","E01012879","Total",649,378,118,260,234,114,229,43,186
"2011","Kingston upon Hull 004A","E01012778","Total",536,227,92,135,254,112,165,55,110
"2011","Kingston upon Hull 004B","E01012783","Total",529,257,80,177,192,89,155,39,116
"2011","Kingston upon Hull 004C","E01012784","Total",791,209,87,122,359,161,168,71,97
"2011","Kingston upon Hull 004D","E01012790","Total",569,290,36,254,151,57,198,29,169
"2011","Kingston upon Hull 004E","E01012906","Total",679,307,90,217,260,109,199,46,153
"2011","Kingston upon Hull 004F","E01012908","Total",490,221,49,172,157,66,158,27,131
"2011","Kingston upon Hull 005A","E01012764","Total",552,227,7,220,98,34,142,9,133
"2011","Kingston upon Hull 005B","E01012765","Total",628,171,12,159,187,81,138,20,118
"2011","Kingston upon Hull 005C","E01012768","Total",698,240,11,229,118,66,167,10,157
"2011","Kingston upon Hull 005D","E01012769","Total",684,326,6,320,95,42,206,13,193
"2011","Kingston upon Hull 006A","E01012829","Total",692,195,5,190,176,65,179,19,160
"2011","Kingston upon Hull 006B","E01012830","Total",612,156,9,147,172,70,142,22,120
"2011","Kingston upon Hull 006C","E01012905","Total",580,271,61,210,183,73,175,36,139
"2011","Kingston upon Hull 006D","E01012910","Total",466,84,16,68,187,61,89,25,64
"2011","Kingston upon Hull 006E","E01012912","Total",756,251,15,236,213,88,198,30,168
"2011","Kingston upon Hull 007A","E01012822","Total",651,270,17,253,172,65,178,22,156
"2011","Kingston upon Hull 007B","E01012904","Total",655,239,28,211,144,43,182,31,151
"2011","Kingston upon Hull 007C","E01012907","Total",595,205,36,169,183,67,146,28,118
"2011","Kingston upon Hull 007D","E01012909","Total",591,110,6,104,155,64,83,20,63
"2011","Kingston upon Hull 007E","E01012911","Total",500,112,7,105,145,50,104,18,86
"2011","Kingston upon Hull 008A","E01012873","Total",643,341,126,215,270,133,219,53,166
"2011","Kingston upon Hull 008B","E01012874","Total",645,325,100,225,240,103,199,45,154
"2011","Kingston upon Hull 008C","E01012880","Total",704,360,128,232,300,130,233,60,173
"2011","Kingston upon Hull 008D","E01012881","Total",639,316,78,238,233,104,224,50,174
"2011","Kingston upon Hull 008E","E01012915","Total",640,316,84,232,221,101,191,41,150
"2011","Kingston upon Hull 008F","E01012917","Total",785,477,86,391,203,90,279,40,239
"2011","Kingston upon Hull 008G","E01012918","Total",609,250,87,163,249,86,191,61,130
"2011","Kingston upon Hull 009A","E01012833","Total",645,312,74,238,232,105,207,30,177
"2011","Kingston upon Hull 009B","E01012835","Total",525,204,6,198,97,29,148,8,140
"2011","Kingston upon Hull 009C","E01012836","Total",785,442,49,393,162,65,277,41,236
"2011","Kingston upon Hull 009D","E01012839","Total",551,244,38,206,155,60,174,27,147
"2011","Kingston upon Hull 009E","E01012840","Total",648,296,74,222,212,80,203,36,167
"2011","Kingston upon Hull 010A","E01012824","Total",682,213,19,194,198,63,183,27,156
"2011","Kingston upon Hull 010B","E01012825","Total",679,294,14,280,151,54,200,17,183
"2011","Kingston upon Hull 010C","E01012834","Total",664,304,95,209,266,120,198,51,147
"2011","Kingston upon Hull 010D","E01012837","Total",741,364,56,308,203,87,267,33,234
"2011","Kingston upon Hull 010E","E01012838","Total",607,279,102,177,252,107,192,51,141
"2011","Kingston upon Hull 011A","E01012821","Total",609,322,19,303,128,36,233,18,215
"2011","Kingston upon Hull 011B","E01012823","Total",602,317,72,245,209,87,200,39,161
"2011","Kingston upon Hull 011C","E01012826","Total",710,345,33,312,190,64,259,39,220
"2011","Kingston upon Hull 011D","E01012827","Total",755,371,14,357,122,39,287,14,273
"2011","Kingston upon Hull 011E","E01012828","Total",679,266,15,251,180,72,200,18,182
"2011","Kingston upon Hull 012A","E01012766","Total",562,109,6,103,169,68,111,18,93
"2011","Kingston upon Hull 012B","E01012767","Total",583,175,6,169,119,43,129,18,111
"2011","Kingston upon Hull 012C","E01012914","Total",627,348,19,329,61,32,83,11,72
"2011","Kingston upon Hull 012D","E01012916","Total",685,249,26,223,155,79,157,19,138
"2011","Kingston upon Hull 013A","E01012812","Total",521,119,4,115,203,71,106,25,81
"2011","Kingston upon Hull 013B","E01012813","Total",681,149,13,136,230,74,132,29,103
"2011","Kingston upon Hull 013C","E01012814","Total",623,202,10,192,200,59,154,28,126
"2011","Kingston upon Hull 013D","E01012815","Total",675,136,8,128,218,89,107,20,87
"2011","Kingston upon Hull 013E","E01012818","Total",507,151,8,143,162,42,122,20,102
"2011","Kingston upon Hull 014A","E01012791","Total",662,179,8,171,199,57,130,25,105
"2011","Kingston upon Hull 014B","E01012792","Total",644,196,11,185,213,83,152,31,121
"2011","Kingston upon Hull 014C","E01012793","Total",620,260,11,249,126,38,188,24,164
"2011","Kingston upon Hull 014D","E01012794","Total",637,133,9,124,220,73,124,31,93
"2011","Kingston upon Hull 014E","E01012913","Total",821,284,84,200,296,115,173,45,128
"2011","Kingston upon Hull 015A","E01012761","Total",863,386,38,348,128,68,253,22,231
"2011","Kingston upon Hull 015B","E01012868","Total",695,292,24,268,86,49,168,21,147
"2011","Kingston upon Hull 015C","E01012869","Total",675,272,23,249,105,50,176,19,157
"2011","Kingston upon Hull 015D","E01012871","Total",742,236,51,185,198,91,126,21,105
"2011","Kingston upon Hull 015E","E01012872","Total",678,277,22,255,92,47,147,10,137
"2011","Kingston upon Hull 016A","E01012804","Total",683,184,13,171,159,75,173,22,151
"2011","Kingston upon Hull 016B","E01012806","Total",743,268,58,210,200,104,195,34,161
"2011","Kingston upon Hull 016C","E01012807","Total",599,204,14,190,149,57,161,23,138
"2011","Kingston upon Hull 016D","E01012817","Total",648,169,33,136,181,92,118,22,96
"2011","Kingston upon Hull 016E","E01012819","Total",622,161,24,137,177,76,123,21,102
"2011","Kingston upon Hull 017A","E01012841","Total",655,352,132,220,285,145,206,57,149
"2011","Kingston upon Hull 017B","E01012844","Total",609,341,97,244,204,90,222,39,183
"2011","Kingston upon Hull 017C","E01012849","Total",712,355,58,297,191,66,252,36,216
"2011","Kingston upon Hull 017D","E01012895","Total",588,325,118,207,245,105,187,42,145
"2011","Kingston upon Hull 017E","E01012897","Total",695,442,138,304,262,132,252,53,199
"2011","Kingston upon Hull 017F","E01012898","Total",669,403,53,350,151,67,294,38,256
"2011","Kingston upon Hull 018A","E01012758","Total",700,141,5,136,173,66,159,19,140
"2011","Kingston upon Hull 018B","E01012762","Total",632,151,17,134,171,65,125,26,99
"2011","Kingston upon Hull 018C","E01012763","Total",996,295,34,261,170,84,203,34,169
"2011","Kingston upon Hull 018D","E01012866","Total",701,230,42,188,162,80,145,26,119
"2011","Kingston upon Hull 018E","E01012870","Total",670,233,29,204,125,57,99,15,84
"2011","Kingston upon Hull 019A","E01012774","Total",667,224,28,196,209,85,156,27,129
"2011","Kingston upon Hull 019B","E01012795","Total",880,397,45,352,257,81,311,41,270
"2011","Kingston upon Hull 019C","E01012797","Total",643,275,29,246,179,84,202,30,172
"2011","Kingston upon Hull 019D","E01012798","Total",834,482,39,443,170,51,363,35,328
"2011","Kingston upon Hull 019E","E01012801","Total",664,223,17,206,176,72,167,21,146
"2011","Kingston upon Hull 020A","E01012816","Total",573,192,16,176,161,47,155,22,133
"2011","Kingston upon Hull 020B","E01012848","Total",631,222,21,201,117,58,161,17,144
"2011","Kingston upon Hull 020C","E01012894","Total",629,261,64,197,208,60,203,49,154
"2011","Kingston upon Hull 020D","E01012896","Total",802,190,41,149,325,115,179,53,126
"2011","Kingston upon Hull 020E","E01012901","Total",611,183,12,171,179,59,166,30,136
"2011","Kingston upon Hull 021A","E01012842","Total",602,270,85,185,240,115,196,56,140
"2011","Kingston upon Hull 021B","E01012843","Total",633,359,105,254,227,105,225,40,185
"2011","Kingston upon Hull 021C","E01012845","Total",623,312,102,210,258,121,209,50,159
"2011","Kingston upon Hull 021D","E01012846","Total",624,318,71,247,194,103,207,32,175
"2011","Kingston upon Hull 021E","E01012847","Total",521,266,85,181,215,105,165,42,123
"2011","Kingston upon Hull 022A","E01012820","Total",561,140,21,119,199,72,126,30,96
"2011","Kingston upon Hull 022B","E01012899","Total",669,195,24,171,196,88,147,25,122
"2011","Kingston upon Hull 022C","E01012900","Total",756,270,68,202,218,122,198,26,172
"2011","Kingston upon Hull 022D","E01012902","Total",616,162,14,148,192,68,146,23,123
"2011","Kingston upon Hull 022E","E01012903","Total",829,258,44,214,213,119,176,29,147
"2011","Kingston upon Hull 023A","E01012796","Total",576,210,17,193,164,64,147,21,126
"2011","Kingston upon Hull 023B","E01012799","Total",606,149,23,126,183,87,111,13,98
"2011","Kingston upon Hull 023C","E01012800","Total",755,252,31,221,180,73,181,27,154
"2011","Kingston upon Hull 023D","E01012802","Total",650,188,17,171,169,83,157,29,128
"2011","Kingston upon Hull 023E","E01012803","Total",664,196,25,171,197,83,146,20,126
"2011","Kingston upon Hull 024A","E01012850","Total",984,406,59,347,198,106,260,43,217
"2011","Kingston upon Hull 024B","E01012852","Total",799,344,74,270,194,85,248,43,205
"2011","Kingston upon Hull 024C","E01012856","Total",819,461,79,382,189,91,338,42,296
"2011","Kingston upon Hull 024D","E01012857","Total",769,400,73,327,197,86,293,36,257
"2011","Kingston upon Hull 024E","E01012867","Total",734,319,69,250,206,118,203,36,167
"2011","Kingston upon Hull 025A","E01012756","Total",714,196,24,172,174,73,166,25,141
"2011","Kingston upon Hull 025B","E01012757","Total",687,152,28,124,169,82,120,26,94
"2011","Kingston upon Hull 025C","E01012759","Total",801,215,22,193,195,91,182,26,156
"2011","Kingston upon Hull 025D","E01012760","Total",724,194,37,157,190,95,136,26,110
"2011","Kingston upon Hull 025E","E01012862","Total",597,276,43,233,149,72,203,31,172
"2011","Kingston upon Hull 026A","E01012805","Total",671,272,42,230,165,79,211,32,179
"2011","Kingston upon Hull 026B","E01012808","Total",874,453,52,401,177,75,306,26,280
"2011","Kingston upon Hull 026C","E01012809","Total",924,337,65,272,225,109,227,39,188
"2011","Kingston upon Hull 026D","E01012810","Total",949,300,10,290,227,121,245,17,228
"2011","Kingston upon Hull 026E","E01012811","Total",855,166,16,150,194,110,136,21,115
"2011","Kingston upon Hull 027A","E01012773","Total",753,192,25,167,238,113,144,27,117
"2011","Kingston upon Hull 027B","E01012776","Total",657,173,24,149,198,83,141,19,122
"2011","Kingston upon Hull 027C","E01012863","Total",602,193,52,141,198,97,152,38,114
"2011","Kingston upon Hull 027D","E01012864","Total",732,239,50,189,225,108,195,49,146
"2011","Kingston upon Hull 027E","E01012865","Total",605,238,33,205,171,79,154,23,131
"2011","Kingston upon Hull 028A","E01012770","Total",591,147,6,141,199,62,126,25,101
"2011","Kingston upon Hull 028B","E01012771","Total",636,212,8,204,192,69,189,26,163
"2011","Kingston upon Hull 028C","E01012772","Total",613,191,19,172,187,52,134,20,114
"2011","Kingston upon Hull 028D","E01012775","Total",658,256,39,217,184,80,213,39,174
"2011","Kingston upon Hull 028E","E01012777","Total",729,431,23,408,131,47,297,30,267
"2011","Kingston upon Hull 029A","E01012851","Total",1383,631,61,570,160,94,367,24,343
"2011","Kingston upon Hull 029C","E01012854","Total",1243,575,78,497,205,133,314,33,281
"2011","Kingston upon Hull 029D","E01012855","Total",945,498,72,426,199,96,326,38,288
"2011","Kingston upon Hull 029E","E01033104","Total",911,308,7,301,37,27,183,5,178
"2011","Kingston upon Hull 029F","E01033109","Total",834,289,39,250,80,50,174,16,158
"2011","Kingston upon Hull 030A","E01012859","Total",651,267,75,192,229,112,172,35,137
"2011","Kingston upon Hull 030B","E01012889","Total",648,323,55,268,164,84,197,27,170
"2011","Kingston upon Hull 030C","E01012891","Total",1078,447,71,376,253,147,248,42,206
"2011","Kingston upon Hull 030D","E01012892","Total",827,268,69,199,259,143,196,48,148
"2011","Kingston upon Hull 030E","E01012893","Total",701,358,77,281,202,96,226,41,185
"2011","Kingston upon Hull 031A","E01012858","Total",729,311,68,243,255,108,224,43,181
"2011","Kingston upon Hull 031B","E01012860","Total",641,200,47,153,223,88,166,42,124
"2011","Kingston upon Hull 031D","E01012886","Total",691,284,51,233,203,87,222,35,187
"2011","Kingston upon Hull 031E","E01012888","Total",725,292,74,218,200,110,199,26,173
"2011","Kingston upon Hull 031G","E01033110","Total",728,377,65,312,172,74,265,34,231
"2011","Kingston upon Hull 033A","E01012882","Total",685,184,17,167,188,66,138,28,110
"2011","Kingston upon Hull 033B","E01012883","Total",809,419,5,414,106,44,298,11,287
"2011","Kingston upon Hull 033C","E01012884","Total",822,399,54,345,238,85,298,39,259
"2011","Kingston upon Hull 033D","E01012887","Total",703,348,50,298,184,67,243,39,204
"2011","Kingston upon Hull 033E","E01032595","Total",772,348,45,303,237,91,264,45,219
"2011","North East Lincolnshire 001A","E01013174","Total",532,205,127,78,280,126,141,55,86
"2011","North East Lincolnshire 001B","E01013175","Total",601,205,14,191,151,53,160,30,130
"2011","North East Lincolnshire 001C","E01013176","Total",600,181,23,158,164,77,145,26,119
"2011","North East Lincolnshire 001D","E01013177","Total",804,437,70,367,201,98,276,31,245
"2011","North East Lincolnshire 001E","E01013178","Total",637,243,22,221,172,61,177,31,146
"2011","North East Lincolnshire 001F","E01013179","Total",632,246,24,222,171,57,196,29,167
"2011","North East Lincolnshire 001G","E01013180","Total",621,208,16,192,159,54,169,29,140
"2011","North East Lincolnshire 002A","E01013136","Total",885,559,75,484,156,70,349,29,320
"2011","North East Lincolnshire 002B","E01013137","Total",989,680,55,625,109,49,464,26,438
"2011","North East Lincolnshire 002C","E01013139","Total",656,406,76,330,155,63,267,38,229
"2011","North East Lincolnshire 002D","E01013142","Total",767,313,93,220,271,137,216,47,169
"2011","North East Lincolnshire 003A","E01013218","Total",624,227,67,160,210,100,177,36,141
"2011","North East Lincolnshire 003B","E01013219","Total",641,260,76,184,211,103,175,30,145
"2011","North East Lincolnshire 003C","E01013220","Total",761,287,92,195,250,132,194,35,159
"2011","North East Lincolnshire 003D","E01013221","Total",953,434,61,373,207,96,250,26,224
"2011","North East Lincolnshire 003E","E01013222","Total",702,254,71,183,220,120,191,36,155
"2011","North East Lincolnshire 004A","E01013144","Total",792,460,70,390,179,72,295,27,268
"2011","North East Lincolnshire 004B","E01013145","Total",503,139,6,133,139,35,110,19,91
"2011","North East Lincolnshire 004C","E01013146","Total",708,211,48,163,242,111,161,38,123
"2011","North East Lincolnshire 004D","E01013148","Total",575,133,8,125,160,36,127,20,107
"2011","North East Lincolnshire 005A","E01013195","Total",616,207,53,154,229,110,160,44,116
"2011","North East Lincolnshire 005B","E01013196","Total",565,216,75,141,228,116,150,40,110
"2011","North East Lincolnshire 005C","E01013201","Total",673,264,86,178,232,108,201,46,155
"2011","North East Lincolnshire 005D","E01013202","Total",621,203,62,141,248,107,158,51,107
"2011","North East Lincolnshire 005E","E01013203","Total",728,312,92,220,240,113,198,41,157
"2011","North East Lincolnshire 006A","E01013138","Total",619,353,119,234,212,121,188,46,142
"2011","North East Lincolnshire 006B","E01013140","Total",652,263,85,178,239,114,170,40,130
"2011","North East Lincolnshire 006C","E01013141","Total",647,238,79,159,256,97,155,43,112
"2011","North East Lincolnshire 006D","E01013143","Total",579,171,50,121,220,94,125,34,91
"2011","North East Lincolnshire 007A","E01013173","Total",534,178,8,170,129,40,132,17,115
"2011","North East Lincolnshire 007B","E01013223","Total",1149,334,21,313,404,109,235,49,186
"2011","North East Lincolnshire 007C","E01013224","Total",778,235,10,225,235,92,181,25,156
"2011","North East Lincolnshire 007D","E01013226","Total",632,188,9,179,179,54,137,18,119
"2011","North East Lincolnshire 008A","E01013187","Total",792,393,23,370,94,30,286,20,266
"2011","North East Lincolnshire 008B","E01013188","Total",684,200,12,188,162,56,147,11,136
"2011","North East Lincolnshire 008C","E01013231","Total",708,210,50,160,242,104,153,39,114
"2011","North East Lincolnshire 008D","E01013233","Total",618,156,31,125,197,81,105,17,88
"2011","North East Lincolnshire 009A","E01013147","Total",607,261,53,208,182,88,188,38,150
"2011","North East Lincolnshire 009D","E01013234","Total",656,231,22,209,178,86,169,15,154
"2011","North East Lincolnshire 009E","E01033414","Total",970,301,43,258,258,108,210,42,168
"2011","North East Lincolnshire 010A","E01013128","Total",616,213,45,168,197,89,161,35,126
"2011","North East Lincolnshire 010B","E01013198","Total",613,181,25,156,178,72,157,23,134
"2011","North East Lincolnshire 010C","E01013199","Total",541,158,52,106,149,69,123,21,102
"2011","North East Lincolnshire 010D","E01013200","Total",511,137,9,128,168,43,118,26,92
"2011","North East Lincolnshire 011A","E01013159","Total",613,222,82,140,234,122,145,41,104
"2011","North East Lincolnshire 011B","E01013161","Total",566,197,73,124,237,109,150,43,107
"2011","North East Lincolnshire 011C","E01013162","Total",670,212,51,161,218,93,153,36,117
"2011","North East Lincolnshire 011D","E01013165","Total",602,244,66,178,184,89,152,28,124
"2011","North East Lincolnshire 012A","E01013158","Total",599,183,20,163,191,77,139,24,115
"2011","North East Lincolnshire 012B","E01013160","Total",655,189,16,173,161,54,147,20,127
"2011","North East Lincolnshire 012C","E01013163","Total",605,254,9,245,108,40,152,10,142
"2011","North East Lincolnshire 012D","E01013164","Total",715,218,42,176,259,123,148,31,117
"2011","North East Lincolnshire 012E","E01013197","Total",524,163,21,142,170,64,123,20,103
"2011","North East Lincolnshire 013A","E01013149","Total",485,152,8,144,127,29,113,15,98
"2011","North East Lincolnshire 013B","E01013150","Total",522,134,16,118,149,50,112,19,93
"2011","North East Lincolnshire 013C","E01013227","Total",751,313,29,284,175,61,236,30,206
"2011","North East Lincolnshire 013D","E01013228","Total",691,141,18,123,201,75,117,20,97
"2011","North East Lincolnshire 013E","E01013229","Total",575,217,69,148,245,97,146,43,103
"2011","North East Lincolnshire 014A","E01013131","Total",778,336,50,286,177,73,219,14,205
"2011","North East Lincolnshire 014B","E01013132","Total",635,228,21,207,170,71,171,26,145
"2011","North East Lincolnshire 014C","E01013133","Total",772,245,35,210,172,74,186,25,161
"2011","North East Lincolnshire 014D","E01013134","Total",691,339,32,307,158,58,229,23,206
"2011","North East Lincolnshire 015A","E01013206","Total",593,288,60,228,178,73,185,32,153
"2011","North East Lincolnshire 015B","E01013207","Total",604,257,26,231,138,55,175,22,153
"2011","North East Lincolnshire 015C","E01013211","Total",642,221,26,195,182,87,165,23,142
"2011","North East Lincolnshire 015D","E01013212","Total",599,326,102,224,219,95,195,44,151
"2011","North East Lincolnshire 016A","E01013181","Total",616,204,78,126,249,108,139,42,97
"2011","North East Lincolnshire 016B","E01013182","Total",636,250,4,246,123,35,158,11,147
"2011","North East Lincolnshire 016C","E01013183","Total",639,178,16,162,198,68,143,23,120
"2011","North East Lincolnshire 016D","E01013184","Total",643,193,25,168,159,71,138,27,111
"2011","North East Lincolnshire 016E","E01013185","Total",657,189,19,170,206,86,140,35,105
"2011","North East Lincolnshire 016F","E01013186","Total",502,111,3,108,177,55,88,12,76
"2011","North East Lincolnshire 017A","E01013129","Total",728,233,33,200,187,82,178,35,143
"2011","North East Lincolnshire 017B","E01013151","Total",520,192,6,186,138,34,134,12,122
"2011","North East Lincolnshire 017C","E01013152","Total",620,248,3,245,160,54,148,17,131
"2011","North East Lincolnshire 017D","E01013155","Total",626,236,9,227,143,52,157,14,143
"2011","North East Lincolnshire 018A","E01013130","Total",627,306,34,272,153,47,239,34,205
"2011","North East Lincolnshire 018B","E01013135","Total",758,426,24,402,112,42,260,21,239
"2011","North East Lincolnshire 018C","E01013154","Total",619,253,10,243,130,34,162,22,140
"2011","North East Lincolnshire 018D","E01013156","Total",661,411,13,398,89,30,259,14,245
"2011","North East Lincolnshire 019A","E01013204","Total",586,254,48,206,179,68,199,27,172
"2011","North East Lincolnshire 019B","E01013205","Total",519,265,109,156,235,101,160,47,113
"2011","North East Lincolnshire 019C","E01013208","Total",520,277,136,141,262,132,178,69,109
"2011","North East Lincolnshire 019D","E01013209","Total",676,392,96,296,210,100,250,40,210
"2011","North East Lincolnshire 019E","E01013210","Total",536,274,131,143,260,137,159,54,105
"2011","North East Lincolnshire 020A","E01013153","Total",643,305,6,299,99,27,171,15,156
"2011","North East Lincolnshire 020B","E01013157","Total",735,177,7,170,264,71,136,25,111
"2011","North East Lincolnshire 020C","E01013166","Total",692,283,5,278,155,43,171,21,150
"2011","North East Lincolnshire 020D","E01013167","Total",808,342,5,337,172,46,224,29,195
"2011","North East Lincolnshire 020E","E01013169","Total",528,269,6,263,91,29,187,11,176
"2011","North East Lincolnshire 021A","E01013189","Total",641,255,11,244,163,45,177,18,159
"2011","North East Lincolnshire 021B","E01013190","Total",1075,233,24,209,421,174,193,43,150
"2011","North East Lincolnshire 021C","E01013191","Total",642,230,6,224,171,59,160,27,133
"2011","North East Lincolnshire 021D","E01013192","Total",744,369,24,345,169,58,290,26,264
"2011","North East Lincolnshire 021E","E01013194","Total",677,315,15,300,153,52,206,21,185
"2011","North East Lincolnshire 022A","E01013168","Total",709,264,2,262,159,48,196,16,180
"2011","North East Lincolnshire 022B","E01013170","Total",665,246,12,234,172,46,177,18,159
"2011","North East Lincolnshire 022C","E01013171","Total",625,130,8,122,281,96,108,33,75
"2011","North East Lincolnshire 022D","E01013172","Total",682,286,6,280,137,41,193,14,179
"2011","North East Lincolnshire 022E","E01013193","Total",728,308,5,303,140,34,216,23,193
"2011","North East Lincolnshire 023A","E01013213","Total",625,335,14,321,114,36,222,15,207
"2011","North East Lincolnshire 023B","E01013214","Total",637,255,7,248,131,38,144,22,122
"2011","North East Lincolnshire 023C","E01013215","Total",620,210,3,207,168,58,124,23,101
"2011","North East Lincolnshire 023D","E01013216","Total",511,118,9,109,190,55,101,16,85
"2011","North East Lincolnshire 023E","E01013217","Total",623,212,8,204,155,51,133,13,120
"2011","North East Lincolnshire 023F","E01013225","Total",429,133,4,129,95,21,85,13,72
"2011","North Lincolnshire 001A","E01013254","Total",814,352,44,308,205,82,246,30,216
"2011","North Lincolnshire 001B","E01013255","Total",832,326,24,302,156,54,234,26,208
"2011","North Lincolnshire 001C","E01013256","Total",1029,275,36,239,356,150,233,50,183
"2011","North Lincolnshire 001D","E01013257","Total",746,229,7,222,189,54,187,29,158
"2011","North Lincolnshire 001E","E01013258","Total",712,263,36,227,228,102,215,39,176
"2011","North Lincolnshire 001F","E01013259","Total",683,294,73,221,245,107,188,43,145
"2011","North Lincolnshire 002A","E01013303","Total",579,209,13,196,147,47,180,25,155
"2011","North Lincolnshire 002B","E01013304","Total",659,198,12,186,193,60,161,29,132
"2011","North Lincolnshire 002C","E01013305","Total",651,172,10,162,193,71,131,27,104
"2011","North Lincolnshire 002D","E01013307","Total",747,254,25,229,199,77,196,29,167
"2011","North Lincolnshire 003A","E01013288","Total",647,202,15,187,195,82,147,22,125
"2011","North Lincolnshire 003B","E01013291","Total",604,224,62,162,247,107,195,49,146
"2011","North Lincolnshire 003C","E01013292","Total",750,247,15,232,187,58,196,38,158
"2011","North Lincolnshire 003D","E01013294","Total",666,230,18,212,180,48,190,34,156
"2011","North Lincolnshire 004A","E01013270","Total",829,244,22,222,244,91,218,30,188
"2011","North Lincolnshire 004B","E01013306","Total",658,218,20,198,193,72,181,24,157
"2011","North Lincolnshire 004C","E01013308","Total",746,243,27,216,204,73,216,31,185
"2011","North Lincolnshire 004D","E01013309","Total",702,225,13,212,173,62,189,33,156
"2011","North Lincolnshire 005A","E01013286","Total",1159,530,35,495,214,110,341,24,317
"2011","North Lincolnshire 005B","E01013287","Total",698,242,8,234,130,55,176,15,161
"2011","North Lincolnshire 005C","E01013289","Total",704,191,2,189,205,75,163,24,139
"2011","North Lincolnshire 005D","E01013290","Total",728,262,12,250,159,46,200,35,165
"2011","North Lincolnshire 005E","E01013293","Total",667,260,6,254,167,68,181,24,157
"2011","North Lincolnshire 006A","E01013245","Total",609,219,39,180,202,88,169,27,142
"2011","North Lincolnshire 006B","E01013246","Total",638,196,20,176,164,55,178,25,153
"2011","North Lincolnshire 006C","E01013247","Total",711,222,20,202,218,65,179,37,142
"2011","North Lincolnshire 006D","E01013248","Total",760,247,10,237,188,69,191,27,164
"2011","North Lincolnshire 006E","E01013249","Total",747,251,30,221,248,97,196,30,166
"2011","North Lincolnshire 007A","E01013297","Total",876,208,10,198,266,141,210,33,177
"2011","North Lincolnshire 007B","E01013300","Total",629,202,41,161,217,123,178,42,136
"2011","North Lincolnshire 007C","E01013302","Total",557,159,12,147,162,59,112,15,97
"2011","North Lincolnshire 007D","E01013331","Total",845,390,40,350,180,92,304,32,272
"2011","North Lincolnshire 008A","E01013296","Total",648,186,59,127,241,124,133,36,97
"2011","North Lincolnshire 008B","E01013298","Total",534,213,97,116,258,122,158,63,95
"2011","North Lincolnshire 008C","E01013299","Total",657,318,90,228,246,114,238,53,185
"2011","North Lincolnshire 008D","E01013330","Total",778,266,51,215,194,111,183,28,155
"2011","North Lincolnshire 008E","E01013332","Total",660,220,55,165,239,118,162,43,119
"2011","North Lincolnshire 009A","E01013295","Total",596,229,12,217,140,38,149,23,126
"2011","North Lincolnshire 009B","E01013301","Total",654,186,27,159,221,93,135,31,104
"2011","North Lincolnshire 009C","E01013333","Total",620,155,14,141,206,93,133,26,107
"2011","North Lincolnshire 009D","E01013334","Total",648,190,17,173,197,78,152,33,119
"2011","North Lincolnshire 010A","E01013310","Total",614,219,35,184,207,78,158,36,122
"2011","North Lincolnshire 010B","E01013312","Total",800,294,79,215,281,122,256,61,195
"2011","North Lincolnshire 010C","E01013313","Total",670,195,16,179,199,84,184,29,155
"2011","North Lincolnshire 010D","E01013314","Total",631,181,19,162,198,86,175,33,142
"2011","North Lincolnshire 011A","E01013267","Total",507,167,9,158,147,53,110,21,89
"2011","North Lincolnshire 011B","E01013268","Total",567,215,23,192,136,41,145,20,125
"2011","North Lincolnshire 011C","E01013269","Total",720,224,11,213,196,64,178,24,154
"2011","North Lincolnshire 011D","E01013271","Total",768,244,42,202,267,108,201,45,156
"2011","North Lincolnshire 011E","E01013272","Total",832,348,28,320,163,59,275,30,245
"2011","North Lincolnshire 011F","E01013273","Total",757,289,7,282,154,59,189,14,175
"2011","North Lincolnshire 012A","E01013279","Total",716,366,71,295,190,106,236,32,204
"2011","North Lincolnshire 012B","E01013285","Total",524,154,5,149,131,42,111,9,102
"2011","North Lincolnshire 012C","E01013316","Total",588,172,4,168,166,50,144,21,123
"2011","North Lincolnshire 012D","E01013321","Total",665,179,9,170,209,68,143,22,121
"2011","North Lincolnshire 013A","E01013274","Total",818,198,10,188,236,90,176,31,145
"2011","North Lincolnshire 013B","E01013275","Total",650,210,10,200,195,55,162,26,136
"2011","North Lincolnshire 013C","E01013276","Total",730,306,23,283,191,64,234,35,199
"2011","North Lincolnshire 013D","E01013277","Total",636,194,8,186,175,47,148,25,123
"2011","North Lincolnshire 014A","E01013315","Total",776,427,29,398,141,60,306,26,280
"2011","North Lincolnshire 014B","E01013317","Total",558,180,16,164,169,46,159,24,135
"2011","North Lincolnshire 014C","E01013318","Total",625,201,20,181,199,65,178,33,145
"2011","North Lincolnshire 014D","E01013319","Total",920,301,87,214,362,178,236,62,174
"2011","North Lincolnshire 015A","E01013238","Total",769,293,28,265,202,85,255,41,214
"2011","North Lincolnshire 015B","E01013240","Total",987,327,60,267,327,165,282,60,222
"2011","North Lincolnshire 015C","E01013311","Total",772,365,101,264,274,135,256,55,201
"2011","North Lincolnshire 015D","E01013320","Total",636,221,26,195,199,88,192,32,160
"2011","North Lincolnshire 016A","E01013278","Total",641,325,81,244,222,109,218,42,176
"2011","North Lincolnshire 016B","E01013280","Total",601,208,28,180,170,83,150,20,130
"2011","North Lincolnshire 016C","E01013281","Total",517,201,62,139,220,98,156,48,108
"2011","North Lincolnshire 016D","E01013283","Total",530,216,73,143,222,103,154,51,103
"2011","North Lincolnshire 017A","E01013236","Total",728,311,14,297,174,80,225,17,208
"2011","North Lincolnshire 017B","E01013239","Total",714,249,26,223,170,78,186,23,163
"2011","North Lincolnshire 017C","E01013282","Total",624,239,52,187,223,89,197,44,153
"2011","North Lincolnshire 017D","E01013284","Total",645,279,62,217,225,100,211,53,158
"2011","North Lincolnshire 018B","E01013237","Total",647,275,80,195,279,116,196,55,141
"2011","North Lincolnshire 018C","E01013261","Total",640,251,4,247,152,62,157,18,139
"2011","North Lincolnshire 018D","E01013262","Total",598,231,7,224,130,48,152,12,140
"2011","North Lincolnshire 018E","E01013263","Total",666,271,9,262,136,42,169,17,152
"2011","North Lincolnshire 018F","E01033296","Total",601,195,15,180,173,86,152,25,127
"2011","North Lincolnshire 018G","E01033297","Total",652,47,15,32,306,161,57,22,35
"2011","North Lincolnshire 019A","E01013260","Total",660,282,5,277,148,35,175,23,152
"2011","North Lincolnshire 019B","E01013264","Total",746,222,16,206,210,84,188,26,162
"2011","North Lincolnshire 019C","E01013265","Total",726,281,2,279,159,46,195,22,173
"2011","North Lincolnshire 019D","E01013266","Total",835,234,10,224,232,87,178,26,152
"2011","North Lincolnshire 020A","E01013241","Total",725,309,11,298,139,50,204,23,181
"2011","North Lincolnshire 020B","E01013242","Total",709,185,12,173,206,61,182,26,156
"2011","North Lincolnshire 020C","E01013243","Total",871,233,22,211,288,100,187,33,154
"2011","North Lincolnshire 020D","E01013244","Total",790,292,29,263,241,88,218,32,186
"2011","North Lincolnshire 021A","E01013324","Total",627,173,5,168,174,58,142,24,118
"2011","North Lincolnshire 021B","E01013326","Total",696,275,14,261,155,48,204,24,180
"2011","North Lincolnshire 021C","E01013327","Total",697,323,11,312,124,43,202,15,187
"2011","North Lincolnshire 021D","E01013328","Total",519,157,11,146,173,46,103,16,87
"2011","North Lincolnshire 022A","E01013322","Total",806,246,22,224,252,103,203,40,163
"2011","North Lincolnshire 022B","E01013323","Total",670,199,15,184,195,80,170,36,134
"2011","North Lincolnshire 022C","E01013325","Total",650,235,8,227,147,42,163,22,141
"2011","North Lincolnshire 022D","E01013329","Total",773,260,27,233,214,85,218,32,186
"2011","North Lincolnshire 023A","E01013250","Total",703,272,16,256,172,54,209,25,184
"2011","North Lincolnshire 023B","E01013251","Total",768,232,6,226,184,51,183,25,158
"2011","North Lincolnshire 023C","E01013252","Total",695,246,16,230,228,74,172,35,137
"2011","North Lincolnshire 023D","E01013253","Total",801,241,20,221,248,74,210,46,164
"2011","York 001A","E01013436","Total",626,133,6,127,263,107,113,38,75
"2011","York 001B","E01013438","Total",733,233,14,219,242,86,165,25,140
"2011","York 001C","E01013439","Total",527,111,5,106,231,77,74,21,53
"2011","York 001D","E01013440","Total",787,234,11,223,224,81,162,25,137
"2011","York 002A","E01013370","Total",756,341,4,337,144,56,214,13,201
"2011","York 002B","E01013373","Total",635,257,6,251,165,68,187,23,164
"2011","York 002C","E01013375","Total",598,238,3,235,123,37,139,13,126
"2011","York 002D","E01013376","Total",635,225,3,222,143,55,158,15,143
"2011","York 003A","E01013371","Total",588,160,4,156,178,59,113,14,99
"2011","York 003B","E01013372","Total",805,390,1,389,133,47,261,10,251
"2011","York 003C","E01013374","Total",594,167,3,164,193,70,116,21,95
"2011","York 003D","E01013377","Total",659,182,6,176,190,66,127,17,110
"2011","York 004A","E01013404","Total",647,213,10,203,169,56,198,23,175
"2011","York 004B","E01013407","Total",672,330,10,320,125,48,205,15,190
"2011","York 004C","E01013408","Total",626,314,7,307,101,25,195,8,187
"2011","York 004D","E01013410","Total",620,249,34,215,189,66,215,33,182
"2011","York 005A","E01013405","Total",611,207,3,204,143,49,141,20,121
"2011","York 005B","E01013406","Total",835,177,17,160,262,110,158,29,129
"2011","York 005C","E01013409","Total",705,277,7,270,161,62,222,22,200
"2011","York 005D","E01013411","Total",713,329,5,324,155,50,215,18,197
"2011","York 006A","E01013428","Total",701,181,19,162,221,88,146,33,113
"2011","York 006B","E01013429","Total",808,101,15,86,328,137,110,39,71
"2011","York 006C","E01013430","Total",656,200,6,194,185,65,157,29,128
"2011","York 006D","E01013431","Total",656,115,15,100,249,115,104,26,78
"2011","York 006E","E01013435","Total",630,201,10,191,182,62,137,21,116
"2011","York 007A","E01013344","Total",677,180,4,176,132,53,125,11,114
"2011","York 007B","E01013346","Total",810,303,18,285,146,55,215,19,196
"2011","York 007C","E01013432","Total",865,234,12,222,284,118,157,28,129
"2011","York 007D","E01013433","Total",651,244,1,243,162,54,159,14,145
"2011","York 007E","E01013434","Total",616,205,7,198,154,45,139,20,119
"2011","York 008A","E01013379","Total",614,204,10,194,179,68,152,16,136
"2011","York 008B","E01013380","Total",716,226,5,221,149,65,151,13,138
"2011","York 008C","E01013385","Total",635,228,30,198,185,86,190,26,164
"2011","York 008D","E01013387","Total",679,297,4,293,149,41,160,13,147
"2011","York 008E","E01013388","Total",503,221,4,217,85,26,142,10,132
"2011","York 008F","E01013389","Total",505,185,5,180,125,36,127,18,109
"2011","York 008G","E01013437","Total",525,167,8,159,126,32,104,10,94
"2011","York 009A","E01013343","Total",839,206,17,189,162,74,176,20,156
"2011","York 009B","E01013345","Total",786,209,16,193,149,73,180,19,161
"2011","York 009C","E01013347","Total",667,246,46,200,221,98,180,38,142
"2011","York 009D","E01013349","Total",523,173,59,114,216,108,135,41,94
"2011","York 009E","E01013350","Total",678,244,39,205,189,86,186,32,154
"2011","York 010A","E01013348","Total",672,135,21,114,150,65,104,18,86
"2011","York 010B","E01013368","Total",937,181,15,166,176,76,156,23,133
"2011","York 010C","E01013382","Total",760,260,43,217,196,83,175,31,144
"2011","York 010D","E01013383","Total",1031,271,43,228,218,102,216,44,172
"2011","York 010E","E01013386","Total",761,257,45,212,229,100,204,50,154
"2011","York 011A","E01013421","Total",524,157,7,150,140,43,124,18,106
"2011","York 011B","E01013422","Total",644,156,10,146,243,85,116,20,96
"2011","York 011C","E01013426","Total",718,304,6,298,165,57,202,18,184
"2011","York 011D","E01013427","Total",605,268,6,262,161,55,139,25,114
"2011","York 012A","E01013335","Total",639,225,45,180,217,91,204,38,166
"2011","York 012B","E01013336","Total",638,227,16,211,154,61,147,23,124
"2011","York 012C","E01013337","Total",697,200,11,189,190,75,153,20,133
"2011","York 012D","E01013338","Total",902,236,26,210,306,136,177,35,142
"2011","York 012E","E01013339","Total",644,214,10,204,204,87,158,18,140
"2011","York 012F","E01013392","Total",632,152,8,144,194,75,134,15,119
"2011","York 013A","E01013366","Total",975,298,9,289,115,52,225,15,210
"2011","York 013C","E01013369","Total",982,353,21,332,106,48,263,17,246
"2011","York 013E","E01013416","Total",791,289,42,247,169,79,214,35,179
"2011","York 013F","E01033067","Total",733,257,35,222,109,64,178,16,162
"2011","York 013G","E01033068","Total",683,181,12,169,59,32,107,5,102
"2011","York 013H","E01033069","Total",645,190,14,176,81,44,115,13,102
"2011","York 013I","E01033070","Total",702,235,4,231,48,25,105,6,99
"2011","York 014A","E01013381","Total",615,176,8,168,188,66,144,21,123
"2011","York 014B","E01013402","Total",641,265,4,261,125,34,159,19,140
"2011","York 014C","E01013419","Total",652,269,8,261,143,46,179,16,163
"2011","York 014D","E01013420","Total",854,284,3,281,219,77,189,21,168
"2011","York 015A","E01013384","Total",653,214,30,184,188,73,192,38,154
"2011","York 015B","E01013398","Total",556,172,25,147,160,73,129,25,104
"2011","York 015C","E01013399","Total",682,263,86,177,276,119,178,43,135
"2011","York 015D","E01013400","Total",862,226,32,194,120,70,136,15,121
"2011","York 015E","E01013401","Total",593,177,28,149,154,61,117,28,89
"2011","York 015F","E01013403","Total",650,248,15,233,120,46,134,14,120
"2011","York 016A","E01013393","Total",730,157,16,141,201,85,139,25,114
"2011","York 016B","E01013394","Total",663,265,48,217,175,93,211,29,182
"2011","York 016C","E01013395","Total",650,161,9,152,179,84,124,20,104
"2011","York 016D","E01013396","Total",767,300,17,283,174,82,207,22,185
"2011","York 016E","E01013441","Total",697,195,20,175,166,77,162,16,146
"2011","York 016F","E01013445","Total",769,336,46,290,193,108,268,32,236
"2011","York 017A","E01013390","Total",796,137,17,120,172,94,128,20,108
"2011","York 017B","E01013391","Total",1049,188,28,160,212,119,152,23,129
"2011","York 017C","E01013397","Total",643,174,6,168,178,72,143,16,127
"2011","York 017D","E01013413","Total",727,153,9,144,193,91,124,17,107
"2011","York 017E","E01013417","Total",838,221,8,213,200,83,138,16,122
"2011","York 018A","E01013442","Total",615,217,26,191,162,61,162,21,141
"2011","York 018B","E01013443","Total",709,313,53,260,193,96,231,31,200
"2011","York 018C","E01013444","Total",585,217,60,157,222,118,164,26,138
"2011","York 018D","E01013446","Total",700,224,30,194,231,103,177,33,144
"2011","York 018E","E01013447","Total",617,198,40,158,205,86,197,40,157
"2011","York 018F","E01013448","Total",604,202,43,159,198,102,162,36,126
"2011","York 019A","E01013360","Total",648,171,13,158,258,133,105,25,80
"2011","York 019B","E01013361","Total",799,151,18,133,202,96,124,23,101
"2011","York 019C","E01013362","Total",772,308,14,294,170,67,219,30,189
"2011","York 019D","E01013363","Total",861,267,24,243,131,58,172,16,156
"2011","York 019E","E01013364","Total",865,254,19,235,133,53,166,14,152
"2011","York 019F","E01013418","Total",798,243,15,228,161,67,197,27,170
"2011","York 020A","E01013351","Total",761,275,5,270,212,49,183,31,152
"2011","York 020B","E01013352","Total",758,329,6,323,181,65,209,25,184
"2011","York 020C","E01013451","Total",468,96,7,89,172,46,84,17,67
"2011","York 020D","E01013452","Total",640,212,4,208,230,80,154,32,122
"2011","York 021A","E01013357","Total",808,283,9,274,259,86,157,26,131
"2011","York 021B","E01013358","Total",671,182,3,179,188,73,138,21,117
"2011","York 021C","E01013412","Total",881,176,17,159,194,100,140,24,116
"2011","York 021D","E01013414","Total",770,178,15,163,183,84,136,19,117
"2011","York 022A","E01013353","Total",727,275,20,255,189,70,225,29,196
"2011","York 022B","E01013354","Total",613,147,3,144,152,59,108,14,94
"2011","York 022C","E01013355","Total",710,296,5,291,111,40,160,11,149
"2011","York 022D","E01013356","Total",654,233,10,223,155,54,155,24,131
"2011","York 022E","E01013359","Total",660,204,30,174,209,81,177,30,147
"2011","York 022F","E01013449","Total",708,221,30,191,223,86,161,26,135
"2011","York 023A","E01013365","Total",1181,448,16,432,288,90,310,49,261
"2011","York 023B","E01013378","Total",480,186,36,150,116,47,95,16,79
"2011","York 023C","E01013450","Total",512,160,13,147,143,46,104,14,90
"2011","York 024A","E01013340","Total",521,170,4,166,165,62,93,15,78
"2011","York 024B","E01013341","Total",616,300,4,296,131,41,195,17,178
"2011","York 024C","E01013342","Total",599,219,3,216,139,41,150,16,134
"2011","York 024D","E01013423","Total",533,187,6,181,145,50,113,21,92
"2011","York 024E","E01013424","Total",506,116,5,111,179,52,72,17,55
"2011","York 024F","E01013425","Total",688,216,7,209,209,64,146,18,128
"2011","Craven 001A","E01027558","Total",845,289,10,279,180,54,213,18,195
"2011","Craven 001B","E01027559","Total",781,285,24,261,189,65,235,38,197
"2011","Craven 001C","E01027569","Total",589,200,4,196,129,42,160,22,138
"2011","Craven 001D","E01027570","Total",1099,388,14,374,247,84,279,35,244
"2011","Craven 002A","E01027562","Total",669,197,3,194,154,36,129,22,107
"2011","Craven 002B","E01027567","Total",789,330,11,319,146,41,209,28,181
"2011","Craven 002C","E01027585","Total",832,364,9,355,148,32,228,20,208
"2011","Craven 003A","E01027568","Total",942,317,11,306,235,75,231,42,189
"2011","Craven 003B","E01027571","Total",782,291,10,281,172,43,185,16,169
"2011","Craven 003C","E01027572","Total",998,368,11,357,213,54,257,29,228
"2011","Craven 003D","E01027573","Total",699,290,3,287,144,34,210,27,183
"2011","Craven 004A","E01027557","Total",655,171,3,168,176,48,129,10,119
"2011","Craven 004B","E01027561","Total",831,298,13,285,210,73,211,28,183
"2011","Craven 004C","E01027576","Total",668,267,3,264,170,30,173,23,150
"2011","Craven 005A","E01027574","Total",646,233,3,230,150,51,155,22,133
"2011","Craven 005B","E01027575","Total",879,345,12,333,204,63,250,34,216
"2011","Craven 005C","E01027577","Total",929,307,12,295,223,66,248,27,221
"2011","Craven 005D","E01027579","Total",533,209,35,174,157,57,180,30,150
"2011","Craven 006A","E01027578","Total",737,186,17,169,184,70,156,23,133
"2011","Craven 006B","E01027580","Total",486,202,29,173,150,55,174,36,138
"2011","Craven 006C","E01027581","Total",1141,396,39,357,281,143,294,46,248
"2011","Craven 006D","E01027582","Total",678,206,9,197,175,68,170,26,144
"2011","Craven 007A","E01027556","Total",703,194,1,193,206,66,151,25,126
"2011","Craven 007B","E01027560","Total",977,221,23,198,325,141,185,38,147
"2011","Craven 007C","E01027563","Total",681,287,9,278,126,39,196,18,178
"2011","Craven 007D","E01027586","Total",854,254,8,246,206,71,176,23,153
"2011","Craven 008A","E01027555","Total",826,288,7,281,219,71,186,18,168
"2011","Craven 008B","E01027564","Total",569,233,12,221,118,43,204,27,177
"2011","Craven 008C","E01027565","Total",657,210,6,204,205,66,129,13,116
"2011","Craven 008D","E01027566","Total",535,155,9,146,144,52,113,16,97
"2011","Craven 008E","E01027583","Total",845,268,14,254,276,94,196,34,162
"2011","Craven 008F","E01027584","Total",728,267,11,256,187,53,195,19,176
"2011","Hambleton 001A","E01027591","Total",730,237,8,229,163,44,157,26,131
"2011","Hambleton 001B","E01027597","Total",687,247,6,241,169,38,161,13,148
"2011","Hambleton 001C","E01027599","Total",801,321,27,294,203,66,250,31,219
"2011","Hambleton 001D","E01027623","Total",584,258,9,249,147,51,150,17,133
"2011","Hambleton 001E","E01027625","Total",772,368,45,323,194,66,259,41,218
"2011","Hambleton 002A","E01027598","Total",855,425,8,417,148,33,217,25,192
"2011","Hambleton 002B","E01027618","Total",1042,388,8,380,250,65,225,25,200
"2011","Hambleton 002C","E01027624","Total",527,190,9,181,163,47,117,22,95
"2011","Hambleton 002D","E01027626","Total",584,229,13,216,128,31,167,22,145
"2011","Hambleton 002E","E01027627","Total",803,253,5,248,180,49,159,20,139
"2011","Hambleton 003A","E01027590","Total",982,325,19,306,225,68,277,31,246
"2011","Hambleton 003B","E01027592","Total",758,209,3,206,156,35,156,15,141
"2011","Hambleton 003C","E01027613","Total",767,226,3,223,182,48,179,29,150
"2011","Hambleton 003D","E01027617","Total",451,123,6,117,108,35,110,19,91
"2011","Hambleton 004A","E01027605","Total",728,171,10,161,190,86,159,27,132
"2011","Hambleton 004B","E01027606","Total",692,276,7,269,160,53,182,17,165
"2011","Hambleton 004C","E01027608","Total",731,190,20,170,206,81,188,25,163
"2011","Hambleton 004D","E01027609","Total",548,129,41,88,223,94,116,34,82
"2011","Hambleton 004E","E01027610","Total",733,225,23,202,204,88,196,28,168
"2011","Hambleton 004F","E01027611","Total",925,406,8,398,170,59,291,19,272
"2011","Hambleton 004G","E01027612","Total",757,322,48,274,226,102,252,35,217
"2011","Hambleton 004H","E01027616","Total",661,236,17,219,185,61,182,23,159
"2011","Hambleton 005A","E01027603","Total",789,253,11,242,216,69,181,29,152
"2011","Hambleton 005B","E01027604","Total",762,217,7,210,188,74,181,30,151
"2011","Hambleton 005C","E01027607","Total",550,229,2,227,99,25,143,10,133
"2011","Hambleton 005D","E01027614","Total",565,225,3,222,118,40,140,12,128
"2011","Hambleton 005E","E01027615","Total",504,160,4,156,164,32,97,16,81
"2011","Hambleton 006A","E01027587","Total",623,274,4,270,138,37,199,18,181
"2011","Hambleton 006B","E01027588","Total",677,201,5,196,190,44,160,18,142
"2011","Hambleton 006C","E01027589","Total",714,217,5,212,183,53,185,20,165
"2011","Hambleton 006D","E01027593","Total",751,237,6,231,189,60,167,25,142
"2011","Hambleton 007B","E01027628","Total",766,196,10,186,216,76,189,28,161
"2011","Hambleton 007C","E01027633","Total",788,225,7,218,196,72,173,24,149
"2011","Hambleton 007D","E01033065","Total",473,102,6,96,179,66,122,33,89
"2011","Hambleton 007E","E01033066","Total",548,74,4,70,313,166,90,33,57
"2011","Hambleton 008A","E01027620","Total",808,227,17,210,264,99,193,39,154
"2011","Hambleton 008B","E01027630","Total",869,285,20,265,169,64,223,32,191
"2011","Hambleton 008C","E01027631","Total",677,274,5,269,147,49,188,21,167
"2011","Hambleton 008D","E01027632","Total",595,156,8,148,191,66,122,31,91
"2011","Hambleton 008E","E01027637","Total",823,239,4,235,186,49,203,29,174
"2011","Hambleton 009A","E01027621","Total",1000,383,24,359,237,76,263,34,229
"2011","Hambleton 009B","E01027629","Total",615,263,25,238,180,77,182,27,155
"2011","Hambleton 009C","E01027635","Total",925,211,15,196,316,143,186,33,153
"2011","Hambleton 009D","E01027636","Total",870,272,10,262,215,69,189,25,164
"2011","Hambleton 010A","E01027594","Total",737,324,14,310,159,64,235,17,218
"2011","Hambleton 010B","E01027595","Total",740,270,13,257,190,76,177,21,156
"2011","Hambleton 010C","E01027596","Total",731,345,3,342,132,36,202,12,190
"2011","Hambleton 010D","E01027601","Total",791,207,4,203,247,74,161,28,133
"2011","Hambleton 010E","E01027622","Total",798,244,8,236,219,56,178,24,154
"2011","Hambleton 011A","E01027600","Total",773,176,9,167,246,65,134,23,111
"2011","Hambleton 011B","E01027619","Total",952,207,16,191,362,147,169,44,125
"2011","Hambleton 011C","E01027634","Total",785,176,14,162,285,92,145,31,114
"2011","Harrogate 001A","E01027666","Total",720,211,12,199,196,65,167,21,146
"2011","Harrogate 001B","E01027667","Total",563,147,13,134,180,45,119,20,99
"2011","Harrogate 001C","E01027685","Total",592,238,8,230,108,41,176,17,159
"2011","Harrogate 001D","E01027686","Total",461,104,9,95,128,47,90,24,66
"2011","Harrogate 002A","E01027712","Total",505,135,11,124,198,56,103,24,79
"2011","Harrogate 002B","E01027713","Total",754,269,15,254,190,77,197,25,172
"2011","Harrogate 002C","E01027714","Total",740,270,13,257,182,73,193,25,168
"2011","Harrogate 002D","E01027715","Total",411,92,4,88,188,94,86,15,71
"2011","Harrogate 003A","E01027643","Total",631,204,11,193,160,54,174,25,149
"2011","Harrogate 003B","E01027688","Total",681,238,6,232,161,50,175,21,154
"2011","Harrogate 003C","E01027736","Total",658,159,10,149,179,73,148,16,132
"2011","Harrogate 003D","E01027737","Total",606,116,7,109,258,128,104,32,72
"2011","Harrogate 004A","E01027705","Total",706,153,9,144,221,80,148,18,130
"2011","Harrogate 004B","E01027706","Total",976,398,25,373,225,119,277,23,254
"2011","Harrogate 004C","E01027707","Total",792,247,18,229,209,75,187,26,161
"2011","Harrogate 004D","E01027708","Total",604,199,8,191,155,66,141,19,122
"2011","Harrogate 004E","E01027709","Total",507,188,2,186,121,39,131,17,114
"2011","Harrogate 004F","E01027710","Total",465,178,21,157,139,57,145,18,127
"2011","Harrogate 004G","E01027711","Total",499,123,17,106,182,66,132,26,106
"2011","Harrogate 005A","E01027644","Total",664,219,8,211,191,67,175,27,148
"2011","Harrogate 005B","E01027645","Total",677,202,13,189,177,57,142,20,122
"2011","Harrogate 005C","E01027647","Total",677,190,1,189,187,50,146,21,125
"2011","Harrogate 005D","E01027687","Total",617,168,5,163,174,47,134,20,114
"2011","Harrogate 006A","E01027681","Total",668,167,10,157,186,57,138,20,118
"2011","Harrogate 006B","E01027693","Total",745,195,5,190,207,69,136,19,117
"2011","Harrogate 006C","E01027701","Total",681,197,9,188,158,58,148,13,135
"2011","Harrogate 006D","E01027702","Total",551,215,8,207,114,41,141,9,132
"2011","Harrogate 007A","E01027642","Total",596,199,5,194,155,50,120,15,105
"2011","Harrogate 007B","E01027646","Total",669,205,9,196,175,53,153,18,135
"2011","Harrogate 007C","E01027674","Total",546,168,2,166,176,37,120,15,105
"2011","Harrogate 007D","E01027675","Total",938,255,15,240,332,123,170,36,134
"2011","Harrogate 008A","E01027641","Total",470,70,4,66,186,49,75,26,49
"2011","Harrogate 008B","E01027664","Total",895,296,15,281,281,122,229,36,193
"2011","Harrogate 008C","E01027665","Total",453,151,5,146,125,49,103,19,84
"2011","Harrogate 008D","E01027722","Total",539,62,7,55,239,76,74,27,47
"2011","Harrogate 009A","E01027668","Total",672,240,19,221,223,93,183,31,152
"2011","Harrogate 009B","E01027669","Total",934,433,16,417,183,69,316,25,291
"2011","Harrogate 009C","E01027673","Total",881,293,14,279,192,62,222,25,197
"2011","Harrogate 009D","E01027676","Total",686,171,25,146,264,99,160,40,120
"2011","Harrogate 010A","E01027638","Total",598,182,5,177,132,51,158,22,136
"2011","Harrogate 010B","E01027639","Total",546,175,5,170,168,55,108,22,86
"2011","Harrogate 010C","E01027640","Total",657,202,11,191,197,74,158,17,141
"2011","Harrogate 010D","E01027690","Total",632,207,5,202,154,64,171,24,147
"2011","Harrogate 010E","E01027738","Total",579,137,16,121,176,79,111,25,86
"2011","Harrogate 010F","E01027739","Total",458,98,8,90,138,70,105,16,89
"2011","Harrogate 010G","E01027741","Total",622,228,12,216,157,58,198,31,167
"2011","Harrogate 011A","E01027689","Total",635,151,15,136,174,80,147,27,120
"2011","Harrogate 011B","E01027691","Total",665,148,15,133,202,90,128,26,102
"2011","Harrogate 011C","E01027720","Total",653,188,25,163,198,87,153,29,124
"2011","Harrogate 011D","E01027721","Total",643,146,6,140,205,76,133,26,107
"2011","Harrogate 011E","E01027723","Total",740,240,35,205,191,68,190,29,161
"2011","Harrogate 012A","E01027670","Total",662,165,17,148,227,60,129,24,105
"2011","Harrogate 012B","E01027671","Total",621,199,5,194,202,44,138,24,114
"2011","Harrogate 012C","E01027672","Total",698,256,6,250,189,47,163,24,139
"2011","Harrogate 012D","E01027704","Total",500,172,4,168,127,46,120,16,104
"2011","Harrogate 013A","E01027649","Total",696,188,26,162,212,80,154,30,124
"2011","Harrogate 013B","E01027651","Total",600,209,40,169,228,87,206,49,157
"2011","Harrogate 013C","E01027657","Total",580,95,14,81,156,73,93,9,84
"2011","Harrogate 013D","E01027658","Total",740,174,35,139,196,106,131,21,110
"2011","Harrogate 013E","E01027692","Total",545,163,14,149,138,51,129,17,112
"2011","Harrogate 013F","E01027740","Total",940,571,20,551,117,44,442,25,417
"2011","Harrogate 014A","E01027648","Total",679,218,23,195,225,82,186,34,152
"2011","Harrogate 014B","E01027650","Total",625,188,18,170,201,63,166,25,141
"2011","Harrogate 014C","E01027726","Total",674,166,15,151,219,101,147,27,120
"2011","Harrogate 014D","E01027727","Total",673,204,12,192,189,76,164,26,138
"2011","Harrogate 014E","E01027728","Total",612,244,10,234,150,54,158,17,141
"2011","Harrogate 014F","E01027729","Total",682,144,30,114,248,105,138,32,106
"2011","Harrogate 015A","E01027652","Total",691,191,14,177,193,74,119,16,103
"2011","Harrogate 015B","E01027655","Total",535,178,3,175,125,39,111,12,99
"2011","Harrogate 015C","E01027659","Total",939,204,14,190,184,102,167,18,149
"2011","Harrogate 015D","E01027677","Total",685,173,3,170,114,57,117,15,102
"2011","Harrogate 015E","E01027678","Total",920,233,18,215,141,65,194,20,174
"2011","Harrogate 015F","E01027680","Total",727,187,5,182,129,53,139,11,128
"2011","Harrogate 016A","E01027683","Total",585,157,6,151,197,59,123,25,98
"2011","Harrogate 016B","E01027684","Total",588,162,16,146,185,45,113,18,95
"2011","Harrogate 016C","E01027695","Total",690,181,9,172,207,71,160,21,139
"2011","Harrogate 016D","E01027696","Total",549,119,7,112,177,47,107,23,84
"2011","Harrogate 016E","E01027703","Total",773,215,13,202,192,57,184,25,159
"2011","Harrogate 017A","E01027660","Total",640,266,7,259,162,52,189,21,168
"2011","Harrogate 017B","E01027661","Total",620,210,16,194,175,53,143,20,123
"2011","Harrogate 017C","E01027662","Total",447,112,3,109,159,51,85,10,75
"2011","Harrogate 017D","E01027663","Total",616,191,8,183,144,58,148,20,128
"2011","Harrogate 017E","E01027697","Total",588,176,13,163,211,79,131,27,104
"2011","Harrogate 017F","E01027733","Total",518,171,7,164,182,66,122,17,105
"2011","Harrogate 018A","E01027682","Total",674,197,7,190,181,74,142,15,127
"2011","Harrogate 018B","E01027694","Total",478,137,3,134,140,58,96,17,79
"2011","Harrogate 018C","E01027734","Total",647,174,8,166,170,61,99,9,90
"2011","Harrogate 018D","E01027735","Total",667,187,5,182,195,68,136,23,113
"2011","Harrogate 019A","E01027656","Total",872,338,5,333,144,56,231,12,219
"2011","Harrogate 019B","E01027679","Total",820,299,5,294,153,50,176,14,162
"2011","Harrogate 019C","E01027730","Total",688,195,16,179,202,79,111,20,91
"2011","Harrogate 019D","E01027731","Total",624,157,6,151,200,79,110,14,96
"2011","Harrogate 019E","E01027732","Total",544,166,2,164,146,41,96,12,84
"2011","Harrogate 020A","E01027653","Total",658,282,11,271,166,66,177,15,162
"2011","Harrogate 020B","E01027654","Total",487,150,8,142,153,41,82,20,62
"2011","Harrogate 020C","E01027698","Total",629,227,10,217,207,61,125,22,103
"2011","Harrogate 020D","E01027716","Total",603,252,7,245,171,53,127,14,113
"2011","Harrogate 020E","E01027717","Total",618,187,7,180,229,83,121,23,98
"2011","Harrogate 020F","E01027718","Total",746,222,12,210,298,96,140,38,102
"2011","Harrogate 020G","E01027719","Total",621,253,7,246,159,54,156,16,140
"2011","Harrogate 021A","E01027699","Total",515,189,5,184,167,42,88,12,76
"2011","Harrogate 021B","E01027700","Total",494,170,8,162,142,43,112,16,96
"2011","Harrogate 021C","E01027724","Total",655,193,7,186,200,55,125,16,109
"2011","Harrogate 021D","E01027725","Total",633,186,7,179,181,58,128,14,114
"2011","Richmondshire 001A","E01027743","Total",536,189,5,184,119,39,131,16,115
"2011","Richmondshire 001B","E01027751","Total",530,146,6,140,141,46,117,15,102
"2011","Richmondshire 001C","E01027752","Total",548,177,4,173,117,27,132,13,119
"2011","Richmondshire 001D","E01027759","Total",615,199,9,190,161,47,155,23,132
"2011","Richmondshire 001E","E01027761","Total",525,217,6,211,113,32,122,19,103
"2011","Richmondshire 001F","E01027762","Total",571,148,8,140,139,40,127,20,107
"2011","Richmondshire 002A","E01027765","Total",670,218,27,191,197,66,166,28,138
"2011","Richmondshire 002B","E01027766","Total",581,234,8,226,128,48,185,19,166
"2011","Richmondshire 002C","E01027767","Total",625,220,10,210,181,58,163,28,135
"2011","Richmondshire 002D","E01027768","Total",496,167,9,158,152,30,114,19,95
"2011","Richmondshire 002E","E01027769","Total",567,209,27,182,165,56,136,17,119
"2011","Richmondshire 002F","E01027770","Total",836,347,30,317,177,69,249,31,218
"2011","Richmondshire 003A","E01027745","Total",624,156,15,141,230,62,127,37,90
"2011","Richmondshire 003B","E01027746","Total",648,211,16,195,162,56,178,24,154
"2011","Richmondshire 003C","E01027747","Total",580,123,17,106,208,87,106,30,76
"2011","Richmondshire 003D","E01027748","Total",530,198,8,190,128,46,142,21,121
"2011","Richmondshire 004A","E01027749","Total",786,258,72,186,302,123,229,54,175
"2011","Richmondshire 004B","E01027750","Total",998,188,32,156,377,124,201,55,146
"2011","Richmondshire 004C","E01027754","Total",454,90,10,80,222,115,88,29,59
"2011","Richmondshire 004E","E01027771","Total",484,37,13,24,343,231,57,31,26
"2011","Richmondshire 004F","E01027772","Total",544,122,13,109,151,57,127,25,102
"2011","Richmondshire 004G","E01033183","Total",421,10,8,2,352,229,59,54,5
"2011","Richmondshire 004H","E01033184","Total",496,37,19,18,304,159,75,48,27
"2011","Richmondshire 005A","E01027742","Total",631,221,4,217,109,33,163,13,150
"2011","Richmondshire 005B","E01027753","Total",606,164,9,155,129,46,141,10,131
"2011","Richmondshire 005C","E01027763","Total",550,194,1,193,84,16,136,9,127
"2011","Richmondshire 005D","E01027764","Total",542,173,8,165,114,36,146,16,130
"2011","Richmondshire 005E","E01027773","Total",493,163,4,159,80,27,116,12,104
"2011","Richmondshire 006A","E01027744","Total",590,219,6,213,109,34,154,16,138
"2011","Richmondshire 006B","E01027756","Total",716,174,26,148,244,101,172,38,134
"2011","Richmondshire 006D","E01027758","Total",591,180,6,174,136,38,142,14,128
"2011","Richmondshire 006E","E01027760","Total",587,189,6,183,102,37,128,10,118
"2011","Richmondshire 006F","E01033185","Total",611,262,9,253,108,32,164,13,151
"2011","Richmondshire 006G","E01033186","Total",625,280,8,272,102,21,165,14,151
"2011","Ryedale 001A","E01027776","Total",651,234,12,222,142,39,159,18,141
"2011","Ryedale 001B","E01027777","Total",606,168,12,156,135,32,141,21,120
"2011","Ryedale 001C","E01027783","Total",817,318,6,312,158,48,185,20,165
"2011","Ryedale 001D","E01027784","Total",772,316,19,297,198,75,216,18,198
"2011","Ryedale 002A","E01027792","Total",875,373,6,367,160,51,210,17,193
"2011","Ryedale 002B","E01027793","Total",658,279,19,260,150,48,212,19,193
"2011","Ryedale 002C","E01027794","Total",876,356,18,338,219,71,238,27,211
"2011","Ryedale 002D","E01027795","Total",719,264,13,251,172,59,199,13,186
"2011","Ryedale 002E","E01027801","Total",755,325,9,316,147,43,225,20,205
"2011","Ryedale 002F","E01027802","Total",710,242,10,232,160,57,174,20,154
"2011","Ryedale 003A","E01027775","Total",635,217,5,212,161,52,146,20,126
"2011","Ryedale 003B","E01027780","Total",788,219,8,211,181,53,167,34,133
"2011","Ryedale 003C","E01027781","Total",637,296,6,290,108,38,201,14,187
"2011","Ryedale 003D","E01027800","Total",728,222,8,214,159,61,169,20,149
"2011","Ryedale 004A","E01027779","Total",475,162,11,151,124,41,122,23,99
"2011","Ryedale 004B","E01027796","Total",772,276,15,261,183,67,234,28,206
"2011","Ryedale 004C","E01027798","Total",831,271,31,240,246,83,229,33,196
"2011","Ryedale 004D","E01027803","Total",714,191,25,166,220,90,163,39,124
"2011","Ryedale 007A","E01027774","Total",832,240,12,228,250,95,174,30,144
"2011","Ryedale 007B","E01027778","Total",1000,285,10,275,250,63,223,32,191
"2011","Ryedale 007C","E01027782","Total",766,268,10,258,158,37,193,18,175
"2011","Ryedale 007D","E01027797","Total",716,182,9,173,172,45,146,26,120
"2011","Ryedale 007E","E01027799","Total",762,250,12,238,184,59,167,15,152
"2011","Ryedale 008A","E01027785","Total",811,301,10,291,164,72,230,20,210
"2011","Ryedale 008B","E01027786","Total",688,266,4,262,138,45,167,14,153
"2011","Ryedale 008C","E01027787","Total",744,251,19,232,202,78,226,36,190
"2011","Ryedale 008D","E01027788","Total",658,284,7,277,128,54,220,11,209
"2011","Ryedale 008E","E01027789","Total",1063,348,53,295,325,161,291,43,248
"2011","Ryedale 008F","E01027790","Total",819,206,14,192,237,94,150,30,120
"2011","Ryedale 008G","E01027791","Total",646,185,2,183,171,67,139,26,113
"2011","Scarborough 001A","E01027837","Total",672,345,27,318,158,69,248,20,228
"2011","Scarborough 001B","E01027839","Total",707,252,18,234,209,80,187,27,160
"2011","Scarborough 001C","E01027869","Total",623,292,11,281,58,28,211,10,201
"2011","Scarborough 001D","E01027870","Total",685,307,26,281,119,40,205,22,183
"2011","Scarborough 001E","E01027871","Total",695,322,11,311,147,53,234,20,214
"2011","Scarborough 002A","E01027813","Total",837,290,12,278,180,59,231,35,196
"2011","Scarborough 002B","E01027822","Total",610,204,10,194,141,45,144,23,121
"2011","Scarborough 002C","E01027840","Total",977,412,39,373,212,64,312,37,275
"2011","Scarborough 002D","E01027841","Total",583,193,6,187,119,35,147,19,128
"2011","Scarborough 003A","E01027838","Total",681,264,6,258,146,42,179,23,156
"2011","Scarborough 003B","E01027864","Total",588,197,38,159,193,67,187,33,154
"2011","Scarborough 003C","E01027865","Total",785,276,36,240,179,74,203,25,178
"2011","Scarborough 003D","E01027866","Total",661,236,20,216,162,62,174,17,157
"2011","Scarborough 004A","E01027821","Total",651,273,11,262,102,37,168,16,152
"2011","Scarborough 004B","E01027823","Total",662,312,14,298,134,43,207,15,192
"2011","Scarborough 004C","E01027831","Total",463,174,4,170,98,34,131,14,117
"2011","Scarborough 004D","E01027832","Total",448,178,6,172,71,16,125,9,116
"2011","Scarborough 004E","E01027836","Total",1018,440,17,423,214,70,300,36,264
"2011","Scarborough 004F","E01027857","Total",560,211,9,202,129,50,145,21,124
"2011","Scarborough 005A","E01027842","Total",709,307,21,286,180,56,229,27,202
"2011","Scarborough 005B","E01027843","Total",622,254,22,232,180,54,192,31,161
"2011","Scarborough 005C","E01027844","Total",656,231,7,224,168,42,155,21,134
"2011","Scarborough 005D","E01027845","Total",725,255,11,244,205,64,183,35,148
"2011","Scarborough 005E","E01027855","Total",628,261,4,257,141,37,162,24,138
"2011","Scarborough 005F","E01027856","Total",610,367,2,365,74,19,220,10,210
"2011","Scarborough 006A","E01027805","Total",778,358,37,321,148,73,260,25,235
"2011","Scarborough 006B","E01027806","Total",928,466,49,417,178,81,310,33,277
"2011","Scarborough 006C","E01027846","Total",766,252,42,210,243,117,198,36,162
"2011","Scarborough 006D","E01027847","Total",996,473,52,421,180,82,308,27,281
"2011","Scarborough 006E","E01027848","Total",456,181,9,172,130,42,113,21,92
"2011","Scarborough 007A","E01027849","Total",518,244,10,234,95,28,158,16,142
"2011","Scarborough 007B","E01027850","Total",622,291,29,262,161,53,233,31,202
"2011","Scarborough 007C","E01027872","Total",604,251,42,209,185,62,183,29,154
"2011","Scarborough 007D","E01027874","Total",620,312,111,201,268,120,219,64,155
"2011","Scarborough 008A","E01027810","Total",649,160,39,121,269,122,139,40,99
"2011","Scarborough 008B","E01027811","Total",687,175,43,132,274,126,154,47,107
"2011","Scarborough 008C","E01027812","Total",753,233,61,172,289,138,189,44,145
"2011","Scarborough 008D","E01027851","Total",626,152,9,143,207,84,136,24,112
"2011","Scarborough 008E","E01027862","Total",753,251,32,219,199,88,204,25,179
"2011","Scarborough 009A","E01027824","Total",717,400,16,384,121,33,309,24,285
"2011","Scarborough 009B","E01027825","Total",759,226,53,173,280,140,194,53,141
"2011","Scarborough 009C","E01027826","Total",655,198,41,157,208,100,162,31,131
"2011","Scarborough 009D","E01027861","Total",646,272,28,244,153,62,184,17,167
"2011","Scarborough 009E","E01027863","Total",661,320,9,311,113,26,196,18,178
"2011","Scarborough 009F","E01027873","Total",723,301,10,291,145,54,226,20,206
"2011","Scarborough 010A","E01027804","Total",847,319,34,285,120,42,231,21,210
"2011","Scarborough 010B","E01027852","Total",899,354,19,335,91,40,226,21,205
"2011","Scarborough 010C","E01027853","Total",657,307,19,288,96,39,193,18,175
"2011","Scarborough 010D","E01027854","Total",857,355,16,339,75,32,242,15,227
"2011","Scarborough 010E","E01027868","Total",1173,650,17,633,112,35,359,11,348
"2011","Scarborough 011A","E01027807","Total",646,257,16,241,150,58,192,21,171
"2011","Scarborough 011B","E01027808","Total",654,299,12,287,128,49,194,26,168
"2011","Scarborough 011C","E01027809","Total",644,313,7,306,95,32,186,14,172
"2011","Scarborough 011D","E01027818","Total",611,208,25,183,190,70,176,34,142
"2011","Scarborough 011E","E01027867","Total",627,302,4,298,116,39,190,14,176
"2011","Scarborough 012A","E01027817","Total",592,256,64,192,200,75,228,50,178
"2011","Scarborough 012B","E01027819","Total",581,292,85,207,231,95,221,48,173
"2011","Scarborough 012C","E01027820","Total",510,188,76,112,237,111,162,52,110
"2011","Scarborough 012D","E01027858","Total",606,242,2,240,132,48,168,11,157
"2011","Scarborough 012E","E01027860","Total",637,211,13,198,193,71,198,36,162
"2011","Scarborough 013A","E01027814","Total",677,273,13,260,169,53,155,16,139
"2011","Scarborough 013B","E01027815","Total",594,191,11,180,127,41,150,19,131
"2011","Scarborough 013C","E01027816","Total",697,291,11,280,155,55,199,34,165
"2011","Scarborough 013D","E01027859","Total",719,235,10,225,211,62,171,33,138
"2011","Scarborough 014A","E01027827","Total",892,470,25,445,122,50,309,24,285
"2011","Scarborough 014B","E01027828","Total",798,477,22,455,136,42,298,27,271
"2011","Scarborough 014C","E01027829","Total",771,459,14,445,92,33,272,19,253
"2011","Scarborough 014D","E01027830","Total",736,291,39,252,244,77,232,60,172
"2011","Scarborough 014E","E01027833","Total",747,333,11,322,128,38,262,29,233
"2011","Scarborough 014F","E01027834","Total",738,374,21,353,137,45,235,26,209
"2011","Scarborough 014G","E01027835","Total",752,289,17,272,168,55,207,35,172
"2011","Selby 001A","E01027918","Total",648,194,8,186,189,68,173,33,140
"2011","Selby 001B","E01027919","Total",509,143,5,138,134,45,117,17,100
"2011","Selby 001C","E01027920","Total",500,148,6,142,144,40,120,16,104
"2011","Selby 001D","E01027921","Total",859,379,13,366,166,52,262,12,250
"2011","Selby 001E","E01027922","Total",668,189,6,183,204,55,132,17,115
"2011","Selby 002A","E01027875","Total",712,191,9,182,229,72,148,27,121
"2011","Selby 002B","E01027886","Total",559,149,8,141,162,63,130,29,101
"2011","Selby 002C","E01027887","Total",663,154,7,147,181,64,136,24,112
"2011","Selby 002D","E01027888","Total",702,168,13,155,242,110,133,22,111
"2011","Selby 002E","E01027904","Total",890,191,12,179,320,124,160,42,118
"2011","Selby 003A","E01027876","Total",653,173,10,163,216,80,155,26,129
"2011","Selby 003B","E01027877","Total",511,146,6,140,128,52,127,13,114
"2011","Selby 003C","E01027900","Total",757,158,9,149,257,100,171,39,132
"2011","Selby 003D","E01027901","Total",636,155,7,148,175,73,142,26,116
"2011","Selby 003E","E01027902","Total",587,168,16,152,181,67,145,29,116
"2011","Selby 003F","E01027903","Total",416,134,4,130,130,39,102,14,88
"2011","Selby 004A","E01027898","Total",1003,253,13,240,302,131,201,26,175
"2011","Selby 004B","E01027914","Total",669,199,6,193,183,71,155,27,128
"2011","Selby 004C","E01027915","Total",710,254,18,236,183,78,202,27,175
"2011","Selby 004D","E01027916","Total",653,194,22,172,193,57,183,34,149
"2011","Selby 004E","E01027917","Total",699,117,13,104,271,102,114,21,93
"2011","Selby 005A","E01027878","Total",548,155,33,122,188,88,122,25,97
"2011","Selby 005B","E01027905","Total",868,272,38,234,200,110,209,29,180
"2011","Selby 005C","E01027907","Total",563,257,55,202,199,91,185,42,143
"2011","Selby 005D","E01027908","Total",779,303,36,267,187,96,241,34,207
"2011","Selby 005E","E01027909","Total",952,300,38,262,257,130,235,35,200
"2011","Selby 005F","E01027910","Total",1099,304,66,238,415,182,265,75,190
"2011","Selby 006A","E01027881","Total",593,267,17,250,127,47,205,21,184
"2011","Selby 006B","E01027906","Total",575,184,38,146,201,91,156,30,126
"2011","Selby 006C","E01027911","Total",619,258,9,249,131,45,196,18,178
"2011","Selby 006D","E01027912","Total",428,157,2,155,106,23,89,6,83
"2011","Selby 006E","E01027913","Total",490,173,2,171,140,36,116,10,106
"2011","Selby 007A","E01027879","Total",566,168,10,158,162,51,127,23,104
"2011","Selby 007B","E01027880","Total",626,209,7,202,189,57,152,28,124
"2011","Selby 007C","E01027882","Total",699,164,10,154,248,91,154,37,117
"2011","Selby 007D","E01027894","Total",773,241,16,225,231,91,198,39,159
"2011","Selby 007E","E01027895","Total",675,229,9,220,153,52,170,19,151
"2011","Selby 008A","E01027883","Total",446,122,12,110,121,43,125,21,104
"2011","Selby 008B","E01027884","Total",627,147,22,125,218,81,144,33,111
"2011","Selby 008C","E01027885","Total",655,205,11,194,190,73,164,23,141
"2011","Selby 008D","E01027896","Total",802,210,13,197,264,89,182,34,148
"2011","Selby 008E","E01027897","Total",840,212,11,201,248,89,168,26,142
"2011","Selby 009A","E01027891","Total",746,235,7,228,160,46,191,24,167
"2011","Selby 009B","E01027892","Total",836,279,24,255,208,96,226,28,198
"2011","Selby 009C","E01027893","Total",764,202,8,194,205,81,149,20,129
"2011","Selby 009D","E01027899","Total",683,180,10,170,254,84,111,23,88
"2011","Selby 010A","E01027889","Total",718,213,25,188,221,90,179,42,137
"2011","Selby 010B","E01027890","Total",807,218,5,213,223,70,181,39,142
"2011","Selby 010C","E01027923","Total",944,285,21,264,266,82,243,30,213
"2011","Selby 010D","E01027924","Total",834,173,15,158,268,103,186,38,148
"2011","Barnsley 001A","E01007434","Total",837,308,41,267,265,96,255,53,202
"2011","Barnsley 001B","E01007435","Total",723,339,39,300,184,74,290,44,246
"2011","Barnsley 001C","E01007438","Total",629,250,21,229,192,47,190,32,158
"2011","Barnsley 001D","E01007439","Total",507,165,15,150,131,34,148,23,125
"2011","Barnsley 002A","E01007433","Total",678,274,46,228,217,71,219,49,170
"2011","Barnsley 002B","E01007436","Total",568,246,27,219,140,43,184,31,153
"2011","Barnsley 002C","E01007437","Total",626,206,28,178,196,78,175,30,145
"2011","Barnsley 002D","E01007440","Total",665,255,56,199,209,94,214,40,174
"2011","Barnsley 003A","E01007329","Total",637,225,22,203,222,77,190,36,154
"2011","Barnsley 003B","E01007331","Total",823,292,30,262,210,92,231,36,195
"2011","Barnsley 003C","E01007342","Total",563,201,32,169,172,60,165,31,134
"2011","Barnsley 003D","E01007343","Total",650,319,29,290,145,65,267,26,241
"2011","Barnsley 004A","E01007356","Total",602,236,17,219,155,40,174,22,152
"2011","Barnsley 004B","E01007357","Total",598,219,38,181,182,60,173,34,139
"2011","Barnsley 004C","E01007361","Total",698,174,24,150,220,83,161,32,129
"2011","Barnsley 004D","E01007362","Total",691,216,9,207,192,68,164,29,135
"2011","Barnsley 004E","E01007363","Total",769,375,41,334,173,61,296,38,258
"2011","Barnsley 005A","E01007355","Total",594,141,9,132,227,83,133,32,101
"2011","Barnsley 005B","E01007358","Total",643,190,24,166,206,74,143,30,113
"2011","Barnsley 005C","E01007359","Total",660,234,29,205,197,76,199,36,163
"2011","Barnsley 005D","E01007360","Total",659,286,20,266,167,54,184,24,160
"2011","Barnsley 005E","E01007386","Total",769,292,10,282,182,71,193,21,172
"2011","Barnsley 006A","E01007328","Total",801,351,65,286,264,96,303,57,246
"2011","Barnsley 006B","E01007330","Total",725,265,31,234,216,75,240,45,195
"2011","Barnsley 006C","E01007332","Total",979,388,70,318,300,145,303,56,247
"2011","Barnsley 006D","E01007333","Total",494,198,50,148,201,67,166,53,113
"2011","Barnsley 007A","E01007323","Total",614,231,69,162,230,92,173,46,127
"2011","Barnsley 007B","E01007324","Total",747,345,65,280,222,83,279,46,233
"2011","Barnsley 007C","E01007325","Total",613,263,112,151,294,138,196,67,129
"2011","Barnsley 007D","E01007326","Total",651,283,35,248,200,68,234,33,201
"2011","Barnsley 007E","E01007327","Total",804,430,40,390,165,55,352,38,314
"2011","Barnsley 007F","E01007411","Total",489,265,75,190,177,77,195,38,157
"2011","Barnsley 008A","E01007341","Total",513,239,53,186,177,71,177,41,136
"2011","Barnsley 008B","E01007345","Total",675,210,32,178,233,93,178,48,130
"2011","Barnsley 008C","E01007346","Total",664,232,49,183,235,95,181,43,138
"2011","Barnsley 008D","E01007347","Total",666,203,21,182,222,77,187,40,147
"2011","Barnsley 009A","E01007334","Total",554,137,6,131,160,53,141,32,109
"2011","Barnsley 009B","E01007335","Total",603,197,19,178,171,53,179,34,145
"2011","Barnsley 009C","E01007400","Total",848,270,18,252,261,111,228,36,192
"2011","Barnsley 009D","E01007404","Total",606,253,8,245,106,40,209,18,191
"2011","Barnsley 009E","E01007406","Total",837,412,41,371,205,82,349,43,306
"2011","Barnsley 010C","E01007408","Total",637,217,20,197,202,70,171,38,133
"2011","Barnsley 010D","E01007409","Total",624,195,9,186,169,53,159,23,136
"2011","Barnsley 010E","E01007410","Total",854,399,36,363,182,69,316,40,276
"2011","Barnsley 010G","E01032550","Total",1177,395,76,319,411,161,362,79,283
"2011","Barnsley 010H","E01032551","Total",1084,342,39,303,344,113,307,72,235
"2011","Barnsley 011A","E01007344","Total",889,281,45,236,303,117,228,60,168
"2011","Barnsley 011B","E01007402","Total",657,273,81,192,261,109,234,70,164
"2011","Barnsley 011C","E01007403","Total",613,268,74,194,220,100,213,55,158
"2011","Barnsley 011D","E01007405","Total",590,292,38,254,120,46,190,23,167
"2011","Barnsley 012A","E01007379","Total",695,265,19,246,169,57,195,32,163
"2011","Barnsley 012B","E01007380","Total",737,225,12,213,233,78,177,29,148
"2011","Barnsley 012C","E01007381","Total",661,225,12,213,185,51,172,20,152
"2011","Barnsley 012D","E01007387","Total",619,192,18,174,191,59,168,23,145
"2011","Barnsley 012E","E01007442","Total",642,299,5,294,123,28,191,16,175
"2011","Barnsley 012F","E01007444","Total",768,342,9,333,154,43,250,14,236
"2011","Barnsley 012G","E01007446","Total",642,299,10,289,134,49,177,12,165
"2011","Barnsley 013A","E01007336","Total",764,270,41,229,178,83,200,27,173
"2011","Barnsley 013B","E01007340","Total",744,218,46,172,217,97,176,25,151
"2011","Barnsley 013C","E01007415","Total",634,226,24,202,185,64,192,37,155
"2011","Barnsley 013D","E01007417","Total",734,233,53,180,216,102,180,28,152
"2011","Barnsley 013E","E01007441","Total",737,203,36,167,219,91,183,29,154
"2011","Barnsley 013F","E01007443","Total",1005,327,68,259,241,131,253,50,203
"2011","Barnsley 013G","E01007445","Total",731,231,22,209,163,78,202,23,179
"2011","Barnsley 014A","E01007372","Total",540,279,75,204,185,88,215,40,175
"2011","Barnsley 014B","E01007373","Total",675,319,79,240,228,99,238,57,181
"2011","Barnsley 014C","E01007374","Total",657,293,23,270,167,70,218,37,181
"2011","Barnsley 014D","E01007375","Total",685,280,32,248,185,61,241,48,193
"2011","Barnsley 014E","E01007377","Total",443,177,47,130,166,64,167,43,124
"2011","Barnsley 014F","E01007378","Total",750,429,76,353,202,85,332,52,280
"2011","Barnsley 015A","E01007319","Total",613,221,6,215,165,46,170,25,145
"2011","Barnsley 015B","E01007321","Total",655,253,5,248,149,41,203,17,186
"2011","Barnsley 015C","E01007322","Total",905,248,49,199,286,133,231,60,171
"2011","Barnsley 015D","E01007337","Total",870,267,44,223,243,116,196,42,154
"2011","Barnsley 016A","E01007418","Total",602,240,6,234,124,39,155,13,142
"2011","Barnsley 016B","E01007419","Total",714,234,12,222,228,60,163,27,136
"2011","Barnsley 016C","E01007420","Total",618,231,6,225,170,56,156,17,139
"2011","Barnsley 016D","E01007425","Total",632,214,2,212,158,51,156,20,136
"2011","Barnsley 017A","E01007338","Total",916,603,43,560,126,53,433,21,412
"2011","Barnsley 017B","E01007339","Total",728,283,54,229,194,91,200,36,164
"2011","Barnsley 017C","E01007413","Total",605,288,80,208,211,91,244,54,190
"2011","Barnsley 017D","E01007414","Total",706,277,61,216,226,101,238,52,186
"2011","Barnsley 018A","E01007317","Total",653,320,73,247,199,74,233,50,183
"2011","Barnsley 018B","E01007318","Total",644,272,65,207,237,113,208,51,157
"2011","Barnsley 018C","E01007320","Total",673,289,76,213,237,100,224,49,175
"2011","Barnsley 018D","E01007416","Total",517,275,63,212,166,84,200,41,159
"2011","Barnsley 019A","E01007382","Total",689,256,26,230,180,73,218,33,185
"2011","Barnsley 019B","E01007383","Total",513,95,9,86,207,65,112,28,84
"2011","Barnsley 019C","E01007384","Total",703,253,17,236,186,69,184,24,160
"2011","Barnsley 019D","E01007385","Total",668,334,17,317,146,54,255,30,225
"2011","Barnsley 020A","E01007348","Total",613,305,48,257,160,72,226,40,186
"2011","Barnsley 020B","E01007349","Total",668,289,41,248,199,72,228,37,191
"2011","Barnsley 020C","E01007350","Total",523,240,10,230,100,28,160,16,144
"2011","Barnsley 020D","E01007351","Total",643,249,37,212,183,63,195,31,164
"2011","Barnsley 020E","E01007352","Total",623,280,54,226,187,73,226,47,179
"2011","Barnsley 020F","E01007353","Total",657,204,37,167,225,88,169,36,133
"2011","Barnsley 020G","E01007354","Total",697,232,41,191,222,76,212,54,158
"2011","Barnsley 021A","E01007458","Total",619,206,32,174,178,72,183,33,150
"2011","Barnsley 021B","E01007459","Total",733,357,21,336,120,30,249,21,228
"2011","Barnsley 021C","E01007460","Total",612,214,20,194,154,49,190,21,169
"2011","Barnsley 021D","E01007461","Total",776,373,60,313,216,95,311,52,259
"2011","Barnsley 021E","E01007462","Total",658,308,78,230,223,88,226,55,171
"2011","Barnsley 021F","E01007463","Total",782,413,98,315,249,101,311,71,240
"2011","Barnsley 022A","E01007369","Total",687,306,66,240,197,101,245,45,200
"2011","Barnsley 022B","E01007370","Total",605,286,62,224,187,78,237,55,182
"2011","Barnsley 022C","E01007371","Total",817,296,60,236,282,104,259,68,191
"2011","Barnsley 022D","E01007376","Total",639,285,48,237,183,77,236,33,203
"2011","Barnsley 023A","E01007447","Total",657,299,38,261,198,66,249,46,203
"2011","Barnsley 023B","E01007448","Total",773,278,59,219,210,90,237,49,188
"2011","Barnsley 023C","E01007449","Total",815,277,41,236,216,90,221,42,179
"2011","Barnsley 023D","E01007450","Total",709,366,41,325,165,56,283,35,248
"2011","Barnsley 024A","E01007427","Total",671,178,12,166,196,89,144,22,122
"2011","Barnsley 024B","E01007428","Total",654,211,11,200,174,57,152,16,136
"2011","Barnsley 024C","E01007429","Total",726,376,18,358,142,47,290,31,259
"2011","Barnsley 024D","E01007430","Total",896,151,12,139,358,150,177,50,127
"2011","Barnsley 024E","E01007431","Total",543,148,16,132,169,45,125,23,102
"2011","Barnsley 024F","E01007432","Total",577,192,17,175,190,52,146,26,120
"2011","Barnsley 025A","E01007364","Total",593,266,29,237,185,63,224,39,185
"2011","Barnsley 025B","E01007365","Total",514,228,47,181,177,63,185,47,138
"2011","Barnsley 025C","E01007366","Total",847,230,22,208,255,126,205,40,165
"2011","Barnsley 025D","E01007367","Total",473,190,47,143,159,70,176,37,139
"2011","Barnsley 025E","E01007368","Total",698,242,39,203,227,105,210,43,167
"2011","Barnsley 026A","E01007451","Total",728,259,53,206,233,84,236,54,182
"2011","Barnsley 026B","E01007452","Total",634,154,24,130,226,87,148,31,117
"2011","Barnsley 026C","E01007453","Total",646,329,72,257,216,76,279,60,219
"2011","Barnsley 026E","E01007455","Total",587,222,15,207,135,35,185,23,162
"2011","Barnsley 026F","E01032924","Total",602,104,19,85,250,120,102,27,75
"2011","Barnsley 026G","E01032925","Total",603,251,34,217,192,86,194,43,151
"2011","Barnsley 027A","E01007421","Total",563,165,1,164,133,37,125,12,113
"2011","Barnsley 027B","E01007422","Total",635,175,6,169,203,67,145,22,123
"2011","Barnsley 027C","E01007423","Total",705,229,15,214,191,64,181,26,155
"2011","Barnsley 027D","E01007426","Total",692,221,15,206,165,62,169,23,146
"2011","Barnsley 028A","E01007396","Total",740,264,29,235,210,76,216,29,187
"2011","Barnsley 028B","E01007397","Total",677,324,21,303,163,55,263,33,230
"2011","Barnsley 028C","E01007398","Total",769,372,17,355,150,41,259,26,233
"2011","Barnsley 028D","E01007399","Total",895,249,25,224,280,118,217,31,186
"2011","Barnsley 028E","E01007424","Total",726,243,18,225,222,80,192,32,160
"2011","Barnsley 029A","E01007388","Total",694,180,23,157,215,73,159,33,126
"2011","Barnsley 029B","E01007393","Total",811,277,39,238,239,104,243,55,188
"2011","Barnsley 029C","E01007394","Total",565,250,55,195,183,64,187,46,141
"2011","Barnsley 029D","E01007456","Total",766,196,18,178,229,78,211,35,176
"2011","Barnsley 029E","E01007457","Total",689,244,39,205,238,109,213,46,167
"2011","Barnsley 030A","E01007389","Total",666,293,6,287,105,26,210,19,191
"2011","Barnsley 030B","E01007390","Total",646,217,23,194,189,60,183,32,151
"2011","Barnsley 030C","E01007391","Total",684,327,44,283,177,61,237,27,210
"2011","Barnsley 030D","E01007392","Total",609,256,57,199,208,80,192,40,152
"2011","Barnsley 030E","E01007395","Total",820,337,68,269,283,114,255,49,206
"2011","Doncaster 001A","E01007632","Total",615,186,45,141,237,89,165,46,119
"2011","Doncaster 001B","E01007633","Total",514,188,50,138,204,87,156,42,114
"2011","Doncaster 001C","E01007634","Total",653,289,71,218,237,113,206,47,159
"2011","Doncaster 001D","E01007635","Total",618,273,41,232,153,68,196,39,157
"2011","Doncaster 002A","E01007487","Total",691,284,34,250,197,69,239,40,199
"2011","Doncaster 002B","E01007488","Total",726,252,31,221,180,75,201,22,179
"2011","Doncaster 002C","E01007489","Total",722,202,34,168,221,109,181,34,147
"2011","Doncaster 002D","E01007490","Total",631,228,28,200,172,72,189,36,153
"2011","Doncaster 002E","E01007491","Total",661,263,78,185,273,119,236,70,166
"2011","Doncaster 002F","E01007492","Total",664,355,39,316,180,73,273,45,228
"2011","Doncaster 002G","E01007493","Total",715,221,13,208,231,85,192,35,157
"2011","Doncaster 003A","E01007636","Total",654,286,52,234,212,84,225,33,192
"2011","Doncaster 003B","E01007637","Total",655,268,35,233,185,75,192,23,169
"2011","Doncaster 003C","E01007638","Total",706,310,44,266,192,81,248,50,198
"2011","Doncaster 003D","E01007639","Total",899,333,21,312,203,86,259,34,225
"2011","Doncaster 003E","E01007640","Total",725,282,12,270,154,50,213,23,190
"2011","Doncaster 003F","E01007641","Total",588,179,26,153,189,72,160,34,126
"2011","Doncaster 003G","E01007642","Total",649,267,51,216,220,105,220,34,186
"2011","Doncaster 004A","E01007625","Total",620,190,11,179,195,57,148,37,111
"2011","Doncaster 004B","E01007626","Total",546,252,30,222,137,51,188,23,165
"2011","Doncaster 004C","E01007627","Total",701,330,60,270,236,105,227,40,187
"2011","Doncaster 004D","E01007628","Total",541,212,65,147,212,97,169,45,124
"2011","Doncaster 004E","E01007629","Total",663,348,93,255,223,102,247,41,206
"2011","Doncaster 005A","E01007468","Total",607,275,0,275,94,37,205,17,188
"2011","Doncaster 005B","E01007469","Total",543,170,24,146,185,63,140,23,117
"2011","Doncaster 005C","E01007470","Total",553,177,37,140,217,91,161,41,120
"2011","Doncaster 005D","E01007472","Total",654,320,67,253,209,96,259,61,198
"2011","Doncaster 005E","E01007473","Total",616,205,40,165,211,107,185,34,151
"2011","Doncaster 005F","E01007474","Total",649,400,71,329,155,86,262,34,228
"2011","Doncaster 006A","E01007554","Total",676,191,19,172,205,90,173,31,142
"2011","Doncaster 006B","E01007555","Total",626,318,48,270,179,86,245,33,212
"2011","Doncaster 006C","E01007556","Total",533,190,54,136,205,98,181,46,135
"2011","Doncaster 006D","E01007561","Total",556,175,8,167,180,51,125,26,99
"2011","Doncaster 006E","E01007562","Total",610,209,24,185,158,74,162,27,135
"2011","Doncaster 006F","E01007563","Total",525,206,72,134,228,114,154,45,109
"2011","Doncaster 007A","E01007621","Total",539,111,7,104,210,74,108,29,79
"2011","Doncaster 007B","E01007622","Total",666,226,12,214,168,63,159,18,141
"2011","Doncaster 007C","E01007623","Total",585,226,11,215,142,58,192,21,171
"2011","Doncaster 007D","E01007624","Total",750,168,11,157,271,111,126,24,102
"2011","Doncaster 007E","E01007630","Total",652,315,9,306,126,43,224,20,204
"2011","Doncaster 007F","E01007631","Total",534,204,4,200,129,44,152,19,133
"2011","Doncaster 008A","E01007553","Total",715,213,4,209,187,67,168,27,141
"2011","Doncaster 008B","E01007557","Total",419,135,13,122,116,49,107,11,96
"2011","Doncaster 008C","E01007558","Total",622,205,17,188,186,76,168,27,141
"2011","Doncaster 008D","E01007559","Total",405,148,8,140,92,18,131,23,108
"2011","Doncaster 008E","E01007560","Total",644,257,21,236,157,57,191,35,156
"2011","Doncaster 009A","E01007464","Total",600,226,58,168,222,85,176,40,136
"2011","Doncaster 009B","E01007465","Total",629,243,35,208,196,72,220,43,177
"2011","Doncaster 009C","E01007466","Total",640,249,94,155,293,141,200,63,137
"2011","Doncaster 009D","E01007467","Total",645,246,42,204,189,80,216,37,179
"2011","Doncaster 009E","E01007471","Total",591,151,14,137,196,50,134,29,105
"2011","Doncaster 009F","E01007504","Total",622,222,31,191,200,76,209,37,172
"2011","Doncaster 009G","E01007507","Total",496,202,70,132,220,102,159,49,110
"2011","Doncaster 010A","E01007506","Total",545,219,63,156,208,77,181,44,137
"2011","Doncaster 010B","E01007508","Total",695,293,81,212,264,145,223,42,181
"2011","Doncaster 010C","E01007509","Total",814,412,101,311,236,116,319,62,257
"2011","Doncaster 010D","E01007510","Total",734,292,42,250,199,89,234,29,205
"2011","Doncaster 010E","E01007511","Total",609,238,61,177,232,113,202,52,150
"2011","Doncaster 011A","E01007475","Total",627,136,9,127,213,63,128,20,108
"2011","Doncaster 011B","E01007476","Total",643,282,16,266,166,59,209,19,190
"2011","Doncaster 011C","E01007477","Total",598,208,6,202,156,60,174,24,150
"2011","Doncaster 011D","E01007478","Total",653,232,15,217,168,64,200,32,168
"2011","Doncaster 012A","E01007512","Total",717,213,17,196,220,92,198,37,161
"2011","Doncaster 012B","E01007513","Total",641,278,28,250,177,69,208,28,180
"2011","Doncaster 012C","E01007515","Total",661,260,30,230,191,68,229,32,197
"2011","Doncaster 012D","E01007518","Total",603,210,14,196,184,62,177,30,147
"2011","Doncaster 012E","E01007519","Total",527,151,31,120,187,74,154,37,117
"2011","Doncaster 013A","E01007505","Total",721,269,21,248,182,70,222,33,189
"2011","Doncaster 013B","E01007514","Total",664,212,47,165,186,102,170,27,143
"2011","Doncaster 013C","E01007516","Total",570,189,18,171,163,57,170,19,151
"2011","Doncaster 013D","E01007517","Total",701,240,63,177,231,123,190,46,144
"2011","Doncaster 014A","E01007479","Total",674,266,29,237,199,91,217,29,188
"2011","Doncaster 014B","E01007480","Total",549,165,34,131,215,88,161,39,122
"2011","Doncaster 014D","E01007482","Total",641,327,30,297,144,62,268,34,234
"2011","Doncaster 014E","E01033259","Total",655,96,16,80,232,119,100,22,78
"2011","Doncaster 014F","E01033260","Total",632,120,22,98,258,122,142,33,109
"2011","Doncaster 015A","E01007570","Total",645,258,14,244,152,61,198,22,176
"2011","Doncaster 015B","E01007650","Total",826,368,13,355,156,48,300,31,269
"2011","Doncaster 015C","E01007651","Total",676,224,75,149,295,124,185,58,127
"2011","Doncaster 015D","E01007652","Total",770,331,65,266,248,112,274,60,214
"2011","Doncaster 015E","E01007653","Total",638,175,24,151,204,90,153,26,127
"2011","Doncaster 015F","E01007656","Total",638,267,47,220,208,79,231,51,180
"2011","Doncaster 016A","E01007581","Total",626,187,9,178,209,56,140,31,109
"2011","Doncaster 016B","E01007582","Total",615,172,15,157,188,67,146,28,118
"2011","Doncaster 016C","E01007588","Total",669,227,21,206,239,101,190,39,151
"2011","Doncaster 016D","E01007589","Total",715,269,8,261,195,65,185,29,156
"2011","Doncaster 017A","E01007483","Total",610,181,12,169,155,50,153,22,131
"2011","Doncaster 017B","E01007484","Total",626,231,12,219,144,61,202,22,180
"2011","Doncaster 017C","E01007485","Total",592,137,9,128,188,61,119,18,101
"2011","Doncaster 017D","E01007486","Total",635,304,15,289,92,47,234,19,215
"2011","Doncaster 018A","E01007564","Total",605,236,48,188,232,69,160,35,125
"2011","Doncaster 018B","E01007565","Total",641,206,11,195,196,72,154,26,128
"2011","Doncaster 018C","E01007566","Total",780,395,45,350,194,83,300,37,263
"2011","Doncaster 018D","E01007567","Total",516,188,24,164,177,64,131,25,106
"2011","Doncaster 018E","E01007568","Total",595,223,86,137,276,124,174,59,115
"2011","Doncaster 018F","E01007569","Total",627,218,41,177,213,80,198,41,157
"2011","Doncaster 019A","E01007644","Total",587,166,15,151,186,79,150,30,120
"2011","Doncaster 019B","E01007646","Total",607,163,11,152,131,49,142,29,113
"2011","Doncaster 019C","E01007647","Total",692,225,12,213,156,50,183,32,151
"2011","Doncaster 019D","E01007648","Total",854,288,42,246,178,92,237,31,206
"2011","Doncaster 019E","E01007649","Total",616,153,19,134,196,70,140,33,107
"2011","Doncaster 019F","E01007654","Total",609,184,29,155,181,85,152,22,130
"2011","Doncaster 020A","E01007583","Total",632,235,6,229,145,50,150,20,130
"2011","Doncaster 020B","E01007586","Total",654,240,11,229,158,44,191,37,154
"2011","Doncaster 020C","E01007587","Total",728,314,20,294,131,36,234,20,214
"2011","Doncaster 020D","E01007620","Total",701,237,11,226,160,60,196,32,164
"2011","Doncaster 021A","E01007584","Total",671,199,11,188,197,77,160,28,132
"2011","Doncaster 021B","E01007585","Total",630,185,10,175,218,78,155,38,117
"2011","Doncaster 021C","E01007617","Total",643,253,4,249,175,53,156,17,139
"2011","Doncaster 021D","E01007618","Total",505,167,9,158,146,38,122,13,109
"2011","Doncaster 021E","E01007619","Total",716,199,7,192,254,77,156,35,121
"2011","Doncaster 022A","E01007529","Total",654,241,70,171,203,117,161,27,134
"2011","Doncaster 022B","E01007530","Total",512,184,44,140,166,97,141,25,116
"2011","Doncaster 022C","E01007531","Total",792,365,52,313,196,100,264,38,226
"2011","Doncaster 022D","E01007643","Total",662,274,84,190,249,128,215,55,160
"2011","Doncaster 022E","E01007645","Total",830,292,69,223,236,135,203,33,170
"2011","Doncaster 022F","E01007655","Total",868,306,60,246,224,128,219,35,184
"2011","Doncaster 023A","E01007494","Total",675,191,34,157,200,87,170,32,138
"2011","Doncaster 023B","E01007532","Total",1017,609,70,539,194,105,433,48,385
"2011","Doncaster 023C","E01007533","Total",623,245,19,226,174,74,196,33,163
"2011","Doncaster 023D","E01007535","Total",638,206,50,156,208,108,163,35,128
"2011","Doncaster 024A","E01007522","Total",755,409,48,361,165,76,310,40,270
"2011","Doncaster 024B","E01007525","Total",671,303,32,271,176,79,240,28,212
"2011","Doncaster 024C","E01007528","Total",634,300,34,266,182,85,229,26,203
"2011","Doncaster 024D","E01007604","Total",574,181,13,168,148,60,151,23,128
"2011","Doncaster 025A","E01007521","Total",599,230,14,216,165,62,156,24,132
"2011","Doncaster 025B","E01007523","Total",661,249,11,238,147,55,175,20,155
"2011","Doncaster 025C","E01007524","Total",720,302,8,294,148,51,188,23,165
"2011","Doncaster 025D","E01007526","Total",667,244,11,233,178,65,195,28,167
"2011","Doncaster 025E","E01007607","Total",607,231,45,186,177,87,170,33,137
"2011","Doncaster 026A","E01007599","Total",715,219,7,212,233,72,177,30,147
"2011","Doncaster 026B","E01007600","Total",604,199,5,194,155,32,135,17,118
"2011","Doncaster 026C","E01007601","Total",610,249,4,245,145,46,184,28,156
"2011","Doncaster 026D","E01007602","Total",614,184,5,179,173,35,160,29,131
"2011","Doncaster 026E","E01007603","Total",603,182,9,173,175,67,109,18,91
"2011","Doncaster 027A","E01007520","Total",605,281,7,274,137,44,167,20,147
"2011","Doncaster 027B","E01007527","Total",1015,180,16,164,284,110,148,37,111
"2011","Doncaster 027C","E01007605","Total",633,247,10,237,166,46,182,27,155
"2011","Doncaster 027D","E01007606","Total",607,216,13,203,161,44,136,21,115
"2011","Doncaster 028A","E01007495","Total",757,274,73,201,265,130,206,47,159
"2011","Doncaster 028B","E01007500","Total",577,276,38,238,189,72,223,45,178
"2011","Doncaster 028C","E01007502","Total",1080,104,19,85,403,185,133,46,87
"2011","Doncaster 028D","E01007534","Total",916,348,91,257,276,176,209,35,174
"2011","Doncaster 029A","E01007496","Total",606,235,94,141,268,122,191,59,132
"2011","Doncaster 029B","E01007497","Total",542,204,52,152,193,89,155,33,122
"2011","Doncaster 029C","E01007498","Total",657,212,40,172,216,101,175,35,140
"2011","Doncaster 029D","E01007499","Total",655,339,58,281,185,72,242,38,204
"2011","Doncaster 029E","E01007501","Total",643,280,14,266,143,47,216,33,183
"2011","Doncaster 029F","E01007503","Total",683,189,12,177,184,70,153,20,133
"2011","Doncaster 030A","E01007575","Total",627,364,67,297,185,87,264,46,218
"2011","Doncaster 030B","E01007578","Total",685,272,50,222,216,76,192,36,156
"2011","Doncaster 030C","E01007579","Total",691,248,21,227,182,85,224,23,201
"2011","Doncaster 030D","E01007580","Total",620,286,27,259,129,32,202,27,175
"2011","Doncaster 031A","E01007571","Total",690,216,35,181,215,79,187,38,149
"2011","Doncaster 031B","E01007572","Total",574,229,40,189,181,63,175,40,135
"2011","Doncaster 031C","E01007573","Total",667,339,66,273,219,87,261,59,202
"2011","Doncaster 031D","E01007574","Total",638,265,53,212,209,104,209,40,169
"2011","Doncaster 031E","E01007576","Total",646,219,35,184,182,64,192,32,160
"2011","Doncaster 031F","E01007577","Total",711,335,79,256,210,116,225,39,186
"2011","Doncaster 032A","E01007536","Total",890,274,32,242,230,114,213,34,179
"2011","Doncaster 032B","E01007542","Total",787,383,57,326,214,91,298,37,261
"2011","Doncaster 032C","E01007543","Total",687,394,54,340,175,53,313,53,260
"2011","Doncaster 032D","E01007544","Total",750,503,97,406,213,97,328,48,280
"2011","Doncaster 033A","E01007546","Total",619,251,51,200,192,95,170,27,143
"2011","Doncaster 033B","E01007551","Total",725,254,15,239,185,66,186,23,163
"2011","Doncaster 033C","E01007552","Total",603,213,13,200,160,60,163,28,135
"2011","Doncaster 033D","E01007613","Total",673,243,7,236,137,38,173,22,151
"2011","Doncaster 034A","E01007545","Total",616,174,33,141,193,93,140,23,117
"2011","Doncaster 034B","E01007547","Total",607,223,53,170,210,85,172,43,129
"2011","Doncaster 034C","E01007548","Total",425,176,49,127,165,69,118,25,93
"2011","Doncaster 034D","E01007549","Total",653,319,30,289,168,56,276,42,234
"2011","Doncaster 034E","E01007550","Total",696,286,30,256,208,61,243,41,202
"2011","Doncaster 035A","E01007537","Total",706,235,34,201,225,86,203,43,160
"2011","Doncaster 035B","E01007538","Total",590,218,38,180,220,75,190,53,137
"2011","Doncaster 035C","E01007539","Total",545,201,48,153,203,77,155,31,124
"2011","Doncaster 035D","E01007540","Total",639,211,42,169,230,106,186,46,140
"2011","Doncaster 035E","E01007541","Total",646,279,31,248,176,72,222,36,186
"2011","Doncaster 036A","E01007591","Total",607,244,26,218,169,62,170,26,144
"2011","Doncaster 036B","E01007594","Total",825,159,15,144,296,116,164,52,112
"2011","Doncaster 036C","E01007596","Total",499,153,5,148,125,28,130,16,114
"2011","Doncaster 036D","E01007598","Total",665,208,13,195,159,59,171,25,146
"2011","Doncaster 037A","E01007590","Total",476,156,32,124,180,65,133,36,97
"2011","Doncaster 037B","E01007592","Total",641,271,62,209,249,131,204,36,168
"2011","Doncaster 037C","E01007593","Total",508,177,45,132,185,81,145,35,110
"2011","Doncaster 037D","E01007595","Total",633,271,46,225,191,66,225,44,181
"2011","Doncaster 037E","E01007597","Total",683,330,78,252,240,123,252,58,194
"2011","Doncaster 038A","E01007608","Total",623,100,40,60,327,99,122,50,72
"2011","Doncaster 038B","E01007609","Total",1023,364,26,338,280,97,287,59,228
"2011","Doncaster 038C","E01007610","Total",813,314,7,307,190,59,180,21,159
"2011","Doncaster 039A","E01007611","Total",583,235,11,224,127,41,171,20,151
"2011","Doncaster 039B","E01007612","Total",638,250,6,244,125,39,163,18,145
"2011","Doncaster 039C","E01007614","Total",532,165,7,158,153,46,113,13,100
"2011","Doncaster 039D","E01007615","Total",641,317,12,305,110,45,217,20,197
"2011","Doncaster 039E","E01007616","Total",587,259,9,250,119,44,149,14,135
"2011","Rotherham 001A","E01007693","Total",941,268,37,231,303,138,254,60,194
"2011","Rotherham 001B","E01007694","Total",737,285,55,230,243,105,249,45,204
"2011","Rotherham 001C","E01007695","Total",972,232,24,208,384,167,233,49,184
"2011","Rotherham 001D","E01007697","Total",662,322,39,283,204,58,257,53,204
"2011","Rotherham 001E","E01007698","Total",634,180,21,159,181,66,165,27,138
"2011","Rotherham 002A","E01007816","Total",649,247,39,208,229,88,212,44,168
"2011","Rotherham 002B","E01007817","Total",638,283,28,255,163,60,239,39,200
"2011","Rotherham 002C","E01007819","Total",627,281,12,269,155,57,188,20,168
"2011","Rotherham 002D","E01007820","Total",625,182,56,126,223,100,140,35,105
"2011","Rotherham 002E","E01007821","Total",670,287,26,261,191,66,239,37,202
"2011","Rotherham 002F","E01007822","Total",710,360,54,306,186,75,264,49,215
"2011","Rotherham 003A","E01007796","Total",573,311,40,271,157,66,230,26,204
"2011","Rotherham 003B","E01007797","Total",580,231,16,215,166,53,153,25,128
"2011","Rotherham 003C","E01007798","Total",543,196,5,191,130,26,155,25,130
"2011","Rotherham 003D","E01007799","Total",613,276,25,251,170,68,216,30,186
"2011","Rotherham 003E","E01007800","Total",698,239,23,216,163,71,188,26,162
"2011","Rotherham 003F","E01007818","Total",674,241,11,230,183,56,173,26,147
"2011","Rotherham 004A","E01007777","Total",651,241,41,200,213,86,190,37,153
"2011","Rotherham 004B","E01007793","Total",628,270,21,249,162,59,229,30,199
"2011","Rotherham 004C","E01007794","Total",553,253,75,178,212,82,176,47,129
"2011","Rotherham 004D","E01007795","Total",634,210,8,202,144,52,173,17,156
"2011","Rotherham 005A","E01007778","Total",593,171,13,158,204,43,147,26,121
"2011","Rotherham 005B","E01007779","Total",582,287,29,258,132,58,210,20,190
"2011","Rotherham 005C","E01007780","Total",616,262,16,246,146,36,170,32,138
"2011","Rotherham 005D","E01007781","Total",656,274,38,236,210,74,214,34,180
"2011","Rotherham 005E","E01007782","Total",597,222,44,178,212,84,183,36,147
"2011","Rotherham 006A","E01007771","Total",620,209,16,193,165,68,165,25,140
"2011","Rotherham 006B","E01007772","Total",556,199,29,170,177,78,154,29,125
"2011","Rotherham 006C","E01007773","Total",642,273,49,224,197,98,201,37,164
"2011","Rotherham 006D","E01007774","Total",605,186,52,134,239,102,155,41,114
"2011","Rotherham 007A","E01007696","Total",662,242,4,238,149,54,167,13,154
"2011","Rotherham 007B","E01007801","Total",614,165,9,156,185,51,126,20,106
"2011","Rotherham 007C","E01007802","Total",581,168,5,163,134,40,149,18,131
"2011","Rotherham 007D","E01007803","Total",547,169,18,151,175,66,145,27,118
"2011","Rotherham 007E","E01007808","Total",590,120,2,118,156,44,127,22,105
"2011","Rotherham 008A","E01007775","Total",545,268,89,179,209,78,187,47,140
"2011","Rotherham 008B","E01007776","Total",652,241,34,207,189,66,189,28,161
"2011","Rotherham 008C","E01007783","Total",813,405,38,367,187,83,313,32,281
"2011","Rotherham 008D","E01007784","Total",762,231,49,182,244,110,177,41,136
"2011","Rotherham 009A","E01007728","Total",483,199,17,182,121,35,160,19,141
"2011","Rotherham 009B","E01007729","Total",846,419,36,383,154,70,304,28,276
"2011","Rotherham 009C","E01007730","Total",702,323,39,284,152,62,255,30,225
"2011","Rotherham 009D","E01007731","Total",566,200,17,183,121,37,167,25,142
"2011","Rotherham 009E","E01007732","Total",766,387,23,364,122,46,298,16,282
"2011","Rotherham 009F","E01007733","Total",629,275,23,252,149,43,221,34,187
"2011","Rotherham 010A","E01007719","Total",525,254,51,203,168,60,188,37,151
"2011","Rotherham 010B","E01007720","Total",638,269,28,241,175,61,218,35,183
"2011","Rotherham 010C","E01007721","Total",711,332,74,258,208,95,250,47,203
"2011","Rotherham 010D","E01007727","Total",684,350,43,307,176,69,285,42,243
"2011","Rotherham 011A","E01007740","Total",595,225,39,186,199,59,192,41,151
"2011","Rotherham 011B","E01007804","Total",661,316,35,281,173,63,244,47,197
"2011","Rotherham 011C","E01007805","Total",641,321,41,280,178,68,266,36,230
"2011","Rotherham 011D","E01007806","Total",518,200,47,153,212,64,165,50,115
"2011","Rotherham 011E","E01007807","Total",607,247,38,209,199,70,201,50,151
"2011","Rotherham 012A","E01007681","Total",576,236,9,227,130,49,186,18,168
"2011","Rotherham 012B","E01007691","Total",884,292,4,288,225,83,234,31,203
"2011","Rotherham 012C","E01007692","Total",712,249,8,241,176,68,194,25,169
"2011","Rotherham 012E","E01032926","Total",642,58,18,40,328,162,82,33,49
"2011","Rotherham 012F","E01032927","Total",634,186,25,161,229,101,170,45,125
"2011","Rotherham 013A","E01007723","Total",589,264,58,206,185,71,189,39,150
"2011","Rotherham 013B","E01007735","Total",556,278,103,175,231,97,201,59,142
"2011","Rotherham 013C","E01007737","Total",595,261,101,160,267,115,165,51,114
"2011","Rotherham 013D","E01007738","Total",554,248,93,155,231,106,161,49,112
"2011","Rotherham 013E","E01007739","Total",619,341,59,282,200,89,269,48,221
"2011","Rotherham 014A","E01007736","Total",678,347,99,248,238,100,234,49,185
"2011","Rotherham 014B","E01007765","Total",641,184,37,147,208,83,138,23,115
"2011","Rotherham 014C","E01007766","Total",519,169,55,114,216,77,154,47,107
"2011","Rotherham 014D","E01007768","Total",816,384,70,314,234,136,269,48,221
"2011","Rotherham 014E","E01007770","Total",613,222,63,159,230,103,207,59,148
"2011","Rotherham 015A","E01007741","Total",680,253,0,253,146,48,190,16,174
"2011","Rotherham 015B","E01007742","Total",607,243,31,212,185,60,202,45,157
"2011","Rotherham 015C","E01007743","Total",502,126,7,119,154,36,106,22,84
"2011","Rotherham 015D","E01007744","Total",713,252,26,226,183,66,176,19,157
"2011","Rotherham 015E","E01007745","Total",677,284,54,230,211,74,221,46,175
"2011","Rotherham 015F","E01007746","Total",587,179,22,157,203,67,141,31,110
"2011","Rotherham 016A","E01007715","Total",643,247,111,136,295,179,161,56,105
"2011","Rotherham 016B","E01007716","Total",744,325,62,263,225,119,246,55,191
"2011","Rotherham 016C","E01007717","Total",813,302,67,235,273,123,237,53,184
"2011","Rotherham 016D","E01007718","Total",653,246,59,187,212,100,196,41,155
"2011","Rotherham 017A","E01007677","Total",558,278,77,201,174,82,202,40,162
"2011","Rotherham 017B","E01007714","Total",990,423,60,363,199,104,329,48,281
"2011","Rotherham 017C","E01007767","Total",671,249,36,213,182,66,221,34,187
"2011","Rotherham 017D","E01007769","Total",614,230,68,162,265,151,152,49,103
"2011","Rotherham 018A","E01007685","Total",597,189,12,177,172,57,125,25,100
"2011","Rotherham 018B","E01007754","Total",523,92,10,82,206,61,116,36,80
"2011","Rotherham 018C","E01007755","Total",573,121,12,109,171,69,135,25,110
"2011","Rotherham 018D","E01007756","Total",601,171,5,166,177,55,147,29,118
"2011","Rotherham 018E","E01007761","Total",701,282,32,250,217,68,237,43,194
"2011","Rotherham 018F","E01007762","Total",582,232,20,212,160,48,193,31,162
"2011","Rotherham 019A","E01007682","Total",555,175,21,154,182,71,170,37,133
"2011","Rotherham 019B","E01007683","Total",582,169,11,158,152,47,165,18,147
"2011","Rotherham 019C","E01007686","Total",686,332,7,325,122,37,221,29,192
"2011","Rotherham 019D","E01007688","Total",654,304,19,285,160,50,199,28,171
"2011","Rotherham 019E","E01007725","Total",477,115,13,102,186,43,111,23,88
"2011","Rotherham 019F","E01007726","Total",733,358,71,287,226,117,272,45,227
"2011","Rotherham 020A","E01007757","Total",674,224,23,201,199,67,197,42,155
"2011","Rotherham 020B","E01007758","Total",565,236,30,206,177,73,192,28,164
"2011","Rotherham 020C","E01007759","Total",670,271,43,228,185,68,250,50,200
"2011","Rotherham 020D","E01007760","Total",786,341,108,233,279,142,231,60,171
"2011","Rotherham 020E","E01007763","Total",674,311,57,254,197,99,236,34,202
"2011","Rotherham 020F","E01007764","Total",691,347,107,240,260,107,252,56,196
"2011","Rotherham 021A","E01007708","Total",761,395,48,347,212,77,311,51,260
"2011","Rotherham 021B","E01007709","Total",611,231,7,224,173,59,164,25,139
"2011","Rotherham 021C","E01007710","Total",656,251,6,245,159,57,166,12,154
"2011","Rotherham 021D","E01007711","Total",688,236,11,225,212,67,176,23,153
"2011","Rotherham 021E","E01007724","Total",584,212,12,200,156,55,182,38,144
"2011","Rotherham 021F","E01007734","Total",768,383,57,326,253,80,328,54,274
"2011","Rotherham 022A","E01007684","Total",666,163,14,149,234,89,143,32,111
"2011","Rotherham 022B","E01007687","Total",644,283,13,270,170,56,226,36,190
"2011","Rotherham 022C","E01007689","Total",623,192,7,185,208,67,165,22,143
"2011","Rotherham 022D","E01007690","Total",694,283,9,274,178,34,174,33,141
"2011","Rotherham 023A","E01007675","Total",653,206,28,178,236,100,170,40,130
"2011","Rotherham 023B","E01007678","Total",662,272,14,258,155,57,152,27,125
"2011","Rotherham 023C","E01007679","Total",748,290,26,264,217,73,269,48,221
"2011","Rotherham 023D","E01007680","Total",684,259,43,216,239,111,213,53,160
"2011","Rotherham 023E","E01007712","Total",747,229,15,214,236,97,170,32,138
"2011","Rotherham 023F","E01007713","Total",632,236,10,226,181,62,152,25,127
"2011","Rotherham 024A","E01007811","Total",579,220,6,214,150,56,143,22,121
"2011","Rotherham 024B","E01007812","Total",544,236,27,209,144,59,194,26,168
"2011","Rotherham 024C","E01007813","Total",591,193,20,173,159,57,163,32,131
"2011","Rotherham 024D","E01007814","Total",474,175,6,169,109,37,150,11,139
"2011","Rotherham 025A","E01007676","Total",719,295,44,251,196,91,208,35,173
"2011","Rotherham 025B","E01007702","Total",614,163,45,118,236,102,135,34,101
"2011","Rotherham 025C","E01007703","Total",500,198,15,183,146,33,122,22,100
"2011","Rotherham 025D","E01007704","Total",670,294,18,276,166,71,212,20,192
"2011","Rotherham 025E","E01007705","Total",593,191,10,181,188,62,139,24,115
"2011","Rotherham 025F","E01007707","Total",649,251,14,237,157,49,167,21,146
"2011","Rotherham 026A","E01007666","Total",570,167,9,158,129,39,157,17,140
"2011","Rotherham 026B","E01007809","Total",726,360,51,309,185,71,285,41,244
"2011","Rotherham 026C","E01007810","Total",793,309,33,276,249,97,259,47,212
"2011","Rotherham 026D","E01007815","Total",705,254,60,194,230,103,205,32,173
"2011","Rotherham 027A","E01007665","Total",702,194,14,180,230,83,154,22,132
"2011","Rotherham 027B","E01007699","Total",755,235,50,185,252,125,215,55,160
"2011","Rotherham 027C","E01007700","Total",719,167,24,143,273,110,158,38,120
"2011","Rotherham 027D","E01007701","Total",723,314,53,261,207,88,261,48,213
"2011","Rotherham 027E","E01007706","Total",556,122,20,102,183,74,131,23,108
"2011","Rotherham 028A","E01007787","Total",1197,320,35,285,331,165,263,53,210
"2011","Rotherham 028B","E01007788","Total",659,222,20,202,173,70,184,34,150
"2011","Rotherham 028C","E01007789","Total",739,332,41,291,197,81,268,41,227
"2011","Rotherham 028D","E01007792","Total",484,107,5,102,195,45,123,32,91
"2011","Rotherham 029A","E01007657","Total",582,180,16,164,181,64,135,26,109
"2011","Rotherham 029B","E01007659","Total",472,146,9,137,142,50,119,26,93
"2011","Rotherham 029C","E01007785","Total",519,158,22,136,181,65,144,34,110
"2011","Rotherham 029D","E01007786","Total",486,181,12,169,130,44,152,22,130
"2011","Rotherham 029E","E01007790","Total",696,349,77,272,188,88,225,31,194
"2011","Rotherham 029F","E01007791","Total",551,226,47,179,188,77,162,35,127
"2011","Rotherham 030A","E01007667","Total",579,205,28,177,194,73,169,33,136
"2011","Rotherham 030B","E01007668","Total",690,345,59,286,203,82,280,54,226
"2011","Rotherham 030C","E01007669","Total",647,262,14,248,144,45,206,21,185
"2011","Rotherham 030D","E01007670","Total",610,181,5,176,149,56,140,24,116
"2011","Rotherham 030E","E01007672","Total",589,150,12,138,179,77,121,29,92
"2011","Rotherham 030F","E01007673","Total",640,268,61,207,205,97,191,32,159
"2011","Rotherham 031A","E01007671","Total",822,182,27,155,324,135,200,53,147
"2011","Rotherham 031B","E01007674","Total",817,203,9,194,238,110,183,36,147
"2011","Rotherham 031C","E01007747","Total",537,219,30,189,160,60,190,32,158
"2011","Rotherham 031D","E01007750","Total",642,238,18,220,158,53,187,32,155
"2011","Rotherham 032A","E01007658","Total",581,160,16,144,168,60,135,23,112
"2011","Rotherham 032B","E01007660","Total",488,154,6,148,130,41,109,20,89
"2011","Rotherham 032C","E01007661","Total",574,208,17,191,165,46,144,20,124
"2011","Rotherham 032D","E01007662","Total",470,247,42,205,144,48,183,31,152
"2011","Rotherham 032E","E01007663","Total",637,243,6,237,151,48,158,13,145
"2011","Rotherham 032F","E01007664","Total",828,357,15,342,179,50,253,37,216
"2011","Rotherham 033A","E01007748","Total",648,285,11,274,141,47,191,20,171
"2011","Rotherham 033B","E01007749","Total",762,227,17,210,245,83,189,38,151
"2011","Rotherham 033C","E01007751","Total",834,236,33,203,285,149,197,35,162
"2011","Rotherham 033D","E01007752","Total",619,171,6,165,173,61,139,20,119
"2011","Rotherham 033E","E01007753","Total",670,267,13,254,184,52,187,24,163
"2011","Sheffield 001A","E01008144","Total",716,231,27,204,206,78,174,31,143
"2011","Sheffield 001B","E01008145","Total",712,338,20,318,150,51,265,37,228
"2011","Sheffield 001C","E01008148","Total",637,269,28,241,177,59,206,34,172
"2011","Sheffield 001D","E01008149","Total",653,204,9,195,187,75,137,27,110
"2011","Sheffield 001E","E01008150","Total",638,253,21,232,172,74,193,26,167
"2011","Sheffield 002A","E01008142","Total",623,224,28,196,194,79,182,40,142
"2011","Sheffield 002B","E01008143","Total",776,267,23,244,198,81,193,26,167
"2011","Sheffield 002C","E01008146","Total",523,146,3,143,168,59,95,15,80
"2011","Sheffield 002D","E01008147","Total",617,222,2,220,145,49,171,15,156
"2011","Sheffield 003A","E01007888","Total",553,121,13,108,164,56,110,16,94
"2011","Sheffield 003B","E01007892","Total",639,314,63,251,199,79,226,34,192
"2011","Sheffield 003C","E01007893","Total",627,200,3,197,159,44,156,21,135
"2011","Sheffield 003D","E01007898","Total",619,136,4,132,197,61,124,18,106
"2011","Sheffield 003E","E01007899","Total",612,210,7,203,152,50,150,16,134
"2011","Sheffield 003F","E01007900","Total",760,274,38,236,219,80,216,35,181
"2011","Sheffield 003G","E01007901","Total",712,364,43,321,182,60,268,37,231
"2011","Sheffield 004A","E01007887","Total",605,210,9,201,167,61,175,24,151
"2011","Sheffield 004B","E01007889","Total",1044,228,14,214,387,154,220,53,167
"2011","Sheffield 004C","E01007890","Total",585,173,3,170,173,61,136,23,113
"2011","Sheffield 004D","E01007891","Total",659,261,5,256,159,51,184,21,163
"2011","Sheffield 004E","E01007894","Total",639,166,9,157,169,69,145,17,128
"2011","Sheffield 004F","E01007895","Total",645,277,25,252,151,46,203,23,180
"2011","Sheffield 004G","E01007896","Total",551,162,8,154,136,35,133,14,119
"2011","Sheffield 005A","E01007897","Total",622,239,5,234,129,33,179,28,151
"2011","Sheffield 005B","E01008134","Total",616,247,9,238,128,36,190,20,170
"2011","Sheffield 005C","E01008135","Total",758,175,14,161,204,85,134,16,118
"2011","Sheffield 005D","E01008137","Total",626,258,5,253,142,46,160,19,141
"2011","Sheffield 005E","E01008141","Total",667,224,6,218,172,72,133,14,119
"2011","Sheffield 006A","E01008053","Total",565,259,30,229,148,44,219,37,182
"2011","Sheffield 006B","E01008056","Total",594,206,36,170,204,71,176,41,135
"2011","Sheffield 006C","E01008058","Total",620,226,8,218,154,49,196,22,174
"2011","Sheffield 006D","E01008138","Total",630,340,11,329,134,36,272,25,247
"2011","Sheffield 006E","E01008139","Total",707,263,19,244,172,58,212,38,174
"2011","Sheffield 007A","E01007856","Total",543,195,46,149,192,77,157,41,116
"2011","Sheffield 007B","E01008054","Total",537,217,83,134,237,112,175,57,118
"2011","Sheffield 007C","E01008055","Total",607,252,80,172,250,112,194,57,137
"2011","Sheffield 007D","E01008057","Total",600,221,58,163,245,119,191,49,142
"2011","Sheffield 008A","E01008126","Total",646,247,7,240,180,52,167,22,145
"2011","Sheffield 008C","E01008128","Total",723,173,7,166,184,71,157,22,135
"2011","Sheffield 008D","E01008136","Total",584,215,19,196,173,58,175,29,146
"2011","Sheffield 008E","E01008140","Total",848,280,16,264,230,89,229,32,197
"2011","Sheffield 008F","E01033275","Total",655,107,23,84,247,112,109,31,78
"2011","Sheffield 008G","E01033280","Total",601,130,8,122,231,68,102,21,81
"2011","Sheffield 009A","E01008085","Total",617,274,52,222,176,67,213,44,169
"2011","Sheffield 009B","E01008086","Total",575,226,53,173,198,86,179,38,141
"2011","Sheffield 009C","E01008116","Total",552,255,61,194,196,81,202,50,152
"2011","Sheffield 009D","E01008117","Total",555,277,40,237,142,47,234,38,196
"2011","Sheffield 009E","E01008118","Total",616,282,52,230,175,80,217,35,182
"2011","Sheffield 009F","E01008119","Total",469,168,49,119,196,94,160,49,111
"2011","Sheffield 009G","E01008125","Total",612,282,40,242,172,58,221,40,181
"2011","Sheffield 010A","E01007849","Total",866,319,77,242,332,139,259,70,189
"2011","Sheffield 010B","E01007857","Total",650,285,81,204,240,119,226,53,173
"2011","Sheffield 010C","E01008059","Total",633,278,73,205,224,100,216,43,173
"2011","Sheffield 010D","E01008060","Total",624,255,59,196,225,97,199,50,149
"2011","Sheffield 011A","E01008061","Total",649,283,69,214,238,117,210,42,168
"2011","Sheffield 011B","E01008063","Total",702,304,27,277,167,58,226,36,190
"2011","Sheffield 011E","E01033277","Total",954,423,136,287,364,183,301,79,222
"2011","Sheffield 012A","E01008087","Total",667,191,14,177,171,68,126,21,105
"2011","Sheffield 012B","E01008088","Total",658,223,15,208,151,53,186,31,155
"2011","Sheffield 012C","E01008090","Total",742,332,91,241,241,134,243,40,203
"2011","Sheffield 012D","E01008092","Total",726,368,48,320,171,86,278,37,241
"2011","Sheffield 012E","E01008122","Total",548,265,90,175,230,115,185,46,139
"2011","Sheffield 012F","E01008124","Total",663,294,89,205,254,142,181,44,137
"2011","Sheffield 013A","E01007848","Total",689,290,87,203,250,116,221,39,182
"2011","Sheffield 013B","E01007851","Total",524,210,73,137,213,88,153,45,108
"2011","Sheffield 013C","E01007947","Total",868,546,65,481,152,79,381,34,347
"2011","Sheffield 013D","E01007948","Total",612,272,89,183,268,120,213,77,136
"2011","Sheffield 013E","E01008062","Total",608,299,82,217,250,123,221,43,178
"2011","Sheffield 014A","E01007847","Total",643,278,38,240,152,70,209,25,184
"2011","Sheffield 014B","E01007850","Total",619,195,33,162,191,57,145,33,112
"2011","Sheffield 014C","E01007852","Total",637,149,21,128,190,72,128,18,110
"2011","Sheffield 014D","E01007853","Total",691,223,23,200,180,67,192,38,154
"2011","Sheffield 014E","E01007854","Total",645,225,112,113,306,166,157,58,99
"2011","Sheffield 014F","E01007855","Total",785,204,87,117,304,160,196,59,137
"2011","Sheffield 015A","E01007941","Total",656,319,56,263,203,82,241,41,200
"2011","Sheffield 015B","E01007945","Total",747,335,87,248,267,113,239,56,183
"2011","Sheffield 015C","E01007946","Total",623,257,99,158,265,137,195,53,142
"2011","Sheffield 015D","E01007950","Total",634,267,82,185,266,130,151,38,113
"2011","Sheffield 015E","E01008123","Total",519,206,51,155,206,93,172,45,127
"2011","Sheffield 016A","E01007987","Total",593,138,17,121,192,67,130,31,99
"2011","Sheffield 016B","E01007988","Total",651,220,7,213,192,56,185,18,167
"2011","Sheffield 016C","E01007989","Total",607,122,10,112,180,81,127,29,98
"2011","Sheffield 016D","E01007991","Total",623,256,49,207,222,67,188,40,148
"2011","Sheffield 017A","E01007995","Total",696,156,25,131,178,83,129,30,99
"2011","Sheffield 017B","E01008089","Total",672,227,60,167,236,104,192,53,139
"2011","Sheffield 017C","E01008091","Total",647,111,19,92,176,71,128,27,101
"2011","Sheffield 017D","E01008093","Total",773,229,17,212,146,66,204,19,185
"2011","Sheffield 018A","E01007903","Total",589,237,33,204,204,86,194,47,147
"2011","Sheffield 018B","E01007904","Total",675,372,88,284,243,125,282,64,218
"2011","Sheffield 018C","E01007913","Total",477,172,70,102,244,137,134,54,80
"2011","Sheffield 018D","E01007914","Total",494,183,79,104,262,127,133,57,76
"2011","Sheffield 019A","E01007870","Total",738,308,40,268,215,115,223,50,173
"2011","Sheffield 019B","E01007871","Total",855,402,55,347,200,107,295,36,259
"2011","Sheffield 019C","E01007943","Total",794,390,98,292,260,127,287,56,231
"2011","Sheffield 019D","E01008094","Total",471,208,51,157,140,78,144,30,114
"2011","Sheffield 020A","E01007869","Total",508,153,58,95,244,125,148,58,90
"2011","Sheffield 020B","E01007872","Total",627,219,44,175,219,117,193,58,135
"2011","Sheffield 020C","E01007873","Total",647,283,67,216,246,137,218,46,172
"2011","Sheffield 020D","E01007942","Total",518,161,67,94,270,133,157,66,91
"2011","Sheffield 020E","E01007949","Total",502,164,58,106,239,124,111,44,67
"2011","Sheffield 021A","E01007990","Total",661,273,19,254,169,65,194,26,168
"2011","Sheffield 021B","E01007992","Total",698,179,11,168,201,79,158,24,134
"2011","Sheffield 021C","E01007993","Total",689,266,39,227,206,71,224,41,183
"2011","Sheffield 021D","E01007994","Total",607,125,16,109,193,86,112,24,88
"2011","Sheffield 021E","E01007996","Total",702,235,14,221,182,83,196,26,170
"2011","Sheffield 022A","E01007874","Total",669,343,143,200,295,147,238,81,157
"2011","Sheffield 022B","E01007875","Total",607,286,126,160,291,138,184,68,116
"2011","Sheffield 022D","E01007877","Total",418,136,56,80,210,126,147,66,81
"2011","Sheffield 022E","E01007940","Total",630,289,106,183,284,133,190,58,132
"2011","Sheffield 022F","E01007944","Total",593,193,85,108,320,199,153,70,83
"2011","Sheffield 022G","E01033269","Total",666,332,145,187,301,173,202,70,132
"2011","Sheffield 022H","E01033270","Total",787,240,69,171,128,70,108,24,84
"2011","Sheffield 023A","E01008129","Total",578,174,6,168,169,39,139,20,119
"2011","Sheffield 023B","E01008130","Total",647,239,8,231,162,44,162,22,140
"2011","Sheffield 023C","E01008131","Total",650,207,10,197,187,64,167,19,148
"2011","Sheffield 023D","E01008132","Total",558,144,4,140,180,51,117,20,97
"2011","Sheffield 023E","E01008133","Total",744,368,8,360,149,42,279,11,268
"2011","Sheffield 024A","E01008151","Total",699,159,9,150,126,61,103,15,88
"2011","Sheffield 024B","E01008153","Total",839,221,24,197,143,69,171,16,155
"2011","Sheffield 024C","E01008154","Total",807,242,17,225,161,72,203,28,175
"2011","Sheffield 024D","E01008155","Total",722,192,31,161,145,65,169,26,143
"2011","Sheffield 024E","E01008156","Total",674,175,8,167,139,55,144,27,117
"2011","Sheffield 024F","E01008160","Total",657,217,14,203,146,64,177,23,154
"2011","Sheffield 025A","E01007997","Total",644,276,22,254,174,70,173,28,145
"2011","Sheffield 025B","E01007998","Total",891,503,21,482,146,59,373,28,345
"2011","Sheffield 025C","E01008152","Total",665,239,14,225,158,63,169,22,147
"2011","Sheffield 025D","E01008158","Total",730,297,43,254,188,78,230,33,197
"2011","Sheffield 026A","E01008065","Total",965,588,88,500,215,111,377,46,331
"2011","Sheffield 026B","E01008068","Total",891,470,87,383,222,110,242,57,185
"2011","Sheffield 026C","E01008072","Total",656,272,48,224,188,79,222,54,168
"2011","Sheffield 026D","E01008157","Total",859,442,29,413,144,42,355,28,327
"2011","Sheffield 026E","E01008161","Total",805,233,28,205,168,77,176,24,152
"2011","Sheffield 027A","E01007883","Total",414,188,69,119,205,102,131,45,86
"2011","Sheffield 027B","E01007902","Total",792,432,61,371,203,122,301,35,266
"2011","Sheffield 027C","E01007905","Total",513,173,98,75,320,136,150,93,57
"2011","Sheffield 027D","E01007906","Total",631,242,81,161,310,166,187,74,113
"2011","Sheffield 028A","E01008064","Total",628,168,10,158,109,46,111,19,92
"2011","Sheffield 028B","E01008066","Total",456,149,2,147,35,17,62,4,58
"2011","Sheffield 028C","E01008069","Total",573,179,9,170,67,30,109,12,97
"2011","Sheffield 028D","E01008074","Total",561,119,5,114,106,47,103,16,87
"2011","Sheffield 029A","E01007951","Total",695,225,9,216,163,66,173,23,150
"2011","Sheffield 029B","E01007960","Total",694,193,7,186,134,59,121,13,108
"2011","Sheffield 029C","E01007962","Total",628,236,5,231,82,44,149,12,137
"2011","Sheffield 029D","E01008159","Total",762,196,13,183,132,71,142,14,128
"2011","Sheffield 030A","E01007866","Total",572,162,7,155,103,40,112,9,103
"2011","Sheffield 030B","E01007867","Total",634,211,8,203,53,18,128,9,119
"2011","Sheffield 030C","E01007868","Total",493,152,6,146,87,38,115,12,103
"2011","Sheffield 030D","E01008067","Total",472,153,9,144,34,17,84,6,78
"2011","Sheffield 030E","E01008073","Total",700,271,10,261,105,32,187,13,174
"2011","Sheffield 032A","E01007907","Total",585,162,30,132,230,113,136,40,96
"2011","Sheffield 032B","E01007908","Total",658,151,14,137,198,91,131,32,99
"2011","Sheffield 032C","E01007909","Total",869,215,25,190,277,121,207,47,160
"2011","Sheffield 032D","E01007911","Total",592,192,11,181,169,66,163,23,140
"2011","Sheffield 032E","E01008014","Total",686,323,33,290,182,89,250,35,215
"2011","Sheffield 032F","E01008016","Total",621,247,31,216,177,74,204,39,165
"2011","Sheffield 033A","E01007952","Total",644,218,6,212,205,69,138,22,116
"2011","Sheffield 033B","E01007953","Total",844,439,5,434,111,34,295,18,277
"2011","Sheffield 033C","E01007954","Total",650,188,5,183,245,82,128,31,97
"2011","Sheffield 033D","E01007961","Total",591,165,3,162,205,77,128,20,108
"2011","Sheffield 036A","E01007859","Total",459,131,6,125,58,23,72,13,59
"2011","Sheffield 036B","E01007860","Total",607,186,9,177,94,43,118,8,110
"2011","Sheffield 036C","E01007863","Total",660,160,1,159,129,56,123,8,115
"2011","Sheffield 036D","E01007864","Total",521,100,2,98,27,10,57,1,56
"2011","Sheffield 036E","E01008104","Total",511,179,35,144,117,45,119,25,94
"2011","Sheffield 037A","E01007910","Total",727,298,52,246,210,80,222,39,183
"2011","Sheffield 037B","E01007912","Total",696,281,7,274,163,45,205,26,179
"2011","Sheffield 037C","E01007971","Total",619,245,31,214,185,61,208,42,166
"2011","Sheffield 037D","E01007973","Total",640,230,11,219,179,55,183,26,157
"2011","Sheffield 038A","E01007858","Total",649,129,8,121,160,61,88,24,64
"2011","Sheffield 038B","E01007861","Total",676,210,4,206,176,56,137,21,116
"2011","Sheffield 038C","E01007862","Total",682,269,14,255,104,43,120,16,104
"2011","Sheffield 038D","E01007865","Total",762,207,13,194,232,87,167,32,135
"2011","Sheffield 039A","E01008011","Total",684,340,110,230,260,133,260,67,193
"2011","Sheffield 039B","E01008012","Total",964,408,118,290,333,200,264,57,207
"2011","Sheffield 039C","E01008013","Total",527,224,57,167,168,69,178,42,136
"2011","Sheffield 039D","E01008015","Total",741,339,54,285,209,77,287,54,233
"2011","Sheffield 039E","E01008017","Total",709,360,65,295,213,80,258,48,210
"2011","Sheffield 039F","E01008018","Total",553,247,47,200,183,77,209,37,172
"2011","Sheffield 040A","E01008105","Total",734,208,26,182,150,67,111,19,92
"2011","Sheffield 040C","E01008107","Total",630,247,58,189,164,66,200,35,165
"2011","Sheffield 040D","E01008111","Total",574,121,8,113,90,34,103,13,90
"2011","Sheffield 040E","E01033271","Total",778,408,69,339,172,114,260,45,215
"2011","Sheffield 040F","E01033272","Total",675,221,35,186,83,47,146,20,126
"2011","Sheffield 041A","E01007955","Total",538,199,3,196,163,41,117,23,94
"2011","Sheffield 041B","E01007956","Total",910,310,7,303,306,91,215,44,171
"2011","Sheffield 041C","E01007957","Total",645,218,3,215,216,87,170,27,143
"2011","Sheffield 041D","E01007958","Total",618,234,8,226,168,59,133,20,113
"2011","Sheffield 041E","E01007959","Total",595,200,4,196,204,74,149,35,114
"2011","Sheffield 042A","E01008108","Total",722,174,40,134,145,75,99,22,77
"2011","Sheffield 042B","E01008109","Total",727,257,33,224,152,77,173,30,143
"2011","Sheffield 042D","E01008112","Total",575,152,39,113,212,124,121,45,76
"2011","Sheffield 042E","E01008113","Total",648,173,34,139,184,102,134,37,97
"2011","Sheffield 042F","E01033273","Total",550,188,28,160,90,41,96,15,81
"2011","Sheffield 042G","E01033274","Total",569,158,10,148,37,23,42,3,39
"2011","Sheffield 043A","E01008095","Total",629,233,56,177,133,75,151,26,125
"2011","Sheffield 043B","E01008096","Total",939,401,85,316,295,130,295,60,235
"2011","Sheffield 043C","E01008097","Total",710,342,86,256,228,111,260,42,218
"2011","Sheffield 043D","E01008101","Total",823,309,41,268,219,101,261,47,214
"2011","Sheffield 044A","E01007965","Total",839,440,59,381,244,88,342,50,292
"2011","Sheffield 044B","E01007969","Total",626,227,9,218,146,60,175,29,146
"2011","Sheffield 044C","E01007972","Total",613,203,7,196,172,59,149,25,124
"2011","Sheffield 044D","E01007974","Total",561,138,22,116,214,56,124,30,94
"2011","Sheffield 045A","E01007963","Total",721,292,16,276,153,49,241,18,223
"2011","Sheffield 045B","E01007967","Total",780,341,43,298,213,92,263,34,229
"2011","Sheffield 045C","E01007999","Total",562,148,7,141,134,35,128,13,115
"2011","Sheffield 045D","E01008008","Total",741,335,50,285,203,88,245,39,206
"2011","Sheffield 045E","E01008009","Total",615,282,113,169,297,144,196,61,135
"2011","Sheffield 046A","E01008043","Total",684,192,7,185,199,77,158,27,131
"2011","Sheffield 046B","E01008044","Total",621,227,14,213,205,87,155,24,131
"2011","Sheffield 046C","E01008047","Total",607,93,4,89,81,32,92,5,87
"2011","Sheffield 046D","E01008048","Total",537,100,3,97,88,33,76,9,67
"2011","Sheffield 046E","E01008050","Total",593,73,7,66,111,47,90,19,71
"2011","Sheffield 047A","E01007931","Total",644,225,5,220,200,82,163,22,141
"2011","Sheffield 047B","E01007934","Total",590,160,3,157,213,92,123,27,96
"2011","Sheffield 047C","E01007935","Total",557,91,11,80,171,84,73,16,57
"2011","Sheffield 047D","E01007936","Total",662,86,10,76,213,102,95,21,74
"2011","Sheffield 047E","E01007937","Total",575,164,6,158,198,83,129,28,101
"2011","Sheffield 047F","E01007938","Total",591,175,3,172,218,80,126,34,92
"2011","Sheffield 048A","E01008098","Total",632,282,90,192,266,118,195,48,147
"2011","Sheffield 048B","E01008100","Total",551,242,77,165,195,86,172,40,132
"2011","Sheffield 048C","E01008102","Total",540,281,42,239,151,67,198,30,168
"2011","Sheffield 048D","E01008103","Total",598,268,89,179,229,102,166,44,122
"2011","Sheffield 049A","E01007964","Total",716,255,16,239,161,68,203,21,182
"2011","Sheffield 049B","E01007966","Total",652,198,20,178,191,58,207,35,172
"2011","Sheffield 049C","E01007968","Total",622,273,49,224,191,62,225,41,184
"2011","Sheffield 049D","E01007970","Total",986,592,37,555,127,62,455,29,426
"2011","Sheffield 050A","E01008042","Total",643,174,16,158,177,87,154,31,123
"2011","Sheffield 050B","E01008045","Total",541,136,10,126,166,69,140,33,107
"2011","Sheffield 050C","E01008046","Total",704,145,22,123,207,115,145,35,110
"2011","Sheffield 050D","E01008049","Total",763,271,1,270,126,52,222,23,199
"2011","Sheffield 050E","E01008051","Total",642,136,18,118,190,95,126,34,92
"2011","Sheffield 050F","E01008052","Total",791,137,10,127,179,76,137,25,112
"2011","Sheffield 051A","E01007975","Total",814,340,43,297,177,81,275,40,235
"2011","Sheffield 051B","E01007976","Total",664,243,27,216,158,64,213,39,174
"2011","Sheffield 051C","E01007977","Total",849,457,54,403,145,67,294,29,265
"2011","Sheffield 051D","E01007979","Total",666,344,124,220,248,122,205,54,151
"2011","Sheffield 051E","E01008099","Total",654,144,23,121,192,89,129,36,93
"2011","Sheffield 052A","E01008000","Total",690,261,16,245,154,71,203,18,185
"2011","Sheffield 052B","E01008001","Total",662,240,30,210,198,79,209,40,169
"2011","Sheffield 052C","E01008004","Total",739,335,30,305,207,70,255,41,214
"2011","Sheffield 052D","E01008005","Total",711,266,11,255,162,63,207,30,177
"2011","Sheffield 052E","E01008010","Total",592,230,56,174,215,81,186,52,134
"2011","Sheffield 053A","E01007978","Total",759,145,33,112,216,94,132,40,92
"2011","Sheffield 053B","E01007980","Total",669,115,19,96,192,100,120,33,87
"2011","Sheffield 053C","E01007981","Total",602,110,13,97,184,91,132,40,92
"2011","Sheffield 053D","E01007983","Total",651,111,15,96,197,90,133,30,103
"2011","Sheffield 053E","E01007985","Total",662,177,13,164,190,77,143,32,111
"2011","Sheffield 054A","E01007982","Total",802,302,65,237,255,100,212,43,169
"2011","Sheffield 054B","E01008002","Total",695,255,12,243,161,64,180,21,159
"2011","Sheffield 054C","E01008003","Total",634,229,7,222,135,46,182,20,162
"2011","Sheffield 054D","E01008006","Total",637,239,5,234,123,41,172,18,154
"2011","Sheffield 055A","E01007927","Total",656,233,4,229,206,48,150,28,122
"2011","Sheffield 055B","E01007928","Total",706,238,9,229,209,67,162,26,136
"2011","Sheffield 055C","E01007929","Total",641,146,2,144,212,83,127,19,108
"2011","Sheffield 055D","E01007930","Total",543,172,4,168,207,68,114,19,95
"2011","Sheffield 055E","E01007932","Total",595,212,10,202,192,49,148,24,124
"2011","Sheffield 055F","E01007939","Total",653,225,4,221,190,52,159,15,144
"2011","Sheffield 056A","E01008028","Total",665,226,24,202,187,66,219,41,178
"2011","Sheffield 056B","E01008029","Total",598,202,25,177,212,79,174,34,140
"2011","Sheffield 056C","E01008032","Total",637,253,34,219,174,73,206,33,173
"2011","Sheffield 056D","E01008034","Total",684,202,33,169,254,78,200,40,160
"2011","Sheffield 059A","E01007828","Total",749,249,35,214,223,81,200,46,154
"2011","Sheffield 059B","E01007829","Total",731,165,16,149,200,85,154,27,127
"2011","Sheffield 059C","E01007831","Total",672,155,16,139,182,75,130,22,108
"2011","Sheffield 059D","E01007832","Total",686,172,12,160,208,78,144,29,115
"2011","Sheffield 059E","E01007986","Total",662,133,10,123,160,87,109,16,93
"2011","Sheffield 060A","E01008007","Total",826,435,45,390,174,68,315,36,279
"2011","Sheffield 060B","E01008075","Total",623,283,82,201,211,94,193,44,149
"2011","Sheffield 060C","E01008076","Total",625,280,53,227,169,78,201,38,163
"2011","Sheffield 060D","E01008077","Total",692,304,40,264,176,67,243,35,208
"2011","Sheffield 061A","E01008031","Total",630,225,18,207,173,60,197,25,172
"2011","Sheffield 061B","E01008033","Total",604,211,8,203,111,35,200,21,179
"2011","Sheffield 061C","E01008038","Total",742,323,8,315,129,34,206,22,184
"2011","Sheffield 061D","E01008040","Total",693,169,26,143,235,82,130,26,104
"2011","Sheffield 062A","E01007835","Total",618,235,15,220,163,54,156,21,135
"2011","Sheffield 062B","E01007836","Total",698,301,9,292,186,47,192,26,166
"2011","Sheffield 062C","E01007843","Total",776,364,30,334,194,85,269,34,235
"2011","Sheffield 062D","E01007846","Total",642,222,13,209,180,74,159,24,135
"2011","Sheffield 063A","E01008030","Total",558,137,13,124,183,66,123,28,95
"2011","Sheffield 063B","E01008035","Total",473,118,1,117,158,52,107,19,88
"2011","Sheffield 063C","E01008036","Total",601,97,7,90,200,66,97,23,74
"2011","Sheffield 063D","E01008041","Total",563,78,10,68,244,92,92,31,61
"2011","Sheffield 064A","E01007827","Total",701,232,6,226,148,68,197,24,173
"2011","Sheffield 064B","E01007830","Total",663,260,4,256,159,49,207,28,179
"2011","Sheffield 064C","E01007833","Total",795,391,8,383,159,48,268,31,237
"2011","Sheffield 064D","E01007984","Total",590,175,3,172,171,65,140,28,112
"2011","Sheffield 064E","E01008078","Total",650,264,5,259,121,46,178,19,159
"2011","Sheffield 064F","E01008079","Total",505,165,8,157,155,57,126,21,105
"2011","Sheffield 065A","E01008019","Total",735,194,35,159,256,97,204,48,156
"2011","Sheffield 065B","E01008020","Total",613,181,11,170,162,55,174,28,146
"2011","Sheffield 065C","E01008022","Total",773,375,72,303,193,98,246,40,206
"2011","Sheffield 065D","E01008027","Total",699,287,32,255,197,84,217,31,186
"2011","Sheffield 065E","E01008037","Total",720,390,39,351,118,40,281,19,262
"2011","Sheffield 065F","E01008039","Total",609,219,8,211,121,38,171,30,141
"2011","Sheffield 066A","E01007824","Total",562,185,7,178,175,66,147,32,115
"2011","Sheffield 066B","E01007825","Total",603,234,4,230,162,57,163,20,143
"2011","Sheffield 066C","E01007826","Total",582,163,3,160,213,63,136,26,110
"2011","Sheffield 066D","E01007834","Total",767,314,11,303,187,70,249,25,224
"2011","Sheffield 068A","E01007920","Total",688,281,5,276,181,50,162,20,142
"2011","Sheffield 068B","E01007921","Total",750,341,6,335,162,61,227,26,201
"2011","Sheffield 068C","E01007923","Total",813,281,6,275,206,73,213,15,198
"2011","Sheffield 068D","E01007925","Total",753,282,6,276,196,62,209,28,181
"2011","Sheffield 068E","E01007926","Total",708,252,7,245,198,54,185,28,157
"2011","Sheffield 068F","E01007933","Total",632,195,4,191,233,50,107,18,89
"2011","Sheffield 069A","E01007823","Total",820,383,22,361,184,63,278,34,244
"2011","Sheffield 069B","E01007916","Total",735,372,76,296,208,104,262,33,229
"2011","Sheffield 069C","E01007919","Total",784,360,75,285,252,112,278,54,224
"2011","Sheffield 069D","E01008080","Total",672,268,16,252,168,64,196,30,166
"2011","Sheffield 070A","E01008081","Total",795,373,26,347,157,56,302,37,265
"2011","Sheffield 070B","E01008082","Total",811,425,38,387,171,79,305,29,276
"2011","Sheffield 070C","E01008083","Total",709,344,51,293,203,97,260,35,225
"2011","Sheffield 070D","E01008084","Total",818,419,99,320,242,126,273,50,223
"2011","Sheffield 071A","E01007915","Total",609,245,2,243,168,58,132,18,114
"2011","Sheffield 071B","E01007917","Total",691,317,17,300,139,41,200,22,178
"2011","Sheffield 071C","E01007918","Total",752,303,14,289,196,72,177,12,165
"2011","Sheffield 071D","E01007922","Total",578,175,2,173,167,57,112,12,100
"2011","Sheffield 071E","E01007924","Total",702,262,14,248,180,72,211,35,176
"2011","Sheffield 072A","E01008021","Total",561,128,9,119,207,48,103,30,73
"2011","Sheffield 072B","E01008023","Total",924,149,14,135,300,121,134,37,97
"2011","Sheffield 072C","E01008024","Total",755,217,18,199,242,97,190,31,159
"2011","Sheffield 072D","E01008025","Total",860,272,22,250,259,105,193,29,164
"2011","Sheffield 072E","E01032585","Total",663,263,6,257,132,51,178,15,163
"2011","Sheffield 073A","E01033261","Total",718,349,16,333,29,22,60,3,57
"2011","Sheffield 073B","E01033262","Total",608,154,4,150,25,17,60,4,56
"2011","Sheffield 073C","E01033263","Total",626,194,55,139,94,59,67,11,56
"2011","Sheffield 073D","E01033264","Total",632,142,9,133,31,21,46,3,43
"2011","Sheffield 073E","E01033276","Total",686,382,5,377,24,17,43,0,43
"2011","Sheffield 074A","E01008114","Total",841,421,101,320,188,87,200,44,156
"2011","Sheffield 074B","E01008115","Total",538,192,25,167,75,33,92,6,86
"2011","Sheffield 074C","E01033265","Total",600,236,5,231,17,9,89,2,87
"2011","Sheffield 074D","E01033266","Total",609,263,20,243,48,27,57,4,53
"2011","Sheffield 074E","E01033267","Total",567,259,6,253,15,9,63,4,59
"2011","Sheffield 075A","E01007878","Total",649,274,69,205,191,82,221,33,188
"2011","Sheffield 075B","E01007879","Total",712,274,22,252,130,51,189,14,175
"2011","Sheffield 075C","E01007881","Total",675,240,45,195,196,90,202,35,167
"2011","Sheffield 075D","E01007882","Total",614,172,27,145,151,66,129,23,106
"2011","Sheffield 075E","E01007885","Total",692,298,71,227,220,103,239,49,190
"2011","Sheffield 075F","E01007886","Total",672,278,90,188,278,127,220,50,170
"2011","Sheffield 075G","E01033268","Total",1054,428,47,381,244,167,297,31,266
"2011","Sheffield 076A","E01007838","Total",644,187,15,172,180,76,161,27,134
"2011","Sheffield 076B","E01007839","Total",667,130,15,115,239,80,132,29,103
"2011","Sheffield 076C","E01007841","Total",637,158,10,148,223,70,126,29,97
"2011","Sheffield 076D","E01007842","Total",685,269,25,244,208,62,211,38,173
"2011","Sheffield 076E","E01033278","Total",1173,554,69,485,310,128,409,57,352
"2011","Sheffield 076F","E01033279","Total",1014,422,64,358,298,120,362,65,297
"2011","Bradford 001A","E01010646","Total",623,243,1,242,134,45,136,13,123
"2011","Bradford 001B","E01010647","Total",509,202,4,198,123,43,122,13,109
"2011","Bradford 001C","E01010648","Total",619,247,3,244,136,41,129,12,117
"2011","Bradford 001D","E01010692","Total",828,302,5,297,199,52,180,27,153
"2011","Bradford 002A","E01010691","Total",645,270,2,268,182,50,152,19,133
"2011","Bradford 002B","E01010693","Total",560,197,5,192,179,45,102,18,84
"2011","Bradford 002C","E01010694","Total",621,236,9,227,166,43,118,23,95
"2011","Bradford 002D","E01010695","Total",843,358,11,347,193,84,269,22,247
"2011","Bradford 002E","E01010696","Total",600,191,3,188,199,74,136,20,116
"2011","Bradford 002F","E01010697","Total",659,273,6,267,168,55,139,20,119
"2011","Bradford 002G","E01010698","Total",847,248,11,237,218,90,187,22,165
"2011","Bradford 002H","E01010699","Total",781,292,18,274,217,87,219,29,190
"2011","Bradford 003A","E01010767","Total",633,251,10,241,179,69,186,23,163
"2011","Bradford 003B","E01010768","Total",637,154,4,150,248,72,117,27,90
"2011","Bradford 003C","E01010769","Total",730,207,5,202,200,95,177,24,153
"2011","Bradford 003D","E01010771","Total",478,154,3,151,169,59,86,14,72
"2011","Bradford 004A","E01010638","Total",653,209,9,200,157,40,182,23,159
"2011","Bradford 004B","E01010639","Total",844,288,9,279,201,79,223,28,195
"2011","Bradford 004C","E01010640","Total",796,211,22,189,229,103,163,24,139
"2011","Bradford 004D","E01010641","Total",622,220,10,210,165,53,187,30,157
"2011","Bradford 004E","E01010642","Total",738,247,7,240,180,58,178,19,159
"2011","Bradford 004F","E01010643","Total",620,155,15,140,160,69,128,21,107
"2011","Bradford 004G","E01010644","Total",635,173,18,155,215,87,160,36,124
"2011","Bradford 004H","E01010645","Total",542,175,4,171,149,42,123,16,107
"2011","Bradford 005A","E01010770","Total",619,154,3,151,223,67,108,16,92
"2011","Bradford 005B","E01010772","Total",501,200,2,198,144,46,97,14,83
"2011","Bradford 005C","E01010773","Total",619,214,6,208,170,68,140,14,126
"2011","Bradford 005D","E01010774","Total",736,258,9,249,160,65,157,12,145
"2011","Bradford 006A","E01010706","Total",709,206,9,197,207,87,138,20,118
"2011","Bradford 006B","E01010707","Total",756,244,8,236,185,75,208,37,171
"2011","Bradford 006C","E01010708","Total",654,212,28,184,195,95,138,22,116
"2011","Bradford 006D","E01010709","Total",1054,298,19,279,360,166,235,51,184
"2011","Bradford 007A","E01010719","Total",495,177,49,128,237,123,151,53,98
"2011","Bradford 007B","E01010727","Total",743,245,8,237,160,56,213,26,187
"2011","Bradford 007C","E01010728","Total",528,168,36,132,218,114,129,53,76
"2011","Bradford 007D","E01010729","Total",483,139,15,124,171,78,110,25,85
"2011","Bradford 008A","E01010700","Total",450,152,57,95,233,131,130,51,79
"2011","Bradford 008B","E01010701","Total",430,176,50,126,208,116,141,54,87
"2011","Bradford 008C","E01010702","Total",510,172,41,131,280,154,168,64,104
"2011","Bradford 008D","E01010703","Total",663,204,39,165,214,100,186,40,146
"2011","Bradford 008E","E01010704","Total",611,187,25,162,193,78,153,28,125
"2011","Bradford 008F","E01010705","Total",674,207,13,194,206,74,165,31,134
"2011","Bradford 008G","E01010710","Total",884,422,57,365,255,141,293,53,240
"2011","Bradford 009A","E01010712","Total",487,140,65,75,278,165,122,61,61
"2011","Bradford 009B","E01010720","Total",618,255,65,190,235,107,222,54,168
"2011","Bradford 009C","E01010721","Total",622,292,58,234,187,79,239,51,188
"2011","Bradford 009D","E01010723","Total",489,170,67,103,255,140,133,66,67
"2011","Bradford 009E","E01010724","Total",611,244,55,189,216,99,187,44,143
"2011","Bradford 009F","E01010725","Total",696,280,31,249,200,85,200,28,172
"2011","Bradford 010A","E01010579","Total",633,224,4,220,184,47,130,22,108
"2011","Bradford 010B","E01010580","Total",999,230,6,224,348,130,197,33,164
"2011","Bradford 010C","E01010764","Total",673,216,2,214,184,50,149,20,129
"2011","Bradford 010D","E01010765","Total",1067,388,23,365,241,91,281,26,255
"2011","Bradford 010E","E01010766","Total",538,158,2,156,154,63,110,19,91
"2011","Bradford 011A","E01010711","Total",803,517,44,473,114,61,325,30,295
"2011","Bradford 011B","E01010713","Total",572,235,52,183,184,78,176,33,143
"2011","Bradford 011C","E01010714","Total",599,196,35,161,193,83,169,33,136
"2011","Bradford 011D","E01010716","Total",854,292,50,242,243,109,227,35,192
"2011","Bradford 012A","E01010715","Total",467,197,26,171,161,53,154,20,134
"2011","Bradford 012B","E01010717","Total",671,223,41,182,248,105,182,49,133
"2011","Bradford 012C","E01010718","Total",665,268,51,217,210,83,243,43,200
"2011","Bradford 012D","E01010726","Total",623,216,4,212,172,54,161,29,132
"2011","Bradford 012E","E01010859","Total",681,205,14,191,183,59,154,28,126
"2011","Bradford 013A","E01010573","Total",726,212,9,203,221,81,137,22,115
"2011","Bradford 013B","E01010574","Total",626,250,2,248,132,35,171,15,156
"2011","Bradford 013C","E01010575","Total",752,273,4,269,173,64,195,19,176
"2011","Bradford 013D","E01010577","Total",662,193,8,185,201,77,116,19,97
"2011","Bradford 014A","E01010722","Total",625,222,74,148,238,105,159,48,111
"2011","Bradford 014B","E01010860","Total",667,160,9,151,179,74,149,22,127
"2011","Bradford 014C","E01010862","Total",712,170,10,160,238,69,155,31,124
"2011","Bradford 014D","E01010863","Total",618,149,5,144,192,66,140,23,117
"2011","Bradford 015A","E01010578","Total",716,182,7,175,166,45,140,25,115
"2011","Bradford 015B","E01010581","Total",709,209,26,183,237,104,154,32,122
"2011","Bradford 015C","E01010582","Total",723,155,15,140,210,86,120,28,92
"2011","Bradford 015D","E01010584","Total",885,290,35,255,195,82,225,29,196
"2011","Bradford 015E","E01010585","Total",986,431,26,405,220,104,297,26,271
"2011","Bradford 016A","E01010568","Total",822,288,15,273,211,75,195,26,169
"2011","Bradford 016B","E01010569","Total",826,347,27,320,207,78,273,35,238
"2011","Bradford 016C","E01010571","Total",828,254,33,221,197,87,201,30,171
"2011","Bradford 016D","E01010572","Total",639,231,10,221,152,51,169,24,145
"2011","Bradford 016E","E01010576","Total",651,207,11,196,167,51,120,19,101
"2011","Bradford 017A","E01010683","Total",705,138,6,132,200,65,113,16,97
"2011","Bradford 017B","E01010684","Total",661,192,10,182,175,62,141,19,122
"2011","Bradford 017C","E01010685","Total",724,187,5,182,194,74,158,22,136
"2011","Bradford 017D","E01010686","Total",714,254,9,245,185,71,154,18,136
"2011","Bradford 018A","E01010570","Total",550,181,5,176,153,60,126,17,109
"2011","Bradford 018B","E01010583","Total",770,326,53,273,210,87,221,39,182
"2011","Bradford 018C","E01010784","Total",760,196,33,163,181,93,185,24,161
"2011","Bradford 018D","E01010785","Total",807,251,10,241,161,87,183,19,164
"2011","Bradford 018E","E01010786","Total",548,182,9,173,172,67,127,25,102
"2011","Bradford 018F","E01010790","Total",597,201,5,196,163,60,142,23,119
"2011","Bradford 019A","E01010680","Total",892,396,47,349,211,114,287,36,251
"2011","Bradford 019B","E01010681","Total",502,134,8,126,168,47,101,16,85
"2011","Bradford 019C","E01010682","Total",659,272,36,236,180,78,225,33,192
"2011","Bradford 019D","E01010687","Total",732,131,7,124,256,113,143,34,109
"2011","Bradford 019E","E01010688","Total",831,175,12,163,241,116,149,22,127
"2011","Bradford 019F","E01010689","Total",767,170,17,153,215,88,139,22,117
"2011","Bradford 019G","E01010690","Total",820,271,14,257,245,103,210,30,180
"2011","Bradford 020B","E01010782","Total",882,332,49,283,207,91,285,41,244
"2011","Bradford 020C","E01010787","Total",696,257,6,251,183,65,202,23,179
"2011","Bradford 020D","E01010788","Total",585,150,15,135,169,72,133,33,100
"2011","Bradford 020E","E01033689","Total",727,198,24,174,112,69,151,19,132
"2011","Bradford 020F","E01033694","Total",518,113,12,101,98,42,115,16,99
"2011","Bradford 021A","E01010776","Total",677,206,33,173,247,109,167,36,131
"2011","Bradford 021B","E01010777","Total",730,359,64,295,209,110,261,46,215
"2011","Bradford 021C","E01010779","Total",640,250,47,203,185,93,185,27,158
"2011","Bradford 021D","E01010781","Total",574,146,41,105,234,103,147,43,104
"2011","Bradford 021E","E01010783","Total",664,235,18,217,199,74,183,28,155
"2011","Bradford 022A","E01010586","Total",700,236,8,228,181,47,151,21,130
"2011","Bradford 022B","E01010587","Total",813,202,11,191,228,93,166,23,143
"2011","Bradford 022C","E01010588","Total",682,214,10,204,207,84,179,43,136
"2011","Bradford 022D","E01010589","Total",645,195,4,191,187,56,124,22,102
"2011","Bradford 022E","E01010591","Total",691,253,27,226,180,82,198,28,170
"2011","Bradford 022F","E01010593","Total",752,248,28,220,237,79,188,31,157
"2011","Bradford 022G","E01010596","Total",617,204,5,199,155,50,150,21,129
"2011","Bradford 023A","E01010854","Total",828,239,20,219,230,91,208,36,172
"2011","Bradford 023B","E01010855","Total",752,253,11,242,198,74,178,18,160
"2011","Bradford 023C","E01010856","Total",763,238,24,214,177,77,195,27,168
"2011","Bradford 023D","E01010857","Total",697,214,19,195,147,51,154,21,133
"2011","Bradford 023E","E01010858","Total",694,187,17,170,206,81,154,29,125
"2011","Bradford 023F","E01010861","Total",742,191,11,180,223,75,175,34,141
"2011","Bradford 024A","E01010603","Total",631,187,19,168,222,87,153,36,117
"2011","Bradford 024B","E01010604","Total",723,261,12,249,193,75,189,29,160
"2011","Bradford 024C","E01010605","Total",621,241,38,203,212,73,214,41,173
"2011","Bradford 024D","E01010775","Total",697,178,13,165,247,99,157,29,128
"2011","Bradford 024E","E01010778","Total",755,215,45,170,270,128,185,54,131
"2011","Bradford 025A","E01010789","Total",665,209,24,185,222,110,195,44,151
"2011","Bradford 025B","E01010791","Total",523,144,16,128,220,98,140,43,97
"2011","Bradford 025C","E01010792","Total",570,176,36,140,248,121,169,60,109
"2011","Bradford 025D","E01010793","Total",549,129,35,94,254,117,115,46,69
"2011","Bradford 026A","E01010652","Total",739,297,16,281,162,55,217,21,196
"2011","Bradford 026B","E01010653","Total",686,263,52,211,239,93,246,60,186
"2011","Bradford 026C","E01010655","Total",529,178,76,102,244,107,138,42,96
"2011","Bradford 026D","E01010656","Total",608,203,6,197,177,58,138,24,114
"2011","Bradford 026E","E01010657","Total",673,177,24,153,202,101,150,30,120
"2011","Bradford 027A","E01010649","Total",605,191,35,156,190,79,174,36,138
"2011","Bradford 027B","E01010650","Total",575,236,121,115,298,164,157,60,97
"2011","Bradford 027C","E01010654","Total",582,281,66,215,209,92,213,44,169
"2011","Bradford 027D","E01010826","Total",521,229,77,152,227,102,181,61,120
"2011","Bradford 028A","E01010597","Total",581,196,36,160,205,88,161,35,126
"2011","Bradford 028B","E01010598","Total",668,209,13,196,217,76,180,45,135
"2011","Bradford 028C","E01010599","Total",473,123,26,97,186,89,101,23,78
"2011","Bradford 028D","E01010600","Total",493,134,37,97,209,98,137,48,89
"2011","Bradford 028E","E01010602","Total",609,199,24,175,199,81,160,31,129
"2011","Bradford 029A","E01010670","Total",458,101,22,79,213,90,103,41,62
"2011","Bradford 029B","E01010671","Total",483,146,32,114,232,104,147,52,95
"2011","Bradford 029C","E01010673","Total",501,136,48,88,253,140,141,64,77
"2011","Bradford 029D","E01010675","Total",622,215,31,184,219,83,187,58,129
"2011","Bradford 030A","E01010669","Total",640,223,50,173,284,140,162,62,100
"2011","Bradford 030B","E01010674","Total",509,180,54,126,263,116,137,49,88
"2011","Bradford 030C","E01010677","Total",638,255,122,133,359,186,171,73,98
"2011","Bradford 030D","E01010805","Total",473,123,16,107,193,86,111,41,70
"2011","Bradford 031A","E01010590","Total",766,205,16,189,231,76,164,32,132
"2011","Bradford 031B","E01010592","Total",670,281,15,266,161,53,204,30,174
"2011","Bradford 031C","E01010594","Total",686,206,18,188,210,64,178,41,137
"2011","Bradford 031D","E01010595","Total",795,267,43,224,261,111,205,46,159
"2011","Bradford 032A","E01010601","Total",735,213,22,191,229,108,181,42,139
"2011","Bradford 032B","E01010651","Total",621,184,14,170,193,84,143,25,118
"2011","Bradford 032C","E01010825","Total",522,132,21,111,181,87,140,29,111
"2011","Bradford 032D","E01010827","Total",526,175,23,152,186,79,131,30,101
"2011","Bradford 033A","E01010804","Total",485,106,40,66,299,130,133,73,60
"2011","Bradford 033B","E01010806","Total",486,183,38,145,202,105,168,53,115
"2011","Bradford 033C","E01010807","Total",742,316,69,247,262,133,227,55,172
"2011","Bradford 033D","E01010808","Total",539,149,66,83,352,188,146,75,71
"2011","Bradford 033E","E01010809","Total",481,123,55,68,288,138,135,67,68
"2011","Bradford 034A","E01010676","Total",513,132,63,69,339,162,154,89,65
"2011","Bradford 034B","E01010679","Total",495,189,25,164,189,95,157,48,109
"2011","Bradford 034C","E01010824","Total",720,300,47,253,192,123,189,33,156
"2011","Bradford 034D","E01010840","Total",501,245,43,202,210,112,204,55,149
"2011","Bradford 034E","E01010841","Total",471,196,50,146,216,116,142,56,86
"2011","Bradford 035A","E01010828","Total",742,324,43,281,208,88,273,37,236
"2011","Bradford 035B","E01010829","Total",602,224,49,175,210,105,185,41,144
"2011","Bradford 035C","E01010830","Total",631,206,52,154,253,140,193,63,130
"2011","Bradford 035D","E01010831","Total",558,161,56,105,277,142,154,66,88
"2011","Bradford 035E","E01010832","Total",462,145,54,91,245,143,132,50,82
"2011","Bradford 036A","E01010672","Total",522,117,5,112,165,66,100,20,80
"2011","Bradford 036B","E01010678","Total",556,175,9,166,159,66,144,28,116
"2011","Bradford 036C","E01010799","Total",649,227,44,183,204,87,185,41,144
"2011","Bradford 036D","E01010800","Total",710,356,119,237,320,132,273,78,195
"2011","Bradford 036E","E01010801","Total",616,183,41,142,258,130,135,49,86
"2011","Bradford 036F","E01010802","Total",632,261,77,184,241,103,208,62,146
"2011","Bradford 037A","E01010803","Total",538,160,42,118,259,145,135,52,83
"2011","Bradford 037B","E01010810","Total",531,166,58,108,308,177,147,69,78
"2011","Bradford 037C","E01010811","Total",552,153,63,90,340,200,143,70,73
"2011","Bradford 037D","E01010813","Total",531,185,54,131,282,154,173,66,107
"2011","Bradford 038A","E01010618","Total",510,199,65,134,256,128,182,59,123
"2011","Bradford 038B","E01010619","Total",521,123,47,76,321,142,139,70,69
"2011","Bradford 038C","E01010625","Total",499,214,93,121,272,130,184,84,100
"2011","Bradford 038D","E01010626","Total",495,146,76,70,307,163,148,69,79
"2011","Bradford 038E","E01010627","Total",536,152,38,114,243,114,160,63,97
"2011","Bradford 039A","E01010606","Total",609,252,84,168,285,164,198,63,135
"2011","Bradford 039B","E01010607","Total",594,208,97,111,328,178,153,83,70
"2011","Bradford 039C","E01010617","Total",595,327,65,262,185,115,240,36,204
"2011","Bradford 039E","E01010842","Total",595,282,91,191,268,158,188,66,122
"2011","Bradford 039G","E01033690","Total",694,238,20,218,67,45,60,8,52
"2011","Bradford 039H","E01033691","Total",620,281,46,235,158,94,166,38,128
"2011","Bradford 039I","E01033692","Total",595,231,28,203,97,57,118,13,105
"2011","Bradford 039J","E01033693","Total",659,230,77,153,330,195,179,84,95
"2011","Bradford 040A","E01010628","Total",669,256,38,218,212,107,187,43,144
"2011","Bradford 040B","E01010629","Total",619,177,35,142,269,142,141,53,88
"2011","Bradford 040C","E01010630","Total",606,251,36,215,218,104,189,35,154
"2011","Bradford 040D","E01010631","Total",550,218,72,146,243,118,187,56,131
"2011","Bradford 040E","E01010632","Total",500,181,74,107,236,104,147,46,101
"2011","Bradford 041A","E01010658","Total",598,182,67,115,277,156,155,51,104
"2011","Bradford 041B","E01010812","Total",642,229,74,155,300,169,152,53,99
"2011","Bradford 041C","E01010833","Total",523,237,74,163,218,114,160,50,110
"2011","Bradford 041D","E01010843","Total",453,150,74,76,284,150,129,73,56
"2011","Bradford 042A","E01010620","Total",517,194,68,126,273,142,164,69,95
"2011","Bradford 042B","E01010621","Total",528,140,83,57,370,202,125,84,41
"2011","Bradford 042C","E01010622","Total",627,205,94,111,372,207,173,89,84
"2011","Bradford 042D","E01010623","Total",529,241,79,162,240,124,188,68,120
"2011","Bradford 042E","E01010624","Total",602,203,67,136,348,197,154,79,75
"2011","Bradford 043A","E01010794","Total",775,318,38,280,231,106,220,46,174
"2011","Bradford 043B","E01010795","Total",754,158,21,137,240,97,164,31,133
"2011","Bradford 043C","E01010796","Total",687,259,34,225,201,80,224,38,186
"2011","Bradford 043D","E01010797","Total",540,92,4,88,188,60,94,19,75
"2011","Bradford 043E","E01010798","Total",692,219,35,184,202,100,173,27,146
"2011","Bradford 044A","E01010834","Total",676,300,22,278,116,60,86,25,61
"2011","Bradford 044B","E01010835","Total",780,252,78,174,395,219,183,97,86
"2011","Bradford 044C","E01010836","Total",524,180,30,150,181,98,93,40,53
"2011","Bradford 044D","E01010837","Total",515,147,60,87,289,143,148,75,73
"2011","Bradford 044E","E01010838","Total",492,149,60,89,268,155,120,61,59
"2011","Bradford 044F","E01010839","Total",491,206,57,149,226,131,114,48,66
"2011","Bradford 045A","E01010608","Total",492,161,83,78,314,180,133,73,60
"2011","Bradford 045B","E01010613","Total",635,276,57,219,194,109,197,30,167
"2011","Bradford 045C","E01010730","Total",801,462,66,396,190,103,285,35,250
"2011","Bradford 045D","E01010734","Total",516,159,74,85,267,142,120,55,65
"2011","Bradford 046A","E01010609","Total",686,299,50,249,212,92,217,39,178
"2011","Bradford 046B","E01010610","Total",702,356,108,248,255,109,240,55,185
"2011","Bradford 046C","E01010611","Total",878,336,92,244,332,172,242,68,174
"2011","Bradford 046D","E01010614","Total",558,204,57,147,199,96,156,44,112
"2011","Bradford 047A","E01010633","Total",624,171,22,149,199,83,167,37,130
"2011","Bradford 047B","E01010634","Total",586,168,11,157,184,48,163,30,133
"2011","Bradford 047C","E01010635","Total",664,338,60,278,215,74,270,42,228
"2011","Bradford 047D","E01010636","Total",746,232,10,222,217,77,187,32,155
"2011","Bradford 047E","E01010637","Total",532,138,23,115,210,88,128,32,96
"2011","Bradford 048A","E01010731","Total",702,332,36,296,168,101,175,41,134
"2011","Bradford 048B","E01010732","Total",692,276,98,178,323,176,212,83,129
"2011","Bradford 048C","E01010733","Total",701,326,103,223,267,152,230,61,169
"2011","Bradford 048D","E01010736","Total",715,255,91,164,319,177,165,60,105
"2011","Bradford 048E","E01010737","Total",522,219,70,149,254,133,184,77,107
"2011","Bradford 049A","E01010659","Total",600,260,105,155,293,146,192,67,125
"2011","Bradford 049D","E01010662","Total",487,112,20,92,182,80,121,33,88
"2011","Bradford 049E","E01010664","Total",528,156,22,134,191,80,153,36,117
"2011","Bradford 049G","E01010761","Total",683,238,26,212,213,91,190,38,152
"2011","Bradford 049H","E01033695","Total",701,150,41,109,319,146,146,44,102
"2011","Bradford 049I","E01033696","Total",652,164,15,149,223,91,112,29,83
"2011","Bradford 049J","E01033697","Total",791,239,84,155,415,232,221,93,128
"2011","Bradford 050A","E01010663","Total",638,272,73,199,217,107,191,52,139
"2011","Bradford 050B","E01010665","Total",602,186,43,143,222,114,163,48,115
"2011","Bradford 050C","E01010666","Total",662,331,92,239,208,114,238,48,190
"2011","Bradford 050D","E01010667","Total",614,213,61,152,237,135,158,51,107
"2011","Bradford 051A","E01010735","Total",507,220,107,113,290,156,141,67,74
"2011","Bradford 051B","E01010738","Total",556,169,78,91,336,192,139,82,57
"2011","Bradford 051C","E01010739","Total",614,297,114,183,304,168,183,67,116
"2011","Bradford 051D","E01010740","Total",538,201,66,135,251,132,160,50,110
"2011","Bradford 051E","E01010744","Total",480,120,44,76,283,154,130,63,67
"2011","Bradford 052A","E01010612","Total",576,282,99,183,223,118,166,38,128
"2011","Bradford 052B","E01010819","Total",651,386,141,245,276,131,258,77,181
"2011","Bradford 052C","E01010820","Total",604,326,100,226,249,126,242,60,182
"2011","Bradford 052D","E01010821","Total",812,342,154,188,395,204,260,103,157
"2011","Bradford 052E","E01010822","Total",549,277,78,199,210,100,193,48,145
"2011","Bradford 053A","E01010615","Total",566,165,40,125,201,87,144,28,116
"2011","Bradford 053B","E01010616","Total",588,208,75,133,272,142,179,62,117
"2011","Bradford 053C","E01010742","Total",608,215,60,155,295,175,200,72,128
"2011","Bradford 053D","E01010743","Total",676,282,45,237,247,154,225,62,163
"2011","Bradford 054A","E01010847","Total",674,217,27,190,221,88,170,37,133
"2011","Bradford 054B","E01010848","Total",650,223,24,199,190,64,203,40,163
"2011","Bradford 054C","E01010852","Total",663,294,40,254,218,103,203,40,163
"2011","Bradford 054D","E01010853","Total",506,160,21,139,164,67,124,22,102
"2011","Bradford 055A","E01010668","Total",516,175,16,159,152,62,138,29,109
"2011","Bradford 055B","E01010755","Total",671,246,100,146,311,155,165,51,114
"2011","Bradford 055C","E01010762","Total",601,173,35,138,242,101,153,42,111
"2011","Bradford 055D","E01010763","Total",621,210,18,192,172,63,164,27,137
"2011","Bradford 055E","E01010846","Total",849,243,45,198,297,117,191,39,152
"2011","Bradford 056A","E01010745","Total",618,233,76,157,252,132,162,53,109
"2011","Bradford 056B","E01010747","Total",644,234,34,200,215,100,185,40,145
"2011","Bradford 056C","E01010748","Total",670,307,62,245,228,78,204,38,166
"2011","Bradford 056D","E01010749","Total",614,250,41,209,170,79,181,36,145
"2011","Bradford 057A","E01010814","Total",797,307,34,273,211,94,254,44,210
"2011","Bradford 057B","E01010815","Total",873,225,64,161,391,188,208,57,151
"2011","Bradford 057C","E01010816","Total",758,174,18,156,253,98,177,36,141
"2011","Bradford 057D","E01010817","Total",881,331,106,225,356,170,267,74,193
"2011","Bradford 057E","E01010818","Total",691,161,29,132,270,113,150,43,107
"2011","Bradford 058A","E01010752","Total",818,246,36,210,229,99,212,40,172
"2011","Bradford 058B","E01010753","Total",597,199,5,194,155,44,153,18,135
"2011","Bradford 058C","E01010754","Total",662,170,18,152,239,88,166,34,132
"2011","Bradford 058D","E01010756","Total",604,131,21,110,194,69,129,31,98
"2011","Bradford 058E","E01010758","Total",477,75,6,69,190,57,97,26,71
"2011","Bradford 058F","E01010759","Total",660,237,31,206,218,93,185,32,153
"2011","Bradford 058G","E01010760","Total",605,153,10,143,210,68,115,21,94
"2011","Bradford 059A","E01010741","Total",656,193,24,169,182,74,146,30,116
"2011","Bradford 059B","E01010845","Total",848,374,87,287,303,134,295,62,233
"2011","Bradford 059C","E01010849","Total",605,202,11,191,158,63,162,29,133
"2011","Bradford 059D","E01010850","Total",507,182,82,100,237,84,145,53,92
"2011","Bradford 059E","E01010851","Total",662,176,17,159,206,90,149,24,125
"2011","Bradford 059F","E01010864","Total",526,180,54,126,216,85,137,32,105
"2011","Bradford 059G","E01010867","Total",581,167,52,115,231,112,134,38,96
"2011","Bradford 059H","E01010874","Total",512,225,42,183,168,74,180,30,150
"2011","Bradford 060A","E01010746","Total",684,253,26,227,167,60,189,34,155
"2011","Bradford 060B","E01010750","Total",693,223,17,206,196,77,194,43,151
"2011","Bradford 060C","E01010751","Total",676,292,21,271,163,54,244,32,212
"2011","Bradford 060D","E01010865","Total",709,200,15,185,208,97,187,35,152
"2011","Bradford 060E","E01010866","Total",607,162,19,143,174,52,144,21,123
"2011","Bradford 061A","E01010868","Total",700,284,62,222,212,97,218,43,175
"2011","Bradford 061B","E01010869","Total",742,279,54,225,216,86,196,30,166
"2011","Bradford 061C","E01010870","Total",684,248,6,242,169,48,207,30,177
"2011","Bradford 061D","E01010871","Total",756,223,40,183,232,93,184,36,148
"2011","Bradford 061E","E01010872","Total",656,262,54,208,221,90,212,49,163
"2011","Bradford 061F","E01010873","Total",509,177,13,164,137,44,119,27,92
"2011","Calderdale 001A","E01010911","Total",711,170,14,156,213,84,144,20,124
"2011","Calderdale 001B","E01010912","Total",688,305,37,268,219,82,232,51,181
"2011","Calderdale 001C","E01010913","Total",550,201,5,196,129,27,148,21,127
"2011","Calderdale 001D","E01010915","Total",576,144,12,132,187,63,129,30,99
"2011","Calderdale 002A","E01010914","Total",784,264,42,222,267,102,208,44,164
"2011","Calderdale 002B","E01010924","Total",643,343,49,294,130,58,242,38,204
"2011","Calderdale 002C","E01010925","Total",575,225,56,169,185,65,180,38,142
"2011","Calderdale 002D","E01010926","Total",439,197,95,102,238,109,143,60,83
"2011","Calderdale 003A","E01010931","Total",613,219,8,211,184,52,153,18,135
"2011","Calderdale 003B","E01010932","Total",679,226,14,212,164,58,163,22,141
"2011","Calderdale 003C","E01010933","Total",701,218,11,207,179,67,161,17,144
"2011","Calderdale 003D","E01010935","Total",691,226,6,220,172,47,151,14,137
"2011","Calderdale 003E","E01010936","Total",814,243,7,236,289,111,152,24,128
"2011","Calderdale 003F","E01010937","Total",685,223,8,215,187,66,149,21,128
"2011","Calderdale 004A","E01010881","Total",718,185,21,164,244,75,178,51,127
"2011","Calderdale 004B","E01010882","Total",649,256,14,242,185,61,208,27,181
"2011","Calderdale 004C","E01010883","Total",644,167,5,162,195,60,159,26,133
"2011","Calderdale 004D","E01010887","Total",710,187,13,174,198,58,154,28,126
"2011","Calderdale 004E","E01010888","Total",794,238,20,218,190,75,228,35,193
"2011","Calderdale 004F","E01010923","Total",795,224,28,196,214,79,188,34,154
"2011","Calderdale 005A","E01010916","Total",578,241,59,182,216,83,181,39,142
"2011","Calderdale 005B","E01010939","Total",712,196,14,182,233,83,159,31,128
"2011","Calderdale 005C","E01010941","Total",522,185,51,134,193,76,161,37,124
"2011","Calderdale 005D","E01010942","Total",773,302,38,264,208,76,245,34,211
"2011","Calderdale 005E","E01010944","Total",595,282,67,215,205,96,216,44,172
"2011","Calderdale 006A","E01010938","Total",613,259,69,190,225,85,181,44,137
"2011","Calderdale 006B","E01010940","Total",637,192,23,169,182,64,164,27,137
"2011","Calderdale 006C","E01010943","Total",603,258,84,174,248,97,172,43,129
"2011","Calderdale 006D","E01010961","Total",532,135,25,110,152,65,109,22,87
"2011","Calderdale 007A","E01010917","Total",862,277,20,257,201,76,223,33,190
"2011","Calderdale 007B","E01010918","Total",725,235,26,209,224,63,186,36,150
"2011","Calderdale 007C","E01010919","Total",772,352,29,323,182,64,270,35,235
"2011","Calderdale 007D","E01010920","Total",726,205,11,194,201,68,150,26,124
"2011","Calderdale 007E","E01010921","Total",720,244,32,212,225,80,213,37,176
"2011","Calderdale 008A","E01010934","Total",911,275,25,250,215,83,215,25,190
"2011","Calderdale 008D","E01010967","Total",786,369,47,322,183,86,239,32,207
"2011","Calderdale 008E","E01010994","Total",1046,484,8,476,95,44,355,13,342
"2011","Calderdale 008F","E01032923","Total",1126,422,56,366,304,145,299,50,249
"2011","Calderdale 009A","E01010927","Total",692,222,6,216,187,66,149,25,124
"2011","Calderdale 009B","E01010928","Total",616,274,78,196,223,91,212,50,162
"2011","Calderdale 009C","E01010997","Total",625,228,9,219,162,47,157,32,125
"2011","Calderdale 009D","E01010999","Total",637,204,9,195,163,66,153,25,128
"2011","Calderdale 010A","E01010929","Total",901,293,89,204,385,208,187,47,140
"2011","Calderdale 010B","E01010930","Total",737,295,69,226,239,113,218,41,177
"2011","Calderdale 010C","E01010998","Total",715,276,31,245,214,97,193,20,173
"2011","Calderdale 010D","E01011000","Total",604,193,59,134,321,186,159,62,97
"2011","Calderdale 011A","E01010904","Total",593,164,8,156,171,55,132,16,116
"2011","Calderdale 011B","E01010906","Total",593,206,3,203,166,52,137,16,121
"2011","Calderdale 011C","E01010907","Total",598,169,11,158,183,49,124,21,103
"2011","Calderdale 011D","E01010909","Total",713,237,15,222,184,70,188,21,167
"2011","Calderdale 012A","E01010960","Total",472,141,50,91,250,136,130,59,71
"2011","Calderdale 012B","E01010964","Total",585,316,88,228,235,121,203,54,149
"2011","Calderdale 012C","E01010965","Total",512,254,35,219,171,83,215,48,167
"2011","Calderdale 012D","E01010966","Total",517,207,75,132,267,135,147,58,89
"2011","Calderdale 012E","E01010995","Total",399,140,38,102,185,88,113,48,65
"2011","Calderdale 013A","E01010982","Total",597,203,16,187,149,57,145,23,122
"2011","Calderdale 013B","E01010983","Total",742,279,30,249,178,91,238,32,206
"2011","Calderdale 013C","E01010985","Total",630,175,22,153,169,69,178,32,146
"2011","Calderdale 013D","E01010986","Total",772,256,49,207,239,93,218,49,169
"2011","Calderdale 013E","E01010987","Total",767,276,24,252,238,94,223,32,191
"2011","Calderdale 013F","E01010988","Total",648,275,45,230,194,76,205,39,166
"2011","Calderdale 014A","E01010996","Total",429,146,50,96,249,134,131,57,74
"2011","Calderdale 014B","E01011001","Total",459,141,52,89,235,125,115,56,59
"2011","Calderdale 014C","E01011002","Total",637,193,51,142,261,124,146,44,102
"2011","Calderdale 014D","E01011003","Total",549,242,55,187,160,90,172,23,149
"2011","Calderdale 015A","E01010878","Total",896,288,24,264,194,80,230,24,206
"2011","Calderdale 015B","E01010879","Total",824,257,5,252,193,60,195,25,170
"2011","Calderdale 015C","E01010905","Total",760,210,11,199,246,106,138,28,110
"2011","Calderdale 015D","E01010908","Total",952,280,20,260,261,115,232,30,202
"2011","Calderdale 015E","E01010910","Total",573,258,22,236,154,62,193,23,170
"2011","Calderdale 016A","E01010969","Total",742,201,16,185,199,84,151,20,131
"2011","Calderdale 016B","E01010970","Total",872,280,19,261,203,80,189,27,162
"2011","Calderdale 016C","E01010974","Total",614,220,32,188,200,77,198,39,159
"2011","Calderdale 016D","E01010977","Total",674,206,10,196,174,64,153,15,138
"2011","Calderdale 017A","E01010975","Total",745,393,12,381,144,42,253,22,231
"2011","Calderdale 017B","E01010976","Total",779,248,13,235,208,77,193,22,171
"2011","Calderdale 017C","E01010978","Total",572,151,30,121,189,82,124,25,99
"2011","Calderdale 017D","E01010979","Total",838,314,27,287,152,49,262,19,243
"2011","Calderdale 017E","E01010980","Total",676,175,26,149,192,82,161,29,132
"2011","Calderdale 017F","E01010981","Total",691,206,42,164,185,81,149,34,115
"2011","Calderdale 018A","E01010989","Total",738,256,15,241,148,59,197,24,173
"2011","Calderdale 018B","E01010990","Total",728,240,27,213,218,99,179,28,151
"2011","Calderdale 018C","E01010991","Total",681,212,14,198,190,66,174,26,148
"2011","Calderdale 018D","E01010992","Total",773,223,21,202,224,87,189,27,162
"2011","Calderdale 018E","E01010993","Total",735,257,54,203,253,101,230,54,176
"2011","Calderdale 019A","E01010875","Total",779,309,6,303,196,61,191,17,174
"2011","Calderdale 019B","E01010876","Total",684,210,10,200,212,64,153,31,122
"2011","Calderdale 019C","E01010877","Total",772,289,23,266,160,73,216,29,187
"2011","Calderdale 019D","E01010880","Total",713,342,54,288,203,76,241,35,206
"2011","Calderdale 019E","E01010949","Total",741,251,32,219,196,76,204,29,175
"2011","Calderdale 020A","E01010922","Total",808,197,22,175,280,104,177,41,136
"2011","Calderdale 020B","E01010956","Total",685,168,9,159,172,56,153,20,133
"2011","Calderdale 020C","E01010958","Total",671,347,46,301,179,63,288,42,246
"2011","Calderdale 020D","E01010959","Total",717,265,39,226,236,95,188,45,143
"2011","Calderdale 021A","E01010968","Total",767,211,12,199,203,66,159,23,136
"2011","Calderdale 021B","E01010971","Total",820,263,10,253,263,106,196,37,159
"2011","Calderdale 021C","E01010972","Total",666,237,9,228,189,72,180,34,146
"2011","Calderdale 021D","E01010973","Total",777,317,11,306,194,77,197,11,186
"2011","Calderdale 022A","E01010884","Total",770,344,28,316,173,62,248,26,222
"2011","Calderdale 022B","E01010885","Total",654,176,11,165,166,67,159,23,136
"2011","Calderdale 022C","E01010886","Total",509,187,8,179,127,49,169,18,151
"2011","Calderdale 022D","E01010984","Total",579,180,29,151,169,71,144,22,122
"2011","Calderdale 023A","E01010946","Total",566,232,4,228,148,41,134,19,115
"2011","Calderdale 023B","E01010947","Total",639,200,9,191,197,67,153,27,126
"2011","Calderdale 023C","E01010950","Total",687,227,26,201,184,61,183,27,156
"2011","Calderdale 023D","E01010951","Total",664,218,28,190,178,74,140,23,117
"2011","Calderdale 024A","E01010891","Total",808,335,39,296,236,84,268,45,223
"2011","Calderdale 024B","E01010892","Total",738,161,22,139,282,116,170,44,126
"2011","Calderdale 024C","E01010895","Total",653,298,33,265,170,64,227,31,196
"2011","Calderdale 024D","E01010945","Total",671,225,29,196,198,72,184,35,149
"2011","Calderdale 024E","E01010948","Total",640,274,9,265,146,50,188,22,166
"2011","Calderdale 025A","E01010889","Total",887,414,65,349,200,89,276,35,241
"2011","Calderdale 025B","E01010890","Total",843,231,29,202,216,82,192,32,160
"2011","Calderdale 025C","E01010893","Total",618,221,20,201,184,71,177,29,148
"2011","Calderdale 025D","E01010894","Total",730,270,52,218,223,101,199,37,162
"2011","Calderdale 025E","E01010901","Total",717,239,9,230,181,64,178,25,153
"2011","Calderdale 025F","E01010903","Total",724,253,19,234,222,60,202,33,169
"2011","Calderdale 026A","E01010896","Total",665,151,7,144,207,73,127,25,102
"2011","Calderdale 026B","E01010897","Total",749,191,13,178,202,66,155,19,136
"2011","Calderdale 026C","E01010898","Total",800,236,20,216,206,86,198,27,171
"2011","Calderdale 026D","E01010899","Total",574,194,23,171,196,76,153,25,128
"2011","Calderdale 026E","E01010900","Total",662,174,9,165,193,60,122,20,102
"2011","Calderdale 026F","E01010902","Total",656,211,42,169,258,104,193,42,151
"2011","Calderdale 027A","E01010952","Total",716,230,11,219,181,55,167,22,145
"2011","Calderdale 027B","E01010953","Total",598,154,12,142,197,67,107,20,87
"2011","Calderdale 027C","E01010954","Total",958,171,13,158,364,156,134,31,103
"2011","Calderdale 027D","E01010955","Total",606,143,9,134,173,51,112,21,91
"2011","Calderdale 027E","E01010957","Total",640,164,8,156,170,59,153,20,133
"2011","Kirklees 001A","E01011051","Total",680,204,12,192,211,81,149,23,126
"2011","Kirklees 001B","E01011055","Total",547,167,10,157,154,53,125,22,103
"2011","Kirklees 001C","E01011056","Total",694,217,10,207,198,71,162,22,140
"2011","Kirklees 001D","E01011057","Total",617,194,13,181,167,54,149,22,127
"2011","Kirklees 001E","E01011058","Total",502,170,20,150,171,64,111,29,82
"2011","Kirklees 002A","E01011048","Total",859,371,21,350,140,58,312,22,290
"2011","Kirklees 002B","E01011049","Total",684,229,39,190,209,89,186,30,156
"2011","Kirklees 002C","E01011050","Total",620,189,9,180,175,65,162,20,142
"2011","Kirklees 002D","E01011052","Total",707,225,27,198,239,91,169,28,141
"2011","Kirklees 002E","E01011053","Total",623,170,5,165,175,72,145,24,121
"2011","Kirklees 002F","E01011059","Total",614,245,98,147,271,142,181,55,126
"2011","Kirklees 003A","E01011062","Total",732,196,23,173,218,93,133,25,108
"2011","Kirklees 003B","E01011064","Total",644,248,54,194,199,91,163,37,126
"2011","Kirklees 003C","E01011068","Total",718,205,9,196,210,69,141,27,114
"2011","Kirklees 003D","E01011069","Total",608,205,6,199,147,47,165,17,148
"2011","Kirklees 004A","E01011241","Total",646,162,7,155,232,85,129,33,96
"2011","Kirklees 004B","E01011242","Total",676,262,28,234,201,67,208,37,171
"2011","Kirklees 004C","E01011243","Total",727,221,9,212,194,68,186,29,157
"2011","Kirklees 004D","E01011244","Total",830,179,22,157,307,133,153,35,118
"2011","Kirklees 005A","E01011060","Total",789,320,16,304,172,69,258,33,225
"2011","Kirklees 005B","E01011061","Total",866,339,25,314,195,84,256,24,232
"2011","Kirklees 005C","E01011063","Total",970,307,18,289,259,120,223,35,188
"2011","Kirklees 005D","E01011065","Total",693,156,27,129,237,100,146,37,109
"2011","Kirklees 005E","E01011066","Total",624,213,11,202,185,71,170,22,148
"2011","Kirklees 006A","E01011027","Total",498,145,32,113,163,67,120,30,90
"2011","Kirklees 006B","E01011028","Total",666,209,37,172,199,83,177,33,144
"2011","Kirklees 006C","E01011030","Total",574,181,63,118,253,114,146,45,101
"2011","Kirklees 006D","E01011031","Total",658,222,13,209,173,74,166,23,143
"2011","Kirklees 006E","E01011054","Total",580,189,5,184,123,36,142,22,120
"2011","Kirklees 007A","E01011013","Total",627,256,12,244,145,63,162,18,144
"2011","Kirklees 007B","E01011014","Total",607,174,35,139,211,97,136,30,106
"2011","Kirklees 007C","E01011023","Total",630,179,17,162,201,101,140,29,111
"2011","Kirklees 007D","E01011024","Total",663,224,55,169,254,122,175,44,131
"2011","Kirklees 008A","E01011067","Total",670,213,22,191,186,63,174,29,145
"2011","Kirklees 008B","E01011247","Total",648,140,13,127,209,75,140,26,114
"2011","Kirklees 008C","E01011249","Total",659,271,55,216,220,89,199,39,160
"2011","Kirklees 008D","E01011251","Total",703,301,55,246,245,99,243,45,198
"2011","Kirklees 009A","E01011245","Total",634,221,36,185,203,72,143,19,124
"2011","Kirklees 009B","E01011246","Total",621,219,54,165,231,88,193,49,144
"2011","Kirklees 009C","E01011248","Total",679,277,13,264,168,51,228,28,200
"2011","Kirklees 009D","E01011250","Total",846,292,38,254,180,103,214,17,197
"2011","Kirklees 010A","E01011015","Total",550,243,36,207,195,95,213,57,156
"2011","Kirklees 010B","E01011029","Total",677,312,48,264,190,90,248,46,202
"2011","Kirklees 010C","E01011032","Total",578,208,57,151,239,112,188,55,133
"2011","Kirklees 010D","E01011034","Total",469,158,37,121,233,114,149,50,99
"2011","Kirklees 011A","E01011157","Total",574,139,30,109,220,108,137,47,90
"2011","Kirklees 011B","E01011161","Total",528,123,10,113,183,70,118,27,91
"2011","Kirklees 011C","E01011163","Total",589,259,53,206,190,82,190,41,149
"2011","Kirklees 011D","E01011164","Total",695,225,12,213,221,88,191,38,153
"2011","Kirklees 011E","E01011165","Total",564,128,29,99,264,135,116,38,78
"2011","Kirklees 011F","E01011166","Total",658,221,29,192,211,91,210,41,169
"2011","Kirklees 011G","E01011167","Total",732,272,54,218,254,123,222,45,177
"2011","Kirklees 012A","E01011033","Total",667,194,25,169,212,107,176,38,138
"2011","Kirklees 012B","E01011035","Total",481,149,35,114,238,105,169,55,114
"2011","Kirklees 012C","E01011036","Total",586,226,71,155,273,133,203,58,145
"2011","Kirklees 012D","E01011037","Total",802,200,33,167,298,171,169,39,130
"2011","Kirklees 013A","E01011016","Total",541,134,26,108,200,88,144,42,102
"2011","Kirklees 013B","E01011017","Total",467,178,45,133,230,84,169,42,127
"2011","Kirklees 013C","E01011018","Total",433,134,27,107,216,100,137,43,94
"2011","Kirklees 013D","E01011019","Total",526,141,16,125,203,75,124,31,93
"2011","Kirklees 013E","E01011020","Total",446,166,39,127,205,106,134,39,95
"2011","Kirklees 014A","E01011021","Total",690,188,9,179,195,76,156,22,134
"2011","Kirklees 014B","E01011022","Total",597,186,11,175,173,65,145,22,123
"2011","Kirklees 014C","E01011126","Total",771,354,29,325,167,72,256,30,226
"2011","Kirklees 014D","E01011127","Total",590,190,20,170,178,65,151,33,118
"2011","Kirklees 015A","E01011156","Total",687,280,9,271,169,67,215,23,192
"2011","Kirklees 015B","E01011158","Total",716,194,22,172,231,102,159,34,125
"2011","Kirklees 015C","E01011159","Total",726,214,6,208,214,77,165,30,135
"2011","Kirklees 015D","E01011160","Total",553,114,9,105,208,68,111,26,85
"2011","Kirklees 015E","E01011162","Total",674,241,12,229,161,69,194,23,171
"2011","Kirklees 016A","E01011025","Total",582,198,76,122,252,111,147,41,106
"2011","Kirklees 016B","E01011026","Total",557,181,14,167,189,87,171,35,136
"2011","Kirklees 016C","E01011136","Total",592,243,53,190,218,105,178,41,137
"2011","Kirklees 016D","E01011137","Total",641,195,46,149,233,101,181,33,148
"2011","Kirklees 017A","E01011128","Total",788,226,48,178,266,138,219,61,158
"2011","Kirklees 017B","E01011130","Total",949,406,52,354,200,102,321,48,273
"2011","Kirklees 017E","E01033542","Total",995,305,39,266,360,143,269,66,203
"2011","Kirklees 018A","E01011121","Total",628,194,52,142,220,99,164,42,122
"2011","Kirklees 018B","E01011122","Total",493,206,85,121,236,101,160,58,102
"2011","Kirklees 018C","E01011123","Total",688,265,23,242,188,76,223,33,190
"2011","Kirklees 018D","E01011124","Total",850,257,30,227,240,111,207,27,180
"2011","Kirklees 018E","E01011125","Total",671,241,34,207,217,84,194,37,157
"2011","Kirklees 018F","E01011129","Total",501,137,29,108,186,63,122,32,90
"2011","Kirklees 019A","E01011138","Total",655,276,83,193,267,135,210,72,138
"2011","Kirklees 019B","E01011139","Total",462,130,36,94,200,84,115,36,79
"2011","Kirklees 019C","E01011140","Total",474,185,95,90,282,145,148,76,72
"2011","Kirklees 019D","E01011141","Total",535,138,31,107,262,130,128,50,78
"2011","Kirklees 020A","E01011132","Total",544,178,8,170,178,51,108,14,94
"2011","Kirklees 020B","E01011142","Total",686,213,12,201,191,67,163,22,141
"2011","Kirklees 020C","E01011217","Total",734,301,8,293,151,48,206,15,191
"2011","Kirklees 020D","E01011218","Total",733,286,18,268,195,83,215,23,192
"2011","Kirklees 021A","E01011216","Total",574,183,5,178,176,68,121,19,102
"2011","Kirklees 021B","E01011219","Total",683,209,8,201,165,55,156,20,136
"2011","Kirklees 021C","E01011220","Total",730,284,64,220,264,114,258,66,192
"2011","Kirklees 021D","E01011221","Total",722,252,13,239,217,55,185,31,154
"2011","Kirklees 022A","E01011046","Total",508,164,10,154,149,40,119,14,105
"2011","Kirklees 022B","E01011100","Total",719,322,33,289,183,80,234,26,208
"2011","Kirklees 022C","E01011102","Total",520,115,20,95,191,58,101,27,74
"2011","Kirklees 022D","E01011108","Total",644,191,17,174,157,64,138,19,119
"2011","Kirklees 023A","E01011133","Total",472,186,54,132,224,98,150,48,102
"2011","Kirklees 023B","E01011134","Total",600,232,92,140,333,178,201,90,111
"2011","Kirklees 023C","E01011143","Total",521,177,52,125,251,139,169,68,101
"2011","Kirklees 023D","E01011144","Total",498,208,54,154,224,118,170,57,113
"2011","Kirklees 023E","E01011260","Total",533,172,26,146,193,101,151,36,115
"2011","Kirklees 024A","E01011257","Total",498,115,39,76,293,139,142,74,68
"2011","Kirklees 024B","E01011258","Total",414,94,29,65,242,97,106,53,53
"2011","Kirklees 024C","E01011259","Total",583,231,55,176,224,96,207,56,151
"2011","Kirklees 024D","E01011261","Total",444,142,37,105,222,112,117,33,84
"2011","Kirklees 024E","E01011262","Total",536,213,56,157,256,117,182,57,125
"2011","Kirklees 024F","E01011263","Total",627,181,29,152,225,94,159,42,117
"2011","Kirklees 025A","E01011101","Total",737,325,133,192,338,173,177,55,122
"2011","Kirklees 025B","E01011103","Total",638,269,52,217,187,79,188,30,158
"2011","Kirklees 025C","E01011104","Total",785,337,40,297,209,78,269,44,225
"2011","Kirklees 025D","E01011105","Total",791,270,96,174,386,193,194,60,134
"2011","Kirklees 026A","E01011212","Total",796,386,26,360,186,67,284,29,255
"2011","Kirklees 026B","E01011213","Total",654,271,8,263,186,51,177,26,151
"2011","Kirklees 026C","E01011214","Total",690,187,16,171,191,65,165,29,136
"2011","Kirklees 026D","E01011215","Total",974,306,11,295,216,85,243,21,222
"2011","Kirklees 027A","E01011039","Total",673,272,26,246,204,86,230,48,182
"2011","Kirklees 027B","E01011042","Total",639,159,15,144,192,65,144,30,114
"2011","Kirklees 027C","E01011047","Total",649,254,9,245,157,52,164,23,141
"2011","Kirklees 027D","E01011210","Total",812,205,29,176,272,102,156,32,124
"2011","Kirklees 028A","E01011252","Total",487,143,2,141,114,27,130,22,108
"2011","Kirklees 028B","E01011253","Total",513,212,38,174,166,63,168,36,132
"2011","Kirklees 028C","E01011254","Total",646,249,9,240,137,40,182,27,155
"2011","Kirklees 028D","E01011255","Total",625,267,65,202,227,96,218,52,166
"2011","Kirklees 028E","E01011256","Total",607,245,21,224,170,71,194,29,165
"2011","Kirklees 029A","E01011038","Total",684,357,107,250,277,131,217,57,160
"2011","Kirklees 029B","E01011041","Total",662,247,45,202,199,77,151,30,121
"2011","Kirklees 029C","E01011106","Total",680,286,96,190,269,117,214,63,151
"2011","Kirklees 029D","E01011107","Total",826,382,86,296,220,124,200,44,156
"2011","Kirklees 030A","E01011201","Total",883,349,14,335,190,88,263,20,243
"2011","Kirklees 030B","E01011203","Total",728,235,14,221,248,88,163,25,138
"2011","Kirklees 030C","E01011209","Total",640,233,7,226,186,63,145,16,129
"2011","Kirklees 030D","E01011211","Total",680,263,9,254,169,71,162,15,147
"2011","Kirklees 031A","E01011040","Total",682,180,36,144,247,126,153,42,111
"2011","Kirklees 031B","E01011043","Total",889,296,57,239,293,140,226,62,164
"2011","Kirklees 031C","E01011044","Total",543,153,34,119,227,95,142,45,97
"2011","Kirklees 031D","E01011045","Total",725,298,45,253,226,111,270,50,220
"2011","Kirklees 032A","E01011089","Total",603,239,26,213,165,57,164,21,143
"2011","Kirklees 032B","E01011091","Total",573,147,5,142,196,74,111,26,85
"2011","Kirklees 032C","E01011092","Total",568,190,3,187,122,39,135,12,123
"2011","Kirklees 032D","E01011200","Total",906,144,15,129,354,167,141,36,105
"2011","Kirklees 033A","E01011204","Total",545,176,4,172,164,57,140,28,112
"2011","Kirklees 033B","E01011206","Total",805,264,12,252,209,67,205,30,175
"2011","Kirklees 033C","E01011208","Total",773,256,30,226,203,94,174,24,150
"2011","Kirklees 033D","E01011240","Total",757,270,25,245,217,83,220,46,174
"2011","Kirklees 034A","E01011231","Total",751,266,21,245,156,80,197,18,179
"2011","Kirklees 034B","E01011236","Total",779,294,23,271,121,62,185,33,152
"2011","Kirklees 034C","E01011238","Total",751,235,15,220,136,54,164,26,138
"2011","Kirklees 034D","E01011239","Total",691,213,14,199,182,83,156,27,129
"2011","Kirklees 035A","E01011093","Total",681,306,78,228,218,96,225,51,174
"2011","Kirklees 035B","E01011094","Total",674,346,75,271,236,78,271,56,215
"2011","Kirklees 035C","E01011096","Total",615,210,34,176,180,75,164,35,129
"2011","Kirklees 035D","E01011098","Total",669,212,32,180,173,94,152,22,130
"2011","Kirklees 036A","E01011146","Total",638,154,10,144,185,54,134,22,112
"2011","Kirklees 036B","E01011151","Total",648,141,8,133,214,76,121,25,96
"2011","Kirklees 036C","E01011202","Total",710,309,16,293,176,53,237,24,213
"2011","Kirklees 036D","E01011205","Total",696,172,6,166,180,60,137,23,114
"2011","Kirklees 037A","E01011090","Total",677,244,28,216,205,87,204,36,168
"2011","Kirklees 037B","E01011095","Total",628,237,17,220,153,56,172,20,152
"2011","Kirklees 037C","E01011097","Total",697,257,26,231,185,67,209,35,174
"2011","Kirklees 037D","E01011099","Total",621,208,22,186,198,70,180,37,143
"2011","Kirklees 038A","E01011150","Total",694,176,22,154,207,95,171,32,139
"2011","Kirklees 038B","E01011155","Total",873,213,14,199,211,110,144,16,128
"2011","Kirklees 038C","E01011207","Total",606,204,11,193,195,61,159,23,136
"2011","Kirklees 038D","E01011234","Total",703,251,32,219,211,77,212,30,182
"2011","Kirklees 039A","E01011232","Total",675,292,31,261,152,76,208,29,179
"2011","Kirklees 039B","E01011233","Total",647,171,20,151,238,117,137,24,113
"2011","Kirklees 039C","E01011235","Total",869,420,33,387,136,65,278,29,249
"2011","Kirklees 039D","E01011237","Total",647,233,75,158,250,136,183,61,122
"2011","Kirklees 040A","E01011004","Total",710,383,48,335,165,74,277,36,241
"2011","Kirklees 040B","E01011006","Total",651,240,21,219,182,65,183,26,157
"2011","Kirklees 040C","E01011008","Total",642,146,22,124,168,70,114,32,82
"2011","Kirklees 040D","E01011012","Total",710,231,39,192,225,106,177,24,153
"2011","Kirklees 041A","E01011145","Total",637,198,18,180,198,74,153,27,126
"2011","Kirklees 041B","E01011147","Total",637,167,19,148,197,79,137,27,110
"2011","Kirklees 041C","E01011148","Total",761,368,55,313,220,87,289,47,242
"2011","Kirklees 041D","E01011152","Total",777,159,18,141,214,76,147,29,118
"2011","Kirklees 042A","E01011007","Total",659,213,24,189,155,69,122,24,98
"2011","Kirklees 042B","E01011223","Total",726,279,100,179,272,142,159,38,121
"2011","Kirklees 042C","E01011225","Total",733,264,60,204,210,98,170,34,136
"2011","Kirklees 042D","E01011229","Total",936,417,30,387,112,52,251,25,226
"2011","Kirklees 043A","E01011080","Total",775,277,76,201,278,154,220,70,150
"2011","Kirklees 043B","E01011081","Total",729,297,61,236,225,109,201,50,151
"2011","Kirklees 043C","E01011082","Total",481,177,64,113,272,149,137,64,73
"2011","Kirklees 043D","E01011230","Total",559,225,89,136,300,174,151,69,82
"2011","Kirklees 044A","E01011005","Total",670,260,8,252,146,44,211,24,187
"2011","Kirklees 044B","E01011009","Total",612,253,23,230,153,49,161,22,139
"2011","Kirklees 044C","E01011010","Total",647,267,69,198,226,96,198,48,150
"2011","Kirklees 044D","E01011011","Total",695,252,6,246,169,53,163,17,146
"2011","Kirklees 045A","E01011077","Total",717,201,22,179,210,90,150,36,114
"2011","Kirklees 045B","E01011149","Total",923,284,43,241,228,129,226,38,188
"2011","Kirklees 045C","E01011153","Total",755,239,29,210,207,83,195,42,153
"2011","Kirklees 045D","E01011154","Total",633,195,53,142,247,108,168,45,123
"2011","Kirklees 046A","E01011191","Total",662,221,18,203,204,55,152,24,128
"2011","Kirklees 046B","E01011192","Total",712,280,23,257,196,81,229,37,192
"2011","Kirklees 046C","E01011193","Total",785,215,29,186,265,107,162,25,137
"2011","Kirklees 046D","E01011194","Total",599,234,2,232,133,35,150,15,135
"2011","Kirklees 047A","E01011079","Total",875,319,61,258,236,110,239,44,195
"2011","Kirklees 047B","E01011083","Total",713,232,22,210,227,96,172,34,138
"2011","Kirklees 047C","E01011084","Total",641,259,126,133,310,162,178,69,109
"2011","Kirklees 047D","E01011085","Total",691,325,41,284,187,80,236,37,199
"2011","Kirklees 048A","E01011224","Total",750,302,54,248,211,93,232,34,198
"2011","Kirklees 048B","E01011226","Total",649,224,16,208,183,68,163,28,135
"2011","Kirklees 048C","E01011227","Total",842,447,58,389,181,70,313,32,281
"2011","Kirklees 048D","E01011228","Total",642,214,20,194,160,55,175,30,145
"2011","Kirklees 049A","E01011071","Total",702,196,15,181,218,87,169,32,137
"2011","Kirklees 049B","E01011072","Total",662,172,18,154,221,85,167,26,141
"2011","Kirklees 049C","E01011073","Total",678,213,25,188,199,91,145,21,124
"2011","Kirklees 049D","E01011078","Total",834,263,23,240,219,99,185,28,157
"2011","Kirklees 050A","E01011086","Total",719,294,8,286,171,61,185,27,158
"2011","Kirklees 050B","E01011087","Total",769,320,33,287,187,73,230,32,198
"2011","Kirklees 050C","E01011088","Total",606,225,6,219,142,43,147,12,135
"2011","Kirklees 050D","E01011222","Total",1003,403,21,382,163,75,265,23,242
"2011","Kirklees 051A","E01011190","Total",729,210,6,204,169,61,159,24,135
"2011","Kirklees 051B","E01011195","Total",447,153,5,148,118,43,92,8,84
"2011","Kirklees 051C","E01011196","Total",726,197,8,189,240,95,163,32,131
"2011","Kirklees 051D","E01011197","Total",667,213,13,200,186,64,169,27,142
"2011","Kirklees 052A","E01011070","Total",661,185,25,160,199,63,171,37,134
"2011","Kirklees 052B","E01011074","Total",832,260,20,240,247,109,187,29,158
"2011","Kirklees 052C","E01011075","Total",662,225,16,209,154,70,179,30,149
"2011","Kirklees 052D","E01011076","Total",626,202,23,179,182,80,165,31,134
"2011","Kirklees 053A","E01011169","Total",607,185,5,180,163,52,116,18,98
"2011","Kirklees 053B","E01011170","Total",740,219,12,207,236,80,166,27,139
"2011","Kirklees 053C","E01011171","Total",632,169,7,162,171,63,105,20,85
"2011","Kirklees 053D","E01011172","Total",531,280,13,267,111,42,229,14,215
"2011","Kirklees 053E","E01011173","Total",525,191,5,186,173,55,124,18,106
"2011","Kirklees 053F","E01011176","Total",577,181,8,173,182,61,138,30,108
"2011","Kirklees 054A","E01011109","Total",723,168,17,151,238,88,153,35,118
"2011","Kirklees 054B","E01011113","Total",740,238,7,231,180,69,158,15,143
"2011","Kirklees 054C","E01011114","Total",688,319,24,295,171,57,222,25,197
"2011","Kirklees 054D","E01011119","Total",660,265,18,247,166,52,180,29,151
"2011","Kirklees 055A","E01011168","Total",672,219,8,211,185,60,159,27,132
"2011","Kirklees 055B","E01011174","Total",704,187,11,176,218,69,139,32,107
"2011","Kirklees 055C","E01011175","Total",598,218,51,167,213,78,176,42,134
"2011","Kirklees 055D","E01011177","Total",722,204,15,189,198,71,151,30,121
"2011","Kirklees 055E","E01011178","Total",871,323,19,304,224,80,245,29,216
"2011","Kirklees 056A","E01011118","Total",634,156,11,145,218,83,124,28,96
"2011","Kirklees 056B","E01011120","Total",592,129,4,125,223,81,97,21,76
"2011","Kirklees 056C","E01011198","Total",662,214,5,209,195,76,143,21,122
"2011","Kirklees 056D","E01011199","Total",621,211,19,192,216,69,143,28,115
"2011","Kirklees 057A","E01011110","Total",584,167,13,154,170,63,118,17,101
"2011","Kirklees 057B","E01011111","Total",643,184,8,176,206,66,138,29,109
"2011","Kirklees 057C","E01011112","Total",667,198,19,179,210,77,179,30,149
"2011","Kirklees 057D","E01011115","Total",772,203,14,189,214,83,169,32,137
"2011","Kirklees 057E","E01011116","Total",691,222,9,213,200,59,147,23,124
"2011","Kirklees 057F","E01011117","Total",729,222,8,214,227,81,160,25,135
"2011","Kirklees 058A","E01011180","Total",799,232,17,215,250,77,172,32,140
"2011","Kirklees 058B","E01011182","Total",766,229,12,217,217,77,154,27,127
"2011","Kirklees 058C","E01011186","Total",678,248,8,240,175,46,163,21,142
"2011","Kirklees 058D","E01011188","Total",699,240,26,214,216,74,164,24,140
"2011","Kirklees 059A","E01011179","Total",765,192,11,181,222,66,144,26,118
"2011","Kirklees 059B","E01011181","Total",846,211,16,195,216,87,163,22,141
"2011","Kirklees 059C","E01011183","Total",793,141,7,134,278,88,143,23,120
"2011","Kirklees 059D","E01011184","Total",582,196,27,169,207,62,152,33,119
"2011","Kirklees 059E","E01011185","Total",701,236,18,218,206,79,161,25,136
"2011","Kirklees 059F","E01011187","Total",685,199,23,176,241,79,172,43,129
"2011","Kirklees 059G","E01011189","Total",675,222,8,214,177,63,136,21,115
"2011","Leeds 001A","E01011698","Total",634,212,9,203,172,58,155,33,122
"2011","Leeds 001B","E01011699","Total",583,187,8,179,138,51,123,14,109
"2011","Leeds 001C","E01011701","Total",529,169,5,164,158,47,126,18,108
"2011","Leeds 001D","E01011702","Total",483,166,6,160,132,37,101,12,89
"2011","Leeds 001E","E01011703","Total",556,249,2,247,119,31,106,12,94
"2011","Leeds 002A","E01011697","Total",558,171,9,162,153,60,133,19,114
"2011","Leeds 002B","E01011700","Total",500,199,2,197,114,41,131,14,117
"2011","Leeds 002C","E01011704","Total",985,436,12,424,155,70,271,7,264
"2011","Leeds 002D","E01011705","Total",636,271,28,243,178,63,205,33,172
"2011","Leeds 003A","E01011581","Total",626,251,14,237,166,61,172,34,138
"2011","Leeds 003B","E01011582","Total",752,334,32,302,216,94,257,40,217
"2011","Leeds 003C","E01011583","Total",601,204,16,188,186,54,141,28,113
"2011","Leeds 003D","E01011584","Total",555,212,13,199,157,47,116,16,100
"2011","Leeds 004A","E01011569","Total",804,235,13,222,184,70,187,21,166
"2011","Leeds 004B","E01011571","Total",758,251,11,240,167,59,195,16,179
"2011","Leeds 004C","E01011572","Total",816,212,10,202,212,81,151,18,133
"2011","Leeds 004D","E01011573","Total",536,149,5,144,166,57,110,16,94
"2011","Leeds 004E","E01011574","Total",711,303,6,297,138,61,239,20,219
"2011","Leeds 005A","E01011707","Total",616,258,8,250,149,53,187,18,169
"2011","Leeds 005B","E01011709","Total",660,259,6,253,183,70,151,22,129
"2011","Leeds 005C","E01011710","Total",638,167,8,159,173,78,130,16,114
"2011","Leeds 005D","E01011711","Total",656,252,5,247,145,61,178,17,161
"2011","Leeds 005E","E01011712","Total",586,169,9,160,147,52,132,17,115
"2011","Leeds 006A","E01011561","Total",533,151,11,140,146,43,100,10,90
"2011","Leeds 006B","E01011696","Total",656,292,7,285,164,43,155,24,131
"2011","Leeds 006C","E01011706","Total",616,203,5,198,192,62,98,12,86
"2011","Leeds 006D","E01011708","Total",612,191,8,183,184,45,133,23,110
"2011","Leeds 006E","E01011713","Total",737,214,16,198,242,96,158,39,119
"2011","Leeds 007A","E01011570","Total",959,267,13,254,312,130,202,41,161
"2011","Leeds 007C","E01011576","Total",594,212,8,204,168,39,127,21,106
"2011","Leeds 007E","E01032503","Total",600,184,6,178,177,51,126,15,111
"2011","Leeds 007F","E01032504","Total",673,280,6,274,188,59,157,20,137
"2011","Leeds 008A","E01011266","Total",893,180,6,174,255,102,110,29,81
"2011","Leeds 008B","E01011270","Total",649,241,7,234,191,54,134,20,114
"2011","Leeds 008C","E01011279","Total",573,194,8,186,164,62,136,21,115
"2011","Leeds 008D","E01011280","Total",715,167,6,161,232,101,146,31,115
"2011","Leeds 009A","E01011265","Total",748,251,10,241,167,80,197,28,169
"2011","Leeds 009B","E01011267","Total",666,249,23,226,182,78,219,28,191
"2011","Leeds 009C","E01011271","Total",903,237,10,227,305,124,170,37,133
"2011","Leeds 009D","E01011272","Total",571,134,5,129,208,77,100,23,77
"2011","Leeds 010A","E01011268","Total",615,213,37,176,190,84,188,38,150
"2011","Leeds 010B","E01011273","Total",700,218,22,196,165,64,150,22,128
"2011","Leeds 010C","E01011274","Total",680,296,37,259,182,88,227,41,186
"2011","Leeds 010D","E01011275","Total",602,200,14,186,159,72,176,30,146
"2011","Leeds 011A","E01011264","Total",565,213,13,200,134,38,163,29,134
"2011","Leeds 011B","E01011269","Total",735,270,16,254,172,62,222,23,199
"2011","Leeds 011C","E01011276","Total",611,167,17,150,174,73,125,26,99
"2011","Leeds 011D","E01011578","Total",625,215,6,209,134,47,162,21,141
"2011","Leeds 012A","E01011554","Total",603,186,11,175,171,73,125,19,106
"2011","Leeds 012B","E01011562","Total",628,208,9,199,194,51,131,19,112
"2011","Leeds 012C","E01011563","Total",618,233,7,226,148,48,144,16,128
"2011","Leeds 012D","E01011564","Total",605,183,7,176,185,77,138,22,116
"2011","Leeds 012E","E01011567","Total",562,138,4,134,184,69,120,16,104
"2011","Leeds 013A","E01011376","Total",623,224,6,218,171,57,158,20,138
"2011","Leeds 013B","E01011377","Total",607,287,2,285,144,30,168,13,155
"2011","Leeds 013C","E01011378","Total",685,284,44,240,168,72,226,26,200
"2011","Leeds 013D","E01011382","Total",662,241,4,237,174,78,147,24,123
"2011","Leeds 014A","E01011277","Total",607,103,9,94,227,92,94,21,73
"2011","Leeds 014B","E01011278","Total",716,200,16,184,202,84,147,24,123
"2011","Leeds 014C","E01011579","Total",493,119,10,109,182,82,104,16,88
"2011","Leeds 014D","E01011580","Total",603,217,4,213,159,53,129,14,115
"2011","Leeds 015A","E01011556","Total",759,214,18,196,211,97,155,18,137
"2011","Leeds 015B","E01011557","Total",646,209,7,202,179,47,163,27,136
"2011","Leeds 015C","E01011565","Total",592,181,9,172,171,71,141,17,124
"2011","Leeds 015D","E01011566","Total",569,184,16,168,166,59,138,27,111
"2011","Leeds 015E","E01011568","Total",861,276,8,268,200,59,194,22,172
"2011","Leeds 016A","E01011380","Total",679,255,12,243,165,59,131,15,116
"2011","Leeds 016B","E01011381","Total",509,164,12,152,154,46,104,16,88
"2011","Leeds 016C","E01011385","Total",525,180,9,171,133,41,128,19,109
"2011","Leeds 016D","E01011386","Total",621,194,6,188,163,63,134,18,116
"2011","Leeds 017A","E01011379","Total",768,323,31,292,178,77,267,34,233
"2011","Leeds 017B","E01011384","Total",660,237,20,217,179,75,167,25,142
"2011","Leeds 017E","E01032501","Total",498,160,8,152,136,59,109,18,91
"2011","Leeds 017F","E01032502","Total",801,306,85,221,277,123,222,48,174
"2011","Leeds 018A","E01011555","Total",561,168,13,155,152,56,117,21,96
"2011","Leeds 018B","E01011558","Total",722,286,58,228,251,107,222,53,169
"2011","Leeds 018C","E01011559","Total",568,247,45,202,188,69,210,37,173
"2011","Leeds 018D","E01011560","Total",883,405,68,337,247,113,329,56,273
"2011","Leeds 019A","E01011383","Total",742,310,22,288,165,69,219,30,189
"2011","Leeds 019B","E01011388","Total",643,262,12,250,161,60,182,20,162
"2011","Leeds 019C","E01011684","Total",638,201,17,184,183,71,156,34,122
"2011","Leeds 019D","E01011695","Total",704,318,69,249,237,97,240,55,185
"2011","Leeds 020A","E01011650","Total",594,172,10,162,163,65,125,24,101
"2011","Leeds 020B","E01011651","Total",637,176,22,154,192,90,135,24,111
"2011","Leeds 020C","E01011653","Total",606,174,10,164,133,58,134,16,118
"2011","Leeds 020D","E01011655","Total",703,244,7,237,132,52,169,12,157
"2011","Leeds 021A","E01011455","Total",481,169,4,165,150,51,99,14,85
"2011","Leeds 021B","E01011456","Total",728,276,6,270,198,76,141,19,122
"2011","Leeds 021C","E01011459","Total",743,274,11,263,150,52,192,28,164
"2011","Leeds 021D","E01011461","Total",611,228,3,225,188,56,122,20,102
"2011","Leeds 022A","E01011311","Total",463,129,9,120,156,49,74,14,60
"2011","Leeds 022B","E01011649","Total",647,222,6,216,172,64,125,15,110
"2011","Leeds 022C","E01011715","Total",527,154,5,149,153,47,110,20,90
"2011","Leeds 022D","E01011719","Total",628,253,5,248,145,46,195,22,173
"2011","Leeds 023A","E01011509","Total",637,254,5,249,140,56,201,13,188
"2011","Leeds 023B","E01011511","Total",529,194,10,184,154,67,149,25,124
"2011","Leeds 023C","E01011512","Total",654,191,11,180,177,73,142,26,116
"2011","Leeds 023D","E01011515","Total",652,171,9,162,141,62,136,24,112
"2011","Leeds 023E","E01011516","Total",644,139,4,135,236,84,136,31,105
"2011","Leeds 024A","E01011508","Total",463,75,6,69,212,81,102,34,68
"2011","Leeds 024B","E01011517","Total",731,199,25,174,220,90,165,31,134
"2011","Leeds 024C","E01011652","Total",501,101,8,93,168,69,101,26,75
"2011","Leeds 024D","E01011654","Total",530,123,8,115,219,91,110,26,84
"2011","Leeds 025A","E01011505","Total",658,231,26,205,203,75,188,37,151
"2011","Leeds 025B","E01011506","Total",513,124,16,108,191,84,108,29,79
"2011","Leeds 025C","E01011507","Total",660,187,12,175,189,70,151,28,123
"2011","Leeds 025D","E01011510","Total",865,462,36,426,172,66,333,31,302
"2011","Leeds 025E","E01011514","Total",632,151,7,144,175,84,115,19,96
"2011","Leeds 027A","E01011452","Total",616,159,2,157,191,76,97,13,84
"2011","Leeds 027B","E01011454","Total",669,153,6,147,171,74,101,14,87
"2011","Leeds 027C","E01011457","Total",591,165,7,158,194,72,112,19,93
"2011","Leeds 027D","E01011458","Total",556,181,2,179,179,60,105,17,88
"2011","Leeds 027E","E01011465","Total",785,296,14,282,138,55,232,20,212
"2011","Leeds 028A","E01011453","Total",661,196,2,194,162,78,137,14,123
"2011","Leeds 028B","E01011460","Total",655,172,19,153,162,76,149,25,124
"2011","Leeds 028C","E01011462","Total",699,240,32,208,207,69,177,40,137
"2011","Leeds 028D","E01011463","Total",749,293,32,261,190,67,230,39,191
"2011","Leeds 028E","E01011464","Total",821,165,5,160,156,85,126,13,113
"2011","Leeds 029A","E01011714","Total",605,201,17,184,181,58,154,26,128
"2011","Leeds 029B","E01011716","Total",607,222,14,208,164,58,144,25,119
"2011","Leeds 029C","E01011717","Total",655,239,27,212,197,82,179,30,149
"2011","Leeds 029D","E01011718","Total",601,200,25,175,200,88,176,34,142
"2011","Leeds 029E","E01011720","Total",691,308,36,272,173,79,250,24,226
"2011","Leeds 030A","E01011296","Total",771,326,8,318,164,52,212,26,186
"2011","Leeds 030B","E01011297","Total",632,173,10,163,213,65,125,27,98
"2011","Leeds 030C","E01011309","Total",654,227,13,214,170,64,148,29,119
"2011","Leeds 030D","E01011310","Total",716,255,7,248,179,68,165,22,143
"2011","Leeds 031A","E01011513","Total",936,169,13,156,317,144,157,30,127
"2011","Leeds 031B","E01011688","Total",608,148,37,111,210,101,124,39,85
"2011","Leeds 031C","E01011689","Total",765,296,19,277,164,79,217,16,201
"2011","Leeds 031D","E01011691","Total",645,249,44,205,194,81,195,37,158
"2011","Leeds 032A","E01011504","Total",749,330,41,289,186,74,258,45,213
"2011","Leeds 032B","E01011641","Total",618,157,9,148,202,78,120,22,98
"2011","Leeds 032C","E01011642","Total",487,112,9,103,177,62,112,28,84
"2011","Leeds 032D","E01011645","Total",608,162,17,145,183,82,138,21,117
"2011","Leeds 033A","E01011484","Total",671,286,66,220,240,99,233,52,181
"2011","Leeds 033B","E01011485","Total",746,298,48,250,190,92,220,29,191
"2011","Leeds 033E","E01011686","Total",810,380,50,330,197,92,299,49,250
"2011","Leeds 033F","E01032493","Total",619,178,9,169,146,57,128,16,112
"2011","Leeds 033G","E01032494","Total",716,244,67,177,246,95,207,52,155
"2011","Leeds 034A","E01011350","Total",713,172,5,167,191,84,145,21,124
"2011","Leeds 034B","E01011351","Total",878,211,6,205,122,56,151,12,139
"2011","Leeds 034C","E01011352","Total",887,202,15,187,113,73,171,14,157
"2011","Leeds 034D","E01011353","Total",822,143,4,139,207,84,123,26,97
"2011","Leeds 035A","E01011656","Total",597,214,72,142,250,98,165,40,125
"2011","Leeds 035B","E01011657","Total",602,253,46,207,183,78,190,31,159
"2011","Leeds 035C","E01011659","Total",648,304,33,271,161,60,227,31,196
"2011","Leeds 035D","E01011661","Total",852,459,42,417,160,52,374,32,342
"2011","Leeds 037A","E01011643","Total",594,215,7,208,139,53,156,20,136
"2011","Leeds 037B","E01011644","Total",542,200,16,184,135,53,128,21,107
"2011","Leeds 037C","E01011646","Total",644,167,17,150,219,82,141,33,108
"2011","Leeds 037D","E01011647","Total",498,127,34,93,234,111,135,50,85
"2011","Leeds 037E","E01011648","Total",566,155,18,137,234,96,129,31,98
"2011","Leeds 038A","E01011354","Total",624,248,78,170,229,109,188,41,147
"2011","Leeds 038B","E01011355","Total",576,205,43,162,199,78,203,46,157
"2011","Leeds 038C","E01011357","Total",880,368,100,268,298,121,266,58,208
"2011","Leeds 038D","E01011450","Total",523,183,35,148,147,70,149,25,124
"2011","Leeds 039A","E01011588","Total",691,168,18,150,239,124,127,26,101
"2011","Leeds 039B","E01011589","Total",699,184,6,178,190,89,145,16,129
"2011","Leeds 039C","E01011590","Total",639,188,8,180,185,79,139,20,119
"2011","Leeds 039D","E01011592","Total",719,236,7,229,121,60,185,11,174
"2011","Leeds 039E","E01011593","Total",789,183,5,178,210,91,153,34,119
"2011","Leeds 040A","E01011421","Total",607,220,33,187,197,79,213,39,174
"2011","Leeds 040B","E01011425","Total",606,158,12,146,205,71,140,25,115
"2011","Leeds 040C","E01011658","Total",631,341,83,258,207,87,211,32,179
"2011","Leeds 040D","E01011660","Total",588,261,47,214,186,72,195,29,166
"2011","Leeds 040E","E01011662","Total",496,226,65,161,195,82,164,40,124
"2011","Leeds 041A","E01011721","Total",621,241,53,188,233,106,186,41,145
"2011","Leeds 041B","E01011722","Total",812,276,50,226,269,131,233,46,187
"2011","Leeds 041C","E01011723","Total",617,294,54,240,217,98,240,31,209
"2011","Leeds 041D","E01011724","Total",830,314,61,253,257,125,272,45,227
"2011","Leeds 042A","E01011356","Total",897,222,35,187,208,97,193,41,152
"2011","Leeds 042B","E01011358","Total",695,318,45,273,191,70,253,36,217
"2011","Leeds 042C","E01011359","Total",745,199,40,159,198,69,186,34,152
"2011","Leeds 042D","E01011360","Total",722,256,72,184,314,145,195,71,124
"2011","Leeds 042E","E01011361","Total",1090,470,114,356,332,139,328,75,253
"2011","Leeds 044A","E01011435","Total",562,128,1,127,23,9,65,2,63
"2011","Leeds 044D","E01011440","Total",611,180,3,177,22,10,107,6,101
"2011","Leeds 044E","E01011441","Total",649,183,9,174,68,32,100,13,87
"2011","Leeds 044F","E01032945","Total",848,180,5,175,56,22,98,11,87
"2011","Leeds 045A","E01011477","Total",866,306,71,235,195,96,207,32,175
"2011","Leeds 045B","E01011480","Total",624,195,13,182,137,61,152,28,124
"2011","Leeds 045C","E01011488","Total",666,171,30,141,119,53,148,26,122
"2011","Leeds 045D","E01011489","Total",823,306,42,264,148,66,252,36,216
"2011","Leeds 046A","E01011324","Total",510,235,86,149,204,100,148,38,110
"2011","Leeds 046B","E01011325","Total",653,201,33,168,187,84,159,24,135
"2011","Leeds 046C","E01011326","Total",575,220,51,169,201,95,169,34,135
"2011","Leeds 046D","E01011332","Total",558,209,40,169,182,82,160,32,128
"2011","Leeds 047A","E01011423","Total",607,218,66,152,266,129,173,41,132
"2011","Leeds 047B","E01011424","Total",516,172,73,99,289,137,131,52,79
"2011","Leeds 047C","E01011427","Total",563,221,84,137,298,150,172,73,99
"2011","Leeds 047D","E01011431","Total",769,338,104,234,316,148,252,60,192
"2011","Leeds 048A","E01011422","Total",495,164,45,119,196,85,106,40,66
"2011","Leeds 048B","E01011426","Total",493,176,64,112,262,126,149,59,90
"2011","Leeds 048C","E01011428","Total",601,185,52,133,273,149,146,48,98
"2011","Leeds 048D","E01011429","Total",693,296,87,209,261,121,212,60,152
"2011","Leeds 050A","E01011663","Total",430,173,87,86,244,120,115,54,61
"2011","Leeds 050B","E01011664","Total",477,210,44,166,165,70,158,30,128
"2011","Leeds 050C","E01011665","Total",626,255,36,219,173,67,202,30,172
"2011","Leeds 050D","E01011667","Total",511,271,149,122,304,147,156,65,91
"2011","Leeds 051A","E01011323","Total",576,251,11,240,136,51,191,15,176
"2011","Leeds 051B","E01011329","Total",662,172,6,166,166,57,145,16,129
"2011","Leeds 051C","E01011330","Total",556,179,21,158,164,62,127,22,105
"2011","Leeds 051D","E01011333","Total",559,190,27,163,167,73,161,21,140
"2011","Leeds 052A","E01011327","Total",624,179,24,155,167,64,156,27,129
"2011","Leeds 052B","E01011328","Total",665,234,36,198,208,88,211,35,176
"2011","Leeds 052C","E01011335","Total",792,207,33,174,215,92,163,32,131
"2011","Leeds 052D","E01011591","Total",810,161,7,154,159,81,129,20,109
"2011","Leeds 053A","E01011430","Total",451,167,70,97,226,115,96,36,60
"2011","Leeds 053B","E01011432","Total",571,219,72,147,259,150,119,41,78
"2011","Leeds 053C","E01011433","Total",668,280,115,165,257,153,150,43,107
"2011","Leeds 053D","E01011434","Total",612,242,81,161,235,148,126,38,88
"2011","Leeds 054A","E01011445","Total",436,125,2,123,23,7,40,4,36
"2011","Leeds 054B","E01011446","Total",465,145,9,136,44,20,64,8,56
"2011","Leeds 054C","E01011447","Total",405,131,13,118,40,19,64,11,53
"2011","Leeds 054D","E01011448","Total",460,177,26,151,69,37,98,16,82
"2011","Leeds 054E","E01011449","Total",566,188,30,158,74,43,112,13,99
"2011","Leeds 055A","E01011670","Total",916,462,83,379,203,101,234,45,189
"2011","Leeds 055B","E01011671","Total",644,283,84,199,235,107,190,51,139
"2011","Leeds 055F","E01033002","Total",761,366,58,308,113,86,186,14,172
"2011","Leeds 055G","E01033003","Total",1109,392,40,352,175,135,176,14,162
"2011","Leeds 055H","E01033005","Total",876,437,71,366,142,72,189,25,164
"2011","Leeds 056A","E01011478","Total",752,234,24,210,93,42,168,16,152
"2011","Leeds 056B","E01011479","Total",543,131,13,118,43,15,91,6,85
"2011","Leeds 056C","E01011481","Total",639,214,36,178,109,63,134,16,118
"2011","Leeds 056D","E01011482","Total",820,174,28,146,119,55,151,26,125
"2011","Leeds 056E","E01011483","Total",665,282,45,237,136,62,174,25,149
"2011","Leeds 057A","E01011406","Total",590,200,6,194,156,61,149,20,129
"2011","Leeds 057B","E01011407","Total",653,227,16,211,175,70,174,23,151
"2011","Leeds 057C","E01011408","Total",735,374,6,368,113,38,270,25,245
"2011","Leeds 057D","E01011409","Total",635,180,13,167,144,55,158,20,138
"2011","Leeds 057E","E01011410","Total",616,217,3,214,110,34,167,18,149
"2011","Leeds 057F","E01011412","Total",624,254,3,251,139,51,168,18,150
"2011","Leeds 058A","E01011331","Total",591,191,14,177,141,52,148,16,132
"2011","Leeds 058B","E01011334","Total",598,164,25,139,151,67,150,26,124
"2011","Leeds 058C","E01011336","Total",777,382,39,343,168,82,316,48,268
"2011","Leeds 058D","E01011337","Total",469,185,95,90,259,116,135,56,79
"2011","Leeds 059A","E01011281","Total",824,266,66,200,218,111,189,33,156
"2011","Leeds 059B","E01011282","Total",610,207,31,176,193,79,178,31,147
"2011","Leeds 059C","E01011283","Total",538,225,68,157,214,94,176,45,131
"2011","Leeds 059D","E01011286","Total",538,147,14,133,146,59,115,20,95
"2011","Leeds 059E","E01011295","Total",686,219,41,178,219,104,158,23,135
"2011","Leeds 060A","E01011339","Total",823,383,52,331,237,113,276,40,236
"2011","Leeds 060B","E01011340","Total",693,311,74,237,243,102,211,36,175
"2011","Leeds 060C","E01011342","Total",569,266,85,181,232,113,160,34,126
"2011","Leeds 060D","E01011346","Total",821,416,82,334,248,117,294,45,249
"2011","Leeds 061A","E01011341","Total",637,227,36,191,206,95,157,29,128
"2011","Leeds 061B","E01011343","Total",807,269,30,239,187,75,219,29,190
"2011","Leeds 061C","E01011345","Total",627,266,55,211,202,82,223,48,175
"2011","Leeds 061D","E01011666","Total",594,169,8,161,187,62,140,21,119
"2011","Leeds 062A","E01011585","Total",650,209,26,183,179,73,180,22,158
"2011","Leeds 062B","E01011587","Total",757,159,7,152,196,100,147,25,122
"2011","Leeds 062C","E01011594","Total",605,224,26,198,214,90,205,33,172
"2011","Leeds 062D","E01011596","Total",759,185,10,175,199,84,147,19,128
"2011","Leeds 062E","E01011598","Total",734,165,10,155,175,83,145,24,121
"2011","Leeds 063B","E01011678","Total",663,259,13,246,51,27,125,7,118
"2011","Leeds 063D","E01011681","Total",673,273,53,220,124,62,165,28,137
"2011","Leeds 063E","E01033006","Total",1016,442,32,410,85,59,128,13,115
"2011","Leeds 064A","E01011338","Total",740,335,86,249,251,124,224,49,175
"2011","Leeds 064B","E01011673","Total",810,369,93,276,267,164,206,35,171
"2011","Leeds 064D","E01011677","Total",786,386,63,323,201,116,258,36,222
"2011","Leeds 064E","E01033031","Total",782,248,21,227,86,56,148,11,137
"2011","Leeds 064F","E01033035","Total",752,313,79,234,207,135,154,38,116
"2011","Leeds 065A","E01011344","Total",824,359,108,251,277,145,233,56,177
"2011","Leeds 065B","E01011347","Total",776,344,120,224,285,150,198,42,156
"2011","Leeds 065C","E01011348","Total",636,284,89,195,262,134,182,42,140
"2011","Leeds 065D","E01011349","Total",962,468,57,411,186,99,362,33,329
"2011","Leeds 066A","E01011586","Total",597,205,18,187,180,81,164,39,125
"2011","Leeds 066B","E01011595","Total",639,201,15,186,210,96,162,41,121
"2011","Leeds 066C","E01011597","Total",557,170,30,140,208,93,137,35,102
"2011","Leeds 066D","E01011599","Total",647,198,12,186,198,83,181,29,152
"2011","Leeds 067B","E01011287","Total",599,180,17,163,161,62,131,18,113
"2011","Leeds 067G","E01032499","Total",702,188,9,179,194,65,168,25,143
"2011","Leeds 067H","E01032500","Total",568,191,33,158,117,62,136,18,118
"2011","Leeds 067I","E01032606","Total",906,298,41,257,255,106,221,38,183
"2011","Leeds 067J","E01032607","Total",547,197,25,172,114,61,135,14,121
"2011","Leeds 067K","E01032608","Total",500,120,20,100,136,55,112,25,87
"2011","Leeds 068A","E01011608","Total",583,203,28,175,171,73,177,25,152
"2011","Leeds 068B","E01011609","Total",668,242,41,201,189,75,208,35,173
"2011","Leeds 068C","E01011610","Total",616,186,7,179,159,51,133,24,109
"2011","Leeds 068D","E01011611","Total",603,241,46,195,190,62,210,42,168
"2011","Leeds 068E","E01011614","Total",807,209,16,193,196,80,151,35,116
"2011","Leeds 069A","E01011413","Total",584,155,10,145,200,68,127,27,100
"2011","Leeds 069B","E01011415","Total",718,199,12,187,180,88,159,27,132
"2011","Leeds 069C","E01011416","Total",606,180,12,168,208,66,139,23,116
"2011","Leeds 069D","E01011417","Total",724,330,10,320,135,34,210,25,185
"2011","Leeds 069E","E01011420","Total",624,312,3,309,94,20,195,14,181
"2011","Leeds 070A","E01011615","Total",639,188,31,157,212,92,154,28,126
"2011","Leeds 070B","E01011617","Total",679,264,73,191,261,122,205,47,158
"2011","Leeds 070C","E01011618","Total",725,254,76,178,247,134,172,42,130
"2011","Leeds 070D","E01011621","Total",588,235,57,178,224,105,158,30,128
"2011","Leeds 071A","E01011284","Total",878,236,68,168,204,113,182,33,149
"2011","Leeds 071B","E01011292","Total",823,395,60,335,182,102,245,24,221
"2011","Leeds 071C","E01011293","Total",743,268,58,210,228,124,204,43,161
"2011","Leeds 071D","E01011294","Total",462,202,45,157,148,67,151,31,120
"2011","Leeds 071E","E01011363","Total",735,331,80,251,238,115,209,45,164
"2011","Leeds 072A","E01011616","Total",680,319,61,258,198,81,228,32,196
"2011","Leeds 072B","E01011620","Total",490,213,71,142,222,100,151,37,114
"2011","Leeds 072C","E01011622","Total",657,278,111,167,306,150,197,56,141
"2011","Leeds 072D","E01011624","Total",714,338,102,236,306,143,227,53,174
"2011","Leeds 073A","E01011411","Total",665,187,12,175,209,71,152,23,129
"2011","Leeds 073B","E01011414","Total",623,184,5,179,176,54,119,18,101
"2011","Leeds 073C","E01011418","Total",612,140,6,134,198,72,121,24,97
"2011","Leeds 073D","E01011419","Total",496,155,4,151,129,37,100,18,82
"2011","Leeds 074A","E01011396","Total",800,250,19,231,212,85,209,29,180
"2011","Leeds 074B","E01011399","Total",623,212,18,194,194,65,164,38,126
"2011","Leeds 074C","E01011400","Total",597,202,14,188,177,62,154,24,130
"2011","Leeds 074D","E01011403","Total",613,306,9,297,140,41,191,14,177
"2011","Leeds 075B","E01011623","Total",703,299,96,203,240,133,181,38,143
"2011","Leeds 075C","E01011625","Total",698,281,75,206,224,128,174,33,141
"2011","Leeds 075D","E01011626","Total",949,374,77,297,186,97,272,46,226
"2011","Leeds 075E","E01033021","Total",697,291,30,261,133,54,232,19,213
"2011","Leeds 075F","E01033033","Total",740,185,12,173,38,21,120,3,117
"2011","Leeds 075G","E01033034","Total",645,72,3,69,19,15,40,1,39
"2011","Leeds 076A","E01011602","Total",743,284,9,275,152,66,233,22,211
"2011","Leeds 076B","E01011603","Total",658,203,12,191,170,67,137,9,128
"2011","Leeds 076C","E01011605","Total",636,219,3,216,167,53,170,15,155
"2011","Leeds 076D","E01011606","Total",642,213,28,185,229,89,174,44,130
"2011","Leeds 076E","E01011613","Total",549,182,31,151,189,82,137,29,108
"2011","Leeds 077A","E01011397","Total",602,151,6,145,192,64,140,23,117
"2011","Leeds 077B","E01011398","Total",498,109,8,101,162,45,84,18,66
"2011","Leeds 077C","E01011401","Total",601,174,5,169,204,74,121,22,99
"2011","Leeds 077D","E01011404","Total",522,147,5,142,177,63,119,21,98
"2011","Leeds 077E","E01011405","Total",627,293,5,288,132,40,186,22,164
"2011","Leeds 078A","E01011725","Total",699,307,88,219,263,111,235,60,175
"2011","Leeds 078B","E01011729","Total",741,264,44,220,185,88,192,26,166
"2011","Leeds 078C","E01011730","Total",657,203,67,136,260,134,176,41,135
"2011","Leeds 078D","E01011735","Total",738,308,74,234,241,107,229,45,184
"2011","Leeds 079A","E01011600","Total",671,199,7,192,182,65,173,23,150
"2011","Leeds 079B","E01011601","Total",624,181,32,149,220,90,149,31,118
"2011","Leeds 079C","E01011604","Total",601,160,10,150,171,71,120,16,104
"2011","Leeds 079D","E01011607","Total",685,178,20,158,233,111,162,41,121
"2011","Leeds 079E","E01011612","Total",687,360,14,346,102,56,247,14,233
"2011","Leeds 080A","E01011726","Total",634,228,49,179,208,88,187,44,143
"2011","Leeds 080B","E01011727","Total",674,186,21,165,202,85,152,24,128
"2011","Leeds 080C","E01011728","Total",626,230,16,214,163,59,167,32,135
"2011","Leeds 080D","E01011739","Total",699,288,46,242,192,78,219,40,179
"2011","Leeds 081A","E01011362","Total",974,332,40,292,207,122,263,34,229
"2011","Leeds 081B","E01011731","Total",609,208,14,194,163,65,173,28,145
"2011","Leeds 081C","E01011732","Total",777,222,17,205,224,96,189,35,154
"2011","Leeds 081D","E01011733","Total",691,229,11,218,158,45,170,15,155
"2011","Leeds 082A","E01011366","Total",757,317,66,251,229,124,228,41,187
"2011","Leeds 082C","E01011368","Total",611,258,62,196,169,103,185,28,157
"2011","Leeds 082D","E01011370","Total",698,226,37,189,194,108,158,36,122
"2011","Leeds 082E","E01033013","Total",647,202,31,171,97,53,134,16,118
"2011","Leeds 082F","E01033032","Total",789,136,17,119,70,46,101,14,87
"2011","Leeds 083A","E01011734","Total",1011,229,32,197,301,146,170,37,133
"2011","Leeds 083B","E01011736","Total",648,189,14,175,180,60,143,28,115
"2011","Leeds 083C","E01011737","Total",760,278,68,210,213,103,192,33,159
"2011","Leeds 083D","E01011738","Total",632,186,12,174,183,63,130,13,117
"2011","Leeds 085A","E01011364","Total",785,349,67,282,210,111,224,37,187
"2011","Leeds 085B","E01011371","Total",728,413,51,362,144,66,300,27,273
"2011","Leeds 085C","E01011373","Total",574,254,68,186,224,119,172,52,120
"2011","Leeds 085D","E01011374","Total",595,204,47,157,150,80,135,24,111
"2011","Leeds 086A","E01011312","Total",669,292,85,207,227,135,155,43,112
"2011","Leeds 086B","E01011316","Total",720,290,70,220,215,113,178,41,137
"2011","Leeds 086C","E01011372","Total",521,224,68,156,200,113,151,48,103
"2011","Leeds 086D","E01011375","Total",689,292,74,218,267,153,176,59,117
"2011","Leeds 087A","E01011390","Total",612,227,25,202,186,69,185,33,152
"2011","Leeds 087B","E01011391","Total",726,324,16,308,156,62,246,32,214
"2011","Leeds 087C","E01011392","Total",643,253,18,235,160,50,195,21,174
"2011","Leeds 087D","E01011402","Total",813,356,13,343,177,61,226,26,200
"2011","Leeds 088A","E01011298","Total",675,224,37,187,201,96,181,32,149
"2011","Leeds 088B","E01011299","Total",947,241,17,224,308,145,218,38,180
"2011","Leeds 088C","E01011302","Total",619,232,3,229,104,27,149,14,135
"2011","Leeds 088D","E01011303","Total",486,179,16,163,149,56,130,16,114
"2011","Leeds 089A","E01011300","Total",614,215,28,187,226,77,164,38,126
"2011","Leeds 089B","E01011301","Total",547,149,12,137,159,52,121,23,98
"2011","Leeds 089C","E01011304","Total",699,259,25,234,209,100,228,40,188
"2011","Leeds 089D","E01011305","Total",634,150,11,139,199,88,151,30,121
"2011","Leeds 089E","E01011306","Total",544,144,4,140,168,50,121,28,93
"2011","Leeds 090A","E01011315","Total",646,211,32,179,190,92,148,27,121
"2011","Leeds 090B","E01011317","Total",856,402,80,322,247,105,277,55,222
"2011","Leeds 090C","E01011318","Total",637,257,78,179,246,123,196,51,145
"2011","Leeds 090D","E01011321","Total",637,269,75,194,247,98,199,56,143
"2011","Leeds 090E","E01011369","Total",727,297,31,266,187,80,231,33,198
"2011","Leeds 091A","E01011313","Total",649,180,49,131,217,104,138,39,99
"2011","Leeds 091B","E01011314","Total",674,186,30,156,186,103,117,22,95
"2011","Leeds 091C","E01011319","Total",624,209,35,174,198,93,155,33,122
"2011","Leeds 091D","E01011320","Total",679,216,34,182,219,77,159,31,128
"2011","Leeds 091E","E01011322","Total",673,247,31,216,198,83,161,32,129
"2011","Leeds 092A","E01011471","Total",636,283,66,217,193,79,213,47,166
"2011","Leeds 092B","E01011472","Total",700,372,73,299,214,88,246,42,204
"2011","Leeds 092C","E01011473","Total",632,302,108,194,258,114,190,55,135
"2011","Leeds 092D","E01011474","Total",641,289,70,219,215,87,204,41,163
"2011","Leeds 093A","E01011518","Total",957,213,22,191,293,138,201,36,165
"2011","Leeds 093B","E01011524","Total",540,147,7,140,147,47,116,25,91
"2011","Leeds 093C","E01011526","Total",489,75,5,70,200,70,88,24,64
"2011","Leeds 093D","E01011531","Total",676,295,6,289,124,39,210,22,188
"2011","Leeds 094A","E01011466","Total",654,259,42,217,179,66,199,32,167
"2011","Leeds 094B","E01011469","Total",641,202,26,176,169,80,141,16,125
"2011","Leeds 094C","E01011475","Total",690,261,79,182,230,105,204,48,156
"2011","Leeds 094D","E01011476","Total",497,195,50,145,181,83,157,33,124
"2011","Leeds 095A","E01011519","Total",648,244,36,208,205,90,175,31,144
"2011","Leeds 095B","E01011522","Total",589,169,4,165,161,56,117,15,102
"2011","Leeds 095C","E01011525","Total",702,185,17,168,191,101,125,18,107
"2011","Leeds 095D","E01011528","Total",622,113,8,105,245,81,108,28,80
"2011","Leeds 095E","E01011532","Total",710,270,29,241,210,79,221,22,199
"2011","Leeds 096A","E01011520","Total",654,221,8,213,172,74,143,16,127
"2011","Leeds 096B","E01011521","Total",908,276,19,257,230,92,186,35,151
"2011","Leeds 096C","E01011523","Total",771,279,25,254,217,101,226,31,195
"2011","Leeds 096D","E01011527","Total",772,233,13,220,200,70,159,24,135
"2011","Leeds 096E","E01011529","Total",580,190,33,157,205,101,149,33,116
"2011","Leeds 097B","E01011635","Total",705,224,15,209,183,66,169,25,144
"2011","Leeds 097C","E01011637","Total",735,164,21,143,255,117,141,26,115
"2011","Leeds 097D","E01011638","Total",617,205,10,195,185,65,158,25,133
"2011","Leeds 097F","E01032487","Total",448,210,28,182,127,47,172,33,139
"2011","Leeds 097G","E01032488","Total",735,212,13,199,230,93,175,29,146
"2011","Leeds 098A","E01011627","Total",592,235,31,204,182,69,175,35,140
"2011","Leeds 098B","E01011628","Total",597,232,5,227,133,47,169,19,150
"2011","Leeds 098C","E01011629","Total",605,216,19,197,153,55,151,19,132
"2011","Leeds 098D","E01011632","Total",605,268,49,219,189,87,214,45,169
"2011","Leeds 098E","E01011633","Total",622,192,10,182,162,62,153,22,131
"2011","Leeds 099A","E01011490","Total",1178,242,40,202,332,183,189,33,156
"2011","Leeds 099C","E01011502","Total",595,225,35,190,187,71,189,39,150
"2011","Leeds 099E","E01032497","Total",640,243,84,159,237,121,165,44,121
"2011","Leeds 099F","E01032498","Total",697,291,24,267,160,52,188,19,169
"2011","Leeds 100A","E01011496","Total",606,78,9,69,235,97,83,25,58
"2011","Leeds 100B","E01011630","Total",886,184,18,166,289,140,154,37,117
"2011","Leeds 100C","E01011634","Total",664,267,29,238,176,73,198,24,174
"2011","Leeds 100D","E01011636","Total",722,280,9,271,177,62,202,21,181
"2011","Leeds 100E","E01011639","Total",645,265,38,227,203,73,217,37,180
"2011","Leeds 101A","E01011491","Total",608,256,53,203,218,99,187,38,149
"2011","Leeds 101B","E01011492","Total",553,290,86,204,214,83,212,59,153
"2011","Leeds 101C","E01011493","Total",644,271,65,206,243,98,188,47,141
"2011","Leeds 101D","E01011494","Total",541,192,54,138,214,94,162,37,125
"2011","Leeds 101E","E01011497","Total",671,312,94,218,257,138,222,36,186
"2011","Leeds 102B","E01011540","Total",641,269,38,231,203,89,213,35,178
"2011","Leeds 102F","E01032489","Total",894,203,25,178,219,102,180,29,151
"2011","Leeds 102G","E01032490","Total",570,89,9,80,206,90,88,17,71
"2011","Leeds 102H","E01032491","Total",489,77,7,70,181,63,81,28,53
"2011","Leeds 102I","E01032492","Total",997,328,65,263,257,123,229,27,202
"2011","Leeds 103A","E01011307","Total",610,210,36,174,192,77,171,29,142
"2011","Leeds 103B","E01011308","Total",655,261,19,242,197,75,182,21,161
"2011","Leeds 103C","E01011393","Total",693,223,14,209,252,94,198,34,164
"2011","Leeds 103D","E01011394","Total",497,162,6,156,152,62,131,23,108
"2011","Leeds 103E","E01011395","Total",464,92,21,71,198,77,95,27,68
"2011","Leeds 104A","E01011533","Total",687,233,21,212,129,63,184,14,170
"2011","Leeds 104B","E01011541","Total",1010,432,19,413,134,57,317,22,295
"2011","Leeds 104C","E01011545","Total",651,176,23,153,171,77,162,27,135
"2011","Leeds 104D","E01011547","Total",834,272,25,247,225,94,251,34,217
"2011","Leeds 105C","E01011499","Total",1053,179,45,134,392,212,190,58,132
"2011","Leeds 105D","E01011500","Total",689,238,18,220,181,54,195,27,168
"2011","Leeds 105E","E01032495","Total",922,172,60,112,406,198,168,62,106
"2011","Leeds 105F","E01032496","Total",878,202,16,186,295,126,175,23,152
"2011","Leeds 106A","E01011530","Total",651,181,5,176,163,70,138,19,119
"2011","Leeds 106B","E01011534","Total",684,209,21,188,173,78,160,23,137
"2011","Leeds 106C","E01011546","Total",743,195,30,165,221,103,147,27,120
"2011","Leeds 106D","E01011548","Total",639,214,16,198,176,46,166,25,141
"2011","Leeds 106E","E01011550","Total",552,134,6,128,202,64,104,21,83
"2011","Leeds 107A","E01011537","Total",947,366,20,346,207,76,273,31,242
"2011","Leeds 107B","E01011538","Total",662,243,30,213,196,83,200,25,175
"2011","Leeds 107C","E01011551","Total",647,109,23,86,238,90,109,26,83
"2011","Leeds 107D","E01011552","Total",575,205,34,171,219,86,180,49,131
"2011","Leeds 108A","E01011535","Total",658,198,11,187,224,64,129,22,107
"2011","Leeds 108B","E01011536","Total",660,200,14,186,203,74,172,24,148
"2011","Leeds 108C","E01011549","Total",512,47,5,42,242,65,70,21,49
"2011","Leeds 108D","E01011553","Total",615,163,13,150,193,72,121,29,92
"2011","Leeds 109A","E01011685","Total",777,181,6,175,155,67,112,11,101
"2011","Leeds 109B","E01011687","Total",574,152,10,142,169,69,129,22,107
"2011","Leeds 109C","E01011690","Total",661,239,2,237,90,35,161,9,152
"2011","Leeds 109D","E01011692","Total",666,136,6,130,129,47,119,12,107
"2011","Leeds 109E","E01011693","Total",725,149,17,132,83,40,99,6,93
"2011","Leeds 109F","E01011694","Total",615,142,8,134,134,67,89,13,76
"2011","Leeds 109G","E01032876","Total",533,155,5,150,126,46,85,14,71
"2011","Leeds 110A","E01011442","Total",543,148,7,141,37,13,73,4,69
"2011","Leeds 110B","E01011443","Total",479,162,6,156,27,16,66,3,63
"2011","Leeds 110C","E01011444","Total",586,235,18,217,35,20,86,9,77
"2011","Leeds 110D","E01011451","Total",466,138,4,134,49,27,81,4,77
"2011","Leeds 110E","E01011668","Total",517,165,19,146,56,28,89,9,80
"2011","Leeds 110F","E01011669","Total",518,153,22,131,85,53,66,12,54
"2011","Leeds 110G","E01032946","Total",778,272,8,264,64,27,160,10,150
"2011","Leeds 111A","E01033008","Total",704,148,3,145,26,22,25,1,24
"2011","Leeds 111B","E01033010","Total",690,209,2,207,18,17,54,0,54
"2011","Leeds 111C","E01033011","Total",761,99,2,97,15,7,43,0,43
"2011","Leeds 111D","E01033015","Total",705,79,2,77,29,27,28,2,26
"2011","Leeds 111E","E01033016","Total",709,82,0,82,20,17,41,0,41
"2011","Leeds 112A","E01011467","Total",647,210,50,160,189,100,177,22,155
"2011","Leeds 112B","E01011468","Total",743,375,61,314,194,81,266,41,225
"2011","Leeds 112C","E01011470","Total",607,235,38,197,151,69,179,27,152
"2011","Leeds 112D","E01033018","Total",729,71,7,64,28,24,22,3,19
"2011","Leeds 112E","E01033019","Total",766,76,6,70,29,23,32,4,28
"2011","Wakefield 001A","E01011740","Total",660,298,66,232,231,109,223,44,179
"2011","Wakefield 001B","E01011741","Total",636,248,22,226,169,49,181,20,161
"2011","Wakefield 001C","E01011742","Total",716,338,49,289,216,76,274,46,228
"2011","Wakefield 001D","E01011745","Total",697,337,112,225,276,143,240,70,170
"2011","Wakefield 001E","E01011746","Total",564,263,89,174,205,91,199,51,148
"2011","Wakefield 002A","E01011752","Total",722,220,19,201,197,88,202,32,170
"2011","Wakefield 002B","E01011753","Total",627,221,15,206,156,62,204,27,177
"2011","Wakefield 002C","E01011756","Total",758,400,23,377,123,47,303,18,285
"2011","Wakefield 002D","E01011760","Total",795,223,26,197,197,98,215,29,186
"2011","Wakefield 002E","E01011762","Total",737,220,22,198,191,82,193,22,171
"2011","Wakefield 003A","E01011743","Total",597,207,6,201,149,41,147,16,131
"2011","Wakefield 003B","E01011744","Total",669,212,8,204,202,68,179,38,141
"2011","Wakefield 003C","E01011747","Total",726,325,64,261,256,119,243,51,192
"2011","Wakefield 003D","E01011750","Total",603,304,87,217,219,89,236,56,180
"2011","Wakefield 003E","E01011754","Total",630,281,40,241,168,67,231,33,198
"2011","Wakefield 004A","E01011757","Total",744,244,34,210,267,107,193,27,166
"2011","Wakefield 004B","E01011759","Total",831,328,47,281,234,91,292,40,252
"2011","Wakefield 004C","E01011761","Total",792,250,23,227,202,88,209,39,170
"2011","Wakefield 004D","E01011763","Total",744,356,37,319,165,70,263,33,230
"2011","Wakefield 004E","E01011764","Total",714,305,41,264,186,91,245,35,210
"2011","Wakefield 005A","E01011748","Total",656,199,16,183,202,60,181,30,151
"2011","Wakefield 005B","E01011749","Total",969,258,50,208,279,135,217,37,180
"2011","Wakefield 005C","E01011751","Total",517,118,10,108,164,45,117,27,90
"2011","Wakefield 005D","E01011755","Total",677,173,10,163,189,78,150,33,117
"2011","Wakefield 006A","E01011873","Total",679,133,8,125,214,101,145,28,117
"2011","Wakefield 006B","E01011877","Total",544,136,6,130,184,63,115,14,101
"2011","Wakefield 006C","E01011894","Total",543,122,9,113,194,53,114,24,90
"2011","Wakefield 006D","E01011895","Total",587,144,19,125,204,65,152,47,105
"2011","Wakefield 007A","E01011875","Total",676,261,27,234,181,84,234,27,207
"2011","Wakefield 007B","E01011876","Total",653,247,27,220,169,63,204,22,182
"2011","Wakefield 007C","E01011878","Total",668,175,20,155,193,69,165,31,134
"2011","Wakefield 007D","E01011880","Total",660,169,13,156,185,78,143,26,117
"2011","Wakefield 008A","E01011881","Total",660,243,21,222,169,67,184,30,154
"2011","Wakefield 008B","E01011887","Total",498,146,5,141,151,43,106,16,90
"2011","Wakefield 008C","E01011893","Total",574,150,4,146,175,44,132,27,105
"2011","Wakefield 008D","E01011896","Total",627,247,16,231,163,56,196,32,164
"2011","Wakefield 008E","E01011897","Total",698,339,37,302,159,59,263,40,223
"2011","Wakefield 009A","E01011874","Total",665,215,8,207,191,68,171,28,143
"2011","Wakefield 009B","E01011879","Total",637,170,10,160,191,71,163,31,132
"2011","Wakefield 009C","E01011882","Total",641,270,9,261,160,44,181,17,164
"2011","Wakefield 009D","E01011883","Total",642,256,10,246,173,46,200,23,177
"2011","Wakefield 010A","E01011805","Total",707,323,21,302,142,52,251,20,231
"2011","Wakefield 010B","E01011807","Total",662,252,30,222,179,80,225,30,195
"2011","Wakefield 010C","E01011808","Total",770,283,29,254,184,86,225,24,201
"2011","Wakefield 010D","E01011810","Total",582,160,26,134,202,76,144,36,108
"2011","Wakefield 011A","E01011803","Total",583,240,59,181,203,96,172,36,136
"2011","Wakefield 011B","E01011804","Total",708,246,29,217,208,92,211,35,176
"2011","Wakefield 011C","E01011806","Total",664,217,28,189,180,58,177,31,146
"2011","Wakefield 011D","E01011809","Total",736,343,20,323,150,47,266,31,235
"2011","Wakefield 011E","E01011811","Total",661,293,90,203,231,103,223,54,169
"2011","Wakefield 012A","E01011835","Total",640,213,13,200,150,46,176,25,151
"2011","Wakefield 012B","E01011836","Total",576,123,28,95,201,70,110,30,80
"2011","Wakefield 012C","E01011839","Total",642,232,42,190,226,97,182,45,137
"2011","Wakefield 012D","E01011843","Total",643,222,49,173,251,110,168,45,123
"2011","Wakefield 012E","E01011844","Total",729,115,8,107,319,136,126,36,90
"2011","Wakefield 013A","E01011758","Total",614,214,30,184,171,68,190,33,157
"2011","Wakefield 013B","E01011812","Total",1010,195,14,181,375,132,201,43,158
"2011","Wakefield 013C","E01011820","Total",636,176,13,163,207,79,180,26,154
"2011","Wakefield 013D","E01011821","Total",599,258,19,239,159,47,195,29,166
"2011","Wakefield 014A","E01011885","Total",597,219,7,212,155,40,153,23,130
"2011","Wakefield 014B","E01011886","Total",649,212,12,200,171,49,171,32,139
"2011","Wakefield 014C","E01011888","Total",598,201,5,196,145,44,144,15,129
"2011","Wakefield 014D","E01011890","Total",489,127,7,120,173,37,114,24,90
"2011","Wakefield 014E","E01011891","Total",716,285,14,271,161,52,244,25,219
"2011","Wakefield 015A","E01011834","Total",613,175,44,131,247,110,161,50,111
"2011","Wakefield 015B","E01011837","Total",613,243,28,215,164,58,184,39,145
"2011","Wakefield 015C","E01011838","Total",1102,460,42,418,181,93,345,29,316
"2011","Wakefield 015D","E01011841","Total",706,275,14,261,167,55,206,20,186
"2011","Wakefield 015E","E01011842","Total",689,372,61,311,195,102,270,44,226
"2011","Wakefield 016A","E01011813","Total",700,308,53,255,236,101,253,49,204
"2011","Wakefield 016B","E01011814","Total",803,304,40,264,226,97,263,45,218
"2011","Wakefield 016C","E01011815","Total",685,286,39,247,172,63,238,34,204
"2011","Wakefield 016D","E01011816","Total",630,299,47,252,176,69,229,37,192
"2011","Wakefield 016E","E01011819","Total",717,188,16,172,182,73,194,27,167
"2011","Wakefield 016F","E01011822","Total",636,213,42,171,192,81,156,30,126
"2011","Wakefield 017A","E01011884","Total",961,179,19,160,296,120,186,39,147
"2011","Wakefield 017B","E01011912","Total",687,289,14,275,137,71,220,22,198
"2011","Wakefield 017C","E01011913","Total",546,175,32,143,208,95,157,45,112
"2011","Wakefield 017D","E01011916","Total",1205,531,15,516,106,49,423,13,410
"2011","Wakefield 018A","E01011840","Total",685,279,36,243,188,78,238,30,208
"2011","Wakefield 018B","E01011850","Total",628,284,66,218,222,89,211,44,167
"2011","Wakefield 018C","E01011852","Total",651,276,82,194,264,117,206,54,152
"2011","Wakefield 018D","E01011853","Total",588,261,38,223,187,74,221,40,181
"2011","Wakefield 019A","E01011920","Total",702,174,19,155,169,87,130,25,105
"2011","Wakefield 019B","E01011923","Total",714,187,16,171,190,63,143,26,117
"2011","Wakefield 019C","E01011924","Total",655,192,22,170,173,69,161,32,129
"2011","Wakefield 019D","E01011925","Total",667,256,70,186,275,129,186,54,132
"2011","Wakefield 020A","E01011909","Total",595,237,25,212,152,49,187,33,154
"2011","Wakefield 020B","E01011910","Total",730,382,41,341,150,65,289,25,264
"2011","Wakefield 020C","E01011911","Total",629,275,80,195,236,102,210,52,158
"2011","Wakefield 020D","E01011914","Total",667,281,50,231,219,91,199,40,159
"2011","Wakefield 020E","E01011915","Total",631,169,45,124,235,113,149,54,95
"2011","Wakefield 021A","E01011823","Total",619,194,10,184,149,63,173,23,150
"2011","Wakefield 021B","E01011824","Total",620,222,45,177,240,113,184,38,146
"2011","Wakefield 021C","E01011825","Total",771,179,21,158,281,119,175,31,144
"2011","Wakefield 021D","E01011826","Total",590,193,13,180,182,52,137,17,120
"2011","Wakefield 021E","E01011827","Total",526,206,10,196,118,37,156,21,135
"2011","Wakefield 021F","E01011828","Total",631,179,23,156,189,78,134,23,111
"2011","Wakefield 022A","E01011889","Total",502,92,4,88,208,62,98,24,74
"2011","Wakefield 022B","E01011892","Total",779,269,25,244,259,93,234,44,190
"2011","Wakefield 022C","E01011919","Total",832,252,39,213,234,112,229,45,184
"2011","Wakefield 022D","E01011921","Total",608,209,22,187,182,64,158,28,130
"2011","Wakefield 022E","E01011926","Total",645,217,52,165,222,122,164,30,134
"2011","Wakefield 022F","E01011927","Total",568,212,36,176,179,74,177,31,146
"2011","Wakefield 023A","E01011845","Total",626,298,3,295,115,23,187,14,173
"2011","Wakefield 023B","E01011846","Total",594,193,15,178,159,44,148,20,128
"2011","Wakefield 023C","E01011847","Total",615,210,10,200,170,51,142,16,126
"2011","Wakefield 023D","E01011848","Total",624,281,16,265,159,43,160,25,135
"2011","Wakefield 023E","E01011851","Total",690,301,21,280,151,53,262,25,237
"2011","Wakefield 024A","E01011775","Total",1131,240,31,209,429,177,225,49,176
"2011","Wakefield 024B","E01011776","Total",619,231,37,194,223,91,208,46,162
"2011","Wakefield 024C","E01011777","Total",622,236,18,218,145,43,187,28,159
"2011","Wakefield 024D","E01011778","Total",652,223,36,187,206,84,188,29,159
"2011","Wakefield 024E","E01011817","Total",557,207,40,167,197,66,180,30,150
"2011","Wakefield 024F","E01011818","Total",592,205,21,184,154,56,171,23,148
"2011","Wakefield 025A","E01011829","Total",613,154,9,145,189,69,135,19,116
"2011","Wakefield 025B","E01011830","Total",660,333,5,328,116,38,254,24,230
"2011","Wakefield 025C","E01011831","Total",776,245,28,217,216,77,193,36,157
"2011","Wakefield 025D","E01011832","Total",621,233,31,202,173,59,202,28,174
"2011","Wakefield 025E","E01011833","Total",667,207,12,195,182,61,170,22,148
"2011","Wakefield 026A","E01011899","Total",542,212,89,123,252,105,169,57,112
"2011","Wakefield 026B","E01011900","Total",752,348,36,312,173,76,285,31,254
"2011","Wakefield 026C","E01011901","Total",584,255,110,145,293,128,173,65,108
"2011","Wakefield 026D","E01011904","Total",500,224,90,134,238,106,136,50,86
"2011","Wakefield 026E","E01011918","Total",634,265,70,195,229,95,173,40,133
"2011","Wakefield 026F","E01011922","Total",639,296,47,249,197,79,216,35,181
"2011","Wakefield 027A","E01011779","Total",598,240,39,201,201,75,186,33,153
"2011","Wakefield 027B","E01011780","Total",870,497,76,421,237,93,386,59,327
"2011","Wakefield 027C","E01011781","Total",804,324,53,271,241,114,270,47,223
"2011","Wakefield 027D","E01011782","Total",640,249,21,228,185,55,205,31,174
"2011","Wakefield 027E","E01011783","Total",594,216,41,175,157,55,176,24,152
"2011","Wakefield 028A","E01011902","Total",674,275,16,259,131,53,216,18,198
"2011","Wakefield 028B","E01011903","Total",617,286,9,277,104,32,203,19,184
"2011","Wakefield 028C","E01011905","Total",684,249,2,247,189,56,190,34,156
"2011","Wakefield 028D","E01011907","Total",875,340,22,318,166,79,268,31,237
"2011","Wakefield 029A","E01011793","Total",729,285,12,273,167,64,205,25,180
"2011","Wakefield 029B","E01011794","Total",613,224,28,196,186,57,162,31,131
"2011","Wakefield 029C","E01011795","Total",595,222,14,208,148,57,173,16,157
"2011","Wakefield 029D","E01011796","Total",582,158,15,143,187,61,138,32,106
"2011","Wakefield 029E","E01011799","Total",775,371,26,345,192,78,300,35,265
"2011","Wakefield 029F","E01011800","Total",718,194,9,185,211,78,155,26,129
"2011","Wakefield 030A","E01011898","Total",717,177,32,145,166,77,151,24,127
"2011","Wakefield 030B","E01011906","Total",672,319,85,234,267,129,224,54,170
"2011","Wakefield 030C","E01011908","Total",934,292,42,250,280,133,211,32,179
"2011","Wakefield 030D","E01011917","Total",699,271,51,220,184,96,212,39,173
"2011","Wakefield 030E","E01011944","Total",589,148,41,107,198,99,117,31,86
"2011","Wakefield 031A","E01011797","Total",706,205,4,201,229,75,150,20,130
"2011","Wakefield 031B","E01011798","Total",662,220,11,209,133,48,159,17,142
"2011","Wakefield 031C","E01011801","Total",645,185,26,159,210,86,184,44,140
"2011","Wakefield 031D","E01011802","Total",647,216,12,204,152,61,177,19,158
"2011","Wakefield 032A","E01011765","Total",640,200,17,183,191,71,190,35,155
"2011","Wakefield 032B","E01011766","Total",584,163,25,138,231,70,143,36,107
"2011","Wakefield 032C","E01011773","Total",609,214,5,209,158,34,150,15,135
"2011","Wakefield 032D","E01011774","Total",590,199,16,183,166,62,173,27,146
"2011","Wakefield 033A","E01011939","Total",639,250,7,243,160,54,140,19,121
"2011","Wakefield 033B","E01011945","Total",648,278,13,265,146,51,175,16,159
"2011","Wakefield 033C","E01011947","Total",670,278,6,272,142,39,147,16,131
"2011","Wakefield 033D","E01011948","Total",665,233,2,231,170,44,139,18,121
"2011","Wakefield 034A","E01011767","Total",740,256,8,248,185,53,205,34,171
"2011","Wakefield 034B","E01011768","Total",583,199,14,185,163,44,150,19,131
"2011","Wakefield 034C","E01011769","Total",930,200,20,180,282,123,187,40,147
"2011","Wakefield 034D","E01011770","Total",795,289,18,271,230,87,257,42,215
"2011","Wakefield 034E","E01011849","Total",730,329,8,321,137,38,199,28,171
"2011","Wakefield 034F","E01011857","Total",721,274,12,262,171,55,167,16,151
"2011","Wakefield 035A","E01011928","Total",625,259,21,238,138,44,201,24,177
"2011","Wakefield 035B","E01011931","Total",637,207,18,189,179,75,163,24,139
"2011","Wakefield 035C","E01011932","Total",607,170,12,158,169,54,101,13,88
"2011","Wakefield 035D","E01011938","Total",570,155,6,149,173,51,134,22,112
"2011","Wakefield 036A","E01011929","Total",746,254,11,243,145,51,197,18,179
"2011","Wakefield 036B","E01011930","Total",713,179,15,164,217,92,154,25,129
"2011","Wakefield 036C","E01011933","Total",657,184,29,155,209,90,163,43,120
"2011","Wakefield 036D","E01011937","Total",606,192,8,184,159,52,130,16,114
"2011","Wakefield 037A","E01011934","Total",621,178,6,172,152,49,133,14,119
"2011","Wakefield 037B","E01011936","Total",659,277,34,243,196,63,231,31,200
"2011","Wakefield 037C","E01011940","Total",614,219,38,181,201,71,178,35,143
"2011","Wakefield 037D","E01011943","Total",806,332,48,284,236,93,266,39,227
"2011","Wakefield 038A","E01011935","Total",756,156,11,145,238,106,139,29,110
"2011","Wakefield 038B","E01011941","Total",646,284,13,271,161,54,190,18,172
"2011","Wakefield 038C","E01011942","Total",554,224,8,216,119,42,133,17,116
"2011","Wakefield 038D","E01011946","Total",617,191,10,181,161,49,147,22,125
"2011","Wakefield 039A","E01011785","Total",608,212,49,163,226,90,183,48,135
"2011","Wakefield 039B","E01011789","Total",510,247,37,210,148,55,204,38,166
"2011","Wakefield 039C","E01011791","Total",626,285,53,232,193,76,236,44,192
"2011","Wakefield 039D","E01011792","Total",631,366,100,266,215,96,245,58,187
"2011","Wakefield 040A","E01011771","Total",615,338,28,310,134,45,249,32,217
"2011","Wakefield 040B","E01011772","Total",692,230,37,193,186,85,186,30,156
"2011","Wakefield 040C","E01011784","Total",772,321,50,271,228,91,246,40,206
"2011","Wakefield 040D","E01011786","Total",620,196,51,145,229,102,168,44,124
"2011","Wakefield 041A","E01011854","Total",513,182,34,148,178,83,175,34,141
"2011","Wakefield 041B","E01011855","Total",686,244,26,218,209,72,217,41,176
"2011","Wakefield 041C","E01011856","Total",622,258,35,223,169,69,210,37,173
"2011","Wakefield 041D","E01011858","Total",638,213,23,190,234,76,199,46,153
"2011","Wakefield 042A","E01011787","Total",765,278,22,256,203,73,220,37,183
"2011","Wakefield 042B","E01011788","Total",729,274,7,267,172,51,214,34,180
"2011","Wakefield 042C","E01011790","Total",761,348,39,309,211,94,274,42,232
"2011","Wakefield 042D","E01011865","Total",754,371,45,326,209,83,292,42,250
"2011","Wakefield 042E","E01011867","Total",684,266,32,234,225,84,233,52,181
"2011","Wakefield 043A","E01011859","Total",688,371,43,328,174,61,278,44,234
"2011","Wakefield 043B","E01011869","Total",683,263,45,218,195,90,222,40,182
"2011","Wakefield 043C","E01011870","Total",641,275,8,267,127,41,223,17,206
"2011","Wakefield 043D","E01011871","Total",661,210,29,181,202,82,209,38,171
"2011","Wakefield 044A","E01011860","Total",642,231,22,209,179,57,195,32,163
"2011","Wakefield 044B","E01011861","Total",815,244,33,211,296,105,207,42,165
"2011","Wakefield 044C","E01011862","Total",606,237,40,197,205,71,206,43,163
"2011","Wakefield 044D","E01011863","Total",609,323,54,269,167,65,259,37,222
"2011","Wakefield 045A","E01011864","Total",662,317,65,252,229,89,247,39,208
"2011","Wakefield 045B","E01011866","Total",641,270,44,226,206,81,222,53,169
"2011","Wakefield 045C","E01011868","Total",814,342,53,289,261,98,257,41,216
"2011","Wakefield 045D","E01011872","Total",629,246,51,195,226,87,198,42,156
"2011","Derby 001A","E01013461","Total",711,255,5,250,170,54,175,17,158
"2011","Derby 001B","E01013462","Total",633,229,12,217,199,88,170,28,142
"2011","Derby 001C","E01013463","Total",607,178,5,173,211,61,123,19,104
"2011","Derby 001D","E01013464","Total",634,287,6,281,155,47,185,25,160
"2011","Derby 002A","E01013465","Total",694,293,7,286,204,71,156,17,139
"2011","Derby 002B","E01013466","Total",648,249,3,246,183,58,159,23,136
"2011","Derby 002C","E01013467","Total",609,255,7,248,159,48,139,17,122
"2011","Derby 002D","E01013468","Total",698,326,9,317,168,48,172,10,162
"2011","Derby 002E","E01013469","Total",722,410,3,407,69,15,235,6,229
"2011","Derby 003A","E01013574","Total",536,129,3,126,174,49,97,17,80
"2011","Derby 003B","E01013575","Total",602,122,2,120,166,66,111,22,89
"2011","Derby 003C","E01013576","Total",566,88,8,80,201,69,104,24,80
"2011","Derby 003D","E01013577","Total",596,81,9,72,237,82,109,32,77
"2011","Derby 003E","E01013578","Total",555,71,5,66,207,84,76,23,53
"2011","Derby 003F","E01013579","Total",631,150,11,139,188,78,128,24,104
"2011","Derby 003G","E01013580","Total",701,127,10,117,172,89,119,18,101
"2011","Derby 004A","E01013530","Total",622,156,25,131,225,117,124,23,101
"2011","Derby 004B","E01013531","Total",601,226,37,189,183,76,182,36,146
"2011","Derby 004C","E01013532","Total",618,253,52,201,202,97,196,36,160
"2011","Derby 004D","E01013581","Total",610,218,62,156,264,127,171,55,116
"2011","Derby 005A","E01013526","Total",735,246,5,241,195,72,192,26,166
"2011","Derby 005B","E01013527","Total",638,202,8,194,173,66,131,14,117
"2011","Derby 005C","E01013528","Total",731,259,12,247,177,79,205,20,185
"2011","Derby 005D","E01013529","Total",1032,331,25,306,261,134,232,31,201
"2011","Derby 006A","E01013505","Total",608,158,16,142,201,76,158,37,121
"2011","Derby 006B","E01013506","Total",696,324,24,300,167,61,248,37,211
"2011","Derby 006C","E01013513","Total",500,195,35,160,175,60,151,34,117
"2011","Derby 006D","E01013534","Total",662,210,21,189,231,98,194,37,157
"2011","Derby 006E","E01013582","Total",694,248,25,223,209,93,197,23,174
"2011","Derby 007A","E01013533","Total",705,358,104,254,268,140,261,58,203
"2011","Derby 007B","E01013535","Total",521,211,104,107,302,136,146,61,85
"2011","Derby 007C","E01013536","Total",680,280,88,192,237,118,215,42,173
"2011","Derby 007D","E01013537","Total",725,295,32,263,197,100,204,22,182
"2011","Derby 007E","E01013538","Total",625,209,40,169,199,94,165,33,132
"2011","Derby 008A","E01013522","Total",918,395,47,348,156,82,283,20,263
"2011","Derby 008B","E01013523","Total",836,319,17,302,107,33,231,12,219
"2011","Derby 008C","E01013524","Total",676,219,14,205,63,25,164,12,152
"2011","Derby 008D","E01013525","Total",1062,264,32,232,182,109,201,22,179
"2011","Derby 009A","E01013548","Total",639,271,34,237,183,61,226,35,191
"2011","Derby 009B","E01013549","Total",622,256,36,220,192,88,205,28,177
"2011","Derby 009C","E01013552","Total",738,349,56,293,228,103,290,55,235
"2011","Derby 009D","E01013553","Total",646,260,42,218,187,74,210,46,164
"2011","Derby 009E","E01013555","Total",598,197,28,169,214,75,190,36,154
"2011","Derby 010A","E01013592","Total",635,205,12,193,154,57,131,16,115
"2011","Derby 010B","E01013594","Total",630,299,8,291,117,34,170,19,151
"2011","Derby 010C","E01013596","Total",692,270,6,264,170,61,191,25,166
"2011","Derby 010D","E01013599","Total",618,245,7,238,134,44,164,20,144
"2011","Derby 011A","E01013547","Total",809,237,37,200,141,74,157,24,133
"2011","Derby 011B","E01013550","Total",538,195,43,152,165,71,161,34,127
"2011","Derby 011C","E01013551","Total",687,179,31,148,127,76,126,15,111
"2011","Derby 011D","E01013554","Total",805,252,45,207,168,97,178,25,153
"2011","Derby 012A","E01013507","Total",643,205,21,184,183,66,168,38,130
"2011","Derby 012B","E01013508","Total",488,176,33,143,193,87,144,39,105
"2011","Derby 012C","E01013509","Total",713,220,26,194,221,99,178,31,147
"2011","Derby 012D","E01013510","Total",624,228,42,186,216,92,192,38,154
"2011","Derby 012E","E01013511","Total",637,212,5,207,173,56,174,29,145
"2011","Derby 012F","E01013512","Total",632,235,50,185,207,78,197,47,150
"2011","Derby 013A","E01013453","Total",1121,335,52,283,196,113,242,32,210
"2011","Derby 013B","E01013454","Total",543,204,42,162,170,79,143,27,116
"2011","Derby 013C","E01013456","Total",1053,468,75,393,219,136,355,42,313
"2011","Derby 013D","E01013457","Total",822,239,50,189,218,134,191,33,158
"2011","Derby 013E","E01013460","Total",909,222,43,179,162,90,150,29,121
"2011","Derby 013F","E01013479","Total",1142,440,32,408,126,75,277,21,256
"2011","Derby 014A","E01013593","Total",591,210,2,208,142,38,143,19,124
"2011","Derby 014B","E01013595","Total",957,298,47,251,308,158,251,50,201
"2011","Derby 014C","E01013597","Total",650,288,32,256,163,64,234,34,200
"2011","Derby 014D","E01013598","Total",632,229,26,203,212,80,189,42,147
"2011","Derby 015A","E01013556","Total",611,184,10,174,182,66,128,16,112
"2011","Derby 015B","E01013557","Total",605,283,3,280,123,34,172,21,151
"2011","Derby 015C","E01013558","Total",853,319,44,275,261,105,198,36,162
"2011","Derby 015D","E01013559","Total",579,186,9,177,151,55,121,14,107
"2011","Derby 015E","E01013564","Total",809,233,8,225,237,96,180,34,146
"2011","Derby 016A","E01013480","Total",1085,516,37,479,152,75,378,21,357
"2011","Derby 016B","E01013483","Total",699,204,56,148,288,140,182,72,110
"2011","Derby 016C","E01013485","Total",639,179,65,114,313,186,174,64,110
"2011","Derby 016D","E01013565","Total",541,165,54,111,264,149,133,58,75
"2011","Derby 016E","E01013566","Total",720,310,66,244,277,159,233,65,168
"2011","Derby 017A","E01013455","Total",812,268,32,236,228,91,228,49,179
"2011","Derby 017B","E01013458","Total",569,198,14,184,150,61,151,36,115
"2011","Derby 017C","E01013542","Total",696,236,18,218,203,75,188,35,153
"2011","Derby 017D","E01013546","Total",645,211,9,202,210,86,154,19,135
"2011","Derby 018A","E01013481","Total",585,227,74,153,267,134,176,66,110
"2011","Derby 018C","E01013484","Total",695,325,103,222,306,167,220,73,147
"2011","Derby 018D","E01013486","Total",573,184,66,118,292,152,143,55,88
"2011","Derby 018E","E01013487","Total",761,295,111,184,357,212,207,71,136
"2011","Derby 018F","E01033166","Total",584,272,24,248,95,57,171,12,159
"2011","Derby 018G","E01033167","Total",621,329,39,290,106,50,240,19,221
"2011","Derby 019A","E01013540","Total",645,218,5,213,190,50,170,16,154
"2011","Derby 019B","E01013560","Total",595,170,5,165,189,47,126,28,98
"2011","Derby 019C","E01013561","Total",687,276,4,272,154,59,171,11,160
"2011","Derby 019D","E01013562","Total",719,361,7,354,107,37,250,12,238
"2011","Derby 019E","E01013563","Total",627,185,7,178,144,46,131,18,113
"2011","Derby 020A","E01013459","Total",595,160,34,126,282,129,162,64,98
"2011","Derby 020B","E01013567","Total",633,209,75,134,306,171,181,67,114
"2011","Derby 020C","E01013568","Total",751,269,78,191,311,150,212,62,150
"2011","Derby 020D","E01013569","Total",541,204,52,152,222,122,150,36,114
"2011","Derby 021A","E01013539","Total",718,66,12,54,435,139,118,60,58
"2011","Derby 021B","E01013541","Total",651,137,47,90,298,121,127,46,81
"2011","Derby 021C","E01013543","Total",624,136,11,125,270,88,143,43,100
"2011","Derby 021D","E01013544","Total",670,156,6,150,254,66,110,20,90
"2011","Derby 021E","E01013545","Total",714,281,30,251,214,75,212,34,178
"2011","Derby 022A","E01013488","Total",572,193,7,186,185,67,141,33,108
"2011","Derby 022B","E01013489","Total",618,241,9,232,159,53,184,32,152
"2011","Derby 022C","E01013490","Total",587,194,12,182,186,54,171,36,135
"2011","Derby 022D","E01013491","Total",600,185,17,168,217,87,174,45,129
"2011","Derby 023A","E01013570","Total",681,254,88,166,297,147,216,75,141
"2011","Derby 023B","E01013571","Total",670,242,80,162,284,142,188,68,120
"2011","Derby 023C","E01013572","Total",688,278,20,258,190,94,228,28,200
"2011","Derby 023D","E01013573","Total",813,301,103,198,356,159,232,71,161
"2011","Derby 024A","E01013470","Total",625,237,24,213,162,74,201,32,169
"2011","Derby 024B","E01013474","Total",719,273,19,254,172,74,232,31,201
"2011","Derby 024C","E01013476","Total",723,194,18,176,146,73,162,21,141
"2011","Derby 024E","E01033171","Total",655,192,34,158,158,92,166,30,136
"2011","Derby 024F","E01033172","Total",730,189,50,139,178,114,147,33,114
"2011","Derby 025A","E01013471","Total",806,244,70,174,268,147,201,45,156
"2011","Derby 025B","E01013473","Total",670,266,46,220,212,94,211,47,164
"2011","Derby 025C","E01013475","Total",573,202,80,122,263,124,169,66,103
"2011","Derby 025D","E01013477","Total",765,249,40,209,213,100,205,43,162
"2011","Derby 025E","E01013502","Total",614,252,35,217,208,75,223,41,182
"2011","Derby 025F","E01013503","Total",615,201,34,167,212,77,145,32,113
"2011","Derby 026A","E01013472","Total",965,456,108,348,313,162,306,55,251
"2011","Derby 026B","E01013497","Total",617,229,60,169,237,89,196,51,145
"2011","Derby 026C","E01013504","Total",714,232,75,157,294,134,154,55,99
"2011","Derby 026D","E01013583","Total",582,231,82,149,263,130,178,47,131
"2011","Derby 026E","E01013590","Total",643,270,109,161,294,139,215,80,135
"2011","Derby 026F","E01013591","Total",819,321,131,190,342,171,236,79,157
"2011","Derby 027A","E01013492","Total",594,215,16,199,190,57,149,21,128
"2011","Derby 027B","E01013493","Total",647,248,24,224,176,79,219,22,197
"2011","Derby 027C","E01013494","Total",795,310,51,259,265,108,258,47,211
"2011","Derby 027D","E01013495","Total",712,215,22,193,231,99,194,39,155
"2011","Derby 028A","E01013496","Total",661,283,81,202,250,109,209,52,157
"2011","Derby 028B","E01013498","Total",585,200,17,183,181,59,161,34,127
"2011","Derby 028C","E01013499","Total",646,297,31,266,158,56,238,32,206
"2011","Derby 028D","E01013500","Total",724,298,24,274,186,64,218,35,183
"2011","Derby 028E","E01013501","Total",620,259,8,251,142,41,215,32,183
"2011","Derby 029A","E01013584","Total",635,255,105,150,330,150,183,78,105
"2011","Derby 029B","E01013585","Total",660,243,57,186,268,124,200,45,155
"2011","Derby 029C","E01013586","Total",618,220,75,145,287,128,172,56,116
"2011","Derby 029D","E01013587","Total",590,170,26,144,195,90,137,27,110
"2011","Derby 029E","E01013588","Total",662,264,38,226,203,90,220,45,175
"2011","Derby 029F","E01013589","Total",551,164,15,149,168,54,161,33,128
"2011","Derby 030B","E01013517","Total",667,307,9,298,121,43,208,18,190
"2011","Derby 030C","E01013518","Total",581,202,12,190,149,48,176,28,148
"2011","Derby 030D","E01013521","Total",691,363,25,338,140,64,284,25,259
"2011","Derby 030E","E01033168","Total",494,108,17,91,212,106,81,18,63
"2011","Derby 030F","E01033169","Total",558,27,9,18,349,155,60,37,23
"2011","Derby 030G","E01033170","Total",566,170,7,163,173,91,109,17,92
"2011","Derby 031A","E01013514","Total",684,206,10,196,210,64,162,21,141
"2011","Derby 031B","E01013515","Total",730,259,25,234,284,87,231,39,192
"2011","Derby 031C","E01013519","Total",587,107,53,54,318,123,120,56,64
"2011","Derby 031D","E01013520","Total",645,191,5,186,195,61,131,14,117
"2011","Leicester 001A","E01013615","Total",543,69,15,54,232,76,91,34,57
"2011","Leicester 001B","E01013616","Total",683,166,45,121,242,105,137,37,100
"2011","Leicester 001C","E01013618","Total",685,208,33,175,197,86,188,31,157
"2011","Leicester 001D","E01013619","Total",639,256,102,154,271,127,200,56,144
"2011","Leicester 002A","E01013733","Total",619,109,25,84,248,116,132,40,92
"2011","Leicester 002B","E01013734","Total",531,177,11,166,153,50,152,31,121
"2011","Leicester 002C","E01013735","Total",469,142,7,135,134,32,148,27,121
"2011","Leicester 002D","E01013736","Total",720,217,19,198,212,94,183,31,152
"2011","Leicester 002E","E01013737","Total",465,103,17,86,176,67,135,33,102
"2011","Leicester 003A","E01013600","Total",755,344,114,230,300,144,256,74,182
"2011","Leicester 003B","E01013601","Total",644,265,60,205,225,103,213,47,166
"2011","Leicester 003C","E01013602","Total",797,316,86,230,266,145,224,55,169
"2011","Leicester 003D","E01013603","Total",798,386,86,300,255,127,280,62,218
"2011","Leicester 003E","E01013604","Total",648,265,70,195,246,110,224,53,171
"2011","Leicester 003F","E01013605","Total",698,224,54,170,245,115,191,55,136
"2011","Leicester 004A","E01013617","Total",936,165,49,116,364,167,196,60,136
"2011","Leicester 004B","E01013620","Total",694,312,134,178,315,182,192,64,128
"2011","Leicester 004C","E01013621","Total",743,332,111,221,305,154,190,54,136
"2011","Leicester 004D","E01013622","Total",729,294,89,205,247,136,175,46,129
"2011","Leicester 004E","E01013623","Total",807,185,38,147,287,134,175,47,128
"2011","Leicester 005A","E01013732","Total",742,204,43,161,302,119,198,64,134
"2011","Leicester 005B","E01013739","Total",570,239,33,206,175,56,193,41,152
"2011","Leicester 005C","E01013740","Total",499,157,22,135,165,58,159,33,126
"2011","Leicester 005D","E01013741","Total",529,115,19,96,227,78,151,43,108
"2011","Leicester 006A","E01013625","Total",668,232,30,202,215,85,220,48,172
"2011","Leicester 006B","E01013628","Total",645,287,41,246,173,68,237,33,204
"2011","Leicester 006C","E01013715","Total",439,151,18,133,147,45,128,32,96
"2011","Leicester 006D","E01013716","Total",560,177,42,135,231,87,175,57,118
"2011","Leicester 006E","E01013738","Total",491,142,14,128,154,69,147,34,113
"2011","Leicester 007A","E01013624","Total",511,176,42,134,205,70,151,46,105
"2011","Leicester 007B","E01013626","Total",574,167,56,111,265,99,179,65,114
"2011","Leicester 007C","E01013627","Total",421,108,8,100,140,34,109,26,83
"2011","Leicester 007D","E01013629","Total",527,151,40,111,226,82,157,49,108
"2011","Leicester 007E","E01013630","Total",576,161,47,114,280,119,182,65,117
"2011","Leicester 008A","E01013606","Total",693,255,27,228,208,83,208,32,176
"2011","Leicester 008B","E01013607","Total",1136,382,50,332,259,133,225,47,178
"2011","Leicester 008C","E01013680","Total",822,199,18,181,268,125,157,33,124
"2011","Leicester 008D","E01013685","Total",616,167,11,156,177,67,155,27,128
"2011","Leicester 008E","E01013686","Total",708,224,17,207,206,72,173,43,130
"2011","Leicester 009A","E01013696","Total",818,212,77,135,393,184,189,76,113
"2011","Leicester 009B","E01013697","Total",921,270,53,217,344,159,223,56,167
"2011","Leicester 009C","E01013699","Total",644,193,19,174,201,73,184,39,145
"2011","Leicester 009E","E01032862","Total",693,128,77,51,362,217,104,50,54
"2011","Leicester 009F","E01032863","Total",612,90,44,46,262,149,70,33,37
"2011","Leicester 009G","E01032865","Total",681,94,42,52,354,167,123,59,64
"2011","Leicester 010A","E01013713","Total",489,154,25,129,188,55,146,40,106
"2011","Leicester 010B","E01013714","Total",503,143,24,119,191,76,154,35,119
"2011","Leicester 010C","E01013717","Total",495,128,42,86,233,94,133,52,81
"2011","Leicester 010D","E01013718","Total",558,202,32,170,197,76,178,36,142
"2011","Leicester 010E","E01013719","Total",480,137,29,108,192,68,154,45,109
"2011","Leicester 010F","E01013720","Total",606,363,33,330,131,41,301,34,267
"2011","Leicester 011A","E01013651","Total",648,237,65,172,273,135,178,46,132
"2011","Leicester 011B","E01013652","Total",576,210,87,123,304,118,169,63,106
"2011","Leicester 011C","E01013653","Total",683,266,72,194,276,119,195,56,139
"2011","Leicester 011D","E01013655","Total",717,243,61,182,285,159,192,52,140
"2011","Leicester 012A","E01013721","Total",658,260,47,213,189,81,201,45,156
"2011","Leicester 012B","E01013723","Total",480,194,68,126,210,97,137,38,99
"2011","Leicester 012C","E01013725","Total",528,238,85,153,231,105,193,51,142
"2011","Leicester 012D","E01013726","Total",885,533,131,402,265,149,351,52,299
"2011","Leicester 012E","E01013728","Total",542,193,76,117,261,110,158,59,99
"2011","Leicester 013A","E01013694","Total",650,243,56,187,286,128,192,46,146
"2011","Leicester 013B","E01013700","Total",615,236,27,209,185,83,171,21,150
"2011","Leicester 013C","E01013770","Total",551,227,18,209,166,72,178,30,148
"2011","Leicester 013D","E01013771","Total",519,124,21,103,208,77,127,33,94
"2011","Leicester 013E","E01013773","Total",576,226,22,204,178,75,201,34,167
"2011","Leicester 016A","E01013681","Total",772,197,65,132,255,133,154,39,115
"2011","Leicester 016B","E01013682","Total",772,197,74,123,262,150,156,37,119
"2011","Leicester 016C","E01013683","Total",980,271,76,195,248,161,181,40,141
"2011","Leicester 016D","E01013684","Total",894,286,60,226,246,134,214,32,182
"2011","Leicester 017A","E01013654","Total",835,364,79,285,305,163,293,70,223
"2011","Leicester 017B","E01013656","Total",502,130,38,92,252,124,137,51,86
"2011","Leicester 017C","E01013657","Total",529,180,62,118,276,135,163,66,97
"2011","Leicester 017D","E01013658","Total",561,143,40,103,275,134,138,60,78
"2011","Leicester 017E","E01013659","Total",565,166,41,125,285,156,152,55,97
"2011","Leicester 017F","E01013743","Total",428,110,34,76,214,88,123,47,76
"2011","Leicester 017G","E01013745","Total",423,102,23,79,216,101,111,53,58
"2011","Leicester 018A","E01013742","Total",462,125,43,82,252,101,139,57,82
"2011","Leicester 018B","E01013744","Total",482,116,36,80,266,116,135,56,79
"2011","Leicester 018C","E01013746","Total",724,318,52,266,237,133,235,45,190
"2011","Leicester 018D","E01013748","Total",682,300,63,237,250,134,228,58,170
"2011","Leicester 018E","E01013754","Total",705,360,120,240,339,217,226,65,161
"2011","Leicester 018F","E01013755","Total",720,339,154,185,411,252,206,74,132
"2011","Leicester 019A","E01013660","Total",647,220,54,166,259,113,194,48,146
"2011","Leicester 019B","E01013661","Total",633,250,68,182,254,127,215,56,159
"2011","Leicester 019C","E01013664","Total",777,315,63,252,273,129,252,65,187
"2011","Leicester 019D","E01013665","Total",620,194,41,153,235,100,178,51,127
"2011","Leicester 019E","E01013667","Total",678,292,35,257,199,68,263,44,219
"2011","Leicester 019F","E01013668","Total",578,174,26,148,220,101,154,28,126
"2011","Leicester 020A","E01013729","Total",545,180,24,156,161,78,139,25,114
"2011","Leicester 020B","E01013780","Total",622,163,11,152,191,73,150,30,120
"2011","Leicester 020C","E01013783","Total",619,169,10,159,195,80,134,26,108
"2011","Leicester 020D","E01013785","Total",542,142,3,139,165,54,117,17,100
"2011","Leicester 020E","E01013786","Total",700,178,18,160,162,85,151,25,126
"2011","Leicester 021A","E01013662","Total",517,127,28,99,235,101,124,44,80
"2011","Leicester 021B","E01013663","Total",512,141,32,109,249,93,144,62,82
"2011","Leicester 021C","E01013747","Total",532,135,36,99,261,124,135,51,84
"2011","Leicester 021D","E01013749","Total",449,108,24,84,225,77,130,47,83
"2011","Leicester 021E","E01013750","Total",416,116,23,93,197,96,114,44,70
"2011","Leicester 021F","E01013758","Total",428,104,23,81,210,80,118,46,72
"2011","Leicester 022A","E01013751","Total",524,143,43,100,262,115,159,70,89
"2011","Leicester 022B","E01013752","Total",444,154,42,112,206,90,132,50,82
"2011","Leicester 022C","E01013753","Total",517,184,61,123,251,114,154,60,94
"2011","Leicester 022D","E01013760","Total",698,277,39,238,154,99,129,29,100
"2011","Leicester 022E","E01013761","Total",619,245,102,143,335,178,174,72,102
"2011","Leicester 022F","E01013762","Total",542,196,53,143,208,97,166,51,115
"2011","Leicester 023A","E01013774","Total",704,179,41,138,152,84,116,25,91
"2011","Leicester 023B","E01013776","Total",754,245,24,221,112,67,128,22,106
"2011","Leicester 023C","E01013778","Total",939,333,61,272,184,109,204,33,171
"2011","Leicester 023D","E01013779","Total",893,216,24,192,145,92,110,17,93
"2011","Leicester 023E","E01013781","Total",768,238,22,216,116,66,120,8,112
"2011","Leicester 023F","E01013782","Total",673,195,19,176,151,80,157,28,129
"2011","Leicester 023G","E01013784","Total",525,133,17,116,97,45,107,14,93
"2011","Leicester 025A","E01013666","Total",597,232,8,224,158,50,185,38,147
"2011","Leicester 025B","E01013669","Total",457,138,8,130,148,45,139,35,104
"2011","Leicester 025C","E01013670","Total",707,279,22,257,177,64,210,36,174
"2011","Leicester 025D","E01013671","Total",589,168,24,144,244,112,157,54,103
"2011","Leicester 025E","E01013672","Total",511,228,16,212,149,54,153,28,125
"2011","Leicester 026A","E01013631","Total",544,177,57,120,244,123,145,53,92
"2011","Leicester 026B","E01013632","Total",740,397,108,289,284,115,275,71,204
"2011","Leicester 026C","E01013638","Total",664,323,122,201,305,125,239,72,167
"2011","Leicester 026D","E01013640","Total",636,245,121,124,359,182,168,75,93
"2011","Leicester 027A","E01013756","Total",675,221,42,179,231,112,166,48,118
"2011","Leicester 027B","E01013757","Total",489,134,18,116,209,90,122,44,78
"2011","Leicester 027C","E01013759","Total",531,126,24,102,253,103,148,54,94
"2011","Leicester 027D","E01013763","Total",828,314,49,265,187,104,191,40,151
"2011","Leicester 027E","E01013764","Total",458,122,25,97,197,78,125,40,85
"2011","Leicester 027F","E01013765","Total",548,178,29,149,174,76,116,33,83
"2011","Leicester 027G","E01013766","Total",500,137,27,110,236,93,148,53,95
"2011","Leicester 028A","E01013633","Total",681,307,72,235,238,103,247,63,184
"2011","Leicester 028B","E01013634","Total",622,283,49,234,204,73,223,42,181
"2011","Leicester 028C","E01013637","Total",764,345,77,268,272,118,262,54,208
"2011","Leicester 028D","E01013639","Total",538,154,66,88,261,126,127,54,73
"2011","Leicester 028E","E01013641","Total",617,148,36,112,177,98,145,38,107
"2011","Leicester 029A","E01013635","Total",595,153,21,132,156,59,156,27,129
"2011","Leicester 029B","E01013636","Total",492,122,6,116,140,47,125,23,102
"2011","Leicester 029C","E01013775","Total",968,270,70,200,217,140,142,30,112
"2011","Leicester 029D","E01013777","Total",731,170,48,122,172,88,139,27,112
"2011","Leicester 030A","E01013642","Total",837,228,17,211,135,66,127,15,112
"2011","Leicester 030B","E01013643","Total",738,207,12,195,137,71,130,13,117
"2011","Leicester 030C","E01013649","Total",684,229,5,224,68,29,115,3,112
"2011","Leicester 030D","E01013650","Total",742,167,5,162,99,43,95,8,87
"2011","Leicester 030E","E01013702","Total",623,166,12,154,169,64,149,29,120
"2011","Leicester 030F","E01013710","Total",714,224,14,210,132,61,151,21,130
"2011","Leicester 030G","E01013711","Total",728,269,9,260,121,52,171,16,155
"2011","Leicester 031A","E01013613","Total",775,189,51,138,221,126,149,29,120
"2011","Leicester 031B","E01013614","Total",714,206,28,178,189,96,171,33,138
"2011","Leicester 031C","E01013687","Total",737,163,41,122,195,108,135,28,107
"2011","Leicester 031D","E01013688","Total",699,215,37,178,155,78,160,30,130
"2011","Leicester 032A","E01013703","Total",513,140,11,129,153,57,90,12,78
"2011","Leicester 032B","E01013704","Total",597,125,5,120,154,65,100,21,79
"2011","Leicester 032C","E01013706","Total",646,155,9,146,211,64,130,26,104
"2011","Leicester 032D","E01013707","Total",602,152,11,141,247,90,116,33,83
"2011","Leicester 032E","E01013712","Total",570,221,12,209,135,45,151,15,136
"2011","Leicester 034A","E01013608","Total",627,187,19,168,191,89,131,20,111
"2011","Leicester 034B","E01013609","Total",741,264,17,247,160,66,212,24,188
"2011","Leicester 034C","E01013610","Total",747,295,45,250,221,109,226,33,193
"2011","Leicester 034D","E01013611","Total",604,200,24,176,186,79,174,36,138
"2011","Leicester 034E","E01013612","Total",631,186,17,169,178,69,138,22,116
"2011","Leicester 035A","E01013678","Total",644,231,57,174,231,86,188,41,147
"2011","Leicester 035B","E01013679","Total",520,204,88,116,263,104,142,59,83
"2011","Leicester 035C","E01013691","Total",606,292,111,181,266,105,212,69,143
"2011","Leicester 035D","E01013692","Total",483,207,97,110,245,94,163,67,96
"2011","Leicester 035E","E01013693","Total",522,246,94,152,237,95,201,77,124
"2011","Leicester 036A","E01013673","Total",611,266,62,204,229,97,230,53,177
"2011","Leicester 036B","E01013674","Total",774,430,63,367,194,92,333,39,294
"2011","Leicester 036C","E01013675","Total",667,243,61,182,232,100,205,49,156
"2011","Leicester 036D","E01013676","Total",823,268,79,189,322,165,219,61,158
"2011","Leicester 036E","E01013677","Total",672,270,54,216,215,106,201,39,162
"2011","Leicester 037A","E01013695","Total",609,266,75,191,238,113,196,39,157
"2011","Leicester 037B","E01013698","Total",587,225,44,181,207,82,182,41,141
"2011","Leicester 037C","E01013767","Total",567,212,27,185,179,77,175,38,137
"2011","Leicester 037D","E01013768","Total",705,371,40,331,160,85,272,38,234
"2011","Leicester 037E","E01013772","Total",616,244,68,176,248,115,179,53,126
"2011","Leicester 037F","E01032597","Total",655,323,54,269,211,94,243,42,201
"2011","Leicester 038A","E01013689","Total",519,166,15,151,89,36,97,18,79
"2011","Leicester 038B","E01013690","Total",656,199,48,151,180,88,169,36,133
"2011","Leicester 038C","E01013705","Total",667,244,30,214,202,84,166,26,140
"2011","Leicester 038D","E01013709","Total",552,164,14,150,178,73,149,30,119
"2011","Leicester 038E","E01032599","Total",580,170,9,161,209,72,145,25,120
"2011","Leicester 039A","E01013722","Total",598,251,84,167,269,124,201,57,144
"2011","Leicester 039B","E01013727","Total",649,262,44,218,205,98,202,37,165
"2011","Leicester 039C","E01013730","Total",758,373,116,257,257,134,254,65,189
"2011","Leicester 039D","E01013731","Total",648,190,85,105,280,136,141,49,92
"2011","Leicester 039E","E01032602","Total",601,262,95,167,265,130,172,60,112
"2011","Leicester 040A","E01013646","Total",1099,454,18,436,87,52,240,17,223
"2011","Leicester 040B","E01013647","Total",947,513,27,486,74,35,188,16,172
"2011","Leicester 040C","E01013648","Total",746,321,62,259,156,76,122,25,97
"2011","Leicester 040D","E01032875","Total",423,246,13,233,32,20,63,9,54
"2011","Leicester 041A","E01032867","Total",813,326,29,297,69,45,92,1,91
"2011","Leicester 041B","E01032868","Total",483,164,15,149,38,31,41,2,39
"2011","Leicester 041C","E01032872","Total",778,276,10,266,33,28,77,3,74
"2011","Leicester 041D","E01032873","Total",887,454,14,440,29,24,166,0,166
"2011","Nottingham 001A","E01013887","Total",637,220,13,207,153,36,177,22,155
"2011","Nottingham 001B","E01013892","Total",600,249,7,242,136,28,184,24,160
"2011","Nottingham 001C","E01013893","Total",583,183,69,114,242,121,127,38,89
"2011","Nottingham 001D","E01013894","Total",638,227,20,207,157,63,182,28,154
"2011","Nottingham 002A","E01013879","Total",573,267,86,181,208,117,190,38,152
"2011","Nottingham 002B","E01013880","Total",678,344,71,273,213,97,256,39,217
"2011","Nottingham 002C","E01013881","Total",649,291,87,204,233,109,206,40,166
"2011","Nottingham 002D","E01013882","Total",628,287,73,214,197,84,184,29,155
"2011","Nottingham 002E","E01013885","Total",769,337,81,256,246,106,248,48,200
"2011","Nottingham 004A","E01013886","Total",660,225,36,189,179,79,180,24,156
"2011","Nottingham 004B","E01013888","Total",696,282,27,255,170,64,229,37,192
"2011","Nottingham 004C","E01013889","Total",721,276,34,242,195,75,209,28,181
"2011","Nottingham 004D","E01013890","Total",661,164,28,136,207,90,149,30,119
"2011","Nottingham 004E","E01013891","Total",731,277,59,218,235,106,223,49,174
"2011","Nottingham 005A","E01013875","Total",521,106,8,98,172,52,127,28,99
"2011","Nottingham 005B","E01013876","Total",757,300,72,228,261,123,211,43,168
"2011","Nottingham 005C","E01013877","Total",680,386,122,264,225,119,230,46,184
"2011","Nottingham 005D","E01013878","Total",538,224,64,160,207,84,147,43,104
"2011","Nottingham 005E","E01013883","Total",681,257,56,201,211,87,192,35,157
"2011","Nottingham 005F","E01013884","Total",639,249,55,194,207,95,194,38,156
"2011","Nottingham 006A","E01013853","Total",653,268,31,237,175,67,204,39,165
"2011","Nottingham 006B","E01013854","Total",639,254,55,199,205,79,186,36,150
"2011","Nottingham 006C","E01013855","Total",642,268,124,144,313,155,152,46,106
"2011","Nottingham 006D","E01013856","Total",638,206,52,154,251,126,190,40,150
"2011","Nottingham 006F","E01033397","Total",694,192,78,114,298,178,144,50,94
"2011","Nottingham 006G","E01033398","Total",637,198,38,160,145,95,133,18,115
"2011","Nottingham 007A","E01013963","Total",718,310,60,250,234,88,234,40,194
"2011","Nottingham 007B","E01013964","Total",671,222,50,172,245,104,150,42,108
"2011","Nottingham 007C","E01013965","Total",617,222,40,182,196,63,198,51,147
"2011","Nottingham 007D","E01013966","Total",568,185,50,135,210,77,157,39,118
"2011","Nottingham 007E","E01013967","Total",478,142,16,126,138,68,115,25,90
"2011","Nottingham 008A","E01013827","Total",608,213,67,146,252,114,198,58,140
"2011","Nottingham 008B","E01013828","Total",790,241,38,203,197,100,181,21,160
"2011","Nottingham 008C","E01013834","Total",642,253,72,181,274,126,201,40,161
"2011","Nottingham 008D","E01013835","Total",715,277,64,213,239,111,227,52,175
"2011","Nottingham 008E","E01013836","Total",872,302,92,210,292,144,227,51,176
"2011","Nottingham 009A","E01013829","Total",797,268,40,228,217,90,218,41,177
"2011","Nottingham 009B","E01013830","Total",696,251,47,204,206,68,209,51,158
"2011","Nottingham 009C","E01013831","Total",672,182,16,166,186,79,161,26,135
"2011","Nottingham 009D","E01013832","Total",745,305,41,264,188,84,235,40,195
"2011","Nottingham 009E","E01013833","Total",561,216,57,159,207,67,171,45,126
"2011","Nottingham 010A","E01013935","Total",744,261,16,245,143,64,176,18,158
"2011","Nottingham 010B","E01013968","Total",669,327,8,319,94,31,247,9,238
"2011","Nottingham 010C","E01013969","Total",798,165,20,145,151,69,169,26,143
"2011","Nottingham 010D","E01013970","Total",670,118,11,107,197,97,129,27,102
"2011","Nottingham 010E","E01013971","Total",769,194,10,184,138,76,169,26,143
"2011","Nottingham 011A","E01013817","Total",642,314,159,155,336,188,182,66,116
"2011","Nottingham 011B","E01013818","Total",579,306,157,149,316,153,154,64,90
"2011","Nottingham 011C","E01013822","Total",641,284,137,147,325,177,184,53,131
"2011","Nottingham 011D","E01013825","Total",690,224,76,148,302,137,179,68,111
"2011","Nottingham 011E","E01013826","Total",706,304,162,142,404,208,187,77,110
"2011","Nottingham 012A","E01013837","Total",736,165,27,138,223,102,161,44,117
"2011","Nottingham 012B","E01013838","Total",664,175,19,156,195,94,133,28,105
"2011","Nottingham 012C","E01013839","Total",862,320,70,250,243,137,246,40,206
"2011","Nottingham 012D","E01013840","Total",982,170,30,140,273,148,153,36,117
"2011","Nottingham 012E","E01013841","Total",692,205,62,143,230,118,168,39,129
"2011","Nottingham 013A","E01013819","Total",735,329,86,243,273,128,259,50,209
"2011","Nottingham 013B","E01013820","Total",669,279,136,143,356,149,188,71,117
"2011","Nottingham 013C","E01013821","Total",627,266,127,139,311,155,163,61,102
"2011","Nottingham 013D","E01013823","Total",666,232,88,144,333,133,190,71,119
"2011","Nottingham 013E","E01013824","Total",599,265,124,141,290,159,173,55,118
"2011","Nottingham 014A","E01013864","Total",710,307,114,193,301,154,182,43,139
"2011","Nottingham 014B","E01013865","Total",752,397,60,337,196,88,296,37,259
"2011","Nottingham 014C","E01013866","Total",609,278,39,239,181,69,238,39,199
"2011","Nottingham 014D","E01013867","Total",598,237,99,138,282,135,174,72,102
"2011","Nottingham 015A","E01013937","Total",748,203,27,176,187,80,144,28,116
"2011","Nottingham 015B","E01013938","Total",704,185,4,181,154,60,139,15,124
"2011","Nottingham 015C","E01013941","Total",827,232,8,224,103,44,156,10,146
"2011","Nottingham 015D","E01013943","Total",812,261,36,225,114,57,123,14,109
"2011","Nottingham 015E","E01013972","Total",693,197,15,182,146,55,192,26,166
"2011","Nottingham 016A","E01013936","Total",1057,246,43,203,254,118,240,50,190
"2011","Nottingham 016B","E01013939","Total",769,251,26,225,158,76,206,21,185
"2011","Nottingham 016C","E01013940","Total",753,278,103,175,278,107,210,68,142
"2011","Nottingham 016D","E01013942","Total",958,408,85,323,302,132,325,60,265
"2011","Nottingham 017A","E01013843","Total",663,197,16,181,114,50,127,16,111
"2011","Nottingham 017B","E01013844","Total",621,181,43,138,163,99,146,34,112
"2011","Nottingham 017C","E01013845","Total",606,154,44,110,236,139,157,46,111
"2011","Nottingham 017D","E01013847","Total",433,124,32,92,138,53,105,29,76
"2011","Nottingham 018A","E01013810","Total",617,238,76,162,252,140,179,51,128
"2011","Nottingham 018B","E01013811","Total",588,270,52,218,149,71,172,34,138
"2011","Nottingham 018C","E01013812","Total",570,211,61,150,224,125,158,50,108
"2011","Nottingham 018D","E01013842","Total",648,211,71,140,236,131,138,36,102
"2011","Nottingham 018E","E01013846","Total",684,258,48,210,161,92,160,25,135
"2011","Nottingham 019A","E01013930","Total",731,224,47,177,281,155,192,52,140
"2011","Nottingham 019B","E01013931","Total",622,274,18,256,175,63,202,42,160
"2011","Nottingham 019C","E01013932","Total",658,272,31,241,193,82,221,47,174
"2011","Nottingham 019D","E01013933","Total",780,334,87,247,288,132,203,55,148
"2011","Nottingham 019E","E01013934","Total",647,245,19,226,171,65,212,36,176
"2011","Nottingham 020A","E01013859","Total",732,406,16,390,133,51,296,23,273
"2011","Nottingham 020B","E01013861","Total",722,472,56,416,162,67,385,38,347
"2011","Nottingham 020C","E01013868","Total",627,325,62,263,199,71,273,53,220
"2011","Nottingham 020D","E01013929","Total",751,272,45,227,238,87,208,56,152
"2011","Nottingham 021A","E01013954","Total",594,248,63,185,188,75,191,42,149
"2011","Nottingham 021B","E01013959","Total",841,390,103,287,280,141,292,61,231
"2011","Nottingham 021C","E01013960","Total",770,367,75,292,225,104,276,48,228
"2011","Nottingham 021D","E01013962","Total",859,346,74,272,240,103,264,55,209
"2011","Nottingham 022A","E01013813","Total",758,344,34,310,94,37,229,20,209
"2011","Nottingham 022B","E01013814","Total",841,358,20,338,67,28,159,12,147
"2011","Nottingham 022C","E01013815","Total",627,241,19,222,57,22,143,12,131
"2011","Nottingham 022D","E01013816","Total",914,464,26,438,82,34,157,24,133
"2011","Nottingham 023C","E01013958","Total",838,417,111,306,268,126,258,52,206
"2011","Nottingham 023D","E01013961","Total",853,353,59,294,166,71,192,40,152
"2011","Nottingham 023E","E01033399","Total",569,290,31,259,81,33,126,14,112
"2011","Nottingham 023F","E01033401","Total",559,278,20,258,56,28,68,11,57
"2011","Nottingham 023G","E01033405","Total",711,372,13,359,30,18,98,5,93
"2011","Nottingham 023H","E01033409","Total",619,275,4,271,15,6,182,4,178
"2011","Nottingham 023I","E01033411","Total",578,318,43,275,133,73,222,23,199
"2011","Nottingham 024A","E01013913","Total",688,211,19,192,214,81,189,38,151
"2011","Nottingham 024B","E01013914","Total",627,206,20,186,213,97,185,42,143
"2011","Nottingham 024C","E01013915","Total",656,277,31,246,182,76,234,43,191
"2011","Nottingham 024D","E01013916","Total",622,244,71,173,256,97,188,51,137
"2011","Nottingham 024E","E01013917","Total",783,261,60,201,265,110,223,50,173
"2011","Nottingham 025A","E01013858","Total",592,244,49,195,205,84,205,64,141
"2011","Nottingham 025B","E01013860","Total",713,390,50,340,185,67,297,45,252
"2011","Nottingham 025C","E01013862","Total",640,292,69,223,246,95,245,56,189
"2011","Nottingham 025D","E01013863","Total",620,229,33,196,186,71,184,39,145
"2011","Nottingham 026A","E01013944","Total",651,207,38,169,211,95,167,46,121
"2011","Nottingham 026B","E01013945","Total",610,277,73,204,191,83,144,38,106
"2011","Nottingham 026D","E01013947","Total",759,315,65,250,215,117,210,47,163
"2011","Nottingham 026E","E01013948","Total",754,406,46,360,126,75,251,24,227
"2011","Nottingham 026F","E01013953","Total",513,187,19,168,51,33,76,6,70
"2011","Nottingham 026G","E01033395","Total",549,293,23,270,47,16,68,9,59
"2011","Nottingham 026H","E01033396","Total",552,298,41,257,112,52,155,17,138
"2011","Nottingham 027A","E01013977","Total",766,246,18,228,232,106,198,31,167
"2011","Nottingham 027B","E01013978","Total",669,219,18,201,223,91,171,33,138
"2011","Nottingham 027C","E01013979","Total",601,169,15,154,221,86,130,33,97
"2011","Nottingham 027D","E01013981","Total",653,184,10,174,196,74,131,26,105
"2011","Nottingham 028E","E01032520","Total",1058,261,4,257,89,49,125,10,115
"2011","Nottingham 028F","E01032522","Total",1002,223,10,213,89,37,110,9,101
"2011","Nottingham 028G","E01033404","Total",1219,489,24,465,81,39,224,15,209
"2011","Nottingham 029A","E01013918","Total",781,234,70,164,255,138,177,50,127
"2011","Nottingham 029B","E01013919","Total",836,255,64,191,234,129,218,48,170
"2011","Nottingham 029C","E01013920","Total",1219,543,80,463,221,115,402,50,352
"2011","Nottingham 029D","E01013921","Total",882,397,135,262,308,190,280,71,209
"2011","Nottingham 029E","E01013957","Total",654,220,69,151,252,121,145,37,108
"2011","Nottingham 030A","E01013980","Total",666,224,12,212,203,71,152,25,127
"2011","Nottingham 030B","E01013982","Total",625,224,9,215,204,62,152,30,122
"2011","Nottingham 030C","E01013983","Total",733,326,38,288,166,66,247,34,213
"2011","Nottingham 030D","E01013984","Total",643,328,6,322,138,41,173,11,162
"2011","Nottingham 030E","E01013985","Total",739,317,20,297,194,84,217,31,186
"2011","Nottingham 031C","E01013924","Total",723,382,13,369,34,20,203,4,199
"2011","Nottingham 031E","E01013926","Total",633,224,26,198,99,46,121,20,101
"2011","Nottingham 031G","E01013928","Total",548,278,33,245,87,52,99,15,84
"2011","Nottingham 031H","E01033408","Total",1014,382,17,365,101,42,201,22,179
"2011","Nottingham 031I","E01033410","Total",820,398,13,385,68,44,119,11,108
"2011","Nottingham 032A","E01013973","Total",401,215,38,177,102,56,101,13,88
"2011","Nottingham 032B","E01013974","Total",667,373,20,353,107,38,222,25,197
"2011","Nottingham 032C","E01013975","Total",425,187,12,175,102,40,117,23,94
"2011","Nottingham 032D","E01013976","Total",679,250,88,162,247,126,141,39,102
"2011","Nottingham 034A","E01013895","Total",636,266,13,253,157,54,193,26,167
"2011","Nottingham 034B","E01013896","Total",588,258,35,223,153,69,191,32,159
"2011","Nottingham 034C","E01013901","Total",639,168,12,156,172,67,130,21,109
"2011","Nottingham 034D","E01013902","Total",677,229,9,220,151,66,157,15,142
"2011","Nottingham 035A","E01013897","Total",641,293,42,251,172,57,220,40,180
"2011","Nottingham 035B","E01013898","Total",436,190,23,167,110,47,152,23,129
"2011","Nottingham 035C","E01013899","Total",492,158,31,127,166,53,165,36,129
"2011","Nottingham 035D","E01013900","Total",672,244,28,216,169,83,223,30,193
"2011","Nottingham 035E","E01013903","Total",491,183,23,160,143,45,138,28,110
"2011","Nottingham 035F","E01013907","Total",756,375,32,343,162,70,300,33,267
"2011","Nottingham 036A","E01013905","Total",633,266,49,217,217,107,222,39,183
"2011","Nottingham 036B","E01013908","Total",774,424,59,365,226,96,284,48,236
"2011","Nottingham 036C","E01013909","Total",786,364,59,305,179,85,222,25,197
"2011","Nottingham 036D","E01013912","Total",666,209,14,195,161,64,180,20,160
"2011","Nottingham 037A","E01013904","Total",626,232,36,196,201,87,177,27,150
"2011","Nottingham 037B","E01013906","Total",689,246,38,208,212,94,207,40,167
"2011","Nottingham 037C","E01013910","Total",628,242,40,202,189,83,215,38,177
"2011","Nottingham 037D","E01013911","Total",690,285,27,258,181,85,201,21,180
"2011","Nottingham 038A","E01013849","Total",693,294,69,225,229,96,238,43,195
"2011","Nottingham 038B","E01013850","Total",715,346,36,310,165,76,255,31,224
"2011","Nottingham 038C","E01013851","Total",786,392,91,301,229,105,285,51,234
"2011","Nottingham 038D","E01013852","Total",763,338,37,301,177,67,246,31,215
"2011","Nottingham 038E","E01032621","Total",704,309,39,270,178,70,228,35,193
"2011","Nottingham 039A","E01013874","Total",684,149,32,117,132,68,123,24,99
"2011","Nottingham 039B","E01033400","Total",599,235,55,180,143,72,124,31,93
"2011","Nottingham 039C","E01033402","Total",623,157,7,150,26,19,45,1,44
"2011","Nottingham 039D","E01033403","Total",639,216,15,201,47,29,88,7,81
"2011","Nottingham 039E","E01033406","Total",602,239,7,232,13,10,54,2,52
"2011","Nottingham 039F","E01033407","Total",640,213,6,207,24,15,52,4,48
"2011","Nottingham 040A","E01013870","Total",1026,350,68,282,223,102,247,52,195
"2011","Nottingham 040B","E01013871","Total",858,429,67,362,220,108,347,54,293
"2011","Nottingham 040C","E01013872","Total",821,300,52,248,226,114,244,43,201
"2011","Nottingham 040D","E01013873","Total",619,174,66,108,199,98,132,49,83
"2011","Rutland 001A","E01013788","Total",1014,287,14,273,343,165,220,44,176
"2011","Rutland 001B","E01013789","Total",596,192,7,185,132,39,131,15,116
"2011","Rutland 001C","E01013790","Total",501,127,3,124,124,40,106,15,91
"2011","Rutland 001D","E01013796","Total",565,160,7,153,184,81,115,15,100
"2011","Rutland 002A","E01013793","Total",610,213,6,207,142,53,157,10,147
"2011","Rutland 002B","E01013800","Total",659,214,5,209,171,52,177,21,156
"2011","Rutland 002C","E01013801","Total",725,238,22,216,195,71,220,32,188
"2011","Rutland 002D","E01013809","Total",525,166,11,155,132,36,123,18,105
"2011","Rutland 003A","E01013798","Total",579,136,9,127,190,59,105,23,82
"2011","Rutland 003B","E01013799","Total",651,225,19,206,154,70,153,23,130
"2011","Rutland 003C","E01013802","Total",1178,523,19,504,252,86,329,26,303
"2011","Rutland 003D","E01013803","Total",982,365,24,341,261,86,248,33,215
"2011","Rutland 004A","E01013791","Total",483,199,9,190,127,35,131,20,111
"2011","Rutland 004B","E01013792","Total",684,226,8,218,201,63,170,18,152
"2011","Rutland 004C","E01013797","Total",724,210,7,203,205,80,152,26,126
"2011","Rutland 004D","E01013804","Total",661,186,6,180,175,54,131,17,114
"2011","Rutland 004E","E01013805","Total",536,160,9,151,153,50,129,17,112
"2011","Rutland 005A","E01013787","Total",540,174,6,168,149,41,115,13,102
"2011","Rutland 005B","E01013794","Total",561,175,3,172,131,39,115,11,104
"2011","Rutland 005C","E01013795","Total",488,165,3,162,100,21,112,13,99
"2011","Rutland 005D","E01013806","Total",498,137,6,131,126,44,111,16,95
"2011","Rutland 005E","E01013807","Total",622,216,15,201,170,65,133,22,111
"2011","Rutland 005F","E01013808","Total",620,237,17,220,154,74,155,8,147
"2011","Amber Valley 001A","E01019400","Total",669,237,59,178,205,86,189,50,139
"2011","Amber Valley 001B","E01019401","Total",771,354,24,330,172,64,280,32,248
"2011","Amber Valley 001C","E01019402","Total",646,196,31,165,198,74,162,39,123
"2011","Amber Valley 001D","E01019404","Total",759,308,22,286,153,50,253,28,225
"2011","Amber Valley 002A","E01019406","Total",482,200,10,190,101,20,148,17,131
"2011","Amber Valley 002B","E01019423","Total",556,209,6,203,121,46,135,13,122
"2011","Amber Valley 002C","E01019424","Total",506,186,8,178,117,44,158,23,135
"2011","Amber Valley 002D","E01019477","Total",1006,375,16,359,214,70,305,36,269
"2011","Amber Valley 003A","E01019403","Total",675,316,41,275,181,71,245,38,207
"2011","Amber Valley 003B","E01019444","Total",594,307,81,226,202,79,213,43,170
"2011","Amber Valley 003C","E01019468","Total",650,213,41,172,184,66,212,49,163
"2011","Amber Valley 003D","E01019469","Total",657,250,86,164,262,123,198,55,143
"2011","Amber Valley 003E","E01019471","Total",642,250,61,189,186,78,211,49,162
"2011","Amber Valley 004A","E01019443","Total",713,306,12,294,151,56,210,19,191
"2011","Amber Valley 004B","E01019470","Total",707,200,25,175,206,74,183,34,149
"2011","Amber Valley 004C","E01019473","Total",536,125,4,121,167,36,112,17,95
"2011","Amber Valley 004D","E01019474","Total",518,113,5,108,135,41,95,17,78
"2011","Amber Valley 004E","E01019475","Total",532,197,17,180,137,41,145,23,122
"2011","Amber Valley 004F","E01019476","Total",637,271,2,269,117,37,196,14,182
"2011","Amber Valley 005A","E01019420","Total",601,189,19,170,143,55,179,22,157
"2011","Amber Valley 005B","E01019442","Total",649,177,23,154,164,51,180,34,146
"2011","Amber Valley 005C","E01019445","Total",640,161,16,145,157,62,139,20,119
"2011","Amber Valley 005D","E01019455","Total",627,179,19,160,149,62,158,23,135
"2011","Amber Valley 005E","E01019456","Total",763,217,32,185,231,95,193,29,164
"2011","Amber Valley 005F","E01019457","Total",548,188,11,177,165,49,147,23,124
"2011","Amber Valley 006A","E01019429","Total",700,214,9,205,160,45,189,22,167
"2011","Amber Valley 006B","E01019454","Total",632,255,6,249,135,39,196,17,179
"2011","Amber Valley 006C","E01019460","Total",664,145,12,133,205,76,158,30,128
"2011","Amber Valley 006D","E01019461","Total",657,275,7,268,142,51,226,15,211
"2011","Amber Valley 006E","E01019462","Total",544,213,10,203,116,45,129,12,117
"2011","Amber Valley 007A","E01019405","Total",592,221,2,219,127,30,143,18,125
"2011","Amber Valley 007B","E01019414","Total",705,268,3,265,143,47,185,24,161
"2011","Amber Valley 007C","E01019428","Total",630,217,14,203,162,45,176,24,152
"2011","Amber Valley 007D","E01019430","Total",800,247,13,234,229,84,194,32,162
"2011","Amber Valley 008A","E01019421","Total",818,262,19,243,205,71,237,40,197
"2011","Amber Valley 008B","E01019422","Total",653,232,12,220,162,55,208,35,173
"2011","Amber Valley 008C","E01019432","Total",847,347,38,309,226,75,288,46,242
"2011","Amber Valley 008D","E01019458","Total",712,221,33,188,196,92,187,28,159
"2011","Amber Valley 008E","E01019459","Total",598,249,45,204,176,57,201,38,163
"2011","Amber Valley 008F","E01019463","Total",639,298,66,232,225,79,215,44,171
"2011","Amber Valley 009A","E01019408","Total",643,178,15,163,194,71,170,38,132
"2011","Amber Valley 009B","E01019409","Total",743,288,13,275,191,60,191,29,162
"2011","Amber Valley 009C","E01019412","Total",579,102,5,97,256,77,99,33,66
"2011","Amber Valley 009D","E01019413","Total",548,96,16,80,254,91,89,31,58
"2011","Amber Valley 009E","E01019416","Total",641,238,7,231,144,43,179,19,160
"2011","Amber Valley 010A","E01019407","Total",1017,331,21,310,216,93,268,24,244
"2011","Amber Valley 010B","E01019415","Total",801,277,26,251,205,76,209,34,175
"2011","Amber Valley 010C","E01019417","Total",912,350,47,303,237,94,258,41,217
"2011","Amber Valley 010D","E01019419","Total",913,248,17,231,201,66,186,28,158
"2011","Amber Valley 011A","E01019410","Total",631,156,12,144,195,66,139,30,109
"2011","Amber Valley 011B","E01019411","Total",644,230,14,216,197,62,179,33,146
"2011","Amber Valley 011C","E01019418","Total",703,189,25,164,248,102,160,43,117
"2011","Amber Valley 011D","E01019447","Total",651,237,10,227,148,55,151,15,136
"2011","Amber Valley 011E","E01019449","Total",784,195,8,187,206,78,176,27,149
"2011","Amber Valley 012A","E01019431","Total",600,196,31,165,189,79,177,35,142
"2011","Amber Valley 012B","E01019433","Total",769,271,35,236,243,96,184,35,149
"2011","Amber Valley 012C","E01019438","Total",667,181,36,145,252,102,158,30,128
"2011","Amber Valley 012D","E01019451","Total",830,222,38,184,237,114,205,37,168
"2011","Amber Valley 012E","E01019464","Total",792,228,10,218,256,94,182,31,151
"2011","Amber Valley 013A","E01019434","Total",540,192,24,168,135,60,135,20,115
"2011","Amber Valley 013B","E01019435","Total",662,150,30,120,240,92,147,29,118
"2011","Amber Valley 013C","E01019436","Total",558,170,19,151,159,56,144,26,118
"2011","Amber Valley 013D","E01019439","Total",516,126,7,119,161,45,142,27,115
"2011","Amber Valley 013E","E01019440","Total",662,244,21,223,169,72,196,24,172
"2011","Amber Valley 015A","E01019446","Total",509,126,9,117,134,44,102,27,75
"2011","Amber Valley 015B","E01019448","Total",686,189,6,183,201,67,187,31,156
"2011","Amber Valley 015C","E01019450","Total",639,220,29,191,179,75,194,31,163
"2011","Amber Valley 015D","E01019465","Total",525,250,15,235,111,30,182,28,154
"2011","Amber Valley 015E","E01019467","Total",650,228,9,219,138,47,161,16,145
"2011","Amber Valley 016A","E01019425","Total",639,252,11,241,217,55,154,22,132
"2011","Amber Valley 016B","E01019426","Total",672,301,13,288,178,43,227,34,193
"2011","Amber Valley 016C","E01019427","Total",717,233,18,215,288,72,166,48,118
"2011","Amber Valley 016D","E01019472","Total",1123,372,13,359,274,73,249,27,222
"2011","Amber Valley 017A","E01019437","Total",610,272,24,248,173,51,222,32,190
"2011","Amber Valley 017B","E01019441","Total",672,263,48,215,203,81,223,48,175
"2011","Amber Valley 017C","E01019452","Total",733,369,68,301,203,89,278,48,230
"2011","Amber Valley 017D","E01019453","Total",808,263,65,198,274,113,203,46,157
"2011","Amber Valley 017E","E01032613","Total",532,211,9,202,122,36,159,16,143
"2011","Bolsover 001A","E01019478","Total",652,173,11,162,204,73,149,18,131
"2011","Bolsover 001B","E01019479","Total",690,219,15,204,229,64,176,36,140
"2011","Bolsover 001C","E01019491","Total",981,305,47,258,310,111,264,49,215
"2011","Bolsover 001D","E01019493","Total",663,186,8,178,193,65,158,26,132
"2011","Bolsover 001E","E01019494","Total",913,389,26,363,194,61,296,29,267
"2011","Bolsover 002A","E01019492","Total",796,335,38,297,211,85,281,46,235
"2011","Bolsover 002B","E01019495","Total",703,287,30,257,175,63,221,42,179
"2011","Bolsover 002C","E01019524","Total",587,185,12,173,149,50,176,28,148
"2011","Bolsover 002D","E01019525","Total",652,248,26,222,183,61,220,42,178
"2011","Bolsover 003A","E01019496","Total",625,233,27,206,162,82,180,24,156
"2011","Bolsover 003B","E01019497","Total",651,342,36,306,143,54,240,25,215
"2011","Bolsover 003C","E01019498","Total",731,260,99,161,288,133,216,67,149
"2011","Bolsover 003D","E01019523","Total",500,236,32,204,119,54,223,35,188
"2011","Bolsover 004A","E01019483","Total",857,308,83,225,322,152,256,67,189
"2011","Bolsover 004B","E01019484","Total",864,306,43,263,216,73,263,40,223
"2011","Bolsover 004C","E01019485","Total",555,265,12,253,120,48,197,22,175
"2011","Bolsover 004D","E01019488","Total",643,289,58,231,216,93,229,39,190
"2011","Bolsover 005A","E01019486","Total",439,124,4,120,135,40,102,26,76
"2011","Bolsover 005B","E01019487","Total",715,358,38,320,191,63,300,47,253
"2011","Bolsover 005C","E01019489","Total",535,223,11,212,108,32,171,18,153
"2011","Bolsover 005D","E01019490","Total",475,149,16,133,145,49,142,32,110
"2011","Bolsover 005E","E01019502","Total",703,312,18,294,156,57,252,34,218
"2011","Bolsover 005F","E01019504","Total",611,266,19,247,135,47,243,31,212
"2011","Bolsover 006A","E01019508","Total",827,404,57,347,243,69,339,74,265
"2011","Bolsover 006B","E01019509","Total",489,233,65,168,189,72,173,47,126
"2011","Bolsover 006C","E01019510","Total",561,304,33,271,127,40,259,39,220
"2011","Bolsover 006D","E01019512","Total",1092,359,46,313,324,125,315,52,263
"2011","Bolsover 007A","E01019503","Total",1046,422,35,387,235,106,295,35,260
"2011","Bolsover 007B","E01019505","Total",605,228,49,179,191,87,199,51,148
"2011","Bolsover 007C","E01019506","Total",565,210,32,178,151,44,185,33,152
"2011","Bolsover 007D","E01019507","Total",778,376,55,321,211,74,321,41,280
"2011","Bolsover 007E","E01019511","Total",837,323,74,249,284,109,271,71,200
"2011","Bolsover 008A","E01019480","Total",677,260,18,242,169,55,213,31,182
"2011","Bolsover 008B","E01019482","Total",670,254,14,240,152,52,213,26,187
"2011","Bolsover 008C","E01019520","Total",724,241,40,201,232,77,197,45,152
"2011","Bolsover 008D","E01019521","Total",663,235,22,213,187,67,185,24,161
"2011","Bolsover 008E","E01019522","Total",648,227,34,193,196,78,195,38,157
"2011","Bolsover 009A","E01019481","Total",541,196,25,171,184,70,186,44,142
"2011","Bolsover 009B","E01019514","Total",661,184,19,165,212,81,170,31,139
"2011","Bolsover 009C","E01019515","Total",675,265,41,224,222,89,227,42,185
"2011","Bolsover 009D","E01019516","Total",682,263,30,233,155,56,215,32,183
"2011","Bolsover 009E","E01019519","Total",788,280,35,245,254,103,226,46,180
"2011","Bolsover 010A","E01019499","Total",599,217,27,190,144,47,173,27,146
"2011","Bolsover 010B","E01019500","Total",597,230,40,190,183,68,197,42,155
"2011","Bolsover 010C","E01019501","Total",654,262,15,247,157,51,200,30,170
"2011","Bolsover 010D","E01019513","Total",559,154,14,140,154,52,118,15,103
"2011","Bolsover 010E","E01019517","Total",657,156,10,146,203,67,146,18,128
"2011","Bolsover 010F","E01019518","Total",665,136,7,129,220,75,139,39,100
"2011","Chesterfield 001A","E01019526","Total",620,195,28,167,174,64,167,38,129
"2011","Chesterfield 001B","E01019528","Total",704,263,14,249,165,59,216,25,191
"2011","Chesterfield 001C","E01019572","Total",642,306,39,267,177,64,226,35,191
"2011","Chesterfield 001D","E01019573","Total",678,208,24,184,160,70,187,25,162
"2011","Chesterfield 001E","E01019574","Total",642,272,17,255,144,52,225,29,196
"2011","Chesterfield 002A","E01019563","Total",647,237,62,175,251,86,223,72,151
"2011","Chesterfield 002B","E01019564","Total",650,244,21,223,166,63,203,30,173
"2011","Chesterfield 002C","E01019565","Total",652,287,54,233,183,72,231,36,195
"2011","Chesterfield 002D","E01019566","Total",722,302,55,247,225,101,245,47,198
"2011","Chesterfield 002E","E01019568","Total",557,230,70,160,244,100,211,70,141
"2011","Chesterfield 003A","E01019527","Total",693,318,62,256,194,74,275,50,225
"2011","Chesterfield 003B","E01019529","Total",649,214,21,193,190,72,176,31,145
"2011","Chesterfield 003C","E01019530","Total",689,233,46,187,190,87,185,33,152
"2011","Chesterfield 003D","E01019531","Total",630,187,28,159,202,89,169,33,136
"2011","Chesterfield 003E","E01019553","Total",737,185,15,170,262,124,163,36,127
"2011","Chesterfield 004A","E01019541","Total",667,277,36,241,195,71,199,33,166
"2011","Chesterfield 004B","E01019542","Total",841,336,39,297,200,97,254,33,221
"2011","Chesterfield 004C","E01019543","Total",768,341,44,297,193,76,256,35,221
"2011","Chesterfield 004D","E01019544","Total",724,328,23,305,180,69,251,25,226
"2011","Chesterfield 004E","E01019571","Total",638,298,57,241,219,79,220,51,169
"2011","Chesterfield 005A","E01019532","Total",535,183,26,157,165,54,134,30,104
"2011","Chesterfield 005B","E01019533","Total",630,161,3,158,163,52,158,27,131
"2011","Chesterfield 005C","E01019534","Total",615,296,9,287,117,42,216,20,196
"2011","Chesterfield 005D","E01019535","Total",638,222,12,210,156,42,154,22,132
"2011","Chesterfield 005E","E01019536","Total",814,327,42,285,230,101,288,43,245
"2011","Chesterfield 006A","E01019549","Total",529,224,47,177,171,64,167,30,137
"2011","Chesterfield 006B","E01019550","Total",670,280,34,246,201,73,214,42,172
"2011","Chesterfield 006C","E01019551","Total",706,288,12,276,153,49,196,30,166
"2011","Chesterfield 006D","E01019552","Total",517,175,14,161,167,57,152,31,121
"2011","Chesterfield 006E","E01019567","Total",768,342,40,302,229,84,277,40,237
"2011","Chesterfield 007A","E01019537","Total",627,246,9,237,160,53,193,25,168
"2011","Chesterfield 007B","E01019569","Total",857,299,19,280,154,64,253,24,229
"2011","Chesterfield 007C","E01019570","Total",599,297,21,276,126,33,208,27,181
"2011","Chesterfield 007D","E01019580","Total",659,286,38,248,172,74,182,25,157
"2011","Chesterfield 007E","E01019581","Total",688,284,29,255,154,55,240,33,207
"2011","Chesterfield 008A","E01019557","Total",617,201,13,188,206,55,166,35,131
"2011","Chesterfield 008B","E01019558","Total",581,146,7,139,160,46,133,24,109
"2011","Chesterfield 008C","E01019559","Total",494,146,4,142,133,43,134,22,112
"2011","Chesterfield 008D","E01019560","Total",622,272,29,243,181,56,203,37,166
"2011","Chesterfield 008E","E01019561","Total",738,388,40,348,135,61,314,27,287
"2011","Chesterfield 008F","E01019562","Total",628,311,17,294,124,49,243,28,215
"2011","Chesterfield 009A","E01019539","Total",745,304,19,285,167,63,228,33,195
"2011","Chesterfield 009B","E01019540","Total",630,207,8,199,161,56,147,17,130
"2011","Chesterfield 009C","E01019555","Total",775,361,31,330,192,74,279,27,252
"2011","Chesterfield 009D","E01019590","Total",848,341,6,335,161,44,237,17,220
"2011","Chesterfield 009E","E01019591","Total",657,204,8,196,211,62,187,25,162
"2011","Chesterfield 010A","E01019538","Total",803,252,16,236,167,72,195,27,168
"2011","Chesterfield 010B","E01019554","Total",725,205,33,172,180,64,188,38,150
"2011","Chesterfield 010C","E01019556","Total",705,271,42,229,164,57,224,28,196
"2011","Chesterfield 010D","E01019579","Total",786,245,47,198,210,87,212,41,171
"2011","Chesterfield 010F","E01033387","Total",621,103,17,86,125,64,101,12,89
"2011","Chesterfield 010G","E01033388","Total",631,190,36,154,180,75,180,30,150
"2011","Chesterfield 011A","E01019586","Total",616,212,6,206,137,46,171,23,148
"2011","Chesterfield 011B","E01019587","Total",642,193,7,186,191,44,138,20,118
"2011","Chesterfield 011C","E01019588","Total",623,259,6,253,136,34,177,17,160
"2011","Chesterfield 011D","E01019589","Total",609,215,4,211,147,50,161,19,142
"2011","Chesterfield 011E","E01019592","Total",684,276,5,271,187,54,168,25,143
"2011","Chesterfield 011F","E01019593","Total",498,226,4,222,108,25,133,12,121
"2011","Chesterfield 012A","E01019545","Total",619,251,13,238,150,43,178,15,163
"2011","Chesterfield 012B","E01019546","Total",643,211,10,201,177,56,171,27,144
"2011","Chesterfield 012C","E01019547","Total",653,236,51,185,211,75,205,52,153
"2011","Chesterfield 012D","E01019548","Total",965,283,17,266,309,135,242,47,195
"2011","Chesterfield 012E","E01019582","Total",634,204,21,183,168,58,176,32,144
"2011","Chesterfield 012F","E01019583","Total",611,175,13,162,188,69,144,22,122
"2011","Chesterfield 012G","E01019585","Total",999,258,26,232,245,106,228,38,190
"2011","Chesterfield 013A","E01019575","Total",700,298,100,198,286,133,232,57,175
"2011","Chesterfield 013B","E01019576","Total",716,320,38,282,169,59,248,33,215
"2011","Chesterfield 013C","E01019577","Total",762,336,28,308,159,59,251,31,220
"2011","Chesterfield 013D","E01019578","Total",814,448,77,371,198,88,345,50,295
"2011","Derbyshire Dales 001A","E01019602","Total",841,297,13,284,190,67,208,31,177
"2011","Derbyshire Dales 001B","E01019614","Total",726,245,8,237,195,55,148,25,123
"2011","Derbyshire Dales 001C","E01019615","Total",937,334,9,325,239,77,234,26,208
"2011","Derbyshire Dales 001D","E01019631","Total",798,249,6,243,217,65,218,39,179
"2011","Derbyshire Dales 002A","E01019600","Total",762,284,11,273,146,37,195,17,178
"2011","Derbyshire Dales 002B","E01019604","Total",823,304,13,291,165,40,219,21,198
"2011","Derbyshire Dales 002C","E01019606","Total",780,310,4,306,156,61,200,18,182
"2011","Derbyshire Dales 002D","E01019618","Total",734,251,4,247,170,51,175,22,153
"2011","Derbyshire Dales 003A","E01019599","Total",653,275,8,267,140,41,181,24,157
"2011","Derbyshire Dales 003B","E01019601","Total",718,340,13,327,148,40,253,29,224
"2011","Derbyshire Dales 003C","E01019613","Total",687,202,9,193,175,48,186,31,155
"2011","Derbyshire Dales 003D","E01019617","Total",705,248,9,239,133,46,209,21,188
"2011","Derbyshire Dales 004A","E01019608","Total",774,307,23,284,200,80,252,33,219
"2011","Derbyshire Dales 004B","E01019610","Total",672,220,5,215,166,44,181,34,147
"2011","Derbyshire Dales 004C","E01019630","Total",783,234,11,223,223,67,189,29,160
"2011","Derbyshire Dales 005A","E01019609","Total",946,314,11,303,219,82,240,27,213
"2011","Derbyshire Dales 005B","E01019621","Total",547,164,9,155,138,46,144,24,120
"2011","Derbyshire Dales 005C","E01019622","Total",689,213,11,202,179,56,167,27,140
"2011","Derbyshire Dales 005D","E01019624","Total",529,179,6,173,135,35,112,10,102
"2011","Derbyshire Dales 005E","E01019627","Total",513,163,10,153,116,31,119,14,105
"2011","Derbyshire Dales 005F","E01019628","Total",498,201,12,189,117,42,125,24,101
"2011","Derbyshire Dales 006A","E01019619","Total",699,267,12,255,127,38,186,26,160
"2011","Derbyshire Dales 006B","E01019620","Total",683,192,12,180,164,45,163,18,145
"2011","Derbyshire Dales 006C","E01019623","Total",670,256,12,244,123,45,206,21,185
"2011","Derbyshire Dales 006D","E01019625","Total",677,323,53,270,223,95,283,59,224
"2011","Derbyshire Dales 006E","E01019626","Total",668,233,7,226,149,39,171,18,153
"2011","Derbyshire Dales 006F","E01019632","Total",732,249,11,238,170,49,173,17,156
"2011","Derbyshire Dales 007A","E01019633","Total",636,234,30,204,200,60,209,41,168
"2011","Derbyshire Dales 007B","E01019634","Total",660,218,10,208,158,58,181,22,159
"2011","Derbyshire Dales 007C","E01019635","Total",574,214,6,208,112,44,135,17,118
"2011","Derbyshire Dales 007D","E01019636","Total",712,249,18,231,168,69,204,25,179
"2011","Derbyshire Dales 008A","E01019595","Total",915,296,10,286,220,43,195,31,164
"2011","Derbyshire Dales 008B","E01019605","Total",781,212,16,196,209,69,184,29,155
"2011","Derbyshire Dales 008C","E01019611","Total",702,212,3,209,172,46,175,20,155
"2011","Derbyshire Dales 008D","E01019616","Total",758,265,9,256,195,65,186,30,156
"2011","Derbyshire Dales 009A","E01019594","Total",769,320,34,286,232,92,236,40,196
"2011","Derbyshire Dales 009B","E01019596","Total",708,297,12,285,193,63,232,20,212
"2011","Derbyshire Dales 009C","E01019597","Total",592,166,13,153,200,65,132,21,111
"2011","Derbyshire Dales 009D","E01019598","Total",727,196,39,157,247,92,159,38,121
"2011","Derbyshire Dales 010A","E01019603","Total",699,224,15,209,189,54,149,24,125
"2011","Derbyshire Dales 010B","E01019607","Total",765,236,5,231,207,60,179,23,156
"2011","Derbyshire Dales 010C","E01019612","Total",828,256,9,247,231,69,195,33,162
"2011","Derbyshire Dales 010D","E01019629","Total",674,185,16,169,208,49,162,36,126
"2011","Erewash 001A","E01019644","Total",714,287,37,250,164,86,228,31,197
"2011","Erewash 001B","E01019646","Total",631,226,70,156,237,90,173,47,126
"2011","Erewash 001C","E01019663","Total",689,405,98,307,211,99,300,57,243
"2011","Erewash 001D","E01019664","Total",494,214,63,151,190,83,164,40,124
"2011","Erewash 001E","E01019665","Total",631,267,34,233,149,63,215,31,184
"2011","Erewash 003A","E01019657","Total",774,290,44,246,218,95,229,38,191
"2011","Erewash 003B","E01019660","Total",853,263,22,241,217,91,213,33,180
"2011","Erewash 003C","E01019661","Total",605,203,33,170,160,77,160,20,140
"2011","Erewash 003D","E01019662","Total",773,325,48,277,197,113,226,38,188
"2011","Erewash 003E","E01019672","Total",729,264,42,222,203,78,189,31,158
"2011","Erewash 003F","E01019690","Total",550,170,28,142,166,79,120,18,102
"2011","Erewash 004A","E01019670","Total",751,236,20,216,239,57,181,31,150
"2011","Erewash 004B","E01019671","Total",784,274,6,268,175,60,208,26,182
"2011","Erewash 004C","E01019701","Total",935,364,22,342,215,75,275,33,242
"2011","Erewash 005A","E01019673","Total",516,198,7,191,134,44,147,19,128
"2011","Erewash 005B","E01019702","Total",753,231,6,225,209,61,171,24,147
"2011","Erewash 005C","E01019703","Total",651,175,11,164,178,62,148,29,119
"2011","Erewash 005D","E01019704","Total",630,211,5,206,153,44,173,17,156
"2011","Erewash 006A","E01019658","Total",794,191,41,150,272,119,179,46,133
"2011","Erewash 006B","E01019659","Total",712,166,12,154,234,68,143,41,102
"2011","Erewash 006C","E01019674","Total",513,191,16,175,136,52,139,11,128
"2011","Erewash 006D","E01019688","Total",648,246,45,201,185,81,202,32,170
"2011","Erewash 006E","E01019689","Total",643,217,21,196,188,62,176,30,146
"2011","Erewash 007A","E01019666","Total",612,239,50,189,218,81,199,41,158
"2011","Erewash 007B","E01019667","Total",692,280,47,233,217,99,226,47,179
"2011","Erewash 007C","E01019668","Total",673,377,45,332,168,69,307,39,268
"2011","Erewash 007D","E01019669","Total",690,286,11,275,161,46,211,30,181
"2011","Erewash 008A","E01019656","Total",501,174,6,168,118,40,125,17,108
"2011","Erewash 008B","E01019691","Total",642,198,17,181,212,71,161,33,128
"2011","Erewash 008C","E01019692","Total",655,280,48,232,201,74,217,46,171
"2011","Erewash 008D","E01019693","Total",847,276,53,223,250,87,220,46,174
"2011","Erewash 008E","E01019694","Total",496,162,3,159,117,38,120,19,101
"2011","Erewash 008F","E01019696","Total",585,213,6,207,133,43,144,20,124
"2011","Erewash 009A","E01019683","Total",549,183,10,173,145,45,133,26,107
"2011","Erewash 009B","E01019684","Total",694,168,8,160,197,74,138,19,119
"2011","Erewash 009C","E01019685","Total",662,226,8,218,139,56,177,18,159
"2011","Erewash 009D","E01019686","Total",606,220,4,216,155,49,157,17,140
"2011","Erewash 009E","E01019687","Total",664,305,32,273,180,58,258,37,221
"2011","Erewash 010A","E01019648","Total",648,208,24,184,197,80,176,27,149
"2011","Erewash 010B","E01019649","Total",795,202,30,172,239,106,190,44,146
"2011","Erewash 010C","E01019650","Total",748,365,67,298,228,90,279,54,225
"2011","Erewash 010D","E01019651","Total",621,214,24,190,181,57,148,24,124
"2011","Erewash 010E","E01019695","Total",602,153,16,137,168,63,122,28,94
"2011","Erewash 011A","E01019641","Total",620,220,1,219,131,41,142,13,129
"2011","Erewash 011B","E01019652","Total",640,169,20,149,213,65,144,27,117
"2011","Erewash 011C","E01019653","Total",595,197,7,190,141,50,129,21,108
"2011","Erewash 011D","E01019707","Total",635,130,16,114,201,66,127,21,106
"2011","Erewash 011E","E01019708","Total",634,170,5,165,216,68,146,28,118
"2011","Erewash 012A","E01019647","Total",972,346,71,275,267,125,250,43,207
"2011","Erewash 012B","E01019675","Total",752,257,38,219,214,107,222,42,180
"2011","Erewash 012C","E01019679","Total",742,215,46,169,230,107,158,40,118
"2011","Erewash 012D","E01019682","Total",793,298,36,262,169,85,262,31,231
"2011","Erewash 013A","E01019642","Total",641,261,7,254,153,52,204,21,183
"2011","Erewash 013B","E01019643","Total",709,271,12,259,173,60,171,25,146
"2011","Erewash 013C","E01019654","Total",708,243,18,225,178,58,194,28,166
"2011","Erewash 013D","E01019655","Total",675,176,31,145,214,85,154,31,123
"2011","Erewash 014A","E01019676","Total",653,208,24,184,198,78,172,29,143
"2011","Erewash 014B","E01019677","Total",637,218,13,205,142,52,164,21,143
"2011","Erewash 014C","E01019678","Total",670,114,15,99,231,75,113,28,85
"2011","Erewash 014D","E01019680","Total",653,188,18,170,191,76,159,24,135
"2011","Erewash 014E","E01019681","Total",680,245,9,236,141,44,194,21,173
"2011","Erewash 014F","E01019698","Total",612,159,9,150,151,46,127,19,108
"2011","Erewash 015A","E01019697","Total",624,220,28,192,192,63,135,25,110
"2011","Erewash 015B","E01019699","Total",725,383,50,333,190,78,284,43,241
"2011","Erewash 015C","E01019700","Total",1006,353,26,327,265,94,262,33,229
"2011","Erewash 015D","E01019705","Total",800,210,22,188,231,102,171,27,144
"2011","Erewash 015E","E01019706","Total",512,165,8,157,154,58,129,22,107
"2011","Erewash 015F","E01019709","Total",527,162,39,123,196,76,131,29,102
"2011","Erewash 016A","E01019638","Total",513,136,7,129,174,60,132,29,103
"2011","Erewash 016B","E01019639","Total",428,124,25,99,156,60,94,27,67
"2011","Erewash 016C","E01019640","Total",586,78,11,67,228,93,92,26,66
"2011","Erewash 016D","E01019645","Total",702,255,18,237,176,73,207,24,183
"2011","Erewash 016E","E01032614","Total",493,65,7,58,201,62,85,20,65
"2011","High Peak 001A","E01019733","Total",650,222,20,202,183,68,190,36,154
"2011","High Peak 001B","E01019752","Total",557,130,27,103,208,74,132,38,94
"2011","High Peak 001C","E01019753","Total",627,139,18,121,192,66,142,32,110
"2011","High Peak 001D","E01019763","Total",917,261,29,232,274,97,255,43,212
"2011","High Peak 002A","E01019728","Total",518,262,57,205,198,93,221,50,171
"2011","High Peak 002B","E01019729","Total",528,230,67,163,206,90,181,47,134
"2011","High Peak 002C","E01019730","Total",850,303,49,254,275,109,263,54,209
"2011","High Peak 002D","E01019731","Total",490,120,9,111,184,69,101,26,75
"2011","High Peak 002E","E01019732","Total",608,198,21,177,180,68,168,38,130
"2011","High Peak 003A","E01019738","Total",614,154,14,140,176,62,133,22,111
"2011","High Peak 003B","E01019739","Total",821,292,29,263,168,83,239,28,211
"2011","High Peak 003C","E01019740","Total",526,138,13,125,156,61,112,21,91
"2011","High Peak 003D","E01019750","Total",577,215,26,189,155,50,179,21,158
"2011","High Peak 003E","E01019751","Total",881,211,14,197,337,132,185,43,142
"2011","High Peak 003F","E01019768","Total",1044,432,59,373,264,122,349,44,305
"2011","High Peak 004A","E01019727","Total",756,318,6,312,162,43,195,21,174
"2011","High Peak 004B","E01019749","Total",492,135,6,129,155,42,105,17,88
"2011","High Peak 004C","E01019754","Total",774,249,7,242,183,52,208,25,183
"2011","High Peak 004D","E01019756","Total",636,106,6,100,301,102,113,30,83
"2011","High Peak 004E","E01019757","Total",550,150,8,142,162,47,132,16,116
"2011","High Peak 004F","E01019758","Total",587,139,10,129,189,61,121,30,91
"2011","High Peak 005A","E01019746","Total",693,193,15,178,195,66,142,26,116
"2011","High Peak 005B","E01019747","Total",518,150,5,145,124,33,139,21,118
"2011","High Peak 005C","E01019748","Total",665,147,14,133,178,82,144,19,125
"2011","High Peak 005D","E01019755","Total",838,193,3,190,217,66,195,45,150
"2011","High Peak 005E","E01019766","Total",614,179,16,163,165,51,148,20,128
"2011","High Peak 006A","E01019711","Total",593,164,13,151,147,69,155,23,132
"2011","High Peak 006B","E01019734","Total",911,290,13,277,244,85,229,26,203
"2011","High Peak 006C","E01019743","Total",587,222,37,185,178,59,201,34,167
"2011","High Peak 006D","E01019744","Total",645,220,16,204,162,55,167,23,144
"2011","High Peak 006E","E01019745","Total",491,190,20,170,133,56,153,19,134
"2011","High Peak 008A","E01019712","Total",607,170,7,163,170,62,144,22,122
"2011","High Peak 008B","E01019713","Total",429,146,8,138,103,33,97,5,92
"2011","High Peak 008C","E01019764","Total",655,226,7,219,206,69,186,32,154
"2011","High Peak 008D","E01019765","Total",859,236,17,219,222,81,199,28,171
"2011","High Peak 008E","E01019767","Total",666,215,18,197,192,66,144,23,121
"2011","High Peak 010A","E01019710","Total",902,323,22,301,199,83,241,29,212
"2011","High Peak 010B","E01019715","Total",702,217,33,184,155,69,164,24,140
"2011","High Peak 010C","E01019717","Total",678,325,14,311,86,34,234,11,223
"2011","High Peak 010D","E01019722","Total",734,190,15,175,250,80,158,44,114
"2011","High Peak 010E","E01019723","Total",893,427,14,413,120,41,285,19,266
"2011","High Peak 011A","E01019716","Total",547,165,13,152,153,53,118,18,100
"2011","High Peak 011B","E01019724","Total",525,175,20,155,172,64,163,32,131
"2011","High Peak 011C","E01019759","Total",665,249,42,207,210,76,191,43,148
"2011","High Peak 011D","E01019760","Total",625,202,21,181,186,53,158,23,135
"2011","High Peak 011E","E01019761","Total",576,189,71,118,282,128,179,65,114
"2011","High Peak 012A","E01019714","Total",1016,270,19,251,351,131,232,48,184
"2011","High Peak 012B","E01019725","Total",581,143,9,134,166,53,128,29,99
"2011","High Peak 012C","E01019726","Total",544,145,14,131,186,74,133,22,111
"2011","High Peak 012D","E01019762","Total",771,320,3,317,185,42,206,30,176
"2011","High Peak 013E","E01019718","Total",950,268,22,246,277,102,232,36,196
"2011","High Peak 013F","E01019719","Total",678,230,30,200,190,72,178,34,144
"2011","High Peak 013G","E01019720","Total",663,246,7,239,141,44,221,23,198
"2011","High Peak 013H","E01019721","Total",470,140,5,135,137,31,99,18,81
"2011","High Peak 013A","E01019735","Total",655,222,7,215,163,59,158,21,137
"2011","High Peak 013B","E01019736","Total",504,122,4,118,116,34,104,13,91
"2011","High Peak 013C","E01019737","Total",559,237,7,230,115,35,176,26,150
"2011","High Peak 013I","E01019741","Total",466,146,7,139,125,44,121,20,101
"2011","High Peak 013D","E01019742","Total",468,119,7,112,137,41,118,22,96
"2011","North East Derbyshire 001A","E01019801","Total",459,105,8,97,114,40,102,16,86
"2011","North East Derbyshire 001B","E01019802","Total",546,153,16,137,153,45,147,27,120
"2011","North East Derbyshire 001C","E01019803","Total",516,176,30,146,178,71,145,23,122
"2011","North East Derbyshire 001D","E01019804","Total",528,101,6,95,158,44,125,30,95
"2011","North East Derbyshire 001E","E01019805","Total",534,114,11,103,198,61,107,26,81
"2011","North East Derbyshire 001F","E01019806","Total",641,178,11,167,162,48,156,31,125
"2011","North East Derbyshire 001G","E01019807","Total",621,244,41,203,201,83,206,46,160
"2011","North East Derbyshire 002A","E01019778","Total",754,356,11,345,159,47,221,22,199
"2011","North East Derbyshire 002B","E01019779","Total",750,344,3,341,141,45,209,23,186
"2011","North East Derbyshire 002C","E01019790","Total",850,206,12,194,210,67,173,31,142
"2011","North East Derbyshire 002D","E01019816","Total",757,259,10,249,184,54,228,24,204
"2011","North East Derbyshire 004A","E01019780","Total",610,218,16,202,202,71,179,32,147
"2011","North East Derbyshire 004B","E01019781","Total",630,222,8,214,154,50,170,26,144
"2011","North East Derbyshire 004C","E01019782","Total",605,246,5,241,150,54,189,19,170
"2011","North East Derbyshire 004D","E01019786","Total",739,276,19,257,172,54,223,28,195
"2011","North East Derbyshire 004E","E01019827","Total",803,305,25,280,221,64,216,29,187
"2011","North East Derbyshire 005A","E01019770","Total",837,290,9,281,196,69,223,22,201
"2011","North East Derbyshire 005B","E01019787","Total",771,271,6,265,201,68,199,29,170
"2011","North East Derbyshire 005C","E01019788","Total",677,233,7,226,169,52,162,22,140
"2011","North East Derbyshire 005D","E01019794","Total",595,251,3,248,124,39,143,25,118
"2011","North East Derbyshire 006A","E01019783","Total",520,160,4,156,152,46,99,13,86
"2011","North East Derbyshire 006B","E01019784","Total",504,139,5,134,153,54,113,16,97
"2011","North East Derbyshire 006C","E01019785","Total",516,162,6,156,148,36,113,19,94
"2011","North East Derbyshire 006D","E01019793","Total",638,244,4,240,134,40,157,17,140
"2011","North East Derbyshire 006E","E01019795","Total",958,332,18,314,302,116,257,40,217
"2011","North East Derbyshire 007A","E01019798","Total",603,207,10,197,143,55,180,18,162
"2011","North East Derbyshire 007B","E01019821","Total",608,242,15,227,123,45,194,23,171
"2011","North East Derbyshire 007C","E01019822","Total",678,243,18,225,170,58,205,30,175
"2011","North East Derbyshire 007D","E01019823","Total",525,233,16,217,131,48,180,29,151
"2011","North East Derbyshire 008A","E01019771","Total",956,387,14,373,203,55,259,20,239
"2011","North East Derbyshire 008B","E01019772","Total",635,197,7,190,176,57,161,29,132
"2011","North East Derbyshire 008C","E01019828","Total",682,351,1,350,94,22,187,16,171
"2011","North East Derbyshire 008D","E01019829","Total",621,221,5,216,162,46,148,20,128
"2011","North East Derbyshire 009A","E01019796","Total",490,234,45,189,146,58,183,34,149
"2011","North East Derbyshire 009B","E01019797","Total",598,213,21,192,159,61,173,26,147
"2011","North East Derbyshire 009C","E01019799","Total",901,437,79,358,252,118,294,40,254
"2011","North East Derbyshire 009D","E01019800","Total",704,224,27,197,222,70,198,47,151
"2011","North East Derbyshire 009E","E01019808","Total",697,322,74,248,213,96,248,53,195
"2011","North East Derbyshire 009F","E01019826","Total",637,276,33,243,183,67,224,37,187
"2011","North East Derbyshire 010A","E01019769","Total",798,275,10,265,186,48,207,27,180
"2011","North East Derbyshire 010B","E01019774","Total",738,367,3,364,105,30,269,21,248
"2011","North East Derbyshire 010C","E01019824","Total",516,202,5,197,123,28,172,25,147
"2011","North East Derbyshire 010D","E01019830","Total",524,185,8,177,144,31,119,21,98
"2011","North East Derbyshire 010E","E01019831","Total",587,158,6,152,167,68,122,17,105
"2011","North East Derbyshire 011A","E01019809","Total",534,231,17,214,97,22,200,27,173
"2011","North East Derbyshire 011B","E01019810","Total",697,248,30,218,151,66,225,31,194
"2011","North East Derbyshire 011C","E01019811","Total",673,202,8,194,176,54,190,27,163
"2011","North East Derbyshire 011D","E01019812","Total",781,227,12,215,201,81,204,30,174
"2011","North East Derbyshire 011E","E01019813","Total",746,277,28,249,226,98,217,42,175
"2011","North East Derbyshire 011F","E01019825","Total",547,153,7,146,181,61,130,24,106
"2011","North East Derbyshire 012A","E01019773","Total",1104,423,42,381,277,113,375,49,326
"2011","North East Derbyshire 012B","E01019775","Total",808,343,39,304,200,69,277,43,234
"2011","North East Derbyshire 012C","E01019776","Total",629,264,18,246,128,37,218,38,180
"2011","North East Derbyshire 012D","E01019777","Total",1063,473,80,393,321,130,353,63,290
"2011","North East Derbyshire 013A","E01019814","Total",756,276,8,268,175,57,209,23,186
"2011","North East Derbyshire 013B","E01019817","Total",523,239,34,205,160,65,186,35,151
"2011","North East Derbyshire 013C","E01019818","Total",644,261,47,214,211,76,199,33,166
"2011","North East Derbyshire 013D","E01019819","Total",629,200,9,191,138,60,154,21,133
"2011","North East Derbyshire 013E","E01019820","Total",618,225,21,204,134,49,158,22,136
"2011","North East Derbyshire 014A","E01019791","Total",748,284,36,248,207,61,219,28,191
"2011","North East Derbyshire 014B","E01019792","Total",879,357,38,319,240,75,286,44,242
"2011","North East Derbyshire 014C","E01019815","Total",1091,290,39,251,376,152,275,61,214
"2011","North East Derbyshire 014D","E01032586","Total",743,329,27,302,177,63,259,33,226
"2011","South Derbyshire 001A","E01019839","Total",681,126,11,115,245,66,107,31,76
"2011","South Derbyshire 001B","E01019845","Total",570,141,11,130,177,78,119,20,99
"2011","South Derbyshire 001C","E01019846","Total",553,192,17,175,153,49,154,26,128
"2011","South Derbyshire 001D","E01019866","Total",896,228,12,216,247,80,200,41,159
"2011","South Derbyshire 002A","E01019840","Total",666,265,21,244,203,66,186,24,162
"2011","South Derbyshire 002B","E01019841","Total",636,247,5,242,152,53,163,20,143
"2011","South Derbyshire 002C","E01019847","Total",590,220,11,209,164,54,161,29,132
"2011","South Derbyshire 002D","E01019848","Total",792,86,12,74,369,131,100,37,63
"2011","South Derbyshire 002F","E01033532","Total",554,67,18,49,257,110,71,37,34
"2011","South Derbyshire 002G","E01033533","Total",599,76,14,62,305,136,74,31,43
"2011","South Derbyshire 002H","E01033534","Total",493,33,11,22,163,96,42,17,25
"2011","South Derbyshire 003A","E01019873","Total",573,93,22,71,210,99,108,36,72
"2011","South Derbyshire 003B","E01019874","Total",589,157,14,143,163,65,151,28,123
"2011","South Derbyshire 003C","E01019875","Total",485,59,10,49,203,64,91,33,58
"2011","South Derbyshire 003D","E01019881","Total",573,193,5,188,136,42,138,18,120
"2011","South Derbyshire 003E","E01019882","Total",683,241,16,225,179,64,202,38,164
"2011","South Derbyshire 004A","E01019832","Total",803,243,9,234,165,56,177,18,159
"2011","South Derbyshire 004B","E01019833","Total",746,238,7,231,236,76,171,27,144
"2011","South Derbyshire 004C","E01019834","Total",646,219,6,213,187,48,166,17,149
"2011","South Derbyshire 004D","E01019835","Total",605,99,11,88,228,73,107,40,67
"2011","South Derbyshire 005A","E01019867","Total",618,188,3,185,132,43,133,11,122
"2011","South Derbyshire 005B","E01019868","Total",661,201,13,188,195,57,147,26,121
"2011","South Derbyshire 005C","E01019869","Total",538,165,8,157,148,53,103,18,85
"2011","South Derbyshire 005D","E01019880","Total",655,185,10,175,200,66,128,22,106
"2011","South Derbyshire 006A","E01019843","Total",673,221,14,207,166,49,179,13,166
"2011","South Derbyshire 006B","E01019853","Total",635,179,11,168,202,67,149,23,126
"2011","South Derbyshire 006C","E01019854","Total",860,330,14,316,193,77,245,32,213
"2011","South Derbyshire 006D","E01019855","Total",648,191,12,179,194,63,140,21,119
"2011","South Derbyshire 007A","E01019844","Total",662,297,37,260,182,75,208,39,169
"2011","South Derbyshire 007B","E01019856","Total",638,263,44,219,209,68,212,40,172
"2011","South Derbyshire 007C","E01019857","Total",479,84,15,69,196,64,84,30,54
"2011","South Derbyshire 007D","E01019858","Total",646,239,65,174,236,75,194,46,148
"2011","South Derbyshire 007E","E01019859","Total",716,243,10,233,180,56,187,24,163
"2011","South Derbyshire 008A","E01019860","Total",510,137,9,128,180,48,131,36,95
"2011","South Derbyshire 008B","E01019861","Total",766,234,23,211,220,85,227,48,179
"2011","South Derbyshire 008C","E01019862","Total",645,238,19,219,157,56,181,23,158
"2011","South Derbyshire 008D","E01019863","Total",732,329,57,272,213,85,238,42,196
"2011","South Derbyshire 008E","E01019864","Total",602,177,40,137,198,80,154,34,120
"2011","South Derbyshire 008F","E01019865","Total",520,136,22,114,180,88,137,29,108
"2011","South Derbyshire 009A","E01019876","Total",812,291,27,264,242,90,239,35,204
"2011","South Derbyshire 009B","E01019877","Total",789,330,27,303,170,66,262,30,232
"2011","South Derbyshire 009C","E01019878","Total",654,201,20,181,184,69,190,32,158
"2011","South Derbyshire 009D","E01019879","Total",754,170,9,161,209,61,178,31,147
"2011","South Derbyshire 011A","E01019850","Total",658,213,8,205,157,46,179,25,154
"2011","South Derbyshire 011B","E01019851","Total",673,215,28,187,191,74,190,35,155
"2011","South Derbyshire 011C","E01019852","Total",738,205,29,176,224,93,178,39,139
"2011","South Derbyshire 011D","E01019870","Total",649,234,19,215,165,52,186,27,159
"2011","South Derbyshire 011E","E01019871","Total",750,261,14,247,204,75,220,32,188
"2011","South Derbyshire 011F","E01019872","Total",828,249,15,234,212,88,222,24,198
"2011","South Derbyshire 012A","E01019837","Total",814,220,47,173,280,126,201,41,160
"2011","South Derbyshire 012B","E01019838","Total",734,270,41,229,217,98,232,43,189
"2011","South Derbyshire 012C","E01033531","Total",672,61,14,47,252,132,90,28,62
"2011","South Derbyshire 012D","E01033536","Total",672,141,28,113,256,115,145,38,107
"2011","South Derbyshire 012E","E01033537","Total",703,212,29,183,213,96,171,37,134
"2011","South Derbyshire 013A","E01019842","Total",666,281,71,210,243,92,218,55,163
"2011","South Derbyshire 013B","E01019883","Total",1206,280,50,230,428,228,279,65,214
"2011","South Derbyshire 013C","E01019885","Total",730,162,17,145,213,96,177,34,143
"2011","South Derbyshire 013D","E01033535","Total",553,75,17,58,252,95,101,37,64
"2011","Blaby 002A","E01025631","Total",491,141,13,128,170,75,114,23,91
"2011","Blaby 002B","E01025632","Total",470,45,3,42,259,75,51,24,27
"2011","Blaby 002C","E01025633","Total",717,199,4,195,201,89,160,30,130
"2011","Blaby 002D","E01025635","Total",483,148,5,143,133,38,113,18,95
"2011","Blaby 003A","E01025634","Total",535,137,4,133,188,65,113,22,91
"2011","Blaby 003B","E01025638","Total",636,278,3,275,148,43,174,17,157
"2011","Blaby 003C","E01025639","Total",533,210,5,205,129,38,126,16,110
"2011","Blaby 003D","E01025640","Total",658,221,15,206,204,77,134,22,112
"2011","Blaby 003E","E01025645","Total",462,114,2,112,139,40,104,15,89
"2011","Blaby 004A","E01025666","Total",628,223,21,202,176,78,193,32,161
"2011","Blaby 004B","E01025667","Total",490,163,6,157,136,56,133,16,117
"2011","Blaby 004C","E01025668","Total",945,132,26,106,357,205,136,46,90
"2011","Blaby 004D","E01025669","Total",840,55,20,35,329,187,94,27,67
"2011","Blaby 005A","E01025636","Total",607,261,14,247,137,50,171,16,155
"2011","Blaby 005B","E01025637","Total",554,170,16,154,164,62,136,21,115
"2011","Blaby 005C","E01025652","Total",505,119,11,108,166,64,114,23,91
"2011","Blaby 005D","E01025653","Total",668,209,19,190,207,83,180,35,145
"2011","Blaby 005E","E01025654","Total",512,199,10,189,149,58,148,29,119
"2011","Blaby 005F","E01025655","Total",619,180,17,163,191,73,157,32,125
"2011","Blaby 005G","E01025656","Total",496,129,13,116,167,62,115,20,95
"2011","Blaby 006A","E01025625","Total",569,229,38,191,169,69,172,25,147
"2011","Blaby 006B","E01025626","Total",567,130,16,114,149,68,110,14,96
"2011","Blaby 006C","E01025627","Total",897,260,28,232,299,111,206,40,166
"2011","Blaby 006D","E01025651","Total",645,172,5,167,210,60,144,20,124
"2011","Blaby 006E","E01025657","Total",808,266,10,256,205,71,238,28,210
"2011","Blaby 006F","E01025660","Total",681,217,11,206,208,69,156,21,135
"2011","Blaby 007A","E01025641","Total",786,226,10,216,207,80,156,25,131
"2011","Blaby 007B","E01025642","Total",841,233,21,212,274,99,169,29,140
"2011","Blaby 007C","E01025643","Total",632,154,19,135,231,79,115,30,85
"2011","Blaby 007D","E01025649","Total",673,206,6,200,178,60,136,17,119
"2011","Blaby 007E","E01025650","Total",570,93,12,81,261,75,87,33,54
"2011","Blaby 008A","E01025610","Total",660,226,23,203,204,76,176,29,147
"2011","Blaby 008B","E01025611","Total",609,213,13,200,180,62,151,22,129
"2011","Blaby 008C","E01025612","Total",691,264,11,253,176,63,195,39,156
"2011","Blaby 008D","E01025658","Total",736,154,17,137,249,80,153,29,124
"2011","Blaby 008E","E01025659","Total",857,299,7,292,185,72,222,26,196
"2011","Blaby 009A","E01025615","Total",557,81,7,74,267,82,92,26,66
"2011","Blaby 009B","E01025646","Total",752,242,22,220,227,99,187,31,156
"2011","Blaby 009C","E01025647","Total",712,229,21,208,202,89,196,24,172
"2011","Blaby 009D","E01025648","Total",732,100,7,93,345,119,108,36,72
"2011","Blaby 010A","E01025613","Total",619,239,6,233,155,41,178,24,154
"2011","Blaby 010B","E01025614","Total",696,163,12,151,246,96,136,28,108
"2011","Blaby 010C","E01025620","Total",470,167,11,156,140,59,113,21,92
"2011","Blaby 010D","E01025621","Total",448,132,5,127,108,47,106,16,90
"2011","Blaby 010E","E01025644","Total",569,150,17,133,180,64,132,20,112
"2011","Blaby 011A","E01025616","Total",638,190,4,186,210,64,132,27,105
"2011","Blaby 011B","E01025617","Total",731,240,4,236,196,55,166,28,138
"2011","Blaby 011C","E01025618","Total",735,272,9,263,202,66,190,27,163
"2011","Blaby 011D","E01025619","Total",693,220,8,212,171,62,157,20,137
"2011","Blaby 012A","E01025661","Total",678,122,15,107,265,105,119,29,90
"2011","Blaby 012B","E01025662","Total",698,254,28,226,183,63,175,23,152
"2011","Blaby 012C","E01025663","Total",582,176,10,166,170,62,133,33,100
"2011","Blaby 012D","E01025664","Total",544,197,6,191,110,35,145,13,132
"2011","Blaby 012E","E01025665","Total",644,227,9,218,155,51,149,30,119
"2011","Blaby 013A","E01025622","Total",760,279,18,261,188,78,186,27,159
"2011","Blaby 013B","E01025623","Total",680,247,12,235,170,63,172,18,154
"2011","Blaby 013C","E01025624","Total",685,149,10,139,225,70,137,37,100
"2011","Blaby 013D","E01025629","Total",648,261,16,245,167,61,189,22,167
"2011","Blaby 013E","E01025630","Total",695,250,5,245,183,66,174,22,152
"2011","Blaby 013F","E01032603","Total",649,285,11,274,118,30,175,21,154
"2011","Charnwood 001B","E01025692","Total",808,177,25,152,248,107,153,32,121
"2011","Charnwood 001C","E01025693","Total",849,268,16,252,194,67,193,17,176
"2011","Charnwood 001E","E01033386","Total",943,260,29,231,231,91,214,35,179
"2011","Charnwood 002A","E01025699","Total",813,443,47,396,132,55,318,28,290
"2011","Charnwood 002B","E01025700","Total",735,225,70,155,249,127,171,46,125
"2011","Charnwood 002C","E01025701","Total",676,241,36,205,193,105,213,38,175
"2011","Charnwood 002D","E01025703","Total",842,239,24,215,206,103,178,32,146
"2011","Charnwood 002E","E01025704","Total",587,161,17,144,134,62,130,21,109
"2011","Charnwood 002F","E01025705","Total",520,125,40,85,170,102,111,27,84
"2011","Charnwood 002G","E01025706","Total",752,236,28,208,211,118,223,40,183
"2011","Charnwood 003A","E01025720","Total",680,287,16,271,87,46,101,7,94
"2011","Charnwood 003B","E01025721","Total",565,256,12,244,68,30,134,15,119
"2011","Charnwood 003C","E01025722","Total",421,136,8,128,98,36,110,17,93
"2011","Charnwood 003D","E01025723","Total",616,225,33,192,127,65,122,30,92
"2011","Charnwood 003E","E01025724","Total",561,200,16,184,73,34,79,11,68
"2011","Charnwood 003F","E01025725","Total",606,300,35,265,147,67,242,28,214
"2011","Charnwood 004A","E01025695","Total",662,193,6,187,139,50,148,17,131
"2011","Charnwood 004B","E01025696","Total",541,133,11,122,177,65,114,23,91
"2011","Charnwood 004C","E01025697","Total",686,352,10,342,97,30,270,17,253
"2011","Charnwood 004D","E01025698","Total",651,175,14,161,176,56,145,27,118
"2011","Charnwood 005A","E01025744","Total",772,180,9,171,236,77,157,28,129
"2011","Charnwood 005B","E01025745","Total",635,230,12,218,143,46,165,19,146
"2011","Charnwood 005C","E01025746","Total",777,261,30,231,230,85,170,28,142
"2011","Charnwood 005D","E01025747","Total",796,264,29,235,244,108,211,36,175
"2011","Charnwood 006A","E01025740","Total",688,185,17,168,160,72,162,26,136
"2011","Charnwood 006B","E01025741","Total",643,158,3,155,174,63,132,24,108
"2011","Charnwood 006C","E01025742","Total",671,234,25,209,209,77,190,31,159
"2011","Charnwood 006D","E01025743","Total",811,197,12,185,213,87,161,24,137
"2011","Charnwood 007A","E01025689","Total",757,328,44,284,181,73,205,36,169
"2011","Charnwood 007B","E01025690","Total",538,219,47,172,178,77,141,38,103
"2011","Charnwood 007C","E01025707","Total",558,227,9,218,145,57,139,19,120
"2011","Charnwood 007D","E01025709","Total",475,176,4,172,134,37,92,13,79
"2011","Charnwood 008A","E01025760","Total",544,147,2,145,167,54,125,23,102
"2011","Charnwood 008B","E01025761","Total",721,161,9,152,249,91,124,27,97
"2011","Charnwood 008C","E01025768","Total",582,188,10,178,164,49,111,17,94
"2011","Charnwood 008D","E01025769","Total",574,158,9,149,180,61,100,20,80
"2011","Charnwood 009A","E01025702","Total",527,147,6,141,118,44,119,11,108
"2011","Charnwood 009B","E01025715","Total",599,188,49,139,218,90,143,45,98
"2011","Charnwood 009C","E01025716","Total",616,208,34,174,211,90,173,34,139
"2011","Charnwood 009D","E01025717","Total",807,223,72,151,331,157,169,51,118
"2011","Charnwood 009E","E01025718","Total",674,324,27,297,106,50,185,16,169
"2011","Charnwood 009F","E01025719","Total",601,219,11,208,156,62,131,21,110
"2011","Charnwood 010A","E01025708","Total",519,221,7,214,126,33,112,18,94
"2011","Charnwood 010B","E01025710","Total",502,190,1,189,135,42,134,18,116
"2011","Charnwood 010C","E01025711","Total",645,276,7,269,168,58,146,19,127
"2011","Charnwood 010D","E01025712","Total",599,271,11,260,139,41,176,26,150
"2011","Charnwood 010E","E01025713","Total",482,146,2,144,156,49,103,16,87
"2011","Charnwood 010F","E01025714","Total",795,106,16,90,332,128,106,30,76
"2011","Charnwood 011A","E01025674","Total",646,198,14,184,174,58,164,21,143
"2011","Charnwood 011B","E01025675","Total",670,196,10,186,174,68,158,24,134
"2011","Charnwood 011C","E01025676","Total",841,204,18,186,313,131,171,38,133
"2011","Charnwood 011D","E01025677","Total",609,234,17,217,160,64,187,18,169
"2011","Charnwood 012A","E01025732","Total",651,165,9,156,210,82,119,22,97
"2011","Charnwood 012B","E01025733","Total",712,242,9,233,166,53,165,17,148
"2011","Charnwood 012C","E01025734","Total",637,229,2,227,187,52,136,17,119
"2011","Charnwood 012D","E01025735","Total",873,269,9,260,193,85,216,23,193
"2011","Charnwood 013A","E01025748","Total",918,204,20,184,278,116,185,37,148
"2011","Charnwood 013B","E01025749","Total",625,230,39,191,202,81,178,36,142
"2011","Charnwood 013C","E01025750","Total",602,154,8,146,174,63,127,25,102
"2011","Charnwood 013D","E01025751","Total",891,196,29,167,277,132,156,28,128
"2011","Charnwood 014A","E01025726","Total",793,131,18,113,274,103,115,28,87
"2011","Charnwood 014B","E01025727","Total",680,222,39,183,210,98,187,39,148
"2011","Charnwood 014C","E01025728","Total",748,229,15,214,246,78,167,36,131
"2011","Charnwood 014D","E01025729","Total",665,157,9,148,222,75,95,18,77
"2011","Charnwood 014E","E01025737","Total",750,182,15,167,273,105,122,32,90
"2011","Charnwood 014F","E01025739","Total",645,247,5,242,128,47,145,16,129
"2011","Charnwood 015A","E01025685","Total",542,156,12,144,185,68,118,24,94
"2011","Charnwood 015B","E01025686","Total",542,110,9,101,187,59,106,31,75
"2011","Charnwood 015C","E01025730","Total",662,199,3,196,148,51,145,20,125
"2011","Charnwood 015D","E01025731","Total",644,237,4,233,157,38,175,18,157
"2011","Charnwood 016A","E01025687","Total",682,236,3,233,158,43,160,17,143
"2011","Charnwood 016B","E01025688","Total",665,211,14,197,189,80,149,23,126
"2011","Charnwood 016C","E01025736","Total",624,219,5,214,157,42,144,16,128
"2011","Charnwood 016D","E01025738","Total",575,175,5,170,177,42,120,26,94
"2011","Charnwood 017A","E01025756","Total",855,213,28,185,269,114,206,45,161
"2011","Charnwood 017B","E01025757","Total",550,82,23,59,224,93,92,30,62
"2011","Charnwood 017C","E01025758","Total",651,149,15,134,248,88,147,34,113
"2011","Charnwood 017D","E01025759","Total",722,324,11,313,131,41,227,6,221
"2011","Charnwood 018A","E01025752","Total",800,213,23,190,246,98,183,32,151
"2011","Charnwood 018B","E01025753","Total",688,278,32,246,185,77,213,23,190
"2011","Charnwood 018C","E01025754","Total",522,144,7,137,144,46,95,17,78
"2011","Charnwood 018D","E01025755","Total",617,169,5,164,187,54,144,27,117
"2011","Charnwood 019A","E01025679","Total",989,325,38,287,348,150,212,54,158
"2011","Charnwood 019B","E01025680","Total",656,229,8,221,207,68,152,25,127
"2011","Charnwood 019C","E01025681","Total",662,232,12,220,159,54,167,21,146
"2011","Charnwood 019D","E01025682","Total",637,271,13,258,130,35,184,26,158
"2011","Charnwood 020A","E01025678","Total",652,173,7,166,237,74,134,29,105
"2011","Charnwood 020B","E01025683","Total",674,211,24,187,238,83,184,32,152
"2011","Charnwood 020C","E01025684","Total",772,232,16,216,270,92,206,39,167
"2011","Charnwood 021A","E01025762","Total",647,199,17,182,170,85,155,20,135
"2011","Charnwood 021B","E01025763","Total",715,256,15,241,174,73,192,24,168
"2011","Charnwood 021C","E01025764","Total",504,156,9,147,159,50,143,34,109
"2011","Charnwood 021D","E01025765","Total",606,217,15,202,177,68,164,28,136
"2011","Charnwood 021E","E01025766","Total",859,238,49,189,287,125,231,56,175
"2011","Charnwood 021F","E01025767","Total",613,175,19,156,159,42,155,29,126
"2011","Charnwood 022A","E01025670","Total",534,200,22,178,156,52,155,31,124
"2011","Charnwood 022B","E01025671","Total",769,236,21,215,244,106,154,22,132
"2011","Charnwood 022C","E01025672","Total",739,228,17,211,212,72,185,28,157
"2011","Charnwood 022D","E01025673","Total",769,293,11,282,176,76,205,21,184
"2011","Harborough 002A","E01025770","Total",803,235,9,226,211,70,151,16,135
"2011","Harborough 002B","E01025809","Total",930,265,9,256,289,106,169,30,139
"2011","Harborough 002C","E01025815","Total",848,226,11,215,230,68,180,26,154
"2011","Harborough 003A","E01025781","Total",600,145,18,127,213,79,96,17,79
"2011","Harborough 003B","E01025782","Total",617,259,9,250,146,55,163,16,147
"2011","Harborough 003C","E01025783","Total",611,202,7,195,171,38,123,20,103
"2011","Harborough 003D","E01025785","Total",902,245,19,226,281,108,183,29,154
"2011","Harborough 003E","E01025786","Total",678,249,17,232,209,61,202,28,174
"2011","Harborough 003F","E01025787","Total",720,235,9,226,166,50,146,18,128
"2011","Harborough 004A","E01025772","Total",880,136,19,117,411,157,122,46,76
"2011","Harborough 004B","E01025773","Total",525,70,4,66,249,89,75,22,53
"2011","Harborough 004C","E01025774","Total",474,88,8,80,187,57,66,13,53
"2011","Harborough 004D","E01025775","Total",769,250,9,241,197,64,219,26,193
"2011","Harborough 004E","E01025776","Total",774,170,8,162,258,89,155,40,115
"2011","Harborough 005A","E01025771","Total",1026,256,17,239,306,113,224,43,181
"2011","Harborough 005B","E01025778","Total",801,163,12,151,288,88,158,29,129
"2011","Harborough 005C","E01025779","Total",623,135,14,121,227,66,117,36,81
"2011","Harborough 005D","E01025780","Total",524,134,3,131,164,52,117,17,100
"2011","Harborough 005E","E01025784","Total",531,129,6,123,169,39,86,14,72
"2011","Harborough 005F","E01025788","Total",465,107,8,99,130,39,94,15,79
"2011","Harborough 006A","E01025777","Total",910,228,6,222,239,67,181,31,150
"2011","Harborough 006B","E01025808","Total",1031,233,9,224,317,110,197,45,152
"2011","Harborough 006C","E01025810","Total",919,242,8,234,251,78,208,35,173
"2011","Harborough 006D","E01025816","Total",889,232,13,219,283,100,172,34,138
"2011","Harborough 007A","E01025789","Total",476,136,6,130,133,36,125,17,108
"2011","Harborough 007B","E01025794","Total",724,179,4,175,246,103,138,23,115
"2011","Harborough 007C","E01025797","Total",713,234,10,224,206,71,175,30,145
"2011","Harborough 007D","E01025802","Total",617,242,1,241,133,46,168,21,147
"2011","Harborough 007E","E01025803","Total",582,145,5,140,211,66,89,20,69
"2011","Harborough 007F","E01025805","Total",661,249,3,246,162,60,167,23,144
"2011","Harborough 008A","E01025795","Total",848,348,14,334,155,57,253,17,236
"2011","Harborough 008B","E01025796","Total",862,266,32,234,243,89,229,37,192
"2011","Harborough 008C","E01025801","Total",618,226,10,216,113,51,184,13,171
"2011","Harborough 008D","E01025806","Total",680,294,33,261,192,72,238,33,205
"2011","Harborough 009A","E01025798","Total",839,308,8,300,195,80,174,14,160
"2011","Harborough 009B","E01025799","Total",704,78,7,71,401,164,78,33,45
"2011","Harborough 009C","E01025800","Total",538,134,5,129,143,51,94,12,82
"2011","Harborough 009D","E01025804","Total",842,323,14,309,211,102,228,28,200
"2011","Harborough 009E","E01025807","Total",595,125,26,99,207,95,108,35,73
"2011","Harborough 010A","E01025790","Total",921,260,7,253,299,100,219,37,182
"2011","Harborough 010B","E01025791","Total",937,336,14,322,256,85,243,27,216
"2011","Harborough 010C","E01025792","Total",1095,394,16,378,238,89,324,27,297
"2011","Harborough 010D","E01025793","Total",987,242,21,221,347,127,210,44,166
"2011","Harborough 011A","E01025812","Total",728,268,16,252,190,62,192,35,157
"2011","Harborough 011B","E01025813","Total",598,188,5,183,201,48,147,34,113
"2011","Harborough 011C","E01025814","Total",622,217,4,213,173,56,141,19,122
"2011","Harborough 011D","E01032598","Total",861,274,12,262,246,82,190,35,155
"2011","Hinckley and Bosworth 001A","E01025868","Total",663,249,8,241,147,54,193,25,168
"2011","Hinckley and Bosworth 001B","E01025869","Total",750,284,9,275,141,48,182,13,169
"2011","Hinckley and Bosworth 001C","E01025870","Total",597,215,4,211,179,47,167,28,139
"2011","Hinckley and Bosworth 001D","E01025871","Total",524,164,12,152,132,42,148,20,128
"2011","Hinckley and Bosworth 001E","E01025878","Total",1034,254,25,229,358,151,238,52,186
"2011","Hinckley and Bosworth 002A","E01025846","Total",821,243,13,230,261,94,171,23,148
"2011","Hinckley and Bosworth 002B","E01025847","Total",654,109,10,99,225,83,99,22,77
"2011","Hinckley and Bosworth 002C","E01025848","Total",708,265,13,252,154,56,184,27,157
"2011","Hinckley and Bosworth 003A","E01025845","Total",642,229,5,224,170,46,151,26,125
"2011","Hinckley and Bosworth 003B","E01025877","Total",728,210,12,198,216,90,168,20,148
"2011","Hinckley and Bosworth 003C","E01025879","Total",525,172,18,154,161,59,155,27,128
"2011","Hinckley and Bosworth 003D","E01025880","Total",637,167,7,160,216,79,138,21,117
"2011","Hinckley and Bosworth 004A","E01025819","Total",710,240,18,222,198,57,185,31,154
"2011","Hinckley and Bosworth 004B","E01025820","Total",657,155,11,144,207,63,129,21,108
"2011","Hinckley and Bosworth 004C","E01025837","Total",834,221,10,211,241,68,178,25,153
"2011","Hinckley and Bosworth 004D","E01025838","Total",671,294,9,285,126,38,182,11,171
"2011","Hinckley and Bosworth 004E","E01025882","Total",690,208,10,198,192,63,131,25,106
"2011","Hinckley and Bosworth 005A","E01025872","Total",653,232,3,229,119,38,169,12,157
"2011","Hinckley and Bosworth 005B","E01025873","Total",651,166,10,156,169,48,144,19,125
"2011","Hinckley and Bosworth 005C","E01025874","Total",674,252,17,235,164,58,205,25,180
"2011","Hinckley and Bosworth 005D","E01025875","Total",658,267,26,241,178,79,191,20,171
"2011","Hinckley and Bosworth 005E","E01025876","Total",742,200,6,194,208,87,148,31,117
"2011","Hinckley and Bosworth 006A","E01025839","Total",698,178,31,147,201,75,133,28,105
"2011","Hinckley and Bosworth 006B","E01025840","Total",685,227,18,209,152,53,180,24,156
"2011","Hinckley and Bosworth 006C","E01025841","Total",763,296,14,282,163,68,204,27,177
"2011","Hinckley and Bosworth 006D","E01025842","Total",764,229,45,184,265,133,198,49,149
"2011","Hinckley and Bosworth 006E","E01025843","Total",729,232,27,205,176,73,173,24,149
"2011","Hinckley and Bosworth 006F","E01025844","Total",751,279,70,209,233,108,187,36,151
"2011","Hinckley and Bosworth 007A","E01025821","Total",796,179,22,157,215,112,160,22,138
"2011","Hinckley and Bosworth 007B","E01025822","Total",654,260,31,229,157,62,204,27,177
"2011","Hinckley and Bosworth 007C","E01025823","Total",639,190,41,149,211,86,151,30,121
"2011","Hinckley and Bosworth 007D","E01025824","Total",629,192,20,172,166,73,160,28,132
"2011","Hinckley and Bosworth 007E","E01025825","Total",607,178,11,167,158,57,153,25,128
"2011","Hinckley and Bosworth 007F","E01025826","Total",583,139,12,127,188,60,114,26,88
"2011","Hinckley and Bosworth 008A","E01025817","Total",834,274,7,267,213,56,211,22,189
"2011","Hinckley and Bosworth 008B","E01025818","Total",557,139,11,128,146,54,126,22,104
"2011","Hinckley and Bosworth 008C","E01025864","Total",639,131,5,126,229,74,120,19,101
"2011","Hinckley and Bosworth 008D","E01025881","Total",616,245,3,242,120,40,167,5,162
"2011","Hinckley and Bosworth 009A","E01025859","Total",579,170,6,164,166,37,135,19,116
"2011","Hinckley and Bosworth 009B","E01025860","Total",543,111,3,108,172,56,96,23,73
"2011","Hinckley and Bosworth 009C","E01025861","Total",748,210,9,201,195,65,177,31,146
"2011","Hinckley and Bosworth 009D","E01025862","Total",655,279,6,273,128,37,167,14,153
"2011","Hinckley and Bosworth 010A","E01025850","Total",626,185,12,173,171,61,156,26,130
"2011","Hinckley and Bosworth 010B","E01025852","Total",856,239,37,202,200,105,183,21,162
"2011","Hinckley and Bosworth 010C","E01025858","Total",905,226,21,205,210,105,174,29,145
"2011","Hinckley and Bosworth 010D","E01025863","Total",708,254,23,231,210,77,195,25,170
"2011","Hinckley and Bosworth 010E","E01025865","Total",775,241,31,210,234,106,208,34,174
"2011","Hinckley and Bosworth 011A","E01025853","Total",1152,215,42,173,419,205,170,42,128
"2011","Hinckley and Bosworth 011B","E01025854","Total",726,145,15,130,255,110,130,31,99
"2011","Hinckley and Bosworth 011C","E01025855","Total",598,145,17,128,176,68,113,21,92
"2011","Hinckley and Bosworth 011D","E01025866","Total",717,288,34,254,186,78,204,34,170
"2011","Hinckley and Bosworth 011E","E01025867","Total",665,179,14,165,186,72,138,29,109
"2011","Hinckley and Bosworth 012A","E01025849","Total",795,235,14,221,169,72,205,33,172
"2011","Hinckley and Bosworth 012B","E01025851","Total",521,173,12,161,162,61,112,16,96
"2011","Hinckley and Bosworth 012C","E01025856","Total",649,324,32,292,164,60,255,39,216
"2011","Hinckley and Bosworth 012D","E01025857","Total",599,126,11,115,186,77,116,14,102
"2011","Hinckley and Bosworth 013A","E01025827","Total",701,354,20,334,125,48,251,24,227
"2011","Hinckley and Bosworth 013B","E01025828","Total",617,236,5,231,146,39,162,22,140
"2011","Hinckley and Bosworth 013C","E01025829","Total",643,268,31,237,184,58,221,43,178
"2011","Hinckley and Bosworth 013D","E01025830","Total",658,237,16,221,180,80,169,16,153
"2011","Hinckley and Bosworth 014A","E01025831","Total",602,198,7,191,149,49,150,14,136
"2011","Hinckley and Bosworth 014B","E01025832","Total",614,135,5,130,219,64,95,18,77
"2011","Hinckley and Bosworth 014C","E01025833","Total",673,212,20,192,197,65,160,24,136
"2011","Hinckley and Bosworth 014D","E01025834","Total",609,156,5,151,193,60,118,13,105
"2011","Hinckley and Bosworth 014E","E01025835","Total",715,294,6,288,147,36,166,13,153
"2011","Hinckley and Bosworth 014F","E01025836","Total",561,173,3,170,132,36,147,11,136
"2011","Melton 001A","E01025885","Total",738,214,6,208,229,84,171,20,151
"2011","Melton 001B","E01025886","Total",815,337,8,329,200,74,243,23,220
"2011","Melton 001C","E01025887","Total",791,220,13,207,193,53,181,26,155
"2011","Melton 001D","E01025890","Total",538,162,17,145,151,48,138,17,121
"2011","Melton 001E","E01025891","Total",545,136,9,127,171,63,114,20,94
"2011","Melton 001F","E01025892","Total",660,155,5,150,234,77,139,36,103
"2011","Melton 002A","E01025901","Total",793,352,5,347,165,48,212,20,192
"2011","Melton 002B","E01025902","Total",705,249,14,235,178,60,162,26,136
"2011","Melton 002C","E01025903","Total",837,180,15,165,209,98,147,21,126
"2011","Melton 002D","E01025904","Total",832,247,9,238,269,100,181,33,148
"2011","Melton 002E","E01025906","Total",648,114,10,104,273,82,105,33,72
"2011","Melton 003A","E01025883","Total",702,190,16,174,165,58,154,26,128
"2011","Melton 003B","E01025884","Total",752,211,17,194,239,97,192,29,163
"2011","Melton 003C","E01025888","Total",739,178,3,175,191,48,144,23,121
"2011","Melton 003D","E01025909","Total",808,211,12,199,208,74,178,26,152
"2011","Melton 004A","E01025896","Total",660,210,8,202,188,61,146,20,126
"2011","Melton 004B","E01025897","Total",941,286,48,238,276,142,216,34,182
"2011","Melton 004C","E01025898","Total",529,162,17,145,160,91,114,20,94
"2011","Melton 004D","E01025899","Total",489,98,16,82,137,48,80,15,65
"2011","Melton 004E","E01025900","Total",626,212,41,171,213,102,171,37,134
"2011","Melton 004F","E01025905","Total",716,283,54,229,232,112,214,38,176
"2011","Melton 005A","E01025893","Total",859,237,15,222,254,68,189,37,152
"2011","Melton 005B","E01025894","Total",804,366,22,344,140,43,270,25,245
"2011","Melton 005C","E01025895","Total",740,169,28,141,217,82,147,36,111
"2011","Melton 005D","E01025907","Total",696,226,39,187,239,97,194,45,149
"2011","Melton 005E","E01025908","Total",738,229,6,223,189,60,166,22,144
"2011","Melton 006A","E01025889","Total",720,206,5,201,181,52,172,25,147
"2011","Melton 006B","E01025910","Total",759,199,7,192,185,44,178,25,153
"2011","Melton 006C","E01025911","Total",644,173,11,162,175,57,136,21,115
"2011","Melton 006D","E01025912","Total",666,159,8,151,175,68,133,25,108
"2011","North West Leicestershire 001A","E01025924","Total",450,111,4,107,118,40,109,18,91
"2011","North West Leicestershire 001B","E01025925","Total",1190,303,20,283,274,113,264,38,226
"2011","North West Leicestershire 001C","E01025926","Total",649,187,13,174,200,64,148,34,114
"2011","North West Leicestershire 001D","E01025927","Total",669,223,28,195,193,61,181,35,146
"2011","North West Leicestershire 001E","E01025928","Total",618,149,6,143,187,66,119,26,93
"2011","North West Leicestershire 002A","E01025923","Total",590,195,13,182,153,55,153,22,131
"2011","North West Leicestershire 002B","E01025944","Total",625,178,9,169,178,55,136,24,112
"2011","North West Leicestershire 002C","E01025945","Total",666,239,14,225,144,62,162,20,142
"2011","North West Leicestershire 002D","E01025946","Total",717,256,19,237,170,73,195,18,177
"2011","North West Leicestershire 003A","E01025915","Total",553,194,3,191,137,50,135,19,116
"2011","North West Leicestershire 003B","E01025916","Total",652,175,11,164,175,63,133,17,116
"2011","North West Leicestershire 003C","E01025917","Total",854,190,22,168,301,139,152,36,116
"2011","North West Leicestershire 003D","E01025918","Total",693,250,35,215,214,96,218,43,175
"2011","North West Leicestershire 004A","E01025960","Total",621,212,8,204,142,63,159,21,138
"2011","North West Leicestershire 004B","E01025961","Total",640,215,8,207,145,58,175,17,158
"2011","North West Leicestershire 004C","E01025962","Total",594,239,38,201,157,58,189,23,166
"2011","North West Leicestershire 004D","E01025965","Total",583,181,2,179,126,38,164,21,143
"2011","North West Leicestershire 005A","E01025955","Total",576,194,5,189,152,50,127,27,100
"2011","North West Leicestershire 005B","E01025956","Total",484,158,18,140,133,44,118,24,94
"2011","North West Leicestershire 005C","E01025963","Total",624,161,14,147,193,70,139,24,115
"2011","North West Leicestershire 005D","E01025964","Total",661,192,11,181,199,56,129,27,102
"2011","North West Leicestershire 006A","E01025914","Total",531,158,6,152,194,48,104,16,88
"2011","North West Leicestershire 006B","E01025919","Total",589,199,17,182,193,75,160,32,128
"2011","North West Leicestershire 006C","E01025920","Total",657,249,20,229,206,74,191,43,148
"2011","North West Leicestershire 006D","E01025921","Total",721,284,12,272,172,52,205,21,184
"2011","North West Leicestershire 007A","E01025966","Total",643,245,31,214,191,71,191,33,158
"2011","North West Leicestershire 007B","E01025967","Total",736,331,11,320,148,47,219,19,200
"2011","North West Leicestershire 007C","E01025968","Total",778,194,8,186,227,88,160,29,131
"2011","North West Leicestershire 007D","E01025969","Total",809,221,15,206,228,97,201,26,175
"2011","North West Leicestershire 008A","E01025950","Total",731,283,43,240,241,97,213,36,177
"2011","North West Leicestershire 008B","E01025951","Total",691,172,12,160,239,68,150,33,117
"2011","North West Leicestershire 008C","E01025952","Total",650,271,18,253,142,45,207,17,190
"2011","North West Leicestershire 008D","E01025953","Total",468,160,24,136,146,53,127,17,110
"2011","North West Leicestershire 008E","E01025954","Total",605,155,19,136,212,73,148,30,118
"2011","North West Leicestershire 009A","E01025932","Total",541,216,57,159,197,82,201,45,156
"2011","North West Leicestershire 009B","E01025933","Total",538,174,24,150,170,55,144,30,114
"2011","North West Leicestershire 009C","E01025934","Total",646,279,85,194,230,91,203,44,159
"2011","North West Leicestershire 009D","E01025935","Total",544,277,7,270,88,22,163,16,147
"2011","North West Leicestershire 009E","E01025936","Total",559,272,13,259,128,31,211,21,190
"2011","North West Leicestershire 010A","E01025929","Total",833,192,20,172,293,115,172,35,137
"2011","North West Leicestershire 010B","E01025930","Total",727,204,36,168,212,93,180,40,140
"2011","North West Leicestershire 010C","E01025931","Total",789,244,34,210,220,103,202,31,171
"2011","North West Leicestershire 010D","E01025957","Total",776,222,36,186,281,128,194,38,156
"2011","North West Leicestershire 011B","E01025937","Total",668,195,13,182,193,76,166,26,140
"2011","North West Leicestershire 011C","E01025958","Total",652,163,25,138,229,98,131,31,100
"2011","North West Leicestershire 011D","E01025959","Total",874,287,16,271,257,91,224,36,188
"2011","North West Leicestershire 011E","E01033102","Total",649,97,12,85,241,137,125,29,96
"2011","North West Leicestershire 011F","E01033103","Total",638,105,9,96,262,79,114,30,84
"2011","North West Leicestershire 012A","E01025913","Total",918,275,10,265,253,81,216,31,185
"2011","North West Leicestershire 012B","E01025947","Total",758,250,8,242,200,81,202,30,172
"2011","North West Leicestershire 012C","E01025948","Total",676,150,35,115,282,105,126,32,94
"2011","North West Leicestershire 012D","E01025949","Total",722,284,46,238,215,93,204,45,159
"2011","North West Leicestershire 013A","E01025938","Total",532,160,4,156,147,60,140,15,125
"2011","North West Leicestershire 013B","E01025939","Total",794,204,24,180,271,120,162,35,127
"2011","North West Leicestershire 013C","E01025940","Total",837,246,27,219,258,96,206,48,158
"2011","North West Leicestershire 013D","E01025941","Total",630,191,8,183,167,62,166,28,138
"2011","North West Leicestershire 013E","E01025942","Total",698,192,8,184,229,70,168,32,136
"2011","North West Leicestershire 013F","E01025943","Total",811,309,37,272,222,70,252,37,215
"2011","Oadby and Wigston 003A","E01025970","Total",507,161,4,157,173,54,131,35,96
"2011","Oadby and Wigston 003B","E01025971","Total",478,188,13,175,148,39,157,30,127
"2011","Oadby and Wigston 003C","E01025972","Total",461,167,10,157,147,46,115,24,91
"2011","Oadby and Wigston 003D","E01025976","Total",575,256,19,237,159,55,203,29,174
"2011","Oadby and Wigston 003E","E01025977","Total",605,276,7,269,125,55,183,19,164
"2011","Oadby and Wigston 003F","E01025978","Total",684,270,15,255,157,57,182,19,163
"2011","Oadby and Wigston 005A","E01025992","Total",745,330,39,291,163,74,250,29,221
"2011","Oadby and Wigston 005B","E01025994","Total",578,216,37,179,215,75,196,51,145
"2011","Oadby and Wigston 005C","E01025997","Total",578,211,32,179,190,71,193,44,149
"2011","Oadby and Wigston 005D","E01025999","Total",625,214,37,177,192,91,149,27,122
"2011","Oadby and Wigston 005E","E01026005","Total",719,270,14,256,173,70,220,34,186
"2011","Oadby and Wigston 006A","E01025985","Total",589,282,3,279,98,31,181,11,170
"2011","Oadby and Wigston 006B","E01025986","Total",607,226,6,220,137,45,170,24,146
"2011","Oadby and Wigston 006C","E01025987","Total",633,180,37,143,218,93,151,30,121
"2011","Oadby and Wigston 006D","E01025988","Total",681,153,41,112,250,129,143,34,109
"2011","Oadby and Wigston 006E","E01025989","Total",746,218,39,179,231,103,196,40,156
"2011","Oadby and Wigston 007A","E01025990","Total",600,250,7,243,128,38,172,18,154
"2011","Oadby and Wigston 007B","E01025991","Total",573,182,9,173,168,42,151,23,128
"2011","Oadby and Wigston 007C","E01025993","Total",576,199,8,191,171,72,136,24,112
"2011","Oadby and Wigston 007D","E01025998","Total",742,148,8,140,212,78,117,23,94
"2011","Oadby and Wigston 007E","E01026000","Total",532,165,8,157,143,46,117,15,102
"2011","Oadby and Wigston 007F","E01026001","Total",590,158,6,152,143,49,133,21,112
"2011","Oadby and Wigston 008A","E01025995","Total",581,207,8,199,177,54,168,34,134
"2011","Oadby and Wigston 008B","E01026003","Total",651,242,19,223,184,67,179,26,153
"2011","Oadby and Wigston 008C","E01026004","Total",682,229,6,223,188,80,170,28,142
"2011","Oadby and Wigston 008D","E01032600","Total",794,285,13,272,220,70,219,43,176
"2011","Oadby and Wigston 008E","E01032601","Total",569,184,9,175,173,60,122,15,107
"2011","Oadby and Wigston 009A","E01025973","Total",474,107,7,100,200,53,127,48,79
"2011","Oadby and Wigston 009B","E01025974","Total",565,139,18,121,207,89,122,26,96
"2011","Oadby and Wigston 009C","E01025975","Total",503,172,10,162,198,56,123,30,93
"2011","Oadby and Wigston 009E","E01025979","Total",490,139,16,123,192,63,124,26,98
"2011","Oadby and Wigston 009D","E01025980","Total",449,148,8,140,167,42,133,31,102
"2011","Oadby and Wigston 009F","E01025981","Total",589,194,22,172,206,53,163,38,125
"2011","Oadby and Wigston 009G","E01025982","Total",607,73,8,65,319,82,98,55,43
"2011","Oadby and Wigston 009H","E01025983","Total",479,138,10,128,165,54,114,23,91
"2011","Oadby and Wigston 009I","E01025984","Total",482,117,5,112,202,40,132,32,100
"2011","Boston 001A","E01026007","Total",474,172,8,164,110,34,131,19,112
"2011","Boston 001B","E01026008","Total",527,205,7,198,111,33,173,18,155
"2011","Boston 001C","E01026009","Total",516,181,16,165,138,37,157,24,133
"2011","Boston 001D","E01026023","Total",589,255,24,231,124,47,171,24,147
"2011","Boston 001E","E01026024","Total",829,329,24,305,239,76,270,55,215
"2011","Boston 002A","E01026010","Total",631,289,72,217,235,122,228,37,191
"2011","Boston 002B","E01026011","Total",1111,337,86,251,441,224,279,64,215
"2011","Boston 002C","E01026030","Total",994,458,57,401,275,140,324,36,288
"2011","Boston 002D","E01026032","Total",784,254,26,228,257,111,208,33,175
"2011","Boston 002E","E01026037","Total",599,243,33,210,160,82,183,23,160
"2011","Boston 003A","E01026006","Total",1149,311,40,271,305,162,259,42,217
"2011","Boston 003B","E01026021","Total",767,273,7,266,186,78,195,20,175
"2011","Boston 003C","E01026025","Total",988,273,51,222,296,152,219,37,182
"2011","Boston 003D","E01026036","Total",687,169,14,155,161,71,146,24,122
"2011","Boston 004A","E01026012","Total",549,313,31,282,126,60,167,16,151
"2011","Boston 004B","E01026015","Total",643,143,12,131,205,86,113,17,96
"2011","Boston 004C","E01026026","Total",819,364,55,309,260,100,320,66,254
"2011","Boston 004D","E01026027","Total",761,219,16,203,236,99,173,35,138
"2011","Boston 004E","E01026028","Total",851,376,27,349,199,77,264,34,230
"2011","Boston 006A","E01026016","Total",987,391,35,356,247,78,291,45,246
"2011","Boston 006B","E01026033","Total",789,241,30,211,224,76,196,38,158
"2011","Boston 006C","E01026034","Total",793,327,26,301,197,72,224,44,180
"2011","Boston 007A","E01026017","Total",691,265,15,250,154,49,224,26,198
"2011","Boston 007B","E01026018","Total",715,259,16,243,144,44,205,29,176
"2011","Boston 007C","E01026019","Total",1161,452,83,369,388,179,361,67,294
"2011","Boston 007D","E01026020","Total",926,316,40,276,275,132,229,41,188
"2011","Boston 007E","E01026041","Total",613,285,19,266,146,59,199,20,179
"2011","Boston 008A","E01026013","Total",625,233,5,228,147,35,167,18,149
"2011","Boston 008B","E01026014","Total",799,283,25,258,246,101,209,29,180
"2011","Boston 008C","E01026022","Total",867,333,6,327,236,87,202,24,178
"2011","Boston 008D","E01026038","Total",573,174,6,168,142,48,137,21,116
"2011","Boston 008E","E01026040","Total",497,150,17,133,147,57,127,22,105
"2011","Boston 009A","E01026029","Total",1007,257,21,236,344,156,220,50,170
"2011","Boston 009B","E01026031","Total",618,252,7,245,118,37,172,19,153
"2011","Boston 009C","E01026035","Total",869,303,2,301,221,68,204,19,185
"2011","Boston 009D","E01026039","Total",493,178,8,170,125,42,121,15,106
"2011","East Lindsey 001A","E01026045","Total",861,393,14,379,156,46,251,26,225
"2011","East Lindsey 001B","E01026061","Total",503,166,9,157,135,40,112,16,96
"2011","East Lindsey 001C","E01026062","Total",525,172,18,154,159,63,125,22,103
"2011","East Lindsey 001D","E01026063","Total",555,235,8,227,120,29,144,17,127
"2011","East Lindsey 001E","E01026080","Total",853,309,18,291,196,59,223,32,191
"2011","East Lindsey 001F","E01026106","Total",500,179,8,171,119,34,118,18,100
"2011","East Lindsey 001G","E01026107","Total",484,120,4,116,138,40,114,26,88
"2011","East Lindsey 002A","E01026058","Total",913,314,23,291,253,99,215,26,189
"2011","East Lindsey 002B","E01026076","Total",932,320,13,307,210,63,279,37,242
"2011","East Lindsey 002C","E01026079","Total",843,366,34,332,215,71,239,37,202
"2011","East Lindsey 003A","E01026077","Total",503,209,19,190,139,47,163,25,138
"2011","East Lindsey 003B","E01026078","Total",472,165,19,146,141,55,136,21,115
"2011","East Lindsey 003C","E01026087","Total",490,221,50,171,189,80,144,30,114
"2011","East Lindsey 003D","E01026088","Total",548,210,10,200,142,49,125,19,106
"2011","East Lindsey 003E","E01026090","Total",610,235,21,214,148,46,159,30,129
"2011","East Lindsey 003F","E01026091","Total",477,144,4,140,126,50,107,13,94
"2011","East Lindsey 003G","E01026108","Total",1051,412,79,333,333,133,335,68,267
"2011","East Lindsey 004A","E01026081","Total",1175,414,42,372,277,133,299,43,256
"2011","East Lindsey 004C","E01026089","Total",971,393,28,365,199,66,241,35,206
"2011","East Lindsey 004D","E01032986","Total",593,210,23,187,117,52,153,17,136
"2011","East Lindsey 004E","E01032987","Total",640,208,21,187,161,77,148,25,123
"2011","East Lindsey 005A","E01026072","Total",888,535,43,492,168,58,313,31,282
"2011","East Lindsey 005B","E01026073","Total",943,565,48,517,188,66,384,42,342
"2011","East Lindsey 005C","E01026074","Total",966,607,44,563,154,57,405,43,362
"2011","East Lindsey 005D","E01026099","Total",889,380,28,352,195,53,293,43,250
"2011","East Lindsey 006A","E01026103","Total",1009,680,36,644,141,44,395,27,368
"2011","East Lindsey 006B","E01026104","Total",1086,738,43,695,164,65,381,40,341
"2011","East Lindsey 006C","E01026109","Total",1149,732,39,693,126,36,423,35,388
"2011","East Lindsey 007A","E01026071","Total",951,329,21,308,198,55,270,32,238
"2011","East Lindsey 007B","E01026082","Total",1003,434,13,421,193,52,289,27,262
"2011","East Lindsey 007C","E01026121","Total",1105,459,38,421,257,84,339,56,283
"2011","East Lindsey 008A","E01026042","Total",672,280,41,239,205,85,209,43,166
"2011","East Lindsey 008B","E01026043","Total",720,335,35,300,188,74,223,29,194
"2011","East Lindsey 008C","E01026044","Total",587,273,10,263,118,37,183,19,164
"2011","East Lindsey 008D","E01026113","Total",886,384,18,366,175,39,295,36,259
"2011","East Lindsey 008E","E01026117","Total",778,310,16,294,164,39,240,32,208
"2011","East Lindsey 009A","E01026060","Total",565,217,12,205,106,30,158,21,137
"2011","East Lindsey 009B","E01026068","Total",942,338,19,319,191,60,258,37,221
"2011","East Lindsey 009C","E01026070","Total",837,312,12,300,186,51,215,32,183
"2011","East Lindsey 009D","E01026105","Total",959,346,13,333,206,56,286,42,244
"2011","East Lindsey 010A","E01026048","Total",756,443,21,422,108,39,299,24,275
"2011","East Lindsey 010B","E01026049","Total",727,347,11,336,129,34,239,32,207
"2011","East Lindsey 010C","E01026050","Total",798,501,25,476,103,29,337,23,314
"2011","East Lindsey 010D","E01026069","Total",978,587,59,528,160,59,360,41,319
"2011","East Lindsey 011A","E01026064","Total",654,255,36,219,175,56,226,41,185
"2011","East Lindsey 011B","E01026065","Total",828,365,10,355,176,54,216,25,191
"2011","East Lindsey 011C","E01026066","Total",876,400,17,383,185,70,259,25,234
"2011","East Lindsey 011D","E01026067","Total",933,390,31,359,214,77,287,39,248
"2011","East Lindsey 012A","E01026084","Total",683,303,35,268,195,77,213,30,183
"2011","East Lindsey 012B","E01026085","Total",1094,585,30,555,175,89,373,30,343
"2011","East Lindsey 012C","E01026115","Total",802,427,37,390,175,59,301,46,255
"2011","East Lindsey 012D","E01026116","Total",713,289,31,258,198,68,197,31,166
"2011","East Lindsey 013A","E01026046","Total",531,228,17,211,120,45,182,16,166
"2011","East Lindsey 013B","E01026047","Total",588,284,2,282,85,28,185,14,171
"2011","East Lindsey 013C","E01026055","Total",485,225,11,214,101,27,157,21,136
"2011","East Lindsey 013D","E01026059","Total",452,189,13,176,98,33,136,25,111
"2011","East Lindsey 013E","E01026100","Total",808,290,41,249,249,103,205,40,165
"2011","East Lindsey 013F","E01026101","Total",590,297,27,270,142,59,216,27,189
"2011","East Lindsey 014A","E01026092","Total",630,251,41,210,184,70,219,43,176
"2011","East Lindsey 014B","E01026093","Total",852,414,50,364,175,94,293,31,262
"2011","East Lindsey 014C","E01026095","Total",483,203,26,177,141,55,128,27,101
"2011","East Lindsey 014D","E01026114","Total",730,339,29,310,158,65,240,30,210
"2011","East Lindsey 015A","E01026083","Total",795,425,68,357,232,94,313,67,246
"2011","East Lindsey 015B","E01026094","Total",836,461,45,416,173,60,331,45,286
"2011","East Lindsey 015C","E01026096","Total",614,185,10,175,204,72,146,31,115
"2011","East Lindsey 015D","E01026097","Total",771,450,26,424,124,35,300,26,274
"2011","East Lindsey 016A","E01026051","Total",525,165,9,156,132,50,139,24,115
"2011","East Lindsey 016B","E01026052","Total",644,239,15,224,195,105,182,39,143
"2011","East Lindsey 016C","E01026053","Total",763,177,46,131,344,165,148,59,89
"2011","East Lindsey 016D","E01026054","Total",725,284,37,247,203,71,229,42,187
"2011","East Lindsey 016E","E01026118","Total",777,403,8,395,151,55,255,27,228
"2011","East Lindsey 016F","E01026119","Total",502,264,4,260,90,23,151,11,140
"2011","East Lindsey 016G","E01026120","Total",663,324,28,296,157,55,215,27,188
"2011","East Lindsey 017A","E01026056","Total",474,166,10,156,117,31,118,19,99
"2011","East Lindsey 017B","E01026110","Total",644,297,24,273,146,36,218,31,187
"2011","East Lindsey 017C","E01026111","Total",652,269,28,241,172,47,201,40,161
"2011","East Lindsey 017D","E01026112","Total",502,262,60,202,148,59,168,37,131
"2011","East Lindsey 018A","E01026057","Total",825,300,19,281,190,44,221,36,185
"2011","East Lindsey 018B","E01026075","Total",927,378,25,353,197,53,288,41,247
"2011","East Lindsey 018C","E01026098","Total",880,346,18,328,211,56,237,32,205
"2011","East Lindsey 018D","E01026102","Total",946,349,36,313,256,83,268,56,212
"2011","Lincoln 001A","E01026149","Total",791,345,56,289,205,85,267,39,228
"2011","Lincoln 001B","E01026150","Total",766,400,60,340,185,80,300,45,255
"2011","Lincoln 001C","E01026166","Total",537,228,36,192,161,62,176,30,146
"2011","Lincoln 001D","E01026168","Total",616,285,73,212,208,90,212,45,167
"2011","Lincoln 002A","E01026153","Total",1090,283,19,264,275,124,242,32,210
"2011","Lincoln 002B","E01026155","Total",744,149,3,146,193,87,150,29,121
"2011","Lincoln 002C","E01026157","Total",628,314,51,263,162,85,194,38,156
"2011","Lincoln 002D","E01026165","Total",715,357,37,320,150,74,256,27,229
"2011","Lincoln 003A","E01026125","Total",500,132,25,107,131,54,101,12,89
"2011","Lincoln 003B","E01026144","Total",628,181,17,164,109,46,138,14,124
"2011","Lincoln 003C","E01026147","Total",1025,224,16,208,245,127,173,36,137
"2011","Lincoln 003D","E01026148","Total",936,299,20,279,132,55,211,15,196
"2011","Lincoln 003E","E01026151","Total",835,257,14,243,198,96,198,26,172
"2011","Lincoln 003F","E01026164","Total",558,223,14,209,131,44,141,17,124
"2011","Lincoln 003G","E01026167","Total",775,304,5,299,112,32,168,12,156
"2011","Lincoln 004A","E01026122","Total",749,183,18,165,138,69,159,26,133
"2011","Lincoln 004B","E01026123","Total",1009,256,73,183,311,148,223,65,158
"2011","Lincoln 004C","E01026124","Total",645,156,29,127,174,91,132,31,101
"2011","Lincoln 004D","E01026126","Total",852,391,26,365,126,68,301,18,283
"2011","Lincoln 004E","E01026152","Total",565,244,89,155,268,128,180,55,125
"2011","Lincoln 004F","E01026154","Total",512,164,43,121,190,67,159,45,114
"2011","Lincoln 004G","E01026156","Total",474,151,40,111,198,77,125,41,84
"2011","Lincoln 005A","E01026132","Total",784,253,19,234,87,37,170,12,158
"2011","Lincoln 005B","E01026143","Total",711,150,10,140,103,49,118,12,106
"2011","Lincoln 005C","E01026145","Total",619,160,15,145,132,57,117,17,100
"2011","Lincoln 005D","E01026146","Total",726,305,18,287,66,36,217,13,204
"2011","Lincoln 006A","E01026134","Total",764,249,23,226,162,92,191,24,167
"2011","Lincoln 006B","E01026176","Total",890,323,36,287,128,73,266,33,233
"2011","Lincoln 006C","E01026177","Total",777,194,40,154,209,112,151,33,118
"2011","Lincoln 006D","E01026178","Total",771,228,25,203,159,83,165,22,143
"2011","Lincoln 007A","E01026127","Total",639,266,63,203,209,88,191,33,158
"2011","Lincoln 007B","E01026128","Total",1185,317,51,266,363,186,254,57,197
"2011","Lincoln 007C","E01026129","Total",705,306,141,165,338,169,206,67,139
"2011","Lincoln 007D","E01026131","Total",597,211,30,181,182,75,189,41,148
"2011","Lincoln 008A","E01026133","Total",995,255,43,212,246,130,194,36,158
"2011","Lincoln 008B","E01026135","Total",676,211,5,206,192,61,175,30,145
"2011","Lincoln 008C","E01026136","Total",616,216,5,211,166,58,173,23,150
"2011","Lincoln 008D","E01026174","Total",604,149,32,117,162,82,125,21,104
"2011","Lincoln 009A","E01026130","Total",588,206,8,198,124,46,140,24,116
"2011","Lincoln 009B","E01026158","Total",648,233,9,224,143,50,163,22,141
"2011","Lincoln 009C","E01026159","Total",643,132,18,114,197,71,137,29,108
"2011","Lincoln 009D","E01026160","Total",606,168,9,159,166,62,136,24,112
"2011","Lincoln 009E","E01026162","Total",621,233,23,210,161,63,185,30,155
"2011","Lincoln 009F","E01026163","Total",602,112,8,104,163,70,128,25,103
"2011","Lincoln 010A","E01026161","Total",675,288,35,253,148,54,239,34,205
"2011","Lincoln 010B","E01026170","Total",591,238,54,184,198,80,190,45,145
"2011","Lincoln 010C","E01026172","Total",575,232,47,185,190,77,183,36,147
"2011","Lincoln 010D","E01026173","Total",697,339,87,252,241,121,274,53,221
"2011","Lincoln 010E","E01026175","Total",883,273,47,226,251,128,221,33,188
"2011","Lincoln 011A","E01026137","Total",465,104,10,94,169,50,93,17,76
"2011","Lincoln 011B","E01026138","Total",618,166,10,156,173,56,159,29,130
"2011","Lincoln 011C","E01026139","Total",496,177,8,169,131,37,127,15,112
"2011","Lincoln 011D","E01026140","Total",624,199,27,172,159,72,175,18,157
"2011","Lincoln 011E","E01026141","Total",557,134,6,128,211,57,142,28,114
"2011","Lincoln 011F","E01026142","Total",508,166,33,133,182,65,136,35,101
"2011","Lincoln 011G","E01026169","Total",752,334,15,319,168,48,264,36,228
"2011","Lincoln 011H","E01026171","Total",667,283,3,280,122,42,170,23,147
"2011","North Kesteven 001A","E01026186","Total",690,259,3,256,155,38,170,21,149
"2011","North Kesteven 001B","E01026187","Total",750,114,7,107,304,82,122,41,81
"2011","North Kesteven 001C","E01026189","Total",809,349,7,342,160,49,219,24,195
"2011","North Kesteven 001D","E01026203","Total",802,318,11,307,175,57,208,26,182
"2011","North Kesteven 001E","E01026204","Total",738,295,5,290,164,45,200,27,173
"2011","North Kesteven 001F","E01026206","Total",780,222,7,215,241,87,184,33,151
"2011","North Kesteven 003B","E01026182","Total",579,156,4,152,179,58,109,16,93
"2011","North Kesteven 003C","E01026193","Total",615,203,9,194,158,37,147,13,134
"2011","North Kesteven 003D","E01026199","Total",954,312,12,300,259,71,237,41,196
"2011","North Kesteven 003E","E01026225","Total",678,153,9,144,233,79,150,32,118
"2011","North Kesteven 003F","E01026226","Total",812,354,2,352,137,34,237,13,224
"2011","North Kesteven 003G","E01032990","Total",919,74,22,52,394,209,135,57,78
"2011","North Kesteven 003H","E01032994","Total",556,143,8,135,162,50,117,19,98
"2011","North Kesteven 004A","E01026184","Total",508,73,6,67,284,161,110,44,66
"2011","North Kesteven 004B","E01026185","Total",810,362,12,350,171,48,247,24,223
"2011","North Kesteven 004C","E01026188","Total",1041,390,26,364,284,130,314,39,275
"2011","North Kesteven 004D","E01026190","Total",646,274,27,247,164,68,196,28,168
"2011","North Kesteven 004E","E01026237","Total",492,180,11,169,106,39,122,20,102
"2011","North Kesteven 004F","E01026238","Total",526,139,14,125,184,71,114,23,91
"2011","North Kesteven 005A","E01026191","Total",697,203,18,185,227,78,167,34,133
"2011","North Kesteven 005B","E01026205","Total",665,271,12,259,155,69,231,22,209
"2011","North Kesteven 005C","E01026211","Total",746,192,13,179,227,85,163,27,136
"2011","North Kesteven 005D","E01026212","Total",663,243,26,217,203,73,158,26,132
"2011","North Kesteven 005E","E01026213","Total",794,381,23,358,165,63,279,31,248
"2011","North Kesteven 006A","E01026192","Total",496,152,12,140,128,40,133,16,117
"2011","North Kesteven 006B","E01026194","Total",803,297,13,284,217,74,232,26,206
"2011","North Kesteven 006C","E01026195","Total",814,256,11,245,233,78,164,29,135
"2011","North Kesteven 006D","E01026196","Total",651,220,19,201,160,37,182,23,159
"2011","North Kesteven 007A","E01026180","Total",604,211,20,191,152,51,153,28,125
"2011","North Kesteven 007B","E01026183","Total",1096,451,50,401,288,88,345,59,286
"2011","North Kesteven 007C","E01026210","Total",957,305,17,288,236,77,228,42,186
"2011","North Kesteven 007D","E01026224","Total",763,358,45,313,211,61,271,38,233
"2011","North Kesteven 008A","E01026179","Total",437,88,8,80,198,107,83,22,61
"2011","North Kesteven 008B","E01026197","Total",605,185,12,173,144,48,162,22,140
"2011","North Kesteven 008C","E01026198","Total",446,35,10,25,235,126,61,30,31
"2011","North Kesteven 008D","E01026223","Total",899,335,10,325,233,73,252,31,221
"2011","North Kesteven 009A","E01026209","Total",961,438,11,427,192,44,295,33,262
"2011","North Kesteven 009B","E01026221","Total",1039,370,27,343,269,83,287,42,245
"2011","North Kesteven 009C","E01026222","Total",817,376,10,366,187,55,232,20,212
"2011","North Kesteven 010A","E01026227","Total",752,281,17,264,153,62,229,20,209
"2011","North Kesteven 010B","E01026230","Total",534,201,33,168,158,63,167,31,136
"2011","North Kesteven 010C","E01026231","Total",1091,250,27,223,377,123,203,41,162
"2011","North Kesteven 010D","E01026232","Total",1015,411,27,384,235,85,312,43,269
"2011","North Kesteven 010E","E01026235","Total",731,311,49,262,204,91,210,38,172
"2011","North Kesteven 011A","E01026228","Total",618,139,22,117,213,72,125,32,93
"2011","North Kesteven 011B","E01026229","Total",614,154,27,127,232,80,118,35,83
"2011","North Kesteven 011C","E01026233","Total",723,222,6,216,224,60,147,28,119
"2011","North Kesteven 011D","E01026234","Total",1051,233,17,216,397,111,190,52,138
"2011","North Kesteven 011E","E01026236","Total",524,240,8,232,119,43,167,14,153
"2011","North Kesteven 012A","E01026200","Total",696,206,12,194,190,60,148,22,126
"2011","North Kesteven 012B","E01026201","Total",858,351,37,314,238,69,253,55,198
"2011","North Kesteven 012C","E01026202","Total",852,429,6,423,163,49,289,22,267
"2011","North Kesteven 012D","E01026207","Total",523,204,18,186,118,36,162,31,131
"2011","North Kesteven 012E","E01026208","Total",662,192,11,181,199,60,139,26,113
"2011","North Kesteven 013A","E01026220","Total",1019,468,23,445,220,62,321,46,275
"2011","North Kesteven 013B","E01032988","Total",599,196,21,175,183,62,173,30,143
"2011","North Kesteven 013C","E01032989","Total",551,67,26,41,223,118,55,27,28
"2011","North Kesteven 013D","E01032993","Total",623,235,8,227,151,39,179,27,152
"2011","North Kesteven 014A","E01026214","Total",513,187,4,183,136,39,127,15,112
"2011","North Kesteven 014B","E01026215","Total",464,207,4,203,119,28,121,12,109
"2011","North Kesteven 014C","E01026218","Total",565,272,3,269,86,30,184,14,170
"2011","North Kesteven 014D","E01026219","Total",506,185,9,176,140,48,136,18,118
"2011","North Kesteven 014E","E01032991","Total",630,211,8,203,158,48,159,26,133
"2011","North Kesteven 014F","E01032992","Total",600,230,13,217,146,50,168,32,136
"2011","South Holland 001A","E01026242","Total",621,236,13,223,150,45,177,28,149
"2011","South Holland 001B","E01026243","Total",570,220,25,195,163,61,177,29,148
"2011","South Holland 001C","E01026244","Total",545,195,17,178,125,37,169,28,141
"2011","South Holland 001D","E01026247","Total",815,317,25,292,183,53,241,38,203
"2011","South Holland 001E","E01026276","Total",972,333,19,314,227,74,261,36,225
"2011","South Holland 002A","E01026246","Total",951,356,32,324,241,86,303,50,253
"2011","South Holland 002B","E01026248","Total",892,245,24,221,261,74,226,43,183
"2011","South Holland 002C","E01026257","Total",856,429,16,413,163,52,261,23,238
"2011","South Holland 003A","E01026250","Total",841,344,56,288,221,99,234,29,205
"2011","South Holland 003B","E01026251","Total",792,339,17,322,186,59,226,33,193
"2011","South Holland 003C","E01026252","Total",779,361,21,340,185,53,247,30,217
"2011","South Holland 003D","E01026253","Total",797,359,35,324,218,74,250,41,209
"2011","South Holland 004A","E01026281","Total",538,179,7,172,140,48,138,23,115
"2011","South Holland 004B","E01026282","Total",713,300,26,274,197,69,210,33,177
"2011","South Holland 004C","E01026283","Total",726,272,14,258,180,61,212,30,182
"2011","South Holland 004D","E01026285","Total",609,235,12,223,140,34,179,31,148
"2011","South Holland 004E","E01026286","Total",498,179,25,154,157,59,143,25,118
"2011","South Holland 005A","E01026241","Total",772,169,26,143,255,90,157,36,121
"2011","South Holland 005B","E01026258","Total",747,293,12,281,160,38,215,18,197
"2011","South Holland 005C","E01026259","Total",703,204,21,183,182,55,187,40,147
"2011","South Holland 005D","E01026260","Total",857,348,33,315,233,80,241,38,203
"2011","South Holland 006B","E01026266","Total",919,266,24,242,232,110,217,30,187
"2011","South Holland 006C","E01026273","Total",716,290,7,283,172,66,182,26,156
"2011","South Holland 006D","E01026274","Total",755,194,21,173,306,115,132,41,91
"2011","South Holland 006E","E01026275","Total",859,330,16,314,219,101,230,31,199
"2011","South Holland 006F","E01032995","Total",692,284,15,269,128,59,205,19,186
"2011","South Holland 006G","E01032996","Total",542,191,8,183,160,55,140,26,114
"2011","South Holland 007A","E01026268","Total",873,370,47,323,228,110,266,36,230
"2011","South Holland 007B","E01026269","Total",925,354,15,339,217,71,217,29,188
"2011","South Holland 007C","E01026270","Total",744,285,67,218,255,108,209,51,158
"2011","South Holland 007D","E01026271","Total",756,312,40,272,218,100,264,31,233
"2011","South Holland 007E","E01026272","Total",559,202,9,193,121,44,149,17,132
"2011","South Holland 008A","E01026254","Total",835,420,24,396,164,67,294,36,258
"2011","South Holland 008B","E01026255","Total",864,368,21,347,189,64,261,30,231
"2011","South Holland 008C","E01026256","Total",688,286,24,262,170,55,224,33,191
"2011","South Holland 008D","E01026277","Total",704,316,66,250,210,83,230,43,187
"2011","South Holland 008E","E01026278","Total",609,217,19,198,144,61,174,22,152
"2011","South Holland 008F","E01026279","Total",614,293,26,267,152,66,175,29,146
"2011","South Holland 009A","E01026262","Total",638,199,8,191,150,52,143,15,128
"2011","South Holland 009B","E01026263","Total",805,216,19,197,277,117,159,40,119
"2011","South Holland 009C","E01026264","Total",636,205,27,178,193,77,168,36,132
"2011","South Holland 009D","E01026265","Total",511,166,12,154,151,56,136,22,114
"2011","South Holland 009E","E01026267","Total",1177,324,29,295,371,169,265,56,209
"2011","South Holland 010A","E01026245","Total",933,401,19,382,191,59,304,39,265
"2011","South Holland 010B","E01026249","Total",773,252,17,235,174,55,211,32,179
"2011","South Holland 010C","E01026280","Total",1020,328,32,296,289,96,289,59,230
"2011","South Holland 011A","E01026239","Total",778,242,25,217,227,88,192,23,169
"2011","South Holland 011B","E01026240","Total",964,324,25,299,303,100,258,47,211
"2011","South Holland 011C","E01026284","Total",781,258,37,221,263,84,200,49,151
"2011","South Kesteven 001A","E01026313","Total",653,201,6,195,172,50,156,22,134
"2011","South Kesteven 001B","E01026314","Total",561,187,17,170,169,57,128,22,106
"2011","South Kesteven 001C","E01026329","Total",786,286,22,264,212,73,207,25,182
"2011","South Kesteven 001D","E01026333","Total",1017,282,19,263,326,91,224,43,181
"2011","South Kesteven 002A","E01026291","Total",840,307,10,297,212,69,213,27,186
"2011","South Kesteven 002B","E01026340","Total",966,395,26,369,253,82,291,51,240
"2011","South Kesteven 002C","E01026355","Total",999,364,18,346,277,80,264,34,230
"2011","South Kesteven 002D","E01026365","Total",993,398,7,391,233,59,239,20,219
"2011","South Kesteven 003A","E01026325","Total",613,251,44,207,215,73,218,48,170
"2011","South Kesteven 003B","E01026326","Total",609,223,23,200,182,75,181,27,154
"2011","South Kesteven 003C","E01026327","Total",610,258,25,233,150,36,203,37,166
"2011","South Kesteven 003D","E01026328","Total",600,270,68,202,231,90,222,50,172
"2011","South Kesteven 003E","E01026352","Total",561,229,8,221,126,37,180,21,159
"2011","South Kesteven 003F","E01026353","Total",857,376,26,350,161,65,270,15,255
"2011","South Kesteven 003G","E01026354","Total",489,151,5,146,123,43,113,18,95
"2011","South Kesteven 004A","E01026320","Total",654,170,5,165,221,50,120,23,97
"2011","South Kesteven 004B","E01026321","Total",537,168,2,166,145,45,133,16,117
"2011","South Kesteven 004C","E01026322","Total",534,173,3,170,108,34,128,15,113
"2011","South Kesteven 004D","E01026323","Total",948,376,25,351,190,70,313,26,287
"2011","South Kesteven 004E","E01026324","Total",885,201,13,188,313,96,178,33,145
"2011","South Kesteven 005A","E01026308","Total",596,247,98,149,274,133,160,50,110
"2011","South Kesteven 005B","E01026309","Total",693,205,29,176,211,92,150,28,122
"2011","South Kesteven 005C","E01026310","Total",454,152,35,117,176,83,106,27,79
"2011","South Kesteven 005D","E01026311","Total",666,210,36,174,238,97,189,37,152
"2011","South Kesteven 005E","E01026312","Total",452,152,89,63,265,105,138,69,69
"2011","South Kesteven 006A","E01026317","Total",978,275,49,226,275,126,178,22,156
"2011","South Kesteven 006B","E01026318","Total",856,240,59,181,307,145,194,49,145
"2011","South Kesteven 006C","E01026319","Total",932,278,19,259,234,92,206,29,177
"2011","South Kesteven 006D","E01026343","Total",909,272,30,242,232,100,244,35,209
"2011","South Kesteven 006E","E01026344","Total",682,171,15,156,188,68,154,35,119
"2011","South Kesteven 006F","E01026345","Total",628,255,38,217,188,65,190,31,159
"2011","South Kesteven 007A","E01026292","Total",618,149,8,141,170,66,157,22,135
"2011","South Kesteven 007B","E01026293","Total",844,196,21,175,284,119,170,33,137
"2011","South Kesteven 007C","E01026294","Total",647,100,13,87,254,114,98,32,66
"2011","South Kesteven 007D","E01026316","Total",1038,316,9,307,267,79,246,31,215
"2011","South Kesteven 007E","E01026332","Total",945,330,19,311,248,69,247,45,202
"2011","South Kesteven 008A","E01026290","Total",905,288,21,267,260,86,222,35,187
"2011","South Kesteven 008B","E01026341","Total",619,226,18,208,185,47,183,37,146
"2011","South Kesteven 008C","E01026342","Total",570,117,8,109,211,70,117,28,89
"2011","South Kesteven 008D","E01026361","Total",1130,392,36,356,325,100,311,55,256
"2011","South Kesteven 009A","E01026315","Total",922,328,23,305,217,71,235,31,204
"2011","South Kesteven 009B","E01026331","Total",1042,341,23,318,284,112,269,49,220
"2011","South Kesteven 009C","E01026338","Total",527,156,14,142,140,53,122,20,102
"2011","South Kesteven 009D","E01026339","Total",539,140,16,124,147,61,128,27,101
"2011","South Kesteven 010A","E01026299","Total",718,254,31,223,216,91,209,37,172
"2011","South Kesteven 010B","E01026300","Total",628,227,3,224,164,43,146,17,129
"2011","South Kesteven 010C","E01026301","Total",694,270,4,266,147,47,186,23,163
"2011","South Kesteven 010D","E01026302","Total",491,116,7,109,166,49,97,22,75
"2011","South Kesteven 011B","E01026296","Total",651,254,12,242,161,41,170,27,143
"2011","South Kesteven 011C","E01026297","Total",586,229,9,220,142,42,187,26,161
"2011","South Kesteven 011D","E01026298","Total",868,350,34,316,208,96,299,46,253
"2011","South Kesteven 011E","E01032997","Total",472,62,13,49,218,97,60,23,37
"2011","South Kesteven 011F","E01032998","Total",482,47,18,29,224,105,51,23,28
"2011","South Kesteven 011G","E01032999","Total",521,184,9,175,144,48,110,20,90
"2011","South Kesteven 012A","E01026330","Total",868,228,19,209,275,82,178,36,142
"2011","South Kesteven 012B","E01026360","Total",885,255,9,246,252,69,204,34,170
"2011","South Kesteven 012C","E01026362","Total",671,137,7,130,241,91,118,26,92
"2011","South Kesteven 012D","E01026363","Total",531,148,13,135,161,66,99,16,83
"2011","South Kesteven 012E","E01026364","Total",709,235,12,223,227,68,137,22,115
"2011","South Kesteven 013A","E01026334","Total",619,162,6,156,204,55,126,24,102
"2011","South Kesteven 013B","E01026335","Total",721,280,13,267,139,39,189,12,177
"2011","South Kesteven 013C","E01026336","Total",693,256,36,220,196,77,191,27,164
"2011","South Kesteven 013D","E01026337","Total",653,210,10,200,170,57,162,29,133
"2011","South Kesteven 014A","E01026303","Total",521,78,7,71,198,80,77,19,58
"2011","South Kesteven 014B","E01026304","Total",609,149,9,140,160,61,101,9,92
"2011","South Kesteven 014C","E01026305","Total",596,91,13,78,187,60,82,25,57
"2011","South Kesteven 014D","E01026306","Total",709,301,24,277,181,66,209,32,177
"2011","South Kesteven 014E","E01026307","Total",550,157,5,152,148,53,110,19,91
"2011","South Kesteven 015A","E01026287","Total",623,205,21,184,152,66,169,30,139
"2011","South Kesteven 015B","E01026288","Total",744,292,58,234,221,103,206,35,171
"2011","South Kesteven 015C","E01026289","Total",858,231,46,185,281,125,172,38,134
"2011","South Kesteven 015D","E01026346","Total",512,135,19,116,141,56,98,18,80
"2011","South Kesteven 015E","E01026347","Total",843,352,13,339,152,58,238,18,220
"2011","South Kesteven 015F","E01026348","Total",466,139,27,112,161,57,125,27,98
"2011","South Kesteven 016A","E01026349","Total",791,308,35,273,197,85,234,28,206
"2011","South Kesteven 016B","E01026350","Total",848,340,15,325,122,44,187,10,177
"2011","South Kesteven 016C","E01026351","Total",850,324,7,317,100,40,182,15,167
"2011","South Kesteven 016D","E01026356","Total",580,78,7,71,213,73,79,24,55
"2011","South Kesteven 016E","E01026357","Total",588,123,6,117,172,65,113,23,90
"2011","South Kesteven 016F","E01026358","Total",624,200,4,196,153,56,125,15,110
"2011","South Kesteven 016G","E01026359","Total",667,222,3,219,193,75,132,17,115
"2011","West Lindsey 001A","E01026367","Total",741,278,12,266,161,43,220,31,189
"2011","West Lindsey 001B","E01026368","Total",687,226,25,201,192,57,174,37,137
"2011","West Lindsey 001C","E01026387","Total",1089,308,18,290,301,81,247,39,208
"2011","West Lindsey 001D","E01026416","Total",552,191,15,176,144,35,128,14,114
"2011","West Lindsey 001G","E01032683","Total",998,326,11,315,230,61,250,39,211
"2011","West Lindsey 002A","E01026380","Total",736,217,28,189,247,84,188,41,147
"2011","West Lindsey 002B","E01026401","Total",621,192,8,184,177,50,152,28,124
"2011","West Lindsey 002C","E01026402","Total",828,274,14,260,211,67,206,27,179
"2011","West Lindsey 002D","E01026403","Total",558,164,8,156,155,49,161,26,135
"2011","West Lindsey 002E","E01026407","Total",558,180,12,168,160,45,165,25,140
"2011","West Lindsey 002F","E01026408","Total",580,221,8,213,132,34,174,22,152
"2011","West Lindsey 003A","E01026389","Total",784,292,27,265,185,74,221,30,191
"2011","West Lindsey 003B","E01026390","Total",841,358,22,336,210,75,274,40,234
"2011","West Lindsey 003C","E01026391","Total",818,296,12,284,183,66,228,25,203
"2011","West Lindsey 003D","E01026392","Total",1281,451,22,429,335,104,326,44,282
"2011","West Lindsey 003E","E01026415","Total",406,132,26,106,128,39,113,21,92
"2011","West Lindsey 004A","E01026378","Total",721,273,62,211,246,101,209,53,156
"2011","West Lindsey 004B","E01026379","Total",733,258,31,227,188,70,187,34,153
"2011","West Lindsey 004C","E01026381","Total",799,338,42,296,203,86,261,26,235
"2011","West Lindsey 004D","E01026382","Total",740,279,37,242,195,89,206,35,171
"2011","West Lindsey 004E","E01026383","Total",614,272,50,222,131,68,181,24,157
"2011","West Lindsey 004F","E01026384","Total",892,372,49,323,197,78,292,38,254
"2011","West Lindsey 005A","E01026385","Total",511,171,11,160,116,42,125,17,108
"2011","West Lindsey 005B","E01026386","Total",522,129,34,95,184,62,136,36,100
"2011","West Lindsey 005C","E01026399","Total",607,161,9,152,184,68,147,32,115
"2011","West Lindsey 005D","E01026411","Total",1045,324,22,302,244,81,248,37,211
"2011","West Lindsey 006A","E01026374","Total",641,307,90,217,244,122,190,31,159
"2011","West Lindsey 006B","E01026375","Total",664,277,66,211,226,101,192,38,154
"2011","West Lindsey 006C","E01026376","Total",778,362,70,292,230,101,245,37,208
"2011","West Lindsey 006D","E01026377","Total",898,311,50,261,312,105,247,50,197
"2011","West Lindsey 007A","E01026388","Total",933,361,11,350,217,50,269,36,233
"2011","West Lindsey 007B","E01026404","Total",962,311,18,293,236,71,273,35,238
"2011","West Lindsey 007C","E01026409","Total",511,142,9,133,126,42,128,28,100
"2011","West Lindsey 007D","E01026410","Total",746,401,8,393,123,34,222,16,206
"2011","West Lindsey 008A","E01026372","Total",1030,349,12,337,300,74,254,31,223
"2011","West Lindsey 008B","E01026412","Total",722,262,15,247,220,74,208,29,179
"2011","West Lindsey 008C","E01026413","Total",871,246,16,230,329,81,178,43,135
"2011","West Lindsey 008D","E01026414","Total",694,219,12,207,207,56,191,45,146
"2011","West Lindsey 009A","E01026396","Total",545,213,5,208,112,29,146,15,131
"2011","West Lindsey 009B","E01026397","Total",993,246,18,228,268,89,201,38,163
"2011","West Lindsey 009C","E01026398","Total",707,291,11,280,144,51,220,20,200
"2011","West Lindsey 009D","E01026400","Total",622,100,24,76,291,121,119,52,67
"2011","West Lindsey 010A","E01026393","Total",636,298,7,291,144,45,160,19,141
"2011","West Lindsey 010B","E01026394","Total",770,245,7,238,191,63,167,29,138
"2011","West Lindsey 010C","E01026395","Total",658,298,9,289,136,42,189,10,179
"2011","West Lindsey 010D","E01026405","Total",523,153,1,152,188,50,117,24,93
"2011","West Lindsey 010E","E01026406","Total",525,196,1,195,145,33,111,13,98
"2011","West Lindsey 011A","E01026366","Total",915,349,23,326,207,80,268,38,230
"2011","West Lindsey 011B","E01026369","Total",486,215,8,207,100,35,145,10,135
"2011","West Lindsey 011C","E01026370","Total",940,365,9,356,223,85,276,35,241
"2011","West Lindsey 011D","E01026371","Total",525,194,7,187,130,45,136,23,113
"2011","West Lindsey 011E","E01026373","Total",828,260,13,247,221,71,225,35,190
"2011","Corby 001A","E01026971","Total",739,256,30,226,237,100,203,34,169
"2011","Corby 001B","E01026979","Total",566,146,6,140,168,49,128,23,105
"2011","Corby 001C","E01026980","Total",652,189,3,186,169,47,153,24,129
"2011","Corby 001D","E01026982","Total",787,227,59,168,311,152,182,45,137
"2011","Corby 002A","E01026969","Total",802,365,20,345,179,70,276,32,244
"2011","Corby 002B","E01026970","Total",656,148,17,131,247,104,174,39,135
"2011","Corby 002C","E01026972","Total",766,221,48,173,287,125,188,41,147
"2011","Corby 002D","E01026976","Total",544,162,34,128,196,87,148,41,107
"2011","Corby 002E","E01026981","Total",480,149,12,137,124,49,112,14,98
"2011","Corby 002F","E01026983","Total",464,145,22,123,125,57,141,28,113
"2011","Corby 003A","E01026957","Total",727,249,19,230,161,69,206,21,185
"2011","Corby 003B","E01026958","Total",738,187,56,131,278,132,168,38,130
"2011","Corby 003C","E01026977","Total",838,266,19,247,216,88,207,27,180
"2011","Corby 003D","E01026978","Total",604,186,11,175,192,67,152,26,126
"2011","Corby 004A","E01026962","Total",602,219,26,193,171,75,193,27,166
"2011","Corby 004B","E01026973","Total",587,190,22,168,182,79,163,30,133
"2011","Corby 004C","E01026974","Total",476,167,10,157,122,41,128,19,109
"2011","Corby 004D","E01026975","Total",645,283,37,246,168,71,236,31,205
"2011","Corby 004E","E01026984","Total",752,281,22,259,212,98,245,46,199
"2011","Corby 004F","E01026985","Total",637,230,15,215,149,55,172,27,145
"2011","Corby 005A","E01026949","Total",613,259,27,232,140,48,216,32,184
"2011","Corby 005B","E01026950","Total",614,240,55,185,237,102,187,42,145
"2011","Corby 005C","E01026951","Total",495,164,30,134,197,74,138,30,108
"2011","Corby 005D","E01026952","Total",499,149,11,138,134,45,134,20,114
"2011","Corby 006A","E01026959","Total",646,218,41,177,190,84,197,42,155
"2011","Corby 006B","E01026960","Total",609,237,60,177,228,113,197,43,154
"2011","Corby 006C","E01026961","Total",502,151,52,99,198,84,134,42,92
"2011","Corby 006D","E01026965","Total",426,169,54,115,156,76,146,39,107
"2011","Corby 006E","E01026966","Total",564,212,43,169,180,67,180,43,137
"2011","Corby 006F","E01026967","Total",693,257,45,212,219,100,200,39,161
"2011","Corby 006G","E01026968","Total",611,283,78,205,198,112,204,55,149
"2011","Corby 008A","E01026953","Total",590,193,9,184,133,44,152,23,129
"2011","Corby 008B","E01026954","Total",534,157,36,121,185,73,168,36,132
"2011","Corby 008C","E01026955","Total",557,124,3,121,182,57,119,27,92
"2011","Corby 008D","E01026956","Total",818,204,23,181,268,114,211,41,170
"2011","Corby 009A","E01026963","Total",550,145,39,106,223,95,136,34,102
"2011","Corby 009B","E01032963","Total",613,72,12,60,241,109,90,34,56
"2011","Corby 009C","E01032964","Total",584,58,12,46,287,141,78,42,36
"2011","Corby 009D","E01032965","Total",492,41,11,30,231,151,61,30,31
"2011","Corby 009E","E01032966","Total",603,50,12,38,295,169,79,29,50
"2011","Corby 009F","E01032967","Total",540,54,27,27,305,176,65,32,33
"2011","Daventry 001A","E01027005","Total",823,196,6,190,270,79,173,40,133
"2011","Daventry 001B","E01027026","Total",794,212,7,205,235,82,146,23,123
"2011","Daventry 001C","E01027030","Total",731,216,8,208,202,46,195,40,155
"2011","Daventry 002A","E01027000","Total",608,188,19,169,193,72,160,28,132
"2011","Daventry 002B","E01027001","Total",510,70,7,63,249,57,75,30,45
"2011","Daventry 002C","E01027002","Total",638,158,7,151,192,69,125,23,102
"2011","Daventry 002D","E01027003","Total",593,138,9,129,183,60,117,17,100
"2011","Daventry 002E","E01027022","Total",745,201,12,189,199,62,177,29,148
"2011","Daventry 003A","E01026994","Total",453,159,7,152,102,23,123,18,105
"2011","Daventry 003D","E01026999","Total",776,276,11,265,186,73,179,32,147
"2011","Daventry 003E","E01027006","Total",745,202,7,195,256,69,152,29,123
"2011","Daventry 003F","E01032968","Total",909,296,14,282,236,73,204,34,170
"2011","Daventry 004A","E01026998","Total",742,195,10,185,173,43,145,16,129
"2011","Daventry 004B","E01027015","Total",522,175,5,170,144,42,117,14,103
"2011","Daventry 004C","E01027016","Total",616,148,7,141,187,57,121,25,96
"2011","Daventry 004D","E01027021","Total",768,199,10,189,220,81,144,25,119
"2011","Daventry 004E","E01027027","Total",903,216,13,203,361,106,180,46,134
"2011","Daventry 005A","E01026997","Total",682,217,9,208,197,66,158,25,133
"2011","Daventry 005B","E01027018","Total",623,225,6,219,148,37,146,13,133
"2011","Daventry 005C","E01027019","Total",652,212,10,202,164,57,169,21,148
"2011","Daventry 005D","E01027020","Total",535,222,11,211,125,27,130,13,117
"2011","Daventry 005E","E01027023","Total",824,236,17,219,253,74,186,38,148
"2011","Daventry 006A","E01026987","Total",516,177,16,161,133,33,144,21,123
"2011","Daventry 006B","E01026989","Total",592,120,29,91,234,100,111,36,75
"2011","Daventry 006C","E01026990","Total",1069,172,37,135,385,176,173,46,127
"2011","Daventry 006D","E01027012","Total",726,232,35,197,210,85,207,32,175
"2011","Daventry 006E","E01027014","Total",799,133,23,110,370,126,155,51,104
"2011","Daventry 007A","E01026986","Total",1134,258,52,206,474,221,244,72,172
"2011","Daventry 007B","E01026988","Total",596,195,57,138,240,103,159,48,111
"2011","Daventry 007C","E01026991","Total",759,342,4,338,97,36,245,13,232
"2011","Daventry 007D","E01026992","Total",931,415,35,380,177,90,301,30,271
"2011","Daventry 007E","E01027010","Total",489,165,11,154,116,48,116,19,97
"2011","Daventry 008A","E01027007","Total",536,139,32,107,203,92,115,26,89
"2011","Daventry 008B","E01027008","Total",888,217,15,202,227,97,171,33,138
"2011","Daventry 008C","E01027009","Total",595,201,47,154,232,111,182,52,130
"2011","Daventry 008D","E01027013","Total",715,249,82,167,305,135,216,63,153
"2011","Daventry 009A","E01027011","Total",820,240,12,228,189,74,166,22,144
"2011","Daventry 009B","E01027017","Total",670,250,17,233,165,59,215,30,185
"2011","Daventry 009C","E01027024","Total",714,166,1,165,194,69,161,26,135
"2011","Daventry 009D","E01027025","Total",751,251,23,228,197,87,197,20,177
"2011","Daventry 010A","E01026993","Total",824,266,4,262,202,51,200,27,173
"2011","Daventry 010B","E01027004","Total",773,231,10,221,206,81,199,28,171
"2011","Daventry 010C","E01027028","Total",887,193,15,178,267,82,171,31,140
"2011","Daventry 010D","E01027029","Total",671,192,30,162,229,86,155,35,120
"2011","East Northamptonshire 001A","E01027033","Total",802,257,24,233,203,80,186,25,161
"2011","East Northamptonshire 001B","E01027043","Total",805,240,18,222,228,64,192,29,163
"2011","East Northamptonshire 001C","E01027050","Total",791,233,13,220,241,88,189,34,155
"2011","East Northamptonshire 002A","E01027031","Total",832,196,13,183,256,83,174,31,143
"2011","East Northamptonshire 002B","E01027044","Total",839,242,10,232,238,79,191,20,171
"2011","East Northamptonshire 002C","E01027046","Total",513,129,7,122,195,50,98,16,82
"2011","East Northamptonshire 002D","E01027047","Total",561,187,6,181,134,45,163,19,144
"2011","East Northamptonshire 002E","E01027048","Total",614,216,10,206,162,43,145,19,126
"2011","East Northamptonshire 002F","E01027049","Total",439,179,5,174,103,29,99,15,84
"2011","East Northamptonshire 003A","E01027032","Total",779,212,13,199,207,65,160,27,133
"2011","East Northamptonshire 003B","E01027045","Total",819,251,15,236,208,73,206,31,175
"2011","East Northamptonshire 003C","E01027075","Total",804,163,21,142,332,126,146,42,104
"2011","East Northamptonshire 003D","E01027076","Total",926,285,17,268,275,105,216,22,194
"2011","East Northamptonshire 003E","E01027077","Total",736,118,7,111,297,101,131,27,104
"2011","East Northamptonshire 004A","E01027057","Total",718,197,14,183,198,76,157,17,140
"2011","East Northamptonshire 004B","E01027074","Total",858,249,15,234,268,93,168,33,135
"2011","East Northamptonshire 004C","E01027078","Total",888,282,11,271,235,75,207,42,165
"2011","East Northamptonshire 005A","E01027051","Total",750,228,29,199,226,86,196,32,164
"2011","East Northamptonshire 005B","E01027052","Total",576,140,12,128,186,72,122,23,99
"2011","East Northamptonshire 005C","E01027053","Total",624,156,9,147,167,51,139,23,116
"2011","East Northamptonshire 005D","E01027054","Total",515,169,4,165,118,36,137,18,119
"2011","East Northamptonshire 005E","E01027055","Total",465,129,8,121,144,48,120,23,97
"2011","East Northamptonshire 005F","E01027056","Total",625,209,34,175,207,73,192,46,146
"2011","East Northamptonshire 006A","E01027038","Total",675,235,44,191,203,75,186,43,143
"2011","East Northamptonshire 006B","E01027039","Total",737,209,20,189,230,106,170,37,133
"2011","East Northamptonshire 006C","E01027040","Total",707,184,10,174,192,89,142,24,118
"2011","East Northamptonshire 006D","E01027041","Total",728,279,53,226,204,87,198,35,163
"2011","East Northamptonshire 006E","E01027042","Total",721,115,17,98,278,117,131,39,92
"2011","East Northamptonshire 007A","E01027034","Total",739,290,12,278,178,60,226,29,197
"2011","East Northamptonshire 007B","E01027035","Total",588,215,37,178,175,66,180,35,145
"2011","East Northamptonshire 007D","E01027037","Total",836,189,12,177,321,140,147,34,113
"2011","East Northamptonshire 007E","E01033244","Total",925,173,13,160,357,167,185,40,145
"2011","East Northamptonshire 007F","E01033245","Total",423,101,4,97,132,49,84,13,71
"2011","East Northamptonshire 008A","E01027061","Total",757,252,45,207,251,101,185,37,148
"2011","East Northamptonshire 008B","E01027062","Total",929,279,48,231,293,119,213,47,166
"2011","East Northamptonshire 008C","E01027063","Total",730,188,16,172,211,84,142,20,122
"2011","East Northamptonshire 008D","E01027064","Total",641,197,5,192,160,66,124,27,97
"2011","East Northamptonshire 008E","E01027072","Total",608,215,73,142,262,121,173,54,119
"2011","East Northamptonshire 008F","E01027073","Total",889,298,28,270,256,116,246,41,205
"2011","East Northamptonshire 009A","E01027058","Total",622,246,48,198,182,88,179,35,144
"2011","East Northamptonshire 009B","E01027059","Total",750,220,38,182,231,112,170,32,138
"2011","East Northamptonshire 009C","E01027060","Total",845,292,34,258,214,94,228,29,199
"2011","East Northamptonshire 009D","E01027065","Total",847,272,29,243,209,100,220,28,192
"2011","East Northamptonshire 009E","E01027069","Total",805,320,15,305,146,60,257,21,236
"2011","East Northamptonshire 010A","E01027066","Total",808,206,7,199,294,114,164,27,137
"2011","East Northamptonshire 010B","E01027067","Total",675,269,5,264,154,56,175,17,158
"2011","East Northamptonshire 010C","E01027068","Total",1118,167,20,147,438,164,191,60,131
"2011","East Northamptonshire 010D","E01027070","Total",682,204,11,193,196,76,156,23,133
"2011","East Northamptonshire 010E","E01027071","Total",598,165,9,156,177,51,150,20,130
"2011","Kettering 001A","E01027090","Total",615,167,7,160,155,44,130,16,114
"2011","Kettering 001B","E01027103","Total",682,185,7,178,192,58,167,25,142
"2011","Kettering 001C","E01027129","Total",949,293,20,273,214,77,238,28,210
"2011","Kettering 002B","E01027094","Total",649,245,5,240,160,48,196,27,169
"2011","Kettering 002C","E01027095","Total",576,167,23,144,192,76,157,36,121
"2011","Kettering 002D","E01027107","Total",565,176,21,155,145,55,130,20,110
"2011","Kettering 002E","E01027108","Total",526,186,5,181,129,33,139,23,116
"2011","Kettering 002F","E01027109","Total",505,141,23,118,162,61,110,20,90
"2011","Kettering 002G","E01032969","Total",490,50,17,33,233,130,75,37,38
"2011","Kettering 002H","E01032970","Total",571,134,26,108,223,110,120,31,89
"2011","Kettering 002I","E01032971","Total",508,127,21,106,146,90,99,17,82
"2011","Kettering 003A","E01027123","Total",662,247,19,228,182,65,179,29,150
"2011","Kettering 003B","E01027124","Total",1003,322,49,273,276,111,261,47,214
"2011","Kettering 003C","E01027125","Total",709,203,18,185,221,73,155,30,125
"2011","Kettering 003D","E01027126","Total",992,351,54,297,247,127,246,38,208
"2011","Kettering 004A","E01027079","Total",739,196,23,173,247,102,175,35,140
"2011","Kettering 004B","E01027080","Total",752,191,10,181,226,87,180,34,146
"2011","Kettering 004C","E01027087","Total",495,127,16,111,152,62,117,23,94
"2011","Kettering 004D","E01027088","Total",482,83,9,74,203,69,92,30,62
"2011","Kettering 004E","E01027089","Total",809,205,24,181,279,134,181,41,140
"2011","Kettering 005A","E01027081","Total",613,217,44,173,210,93,182,47,135
"2011","Kettering 005B","E01027082","Total",703,209,59,150,232,105,178,39,139
"2011","Kettering 005C","E01027083","Total",648,309,84,225,218,99,217,39,178
"2011","Kettering 005D","E01027127","Total",780,349,78,271,271,93,298,78,220
"2011","Kettering 005E","E01027128","Total",676,243,61,182,251,104,177,36,141
"2011","Kettering 006A","E01027105","Total",918,203,25,178,261,139,196,44,152
"2011","Kettering 006B","E01027106","Total",876,240,43,197,268,143,168,32,136
"2011","Kettering 006C","E01027111","Total",916,213,33,180,273,152,171,35,136
"2011","Kettering 006D","E01027112","Total",935,219,49,170,298,145,204,45,159
"2011","Kettering 007A","E01027104","Total",1096,380,45,335,281,170,316,58,258
"2011","Kettering 007B","E01027110","Total",1110,561,32,529,136,71,423,17,406
"2011","Kettering 007C","E01027113","Total",963,356,18,338,222,91,293,28,265
"2011","Kettering 007D","E01027115","Total",485,188,4,184,134,41,111,14,97
"2011","Kettering 007E","E01027116","Total",817,113,20,93,368,166,122,33,89
"2011","Kettering 007F","E01027117","Total",610,202,5,197,136,71,138,12,126
"2011","Kettering 008A","E01027096","Total",453,130,11,119,153,63,106,22,84
"2011","Kettering 008B","E01027097","Total",592,181,6,175,158,49,137,28,109
"2011","Kettering 008C","E01027098","Total",482,112,5,107,172,73,114,28,86
"2011","Kettering 008D","E01027099","Total",670,274,7,267,149,56,200,25,175
"2011","Kettering 008E","E01027122","Total",503,170,6,164,134,47,142,21,121
"2011","Kettering 009A","E01027100","Total",683,237,28,209,205,87,194,39,155
"2011","Kettering 009B","E01027114","Total",680,191,19,172,206,68,195,30,165
"2011","Kettering 009C","E01027130","Total",788,302,45,257,229,104,207,27,180
"2011","Kettering 009D","E01027131","Total",994,402,54,348,245,108,305,37,268
"2011","Kettering 010A","E01027084","Total",642,262,7,255,152,51,179,25,154
"2011","Kettering 010B","E01027085","Total",517,191,15,176,155,51,122,20,102
"2011","Kettering 010C","E01027086","Total",684,209,8,201,232,68,148,28,120
"2011","Kettering 010D","E01027120","Total",521,75,10,65,201,56,77,25,52
"2011","Kettering 010E","E01027121","Total",533,143,2,141,183,43,109,30,79
"2011","Kettering 011A","E01027091","Total",762,236,29,207,265,114,184,33,151
"2011","Kettering 011B","E01027092","Total",619,181,12,169,173,58,148,24,124
"2011","Kettering 011C","E01027101","Total",1017,280,39,241,350,140,235,47,188
"2011","Kettering 011D","E01027102","Total",679,206,14,192,219,83,173,39,134
"2011","Kettering 011F","E01027119","Total",748,270,24,246,197,74,216,29,187
"2011","Kettering 011G","E01032972","Total",578,156,7,149,167,54,139,27,112
"2011","Kettering 011H","E01032973","Total",596,51,14,37,312,167,77,31,46
"2011","Kettering 011I","E01032974","Total",535,117,8,109,186,74,87,24,63
"2011","Northampton 001A","E01027145","Total",567,197,15,182,146,44,139,28,111
"2011","Northampton 001B","E01027148","Total",572,128,11,117,191,63,133,32,101
"2011","Northampton 001C","E01027149","Total",612,189,9,180,141,67,149,23,126
"2011","Northampton 001D","E01027232","Total",622,205,29,176,177,79,148,16,132
"2011","Northampton 002A","E01027218","Total",701,263,4,259,139,48,187,15,172
"2011","Northampton 002B","E01027219","Total",798,374,10,364,140,47,251,24,227
"2011","Northampton 002C","E01027221","Total",748,233,11,222,199,75,167,26,141
"2011","Northampton 002D","E01027222","Total",497,105,5,100,153,38,88,24,64
"2011","Northampton 003A","E01027143","Total",530,165,10,155,137,51,115,12,103
"2011","Northampton 003B","E01027144","Total",635,198,4,194,146,41,170,26,144
"2011","Northampton 003C","E01027146","Total",635,220,16,204,185,74,154,22,132
"2011","Northampton 003D","E01027147","Total",809,370,32,338,181,81,298,29,269
"2011","Northampton 004A","E01027195","Total",607,188,51,137,223,120,179,44,135
"2011","Northampton 004B","E01027245","Total",667,163,45,118,240,128,136,31,105
"2011","Northampton 004C","E01027247","Total",619,132,40,92,243,107,133,46,87
"2011","Northampton 004D","E01027248","Total",586,189,76,113,247,123,145,31,114
"2011","Northampton 004E","E01027249","Total",683,222,93,129,299,150,183,57,126
"2011","Northampton 005A","E01027174","Total",515,128,11,117,160,53,127,36,91
"2011","Northampton 005B","E01027175","Total",599,120,43,77,242,104,125,36,89
"2011","Northampton 005C","E01027178","Total",781,229,98,131,353,175,186,64,122
"2011","Northampton 005D","E01027200","Total",577,184,71,113,249,139,164,55,109
"2011","Northampton 005E","E01027246","Total",756,262,101,161,319,171,195,53,142
"2011","Northampton 006A","E01027171","Total",683,276,8,268,162,73,213,28,185
"2011","Northampton 006B","E01027172","Total",658,241,15,226,181,62,167,21,146
"2011","Northampton 006C","E01027182","Total",606,214,11,203,152,46,164,28,136
"2011","Northampton 006D","E01027183","Total",613,261,5,256,107,26,190,24,166
"2011","Northampton 007A","E01027196","Total",527,155,49,106,213,93,130,46,84
"2011","Northampton 007B","E01027197","Total",605,200,26,174,186,72,182,26,156
"2011","Northampton 007C","E01027198","Total",650,245,64,181,257,116,214,52,162
"2011","Northampton 007D","E01027199","Total",504,202,82,120,247,113,168,51,117
"2011","Northampton 008A","E01027190","Total",778,338,9,329,130,50,233,13,220
"2011","Northampton 008B","E01027191","Total",761,184,29,155,225,113,137,25,112
"2011","Northampton 008C","E01027193","Total",619,154,7,147,160,63,112,17,95
"2011","Northampton 008D","E01027194","Total",626,242,4,238,121,50,166,15,151
"2011","Northampton 009A","E01027192","Total",538,122,26,96,179,84,97,26,71
"2011","Northampton 009B","E01027229","Total",613,215,55,160,214,105,166,40,126
"2011","Northampton 009C","E01027230","Total",618,203,81,122,264,125,140,43,97
"2011","Northampton 009D","E01027231","Total",800,337,49,288,225,104,264,32,232
"2011","Northampton 010A","E01027179","Total",770,238,28,210,245,79,216,46,170
"2011","Northampton 010B","E01027180","Total",707,326,21,305,174,67,250,23,227
"2011","Northampton 010C","E01027181","Total",770,376,4,372,146,59,237,19,218
"2011","Northampton 011A","E01027140","Total",461,169,53,116,189,85,139,39,100
"2011","Northampton 011B","E01027142","Total",601,206,22,184,167,72,161,23,138
"2011","Northampton 011C","E01027176","Total",602,149,17,132,182,67,138,27,111
"2011","Northampton 011D","E01027177","Total",630,256,71,185,243,124,198,39,159
"2011","Northampton 012A","E01027168","Total",728,326,75,251,255,110,239,57,182
"2011","Northampton 012B","E01027169","Total",585,121,14,107,229,92,123,39,84
"2011","Northampton 012C","E01027170","Total",621,199,62,137,277,126,167,50,117
"2011","Northampton 012D","E01027173","Total",600,178,50,128,248,107,171,50,121
"2011","Northampton 013A","E01027136","Total",776,179,9,170,184,96,162,14,148
"2011","Northampton 013B","E01027186","Total",668,148,9,139,230,100,128,34,94
"2011","Northampton 013C","E01027188","Total",732,209,43,166,289,122,178,42,136
"2011","Northampton 013D","E01027220","Total",596,255,4,251,108,35,184,17,167
"2011","Northampton 014A","E01027208","Total",602,150,18,132,194,70,121,27,94
"2011","Northampton 014B","E01027209","Total",551,84,6,78,159,73,93,18,75
"2011","Northampton 014C","E01027211","Total",629,219,3,216,120,38,154,15,139
"2011","Northampton 014D","E01027212","Total",566,75,7,68,187,84,79,16,63
"2011","Northampton 015A","E01027184","Total",625,167,23,144,164,92,147,16,131
"2011","Northampton 015B","E01027185","Total",595,212,21,191,153,69,171,23,148
"2011","Northampton 015C","E01027187","Total",539,135,13,122,115,53,114,26,88
"2011","Northampton 015D","E01027189","Total",734,205,24,181,180,99,155,21,134
"2011","Northampton 016A","E01027137","Total",631,198,48,150,194,93,162,34,128
"2011","Northampton 016B","E01027138","Total",635,162,14,148,169,71,138,35,103
"2011","Northampton 016C","E01027139","Total",616,106,22,84,200,81,114,26,88
"2011","Northampton 016D","E01027141","Total",540,133,17,116,192,60,117,33,84
"2011","Northampton 016E","E01027259","Total",581,121,14,107,196,75,130,38,92
"2011","Northampton 017A","E01027239","Total",666,278,66,212,258,129,217,49,168
"2011","Northampton 017B","E01027241","Total",711,212,60,152,246,145,168,39,129
"2011","Northampton 017C","E01027242","Total",595,224,73,151,236,109,186,44,142
"2011","Northampton 017D","E01027243","Total",674,260,57,203,233,119,208,48,160
"2011","Northampton 017E","E01027244","Total",684,287,98,189,294,186,156,40,116
"2011","Northampton 018A","E01027213","Total",642,192,14,178,192,81,145,20,125
"2011","Northampton 018B","E01027214","Total",746,306,28,278,169,78,248,32,216
"2011","Northampton 018C","E01027216","Total",776,287,12,275,134,47,203,16,187
"2011","Northampton 018D","E01027240","Total",512,167,32,135,180,89,128,29,99
"2011","Northampton 019A","E01027207","Total",605,254,6,248,122,40,147,19,128
"2011","Northampton 019B","E01027210","Total",451,132,10,122,142,55,119,18,101
"2011","Northampton 019C","E01027215","Total",601,193,11,182,175,65,168,22,146
"2011","Northampton 019D","E01027217","Total",941,370,22,348,232,112,247,22,225
"2011","Northampton 020A","E01027255","Total",540,170,8,162,155,43,111,19,92
"2011","Northampton 020B","E01027256","Total",630,227,2,225,156,42,165,20,145
"2011","Northampton 020C","E01027258","Total",497,67,5,62,223,68,80,33,47
"2011","Northampton 020D","E01027260","Total",584,207,8,199,140,35,135,17,118
"2011","Northampton 021B","E01027152","Total",742,212,56,156,209,117,152,34,118
"2011","Northampton 021C","E01027153","Total",994,377,40,337,161,102,271,16,255
"2011","Northampton 021D","E01027154","Total",778,234,53,181,237,145,151,30,121
"2011","Northampton 021E","E01032978","Total",799,323,40,283,144,86,199,23,176
"2011","Northampton 021F","E01032979","Total",743,286,68,218,165,104,183,26,157
"2011","Northampton 022A","E01027132","Total",937,170,22,148,214,111,176,25,151
"2011","Northampton 022B","E01027133","Total",759,161,16,145,200,110,130,18,112
"2011","Northampton 022C","E01027134","Total",690,112,12,100,203,101,122,18,104
"2011","Northampton 022D","E01027135","Total",716,180,10,170,228,108,149,23,126
"2011","Northampton 023A","E01027155","Total",980,224,46,178,245,164,179,41,138
"2011","Northampton 023B","E01027225","Total",724,146,26,120,168,101,153,26,127
"2011","Northampton 023C","E01027227","Total",659,130,43,87,197,112,109,36,73
"2011","Northampton 023D","E01027228","Total",929,221,35,186,195,111,212,33,179
"2011","Northampton 024A","E01027151","Total",728,190,37,153,199,114,154,34,120
"2011","Northampton 024B","E01027236","Total",679,263,10,253,138,63,199,23,176
"2011","Northampton 024C","E01027237","Total",882,205,33,172,240,132,191,31,160
"2011","Northampton 024D","E01027238","Total",960,291,31,260,229,134,226,33,193
"2011","Northampton 025A","E01027223","Total",1107,277,26,251,149,75,222,21,201
"2011","Northampton 025B","E01027224","Total",904,278,19,259,180,91,217,18,199
"2011","Northampton 025C","E01027226","Total",853,222,27,195,175,110,198,20,178
"2011","Northampton 025D","E01027257","Total",477,179,4,175,121,46,126,13,113
"2011","Northampton 026A","E01027233","Total",483,126,73,53,243,136,98,41,57
"2011","Northampton 026B","E01027234","Total",588,142,21,121,195,95,136,30,106
"2011","Northampton 026C","E01027235","Total",629,286,79,207,231,108,225,59,166
"2011","Northampton 026D","E01027252","Total",640,173,50,123,246,128,153,44,109
"2011","Northampton 027A","E01027156","Total",504,156,41,115,185,84,139,40,99
"2011","Northampton 027B","E01027159","Total",511,138,10,128,156,61,124,22,102
"2011","Northampton 027C","E01027160","Total",705,111,15,96,271,134,115,32,83
"2011","Northampton 027D","E01027161","Total",669,286,51,235,224,107,255,42,213
"2011","Northampton 028B","E01027158","Total",646,164,24,140,190,101,149,32,117
"2011","Northampton 028C","E01027201","Total",880,223,19,204,294,125,179,35,144
"2011","Northampton 028D","E01027202","Total",674,237,8,229,179,66,159,18,141
"2011","Northampton 028E","E01032980","Total",732,101,29,72,178,114,89,20,69
"2011","Northampton 028F","E01032981","Total",669,101,29,72,202,110,99,24,75
"2011","Northampton 029A","E01027250","Total",595,149,11,138,153,63,120,14,106
"2011","Northampton 029C","E01027253","Total",730,145,18,127,252,108,119,26,93
"2011","Northampton 029D","E01027254","Total",652,115,9,106,259,101,105,30,75
"2011","Northampton 029E","E01032975","Total",651,58,14,44,289,152,76,22,54
"2011","Northampton 029F","E01032976","Total",651,283,23,260,153,95,215,19,196
"2011","Northampton 029G","E01032977","Total",707,99,50,49,306,177,70,33,37
"2011","Northampton 030A","E01027162","Total",689,122,14,108,221,97,104,27,77
"2011","Northampton 030B","E01027163","Total",566,160,7,153,174,67,121,18,103
"2011","Northampton 030C","E01027164","Total",622,67,18,49,244,114,67,24,43
"2011","Northampton 030D","E01027165","Total",491,57,8,49,206,75,80,25,55
"2011","Northampton 030E","E01027166","Total",625,64,15,49,257,117,80,27,53
"2011","Northampton 030F","E01027167","Total",572,139,12,127,192,72,102,13,89
"2011","Northampton 031A","E01027203","Total",557,52,13,39,313,97,59,31,28
"2011","Northampton 031B","E01027204","Total",642,147,17,130,266,95,134,37,97
"2011","Northampton 031C","E01027205","Total",723,50,6,44,449,156,75,37,38
"2011","Northampton 031D","E01027206","Total",1027,203,8,195,466,164,170,51,119
"2011","South Northamptonshire 001A","E01027282","Total",653,187,11,176,202,66,163,35,128
"2011","South Northamptonshire 001B","E01027283","Total",611,153,8,145,205,52,120,18,102
"2011","South Northamptonshire 001C","E01027285","Total",689,201,9,192,207,64,180,32,148
"2011","South Northamptonshire 001D","E01027286","Total",654,218,6,212,176,55,162,20,142
"2011","South Northamptonshire 001E","E01027287","Total",679,234,15,219,184,53,164,33,131
"2011","South Northamptonshire 002A","E01027273","Total",763,256,12,244,206,68,186,26,160
"2011","South Northamptonshire 002B","E01027274","Total",623,152,9,143,205,52,122,24,98
"2011","South Northamptonshire 002C","E01027275","Total",600,209,7,202,157,49,159,26,133
"2011","South Northamptonshire 002D","E01027308","Total",687,206,9,197,180,47,145,29,116
"2011","South Northamptonshire 003A","E01027263","Total",796,270,12,258,177,71,220,25,195
"2011","South Northamptonshire 003C","E01027279","Total",743,304,16,288,170,62,195,25,170
"2011","South Northamptonshire 003D","E01027284","Total",756,168,7,161,226,91,174,31,143
"2011","South Northamptonshire 003E","E01027294","Total",744,177,14,163,245,80,163,27,136
"2011","South Northamptonshire 003F","E01032982","Total",500,88,6,82,194,98,83,26,57
"2011","South Northamptonshire 003G","E01032983","Total",523,32,6,26,292,124,46,24,22
"2011","South Northamptonshire 003H","E01032984","Total",539,28,7,21,296,152,39,20,19
"2011","South Northamptonshire 003I","E01032985","Total",611,174,6,168,176,67,151,25,126
"2011","South Northamptonshire 004A","E01027262","Total",675,156,4,152,171,54,138,20,118
"2011","South Northamptonshire 004B","E01027277","Total",760,177,13,164,219,72,162,27,135
"2011","South Northamptonshire 004C","E01027289","Total",714,240,6,234,174,61,168,25,143
"2011","South Northamptonshire 004D","E01027300","Total",523,96,3,93,182,55,82,20,62
"2011","South Northamptonshire 004E","E01027303","Total",639,130,4,126,174,61,118,16,102
"2011","South Northamptonshire 005A","E01027297","Total",695,217,6,211,191,61,153,21,132
"2011","South Northamptonshire 005B","E01027298","Total",516,113,4,109,159,58,99,16,83
"2011","South Northamptonshire 005C","E01027299","Total",616,159,10,149,172,60,144,13,131
"2011","South Northamptonshire 005D","E01027301","Total",909,172,11,161,324,123,157,26,131
"2011","South Northamptonshire 005E","E01027302","Total",672,242,33,209,188,83,198,29,169
"2011","South Northamptonshire 006A","E01027291","Total",590,195,1,194,174,53,131,14,117
"2011","South Northamptonshire 006B","E01027292","Total",466,157,10,147,142,40,145,22,123
"2011","South Northamptonshire 006C","E01027293","Total",483,119,6,113,156,44,97,12,85
"2011","South Northamptonshire 006D","E01027304","Total",729,189,9,180,210,60,157,25,132
"2011","South Northamptonshire 006E","E01027305","Total",769,214,8,206,206,66,161,21,140
"2011","South Northamptonshire 007A","E01027261","Total",776,166,8,158,258,81,150,24,126
"2011","South Northamptonshire 007B","E01027295","Total",858,171,8,163,272,98,172,31,141
"2011","South Northamptonshire 007C","E01027306","Total",722,168,7,161,194,50,134,17,117
"2011","South Northamptonshire 008A","E01027276","Total",1040,289,19,270,323,125,193,30,163
"2011","South Northamptonshire 008B","E01027280","Total",897,146,11,135,354,145,156,42,114
"2011","South Northamptonshire 008C","E01027281","Total",684,196,11,185,214,93,159,29,130
"2011","South Northamptonshire 008D","E01027307","Total",832,239,7,232,221,71,185,16,169
"2011","South Northamptonshire 009A","E01027265","Total",669,209,6,203,174,68,180,31,149
"2011","South Northamptonshire 009B","E01027266","Total",482,125,2,123,178,45,114,23,91
"2011","South Northamptonshire 009C","E01027270","Total",581,63,4,59,296,98,77,29,48
"2011","South Northamptonshire 009D","E01027271","Total",628,103,8,95,254,87,112,27,85
"2011","South Northamptonshire 009E","E01027272","Total",591,84,8,76,225,75,100,30,70
"2011","South Northamptonshire 010A","E01027264","Total",648,189,11,178,150,56,147,14,133
"2011","South Northamptonshire 010B","E01027267","Total",509,154,4,150,149,63,118,13,105
"2011","South Northamptonshire 010C","E01027268","Total",517,107,5,102,174,70,112,26,86
"2011","South Northamptonshire 010D","E01027269","Total",689,226,14,212,168,71,180,20,160
"2011","South Northamptonshire 011A","E01027288","Total",904,268,19,249,252,91,235,35,200
"2011","South Northamptonshire 011B","E01027290","Total",918,252,12,240,256,106,176,25,151
"2011","South Northamptonshire 011C","E01027296","Total",845,233,8,225,228,70,168,24,144
"2011","Wellingborough 001A","E01027326","Total",710,265,18,247,157,55,197,34,163
"2011","Wellingborough 001B","E01027327","Total",695,246,24,222,158,50,191,25,166
"2011","Wellingborough 001C","E01027328","Total",582,200,29,171,175,67,162,33,129
"2011","Wellingborough 001D","E01027338","Total",994,336,21,315,239,66,248,33,215
"2011","Wellingborough 002A","E01027330","Total",633,192,57,135,271,112,153,35,118
"2011","Wellingborough 002B","E01027331","Total",623,289,60,229,194,95,175,32,143
"2011","Wellingborough 002C","E01027332","Total",649,270,5,265,146,51,175,18,157
"2011","Wellingborough 002D","E01027333","Total",840,145,18,127,345,130,164,60,104
"2011","Wellingborough 002E","E01027334","Total",531,238,116,122,258,138,128,49,79
"2011","Wellingborough 003A","E01027343","Total",621,167,12,155,183,71,154,29,125
"2011","Wellingborough 003B","E01027344","Total",628,225,11,214,144,39,168,16,152
"2011","Wellingborough 003C","E01027345","Total",489,96,3,93,191,55,105,20,85
"2011","Wellingborough 003D","E01027346","Total",577,86,10,76,220,74,104,29,75
"2011","Wellingborough 003E","E01027347","Total",744,171,7,164,258,87,151,31,120
"2011","Wellingborough 004A","E01027313","Total",639,190,32,158,211,101,174,32,142
"2011","Wellingborough 004B","E01027314","Total",897,248,27,221,216,117,208,26,182
"2011","Wellingborough 004C","E01027315","Total",1062,276,51,225,300,154,225,36,189
"2011","Wellingborough 004D","E01027316","Total",650,195,26,169,194,103,173,29,144
"2011","Wellingborough 005A","E01027339","Total",555,230,67,163,227,93,179,51,128
"2011","Wellingborough 005B","E01027340","Total",658,295,49,246,181,83,210,37,173
"2011","Wellingborough 005C","E01027341","Total",593,202,58,144,250,122,157,38,119
"2011","Wellingborough 005D","E01027342","Total",652,243,58,185,222,98,213,43,170
"2011","Wellingborough 006A","E01027349","Total",860,325,19,306,149,75,264,21,243
"2011","Wellingborough 006B","E01027350","Total",672,236,13,223,144,53,199,21,178
"2011","Wellingborough 006C","E01027351","Total",794,402,52,350,183,86,300,31,269
"2011","Wellingborough 006D","E01027352","Total",638,224,9,215,164,72,198,25,173
"2011","Wellingborough 007A","E01027309","Total",651,240,9,231,155,54,178,26,152
"2011","Wellingborough 007B","E01027310","Total",607,240,82,158,254,135,186,58,128
"2011","Wellingborough 007C","E01027311","Total",483,106,8,98,165,53,105,25,80
"2011","Wellingborough 007D","E01027312","Total",627,245,43,202,186,83,178,32,146
"2011","Wellingborough 008A","E01027317","Total",644,252,47,205,216,80,188,40,148
"2011","Wellingborough 008B","E01027318","Total",591,254,107,147,280,137,163,40,123
"2011","Wellingborough 008C","E01027319","Total",605,182,41,141,225,88,170,45,125
"2011","Wellingborough 008D","E01027320","Total",744,220,37,183,264,129,193,46,147
"2011","Wellingborough 008E","E01027321","Total",580,91,13,78,249,105,95,33,62
"2011","Wellingborough 009A","E01027322","Total",511,136,8,128,151,43,105,20,85
"2011","Wellingborough 009B","E01027323","Total",610,193,20,173,205,85,155,26,129
"2011","Wellingborough 009C","E01027324","Total",503,180,7,173,118,41,131,15,116
"2011","Wellingborough 009D","E01027325","Total",673,176,14,162,208,74,129,22,107
"2011","Wellingborough 009E","E01027329","Total",791,298,12,286,170,50,219,24,195
"2011","Wellingborough 009F","E01027353","Total",772,272,12,260,172,68,190,20,170
"2011","Wellingborough 010A","E01027335","Total",632,240,15,225,150,48,141,21,120
"2011","Wellingborough 010B","E01027336","Total",652,251,22,229,160,66,186,15,171
"2011","Wellingborough 010C","E01027337","Total",793,231,13,218,221,87,211,30,181
"2011","Wellingborough 010D","E01027348","Total",890,251,12,239,232,86,229,33,196
"2011","Wellingborough 010E","E01027354","Total",1053,313,33,280,309,114,223,40,183
"2011","Wellingborough 010F","E01027355","Total",659,170,5,165,198,76,140,27,113
"2011","Ashfield 001A","E01027979","Total",699,286,12,274,133,49,220,21,199
"2011","Ashfield 001B","E01027980","Total",649,266,60,206,226,76,204,48,156
"2011","Ashfield 001C","E01027981","Total",678,277,22,255,164,60,209,27,182
"2011","Ashfield 001D","E01027983","Total",642,238,45,193,193,76,210,40,170
"2011","Ashfield 002A","E01027970","Total",609,195,19,176,174,65,143,23,120
"2011","Ashfield 002B","E01027971","Total",602,215,13,202,138,46,162,20,142
"2011","Ashfield 002C","E01027982","Total",666,276,10,266,142,54,226,18,208
"2011","Ashfield 002D","E01027984","Total",636,198,12,186,179,68,153,23,130
"2011","Ashfield 003A","E01027966","Total",636,332,45,287,179,51,283,62,221
"2011","Ashfield 003B","E01027986","Total",624,276,29,247,146,56,206,31,175
"2011","Ashfield 003C","E01027987","Total",746,294,77,217,274,123,217,54,163
"2011","Ashfield 003D","E01027990","Total",789,205,20,185,231,93,179,32,147
"2011","Ashfield 004A","E01027967","Total",756,277,56,221,255,119,220,44,176
"2011","Ashfield 004B","E01027972","Total",874,245,46,199,330,130,228,66,162
"2011","Ashfield 004C","E01027977","Total",782,249,41,208,250,104,257,66,191
"2011","Ashfield 004D","E01027978","Total",805,308,96,212,271,138,253,59,194
"2011","Ashfield 004E","E01027985","Total",757,214,42,172,262,118,194,49,145
"2011","Ashfield 005A","E01027964","Total",617,244,43,201,195,78,206,46,160
"2011","Ashfield 005B","E01027965","Total",563,260,66,194,199,79,191,37,154
"2011","Ashfield 005C","E01027968","Total",573,315,55,260,160,67,245,54,191
"2011","Ashfield 005D","E01027974","Total",671,319,96,223,245,98,252,65,187
"2011","Ashfield 005E","E01027976","Total",790,416,47,369,184,64,300,37,263
"2011","Ashfield 006A","E01027969","Total",575,172,30,142,181,66,155,33,122
"2011","Ashfield 006B","E01027975","Total",708,234,36,198,224,84,182,39,143
"2011","Ashfield 006C","E01027988","Total",693,250,18,232,194,75,194,30,164
"2011","Ashfield 006D","E01027989","Total",736,311,11,300,144,64,231,23,208
"2011","Ashfield 006E","E01027991","Total",539,198,24,174,153,51,176,29,147
"2011","Ashfield 006F","E01027992","Total",846,126,16,110,344,136,142,37,105
"2011","Ashfield 007A","E01027949","Total",646,205,18,187,180,71,169,25,144
"2011","Ashfield 007B","E01027951","Total",648,295,110,185,260,124,181,56,125
"2011","Ashfield 007C","E01027953","Total",636,239,15,224,162,43,183,26,157
"2011","Ashfield 007D","E01027954","Total",664,197,51,146,241,111,170,51,119
"2011","Ashfield 007E","E01027973","Total",647,233,6,227,205,74,175,38,137
"2011","Ashfield 008A","E01027952","Total",808,316,64,252,257,127,279,47,232
"2011","Ashfield 008B","E01027955","Total",512,156,33,123,167,69,145,32,113
"2011","Ashfield 008C","E01027956","Total",686,369,61,308,193,78,267,42,225
"2011","Ashfield 008D","E01027958","Total",596,229,56,173,217,103,202,48,154
"2011","Ashfield 009A","E01027947","Total",692,238,27,211,215,78,187,37,150
"2011","Ashfield 009B","E01027948","Total",792,226,15,211,227,84,206,36,170
"2011","Ashfield 009C","E01027950","Total",918,360,36,324,225,88,278,41,237
"2011","Ashfield 009D","E01027957","Total",524,197,29,168,154,56,151,27,124
"2011","Ashfield 009E","E01027959","Total",527,95,8,87,219,59,109,31,78
"2011","Ashfield 010A","E01027995","Total",681,228,14,214,171,57,180,28,152
"2011","Ashfield 010B","E01027996","Total",859,295,42,253,265,100,271,49,222
"2011","Ashfield 010C","E01027997","Total",740,279,16,263,155,63,228,32,196
"2011","Ashfield 010D","E01027998","Total",836,325,26,299,194,75,238,36,202
"2011","Ashfield 011A","E01027960","Total",740,304,25,279,186,69,227,28,199
"2011","Ashfield 011B","E01027961","Total",792,276,13,263,193,62,225,24,201
"2011","Ashfield 011C","E01027962","Total",608,157,15,142,187,64,163,30,133
"2011","Ashfield 011D","E01027963","Total",645,222,37,185,235,75,207,48,159
"2011","Ashfield 012A","E01027945","Total",726,240,27,213,218,81,190,28,162
"2011","Ashfield 012B","E01027946","Total",621,217,24,193,158,49,184,26,158
"2011","Ashfield 012C","E01027993","Total",655,223,18,205,175,47,168,25,143
"2011","Ashfield 012D","E01027994","Total",640,256,19,237,164,48,212,28,184
"2011","Ashfield 013A","E01027929","Total",1052,295,51,244,334,164,233,46,187
"2011","Ashfield 013B","E01027931","Total",899,374,73,301,258,125,263,39,224
"2011","Ashfield 013C","E01027934","Total",582,142,13,129,198,72,124,22,102
"2011","Ashfield 013D","E01027935","Total",503,138,24,114,165,49,134,32,102
"2011","Ashfield 013E","E01027936","Total",650,268,9,259,156,47,183,22,161
"2011","Ashfield 014A","E01027927","Total",934,368,41,327,269,116,268,32,236
"2011","Ashfield 014B","E01027928","Total",893,273,36,237,248,92,217,49,168
"2011","Ashfield 014C","E01027932","Total",898,233,50,183,316,156,213,50,163
"2011","Ashfield 014D","E01027933","Total",661,201,33,168,194,88,183,31,152
"2011","Ashfield 014E","E01027937","Total",648,267,35,232,175,85,217,23,194
"2011","Ashfield 015A","E01027925","Total",743,267,22,245,243,93,215,35,180
"2011","Ashfield 015B","E01027938","Total",489,76,3,73,191,61,99,24,75
"2011","Ashfield 015C","E01027940","Total",562,155,5,150,151,58,141,16,125
"2011","Ashfield 015D","E01027943","Total",592,187,20,167,169,63,166,31,135
"2011","Ashfield 015E","E01027944","Total",655,235,13,222,173,51,172,23,149
"2011","Ashfield 016A","E01027926","Total",657,255,16,239,150,58,170,18,152
"2011","Ashfield 016B","E01027930","Total",717,304,59,245,219,87,257,54,203
"2011","Ashfield 016C","E01027939","Total",601,264,63,201,201,79,219,43,176
"2011","Ashfield 016D","E01027941","Total",571,197,20,177,147,46,144,20,124
"2011","Ashfield 016E","E01027942","Total",524,178,52,126,189,74,146,39,107
"2011","Bassetlaw 001A","E01028000","Total",951,335,10,325,219,75,255,30,225
"2011","Bassetlaw 001B","E01028024","Total",775,261,24,237,229,73,224,43,181
"2011","Bassetlaw 001C","E01028025","Total",633,196,32,164,203,67,171,36,135
"2011","Bassetlaw 001D","E01028026","Total",661,308,60,248,207,83,242,55,187
"2011","Bassetlaw 001E","E01028027","Total",592,223,37,186,180,72,169,36,133
"2011","Bassetlaw 001F","E01028028","Total",677,293,38,255,217,91,193,37,156
"2011","Bassetlaw 002A","E01027999","Total",994,340,11,329,232,69,290,54,236
"2011","Bassetlaw 002B","E01028005","Total",822,298,19,279,175,56,218,21,197
"2011","Bassetlaw 002C","E01028031","Total",473,174,12,162,115,41,127,21,106
"2011","Bassetlaw 002D","E01028032","Total",559,182,11,171,168,57,131,20,111
"2011","Bassetlaw 002E","E01028035","Total",961,299,23,276,258,92,222,35,187
"2011","Bassetlaw 003A","E01028023","Total",947,290,15,275,258,76,230,43,187
"2011","Bassetlaw 003B","E01028034","Total",1010,367,27,340,268,98,274,44,230
"2011","Bassetlaw 003C","E01028036","Total",868,273,15,258,225,47,243,39,204
"2011","Bassetlaw 004A","E01028001","Total",593,301,51,250,175,74,254,48,206
"2011","Bassetlaw 004B","E01028002","Total",600,242,21,221,150,45,197,31,166
"2011","Bassetlaw 004C","E01028003","Total",600,218,17,201,155,40,188,28,160
"2011","Bassetlaw 004D","E01028004","Total",681,274,7,267,127,47,183,22,161
"2011","Bassetlaw 004E","E01028029","Total",524,219,22,197,136,49,171,34,137
"2011","Bassetlaw 004F","E01028030","Total",497,156,25,131,174,62,132,33,99
"2011","Bassetlaw 005A","E01028013","Total",783,312,25,287,201,66,237,25,212
"2011","Bassetlaw 005B","E01028014","Total",767,384,33,351,169,65,263,30,233
"2011","Bassetlaw 005C","E01028015","Total",628,171,12,159,186,53,142,23,119
"2011","Bassetlaw 005D","E01028016","Total",615,274,18,256,137,44,203,35,168
"2011","Bassetlaw 006A","E01028046","Total",673,219,15,204,191,69,188,28,160
"2011","Bassetlaw 006B","E01028047","Total",739,86,18,68,378,124,108,52,56
"2011","Bassetlaw 006C","E01028048","Total",611,113,16,97,243,94,141,36,105
"2011","Bassetlaw 006D","E01028049","Total",749,285,26,259,214,84,221,36,185
"2011","Bassetlaw 006E","E01028050","Total",729,150,20,130,293,104,180,50,130
"2011","Bassetlaw 008A","E01028008","Total",508,187,57,130,210,90,134,43,91
"2011","Bassetlaw 008B","E01028009","Total",630,269,6,263,111,42,164,16,148
"2011","Bassetlaw 008C","E01028010","Total",547,163,6,157,168,45,131,27,104
"2011","Bassetlaw 008D","E01028011","Total",794,327,44,283,170,79,234,26,208
"2011","Bassetlaw 008E","E01028012","Total",618,195,20,175,163,59,160,21,139
"2011","Bassetlaw 008F","E01028022","Total",659,186,33,153,206,96,142,24,118
"2011","Bassetlaw 009A","E01028055","Total",774,329,41,288,181,80,273,27,246
"2011","Bassetlaw 009B","E01028056","Total",507,168,36,132,180,80,153,35,118
"2011","Bassetlaw 009C","E01028058","Total",741,180,12,168,249,95,155,34,121
"2011","Bassetlaw 009D","E01028059","Total",640,89,13,76,307,102,121,44,77
"2011","Bassetlaw 010A","E01028017","Total",620,277,15,262,135,50,231,31,200
"2011","Bassetlaw 010B","E01028018","Total",625,171,23,148,178,59,128,27,101
"2011","Bassetlaw 010C","E01028019","Total",628,257,39,218,190,75,187,35,152
"2011","Bassetlaw 010D","E01028020","Total",864,252,36,216,229,105,212,43,169
"2011","Bassetlaw 010E","E01028021","Total",674,261,12,249,168,69,178,18,160
"2011","Bassetlaw 012A","E01028057","Total",602,187,34,153,156,74,168,27,141
"2011","Bassetlaw 012B","E01028065","Total",726,355,106,249,287,134,274,80,194
"2011","Bassetlaw 012C","E01028066","Total",684,292,86,206,245,116,232,56,176
"2011","Bassetlaw 012D","E01028068","Total",823,339,45,294,206,110,250,29,221
"2011","Bassetlaw 013A","E01028060","Total",727,306,10,296,169,44,187,15,172
"2011","Bassetlaw 013B","E01028061","Total",639,162,11,151,202,79,131,26,105
"2011","Bassetlaw 013C","E01028062","Total",912,313,20,293,207,88,274,33,241
"2011","Bassetlaw 013D","E01028067","Total",643,238,41,197,201,81,215,42,173
"2011","Bassetlaw 014A","E01028040","Total",434,150,15,135,131,43,139,30,109
"2011","Bassetlaw 014B","E01028041","Total",453,165,12,153,109,27,147,24,123
"2011","Bassetlaw 014C","E01028043","Total",601,226,14,212,174,67,176,28,148
"2011","Bassetlaw 014D","E01028063","Total",730,219,6,213,199,59,179,30,149
"2011","Bassetlaw 014E","E01028064","Total",533,191,30,161,169,63,178,34,144
"2011","Bassetlaw 015A","E01028006","Total",535,179,7,172,122,41,140,19,121
"2011","Bassetlaw 015B","E01028007","Total",455,140,14,126,137,34,91,14,77
"2011","Bassetlaw 015C","E01028033","Total",840,243,17,226,226,64,248,41,207
"2011","Bassetlaw 015D","E01028037","Total",687,193,11,182,196,70,173,25,148
"2011","Bassetlaw 015E","E01028038","Total",641,245,27,218,175,55,195,33,162
"2011","Bassetlaw 015F","E01028039","Total",504,168,6,162,108,36,144,15,129
"2011","Bassetlaw 016E","E01028042","Total",568,175,15,160,199,67,168,39,129
"2011","Bassetlaw 016F","E01028044","Total",755,379,44,335,177,69,286,34,252
"2011","Bassetlaw 016G","E01028045","Total",857,362,22,340,223,86,310,39,271
"2011","Bassetlaw 016A","E01028051","Total",737,320,15,305,139,53,231,16,215
"2011","Bassetlaw 016B","E01028052","Total",689,255,9,246,200,62,208,28,180
"2011","Bassetlaw 016C","E01028053","Total",782,349,31,318,162,68,273,25,248
"2011","Bassetlaw 016D","E01028054","Total",569,194,7,187,159,39,141,21,120
"2011","Broxtowe 001A","E01028092","Total",529,174,23,151,152,59,149,23,126
"2011","Broxtowe 001B","E01028093","Total",454,175,5,170,95,29,119,17,102
"2011","Broxtowe 001C","E01028107","Total",638,169,11,158,176,66,187,33,154
"2011","Broxtowe 001D","E01028108","Total",657,229,14,215,151,62,219,25,194
"2011","Broxtowe 001E","E01028114","Total",664,256,16,240,158,50,212,38,174
"2011","Broxtowe 002A","E01028110","Total",625,289,56,233,193,84,202,46,156
"2011","Broxtowe 002B","E01028111","Total",635,255,34,221,146,59,205,25,180
"2011","Broxtowe 002C","E01028112","Total",742,315,43,272,185,79,269,34,235
"2011","Broxtowe 002D","E01028113","Total",612,257,45,212,191,87,223,42,181
"2011","Broxtowe 003A","E01028109","Total",749,285,19,266,178,70,207,25,182
"2011","Broxtowe 003B","E01028115","Total",666,257,9,248,137,43,179,22,157
"2011","Broxtowe 003C","E01028116","Total",692,252,13,239,200,81,190,26,164
"2011","Broxtowe 003D","E01028117","Total",553,98,9,89,211,73,92,24,68
"2011","Broxtowe 003E","E01028118","Total",766,366,4,362,122,35,237,26,211
"2011","Broxtowe 004A","E01028102","Total",582,174,21,153,167,65,141,26,115
"2011","Broxtowe 004B","E01028103","Total",532,203,20,183,129,48,161,26,135
"2011","Broxtowe 004C","E01028104","Total",616,164,7,157,177,53,149,25,124
"2011","Broxtowe 004D","E01028122","Total",739,321,15,306,183,58,249,28,221
"2011","Broxtowe 004E","E01028123","Total",767,191,11,180,239,94,140,26,114
"2011","Broxtowe 004F","E01028124","Total",640,250,13,237,163,55,174,28,146
"2011","Broxtowe 007A","E01028087","Total",688,269,12,257,159,54,150,17,133
"2011","Broxtowe 007B","E01028088","Total",634,246,7,239,152,56,161,18,143
"2011","Broxtowe 007C","E01028089","Total",537,195,7,188,146,45,117,16,101
"2011","Broxtowe 007D","E01028090","Total",628,246,11,235,153,54,188,21,167
"2011","Broxtowe 007E","E01028091","Total",617,232,5,227,166,72,151,18,133
"2011","Broxtowe 008A","E01028125","Total",695,234,21,213,190,83,198,21,177
"2011","Broxtowe 008B","E01028126","Total",576,172,26,146,197,82,135,36,99
"2011","Broxtowe 008C","E01028127","Total",759,356,77,279,240,122,237,47,190
"2011","Broxtowe 008D","E01028134","Total",636,160,31,129,197,93,161,36,125
"2011","Broxtowe 009A","E01028076","Total",592,204,25,179,126,58,129,14,115
"2011","Broxtowe 009B","E01028077","Total",587,243,39,204,165,64,178,25,153
"2011","Broxtowe 009C","E01028078","Total",624,186,31,155,190,86,144,33,111
"2011","Broxtowe 009D","E01028079","Total",538,194,14,180,115,50,107,18,89
"2011","Broxtowe 009E","E01028084","Total",744,213,14,199,220,92,154,19,135
"2011","Broxtowe 010A","E01028128","Total",730,212,13,199,214,66,160,21,139
"2011","Broxtowe 010B","E01028129","Total",630,244,17,227,175,69,193,28,165
"2011","Broxtowe 010C","E01028130","Total",802,312,39,273,221,101,258,36,222
"2011","Broxtowe 010D","E01028131","Total",621,187,10,177,186,64,150,26,124
"2011","Broxtowe 010E","E01028132","Total",432,139,23,116,150,59,116,26,90
"2011","Broxtowe 010F","E01028133","Total",638,153,27,126,190,81,130,28,102
"2011","Broxtowe 011A","E01028073","Total",775,391,11,380,96,46,269,11,258
"2011","Broxtowe 011B","E01028074","Total",711,325,20,305,103,53,219,14,205
"2011","Broxtowe 011C","E01028075","Total",694,203,34,169,167,93,155,25,130
"2011","Broxtowe 011D","E01028085","Total",902,324,30,294,198,97,215,25,190
"2011","Broxtowe 011E","E01028086","Total",727,223,14,209,148,61,148,14,134
"2011","Broxtowe 012A","E01028080","Total",773,182,23,159,192,92,130,23,107
"2011","Broxtowe 012B","E01028081","Total",574,249,14,235,115,47,172,17,155
"2011","Broxtowe 012C","E01028082","Total",507,117,6,111,154,56,93,16,77
"2011","Broxtowe 012D","E01028083","Total",599,201,33,168,130,65,170,22,148
"2011","Broxtowe 013A","E01028097","Total",615,208,5,203,147,54,150,17,133
"2011","Broxtowe 013B","E01028098","Total",735,254,39,215,263,130,219,44,175
"2011","Broxtowe 013C","E01028099","Total",628,232,13,219,134,56,168,23,145
"2011","Broxtowe 013D","E01028100","Total",782,337,25,312,188,63,273,35,238
"2011","Broxtowe 013E","E01028101","Total",596,231,73,158,231,106,161,43,118
"2011","Broxtowe 014A","E01028069","Total",525,153,9,144,137,57,137,18,119
"2011","Broxtowe 014B","E01028070","Total",483,188,2,186,108,27,134,17,117
"2011","Broxtowe 014C","E01028094","Total",742,255,20,235,199,76,196,23,173
"2011","Broxtowe 014D","E01028095","Total",616,230,18,212,182,67,158,24,134
"2011","Broxtowe 014E","E01028096","Total",766,281,10,271,194,54,197,14,183
"2011","Broxtowe 015A","E01028135","Total",569,191,8,183,178,48,146,21,125
"2011","Broxtowe 015B","E01028136","Total",665,223,9,214,218,67,171,30,141
"2011","Broxtowe 015C","E01028137","Total",984,108,15,93,392,162,120,28,92
"2011","Broxtowe 015D","E01028138","Total",559,216,6,210,118,30,165,17,148
"2011","Broxtowe 015E","E01028139","Total",573,144,7,137,206,58,106,21,85
"2011","Broxtowe 016A","E01028105","Total",503,166,18,148,150,48,145,30,115
"2011","Broxtowe 016B","E01028106","Total",672,224,9,215,142,38,194,24,170
"2011","Broxtowe 016C","E01028119","Total",798,121,17,104,326,126,133,46,87
"2011","Broxtowe 016D","E01028120","Total",643,212,3,209,179,53,163,26,137
"2011","Broxtowe 016E","E01028121","Total",581,168,12,156,223,66,118,33,85
"2011","Broxtowe 016F","E01033412","Total",1007,351,12,339,255,71,259,28,231
"2011","Broxtowe 016G","E01033413","Total",950,271,23,248,274,96,247,41,206
"2011","Gedling 001A","E01028189","Total",949,291,30,261,268,104,263,41,222
"2011","Gedling 001B","E01028198","Total",621,252,7,245,154,47,167,18,149
"2011","Gedling 001C","E01028199","Total",657,301,6,295,132,45,173,16,157
"2011","Gedling 001D","E01028200","Total",692,213,9,204,183,56,147,23,124
"2011","Gedling 001E","E01028201","Total",495,184,1,183,133,38,127,17,110
"2011","Gedling 002A","E01028150","Total",615,227,6,221,121,40,166,13,153
"2011","Gedling 002B","E01028151","Total",467,144,8,136,142,39,120,12,108
"2011","Gedling 002C","E01028152","Total",625,202,18,184,188,61,146,27,119
"2011","Gedling 002D","E01028153","Total",585,252,41,211,163,72,209,38,171
"2011","Gedling 002E","E01028154","Total",695,191,34,157,236,88,163,33,130
"2011","Gedling 002F","E01028213","Total",886,334,7,327,172,64,217,23,194
"2011","Gedling 004A","E01028143","Total",633,263,13,250,146,59,202,25,177
"2011","Gedling 004B","E01028205","Total",523,183,26,157,170,46,135,22,113
"2011","Gedling 004C","E01028206","Total",633,222,16,206,174,47,169,36,133
"2011","Gedling 004D","E01028207","Total",524,203,11,192,156,57,159,27,132
"2011","Gedling 004E","E01028208","Total",485,187,25,162,147,53,151,23,128
"2011","Gedling 005A","E01028173","Total",441,242,49,193,146,47,203,45,158
"2011","Gedling 005B","E01028174","Total",585,200,44,156,230,100,171,45,126
"2011","Gedling 005C","E01028175","Total",804,284,17,267,226,95,233,34,199
"2011","Gedling 005D","E01028209","Total",616,232,48,184,191,87,183,36,147
"2011","Gedling 006A","E01028144","Total",663,219,36,183,217,98,183,34,149
"2011","Gedling 006B","E01028165","Total",747,311,23,288,170,76,245,17,228
"2011","Gedling 006C","E01028166","Total",715,256,52,204,230,86,210,46,164
"2011","Gedling 006D","E01028167","Total",832,256,50,206,239,109,229,50,179
"2011","Gedling 007A","E01028179","Total",588,170,10,160,165,46,130,23,107
"2011","Gedling 007B","E01028180","Total",648,218,15,203,168,55,158,30,128
"2011","Gedling 007C","E01028181","Total",666,154,9,145,157,55,122,22,100
"2011","Gedling 007D","E01028182","Total",653,177,9,168,204,73,135,27,108
"2011","Gedling 007E","E01028183","Total",598,269,16,253,113,46,185,16,169
"2011","Gedling 008A","E01028148","Total",836,327,6,321,221,77,194,29,165
"2011","Gedling 008B","E01028149","Total",749,282,13,269,193,75,207,20,187
"2011","Gedling 008C","E01028178","Total",927,308,14,294,216,79,227,31,196
"2011","Gedling 009A","E01028176","Total",613,203,4,199,183,60,162,23,139
"2011","Gedling 009B","E01028177","Total",750,242,13,229,181,80,159,26,133
"2011","Gedling 009C","E01028214","Total",633,222,9,213,178,66,186,28,158
"2011","Gedling 009D","E01028215","Total",510,140,9,131,186,68,111,16,95
"2011","Gedling 009E","E01028216","Total",516,167,4,163,160,48,119,18,101
"2011","Gedling 009F","E01028217","Total",585,157,6,151,142,30,143,22,121
"2011","Gedling 009G","E01028218","Total",665,270,3,267,142,41,175,16,159
"2011","Gedling 010A","E01028193","Total",672,291,7,284,140,56,222,19,203
"2011","Gedling 010B","E01028194","Total",644,180,8,172,180,61,161,27,134
"2011","Gedling 010C","E01028195","Total",621,152,13,139,165,61,144,25,119
"2011","Gedling 010D","E01028196","Total",580,148,8,140,180,70,131,23,108
"2011","Gedling 010E","E01028197","Total",608,233,10,223,154,74,152,16,136
"2011","Gedling 010F","E01028204","Total",583,183,8,175,142,59,147,23,124
"2011","Gedling 011A","E01028172","Total",462,129,9,120,149,52,114,22,92
"2011","Gedling 011B","E01028190","Total",646,180,14,166,210,67,151,36,115
"2011","Gedling 011C","E01028202","Total",649,263,17,246,154,50,201,27,174
"2011","Gedling 011D","E01028203","Total",606,191,20,171,153,63,157,30,127
"2011","Gedling 011E","E01028212","Total",620,192,49,143,239,90,163,52,111
"2011","Gedling 012A","E01028168","Total",541,186,11,175,153,49,143,27,116
"2011","Gedling 012B","E01028169","Total",604,215,6,209,165,40,154,23,131
"2011","Gedling 012C","E01028170","Total",619,234,5,229,166,60,179,21,158
"2011","Gedling 012D","E01028171","Total",563,160,19,141,179,66,151,31,120
"2011","Gedling 012E","E01028191","Total",735,192,29,163,256,106,180,44,136
"2011","Gedling 012F","E01028192","Total",638,203,34,169,216,91,187,43,144
"2011","Gedling 013A","E01028160","Total",657,176,19,157,200,88,166,32,134
"2011","Gedling 013B","E01028161","Total",654,181,26,155,189,87,172,39,133
"2011","Gedling 013C","E01028162","Total",631,187,32,155,208,95,129,30,99
"2011","Gedling 013D","E01028163","Total",639,201,9,192,155,57,140,20,120
"2011","Gedling 013E","E01028211","Total",588,205,14,191,161,55,175,33,142
"2011","Gedling 014A","E01028155","Total",626,212,11,201,167,59,186,24,162
"2011","Gedling 014B","E01028156","Total",655,239,23,216,136,44,198,27,171
"2011","Gedling 014C","E01028157","Total",493,148,12,136,148,53,142,32,110
"2011","Gedling 014D","E01028158","Total",761,283,31,252,176,65,230,28,202
"2011","Gedling 014E","E01028159","Total",600,192,18,174,165,70,169,27,142
"2011","Gedling 014F","E01028164","Total",570,205,27,178,169,60,193,40,153
"2011","Gedling 014G","E01028210","Total",688,281,32,249,177,62,224,28,196
"2011","Gedling 015A","E01028184","Total",481,103,13,90,145,55,99,24,75
"2011","Gedling 015B","E01028185","Total",885,298,48,250,256,120,247,39,208
"2011","Gedling 015C","E01028186","Total",761,261,47,214,207,118,241,35,206
"2011","Gedling 015D","E01028187","Total",676,210,88,122,243,120,147,40,107
"2011","Gedling 015E","E01028188","Total",648,115,31,84,205,113,118,31,87
"2011","Gedling 016A","E01028142","Total",849,297,17,280,209,100,230,24,206
"2011","Gedling 016B","E01028146","Total",653,140,38,102,197,74,132,32,100
"2011","Gedling 016C","E01028147","Total",474,142,36,106,162,67,118,23,95
"2011","Gedling 016D","E01032622","Total",544,161,12,149,151,54,135,25,110
"2011","Mansfield 001A","E01028224","Total",647,330,25,305,145,49,232,30,202
"2011","Mansfield 001B","E01028257","Total",596,186,48,138,249,98,182,60,122
"2011","Mansfield 001C","E01028258","Total",721,339,25,314,165,52,275,42,233
"2011","Mansfield 001D","E01028259","Total",563,208,62,146,206,79,181,57,124
"2011","Mansfield 002A","E01028223","Total",436,190,20,170,118,47,157,29,128
"2011","Mansfield 002B","E01028225","Total",640,272,25,247,182,53,236,44,192
"2011","Mansfield 002C","E01028226","Total",604,213,59,154,236,100,193,61,132
"2011","Mansfield 002D","E01028260","Total",728,291,18,273,167,62,243,32,211
"2011","Mansfield 003A","E01028251","Total",649,173,8,165,199,58,175,38,137
"2011","Mansfield 003B","E01028252","Total",826,305,35,270,264,93,254,43,211
"2011","Mansfield 003C","E01028253","Total",713,251,9,242,190,63,182,25,157
"2011","Mansfield 003D","E01028277","Total",526,208,5,203,109,29,154,20,134
"2011","Mansfield 003E","E01028278","Total",641,274,21,253,149,51,220,29,191
"2011","Mansfield 004A","E01028271","Total",792,332,60,272,224,91,261,32,229
"2011","Mansfield 004B","E01028279","Total",663,323,20,303,140,43,281,29,252
"2011","Mansfield 004C","E01028280","Total",547,238,29,209,164,58,200,43,157
"2011","Mansfield 004D","E01028281","Total",573,226,81,145,244,103,195,59,136
"2011","Mansfield 004E","E01028283","Total",772,248,13,235,230,95,177,31,146
"2011","Mansfield 005A","E01028242","Total",695,180,8,172,171,66,214,31,183
"2011","Mansfield 005B","E01028250","Total",605,184,20,164,186,66,167,30,137
"2011","Mansfield 005C","E01028272","Total",729,271,33,238,209,75,220,39,181
"2011","Mansfield 005D","E01028273","Total",624,176,25,151,195,67,162,24,138
"2011","Mansfield 006A","E01028229","Total",720,341,12,329,118,40,269,21,248
"2011","Mansfield 006B","E01028232","Total",656,269,29,240,162,66,234,38,196
"2011","Mansfield 006E","E01028267","Total",726,269,70,199,293,115,244,73,171
"2011","Mansfield 006F","E01028282","Total",515,237,40,197,151,66,192,25,167
"2011","Mansfield 006G","E01033392","Total",960,414,52,362,256,103,343,55,288
"2011","Mansfield 007A","E01028237","Total",659,224,15,209,162,53,183,23,160
"2011","Mansfield 007B","E01028238","Total",594,241,54,187,231,79,185,59,126
"2011","Mansfield 007C","E01028239","Total",657,211,35,176,219,93,188,49,139
"2011","Mansfield 007D","E01028240","Total",628,193,12,181,177,60,172,28,144
"2011","Mansfield 007E","E01028241","Total",884,159,17,142,353,132,177,52,125
"2011","Mansfield 007F","E01028243","Total",809,384,23,361,198,76,296,36,260
"2011","Mansfield 008A","E01028227","Total",608,254,45,209,184,86,194,32,162
"2011","Mansfield 008B","E01028228","Total",511,190,12,178,137,65,142,18,124
"2011","Mansfield 008C","E01028247","Total",789,273,60,213,235,123,213,39,174
"2011","Mansfield 008D","E01028268","Total",770,241,60,181,230,123,182,33,149
"2011","Mansfield 008E","E01028269","Total",656,191,35,156,195,89,180,23,157
"2011","Mansfield 008F","E01028284","Total",714,320,38,282,196,98,240,36,204
"2011","Mansfield 009A","E01028233","Total",806,253,56,197,256,120,199,51,148
"2011","Mansfield 009B","E01028234","Total",797,368,85,283,280,128,277,61,216
"2011","Mansfield 009C","E01028274","Total",691,221,24,197,144,50,192,26,166
"2011","Mansfield 009D","E01028275","Total",665,284,96,188,264,130,216,58,158
"2011","Mansfield 009E","E01028276","Total",767,444,94,350,198,110,329,48,281
"2011","Mansfield 010A","E01028230","Total",584,214,47,167,208,85,187,49,138
"2011","Mansfield 010B","E01028231","Total",652,301,42,259,188,65,244,44,200
"2011","Mansfield 010C","E01028244","Total",666,196,10,186,176,82,174,24,150
"2011","Mansfield 010D","E01028245","Total",589,263,44,219,182,58,221,48,173
"2011","Mansfield 010E","E01028246","Total",720,198,11,187,181,65,194,32,162
"2011","Mansfield 010F","E01028248","Total",634,265,40,225,177,76,200,34,166
"2011","Mansfield 010G","E01028249","Total",561,196,20,176,174,53,178,35,143
"2011","Mansfield 011A","E01028235","Total",678,192,8,184,191,74,179,32,147
"2011","Mansfield 011B","E01028236","Total",715,200,20,180,241,83,187,41,146
"2011","Mansfield 011C","E01028262","Total",618,186,9,177,165,58,178,31,147
"2011","Mansfield 011D","E01028264","Total",779,235,10,225,229,74,202,30,172
"2011","Mansfield 012A","E01028254","Total",561,230,33,197,148,58,179,36,143
"2011","Mansfield 012B","E01028256","Total",807,364,50,314,205,84,280,47,233
"2011","Mansfield 012C","E01028261","Total",686,309,81,228,242,93,221,59,162
"2011","Mansfield 012D","E01028263","Total",785,449,82,367,210,73,367,49,318
"2011","Mansfield 013A","E01028219","Total",626,234,5,229,121,48,174,18,156
"2011","Mansfield 013B","E01028220","Total",781,199,13,186,200,72,197,37,160
"2011","Mansfield 013D","E01028222","Total",680,269,4,265,155,57,205,19,186
"2011","Mansfield 013E","E01028255","Total",594,276,10,266,104,25,166,19,147
"2011","Mansfield 013F","E01028270","Total",651,215,9,206,185,64,165,24,141
"2011","Mansfield 013G","E01033389","Total",594,80,12,68,198,107,65,15,50
"2011","Mansfield 013H","E01033390","Total",584,42,11,31,274,136,64,34,30
"2011","Mansfield 013I","E01033391","Total",511,175,3,172,128,43,127,15,112
"2011","Newark and Sherwood 001A","E01028301","Total",727,294,106,188,294,125,218,68,150
"2011","Newark and Sherwood 001B","E01028302","Total",690,254,18,236,172,58,228,29,199
"2011","Newark and Sherwood 001C","E01028338","Total",665,256,25,231,212,59,239,43,196
"2011","Newark and Sherwood 001D","E01028339","Total",727,199,41,158,261,91,197,46,151
"2011","Newark and Sherwood 001E","E01028340","Total",710,317,23,294,170,52,297,33,264
"2011","Newark and Sherwood 001F","E01028341","Total",758,293,5,288,125,34,224,15,209
"2011","Newark and Sherwood 002A","E01028313","Total",849,375,50,325,245,106,320,46,274
"2011","Newark and Sherwood 002B","E01028314","Total",978,214,43,171,418,157,256,78,178
"2011","Newark and Sherwood 002C","E01028321","Total",717,304,13,291,145,48,221,23,198
"2011","Newark and Sherwood 002D","E01028322","Total",884,374,12,362,199,60,296,35,261
"2011","Newark and Sherwood 002E","E01028323","Total",667,164,17,147,238,76,174,40,134
"2011","Newark and Sherwood 003A","E01028303","Total",669,274,8,266,152,51,195,23,172
"2011","Newark and Sherwood 003B","E01028312","Total",937,282,14,268,246,78,250,34,216
"2011","Newark and Sherwood 003C","E01028337","Total",621,191,4,187,175,40,145,22,123
"2011","Newark and Sherwood 003D","E01028349","Total",631,181,12,169,159,44,157,35,122
"2011","Newark and Sherwood 003E","E01028350","Total",498,182,9,173,135,42,125,14,111
"2011","Newark and Sherwood 004A","E01028315","Total",653,271,8,263,135,45,198,20,178
"2011","Newark and Sherwood 004B","E01028316","Total",702,317,16,301,122,46,221,22,199
"2011","Newark and Sherwood 004C","E01028317","Total",642,177,11,166,182,50,168,26,142
"2011","Newark and Sherwood 004D","E01028353","Total",1159,371,16,355,337,122,293,48,245
"2011","Newark and Sherwood 005A","E01028295","Total",801,241,21,220,241,86,203,37,166
"2011","Newark and Sherwood 005B","E01028297","Total",815,326,56,270,260,122,268,51,217
"2011","Newark and Sherwood 005C","E01028327","Total",672,226,8,218,186,54,180,24,156
"2011","Newark and Sherwood 005D","E01028328","Total",738,283,7,276,189,62,184,21,163
"2011","Newark and Sherwood 005E","E01028329","Total",626,185,12,173,198,60,124,25,99
"2011","Newark and Sherwood 006A","E01028296","Total",554,208,27,181,164,62,169,39,130
"2011","Newark and Sherwood 006B","E01028298","Total",664,179,13,166,204,70,174,36,138
"2011","Newark and Sherwood 006C","E01028299","Total",525,168,33,135,188,74,163,42,121
"2011","Newark and Sherwood 006D","E01028300","Total",681,281,45,236,207,93,236,44,192
"2011","Newark and Sherwood 006E","E01028342","Total",622,149,38,111,235,96,155,42,113
"2011","Newark and Sherwood 006F","E01028343","Total",899,389,36,353,235,79,340,48,292
"2011","Newark and Sherwood 006G","E01028344","Total",610,165,16,149,187,48,176,40,136
"2011","Newark and Sherwood 007A","E01028294","Total",820,262,28,234,215,105,205,28,177
"2011","Newark and Sherwood 007B","E01028304","Total",648,257,54,203,187,102,193,33,160
"2011","Newark and Sherwood 007C","E01028305","Total",568,146,26,120,169,71,125,26,99
"2011","Newark and Sherwood 007D","E01028306","Total",688,243,46,197,203,80,189,32,157
"2011","Newark and Sherwood 007E","E01028307","Total",500,92,19,73,175,68,97,23,74
"2011","Newark and Sherwood 007F","E01028310","Total",888,289,44,245,180,95,204,30,174
"2011","Newark and Sherwood 007G","E01028311","Total",843,349,24,325,123,66,251,15,236
"2011","Newark and Sherwood 008A","E01028345","Total",999,459,15,444,213,64,261,23,238
"2011","Newark and Sherwood 008B","E01028346","Total",925,333,11,322,256,65,244,36,208
"2011","Newark and Sherwood 008C","E01028347","Total",638,212,5,207,202,58,137,25,112
"2011","Newark and Sherwood 008D","E01028348","Total",507,206,4,202,131,45,150,14,136
"2011","Newark and Sherwood 009A","E01028292","Total",902,212,11,201,304,127,168,31,137
"2011","Newark and Sherwood 009B","E01028293","Total",851,221,29,192,266,121,172,28,144
"2011","Newark and Sherwood 009C","E01028333","Total",614,190,24,166,161,71,150,25,125
"2011","Newark and Sherwood 009D","E01028334","Total",595,219,60,159,231,81,175,56,119
"2011","Newark and Sherwood 009E","E01028335","Total",865,302,28,274,182,79,220,27,193
"2011","Newark and Sherwood 010A","E01028308","Total",736,284,21,263,144,66,190,22,168
"2011","Newark and Sherwood 010B","E01028309","Total",632,222,6,216,128,49,159,12,147
"2011","Newark and Sherwood 010C","E01028318","Total",621,262,41,221,193,72,208,43,165
"2011","Newark and Sherwood 010D","E01028319","Total",848,386,66,320,244,115,298,48,250
"2011","Newark and Sherwood 010E","E01028320","Total",765,394,87,307,232,120,293,40,253
"2011","Newark and Sherwood 011A","E01028285","Total",527,121,11,110,169,46,104,15,89
"2011","Newark and Sherwood 011B","E01028286","Total",598,297,7,290,127,35,209,21,188
"2011","Newark and Sherwood 011C","E01028287","Total",640,243,8,235,166,59,169,25,144
"2011","Newark and Sherwood 011D","E01028288","Total",644,225,15,210,195,70,163,31,132
"2011","Newark and Sherwood 011E","E01028289","Total",642,210,13,197,141,49,173,27,146
"2011","Newark and Sherwood 011F","E01028290","Total",614,223,18,205,175,61,178,23,155
"2011","Newark and Sherwood 011G","E01028291","Total",638,179,33,146,224,78,176,44,132
"2011","Newark and Sherwood 012B","E01028325","Total",515,165,7,158,124,45,135,19,116
"2011","Newark and Sherwood 012C","E01028326","Total",583,240,13,227,124,38,176,16,160
"2011","Newark and Sherwood 012D","E01028336","Total",474,154,4,150,128,43,115,19,96
"2011","Newark and Sherwood 012E","E01028352","Total",468,127,7,120,150,30,95,20,75
"2011","Newark and Sherwood 012F","E01033393","Total",865,79,14,65,350,167,112,48,64
"2011","Newark and Sherwood 012G","E01033394","Total",561,201,9,192,136,44,145,21,124
"2011","Newark and Sherwood 013A","E01028330","Total",689,238,7,231,184,55,170,32,138
"2011","Newark and Sherwood 013B","E01028331","Total",598,184,8,176,161,53,151,22,129
"2011","Newark and Sherwood 013C","E01028332","Total",692,208,4,204,198,58,138,16,122
"2011","Newark and Sherwood 013D","E01028351","Total",481,161,4,157,143,33,116,15,101
"2011","Rushcliffe 001A","E01028371","Total",820,293,10,283,213,62,183,24,159
"2011","Rushcliffe 001B","E01028403","Total",944,344,13,331,270,73,244,26,218
"2011","Rushcliffe 001C","E01028411","Total",851,206,4,202,267,81,178,29,149
"2011","Rushcliffe 002A","E01028357","Total",631,256,6,250,159,60,156,15,141
"2011","Rushcliffe 002B","E01028358","Total",628,253,13,240,147,48,173,13,160
"2011","Rushcliffe 002C","E01028359","Total",667,150,3,147,244,109,96,19,77
"2011","Rushcliffe 002D","E01028360","Total",766,137,22,115,263,116,119,37,82
"2011","Rushcliffe 002E","E01028361","Total",604,155,10,145,205,73,127,23,104
"2011","Rushcliffe 002F","E01028362","Total",593,235,32,203,189,69,176,31,145
"2011","Rushcliffe 003A","E01028393","Total",502,205,5,200,99,31,118,10,108
"2011","Rushcliffe 003B","E01028394","Total",693,299,12,287,155,49,198,20,178
"2011","Rushcliffe 003C","E01028395","Total",571,113,7,106,212,76,103,21,82
"2011","Rushcliffe 003D","E01028413","Total",754,318,17,301,219,90,242,33,209
"2011","Rushcliffe 003E","E01028414","Total",692,274,12,262,152,68,169,23,146
"2011","Rushcliffe 003F","E01028415","Total",628,186,6,180,187,66,140,25,115
"2011","Rushcliffe 004A","E01028354","Total",598,158,4,154,219,78,121,24,97
"2011","Rushcliffe 004B","E01028355","Total",658,191,8,183,184,86,158,23,135
"2011","Rushcliffe 004C","E01028384","Total",667,113,7,106,226,105,105,23,82
"2011","Rushcliffe 004D","E01028385","Total",674,145,8,137,251,115,127,33,94
"2011","Rushcliffe 004E","E01028386","Total",632,110,2,108,219,93,109,19,90
"2011","Rushcliffe 005A","E01028396","Total",641,116,5,111,206,78,89,13,76
"2011","Rushcliffe 005B","E01028398","Total",690,209,19,190,172,97,156,21,135
"2011","Rushcliffe 005C","E01028399","Total",498,116,7,109,191,84,91,12,79
"2011","Rushcliffe 005D","E01028416","Total",691,196,7,189,112,41,176,16,160
"2011","Rushcliffe 005E","E01028417","Total",622,95,3,92,124,53,100,11,89
"2011","Rushcliffe 005F","E01028418","Total",679,239,5,234,119,56,184,13,171
"2011","Rushcliffe 006A","E01028356","Total",606,162,15,147,209,73,134,28,106
"2011","Rushcliffe 006B","E01028375","Total",794,148,33,115,277,126,112,37,75
"2011","Rushcliffe 006C","E01028376","Total",670,180,3,177,191,78,126,15,111
"2011","Rushcliffe 006D","E01028377","Total",735,130,7,123,312,119,136,29,107
"2011","Rushcliffe 006E","E01028397","Total",696,187,14,173,243,73,140,34,106
"2011","Rushcliffe 007A","E01028363","Total",510,70,3,67,230,79,75,28,47
"2011","Rushcliffe 007B","E01028364","Total",676,124,4,120,262,100,97,22,75
"2011","Rushcliffe 007C","E01028365","Total",681,149,7,142,205,70,119,20,99
"2011","Rushcliffe 007D","E01028391","Total",826,310,9,301,230,66,228,33,195
"2011","Rushcliffe 007E","E01028392","Total",934,397,28,369,233,87,288,35,253
"2011","Rushcliffe 008A","E01028372","Total",557,245,14,231,132,48,173,17,156
"2011","Rushcliffe 008B","E01028373","Total",562,221,3,218,164,58,122,21,101
"2011","Rushcliffe 008C","E01028374","Total",580,279,23,256,170,58,188,24,164
"2011","Rushcliffe 008D","E01028400","Total",584,144,2,142,224,74,108,30,78
"2011","Rushcliffe 008E","E01028401","Total",481,118,8,110,193,56,102,23,79
"2011","Rushcliffe 009A","E01028366","Total",515,163,36,127,208,82,145,34,111
"2011","Rushcliffe 009B","E01028367","Total",549,158,11,147,167,65,125,24,101
"2011","Rushcliffe 009C","E01028368","Total",632,157,13,144,175,68,150,30,120
"2011","Rushcliffe 009D","E01028369","Total",592,161,39,122,227,86,138,39,99
"2011","Rushcliffe 009E","E01028370","Total",640,231,14,217,164,62,178,25,153
"2011","Rushcliffe 010A","E01028402","Total",772,211,8,203,220,62,156,31,125
"2011","Rushcliffe 010B","E01028419","Total",1046,316,12,304,276,112,256,31,225
"2011","Rushcliffe 010C","E01028420","Total",579,185,11,174,161,52,129,24,105
"2011","Rushcliffe 011A","E01028404","Total",674,208,10,198,181,58,138,18,120
"2011","Rushcliffe 011B","E01028405","Total",899,318,27,291,258,131,242,38,204
"2011","Rushcliffe 011C","E01028406","Total",710,213,14,199,214,93,184,19,165
"2011","Rushcliffe 011D","E01028407","Total",863,225,16,209,242,113,175,28,147
"2011","Rushcliffe 012A","E01028379","Total",719,323,6,317,146,27,207,26,181
"2011","Rushcliffe 012B","E01028412","Total",793,310,4,306,207,70,180,24,156
"2011","Rushcliffe 012C","E01028421","Total",866,265,13,252,260,74,186,29,157
"2011","Rushcliffe 013A","E01028380","Total",530,196,40,156,171,77,189,37,152
"2011","Rushcliffe 013B","E01028381","Total",597,233,3,230,131,37,141,17,124
"2011","Rushcliffe 013C","E01028382","Total",628,257,5,252,170,45,180,29,151
"2011","Rushcliffe 013D","E01028383","Total",505,216,2,214,95,26,159,14,145
"2011","Rushcliffe 014A","E01028378","Total",892,301,11,290,197,58,206,29,177
"2011","Rushcliffe 014B","E01028387","Total",672,218,26,192,263,94,187,47,140
"2011","Rushcliffe 014C","E01028408","Total",861,258,15,243,251,90,202,37,165
"2011","Rushcliffe 015A","E01028388","Total",622,146,5,141,240,71,114,26,88
"2011","Rushcliffe 015B","E01028389","Total",669,299,1,298,131,38,196,25,171
"2011","Rushcliffe 015C","E01028390","Total",686,261,13,248,168,58,185,17,168
"2011","Rushcliffe 015D","E01028409","Total",508,131,3,128,153,50,101,14,87
"2011","Rushcliffe 015E","E01028410","Total",530,168,8,160,156,49,119,12,107
"2011","Herefordshire 001A","E01013998","Total",612,249,8,241,115,23,172,17,155
"2011","Herefordshire 001B","E01014051","Total",737,250,29,221,215,67,167,24,143
"2011","Herefordshire 001C","E01014052","Total",652,198,10,188,150,32,183,31,152
"2011","Herefordshire 001D","E01014096","Total",649,214,11,203,152,42,147,15,132
"2011","Herefordshire 002A","E01014041","Total",721,309,21,288,151,69,239,24,215
"2011","Herefordshire 002B","E01014042","Total",665,250,74,176,256,110,201,61,140
"2011","Herefordshire 002C","E01014043","Total",513,239,10,229,96,40,151,11,140
"2011","Herefordshire 002D","E01014044","Total",598,191,29,162,192,85,145,33,112
"2011","Herefordshire 003A","E01014045","Total",683,206,8,198,175,64,162,31,131
"2011","Herefordshire 003B","E01014046","Total",616,218,15,203,142,44,173,20,153
"2011","Herefordshire 003C","E01014047","Total",612,247,41,206,190,78,198,46,152
"2011","Herefordshire 003D","E01014048","Total",776,329,26,303,141,74,263,21,242
"2011","Herefordshire 004A","E01013999","Total",614,245,4,241,138,35,160,20,140
"2011","Herefordshire 004B","E01014017","Total",632,199,10,189,169,49,149,27,122
"2011","Herefordshire 004C","E01014024","Total",545,151,9,142,121,36,125,18,107
"2011","Herefordshire 004D","E01014025","Total",596,229,9,220,121,29,160,13,147
"2011","Herefordshire 004E","E01014055","Total",672,225,19,206,180,60,165,25,140
"2011","Herefordshire 004F","E01014097","Total",576,197,6,191,130,37,166,27,139
"2011","Herefordshire 005A","E01014000","Total",567,171,10,161,132,35,148,22,126
"2011","Herefordshire 005B","E01014001","Total",623,199,12,187,140,42,147,18,129
"2011","Herefordshire 005C","E01014002","Total",616,289,7,282,113,37,201,14,187
"2011","Herefordshire 005D","E01014003","Total",595,203,20,183,181,72,171,33,138
"2011","Herefordshire 005E","E01014004","Total",589,195,5,190,143,42,141,16,125
"2011","Herefordshire 005F","E01014005","Total",798,343,45,298,186,70,234,29,205
"2011","Herefordshire 005G","E01014015","Total",656,189,7,182,180,59,163,33,130
"2011","Herefordshire 006A","E01014008","Total",705,263,9,254,151,49,202,22,180
"2011","Herefordshire 006B","E01014009","Total",646,218,9,209,138,54,159,16,143
"2011","Herefordshire 006C","E01014033","Total",776,300,25,275,168,60,205,28,177
"2011","Herefordshire 006D","E01014034","Total",683,265,32,233,180,77,201,24,177
"2011","Herefordshire 006E","E01014056","Total",610,182,8,174,162,46,154,27,127
"2011","Herefordshire 007A","E01014006","Total",652,223,12,211,179,48,162,34,128
"2011","Herefordshire 007B","E01014012","Total",699,253,3,250,141,53,214,25,189
"2011","Herefordshire 007C","E01014013","Total",670,167,26,141,315,144,168,55,113
"2011","Herefordshire 007D","E01014016","Total",665,320,23,297,167,56,193,22,171
"2011","Herefordshire 007E","E01014100","Total",650,205,11,194,155,45,167,24,143
"2011","Herefordshire 007F","E01014101","Total",454,138,4,134,94,29,108,13,95
"2011","Herefordshire 008A","E01014022","Total",791,185,8,177,253,63,173,25,148
"2011","Herefordshire 008B","E01014023","Total",680,164,26,138,234,106,154,34,120
"2011","Herefordshire 008C","E01014081","Total",598,201,7,194,159,55,170,26,144
"2011","Herefordshire 008D","E01014082","Total",694,241,12,229,195,60,180,25,155
"2011","Herefordshire 009A","E01014027","Total",532,169,6,163,107,32,126,13,113
"2011","Herefordshire 009B","E01014028","Total",624,250,10,240,120,30,163,21,142
"2011","Herefordshire 009C","E01014029","Total",656,290,12,278,150,44,197,26,171
"2011","Herefordshire 009D","E01014030","Total",587,200,9,191,144,35,143,21,122
"2011","Herefordshire 010A","E01014083","Total",710,277,2,275,162,63,196,26,170
"2011","Herefordshire 010B","E01014084","Total",735,260,15,245,182,70,201,20,181
"2011","Herefordshire 010C","E01014085","Total",578,187,29,158,182,63,164,35,129
"2011","Herefordshire 010D","E01014087","Total",712,159,4,155,143,63,152,23,129
"2011","Herefordshire 010E","E01014088","Total",696,191,14,177,154,80,156,17,139
"2011","Herefordshire 010F","E01014089","Total",579,159,23,136,190,73,157,34,123
"2011","Herefordshire 011A","E01013987","Total",671,247,9,238,164,71,171,18,153
"2011","Herefordshire 011B","E01013988","Total",912,421,4,417,137,41,312,22,290
"2011","Herefordshire 011C","E01014007","Total",668,195,10,185,191,57,147,34,113
"2011","Herefordshire 011D","E01014095","Total",581,171,28,143,205,58,155,36,119
"2011","Herefordshire 012A","E01013986","Total",729,248,31,217,217,90,218,36,182
"2011","Herefordshire 012B","E01013989","Total",582,185,28,157,183,85,150,26,124
"2011","Herefordshire 012C","E01014010","Total",849,273,28,245,153,59,188,18,170
"2011","Herefordshire 012D","E01014011","Total",648,190,20,170,188,77,176,28,148
"2011","Herefordshire 012E","E01014086","Total",713,238,35,203,184,95,202,24,178
"2011","Herefordshire 012F","E01014092","Total",903,294,14,280,187,73,236,25,211
"2011","Herefordshire 013A","E01014075","Total",693,195,8,187,205,77,165,28,137
"2011","Herefordshire 013B","E01014076","Total",1030,259,22,237,277,121,238,41,197
"2011","Herefordshire 013C","E01014077","Total",710,230,8,222,175,56,170,30,140
"2011","Herefordshire 013D","E01014078","Total",599,205,16,189,177,72,159,26,133
"2011","Herefordshire 014A","E01014090","Total",601,228,4,224,192,47,172,28,144
"2011","Herefordshire 014B","E01014091","Total",634,251,5,246,156,42,176,15,161
"2011","Herefordshire 014C","E01014093","Total",598,232,12,220,162,55,173,34,139
"2011","Herefordshire 014D","E01014094","Total",589,199,12,187,184,64,152,21,131
"2011","Herefordshire 015A","E01014068","Total",609,199,16,183,153,58,168,40,128
"2011","Herefordshire 015B","E01014070","Total",897,234,18,216,294,134,235,50,185
"2011","Herefordshire 015C","E01014072","Total",826,218,41,177,287,140,205,50,155
"2011","Herefordshire 015D","E01014073","Total",801,281,60,221,315,184,225,42,183
"2011","Herefordshire 015E","E01014074","Total",722,325,59,266,202,104,251,36,215
"2011","Herefordshire 016A","E01013996","Total",680,159,11,148,203,84,153,26,127
"2011","Herefordshire 016B","E01013997","Total",822,169,15,154,275,99,169,38,131
"2011","Herefordshire 016C","E01014079","Total",641,203,19,184,184,61,188,30,158
"2011","Herefordshire 016D","E01014080","Total",598,263,13,250,137,49,183,26,157
"2011","Herefordshire 017A","E01013992","Total",594,141,31,110,208,101,161,41,120
"2011","Herefordshire 017B","E01013993","Total",606,216,50,166,227,88,182,45,137
"2011","Herefordshire 017C","E01013994","Total",632,242,57,185,238,116,217,54,163
"2011","Herefordshire 017D","E01013995","Total",734,306,114,192,316,169,235,66,169
"2011","Herefordshire 017E","E01014071","Total",610,241,56,185,196,71,185,47,138
"2011","Herefordshire 018A","E01013990","Total",751,268,13,255,166,38,205,20,185
"2011","Herefordshire 018B","E01013991","Total",536,168,10,158,161,55,124,27,97
"2011","Herefordshire 018C","E01014014","Total",729,183,7,176,209,65,146,19,127
"2011","Herefordshire 018D","E01014054","Total",585,166,6,160,130,34,141,19,122
"2011","Herefordshire 019A","E01014035","Total",790,288,27,261,215,86,236,33,203
"2011","Herefordshire 019B","E01014036","Total",690,318,11,307,130,42,193,17,176
"2011","Herefordshire 019C","E01014037","Total",733,371,8,363,125,45,242,23,219
"2011","Herefordshire 019D","E01014038","Total",624,218,23,195,164,67,163,38,125
"2011","Herefordshire 019E","E01014039","Total",721,174,11,163,268,105,135,33,102
"2011","Herefordshire 019F","E01014040","Total",757,322,11,311,149,54,235,21,214
"2011","Herefordshire 020A","E01014018","Total",628,195,8,187,157,49,151,22,129
"2011","Herefordshire 020B","E01014019","Total",671,213,14,199,167,54,188,29,159
"2011","Herefordshire 020C","E01014020","Total",636,179,9,170,173,51,164,31,133
"2011","Herefordshire 020D","E01014021","Total",638,230,10,220,154,58,176,26,150
"2011","Herefordshire 021A","E01014026","Total",896,292,21,271,221,80,231,43,188
"2011","Herefordshire 021B","E01014059","Total",780,226,8,218,215,59,217,40,177
"2011","Herefordshire 021C","E01014060","Total",646,221,9,212,171,53,162,28,134
"2011","Herefordshire 021D","E01014069","Total",793,166,39,127,299,149,159,40,119
"2011","Herefordshire 021E","E01014098","Total",583,182,28,154,218,69,161,41,120
"2011","Herefordshire 021F","E01014099","Total",735,233,8,225,186,63,201,29,172
"2011","Herefordshire 022A","E01014061","Total",683,328,8,320,152,38,192,25,167
"2011","Herefordshire 022B","E01014062","Total",819,326,17,309,151,69,225,19,206
"2011","Herefordshire 022C","E01014063","Total",734,298,26,272,215,71,198,34,164
"2011","Herefordshire 022D","E01014064","Total",779,298,38,260,195,81,243,38,205
"2011","Herefordshire 022E","E01014065","Total",634,200,19,181,178,72,166,33,133
"2011","Herefordshire 022F","E01014066","Total",541,208,8,200,105,34,135,9,126
"2011","Herefordshire 022G","E01014067","Total",594,199,2,197,167,49,141,25,116
"2011","Herefordshire 023A","E01014031","Total",631,202,14,188,161,49,164,23,141
"2011","Herefordshire 023B","E01014032","Total",689,229,5,224,167,44,162,11,151
"2011","Herefordshire 023C","E01014049","Total",666,233,10,223,157,52,166,23,143
"2011","Herefordshire 023D","E01014050","Total",706,198,12,186,197,55,178,34,144
"2011","Herefordshire 023E","E01014053","Total",719,213,6,207,167,49,163,23,140
"2011","Herefordshire 023F","E01014057","Total",726,274,22,252,183,63,199,22,177
"2011","Herefordshire 023G","E01014058","Total",699,231,5,226,145,38,167,25,142
"2011","Shropshire 025A","E01028853","Total",641,246,27,219,186,54,210,39,171
"2011","Shropshire 025B","E01028854","Total",665,223,4,219,144,50,166,16,150
"2011","Shropshire 025C","E01028855","Total",656,188,9,179,178,60,155,25,130
"2011","Shropshire 025D","E01028856","Total",602,210,6,204,130,51,158,15,143
"2011","Shropshire 025E","E01028857","Total",752,243,16,227,197,61,174,22,152
"2011","Shropshire 027A","E01028826","Total",760,276,19,257,156,50,209,28,181
"2011","Shropshire 027B","E01028827","Total",598,181,11,170,212,77,164,33,131
"2011","Shropshire 027C","E01028844","Total",478,79,2,77,230,135,69,17,52
"2011","Shropshire 027D","E01028845","Total",881,373,3,370,176,42,235,16,219
"2011","Shropshire 029A","E01028838","Total",649,265,30,235,176,73,210,42,168
"2011","Shropshire 029B","E01028839","Total",555,183,10,173,156,56,144,28,116
"2011","Shropshire 029C","E01028840","Total",534,155,13,142,141,49,116,18,98
"2011","Shropshire 029D","E01028841","Total",681,214,19,195,169,60,208,31,177
"2011","Shropshire 029E","E01028850","Total",931,204,8,196,248,93,192,30,162
"2011","Shropshire 029F","E01028851","Total",741,262,13,249,167,48,189,25,164
"2011","Shropshire 029G","E01028852","Total",708,257,13,244,174,61,184,21,163
"2011","Shropshire 031A","E01028830","Total",702,253,5,248,135,39,211,25,186
"2011","Shropshire 031B","E01028831","Total",635,216,9,207,173,51,141,15,126
"2011","Shropshire 031C","E01028836","Total",686,300,24,276,178,64,219,29,190
"2011","Shropshire 031D","E01028837","Total",660,215,4,211,149,37,160,23,137
"2011","Shropshire 033A","E01028832","Total",871,274,10,264,156,54,214,23,191
"2011","Shropshire 033B","E01028833","Total",670,257,8,249,139,37,193,17,176
"2011","Shropshire 033C","E01028834","Total",645,232,19,213,160,55,184,24,160
"2011","Shropshire 033D","E01028835","Total",632,181,12,169,159,63,163,25,138
"2011","Shropshire 034A","E01028828","Total",673,192,10,182,197,73,178,29,149
"2011","Shropshire 034B","E01028829","Total",579,217,7,210,127,37,135,15,120
"2011","Shropshire 034C","E01028842","Total",665,196,5,191,179,34,130,16,114
"2011","Shropshire 034D","E01028847","Total",617,180,8,172,149,52,123,20,103
"2011","Shropshire 034E","E01028859","Total",661,184,11,173,168,55,154,19,135
"2011","Shropshire 035A","E01028843","Total",681,196,15,181,184,65,168,23,145
"2011","Shropshire 035B","E01028846","Total",729,217,15,202,185,61,161,18,143
"2011","Shropshire 035C","E01028848","Total",690,262,15,247,173,51,186,30,156
"2011","Shropshire 035D","E01028849","Total",893,357,62,295,260,106,256,46,210
"2011","Shropshire 035E","E01028858","Total",839,268,10,258,194,51,196,23,173
"2011","Shropshire 001A","E01028891","Total",850,310,23,287,196,95,246,29,217
"2011","Shropshire 001B","E01028892","Total",593,193,4,189,126,34,155,13,142
"2011","Shropshire 001C","E01028894","Total",649,232,18,214,193,82,176,31,145
"2011","Shropshire 001D","E01028895","Total",684,224,27,197,204,78,170,33,137
"2011","Shropshire 001E","E01028896","Total",889,258,22,236,271,130,194,34,160
"2011","Shropshire 001F","E01028897","Total",617,242,24,218,182,66,179,28,151
"2011","Shropshire 002A","E01028880","Total",638,227,29,198,195,73,176,38,138
"2011","Shropshire 002B","E01028881","Total",523,190,5,185,116,30,149,25,124
"2011","Shropshire 002C","E01028882","Total",605,144,13,131,175,63,141,21,120
"2011","Shropshire 002D","E01028893","Total",605,150,6,144,153,38,149,28,121
"2011","Shropshire 002E","E01028899","Total",648,204,11,193,158,47,169,28,141
"2011","Shropshire 004A","E01028864","Total",611,194,8,186,147,46,171,16,155
"2011","Shropshire 004B","E01028865","Total",722,253,14,239,222,86,156,29,127
"2011","Shropshire 004C","E01028866","Total",593,181,14,167,158,46,142,19,123
"2011","Shropshire 004D","E01028867","Total",612,281,20,261,154,58,228,30,198
"2011","Shropshire 004E","E01028872","Total",560,144,11,133,154,36,127,29,98
"2011","Shropshire 005A","E01028873","Total",835,348,60,288,229,121,263,36,227
"2011","Shropshire 005B","E01028874","Total",615,282,11,271,115,39,181,24,157
"2011","Shropshire 005C","E01028875","Total",984,267,34,233,350,157,213,57,156
"2011","Shropshire 005D","E01028876","Total",841,358,36,322,213,93,257,34,223
"2011","Shropshire 005E","E01028877","Total",534,168,9,159,160,61,135,28,107
"2011","Shropshire 005F","E01028878","Total",683,237,16,221,176,65,173,29,144
"2011","Shropshire 005G","E01028879","Total",652,219,31,188,195,80,182,33,149
"2011","Shropshire 008A","E01028886","Total",757,259,34,225,243,104,194,29,165
"2011","Shropshire 008B","E01028887","Total",596,253,13,240,152,50,187,24,163
"2011","Shropshire 008C","E01028889","Total",622,273,8,265,117,42,193,20,173
"2011","Shropshire 008D","E01028890","Total",651,247,19,228,174,60,186,31,155
"2011","Shropshire 009A","E01028868","Total",592,187,9,178,173,61,154,20,134
"2011","Shropshire 009B","E01028869","Total",555,143,11,132,178,59,132,30,102
"2011","Shropshire 009C","E01028871","Total",484,135,20,115,138,46,142,28,114
"2011","Shropshire 009D","E01028885","Total",791,179,31,148,325,160,151,43,108
"2011","Shropshire 010A","E01028860","Total",720,238,14,224,261,70,184,31,153
"2011","Shropshire 010B","E01028862","Total",650,192,12,180,177,54,137,26,111
"2011","Shropshire 010C","E01028863","Total",497,139,13,126,159,56,122,20,102
"2011","Shropshire 010D","E01028888","Total",593,134,11,123,199,61,154,35,119
"2011","Shropshire 010E","E01028898","Total",555,148,7,141,152,35,137,23,114
"2011","Shropshire 013A","E01028861","Total",526,173,8,165,136,45,120,24,96
"2011","Shropshire 013B","E01028870","Total",578,139,4,135,190,57,130,20,110
"2011","Shropshire 013C","E01028883","Total",524,111,5,106,185,67,112,16,96
"2011","Shropshire 013D","E01028884","Total",647,231,15,216,182,60,166,22,144
"2011","Shropshire 003A","E01028910","Total",507,172,4,168,124,42,146,16,130
"2011","Shropshire 003B","E01028911","Total",539,170,4,166,131,37,153,18,135
"2011","Shropshire 003C","E01028912","Total",499,211,43,168,149,72,186,38,148
"2011","Shropshire 003D","E01028920","Total",525,187,11,176,134,45,187,24,163
"2011","Shropshire 003E","E01028921","Total",632,185,9,176,199,63,159,25,134
"2011","Shropshire 003F","E01028925","Total",531,161,9,152,124,41,147,22,125
"2011","Shropshire 003G","E01028926","Total",596,232,26,206,176,80,176,37,139
"2011","Shropshire 006C","E01028902","Total",498,214,5,209,92,39,153,15,138
"2011","Shropshire 006D","E01028903","Total",636,310,30,280,133,46,242,24,218
"2011","Shropshire 006E","E01028904","Total",577,188,19,169,195,64,159,29,130
"2011","Shropshire 006F","E01028905","Total",730,224,55,169,259,105,180,40,140
"2011","Shropshire 006G","E01028909","Total",607,208,33,175,181,62,189,44,145
"2011","Shropshire 006H","E01033528","Total",1050,229,15,214,364,125,218,43,175
"2011","Shropshire 007A","E01028906","Total",668,275,16,259,119,52,206,26,180
"2011","Shropshire 007B","E01028907","Total",809,309,12,297,173,70,228,26,202
"2011","Shropshire 007C","E01028908","Total",755,269,59,210,197,102,188,31,157
"2011","Shropshire 007D","E01028916","Total",699,316,4,312,137,49,214,22,192
"2011","Shropshire 007E","E01028917","Total",642,202,6,196,175,74,159,17,142
"2011","Shropshire 007F","E01028924","Total",632,163,20,143,228,115,154,28,126
"2011","Shropshire 011A","E01028913","Total",641,193,11,182,165,54,152,15,137
"2011","Shropshire 011B","E01028918","Total",580,163,16,147,178,61,132,24,108
"2011","Shropshire 011C","E01028919","Total",493,124,11,113,170,56,99,19,80
"2011","Shropshire 011D","E01028927","Total",427,143,8,135,118,39,114,23,91
"2011","Shropshire 011E","E01028928","Total",644,218,20,198,176,57,190,39,151
"2011","Shropshire 012A","E01028914","Total",460,173,9,164,101,30,125,19,106
"2011","Shropshire 012B","E01028915","Total",586,208,6,202,149,54,147,20,127
"2011","Shropshire 012C","E01028922","Total",494,124,9,115,136,42,118,29,89
"2011","Shropshire 012D","E01028923","Total",648,190,5,185,152,41,150,17,133
"2011","Shropshire 014A","E01028929","Total",593,151,9,142,178,73,114,19,95
"2011","Shropshire 014B","E01028969","Total",541,141,11,130,177,54,134,25,109
"2011","Shropshire 014C","E01028970","Total",493,141,3,138,135,40,123,24,99
"2011","Shropshire 014D","E01028971","Total",910,332,11,321,244,72,253,31,222
"2011","Shropshire 014E","E01028978","Total",616,143,21,122,187,74,134,25,109
"2011","Shropshire 014F","E01028979","Total",508,138,7,131,153,48,123,23,100
"2011","Shropshire 015A","E01028933","Total",655,178,19,159,216,88,143,30,113
"2011","Shropshire 015B","E01028934","Total",614,225,61,164,255,117,175,42,133
"2011","Shropshire 015C","E01028956","Total",642,239,14,225,186,60,161,31,130
"2011","Shropshire 015D","E01028957","Total",641,261,75,186,256,125,203,55,148
"2011","Shropshire 015E","E01028958","Total",764,243,35,208,241,96,234,40,194
"2011","Shropshire 016A","E01028932","Total",784,176,11,165,233,94,157,27,130
"2011","Shropshire 016B","E01028981","Total",668,188,9,179,198,72,144,32,112
"2011","Shropshire 016C","E01028982","Total",642,182,33,149,217,107,161,35,126
"2011","Shropshire 016D","E01028983","Total",810,290,46,244,271,101,255,53,202
"2011","Shropshire 017A","E01028930","Total",678,141,20,121,231,100,109,21,88
"2011","Shropshire 017B","E01028931","Total",925,228,24,204,216,92,193,33,160
"2011","Shropshire 017C","E01028944","Total",836,306,27,279,169,76,240,25,215
"2011","Shropshire 017D","E01028945","Total",1032,302,53,249,256,148,244,35,209
"2011","Shropshire 018A","E01028965","Total",641,281,31,250,170,70,214,41,173
"2011","Shropshire 018B","E01028966","Total",494,152,6,146,145,49,119,21,98
"2011","Shropshire 018C","E01028967","Total",655,301,59,242,236,100,238,41,197
"2011","Shropshire 018D","E01028968","Total",537,190,31,159,197,75,171,41,130
"2011","Shropshire 018E","E01028988","Total",710,168,18,150,218,86,150,28,122
"2011","Shropshire 018F","E01028989","Total",658,184,36,148,259,94,173,42,131
"2011","Shropshire 019A","E01028946","Total",1126,321,14,307,135,42,234,22,212
"2011","Shropshire 019B","E01028972","Total",738,265,7,258,196,69,182,27,155
"2011","Shropshire 019C","E01028973","Total",969,301,15,286,192,89,216,21,195
"2011","Shropshire 019D","E01028987","Total",1056,343,8,335,178,68,257,19,238
"2011","Shropshire 020A","E01028941","Total",835,278,16,262,213,81,227,17,210
"2011","Shropshire 020B","E01028942","Total",514,106,10,96,230,73,96,21,75
"2011","Shropshire 020C","E01028943","Total",1076,280,14,266,235,96,255,33,222
"2011","Shropshire 020D","E01028951","Total",674,251,12,239,176,62,167,21,146
"2011","Shropshire 020E","E01028953","Total",647,270,6,264,176,69,180,23,157
"2011","Shropshire 021A","E01028947","Total",637,302,2,300,126,44,179,11,168
"2011","Shropshire 021B","E01028948","Total",636,272,15,257,157,56,197,26,171
"2011","Shropshire 021C","E01028949","Total",648,231,11,220,155,57,155,28,127
"2011","Shropshire 021D","E01028985","Total",632,238,4,234,119,43,152,12,140
"2011","Shropshire 022A","E01028938","Total",874,298,11,287,159,52,225,22,203
"2011","Shropshire 022B","E01028939","Total",772,189,22,167,190,74,156,28,128
"2011","Shropshire 022C","E01028984","Total",689,249,25,224,144,67,213,32,181
"2011","Shropshire 022D","E01028986","Total",634,220,3,217,176,48,141,30,111
"2011","Shropshire 023A","E01028940","Total",678,242,17,225,204,61,195,38,157
"2011","Shropshire 023B","E01028952","Total",800,252,9,243,199,73,198,31,167
"2011","Shropshire 023C","E01028962","Total",676,268,53,215,226,91,239,59,180
"2011","Shropshire 023D","E01028963","Total",663,207,9,198,200,57,127,14,113
"2011","Shropshire 023E","E01028964","Total",675,208,5,203,199,63,152,27,125
"2011","Shropshire 023F","E01028974","Total",507,141,4,137,145,49,110,14,96
"2011","Shropshire 024A","E01028935","Total",630,226,5,221,152,45,160,21,139
"2011","Shropshire 024B","E01028936","Total",858,305,6,299,204,62,213,35,178
"2011","Shropshire 024C","E01028937","Total",637,200,10,190,188,64,168,28,140
"2011","Shropshire 024D","E01028959","Total",1098,282,12,270,278,111,264,33,231
"2011","Shropshire 026A","E01028954","Total",522,181,6,175,134,33,134,16,118
"2011","Shropshire 026B","E01028955","Total",494,202,12,190,108,49,148,17,131
"2011","Shropshire 026C","E01028975","Total",720,226,14,212,221,90,180,21,159
"2011","Shropshire 026D","E01028976","Total",684,225,11,214,173,55,167,19,148
"2011","Shropshire 026E","E01028977","Total",819,305,10,295,211,74,228,35,193
"2011","Shropshire 028A","E01028950","Total",978,312,18,294,263,82,227,38,189
"2011","Shropshire 028B","E01028960","Total",540,135,3,132,136,37,119,22,97
"2011","Shropshire 028C","E01028961","Total",525,134,10,124,172,49,115,21,94
"2011","Shropshire 028D","E01028980","Total",938,310,14,296,228,68,233,31,202
"2011","Shropshire 030A","E01028991","Total",519,158,12,146,135,43,115,19,96
"2011","Shropshire 030B","E01028992","Total",691,234,17,217,161,63,184,18,166
"2011","Shropshire 030D","E01033529","Total",431,110,1,109,100,27,113,22,91
"2011","Shropshire 030E","E01033530","Total",831,237,9,228,225,72,210,30,180
"2011","Shropshire 032A","E01028990","Total",467,131,10,121,135,45,112,14,98
"2011","Shropshire 032B","E01028997","Total",1075,545,15,530,181,43,311,24,287
"2011","Shropshire 032C","E01028998","Total",1105,497,17,480,208,65,350,43,307
"2011","Shropshire 036A","E01028993","Total",618,155,10,145,166,47,135,24,111
"2011","Shropshire 036B","E01029004","Total",447,137,6,131,87,34,121,16,105
"2011","Shropshire 036C","E01029013","Total",780,285,15,270,163,53,210,27,183
"2011","Shropshire 036D","E01029014","Total",504,191,44,147,178,75,164,46,118
"2011","Shropshire 036E","E01029015","Total",597,168,9,159,132,46,157,23,134
"2011","Shropshire 037A","E01028994","Total",557,242,7,235,115,32,168,19,149
"2011","Shropshire 037B","E01029003","Total",1040,320,5,315,212,76,266,23,243
"2011","Shropshire 037C","E01029005","Total",558,193,5,188,121,44,158,18,140
"2011","Shropshire 037D","E01029016","Total",595,211,7,204,126,34,153,24,129
"2011","Shropshire 038A","E01029006","Total",753,360,15,345,147,49,250,18,232
"2011","Shropshire 038B","E01029007","Total",504,207,40,167,168,71,161,41,120
"2011","Shropshire 038D","E01029009","Total",554,224,8,216,104,36,146,9,137
"2011","Shropshire 038E","E01029010","Total",582,165,32,133,172,67,139,29,110
"2011","Shropshire 038F","E01029011","Total",683,266,23,243,149,52,215,25,190
"2011","Shropshire 038G","E01029012","Total",796,233,26,207,266,103,177,29,148
"2011","Shropshire 038H","E01033526","Total",615,303,14,289,61,20,215,16,199
"2011","Shropshire 038I","E01033527","Total",686,347,10,337,68,28,213,7,206
"2011","Shropshire 039A","E01028995","Total",641,197,8,189,186,61,159,20,139
"2011","Shropshire 039B","E01028996","Total",573,210,5,205,122,40,142,14,128
"2011","Shropshire 039C","E01028999","Total",654,229,9,220,148,42,182,23,159
"2011","Shropshire 039D","E01029000","Total",477,164,3,161,94,21,124,15,109
"2011","Shropshire 039E","E01029001","Total",798,247,22,225,246,76,169,28,141
"2011","Shropshire 039F","E01029002","Total",551,194,23,171,162,62,161,31,130
"2011","Stoke-on-Trent 001A","E01014257","Total",640,217,36,181,176,62,182,32,150
"2011","Stoke-on-Trent 001B","E01014258","Total",541,81,5,76,230,81,114,37,77
"2011","Stoke-on-Trent 001C","E01014259","Total",647,237,20,217,155,59,190,30,160
"2011","Stoke-on-Trent 001D","E01014260","Total",604,300,38,262,153,58,226,34,192
"2011","Stoke-on-Trent 001E","E01014264","Total",772,237,27,210,262,91,190,38,152
"2011","Stoke-on-Trent 002A","E01014357","Total",705,306,33,273,178,82,229,21,208
"2011","Stoke-on-Trent 002B","E01014358","Total",590,271,77,194,212,103,195,39,156
"2011","Stoke-on-Trent 002C","E01014359","Total",758,278,48,230,261,131,231,57,174
"2011","Stoke-on-Trent 002D","E01014360","Total",784,192,36,156,302,146,181,48,133
"2011","Stoke-on-Trent 003A","E01014261","Total",577,281,100,181,232,108,204,54,150
"2011","Stoke-on-Trent 003B","E01014262","Total",528,234,65,169,179,67,185,36,149
"2011","Stoke-on-Trent 003C","E01014263","Total",624,210,80,130,273,114,191,72,119
"2011","Stoke-on-Trent 003D","E01014333","Total",605,169,13,156,172,60,158,33,125
"2011","Stoke-on-Trent 003E","E01014334","Total",756,453,14,439,91,34,324,16,308
"2011","Stoke-on-Trent 004A","E01014331","Total",639,298,80,218,223,102,216,55,161
"2011","Stoke-on-Trent 004B","E01014332","Total",790,361,15,346,146,61,276,33,243
"2011","Stoke-on-Trent 004C","E01014335","Total",751,237,19,218,207,86,187,25,162
"2011","Stoke-on-Trent 004D","E01014336","Total",717,339,66,273,211,95,254,45,209
"2011","Stoke-on-Trent 004E","E01014337","Total",722,298,61,237,233,98,242,46,196
"2011","Stoke-on-Trent 005A","E01014354","Total",846,417,70,347,240,128,303,52,251
"2011","Stoke-on-Trent 005B","E01014355","Total",753,237,42,195,266,145,202,39,163
"2011","Stoke-on-Trent 005C","E01014356","Total",746,273,62,211,251,116,209,47,162
"2011","Stoke-on-Trent 005D","E01014361","Total",667,266,97,169,262,149,188,46,142
"2011","Stoke-on-Trent 006A","E01014241","Total",656,236,50,186,207,76,215,66,149
"2011","Stoke-on-Trent 006B","E01014242","Total",628,307,69,238,214,82,248,61,187
"2011","Stoke-on-Trent 006C","E01014243","Total",599,201,7,194,153,37,170,23,147
"2011","Stoke-on-Trent 006D","E01014244","Total",606,279,100,179,268,143,204,61,143
"2011","Stoke-on-Trent 006E","E01014245","Total",706,221,36,185,238,117,191,45,146
"2011","Stoke-on-Trent 006F","E01014248","Total",660,198,42,156,210,106,192,36,156
"2011","Stoke-on-Trent 007A","E01014214","Total",628,236,1,235,140,34,170,21,149
"2011","Stoke-on-Trent 007B","E01014215","Total",610,220,17,203,188,70,174,29,145
"2011","Stoke-on-Trent 007C","E01014216","Total",634,271,16,255,151,63,219,24,195
"2011","Stoke-on-Trent 007D","E01014265","Total",681,222,7,215,166,62,152,18,134
"2011","Stoke-on-Trent 007E","E01014267","Total",1060,303,33,270,304,140,268,49,219
"2011","Stoke-on-Trent 007F","E01014272","Total",661,225,13,212,165,63,174,23,151
"2011","Stoke-on-Trent 008A","E01014246","Total",728,293,43,250,211,83,231,41,190
"2011","Stoke-on-Trent 008B","E01014266","Total",577,250,38,212,160,72,172,27,145
"2011","Stoke-on-Trent 008C","E01014268","Total",998,419,42,377,294,140,336,40,296
"2011","Stoke-on-Trent 008D","E01014270","Total",650,244,23,221,181,66,184,38,146
"2011","Stoke-on-Trent 008E","E01014271","Total",615,192,22,170,209,79,171,44,127
"2011","Stoke-on-Trent 009A","E01014247","Total",776,303,59,244,226,104,221,48,173
"2011","Stoke-on-Trent 009B","E01014250","Total",537,273,57,216,150,70,210,42,168
"2011","Stoke-on-Trent 009C","E01014251","Total",912,386,67,319,221,119,295,44,251
"2011","Stoke-on-Trent 009D","E01014252","Total",748,229,46,183,231,97,167,25,142
"2011","Stoke-on-Trent 009E","E01014255","Total",692,238,65,173,289,153,212,63,149
"2011","Stoke-on-Trent 010A","E01014269","Total",668,304,67,237,253,110,241,52,189
"2011","Stoke-on-Trent 010B","E01014324","Total",684,298,16,282,147,43,204,17,187
"2011","Stoke-on-Trent 010C","E01014325","Total",518,90,3,87,180,55,100,22,78
"2011","Stoke-on-Trent 010D","E01014326","Total",589,142,10,132,177,49,157,31,126
"2011","Stoke-on-Trent 011A","E01014249","Total",782,392,77,315,224,122,268,61,207
"2011","Stoke-on-Trent 011B","E01014253","Total",657,213,27,186,210,79,181,35,146
"2011","Stoke-on-Trent 011C","E01014254","Total",643,257,87,170,217,124,174,39,135
"2011","Stoke-on-Trent 011D","E01014256","Total",775,354,53,301,201,84,260,41,219
"2011","Stoke-on-Trent 012A","E01014210","Total",612,274,45,229,189,72,218,41,177
"2011","Stoke-on-Trent 012B","E01014211","Total",622,309,68,241,204,82,257,60,197
"2011","Stoke-on-Trent 012C","E01014212","Total",610,306,46,260,174,75,267,35,232
"2011","Stoke-on-Trent 012D","E01014213","Total",521,174,44,130,169,72,151,25,126
"2011","Stoke-on-Trent 012E","E01014217","Total",639,326,80,246,221,93,261,61,200
"2011","Stoke-on-Trent 013A","E01014323","Total",609,191,27,164,177,92,141,22,119
"2011","Stoke-on-Trent 013B","E01014327","Total",675,233,39,194,204,86,178,32,146
"2011","Stoke-on-Trent 013C","E01014328","Total",640,230,37,193,180,84,191,33,158
"2011","Stoke-on-Trent 013D","E01014329","Total",723,295,33,262,220,99,243,43,200
"2011","Stoke-on-Trent 013E","E01014330","Total",912,483,48,435,161,78,385,42,343
"2011","Stoke-on-Trent 014A","E01014218","Total",612,271,67,204,230,87,228,63,165
"2011","Stoke-on-Trent 014B","E01014219","Total",584,222,19,203,135,50,164,24,140
"2011","Stoke-on-Trent 014C","E01014225","Total",668,243,18,225,163,56,190,23,167
"2011","Stoke-on-Trent 014D","E01014226","Total",723,383,16,367,145,54,323,25,298
"2011","Stoke-on-Trent 014E","E01014228","Total",573,222,9,213,114,43,182,16,166
"2011","Stoke-on-Trent 014F","E01014230","Total",686,273,33,240,182,80,228,32,196
"2011","Stoke-on-Trent 015A","E01014281","Total",622,238,46,192,172,79,134,36,98
"2011","Stoke-on-Trent 015B","E01014285","Total",918,281,62,219,291,163,217,49,168
"2011","Stoke-on-Trent 015C","E01014286","Total",544,220,42,178,173,84,159,33,126
"2011","Stoke-on-Trent 015D","E01014287","Total",635,286,58,228,179,89,205,38,167
"2011","Stoke-on-Trent 016B","E01014231","Total",947,394,24,370,113,69,299,21,278
"2011","Stoke-on-Trent 016D","E01014282","Total",493,273,21,252,69,34,156,15,141
"2011","Stoke-on-Trent 016E","E01014283","Total",806,245,20,225,111,69,151,22,129
"2011","Stoke-on-Trent 016F","E01014284","Total",468,185,15,170,57,40,48,7,41
"2011","Stoke-on-Trent 016G","E01033216","Total",1186,432,46,386,246,112,331,45,286
"2011","Stoke-on-Trent 017A","E01014220","Total",717,365,86,279,243,109,279,51,228
"2011","Stoke-on-Trent 017B","E01014221","Total",657,288,69,219,238,102,213,42,171
"2011","Stoke-on-Trent 017C","E01014222","Total",647,308,90,218,239,108,256,73,183
"2011","Stoke-on-Trent 017D","E01014223","Total",749,376,88,288,212,108,256,51,205
"2011","Stoke-on-Trent 017E","E01014224","Total",671,355,93,262,223,100,265,48,217
"2011","Stoke-on-Trent 017F","E01014229","Total",771,327,80,247,304,140,273,59,214
"2011","Stoke-on-Trent 018A","E01014288","Total",728,195,18,177,187,90,142,24,118
"2011","Stoke-on-Trent 018B","E01014289","Total",666,194,15,179,162,80,154,20,134
"2011","Stoke-on-Trent 018C","E01014290","Total",673,184,18,166,197,95,137,29,108
"2011","Stoke-on-Trent 018D","E01014291","Total",624,217,25,192,160,57,177,32,145
"2011","Stoke-on-Trent 018E","E01014292","Total",692,190,21,169,184,77,151,30,121
"2011","Stoke-on-Trent 018F","E01014294","Total",597,212,27,185,164,62,197,39,158
"2011","Stoke-on-Trent 019A","E01014293","Total",772,274,37,237,188,100,183,29,154
"2011","Stoke-on-Trent 019B","E01014295","Total",794,311,21,290,197,70,237,33,204
"2011","Stoke-on-Trent 019C","E01014339","Total",803,276,59,217,213,112,187,32,155
"2011","Stoke-on-Trent 019D","E01014340","Total",863,296,63,233,266,122,217,42,175
"2011","Stoke-on-Trent 019E","E01014345","Total",893,347,55,292,175,89,280,30,250
"2011","Stoke-on-Trent 020A","E01014274","Total",858,313,61,252,268,135,233,42,191
"2011","Stoke-on-Trent 020B","E01014275","Total",754,420,55,365,176,82,326,33,293
"2011","Stoke-on-Trent 020C","E01014276","Total",735,231,38,193,222,98,176,34,142
"2011","Stoke-on-Trent 020D","E01014277","Total",711,259,21,238,182,83,211,28,183
"2011","Stoke-on-Trent 020E","E01014279","Total",803,248,43,205,237,118,184,30,154
"2011","Stoke-on-Trent 021A","E01014273","Total",577,200,69,131,206,113,164,55,109
"2011","Stoke-on-Trent 021B","E01014278","Total",588,202,46,156,163,77,195,43,152
"2011","Stoke-on-Trent 021C","E01014280","Total",610,194,8,186,138,49,170,22,148
"2011","Stoke-on-Trent 021D","E01014297","Total",487,98,13,85,168,55,115,29,86
"2011","Stoke-on-Trent 022A","E01014296","Total",608,208,29,179,181,68,182,34,148
"2011","Stoke-on-Trent 022B","E01014298","Total",687,266,57,209,234,94,239,61,178
"2011","Stoke-on-Trent 022C","E01014300","Total",623,262,54,208,201,78,225,44,181
"2011","Stoke-on-Trent 022D","E01014302","Total",926,444,40,404,212,108,326,33,293
"2011","Stoke-on-Trent 023A","E01014338","Total",676,231,13,218,161,61,196,32,164
"2011","Stoke-on-Trent 023B","E01014341","Total",764,268,33,235,188,67,213,33,180
"2011","Stoke-on-Trent 023C","E01014342","Total",598,264,66,198,218,84,212,53,159
"2011","Stoke-on-Trent 023D","E01014343","Total",843,252,45,207,222,114,193,35,158
"2011","Stoke-on-Trent 023E","E01014344","Total",615,233,45,188,216,86,195,35,160
"2011","Stoke-on-Trent 024A","E01014363","Total",624,292,17,275,119,37,215,31,184
"2011","Stoke-on-Trent 024B","E01014364","Total",597,217,28,189,178,66,172,31,141
"2011","Stoke-on-Trent 024C","E01014365","Total",638,280,16,264,142,46,177,18,159
"2011","Stoke-on-Trent 024D","E01014369","Total",556,213,25,188,151,54,179,28,151
"2011","Stoke-on-Trent 025A","E01014299","Total",598,131,9,122,171,64,149,19,130
"2011","Stoke-on-Trent 025B","E01014301","Total",651,120,15,105,278,117,140,36,104
"2011","Stoke-on-Trent 025C","E01014303","Total",656,138,13,125,230,90,143,30,113
"2011","Stoke-on-Trent 025D","E01014304","Total",645,223,9,214,162,61,188,21,167
"2011","Stoke-on-Trent 025E","E01014362","Total",586,179,10,169,166,56,172,25,147
"2011","Stoke-on-Trent 026A","E01014233","Total",629,287,19,268,139,51,213,28,185
"2011","Stoke-on-Trent 026B","E01014234","Total",564,209,72,137,266,98,190,60,130
"2011","Stoke-on-Trent 026C","E01014239","Total",601,206,19,187,184,59,185,29,156
"2011","Stoke-on-Trent 026D","E01014240","Total",626,241,35,206,202,69,206,51,155
"2011","Stoke-on-Trent 027A","E01014308","Total",768,344,15,329,148,50,265,24,241
"2011","Stoke-on-Trent 027B","E01014309","Total",599,284,22,262,140,63,210,30,180
"2011","Stoke-on-Trent 027C","E01014311","Total",617,269,41,228,144,69,210,26,184
"2011","Stoke-on-Trent 027D","E01014313","Total",830,509,34,475,156,58,374,34,340
"2011","Stoke-on-Trent 028A","E01014321","Total",642,201,16,185,160,77,190,39,151
"2011","Stoke-on-Trent 028B","E01014366","Total",809,410,99,311,256,128,282,64,218
"2011","Stoke-on-Trent 028C","E01014367","Total",666,354,78,276,210,102,267,52,215
"2011","Stoke-on-Trent 028D","E01014368","Total",676,301,72,229,229,114,236,46,190
"2011","Stoke-on-Trent 029A","E01014305","Total",481,184,45,139,194,102,140,35,105
"2011","Stoke-on-Trent 029B","E01014306","Total",539,193,50,143,199,99,171,43,128
"2011","Stoke-on-Trent 029C","E01014307","Total",462,166,47,119,207,114,148,40,108
"2011","Stoke-on-Trent 029D","E01014312","Total",593,230,23,207,171,68,184,31,153
"2011","Stoke-on-Trent 030A","E01014346","Total",729,300,10,290,134,49,214,15,199
"2011","Stoke-on-Trent 030B","E01014348","Total",615,274,9,265,126,53,170,19,151
"2011","Stoke-on-Trent 030C","E01014349","Total",642,273,7,266,145,48,189,19,170
"2011","Stoke-on-Trent 030D","E01014353","Total",706,241,50,191,258,115,217,54,163
"2011","Stoke-on-Trent 031A","E01014310","Total",751,184,18,166,310,132,155,46,109
"2011","Stoke-on-Trent 031B","E01014314","Total",523,120,8,112,191,58,125,32,93
"2011","Stoke-on-Trent 031C","E01014316","Total",616,320,98,222,264,121,232,79,153
"2011","Stoke-on-Trent 031D","E01014317","Total",692,376,81,295,218,91,278,51,227
"2011","Stoke-on-Trent 031E","E01014322","Total",656,237,48,189,231,91,186,41,145
"2011","Stoke-on-Trent 032A","E01014235","Total",765,390,42,348,181,67,326,42,284
"2011","Stoke-on-Trent 032B","E01014236","Total",986,377,84,293,360,166,289,65,224
"2011","Stoke-on-Trent 032C","E01014237","Total",777,388,61,327,205,79,313,47,266
"2011","Stoke-on-Trent 032D","E01014238","Total",666,331,55,276,202,88,234,41,193
"2011","Stoke-on-Trent 033A","E01014315","Total",598,222,3,219,115,33,154,19,135
"2011","Stoke-on-Trent 033B","E01014318","Total",597,171,9,162,187,55,139,14,125
"2011","Stoke-on-Trent 033C","E01014319","Total",597,188,24,164,230,78,168,39,129
"2011","Stoke-on-Trent 033D","E01014320","Total",477,75,3,72,182,57,79,21,58
"2011","Stoke-on-Trent 034A","E01014347","Total",583,124,7,117,164,45,129,22,107
"2011","Stoke-on-Trent 034B","E01014350","Total",553,168,5,163,151,44,121,13,108
"2011","Stoke-on-Trent 034C","E01014351","Total",566,108,3,105,153,58,110,17,93
"2011","Stoke-on-Trent 034D","E01014352","Total",579,170,3,167,144,53,128,18,110
"2011","Telford and Wrekin 001A","E01014171","Total",591,241,20,221,160,65,186,34,152
"2011","Telford and Wrekin 001B","E01014172","Total",518,131,5,126,181,49,120,27,93
"2011","Telford and Wrekin 001C","E01014173","Total",663,238,14,224,171,76,178,23,155
"2011","Telford and Wrekin 001D","E01014174","Total",593,145,2,143,230,44,122,23,99
"2011","Telford and Wrekin 002A","E01014112","Total",624,215,15,200,182,59,139,22,117
"2011","Telford and Wrekin 002B","E01014131","Total",584,164,7,157,161,47,139,23,116
"2011","Telford and Wrekin 002C","E01014132","Total",450,180,7,173,120,28,113,17,96
"2011","Telford and Wrekin 002D","E01014135","Total",477,113,9,104,142,35,117,15,102
"2011","Telford and Wrekin 003A","E01014175","Total",507,168,13,155,134,51,146,25,121
"2011","Telford and Wrekin 003B","E01014176","Total",632,242,11,231,144,50,186,27,159
"2011","Telford and Wrekin 003C","E01014177","Total",584,201,7,194,159,45,145,29,116
"2011","Telford and Wrekin 003D","E01014178","Total",665,254,16,238,125,54,152,15,137
"2011","Telford and Wrekin 004A","E01014111","Total",625,188,8,180,183,51,159,39,120
"2011","Telford and Wrekin 004B","E01014167","Total",688,114,19,95,334,109,125,50,75
"2011","Telford and Wrekin 004C","E01014168","Total",501,101,16,85,222,61,98,30,68
"2011","Telford and Wrekin 004D","E01014170","Total",658,269,9,260,173,56,178,26,152
"2011","Telford and Wrekin 005A","E01014125","Total",659,239,45,194,203,93,220,45,175
"2011","Telford and Wrekin 005B","E01014126","Total",597,250,39,211,170,77,202,36,166
"2011","Telford and Wrekin 005C","E01014127","Total",644,226,68,158,266,125,196,59,137
"2011","Telford and Wrekin 005D","E01014128","Total",814,252,36,216,283,138,239,45,194
"2011","Telford and Wrekin 005E","E01014169","Total",703,148,51,97,298,142,134,45,89
"2011","Telford and Wrekin 006A","E01014129","Total",534,248,8,240,90,36,178,17,161
"2011","Telford and Wrekin 006B","E01014130","Total",579,154,12,142,182,61,128,26,102
"2011","Telford and Wrekin 006C","E01014179","Total",487,174,7,167,134,38,121,10,111
"2011","Telford and Wrekin 006D","E01014180","Total",586,240,14,226,143,47,199,27,172
"2011","Telford and Wrekin 006E","E01014189","Total",589,126,22,104,225,90,128,41,87
"2011","Telford and Wrekin 006F","E01014190","Total",607,101,9,92,244,57,109,29,80
"2011","Telford and Wrekin 007A","E01014102","Total",674,141,13,128,258,81,146,42,104
"2011","Telford and Wrekin 007B","E01014103","Total",473,124,9,115,152,48,126,24,102
"2011","Telford and Wrekin 007C","E01014138","Total",603,211,30,181,200,81,175,34,141
"2011","Telford and Wrekin 007D","E01014140","Total",615,200,40,160,193,74,185,44,141
"2011","Telford and Wrekin 008A","E01014205","Total",596,216,8,208,123,44,166,18,148
"2011","Telford and Wrekin 008B","E01014206","Total",511,172,43,129,187,70,133,32,101
"2011","Telford and Wrekin 008C","E01014207","Total",492,137,12,125,167,64,128,28,100
"2011","Telford and Wrekin 008D","E01014208","Total",534,217,32,185,160,70,160,24,136
"2011","Telford and Wrekin 008E","E01014209","Total",591,217,18,199,173,60,181,32,149
"2011","Telford and Wrekin 009A","E01014137","Total",519,89,11,78,245,76,97,31,66
"2011","Telford and Wrekin 009B","E01014139","Total",517,190,31,159,193,96,181,31,150
"2011","Telford and Wrekin 009C","E01014141","Total",1086,272,85,187,446,250,239,69,170
"2011","Telford and Wrekin 009D","E01014142","Total",450,168,65,103,220,107,136,41,95
"2011","Telford and Wrekin 009E","E01014143","Total",602,248,34,214,209,92,209,42,167
"2011","Telford and Wrekin 010A","E01014136","Total",693,247,9,238,145,45,176,22,154
"2011","Telford and Wrekin 010B","E01014148","Total",700,171,14,157,149,63,148,28,120
"2011","Telford and Wrekin 010C","E01014149","Total",435,115,9,106,111,49,106,13,93
"2011","Telford and Wrekin 010D","E01014202","Total",899,205,27,178,304,127,175,35,140
"2011","Telford and Wrekin 010E","E01014203","Total",618,199,6,193,201,54,150,26,124
"2011","Telford and Wrekin 010F","E01014204","Total",750,180,14,166,264,85,163,34,129
"2011","Telford and Wrekin 011A","E01014104","Total",641,190,37,153,229,96,180,44,136
"2011","Telford and Wrekin 011B","E01014105","Total",698,254,84,170,281,139,214,59,155
"2011","Telford and Wrekin 011C","E01014113","Total",645,259,44,215,200,92,228,51,177
"2011","Telford and Wrekin 011D","E01014114","Total",647,252,12,240,139,36,185,23,162
"2011","Telford and Wrekin 012A","E01014133","Total",773,284,24,260,192,76,202,26,176
"2011","Telford and Wrekin 012B","E01014134","Total",590,248,7,241,128,41,173,12,161
"2011","Telford and Wrekin 012C","E01014144","Total",656,304,51,253,188,67,237,42,195
"2011","Telford and Wrekin 012D","E01014145","Total",874,298,35,263,211,103,261,36,225
"2011","Telford and Wrekin 013A","E01014185","Total",790,359,34,325,179,66,292,35,257
"2011","Telford and Wrekin 013B","E01014186","Total",627,189,25,164,193,88,152,22,130
"2011","Telford and Wrekin 013C","E01014187","Total",669,217,22,195,181,78,172,26,146
"2011","Telford and Wrekin 013D","E01014188","Total",607,123,11,112,203,92,127,33,94
"2011","Telford and Wrekin 014A","E01014150","Total",686,153,9,144,196,67,159,36,123
"2011","Telford and Wrekin 014B","E01014151","Total",639,268,53,215,213,82,213,47,166
"2011","Telford and Wrekin 014C","E01014152","Total",587,277,35,242,154,56,224,38,186
"2011","Telford and Wrekin 014D","E01014153","Total",793,293,37,256,209,100,236,38,198
"2011","Telford and Wrekin 014E","E01014154","Total",682,181,22,159,225,90,153,32,121
"2011","Telford and Wrekin 014F","E01014155","Total",676,233,49,184,231,82,183,56,127
"2011","Telford and Wrekin 015A","E01014181","Total",667,65,15,50,340,100,77,39,38
"2011","Telford and Wrekin 015B","E01014182","Total",469,99,7,92,168,53,80,21,59
"2011","Telford and Wrekin 015C","E01014183","Total",602,172,11,161,176,54,151,28,123
"2011","Telford and Wrekin 015D","E01014184","Total",529,140,29,111,226,102,131,40,91
"2011","Telford and Wrekin 016A","E01014146","Total",776,135,21,114,330,163,168,54,114
"2011","Telford and Wrekin 016B","E01014147","Total",783,141,28,113,299,130,141,34,107
"2011","Telford and Wrekin 016C","E01014156","Total",796,184,71,113,364,170,163,62,101
"2011","Telford and Wrekin 016D","E01014157","Total",530,74,12,62,204,75,108,35,73
"2011","Telford and Wrekin 016E","E01014158","Total",643,148,27,121,224,102,158,34,124
"2011","Telford and Wrekin 017A","E01014124","Total",755,333,64,269,200,108,238,31,207
"2011","Telford and Wrekin 017B","E01014163","Total",516,218,74,144,219,97,189,46,143
"2011","Telford and Wrekin 017C","E01014164","Total",691,332,88,244,249,137,233,56,177
"2011","Telford and Wrekin 017D","E01014165","Total",586,238,60,178,202,89,204,41,163
"2011","Telford and Wrekin 017E","E01014166","Total",641,213,37,176,216,95,169,35,134
"2011","Telford and Wrekin 018A","E01014191","Total",731,216,52,164,218,121,181,38,143
"2011","Telford and Wrekin 018B","E01014192","Total",480,125,41,84,212,90,129,49,80
"2011","Telford and Wrekin 018C","E01014193","Total",610,184,63,121,262,103,176,61,115
"2011","Telford and Wrekin 018D","E01014194","Total",595,187,55,132,234,95,163,48,115
"2011","Telford and Wrekin 018E","E01014195","Total",523,107,14,93,194,64,102,23,79
"2011","Telford and Wrekin 018F","E01014196","Total",649,263,51,212,206,77,221,38,183
"2011","Telford and Wrekin 019A","E01014119","Total",678,210,24,186,217,72,179,38,141
"2011","Telford and Wrekin 019B","E01014120","Total",767,341,56,285,236,105,279,50,229
"2011","Telford and Wrekin 019C","E01014121","Total",614,230,18,212,151,44,198,30,168
"2011","Telford and Wrekin 019D","E01014122","Total",731,140,44,96,208,96,148,42,106
"2011","Telford and Wrekin 019E","E01014123","Total",617,102,12,90,222,92,111,29,82
"2011","Telford and Wrekin 020A","E01014106","Total",618,185,44,141,232,114,170,54,116
"2011","Telford and Wrekin 020B","E01014107","Total",475,127,9,118,114,38,117,20,97
"2011","Telford and Wrekin 020C","E01014108","Total",645,295,102,193,234,119,204,54,150
"2011","Telford and Wrekin 020D","E01014109","Total",463,117,52,65,170,76,109,23,86
"2011","Telford and Wrekin 020E","E01014110","Total",470,178,113,65,263,132,123,64,59
"2011","Telford and Wrekin 021A","E01014197","Total",552,220,96,124,236,90,166,56,110
"2011","Telford and Wrekin 021B","E01014198","Total",412,212,87,125,183,85,144,43,101
"2011","Telford and Wrekin 021C","E01014199","Total",604,178,89,89,296,148,124,51,73
"2011","Telford and Wrekin 021D","E01014200","Total",452,193,98,95,232,109,139,57,82
"2011","Telford and Wrekin 021E","E01014201","Total",455,177,96,81,233,108,125,50,75
"2011","Telford and Wrekin 022A","E01014159","Total",594,260,33,227,143,61,228,38,190
"2011","Telford and Wrekin 022B","E01014160","Total",526,163,28,135,161,54,127,30,97
"2011","Telford and Wrekin 022C","E01014161","Total",499,159,23,136,132,57,137,28,109
"2011","Telford and Wrekin 022D","E01014162","Total",810,395,32,363,169,63,312,29,283
"2011","Telford and Wrekin 023A","E01014115","Total",549,215,54,161,181,92,167,26,141
"2011","Telford and Wrekin 023B","E01014116","Total",776,417,83,334,218,106,291,53,238
"2011","Telford and Wrekin 023C","E01014117","Total",485,174,20,154,120,31,142,35,107
"2011","Telford and Wrekin 023D","E01014118","Total",447,172,84,88,198,94,137,56,81
"2011","Cannock Chase 001A","E01029368","Total",510,164,2,162,114,23,138,18,120
"2011","Cannock Chase 001B","E01029369","Total",496,139,14,125,174,52,134,18,116
"2011","Cannock Chase 001C","E01029370","Total",577,181,5,176,129,31,146,11,135
"2011","Cannock Chase 001D","E01029371","Total",610,141,20,121,222,87,156,40,116
"2011","Cannock Chase 001E","E01029402","Total",839,302,7,295,229,78,194,27,167
"2011","Cannock Chase 002A","E01029372","Total",527,203,53,150,217,84,171,56,115
"2011","Cannock Chase 002B","E01029373","Total",881,267,40,227,343,138,271,77,194
"2011","Cannock Chase 002C","E01029401","Total",653,195,20,175,212,77,191,32,159
"2011","Cannock Chase 002D","E01029403","Total",620,188,18,170,201,75,192,31,161
"2011","Cannock Chase 002E","E01029404","Total",800,365,31,334,141,71,278,17,261
"2011","Cannock Chase 003A","E01029345","Total",658,194,31,163,218,91,172,37,135
"2011","Cannock Chase 003B","E01029346","Total",743,327,66,261,267,126,260,45,215
"2011","Cannock Chase 003C","E01029347","Total",642,237,7,230,123,46,190,15,175
"2011","Cannock Chase 003D","E01029348","Total",700,247,30,217,214,70,233,57,176
"2011","Cannock Chase 003E","E01029374","Total",955,252,43,209,338,133,254,49,205
"2011","Cannock Chase 004A","E01029383","Total",617,136,25,111,230,82,133,34,99
"2011","Cannock Chase 004B","E01029385","Total",608,172,12,160,155,61,158,28,130
"2011","Cannock Chase 004C","E01029388","Total",615,256,32,224,176,69,235,37,198
"2011","Cannock Chase 004D","E01029390","Total",453,176,36,140,146,61,152,28,124
"2011","Cannock Chase 005A","E01029384","Total",813,239,19,220,247,88,214,45,169
"2011","Cannock Chase 005B","E01029386","Total",603,217,36,181,192,80,195,48,147
"2011","Cannock Chase 005C","E01029387","Total",639,243,30,213,168,69,233,34,199
"2011","Cannock Chase 005D","E01029389","Total",784,209,21,188,187,80,192,24,168
"2011","Cannock Chase 006A","E01029379","Total",643,108,17,91,310,108,131,40,91
"2011","Cannock Chase 006B","E01029398","Total",690,230,18,212,195,66,184,32,152
"2011","Cannock Chase 006C","E01029399","Total",647,172,19,153,200,77,145,29,116
"2011","Cannock Chase 006D","E01029400","Total",636,170,34,136,224,74,163,23,140
"2011","Cannock Chase 007A","E01029354","Total",647,247,30,217,198,70,229,41,188
"2011","Cannock Chase 007B","E01029355","Total",657,285,44,241,211,89,254,54,200
"2011","Cannock Chase 007C","E01029356","Total",638,280,45,235,200,61,247,48,199
"2011","Cannock Chase 007D","E01029357","Total",551,196,43,153,158,67,162,31,131
"2011","Cannock Chase 007E","E01029358","Total",499,224,74,150,211,93,192,57,135
"2011","Cannock Chase 008A","E01029349","Total",615,256,22,234,137,64,195,17,178
"2011","Cannock Chase 008B","E01029350","Total",678,295,45,250,193,79,239,49,190
"2011","Cannock Chase 008C","E01029351","Total",651,288,81,207,214,92,188,32,156
"2011","Cannock Chase 008D","E01029352","Total",548,142,25,117,159,63,137,26,111
"2011","Cannock Chase 008E","E01029393","Total",756,264,11,253,181,52,227,34,193
"2011","Cannock Chase 009A","E01029380","Total",565,90,13,77,236,81,102,30,72
"2011","Cannock Chase 009B","E01029381","Total",692,289,31,258,160,64,227,29,198
"2011","Cannock Chase 009C","E01029382","Total",726,253,17,236,181,70,206,30,176
"2011","Cannock Chase 009D","E01029391","Total",673,200,12,188,194,62,179,37,142
"2011","Cannock Chase 009E","E01029392","Total",716,137,10,127,300,109,169,50,119
"2011","Cannock Chase 010A","E01029375","Total",893,97,27,70,396,168,122,50,72
"2011","Cannock Chase 010B","E01029376","Total",732,94,27,67,311,122,112,34,78
"2011","Cannock Chase 010C","E01029377","Total",513,36,6,30,251,79,68,23,45
"2011","Cannock Chase 010D","E01029378","Total",659,91,12,79,251,99,122,37,85
"2011","Cannock Chase 011A","E01029353","Total",690,315,15,300,130,40,222,23,199
"2011","Cannock Chase 011B","E01029364","Total",724,241,6,235,154,45,191,23,168
"2011","Cannock Chase 011C","E01029365","Total",652,190,9,181,173,60,195,28,167
"2011","Cannock Chase 011D","E01029366","Total",735,324,8,316,149,41,216,25,191
"2011","Cannock Chase 011E","E01029367","Total",944,352,30,322,261,97,273,43,230
"2011","Cannock Chase 012A","E01029359","Total",744,244,54,190,220,108,205,43,162
"2011","Cannock Chase 012B","E01029360","Total",734,335,35,300,164,64,261,31,230
"2011","Cannock Chase 012C","E01029361","Total",628,256,42,214,194,73,195,36,159
"2011","Cannock Chase 012D","E01029362","Total",685,275,77,198,248,111,221,57,164
"2011","Cannock Chase 012E","E01029363","Total",670,303,19,284,146,65,232,26,206
"2011","Cannock Chase 013A","E01029394","Total",634,245,19,226,135,45,202,27,175
"2011","Cannock Chase 013B","E01029395","Total",683,214,12,202,167,45,169,25,144
"2011","Cannock Chase 013C","E01029396","Total",721,201,22,179,204,82,194,40,154
"2011","Cannock Chase 013D","E01029397","Total",1052,357,77,280,436,174,302,85,217
"2011","East Staffordshire 001A","E01029405","Total",638,170,11,159,174,60,134,21,113
"2011","East Staffordshire 001B","E01029406","Total",474,102,4,98,147,29,108,15,93
"2011","East Staffordshire 001C","E01029422","Total",470,152,5,147,130,34,112,18,94
"2011","East Staffordshire 001D","E01029423","Total",670,210,34,176,217,93,163,33,130
"2011","East Staffordshire 001E","E01029467","Total",900,272,11,261,210,81,218,17,201
"2011","East Staffordshire 002A","E01029430","Total",603,161,7,154,180,60,142,23,119
"2011","East Staffordshire 002B","E01029431","Total",686,226,33,193,226,79,191,36,155
"2011","East Staffordshire 002C","E01029432","Total",632,225,10,215,162,56,141,23,118
"2011","East Staffordshire 002D","E01029433","Total",614,186,30,156,219,94,173,37,136
"2011","East Staffordshire 003A","E01029459","Total",624,111,12,99,242,79,107,33,74
"2011","East Staffordshire 003B","E01029460","Total",786,268,14,254,220,76,224,30,194
"2011","East Staffordshire 003C","E01029461","Total",843,259,21,238,240,80,201,24,177
"2011","East Staffordshire 003D","E01029462","Total",689,238,12,226,185,68,159,15,144
"2011","East Staffordshire 004A","E01029443","Total",707,251,5,246,193,64,155,18,137
"2011","East Staffordshire 004B","E01029444","Total",726,311,13,298,153,52,184,22,162
"2011","East Staffordshire 004C","E01029463","Total",508,155,6,149,137,55,114,18,96
"2011","East Staffordshire 004D","E01029464","Total",693,261,24,237,177,54,214,27,187
"2011","East Staffordshire 004E","E01029465","Total",702,245,14,231,148,61,179,17,162
"2011","East Staffordshire 004F","E01029466","Total",615,192,12,180,198,58,128,18,110
"2011","East Staffordshire 005A","E01029454","Total",642,209,9,200,196,46,151,35,116
"2011","East Staffordshire 005B","E01029455","Total",747,236,8,228,246,87,170,27,143
"2011","East Staffordshire 005C","E01029456","Total",747,297,16,281,154,70,204,24,180
"2011","East Staffordshire 005D","E01029457","Total",533,100,5,95,210,72,99,27,72
"2011","East Staffordshire 005E","E01029458","Total",616,230,14,216,172,56,150,26,124
"2011","East Staffordshire 006A","E01029411","Total",519,139,4,135,144,53,127,20,107
"2011","East Staffordshire 006B","E01029412","Total",576,184,2,182,133,34,144,18,126
"2011","East Staffordshire 006C","E01029424","Total",433,152,3,149,104,29,103,9,94
"2011","East Staffordshire 006D","E01029425","Total",601,172,4,168,159,48,118,16,102
"2011","East Staffordshire 006E","E01029473","Total",562,161,5,156,158,36,140,22,118
"2011","East Staffordshire 006F","E01029474","Total",517,192,3,189,135,41,135,17,118
"2011","East Staffordshire 007A","E01029434","Total",628,172,38,134,231,97,153,39,114
"2011","East Staffordshire 007B","E01029435","Total",641,256,9,247,164,58,192,30,162
"2011","East Staffordshire 007C","E01029436","Total",842,346,46,300,243,104,251,33,218
"2011","East Staffordshire 007D","E01029437","Total",924,311,68,243,365,165,285,66,219
"2011","East Staffordshire 007E","E01029438","Total",638,236,16,220,178,64,164,26,138
"2011","East Staffordshire 008A","E01029426","Total",713,240,55,185,259,153,188,44,144
"2011","East Staffordshire 008B","E01029427","Total",653,298,61,237,205,94,229,41,188
"2011","East Staffordshire 008C","E01029428","Total",645,127,27,100,237,106,106,29,77
"2011","East Staffordshire 008D","E01029429","Total",491,158,35,123,187,97,138,33,105
"2011","East Staffordshire 009A","E01029445","Total",849,274,64,210,245,152,207,54,153
"2011","East Staffordshire 009B","E01029446","Total",743,244,28,216,208,87,165,28,137
"2011","East Staffordshire 009C","E01029447","Total",605,140,39,101,258,142,138,55,83
"2011","East Staffordshire 009D","E01029448","Total",734,311,36,275,187,96,237,25,212
"2011","East Staffordshire 010A","E01029468","Total",693,291,71,220,254,130,236,58,178
"2011","East Staffordshire 010B","E01029469","Total",763,277,24,253,205,75,187,29,158
"2011","East Staffordshire 010C","E01029470","Total",635,230,42,188,218,99,160,42,118
"2011","East Staffordshire 010D","E01029471","Total",685,176,11,165,202,65,152,25,127
"2011","East Staffordshire 010E","E01029472","Total",654,272,53,219,200,81,201,43,158
"2011","East Staffordshire 011A","E01029407","Total",544,167,44,123,213,110,147,31,116
"2011","East Staffordshire 011B","E01029408","Total",825,193,59,134,311,165,173,53,120
"2011","East Staffordshire 011C","E01029409","Total",667,211,47,164,229,128,159,41,118
"2011","East Staffordshire 011D","E01029410","Total",601,168,27,141,207,110,133,27,106
"2011","East Staffordshire 011F","E01032896","Total",564,116,17,99,94,53,106,24,82
"2011","East Staffordshire 011G","E01032897","Total",577,163,15,148,138,71,143,19,124
"2011","East Staffordshire 011H","E01032898","Total",599,240,33,207,151,86,181,24,157
"2011","East Staffordshire 012A","E01029418","Total",823,173,8,165,270,81,126,21,105
"2011","East Staffordshire 012B","E01029419","Total",651,194,8,186,192,50,143,24,119
"2011","East Staffordshire 012C","E01029420","Total",737,266,9,257,219,77,195,28,167
"2011","East Staffordshire 013A","E01029413","Total",655,188,12,176,183,57,175,21,154
"2011","East Staffordshire 013B","E01029414","Total",686,129,8,121,202,81,112,31,81
"2011","East Staffordshire 013C","E01029415","Total",627,76,8,68,263,100,100,47,53
"2011","East Staffordshire 013D","E01029416","Total",538,182,9,173,137,43,136,19,117
"2011","East Staffordshire 013E","E01029417","Total",527,198,13,185,136,43,140,19,121
"2011","East Staffordshire 014A","E01029449","Total",698,224,22,202,171,56,156,16,140
"2011","East Staffordshire 014B","E01029450","Total",617,238,43,195,184,72,193,47,146
"2011","East Staffordshire 014C","E01029451","Total",849,333,28,305,200,89,251,29,222
"2011","East Staffordshire 014D","E01029452","Total",769,327,36,291,194,79,262,28,234
"2011","East Staffordshire 014E","E01029453","Total",703,330,49,281,208,99,267,52,215
"2011","East Staffordshire 015A","E01029439","Total",633,246,7,239,150,49,167,19,148
"2011","East Staffordshire 015B","E01029440","Total",526,139,4,135,157,48,116,24,92
"2011","East Staffordshire 015C","E01029441","Total",670,244,13,231,182,51,176,20,156
"2011","East Staffordshire 015D","E01029442","Total",556,202,8,194,170,45,143,20,123
"2011","Lichfield 001A","E01029480","Total",746,169,19,150,244,100,153,36,117
"2011","Lichfield 001B","E01029481","Total",804,308,15,293,180,69,240,32,208
"2011","Lichfield 001C","E01029482","Total",635,200,21,179,218,69,198,47,151
"2011","Lichfield 001D","E01029498","Total",711,220,8,212,175,58,181,30,151
"2011","Lichfield 002A","E01029477","Total",647,203,3,200,186,50,151,18,133
"2011","Lichfield 002B","E01029478","Total",645,229,11,218,203,51,193,35,158
"2011","Lichfield 002C","E01029479","Total",1040,195,23,172,424,182,200,53,147
"2011","Lichfield 002D","E01029509","Total",668,202,6,196,164,50,158,21,137
"2011","Lichfield 003A","E01029486","Total",615,210,5,205,136,38,186,17,169
"2011","Lichfield 003B","E01029507","Total",636,149,4,145,196,61,146,28,118
"2011","Lichfield 003C","E01029508","Total",919,251,11,240,295,106,189,32,157
"2011","Lichfield 003D","E01029515","Total",775,264,6,258,171,40,198,33,165
"2011","Lichfield 004A","E01029492","Total",767,278,96,182,326,151,221,69,152
"2011","Lichfield 004B","E01029499","Total",736,330,53,277,218,83,280,53,227
"2011","Lichfield 004C","E01029501","Total",613,241,32,209,189,61,191,40,151
"2011","Lichfield 004E","E01029526","Total",851,393,25,368,133,49,280,28,252
"2011","Lichfield 004F","E01032899","Total",831,461,12,449,97,30,316,12,304
"2011","Lichfield 004G","E01032900","Total",792,94,35,59,346,188,98,38,60
"2011","Lichfield 005A","E01029483","Total",617,199,4,195,153,43,137,27,110
"2011","Lichfield 005B","E01029484","Total",824,255,14,241,185,79,172,16,156
"2011","Lichfield 005C","E01029485","Total",650,177,4,173,152,47,125,15,110
"2011","Lichfield 005D","E01029500","Total",734,234,9,225,183,49,190,26,164
"2011","Lichfield 005E","E01029520","Total",602,183,2,181,186,45,118,20,98
"2011","Lichfield 005F","E01029524","Total",725,244,33,211,188,72,183,35,148
"2011","Lichfield 005G","E01029525","Total",750,305,14,291,166,52,210,25,185
"2011","Lichfield 006A","E01029487","Total",704,297,36,261,198,94,234,34,200
"2011","Lichfield 006B","E01029493","Total",810,202,10,192,256,71,178,28,150
"2011","Lichfield 006C","E01029494","Total",646,226,19,207,181,65,198,31,167
"2011","Lichfield 006D","E01029495","Total",671,179,10,169,212,72,163,35,128
"2011","Lichfield 006E","E01029497","Total",862,323,34,289,229,85,283,39,244
"2011","Lichfield 007A","E01029491","Total",775,263,29,234,207,93,199,34,165
"2011","Lichfield 007B","E01029511","Total",682,240,10,230,182,59,165,19,146
"2011","Lichfield 007C","E01029512","Total",762,214,18,196,254,103,144,30,114
"2011","Lichfield 007D","E01029518","Total",1114,293,17,276,364,160,209,48,161
"2011","Lichfield 007E","E01029519","Total",935,284,23,261,272,107,213,31,182
"2011","Lichfield 008A","E01029516","Total",743,214,11,203,229,76,179,31,148
"2011","Lichfield 008B","E01029517","Total",669,187,10,177,182,66,144,33,111
"2011","Lichfield 008C","E01029530","Total",676,189,21,168,225,103,136,32,104
"2011","Lichfield 008D","E01029531","Total",679,231,7,224,193,46,129,16,113
"2011","Lichfield 009A","E01029475","Total",842,281,13,268,224,75,222,34,188
"2011","Lichfield 009B","E01029476","Total",607,246,5,241,136,41,167,13,154
"2011","Lichfield 009C","E01029489","Total",653,245,3,242,166,39,182,23,159
"2011","Lichfield 009D","E01029490","Total",607,160,9,151,170,57,165,24,141
"2011","Lichfield 009E","E01029505","Total",649,215,10,205,166,56,160,22,138
"2011","Lichfield 009F","E01029506","Total",757,282,6,276,160,56,188,19,169
"2011","Lichfield 010A","E01029496","Total",753,278,59,219,258,101,250,61,189
"2011","Lichfield 010B","E01029527","Total",548,220,34,186,164,75,188,33,155
"2011","Lichfield 010C","E01029528","Total",523,180,24,156,173,61,144,36,108
"2011","Lichfield 010D","E01029529","Total",491,111,28,83,193,89,101,35,66
"2011","Lichfield 011A","E01029513","Total",491,141,8,133,155,47,95,15,80
"2011","Lichfield 011B","E01029514","Total",613,232,10,222,141,35,140,19,121
"2011","Lichfield 011C","E01029521","Total",692,241,5,236,187,44,153,21,132
"2011","Lichfield 011D","E01029522","Total",625,197,19,178,166,38,161,20,141
"2011","Lichfield 011E","E01029523","Total",625,203,8,195,176,54,150,20,130
"2011","Lichfield 012A","E01029488","Total",695,174,15,159,198,57,140,23,117
"2011","Lichfield 012B","E01029502","Total",644,215,39,176,214,100,161,32,129
"2011","Lichfield 012C","E01029503","Total",644,236,18,218,178,67,184,30,154
"2011","Lichfield 012D","E01029504","Total",704,259,27,232,171,73,209,32,177
"2011","Newcastle-under-Lyme 001A","E01029562","Total",528,126,8,118,195,60,139,33,106
"2011","Newcastle-under-Lyme 001B","E01029565","Total",468,85,12,73,182,63,88,23,65
"2011","Newcastle-under-Lyme 001C","E01029581","Total",675,204,14,190,195,68,174,31,143
"2011","Newcastle-under-Lyme 001D","E01029582","Total",792,276,24,252,208,66,232,35,197
"2011","Newcastle-under-Lyme 001E","E01029586","Total",541,177,2,175,104,34,125,13,112
"2011","Newcastle-under-Lyme 001F","E01029587","Total",539,171,8,163,149,65,125,20,105
"2011","Newcastle-under-Lyme 002A","E01029561","Total",602,242,41,201,206,66,205,42,163
"2011","Newcastle-under-Lyme 002B","E01029563","Total",601,212,13,199,160,51,181,33,148
"2011","Newcastle-under-Lyme 002C","E01029564","Total",542,183,44,139,186,85,177,47,130
"2011","Newcastle-under-Lyme 002D","E01029588","Total",735,261,19,242,166,65,235,22,213
"2011","Newcastle-under-Lyme 003A","E01029540","Total",636,289,15,274,142,41,213,19,194
"2011","Newcastle-under-Lyme 003B","E01029541","Total",624,228,49,179,236,102,196,56,140
"2011","Newcastle-under-Lyme 003C","E01029542","Total",641,209,19,190,138,50,168,19,149
"2011","Newcastle-under-Lyme 003D","E01029543","Total",474,188,32,156,147,52,148,26,122
"2011","Newcastle-under-Lyme 003E","E01029595","Total",591,225,12,213,106,41,166,12,154
"2011","Newcastle-under-Lyme 003F","E01029597","Total",622,223,34,189,205,73,191,43,148
"2011","Newcastle-under-Lyme 004A","E01029536","Total",644,224,3,221,163,44,173,26,147
"2011","Newcastle-under-Lyme 004B","E01029544","Total",517,105,6,99,176,46,125,34,91
"2011","Newcastle-under-Lyme 004C","E01029545","Total",616,166,20,146,200,72,135,21,114
"2011","Newcastle-under-Lyme 004D","E01029546","Total",484,47,3,44,215,77,93,36,57
"2011","Newcastle-under-Lyme 004E","E01029596","Total",522,250,11,239,85,25,163,20,143
"2011","Newcastle-under-Lyme 005A","E01029532","Total",642,213,8,205,163,63,179,19,160
"2011","Newcastle-under-Lyme 005B","E01029533","Total",651,233,15,218,159,50,188,31,157
"2011","Newcastle-under-Lyme 005C","E01029534","Total",673,210,6,204,167,63,208,23,185
"2011","Newcastle-under-Lyme 005D","E01029535","Total",601,222,33,189,196,77,201,46,155
"2011","Newcastle-under-Lyme 005E","E01029556","Total",1111,389,21,368,283,92,380,51,329
"2011","Newcastle-under-Lyme 006A","E01029537","Total",626,210,29,181,214,85,185,35,150
"2011","Newcastle-under-Lyme 006B","E01029538","Total",715,293,32,261,205,91,247,39,208
"2011","Newcastle-under-Lyme 006C","E01029539","Total",618,207,20,187,206,62,173,37,136
"2011","Newcastle-under-Lyme 006D","E01029552","Total",629,217,22,195,165,54,179,26,153
"2011","Newcastle-under-Lyme 006E","E01029558","Total",638,226,61,165,260,107,196,51,145
"2011","Newcastle-under-Lyme 007A","E01029547","Total",626,255,62,193,230,113,204,48,156
"2011","Newcastle-under-Lyme 007B","E01029548","Total",662,311,70,241,199,86,232,47,185
"2011","Newcastle-under-Lyme 007C","E01029559","Total",588,149,21,128,185,70,135,24,111
"2011","Newcastle-under-Lyme 007D","E01029560","Total",672,267,59,208,230,96,234,53,181
"2011","Newcastle-under-Lyme 007E","E01029568","Total",631,256,33,223,173,72,197,33,164
"2011","Newcastle-under-Lyme 008A","E01029583","Total",682,240,14,226,163,55,202,17,185
"2011","Newcastle-under-Lyme 008B","E01029584","Total",538,194,5,189,140,61,151,21,130
"2011","Newcastle-under-Lyme 008C","E01029585","Total",661,186,14,172,179,76,141,25,116
"2011","Newcastle-under-Lyme 008D","E01029609","Total",767,217,36,181,217,100,183,40,143
"2011","Newcastle-under-Lyme 008E","E01029611","Total",800,276,25,251,212,101,232,35,197
"2011","Newcastle-under-Lyme 009A","E01029577","Total",683,200,7,193,164,48,167,19,148
"2011","Newcastle-under-Lyme 009B","E01029579","Total",766,248,10,238,201,75,210,29,181
"2011","Newcastle-under-Lyme 009C","E01029580","Total",574,158,11,147,183,67,135,22,113
"2011","Newcastle-under-Lyme 009D","E01029610","Total",585,154,6,148,155,57,128,17,111
"2011","Newcastle-under-Lyme 009E","E01029612","Total",495,162,8,154,156,46,119,18,101
"2011","Newcastle-under-Lyme 010A","E01029553","Total",605,237,36,201,198,63,200,37,163
"2011","Newcastle-under-Lyme 010B","E01029554","Total",637,350,41,309,132,66,247,30,217
"2011","Newcastle-under-Lyme 010C","E01029566","Total",504,217,72,145,220,115,167,41,126
"2011","Newcastle-under-Lyme 010D","E01029567","Total",725,242,15,227,192,71,223,45,178
"2011","Newcastle-under-Lyme 010E","E01029598","Total",737,277,56,221,253,99,208,50,158
"2011","Newcastle-under-Lyme 010F","E01029599","Total",734,342,26,316,144,50,263,24,239
"2011","Newcastle-under-Lyme 011A","E01029555","Total",758,275,34,241,198,73,242,29,213
"2011","Newcastle-under-Lyme 011B","E01029578","Total",806,323,11,312,148,49,241,19,222
"2011","Newcastle-under-Lyme 011C","E01029602","Total",946,377,19,358,149,72,236,20,216
"2011","Newcastle-under-Lyme 011D","E01029603","Total",739,311,28,283,125,54,211,16,195
"2011","Newcastle-under-Lyme 011E","E01029604","Total",940,448,18,430,118,52,339,20,319
"2011","Newcastle-under-Lyme 012A","E01029576","Total",550,149,3,146,150,60,134,23,111
"2011","Newcastle-under-Lyme 012B","E01029593","Total",745,320,51,269,228,94,268,41,227
"2011","Newcastle-under-Lyme 012C","E01029594","Total",872,344,24,320,203,85,266,31,235
"2011","Newcastle-under-Lyme 013A","E01029557","Total",551,176,7,169,122,33,142,24,118
"2011","Newcastle-under-Lyme 013B","E01029573","Total",640,216,15,201,183,56,154,27,127
"2011","Newcastle-under-Lyme 013C","E01029574","Total",610,239,15,224,137,46,172,27,145
"2011","Newcastle-under-Lyme 013D","E01029575","Total",435,152,20,132,126,43,139,24,115
"2011","Newcastle-under-Lyme 014A","E01029549","Total",798,388,27,361,169,60,300,32,268
"2011","Newcastle-under-Lyme 014B","E01029551","Total",660,195,15,180,213,82,160,30,130
"2011","Newcastle-under-Lyme 014C","E01029591","Total",738,345,34,311,193,71,276,39,237
"2011","Newcastle-under-Lyme 014D","E01029600","Total",623,267,5,262,158,49,168,18,150
"2011","Newcastle-under-Lyme 014E","E01029605","Total",542,176,1,175,155,55,146,20,126
"2011","Newcastle-under-Lyme 014F","E01029607","Total",639,266,17,249,165,58,220,31,189
"2011","Newcastle-under-Lyme 015B","E01029589","Total",522,171,6,165,122,25,121,14,107
"2011","Newcastle-under-Lyme 015C","E01029590","Total",613,270,15,255,129,34,195,24,171
"2011","Newcastle-under-Lyme 015E","E01029601","Total",690,331,5,326,133,44,185,15,170
"2011","Newcastle-under-Lyme 015F","E01029606","Total",587,183,4,179,213,51,121,24,97
"2011","Newcastle-under-Lyme 015G","E01029608","Total",646,290,7,283,138,26,163,19,144
"2011","Newcastle-under-Lyme 015H","E01033257","Total",1113,330,11,319,315,81,247,41,206
"2011","Newcastle-under-Lyme 016A","E01029569","Total",595,199,9,190,140,43,164,21,143
"2011","Newcastle-under-Lyme 016B","E01029570","Total",1035,338,10,328,248,73,258,27,231
"2011","Newcastle-under-Lyme 016C","E01029571","Total",561,202,16,186,160,37,152,22,130
"2011","Newcastle-under-Lyme 016D","E01029572","Total",650,192,9,183,204,57,159,24,135
"2011","South Staffordshire 001A","E01029655","Total",890,359,23,336,207,76,271,41,230
"2011","South Staffordshire 001B","E01029656","Total",729,224,9,215,185,58,152,27,125
"2011","South Staffordshire 001C","E01029657","Total",622,87,5,82,278,78,110,34,76
"2011","South Staffordshire 001D","E01029658","Total",566,225,15,210,157,41,150,29,121
"2011","South Staffordshire 001E","E01029659","Total",578,211,11,200,145,44,134,17,117
"2011","South Staffordshire 001F","E01029660","Total",879,263,17,246,227,61,214,37,177
"2011","South Staffordshire 002A","E01029621","Total",607,192,21,171,170,47,168,36,132
"2011","South Staffordshire 002B","E01029646","Total",568,164,24,140,192,76,158,33,125
"2011","South Staffordshire 002C","E01029647","Total",877,193,35,158,327,154,195,54,141
"2011","South Staffordshire 002D","E01029648","Total",589,217,44,173,187,69,177,41,136
"2011","South Staffordshire 003A","E01029617","Total",681,226,8,218,184,62,174,24,150
"2011","South Staffordshire 003B","E01029618","Total",737,329,19,310,169,52,186,18,168
"2011","South Staffordshire 003C","E01029668","Total",524,170,5,165,125,27,138,15,123
"2011","South Staffordshire 003D","E01029669","Total",564,220,18,202,141,43,156,27,129
"2011","South Staffordshire 003E","E01029670","Total",640,169,8,161,172,54,147,25,122
"2011","South Staffordshire 004A","E01029620","Total",505,166,21,145,159,54,137,26,111
"2011","South Staffordshire 004B","E01029622","Total",633,217,12,205,180,58,177,31,146
"2011","South Staffordshire 004C","E01029623","Total",487,177,18,159,146,38,147,26,121
"2011","South Staffordshire 004D","E01029624","Total",549,112,10,102,212,63,112,33,79
"2011","South Staffordshire 004E","E01029625","Total",481,180,4,176,115,38,129,22,107
"2011","South Staffordshire 004F","E01029641","Total",685,191,17,174,187,73,158,29,129
"2011","South Staffordshire 004G","E01029642","Total",628,260,11,249,141,44,171,17,154
"2011","South Staffordshire 005A","E01029638","Total",885,373,24,349,209,64,289,38,251
"2011","South Staffordshire 005B","E01029639","Total",516,137,15,122,178,34,140,33,107
"2011","South Staffordshire 005C","E01029640","Total",562,111,22,89,228,93,102,34,68
"2011","South Staffordshire 005D","E01029643","Total",635,294,37,257,175,65,217,41,176
"2011","South Staffordshire 005E","E01029644","Total",600,233,14,219,137,33,190,17,173
"2011","South Staffordshire 006A","E01029616","Total",681,258,9,249,141,49,169,19,150
"2011","South Staffordshire 006B","E01029619","Total",841,326,8,318,204,56,249,32,217
"2011","South Staffordshire 006C","E01029636","Total",592,188,9,179,159,42,121,20,101
"2011","South Staffordshire 006D","E01029637","Total",673,124,10,114,252,86,132,40,92
"2011","South Staffordshire 007A","E01029632","Total",606,163,7,156,176,49,118,28,90
"2011","South Staffordshire 007B","E01029633","Total",667,205,10,195,208,59,163,39,124
"2011","South Staffordshire 007C","E01029634","Total",593,231,36,195,182,63,150,32,118
"2011","South Staffordshire 007D","E01029635","Total",724,249,41,208,229,81,215,40,175
"2011","South Staffordshire 008A","E01029613","Total",628,246,8,238,142,55,165,20,145
"2011","South Staffordshire 008B","E01029614","Total",700,237,26,211,234,76,188,36,152
"2011","South Staffordshire 008C","E01029615","Total",574,254,34,220,157,66,210,37,173
"2011","South Staffordshire 008D","E01029627","Total",665,309,33,276,149,52,251,28,223
"2011","South Staffordshire 009A","E01029626","Total",612,222,8,214,153,54,153,22,131
"2011","South Staffordshire 009B","E01029628","Total",512,210,1,209,124,41,125,17,108
"2011","South Staffordshire 009C","E01029629","Total",500,192,3,189,134,40,117,12,105
"2011","South Staffordshire 009D","E01029630","Total",547,171,8,163,144,40,116,21,95
"2011","South Staffordshire 009E","E01029631","Total",580,159,7,152,181,69,147,27,120
"2011","South Staffordshire 010A","E01029654","Total",953,310,18,292,247,83,234,32,202
"2011","South Staffordshire 010B","E01029661","Total",776,192,13,179,220,64,165,35,130
"2011","South Staffordshire 010C","E01029663","Total",597,120,7,113,202,62,102,19,83
"2011","South Staffordshire 010D","E01029665","Total",764,172,17,155,232,74,148,37,111
"2011","South Staffordshire 011A","E01029662","Total",831,168,14,154,312,99,176,56,120
"2011","South Staffordshire 011B","E01029664","Total",675,153,12,141,198,74,152,30,122
"2011","South Staffordshire 011C","E01029666","Total",768,302,38,264,204,88,237,25,212
"2011","South Staffordshire 012A","E01029671","Total",662,317,11,306,154,37,206,28,178
"2011","South Staffordshire 012B","E01029673","Total",672,249,12,237,175,62,183,27,156
"2011","South Staffordshire 012C","E01029676","Total",524,253,5,248,99,19,191,16,175
"2011","South Staffordshire 012D","E01029679","Total",623,263,46,217,190,76,181,31,150
"2011","South Staffordshire 012E","E01029680","Total",632,205,12,193,180,55,149,22,127
"2011","South Staffordshire 013A","E01029645","Total",875,362,12,350,150,50,264,22,242
"2011","South Staffordshire 013B","E01029667","Total",887,277,12,265,226,50,219,31,188
"2011","South Staffordshire 013C","E01029672","Total",626,180,4,176,163,44,142,25,117
"2011","South Staffordshire 013D","E01029674","Total",689,179,6,173,246,60,145,29,116
"2011","South Staffordshire 013E","E01029675","Total",678,342,7,335,131,29,209,16,193
"2011","South Staffordshire 013F","E01029677","Total",557,199,7,192,139,47,125,18,107
"2011","South Staffordshire 013G","E01029678","Total",683,137,10,127,219,67,133,36,97
"2011","South Staffordshire 014A","E01029649","Total",601,276,11,265,107,39,199,11,188
"2011","South Staffordshire 014B","E01029650","Total",660,236,9,227,149,39,168,16,152
"2011","South Staffordshire 014C","E01029651","Total",620,223,8,215,152,32,154,25,129
"2011","South Staffordshire 014D","E01029652","Total",672,195,11,184,176,41,133,20,113
"2011","South Staffordshire 014E","E01029653","Total",521,186,17,169,170,52,159,27,132
"2011","Stafford 001A","E01029702","Total",667,282,19,263,155,49,217,23,194
"2011","Stafford 001B","E01029703","Total",624,162,10,152,185,60,152,25,127
"2011","Stafford 001C","E01029704","Total",602,243,8,235,142,53,172,25,147
"2011","Stafford 001D","E01029705","Total",628,280,10,270,136,44,168,18,150
"2011","Stafford 002A","E01029681","Total",497,164,19,145,146,58,149,27,122
"2011","Stafford 002B","E01029682","Total",711,300,13,287,144,54,220,19,201
"2011","Stafford 002C","E01029683","Total",552,195,13,182,147,46,144,21,123
"2011","Stafford 002D","E01029748","Total",588,186,4,182,143,35,132,18,114
"2011","Stafford 002E","E01029749","Total",738,265,8,257,162,62,211,19,192
"2011","Stafford 003A","E01029740","Total",697,264,40,224,229,90,204,45,159
"2011","Stafford 003B","E01029744","Total",989,216,13,203,320,137,193,36,157
"2011","Stafford 003C","E01029745","Total",903,393,18,375,166,68,287,36,251
"2011","Stafford 003D","E01029746","Total",674,235,25,210,192,69,185,31,154
"2011","Stafford 003E","E01029753","Total",654,304,13,291,121,47,225,21,204
"2011","Stafford 003F","E01029756","Total",759,184,15,169,227,93,175,41,134
"2011","Stafford 004A","E01029733","Total",765,200,7,193,211,71,185,32,153
"2011","Stafford 004B","E01029739","Total",603,136,6,130,227,75,102,25,77
"2011","Stafford 004C","E01029741","Total",688,125,7,118,258,87,124,34,90
"2011","Stafford 004D","E01029754","Total",565,184,4,180,156,54,140,19,121
"2011","Stafford 004E","E01029755","Total",647,271,4,267,126,43,199,21,178
"2011","Stafford 005A","E01029695","Total",924,344,9,335,197,67,241,30,211
"2011","Stafford 005B","E01029696","Total",644,192,14,178,151,39,142,18,124
"2011","Stafford 005C","E01029697","Total",536,148,6,142,154,53,114,16,98
"2011","Stafford 005D","E01029698","Total",689,218,9,209,155,52,162,17,145
"2011","Stafford 005E","E01029747","Total",595,168,2,166,172,45,131,17,114
"2011","Stafford 006A","E01029690","Total",637,131,7,124,216,93,137,27,110
"2011","Stafford 006B","E01029718","Total",805,247,11,236,224,81,200,36,164
"2011","Stafford 006C","E01029743","Total",614,229,7,222,126,48,157,18,139
"2011","Stafford 006D","E01029751","Total",724,320,16,304,152,50,215,28,187
"2011","Stafford 007A","E01029719","Total",730,317,9,308,141,44,210,27,183
"2011","Stafford 007B","E01029720","Total",670,220,62,158,273,125,186,53,133
"2011","Stafford 007C","E01029721","Total",641,178,20,158,196,62,154,37,117
"2011","Stafford 007D","E01029750","Total",660,206,36,170,216,100,169,36,133
"2011","Stafford 007E","E01029752","Total",521,189,56,133,218,102,135,48,87
"2011","Stafford 008A","E01029687","Total",823,267,10,257,192,55,200,27,173
"2011","Stafford 008B","E01029710","Total",640,222,6,216,144,40,160,23,137
"2011","Stafford 008C","E01029711","Total",612,158,5,153,179,52,134,23,111
"2011","Stafford 008D","E01029712","Total",774,240,12,228,237,76,208,31,177
"2011","Stafford 008E","E01029713","Total",694,250,16,234,179,61,187,24,163
"2011","Stafford 009A","E01029692","Total",669,238,37,201,217,93,216,45,171
"2011","Stafford 009B","E01029693","Total",805,295,22,273,220,131,92,30,62
"2011","Stafford 009C","E01029722","Total",687,188,18,170,188,64,172,31,141
"2011","Stafford 009D","E01029725","Total",695,299,4,295,124,54,237,19,218
"2011","Stafford 010A","E01029689","Total",835,167,11,156,159,75,143,22,121
"2011","Stafford 010B","E01029691","Total",693,287,13,274,95,45,231,14,217
"2011","Stafford 010C","E01029694","Total",619,119,7,112,173,98,101,22,79
"2011","Stafford 010D","E01029699","Total",955,303,22,281,221,115,257,33,224
"2011","Stafford 010E","E01029701","Total",1131,400,38,362,169,91,266,27,239
"2011","Stafford 011A","E01029686","Total",607,211,6,205,169,54,153,25,128
"2011","Stafford 011B","E01029700","Total",536,112,7,105,163,51,106,25,81
"2011","Stafford 011C","E01029723","Total",687,206,4,202,176,61,150,23,127
"2011","Stafford 011D","E01029724","Total",680,179,3,176,213,62,136,26,110
"2011","Stafford 011E","E01029732","Total",601,150,12,138,166,63,113,26,87
"2011","Stafford 012A","E01029714","Total",647,138,9,129,205,68,130,21,109
"2011","Stafford 012B","E01029736","Total",602,108,9,99,207,79,112,22,90
"2011","Stafford 012C","E01029737","Total",666,242,13,229,173,53,199,26,173
"2011","Stafford 012D","E01029738","Total",583,160,4,156,158,51,132,15,117
"2011","Stafford 012E","E01029742","Total",861,333,11,322,181,57,215,17,198
"2011","Stafford 013A","E01029715","Total",785,247,43,204,241,99,223,36,187
"2011","Stafford 013B","E01029716","Total",681,274,48,226,203,76,207,40,167
"2011","Stafford 013C","E01029717","Total",770,327,98,229,282,122,275,59,216
"2011","Stafford 013D","E01029727","Total",689,302,47,255,200,91,233,44,189
"2011","Stafford 013E","E01029728","Total",621,224,23,201,193,79,185,32,153
"2011","Stafford 014A","E01029684","Total",596,191,2,189,193,61,141,19,122
"2011","Stafford 014B","E01029685","Total",637,284,5,279,176,59,164,25,139
"2011","Stafford 014C","E01029730","Total",445,166,1,165,111,28,98,10,88
"2011","Stafford 014D","E01029731","Total",638,185,7,178,236,69,148,28,120
"2011","Stafford 014E","E01029757","Total",640,156,7,149,232,81,148,29,119
"2011","Stafford 014F","E01029758","Total",656,231,5,226,175,51,163,24,139
"2011","Stafford 014G","E01029759","Total",726,234,8,226,207,66,169,24,145
"2011","Stafford 014H","E01029760","Total",668,291,3,288,168,50,187,24,163
"2011","Stafford 015A","E01029688","Total",914,298,14,284,246,74,217,29,188
"2011","Stafford 015B","E01029706","Total",660,206,8,198,161,50,132,19,113
"2011","Stafford 015C","E01029707","Total",674,264,15,249,163,75,206,26,180
"2011","Stafford 015D","E01029708","Total",773,211,11,200,215,74,164,23,141
"2011","Stafford 015E","E01029709","Total",620,183,9,174,167,40,140,26,114
"2011","Stafford 016A","E01029726","Total",702,240,26,214,195,74,201,46,155
"2011","Stafford 016B","E01029729","Total",868,331,18,313,167,69,272,20,252
"2011","Stafford 016C","E01029734","Total",949,357,93,264,368,187,293,56,237
"2011","Stafford 016D","E01029735","Total",948,268,34,234,307,143,219,44,175
"2011","Staffordshire Moorlands 001A","E01029797","Total",623,159,12,147,155,50,149,27,122
"2011","Staffordshire Moorlands 001B","E01029806","Total",677,261,7,254,139,44,190,24,166
"2011","Staffordshire Moorlands 001C","E01029808","Total",663,254,29,225,169,61,198,30,168
"2011","Staffordshire Moorlands 001D","E01029809","Total",618,254,43,211,181,72,217,45,172
"2011","Staffordshire Moorlands 001E","E01029810","Total",546,202,37,165,195,74,166,42,124
"2011","Staffordshire Moorlands 002A","E01029767","Total",727,238,5,233,158,42,202,20,182
"2011","Staffordshire Moorlands 002B","E01029769","Total",753,325,3,322,127,34,218,20,198
"2011","Staffordshire Moorlands 002C","E01029770","Total",839,272,7,265,205,69,213,25,188
"2011","Staffordshire Moorlands 002D","E01029802","Total",739,205,9,196,186,49,175,27,148
"2011","Staffordshire Moorlands 003A","E01029763","Total",682,294,69,225,238,93,255,59,196
"2011","Staffordshire Moorlands 003B","E01029764","Total",651,122,40,82,329,113,129,40,89
"2011","Staffordshire Moorlands 003C","E01029765","Total",541,224,46,178,192,81,197,44,153
"2011","Staffordshire Moorlands 003D","E01029766","Total",631,234,25,209,206,78,227,39,188
"2011","Staffordshire Moorlands 003E","E01029774","Total",919,297,45,252,254,125,229,38,191
"2011","Staffordshire Moorlands 004A","E01029768","Total",621,245,4,241,118,53,185,18,167
"2011","Staffordshire Moorlands 004B","E01029771","Total",724,340,11,329,142,48,232,29,203
"2011","Staffordshire Moorlands 004C","E01029772","Total",777,279,14,265,184,74,229,23,206
"2011","Staffordshire Moorlands 004D","E01029773","Total",663,242,7,235,157,56,193,23,170
"2011","Staffordshire Moorlands 005A","E01029804","Total",923,283,35,248,216,97,256,41,215
"2011","Staffordshire Moorlands 005B","E01029807","Total",547,222,10,212,117,41,170,20,150
"2011","Staffordshire Moorlands 005C","E01029811","Total",658,238,25,213,195,73,191,21,170
"2011","Staffordshire Moorlands 005D","E01029812","Total",993,333,40,293,267,117,258,25,233
"2011","Staffordshire Moorlands 005E","E01029814","Total",790,218,19,199,218,72,171,28,143
"2011","Staffordshire Moorlands 006A","E01029792","Total",996,256,8,248,283,110,232,47,185
"2011","Staffordshire Moorlands 006B","E01029793","Total",687,217,9,208,196,55,172,30,142
"2011","Staffordshire Moorlands 006C","E01029805","Total",731,291,13,278,190,49,204,31,173
"2011","Staffordshire Moorlands 006D","E01029813","Total",896,282,19,263,272,104,220,42,178
"2011","Staffordshire Moorlands 006E","E01029815","Total",676,278,14,264,164,43,190,19,171
"2011","Staffordshire Moorlands 006F","E01029816","Total",608,220,3,217,157,52,178,22,156
"2011","Staffordshire Moorlands 007A","E01029801","Total",776,235,15,220,188,68,182,24,158
"2011","Staffordshire Moorlands 007B","E01029803","Total",778,248,5,243,172,50,190,21,169
"2011","Staffordshire Moorlands 007C","E01029817","Total",823,232,7,225,169,46,217,25,192
"2011","Staffordshire Moorlands 008A","E01029762","Total",669,232,9,223,178,53,175,32,143
"2011","Staffordshire Moorlands 008B","E01029775","Total",670,269,10,259,148,52,196,21,175
"2011","Staffordshire Moorlands 008C","E01029776","Total",737,268,3,265,184,51,178,21,157
"2011","Staffordshire Moorlands 008D","E01029777","Total",632,243,7,236,186,57,194,27,167
"2011","Staffordshire Moorlands 009A","E01029779","Total",726,317,5,312,152,58,215,29,186
"2011","Staffordshire Moorlands 009B","E01029780","Total",650,231,20,211,189,56,186,34,152
"2011","Staffordshire Moorlands 009C","E01029794","Total",584,188,2,186,141,43,151,24,127
"2011","Staffordshire Moorlands 009D","E01029818","Total",618,161,4,157,180,58,151,21,130
"2011","Staffordshire Moorlands 009E","E01029819","Total",729,281,8,273,160,53,226,23,203
"2011","Staffordshire Moorlands 010A","E01029761","Total",596,225,11,214,134,36,141,21,120
"2011","Staffordshire Moorlands 010B","E01029782","Total",839,311,44,267,238,99,278,37,241
"2011","Staffordshire Moorlands 010C","E01029795","Total",767,248,7,241,173,54,207,31,176
"2011","Staffordshire Moorlands 010D","E01029796","Total",642,207,14,193,163,48,179,33,146
"2011","Staffordshire Moorlands 011A","E01029781","Total",662,213,11,202,174,57,163,26,137
"2011","Staffordshire Moorlands 011B","E01029783","Total",652,281,27,254,178,60,233,21,212
"2011","Staffordshire Moorlands 011C","E01029786","Total",589,166,12,154,165,53,134,22,112
"2011","Staffordshire Moorlands 011D","E01029787","Total",782,338,20,318,174,65,268,30,238
"2011","Staffordshire Moorlands 012A","E01029778","Total",707,206,13,193,170,48,179,29,150
"2011","Staffordshire Moorlands 012B","E01029789","Total",449,164,9,155,107,34,135,23,112
"2011","Staffordshire Moorlands 012C","E01029798","Total",749,265,22,243,205,58,183,30,153
"2011","Staffordshire Moorlands 012D","E01029799","Total",807,297,7,290,183,55,220,30,190
"2011","Staffordshire Moorlands 012E","E01029800","Total",670,210,4,206,182,48,179,28,151
"2011","Staffordshire Moorlands 013A","E01029784","Total",898,311,7,304,244,86,225,34,191
"2011","Staffordshire Moorlands 013B","E01029785","Total",728,215,9,206,223,67,186,27,159
"2011","Staffordshire Moorlands 013C","E01029788","Total",547,157,5,152,150,48,128,21,107
"2011","Staffordshire Moorlands 013D","E01029790","Total",785,235,20,215,254,98,218,51,167
"2011","Staffordshire Moorlands 013E","E01029791","Total",612,145,15,130,158,57,136,19,117
"2011","Tamworth 001A","E01029846","Total",521,183,10,173,143,39,148,22,126
"2011","Tamworth 001B","E01029847","Total",537,152,6,146,137,37,137,30,107
"2011","Tamworth 001C","E01029848","Total",515,170,5,165,135,31,138,16,122
"2011","Tamworth 001D","E01029852","Total",763,353,50,303,229,69,265,47,218
"2011","Tamworth 001E","E01029853","Total",672,237,27,210,201,85,176,36,140
"2011","Tamworth 001F","E01029854","Total",641,236,1,235,145,42,162,23,139
"2011","Tamworth 002A","E01029835","Total",1048,633,32,601,105,49,447,24,423
"2011","Tamworth 002B","E01029836","Total",587,192,22,170,159,65,143,21,122
"2011","Tamworth 002C","E01029849","Total",683,334,67,267,223,94,238,35,203
"2011","Tamworth 002D","E01029850","Total",574,215,29,186,176,59,194,35,159
"2011","Tamworth 002E","E01029851","Total",985,373,49,324,242,101,264,38,226
"2011","Tamworth 003A","E01029820","Total",585,171,33,138,217,86,136,37,99
"2011","Tamworth 003B","E01029821","Total",648,225,13,212,141,42,176,19,157
"2011","Tamworth 003C","E01029822","Total",526,57,16,41,271,88,94,38,56
"2011","Tamworth 003D","E01029824","Total",734,278,83,195,280,133,250,60,190
"2011","Tamworth 003E","E01029841","Total",608,183,14,169,154,54,165,24,141
"2011","Tamworth 004A","E01029823","Total",657,261,10,251,148,58,187,19,168
"2011","Tamworth 004B","E01029831","Total",634,237,47,190,192,81,192,30,162
"2011","Tamworth 004C","E01029832","Total",700,282,20,262,204,86,180,28,152
"2011","Tamworth 004D","E01029834","Total",680,280,44,236,201,97,208,28,180
"2011","Tamworth 004E","E01029844","Total",496,103,10,93,155,55,118,20,98
"2011","Tamworth 005A","E01029833","Total",684,124,18,106,239,87,139,40,99
"2011","Tamworth 005B","E01029837","Total",697,208,21,187,205,86,180,36,144
"2011","Tamworth 005C","E01029838","Total",714,182,21,161,201,86,126,19,107
"2011","Tamworth 005D","E01029839","Total",445,58,4,54,179,51,70,20,50
"2011","Tamworth 006A","E01029825","Total",512,103,11,92,166,62,133,30,103
"2011","Tamworth 006B","E01029826","Total",640,192,15,177,180,57,176,27,149
"2011","Tamworth 006C","E01029827","Total",541,201,51,150,214,89,165,37,128
"2011","Tamworth 006D","E01029828","Total",480,159,56,103,202,89,129,43,86
"2011","Tamworth 006E","E01029830","Total",543,188,33,155,153,74,134,26,108
"2011","Tamworth 007A","E01029840","Total",460,162,76,86,214,96,142,60,82
"2011","Tamworth 007B","E01029842","Total",518,175,71,104,223,101,146,40,106
"2011","Tamworth 007C","E01029843","Total",552,174,44,130,231,93,156,44,112
"2011","Tamworth 007D","E01029845","Total",472,255,58,197,168,82,197,48,149
"2011","Tamworth 007E","E01029859","Total",754,283,97,186,318,157,205,56,149
"2011","Tamworth 008A","E01029855","Total",547,122,31,91,237,72,111,34,77
"2011","Tamworth 008B","E01029856","Total",595,92,15,77,193,85,121,32,89
"2011","Tamworth 008C","E01029857","Total",567,146,43,103,201,92,140,43,97
"2011","Tamworth 008D","E01029858","Total",635,127,9,118,210,79,107,28,79
"2011","Tamworth 008E","E01029865","Total",602,81,12,69,227,84,105,27,78
"2011","Tamworth 009A","E01029860","Total",536,124,6,118,167,65,102,16,86
"2011","Tamworth 009B","E01029861","Total",595,241,11,230,152,42,188,28,160
"2011","Tamworth 009C","E01029862","Total",480,68,2,66,203,69,85,25,60
"2011","Tamworth 009D","E01029863","Total",756,196,11,185,212,102,172,22,150
"2011","Tamworth 009E","E01029864","Total",646,157,14,143,185,66,131,19,112
"2011","Tamworth 010A","E01029829","Total",781,164,47,117,297,148,161,44,117
"2011","Tamworth 010C","E01029867","Total",679,216,43,173,223,106,191,50,141
"2011","Tamworth 010D","E01029868","Total",500,63,2,61,192,63,94,27,67
"2011","Tamworth 010E","E01029869","Total",660,208,27,181,221,79,177,28,149
"2011","Tamworth 010F","E01032901","Total",634,76,25,51,266,138,82,34,48
"2011","Tamworth 010G","E01032902","Total",598,144,12,132,172,78,137,22,115
"2011","North Warwickshire 001A","E01031035","Total",749,212,23,189,236,78,188,37,151
"2011","North Warwickshire 001B","E01031036","Total",619,194,12,182,176,42,159,20,139
"2011","North Warwickshire 001C","E01031037","Total",645,246,16,230,176,59,204,34,170
"2011","North Warwickshire 001D","E01031038","Total",751,204,18,186,267,96,196,39,157
"2011","North Warwickshire 001E","E01031039","Total",656,182,7,175,210,67,134,28,106
"2011","North Warwickshire 001F","E01031040","Total",754,192,11,181,219,84,175,28,147
"2011","North Warwickshire 002A","E01031016","Total",678,266,35,231,174,64,244,42,202
"2011","North Warwickshire 002B","E01031025","Total",690,225,19,206,174,72,204,25,179
"2011","North Warwickshire 002C","E01031026","Total",596,157,39,118,219,80,161,46,115
"2011","North Warwickshire 002D","E01031031","Total",1015,261,29,232,351,144,227,48,179
"2011","North Warwickshire 002E","E01031032","Total",528,184,23,161,156,61,167,30,137
"2011","North Warwickshire 003A","E01031009","Total",971,282,36,246,242,119,238,36,202
"2011","North Warwickshire 003B","E01031010","Total",847,315,56,259,242,107,255,46,209
"2011","North Warwickshire 003C","E01031011","Total",788,248,16,232,243,72,207,33,174
"2011","North Warwickshire 003D","E01031012","Total",631,284,28,256,168,67,208,33,175
"2011","North Warwickshire 003E","E01031013","Total",484,182,6,176,97,30,137,9,128
"2011","North Warwickshire 003F","E01031014","Total",505,173,10,163,130,38,127,15,112
"2011","North Warwickshire 003G","E01031015","Total",598,261,55,206,190,73,208,43,165
"2011","North Warwickshire 004A","E01031023","Total",639,197,8,189,164,54,149,23,126
"2011","North Warwickshire 004B","E01031024","Total",675,177,4,173,157,40,177,19,158
"2011","North Warwickshire 004C","E01031033","Total",783,298,20,278,205,69,236,36,200
"2011","North Warwickshire 004D","E01031034","Total",767,187,8,179,213,71,156,30,126
"2011","North Warwickshire 005A","E01031005","Total",578,193,30,163,202,82,178,33,145
"2011","North Warwickshire 005B","E01031008","Total",578,187,33,154,177,84,165,30,135
"2011","North Warwickshire 005C","E01031017","Total",524,158,5,153,144,59,132,22,110
"2011","North Warwickshire 005D","E01031018","Total",461,126,5,121,117,43,113,22,91
"2011","North Warwickshire 005E","E01031029","Total",578,161,9,152,205,57,146,29,117
"2011","North Warwickshire 005F","E01031030","Total",984,330,36,294,259,99,290,46,244
"2011","North Warwickshire 006A","E01031019","Total",668,152,9,143,238,80,108,15,93
"2011","North Warwickshire 006B","E01031020","Total",700,186,8,178,174,67,154,19,135
"2011","North Warwickshire 006C","E01031021","Total",779,295,16,279,155,53,234,27,207
"2011","North Warwickshire 006D","E01031022","Total",687,241,10,231,165,44,190,23,167
"2011","North Warwickshire 006E","E01031041","Total",720,192,6,186,189,52,164,19,145
"2011","North Warwickshire 006F","E01031042","Total",721,241,13,228,196,64,191,27,164
"2011","North Warwickshire 007A","E01031006","Total",635,193,24,169,205,91,198,36,162
"2011","North Warwickshire 007B","E01031007","Total",489,122,0,122,135,42,117,18,99
"2011","North Warwickshire 007C","E01031027","Total",580,170,8,162,149,49,139,19,120
"2011","North Warwickshire 007D","E01031028","Total",761,210,14,196,207,77,192,48,144
"2011","Nuneaton and Bedworth 001A","E01031110","Total",655,261,8,253,159,42,174,23,151
"2011","Nuneaton and Bedworth 001B","E01031111","Total",412,110,3,107,133,26,80,22,58
"2011","Nuneaton and Bedworth 001C","E01031112","Total",661,240,14,226,221,62,160,23,137
"2011","Nuneaton and Bedworth 001D","E01031113","Total",607,221,6,215,164,56,144,22,122
"2011","Nuneaton and Bedworth 001E","E01031114","Total",745,311,8,303,163,45,249,28,221
"2011","Nuneaton and Bedworth 002C","E01031073","Total",821,306,35,271,234,102,242,43,199
"2011","Nuneaton and Bedworth 002D","E01031074","Total",723,259,33,226,192,96,198,25,173
"2011","Nuneaton and Bedworth 002E","E01031075","Total",709,275,67,208,247,109,223,51,172
"2011","Nuneaton and Bedworth 002F","E01032890","Total",822,318,135,183,367,159,233,71,162
"2011","Nuneaton and Bedworth 003A","E01031100","Total",503,107,7,100,177,46,117,28,89
"2011","Nuneaton and Bedworth 003B","E01031101","Total",516,117,2,115,203,46,103,26,77
"2011","Nuneaton and Bedworth 003C","E01031102","Total",582,165,13,152,162,52,130,21,109
"2011","Nuneaton and Bedworth 003D","E01031103","Total",490,153,1,152,158,37,116,23,93
"2011","Nuneaton and Bedworth 003E","E01031104","Total",642,328,5,323,118,18,194,18,176
"2011","Nuneaton and Bedworth 004A","E01031081","Total",655,167,46,121,279,130,152,49,103
"2011","Nuneaton and Bedworth 004B","E01031082","Total",504,57,11,46,213,67,77,23,54
"2011","Nuneaton and Bedworth 004C","E01031083","Total",626,163,12,151,220,81,141,23,118
"2011","Nuneaton and Bedworth 004D","E01031084","Total",868,153,20,133,327,152,158,39,119
"2011","Nuneaton and Bedworth 004E","E01031085","Total",523,97,7,90,176,58,116,31,85
"2011","Nuneaton and Bedworth 005A","E01031043","Total",906,391,30,361,157,76,306,32,274
"2011","Nuneaton and Bedworth 005B","E01031044","Total",752,290,68,222,251,134,203,45,158
"2011","Nuneaton and Bedworth 005C","E01031045","Total",763,269,26,243,200,93,194,27,167
"2011","Nuneaton and Bedworth 005D","E01031046","Total",716,220,52,168,245,99,192,51,141
"2011","Nuneaton and Bedworth 005E","E01031047","Total",845,227,29,198,252,139,195,41,154
"2011","Nuneaton and Bedworth 006A","E01031057","Total",687,355,94,261,244,117,247,57,190
"2011","Nuneaton and Bedworth 006B","E01031058","Total",623,219,44,175,178,66,176,35,141
"2011","Nuneaton and Bedworth 006C","E01031059","Total",637,205,32,173,191,86,163,28,135
"2011","Nuneaton and Bedworth 006D","E01031060","Total",635,239,29,210,169,56,171,17,154
"2011","Nuneaton and Bedworth 006E","E01031061","Total",602,124,16,108,235,76,144,45,99
"2011","Nuneaton and Bedworth 007A","E01031090","Total",620,272,58,214,206,91,189,40,149
"2011","Nuneaton and Bedworth 007B","E01031091","Total",599,189,16,173,179,77,142,21,121
"2011","Nuneaton and Bedworth 007C","E01031092","Total",622,224,43,181,206,83,174,38,136
"2011","Nuneaton and Bedworth 007D","E01031093","Total",538,168,14,154,173,59,134,36,98
"2011","Nuneaton and Bedworth 007E","E01031094","Total",506,161,29,132,174,76,121,30,91
"2011","Nuneaton and Bedworth 008A","E01031048","Total",511,128,15,113,166,67,101,17,84
"2011","Nuneaton and Bedworth 008B","E01031049","Total",929,252,16,236,305,126,230,49,181
"2011","Nuneaton and Bedworth 008C","E01031050","Total",776,167,37,130,242,118,139,32,107
"2011","Nuneaton and Bedworth 008D","E01031051","Total",581,209,9,200,138,45,168,24,144
"2011","Nuneaton and Bedworth 009A","E01031115","Total",713,214,23,191,213,103,199,30,169
"2011","Nuneaton and Bedworth 009B","E01031116","Total",719,348,91,257,254,121,245,50,195
"2011","Nuneaton and Bedworth 009C","E01031117","Total",589,215,52,163,212,95,163,34,129
"2011","Nuneaton and Bedworth 009D","E01031118","Total",483,188,47,141,168,53,167,40,127
"2011","Nuneaton and Bedworth 009E","E01031119","Total",731,326,40,286,198,88,236,41,195
"2011","Nuneaton and Bedworth 010A","E01031052","Total",639,171,42,129,238,102,143,43,100
"2011","Nuneaton and Bedworth 010B","E01031053","Total",713,348,14,334,139,58,256,21,235
"2011","Nuneaton and Bedworth 010C","E01031054","Total",661,225,39,186,214,81,182,36,146
"2011","Nuneaton and Bedworth 010D","E01031055","Total",664,101,23,78,277,129,95,19,76
"2011","Nuneaton and Bedworth 010E","E01031056","Total",615,224,33,191,183,69,172,35,137
"2011","Nuneaton and Bedworth 011A","E01031120","Total",585,143,7,136,162,55,133,21,112
"2011","Nuneaton and Bedworth 011B","E01031121","Total",454,127,5,122,137,43,78,14,64
"2011","Nuneaton and Bedworth 011C","E01031122","Total",623,213,4,209,156,42,140,15,125
"2011","Nuneaton and Bedworth 011D","E01031123","Total",507,159,1,158,128,36,108,18,90
"2011","Nuneaton and Bedworth 011E","E01031124","Total",638,236,7,229,154,47,149,19,130
"2011","Nuneaton and Bedworth 012A","E01031105","Total",590,201,17,184,180,56,149,22,127
"2011","Nuneaton and Bedworth 012B","E01031106","Total",624,261,19,242,157,64,177,30,147
"2011","Nuneaton and Bedworth 012C","E01031107","Total",469,97,9,88,160,64,107,24,83
"2011","Nuneaton and Bedworth 012D","E01031108","Total",545,102,9,93,185,64,127,35,92
"2011","Nuneaton and Bedworth 012E","E01031109","Total",738,302,38,264,216,78,239,31,208
"2011","Nuneaton and Bedworth 013A","E01031062","Total",494,180,14,166,135,39,117,18,99
"2011","Nuneaton and Bedworth 013B","E01031063","Total",660,327,45,282,150,69,229,23,206
"2011","Nuneaton and Bedworth 013C","E01031064","Total",571,256,13,243,123,39,218,18,200
"2011","Nuneaton and Bedworth 013D","E01031065","Total",623,219,37,182,196,73,161,27,134
"2011","Nuneaton and Bedworth 013E","E01031066","Total",637,303,57,246,188,79,233,31,202
"2011","Nuneaton and Bedworth 014A","E01031067","Total",733,335,19,316,140,48,229,17,212
"2011","Nuneaton and Bedworth 014B","E01031068","Total",739,305,6,299,165,55,225,21,204
"2011","Nuneaton and Bedworth 014C","E01031069","Total",667,333,4,329,134,49,187,16,171
"2011","Nuneaton and Bedworth 014D","E01031070","Total",655,270,6,264,119,35,177,14,163
"2011","Nuneaton and Bedworth 015A","E01031095","Total",496,172,39,133,191,81,141,33,108
"2011","Nuneaton and Bedworth 015B","E01031096","Total",600,139,15,124,175,76,149,30,119
"2011","Nuneaton and Bedworth 015C","E01031097","Total",751,312,45,267,212,90,276,50,226
"2011","Nuneaton and Bedworth 015D","E01031098","Total",559,151,32,119,213,97,145,34,111
"2011","Nuneaton and Bedworth 015E","E01031099","Total",935,150,17,133,322,141,185,54,131
"2011","Nuneaton and Bedworth 016A","E01031086","Total",773,278,30,248,229,101,265,40,225
"2011","Nuneaton and Bedworth 016B","E01031087","Total",890,289,62,227,322,132,218,46,172
"2011","Nuneaton and Bedworth 016C","E01031088","Total",772,206,30,176,277,113,171,32,139
"2011","Nuneaton and Bedworth 016D","E01031089","Total",639,255,8,247,125,50,198,22,176
"2011","Nuneaton and Bedworth 018A","E01031077","Total",612,212,50,162,215,97,204,59,145
"2011","Nuneaton and Bedworth 018B","E01031078","Total",811,236,21,215,252,100,215,32,183
"2011","Nuneaton and Bedworth 018C","E01031079","Total",642,260,22,238,154,62,195,26,169
"2011","Nuneaton and Bedworth 018D","E01031080","Total",669,255,43,212,194,85,205,40,165
"2011","Nuneaton and Bedworth 018E","E01032588","Total",571,193,13,180,154,51,142,26,116
"2011","Rugby 001B","E01031129","Total",510,173,4,169,117,45,132,15,117
"2011","Rugby 001C","E01031159","Total",691,221,17,204,185,65,176,25,151
"2011","Rugby 001D","E01031160","Total",905,272,12,260,223,75,223,33,190
"2011","Rugby 001E","E01031182","Total",839,202,9,193,286,125,207,43,164
"2011","Rugby 001F","E01032891","Total",694,43,7,36,246,134,63,19,44
"2011","Rugby 001G","E01032892","Total",766,186,10,176,271,94,157,32,125
"2011","Rugby 002A","E01031137","Total",561,126,13,113,140,71,133,21,112
"2011","Rugby 002B","E01031138","Total",450,74,21,53,176,52,80,27,53
"2011","Rugby 002C","E01031139","Total",686,82,12,70,264,84,116,37,79
"2011","Rugby 002D","E01031140","Total",537,152,20,132,155,53,131,21,110
"2011","Rugby 002E","E01031141","Total",749,166,36,130,277,151,139,40,99
"2011","Rugby 002F","E01031142","Total",688,227,72,155,279,139,153,47,106
"2011","Rugby 003A","E01031171","Total",607,164,24,140,191,69,161,30,131
"2011","Rugby 003B","E01031172","Total",735,273,56,217,237,129,200,35,165
"2011","Rugby 003C","E01031173","Total",994,467,44,423,180,97,322,27,295
"2011","Rugby 003D","E01031174","Total",739,231,37,194,212,105,208,35,173
"2011","Rugby 004A","E01031151","Total",620,222,4,218,163,56,159,19,140
"2011","Rugby 004B","E01031152","Total",495,173,6,167,108,38,126,11,115
"2011","Rugby 004C","E01031153","Total",589,192,26,166,194,68,146,29,117
"2011","Rugby 004D","E01031154","Total",763,209,6,203,194,72,149,22,127
"2011","Rugby 004E","E01031181","Total",728,210,11,199,234,87,166,29,137
"2011","Rugby 005A","E01031130","Total",764,132,31,101,252,125,151,43,108
"2011","Rugby 005B","E01031131","Total",687,155,34,121,211,103,142,32,110
"2011","Rugby 005C","E01031132","Total",867,204,35,169,235,99,169,32,137
"2011","Rugby 005D","E01031133","Total",715,233,40,193,221,98,196,38,158
"2011","Rugby 006A","E01031167","Total",551,156,14,142,160,58,136,22,114
"2011","Rugby 006B","E01031168","Total",1157,300,83,217,426,232,243,62,181
"2011","Rugby 006C","E01031169","Total",923,188,42,146,267,142,172,28,144
"2011","Rugby 006D","E01031170","Total",757,266,33,233,193,86,221,41,180
"2011","Rugby 007A","E01031125","Total",658,177,9,168,158,72,141,18,123
"2011","Rugby 007C","E01031127","Total",624,207,48,159,235,96,164,42,122
"2011","Rugby 007D","E01031164","Total",849,184,16,168,258,98,188,31,157
"2011","Rugby 007E","E01031165","Total",690,249,43,206,218,87,206,52,154
"2011","Rugby 007F","E01032893","Total",589,60,14,46,376,127,76,43,33
"2011","Rugby 007G","E01032894","Total",483,56,19,37,269,119,70,28,42
"2011","Rugby 007H","E01032895","Total",542,109,14,95,217,89,100,26,74
"2011","Rugby 008A","E01031155","Total",545,150,5,145,187,63,106,22,84
"2011","Rugby 008B","E01031156","Total",647,169,7,162,180,74,130,18,112
"2011","Rugby 008C","E01031157","Total",791,193,13,180,286,104,164,31,133
"2011","Rugby 008D","E01031158","Total",480,208,0,208,112,41,147,13,134
"2011","Rugby 009A","E01031143","Total",649,222,8,214,158,50,147,19,128
"2011","Rugby 009B","E01031144","Total",576,163,17,146,150,67,137,13,124
"2011","Rugby 009C","E01031145","Total",503,216,9,207,82,31,179,11,168
"2011","Rugby 009D","E01031146","Total",630,254,28,226,178,60,165,30,135
"2011","Rugby 010A","E01031161","Total",874,321,14,307,207,67,213,28,185
"2011","Rugby 010B","E01031162","Total",732,239,12,227,203,63,194,33,161
"2011","Rugby 010C","E01031163","Total",743,343,24,319,171,66,244,34,210
"2011","Rugby 010D","E01031179","Total",690,189,2,187,238,72,146,24,122
"2011","Rugby 010E","E01031180","Total",856,285,18,267,250,93,238,44,194
"2011","Rugby 011A","E01031134","Total",732,312,4,308,157,52,213,20,193
"2011","Rugby 011B","E01031135","Total",777,375,7,368,152,37,229,18,211
"2011","Rugby 011C","E01031136","Total",722,253,11,242,183,65,194,35,159
"2011","Rugby 011D","E01031175","Total",575,257,4,253,136,42,165,20,145
"2011","Rugby 011E","E01031176","Total",590,175,29,146,207,84,149,39,110
"2011","Rugby 011F","E01031177","Total",609,191,39,152,226,90,175,41,134
"2011","Rugby 011G","E01031178","Total",643,292,21,271,141,52,188,20,168
"2011","Rugby 012A","E01031147","Total",671,313,7,306,160,40,157,16,141
"2011","Rugby 012B","E01031148","Total",740,308,17,291,189,69,178,21,157
"2011","Rugby 012C","E01031149","Total",626,189,8,181,157,46,141,22,119
"2011","Rugby 012D","E01031150","Total",493,180,8,172,126,39,113,19,94
"2011","Rugby 012E","E01031166","Total",779,212,10,202,217,65,167,30,137
"2011","Stratford-on-Avon 001A","E01031213","Total",757,206,16,190,200,69,184,29,155
"2011","Stratford-on-Avon 001B","E01031243","Total",788,275,8,267,195,51,188,24,164
"2011","Stratford-on-Avon 001C","E01031244","Total",742,221,9,212,192,64,156,24,132
"2011","Stratford-on-Avon 002A","E01031195","Total",918,311,9,302,259,81,209,32,177
"2011","Stratford-on-Avon 002B","E01031202","Total",788,317,5,312,139,53,187,16,171
"2011","Stratford-on-Avon 002C","E01031203","Total",706,281,15,266,154,50,221,25,196
"2011","Stratford-on-Avon 002D","E01031204","Total",632,297,2,295,103,41,200,9,191
"2011","Stratford-on-Avon 003A","E01031239","Total",688,203,11,192,185,67,153,17,136
"2011","Stratford-on-Avon 003B","E01031240","Total",579,212,18,194,159,48,160,18,142
"2011","Stratford-on-Avon 003C","E01031241","Total",593,194,18,176,173,49,157,20,137
"2011","Stratford-on-Avon 003D","E01031242","Total",653,276,24,252,183,61,217,38,179
"2011","Stratford-on-Avon 004A","E01031219","Total",639,195,26,169,224,71,168,38,130
"2011","Stratford-on-Avon 004B","E01031220","Total",601,180,8,172,205,52,147,23,124
"2011","Stratford-on-Avon 004C","E01031221","Total",695,247,22,225,188,75,179,21,158
"2011","Stratford-on-Avon 004D","E01031222","Total",843,236,8,228,226,78,182,33,149
"2011","Stratford-on-Avon 004E","E01031223","Total",526,123,10,113,179,58,113,25,88
"2011","Stratford-on-Avon 004F","E01031224","Total",455,117,8,109,149,41,106,19,87
"2011","Stratford-on-Avon 005A","E01031197","Total",513,139,8,131,128,42,116,19,97
"2011","Stratford-on-Avon 005B","E01031198","Total",521,120,4,116,174,53,105,15,90
"2011","Stratford-on-Avon 005C","E01031199","Total",598,179,15,164,171,46,159,29,130
"2011","Stratford-on-Avon 005D","E01031200","Total",652,128,13,115,203,76,131,30,101
"2011","Stratford-on-Avon 005E","E01031201","Total",671,238,6,232,178,62,113,17,96
"2011","Stratford-on-Avon 005F","E01031210","Total",516,144,10,134,144,49,102,16,86
"2011","Stratford-on-Avon 005G","E01031211","Total",449,140,11,129,138,56,114,21,93
"2011","Stratford-on-Avon 006A","E01031183","Total",809,258,15,243,170,55,174,19,155
"2011","Stratford-on-Avon 006B","E01031184","Total",650,221,12,209,193,49,142,24,118
"2011","Stratford-on-Avon 006C","E01031185","Total",628,231,22,209,175,55,206,39,167
"2011","Stratford-on-Avon 006D","E01031186","Total",665,285,24,261,174,61,215,34,181
"2011","Stratford-on-Avon 007A","E01031187","Total",813,265,8,257,216,70,185,30,155
"2011","Stratford-on-Avon 007B","E01031188","Total",912,286,13,273,232,73,204,26,178
"2011","Stratford-on-Avon 007C","E01031208","Total",881,299,12,287,199,57,193,29,164
"2011","Stratford-on-Avon 008A","E01031217","Total",513,184,6,178,126,36,129,20,109
"2011","Stratford-on-Avon 008B","E01031218","Total",452,100,5,95,146,49,76,15,61
"2011","Stratford-on-Avon 008C","E01031249","Total",509,151,13,138,145,50,133,23,110
"2011","Stratford-on-Avon 008D","E01031250","Total",662,239,8,231,148,43,168,23,145
"2011","Stratford-on-Avon 008E","E01031251","Total",504,190,4,186,132,37,110,22,88
"2011","Stratford-on-Avon 008F","E01031252","Total",514,156,8,148,123,47,121,11,110
"2011","Stratford-on-Avon 008G","E01031253","Total",661,224,15,209,190,73,175,25,150
"2011","Stratford-on-Avon 009A","E01031228","Total",713,282,6,276,139,41,194,20,174
"2011","Stratford-on-Avon 009B","E01031229","Total",1005,344,10,334,118,53,217,16,201
"2011","Stratford-on-Avon 009C","E01031230","Total",972,211,22,189,315,137,214,45,169
"2011","Stratford-on-Avon 009D","E01031231","Total",1020,306,44,262,252,111,255,43,212
"2011","Stratford-on-Avon 009E","E01031236","Total",650,150,15,135,194,57,170,28,142
"2011","Stratford-on-Avon 009F","E01031238","Total",640,275,22,253,135,51,235,20,215
"2011","Stratford-on-Avon 010A","E01031225","Total",708,268,4,264,159,55,190,18,172
"2011","Stratford-on-Avon 010C","E01031227","Total",904,342,10,332,212,62,230,20,210
"2011","Stratford-on-Avon 010D","E01033250","Total",552,88,17,71,230,112,62,21,41
"2011","Stratford-on-Avon 010E","E01033251","Total",458,82,22,60,193,82,60,22,38
"2011","Stratford-on-Avon 010F","E01033252","Total",546,211,5,206,138,41,125,11,114
"2011","Stratford-on-Avon 011A","E01031232","Total",993,290,11,279,278,94,207,33,174
"2011","Stratford-on-Avon 011B","E01031233","Total",731,259,20,239,190,58,184,23,161
"2011","Stratford-on-Avon 011C","E01031234","Total",971,429,6,423,132,59,296,14,282
"2011","Stratford-on-Avon 011D","E01031235","Total",941,414,15,399,151,74,248,13,235
"2011","Stratford-on-Avon 011E","E01031237","Total",590,208,9,199,138,40,144,20,124
"2011","Stratford-on-Avon 012A","E01031189","Total",621,186,12,174,176,54,155,35,120
"2011","Stratford-on-Avon 012B","E01031190","Total",669,182,27,155,239,90,160,31,129
"2011","Stratford-on-Avon 012C","E01031191","Total",707,194,7,187,224,59,153,25,128
"2011","Stratford-on-Avon 012D","E01031192","Total",859,243,11,232,226,88,197,30,167
"2011","Stratford-on-Avon 012E","E01031248","Total",913,324,13,311,242,71,223,37,186
"2011","Stratford-on-Avon 013A","E01031194","Total",969,233,14,219,294,122,197,28,169
"2011","Stratford-on-Avon 013B","E01031205","Total",659,161,6,155,181,59,129,19,110
"2011","Stratford-on-Avon 013C","E01031206","Total",607,182,13,169,175,70,151,18,133
"2011","Stratford-on-Avon 013D","E01031207","Total",540,149,21,128,149,64,136,27,109
"2011","Stratford-on-Avon 013E","E01031247","Total",965,306,10,296,248,60,241,33,208
"2011","Stratford-on-Avon 014A","E01031196","Total",975,274,11,263,297,90,186,42,144
"2011","Stratford-on-Avon 014B","E01031212","Total",1105,296,27,269,348,143,248,45,203
"2011","Stratford-on-Avon 014C","E01031245","Total",544,227,11,216,123,44,141,17,124
"2011","Stratford-on-Avon 014D","E01031246","Total",464,138,3,135,122,34,97,8,89
"2011","Stratford-on-Avon 015A","E01031193","Total",948,302,14,288,226,67,226,29,197
"2011","Stratford-on-Avon 015B","E01031209","Total",975,359,14,345,211,74,246,25,221
"2011","Stratford-on-Avon 015C","E01031214","Total",776,287,7,280,226,85,168,28,140
"2011","Stratford-on-Avon 015D","E01031215","Total",865,319,14,305,172,77,230,26,204
"2011","Stratford-on-Avon 015E","E01031216","Total",677,265,8,257,150,47,196,17,179
"2011","Warwick 001A","E01031254","Total",624,192,4,188,174,57,134,19,115
"2011","Warwick 001B","E01031255","Total",627,201,7,194,183,62,131,22,109
"2011","Warwick 001C","E01031256","Total",795,331,9,322,142,43,183,14,169
"2011","Warwick 001D","E01031257","Total",666,177,15,162,161,76,126,19,107
"2011","Warwick 001E","E01031258","Total",775,321,11,310,156,73,205,21,184
"2011","Warwick 002A","E01031296","Total",718,165,6,159,225,61,146,30,116
"2011","Warwick 002B","E01031297","Total",876,238,12,226,252,110,207,37,170
"2011","Warwick 002C","E01031298","Total",796,317,7,310,191,66,201,25,176
"2011","Warwick 002D","E01031299","Total",560,188,8,180,180,35,106,19,87
"2011","Warwick 002E","E01031300","Total",708,184,11,173,221,74,126,26,100
"2011","Warwick 003A","E01031303","Total",714,280,17,263,165,61,216,19,197
"2011","Warwick 003B","E01031304","Total",603,232,14,218,184,54,145,21,124
"2011","Warwick 003C","E01031305","Total",654,292,0,292,148,30,167,19,148
"2011","Warwick 003D","E01031306","Total",601,178,11,167,193,72,144,20,124
"2011","Warwick 003E","E01031307","Total",664,271,5,266,150,49,164,13,151
"2011","Warwick 004A","E01031281","Total",626,154,6,148,164,49,103,18,85
"2011","Warwick 004B","E01031282","Total",669,207,17,190,158,56,143,24,119
"2011","Warwick 004C","E01031283","Total",526,131,6,125,143,38,98,16,82
"2011","Warwick 004D","E01031284","Total",506,127,5,122,141,36,97,16,81
"2011","Warwick 005A","E01031277","Total",642,210,11,199,191,74,157,35,122
"2011","Warwick 005B","E01031278","Total",566,159,6,153,179,63,108,24,84
"2011","Warwick 005C","E01031279","Total",622,265,6,259,124,46,162,16,146
"2011","Warwick 005D","E01031280","Total",524,114,4,110,159,45,112,21,91
"2011","Warwick 005E","E01031301","Total",590,171,6,165,140,48,136,22,114
"2011","Warwick 005F","E01031302","Total",434,130,9,121,127,54,116,19,97
"2011","Warwick 005G","E01031308","Total",850,271,21,250,196,75,170,17,153
"2011","Warwick 006A","E01031273","Total",656,256,49,207,182,80,183,42,141
"2011","Warwick 006B","E01031274","Total",621,221,43,178,218,87,153,28,125
"2011","Warwick 006C","E01031275","Total",529,195,10,185,129,46,114,11,103
"2011","Warwick 006D","E01031276","Total",636,214,43,171,211,96,177,35,142
"2011","Warwick 007B","E01031272","Total",784,191,18,173,160,71,133,16,117
"2011","Warwick 007C","E01031285","Total",1043,363,3,360,155,60,231,20,211
"2011","Warwick 007D","E01031286","Total",695,258,12,246,181,94,197,21,176
"2011","Warwick 007E","E01031287","Total",583,166,6,160,215,85,112,24,88
"2011","Warwick 007F","E01031288","Total",713,268,8,260,168,72,158,18,140
"2011","Warwick 007G","E01031289","Total",569,146,9,137,201,87,104,17,87
"2011","Warwick 007H","E01033253","Total",751,212,4,208,68,29,92,5,87
"2011","Warwick 007I","E01033256","Total",707,237,5,232,65,29,129,7,122
"2011","Warwick 008A","E01031309","Total",764,226,33,193,230,113,201,32,169
"2011","Warwick 008B","E01031310","Total",559,182,11,171,151,52,155,25,130
"2011","Warwick 008C","E01031311","Total",569,193,26,167,169,63,158,30,128
"2011","Warwick 008D","E01031312","Total",542,151,23,128,166,80,144,30,114
"2011","Warwick 008E","E01031313","Total",591,180,2,178,131,51,149,13,136
"2011","Warwick 008F","E01031314","Total",605,153,7,146,145,62,121,17,104
"2011","Warwick 009A","E01031290","Total",833,201,12,189,154,63,148,16,132
"2011","Warwick 009B","E01031291","Total",788,265,13,252,87,43,141,15,126
"2011","Warwick 009C","E01031292","Total",649,158,8,150,193,85,122,27,95
"2011","Warwick 009D","E01031293","Total",702,206,21,185,190,74,143,30,113
"2011","Warwick 009E","E01031294","Total",646,193,8,185,174,71,130,21,109
"2011","Warwick 009F","E01031295","Total",497,209,2,207,110,37,126,13,113
"2011","Warwick 010A","E01031271","Total",874,344,27,317,143,69,248,23,225
"2011","Warwick 010B","E01031332","Total",519,152,40,112,195,96,134,38,96
"2011","Warwick 010C","E01031333","Total",482,141,26,115,163,84,119,37,82
"2011","Warwick 010D","E01031334","Total",657,163,20,143,216,103,165,28,137
"2011","Warwick 010E","E01031335","Total",627,120,9,111,120,62,92,11,81
"2011","Warwick 010F","E01031336","Total",832,230,19,211,103,56,142,12,130
"2011","Warwick 010G","E01031337","Total",702,162,17,145,157,73,123,17,106
"2011","Warwick 011A","E01031321","Total",506,138,48,90,223,111,126,39,87
"2011","Warwick 011B","E01031322","Total",851,205,19,186,208,100,171,17,154
"2011","Warwick 011C","E01031323","Total",805,272,13,259,165,67,234,23,211
"2011","Warwick 011D","E01031324","Total",1245,347,17,330,142,67,230,16,214
"2011","Warwick 011E","E01031325","Total",617,197,30,167,189,78,161,23,138
"2011","Warwick 011G","E01033254","Total",574,40,16,24,246,151,61,24,37
"2011","Warwick 011H","E01033255","Total",640,120,17,103,244,101,131,38,93
"2011","Warwick 012A","E01031315","Total",800,142,17,125,363,119,149,54,95
"2011","Warwick 012B","E01031316","Total",767,323,12,311,130,56,264,22,242
"2011","Warwick 012C","E01031317","Total",749,285,7,278,133,45,153,16,137
"2011","Warwick 012D","E01031318","Total",677,105,10,95,316,115,99,38,61
"2011","Warwick 012E","E01031319","Total",855,215,16,199,257,107,163,28,135
"2011","Warwick 012F","E01031320","Total",632,172,6,166,156,55,111,15,96
"2011","Warwick 013A","E01031261","Total",589,219,35,184,159,64,163,26,137
"2011","Warwick 013B","E01031262","Total",637,185,28,157,171,79,144,22,122
"2011","Warwick 013C","E01031263","Total",641,216,29,187,160,59,129,29,100
"2011","Warwick 013D","E01031264","Total",621,209,55,154,230,103,181,51,130
"2011","Warwick 013E","E01031265","Total",516,162,44,118,181,80,127,33,94
"2011","Warwick 013F","E01031266","Total",861,259,18,241,114,55,187,19,168
"2011","Warwick 014A","E01031259","Total",509,88,7,81,197,63,80,19,61
"2011","Warwick 014B","E01031260","Total",512,162,11,151,142,52,128,23,105
"2011","Warwick 014C","E01031267","Total",736,213,3,210,195,66,174,19,155
"2011","Warwick 014D","E01031268","Total",1087,165,13,152,433,172,177,41,136
"2011","Warwick 014E","E01031269","Total",743,217,5,212,191,68,154,23,131
"2011","Warwick 015A","E01031327","Total",628,215,33,182,211,79,180,43,137
"2011","Warwick 015B","E01031328","Total",885,241,22,219,272,121,191,33,158
"2011","Warwick 015C","E01031329","Total",985,215,37,178,385,171,205,61,144
"2011","Warwick 015D","E01031330","Total",599,154,15,139,184,71,115,20,95
"2011","Warwick 015E","E01031331","Total",751,202,3,199,228,79,183,24,159
"2011","Birmingham 001A","E01009417","Total",608,219,13,206,206,74,180,34,146
"2011","Birmingham 001B","E01009418","Total",645,257,29,228,202,73,179,36,143
"2011","Birmingham 001C","E01009419","Total",579,232,5,227,147,42,162,25,137
"2011","Birmingham 001D","E01009433","Total",746,270,10,260,199,69,201,24,177
"2011","Birmingham 002A","E01009415","Total",672,240,8,232,187,68,159,20,139
"2011","Birmingham 002B","E01009422","Total",864,337,11,326,210,74,198,22,176
"2011","Birmingham 002C","E01009423","Total",759,317,26,291,176,56,241,32,209
"2011","Birmingham 002D","E01009425","Total",846,416,17,399,166,47,251,20,231
"2011","Birmingham 003A","E01009416","Total",1008,200,23,177,440,193,149,41,108
"2011","Birmingham 003B","E01009420","Total",632,215,11,204,207,86,148,25,123
"2011","Birmingham 003C","E01009426","Total",607,241,4,237,168,44,155,23,132
"2011","Birmingham 003D","E01009429","Total",588,204,3,201,181,65,107,14,93
"2011","Birmingham 003E","E01009431","Total",611,212,10,202,206,66,147,23,124
"2011","Birmingham 004A","E01009421","Total",639,217,4,213,188,48,134,22,112
"2011","Birmingham 004B","E01009424","Total",689,198,8,190,177,64,153,27,126
"2011","Birmingham 004C","E01009427","Total",702,231,9,222,147,43,179,17,162
"2011","Birmingham 004D","E01009428","Total",650,235,7,228,177,64,121,12,109
"2011","Birmingham 004E","E01009430","Total",648,230,9,221,179,43,155,20,135
"2011","Birmingham 004F","E01009468","Total",626,239,2,237,159,32,153,21,132
"2011","Birmingham 005A","E01009445","Total",686,281,77,204,293,126,212,56,156
"2011","Birmingham 005B","E01009446","Total",1008,264,13,251,348,134,255,40,215
"2011","Birmingham 005C","E01009447","Total",629,198,20,178,221,78,178,29,149
"2011","Birmingham 005D","E01009448","Total",673,268,51,217,225,72,237,53,184
"2011","Birmingham 005E","E01009452","Total",682,237,26,211,208,81,187,35,152
"2011","Birmingham 005F","E01009455","Total",721,327,31,296,148,44,232,25,207
"2011","Birmingham 006A","E01009432","Total",642,251,54,197,211,79,166,32,134
"2011","Birmingham 006B","E01009435","Total",711,109,11,98,262,84,128,36,92
"2011","Birmingham 006C","E01009437","Total",806,303,13,290,209,65,199,24,175
"2011","Birmingham 006D","E01009444","Total",623,242,5,237,165,45,154,17,137
"2011","Birmingham 006E","E01009454","Total",655,143,7,136,201,59,121,33,88
"2011","Birmingham 007A","E01009221","Total",593,198,25,173,195,65,163,36,127
"2011","Birmingham 007B","E01009464","Total",530,167,10,157,158,40,133,26,107
"2011","Birmingham 007C","E01009465","Total",503,133,8,125,188,65,134,29,105
"2011","Birmingham 007D","E01009467","Total",662,232,17,215,180,57,180,26,154
"2011","Birmingham 008A","E01009220","Total",628,197,46,151,244,103,165,42,123
"2011","Birmingham 008B","E01009222","Total",604,236,73,163,248,109,197,67,130
"2011","Birmingham 008C","E01009224","Total",620,229,21,208,179,69,199,35,164
"2011","Birmingham 008D","E01009233","Total",628,245,72,173,239,109,194,53,141
"2011","Birmingham 009A","E01009449","Total",949,317,12,305,175,76,230,21,209
"2011","Birmingham 009B","E01009451","Total",652,179,14,165,192,83,165,36,129
"2011","Birmingham 009C","E01009453","Total",526,121,11,110,198,79,120,23,97
"2011","Birmingham 009D","E01009466","Total",668,193,6,187,191,63,156,29,127
"2011","Birmingham 009E","E01009471","Total",701,197,8,189,196,51,170,26,144
"2011","Birmingham 010A","E01009135","Total",597,202,12,190,139,57,180,28,152
"2011","Birmingham 010B","E01009469","Total",591,202,8,194,150,52,128,26,102
"2011","Birmingham 010C","E01009470","Total",532,162,5,157,152,56,119,17,102
"2011","Birmingham 010D","E01009472","Total",635,193,11,182,230,85,167,37,130
"2011","Birmingham 010E","E01009473","Total",682,212,23,189,209,84,178,33,145
"2011","Birmingham 010F","E01009474","Total",635,204,16,188,225,75,154,22,132
"2011","Birmingham 011A","E01009127","Total",586,260,96,164,256,118,173,48,125
"2011","Birmingham 011B","E01009128","Total",532,212,48,164,198,86,184,41,143
"2011","Birmingham 011C","E01009130","Total",608,270,71,199,219,104,211,47,164
"2011","Birmingham 011D","E01009131","Total",517,179,55,124,216,88,167,44,123
"2011","Birmingham 011E","E01009133","Total",610,284,72,212,219,92,229,62,167
"2011","Birmingham 011F","E01009134","Total",664,323,66,257,211,91,239,42,197
"2011","Birmingham 011G","E01009137","Total",581,218,81,137,258,117,183,56,127
"2011","Birmingham 012A","E01009434","Total",626,125,6,119,235,80,97,22,75
"2011","Birmingham 012B","E01009436","Total",539,159,3,156,166,48,116,19,97
"2011","Birmingham 012C","E01009438","Total",608,134,8,126,173,66,124,27,97
"2011","Birmingham 012D","E01009440","Total",630,225,8,217,166,57,187,26,161
"2011","Birmingham 012E","E01009450","Total",679,220,12,208,190,59,157,21,136
"2011","Birmingham 013A","E01009223","Total",676,220,22,198,192,77,185,30,155
"2011","Birmingham 013B","E01009225","Total",764,374,45,329,200,77,321,42,279
"2011","Birmingham 013C","E01009227","Total",693,195,15,180,198,81,179,36,143
"2011","Birmingham 013D","E01009228","Total",677,218,35,183,232,101,191,27,164
"2011","Birmingham 014A","E01009121","Total",926,365,81,284,362,155,286,75,211
"2011","Birmingham 014B","E01009122","Total",665,333,78,255,229,98,225,46,179
"2011","Birmingham 014C","E01009129","Total",581,261,91,170,260,115,188,53,135
"2011","Birmingham 014D","E01009132","Total",616,268,86,182,249,108,223,52,171
"2011","Birmingham 014E","E01009136","Total",798,421,52,369,169,77,337,34,303
"2011","Birmingham 015A","E01009457","Total",608,209,2,207,150,39,133,14,119
"2011","Birmingham 015B","E01009459","Total",665,189,6,183,195,85,132,24,108
"2011","Birmingham 015C","E01009461","Total",522,168,9,159,150,46,125,18,107
"2011","Birmingham 015D","E01009463","Total",619,226,3,223,146,42,161,26,135
"2011","Birmingham 016A","E01009235","Total",625,187,25,162,223,83,156,36,120
"2011","Birmingham 016B","E01009243","Total",626,209,24,185,194,84,182,27,155
"2011","Birmingham 016C","E01009245","Total",565,177,30,147,200,84,151,37,114
"2011","Birmingham 016D","E01009246","Total",637,191,14,177,199,72,167,26,141
"2011","Birmingham 016E","E01009247","Total",571,162,23,139,218,75,147,36,111
"2011","Birmingham 017A","E01009226","Total",663,216,41,175,206,100,173,38,135
"2011","Birmingham 017B","E01009229","Total",637,194,18,176,206,93,165,34,131
"2011","Birmingham 017C","E01009230","Total",655,213,24,189,202,77,186,34,152
"2011","Birmingham 017D","E01009231","Total",758,249,22,227,223,78,224,33,191
"2011","Birmingham 018A","E01009001","Total",694,234,28,206,192,92,205,28,177
"2011","Birmingham 018B","E01009003","Total",690,230,21,209,143,64,179,23,156
"2011","Birmingham 018C","E01009456","Total",660,178,15,163,229,75,147,28,119
"2011","Birmingham 018D","E01009458","Total",784,444,10,434,136,45,327,23,304
"2011","Birmingham 018E","E01009460","Total",833,251,16,235,173,85,201,21,180
"2011","Birmingham 018F","E01009462","Total",798,266,17,249,191,62,244,28,216
"2011","Birmingham 019A","E01009234","Total",623,152,36,116,244,100,134,30,104
"2011","Birmingham 019B","E01009236","Total",636,193,26,167,218,84,169,35,134
"2011","Birmingham 019C","E01009244","Total",620,189,22,167,219,99,163,29,134
"2011","Birmingham 019D","E01009248","Total",696,166,38,128,274,101,149,42,107
"2011","Birmingham 020A","E01009403","Total",615,244,70,174,232,97,201,49,152
"2011","Birmingham 020B","E01009404","Total",632,241,64,177,234,85,206,55,151
"2011","Birmingham 020C","E01009405","Total",604,227,33,194,179,78,187,27,160
"2011","Birmingham 020D","E01009406","Total",775,336,45,291,213,97,264,31,233
"2011","Birmingham 020E","E01009407","Total",733,292,66,226,228,99,212,46,166
"2011","Birmingham 021A","E01009439","Total",619,235,7,228,147,59,159,15,144
"2011","Birmingham 021B","E01009441","Total",639,195,15,180,152,53,208,25,183
"2011","Birmingham 021C","E01009442","Total",605,225,11,214,169,66,180,26,154
"2011","Birmingham 021D","E01009443","Total",536,133,7,126,154,63,94,14,80
"2011","Birmingham 022A","E01009123","Total",611,231,48,183,204,84,201,47,154
"2011","Birmingham 022B","E01009124","Total",639,328,164,164,324,165,182,63,119
"2011","Birmingham 022C","E01009125","Total",689,278,68,210,256,96,211,53,158
"2011","Birmingham 022D","E01009232","Total",606,180,19,161,206,82,152,29,123
"2011","Birmingham 023A","E01009002","Total",653,319,109,210,263,139,203,41,162
"2011","Birmingham 023C","E01009006","Total",763,186,33,153,175,90,172,24,148
"2011","Birmingham 023D","E01009007","Total",777,270,53,217,203,112,198,33,165
"2011","Birmingham 023F","E01033632","Total",1018,449,124,325,335,191,312,56,256
"2011","Birmingham 024A","E01009237","Total",604,240,35,205,220,83,187,38,149
"2011","Birmingham 024B","E01009238","Total",632,229,18,211,187,67,217,37,180
"2011","Birmingham 024C","E01009240","Total",610,170,32,138,219,95,144,30,114
"2011","Birmingham 024D","E01009241","Total",608,177,30,147,251,118,139,42,97
"2011","Birmingham 024E","E01009242","Total",605,195,36,159,231,93,143,42,101
"2011","Birmingham 025A","E01009005","Total",643,240,20,220,145,65,195,18,177
"2011","Birmingham 025B","E01009009","Total",637,218,24,194,176,73,172,25,147
"2011","Birmingham 025C","E01009098","Total",933,380,56,324,281,125,286,42,244
"2011","Birmingham 025D","E01009100","Total",839,305,58,247,291,120,260,54,206
"2011","Birmingham 025E","E01009105","Total",653,223,25,198,199,94,185,37,148
"2011","Birmingham 026A","E01009126","Total",542,153,22,131,191,69,146,46,100
"2011","Birmingham 026B","E01009408","Total",657,249,60,189,245,93,200,53,147
"2011","Birmingham 026C","E01009409","Total",724,268,43,225,194,109,204,32,172
"2011","Birmingham 026D","E01009410","Total",764,318,39,279,206,85,274,40,234
"2011","Birmingham 028A","E01009008","Total",603,196,19,177,168,65,170,28,142
"2011","Birmingham 028B","E01009011","Total",783,280,21,259,201,76,238,36,202
"2011","Birmingham 028C","E01009012","Total",590,164,25,139,187,68,146,30,116
"2011","Birmingham 028D","E01009102","Total",630,252,53,199,219,83,214,52,162
"2011","Birmingham 028E","E01009104","Total",646,277,73,204,251,125,210,51,159
"2011","Birmingham 029A","E01009096","Total",774,354,47,307,191,80,282,47,235
"2011","Birmingham 029B","E01009097","Total",792,366,106,260,320,119,259,60,199
"2011","Birmingham 029C","E01009099","Total",811,348,101,247,303,129,261,72,189
"2011","Birmingham 029D","E01009101","Total",626,279,60,219,245,85,241,58,183
"2011","Birmingham 029E","E01009103","Total",657,320,72,248,223,83,246,51,195
"2011","Birmingham 029F","E01009106","Total",587,227,26,201,161,50,196,37,159
"2011","Birmingham 030A","E01008915","Total",506,170,62,108,215,110,128,40,88
"2011","Birmingham 030B","E01009411","Total",871,201,42,159,247,137,189,40,149
"2011","Birmingham 030C","E01009412","Total",651,231,48,183,215,107,186,50,136
"2011","Birmingham 030D","E01009413","Total",655,204,44,160,216,99,163,45,118
"2011","Birmingham 030E","E01009414","Total",768,201,54,147,264,139,158,47,111
"2011","Birmingham 031A","E01008998","Total",639,228,81,147,272,124,204,64,140
"2011","Birmingham 031B","E01008999","Total",522,174,32,142,200,80,174,53,121
"2011","Birmingham 031C","E01009000","Total",794,286,41,245,189,87,237,52,185
"2011","Birmingham 031D","E01009013","Total",857,306,47,259,241,118,218,29,189
"2011","Birmingham 031E","E01009400","Total",525,202,41,161,184,78,145,41,104
"2011","Birmingham 031F","E01009401","Total",636,243,62,181,232,109,181,51,130
"2011","Birmingham 031H","E01033630","Total",595,179,43,136,146,78,117,28,89
"2011","Birmingham 031I","E01033646","Total",772,303,47,256,192,101,236,38,198
"2011","Birmingham 032A","E01009049","Total",570,197,33,164,215,89,178,48,130
"2011","Birmingham 032B","E01009056","Total",749,276,59,217,266,135,182,57,125
"2011","Birmingham 032C","E01009263","Total",650,230,38,192,208,72,182,40,142
"2011","Birmingham 032D","E01009264","Total",585,197,25,172,114,66,130,17,113
"2011","Birmingham 032E","E01009265","Total",572,167,27,140,207,94,167,46,121
"2011","Birmingham 033A","E01009051","Total",478,182,59,123,203,95,117,45,72
"2011","Birmingham 033B","E01009053","Total",435,178,77,101,217,110,121,43,78
"2011","Birmingham 033C","E01009054","Total",417,121,36,85,216,102,128,66,62
"2011","Birmingham 033D","E01009058","Total",465,164,62,102,249,130,126,53,73
"2011","Birmingham 033E","E01009061","Total",432,144,64,80,252,120,126,69,57
"2011","Birmingham 033F","E01009239","Total",495,218,27,191,120,49,135,23,112
"2011","Birmingham 034A","E01009266","Total",615,186,46,140,242,93,142,35,107
"2011","Birmingham 034B","E01009269","Total",544,195,66,129,241,120,130,47,83
"2011","Birmingham 034C","E01009270","Total",646,245,90,155,288,132,194,63,131
"2011","Birmingham 034D","E01009271","Total",535,208,65,143,238,105,138,45,93
"2011","Birmingham 034E","E01009273","Total",512,200,50,150,202,78,177,57,120
"2011","Birmingham 035A","E01009050","Total",652,246,67,179,256,118,176,47,129
"2011","Birmingham 035D","E01009057","Total",647,277,97,180,292,151,185,72,113
"2011","Birmingham 035E","E01009059","Total",569,245,72,173,249,123,169,61,108
"2011","Birmingham 035F","E01009060","Total",426,143,51,92,215,124,117,66,51
"2011","Birmingham 035G","E01033621","Total",866,330,104,226,373,169,237,89,148
"2011","Birmingham 036A","E01009268","Total",432,112,18,94,190,70,136,44,92
"2011","Birmingham 036B","E01009272","Total",487,178,65,113,241,85,132,52,80
"2011","Birmingham 036C","E01009274","Total",739,275,81,194,311,133,195,60,135
"2011","Birmingham 036D","E01009349","Total",595,228,89,139,282,134,176,60,116
"2011","Birmingham 036E","E01009351","Total",564,207,80,127,275,127,154,50,104
"2011","Birmingham 036F","E01009354","Total",520,213,58,155,201,83,181,46,135
"2011","Birmingham 037A","E01008899","Total",478,242,73,169,183,92,164,42,122
"2011","Birmingham 037C","E01008901","Total",573,259,80,179,230,104,207,69,138
"2011","Birmingham 037E","E01008916","Total",454,189,76,113,251,140,132,58,74
"2011","Birmingham 037F","E01033636","Total",845,330,129,201,478,249,275,123,152
"2011","Birmingham 038A","E01009079","Total",719,367,113,254,264,135,193,50,143
"2011","Birmingham 038B","E01009080","Total",412,172,91,81,212,91,117,44,73
"2011","Birmingham 038C","E01009081","Total",558,262,72,190,200,94,199,35,164
"2011","Birmingham 038D","E01009083","Total",559,269,99,170,242,121,171,32,139
"2011","Birmingham 039A","E01009275","Total",476,170,52,118,219,91,137,44,93
"2011","Birmingham 039B","E01009350","Total",454,170,77,93,239,105,137,65,72
"2011","Birmingham 039C","E01009352","Total",465,177,58,119,221,92,149,63,86
"2011","Birmingham 039D","E01009353","Total",460,173,55,118,203,105,116,50,66
"2011","Birmingham 039E","E01009355","Total",522,209,66,143,204,93,154,56,98
"2011","Birmingham 039H","E01033635","Total",947,329,110,219,448,186,276,100,176
"2011","Birmingham 040A","E01008905","Total",421,132,57,75,250,135,136,70,66
"2011","Birmingham 040B","E01008907","Total",560,257,64,193,225,110,192,62,130
"2011","Birmingham 040C","E01009047","Total",552,241,64,177,234,113,171,53,118
"2011","Birmingham 040D","E01009048","Total",567,223,39,184,215,96,160,54,106
"2011","Birmingham 040E","E01009062","Total",476,180,78,102,268,118,132,59,73
"2011","Birmingham 041D","E01008909","Total",472,157,69,88,280,132,152,74,78
"2011","Birmingham 041F","E01033628","Total",754,313,87,226,350,197,279,95,184
"2011","Birmingham 041G","E01033637","Total",850,362,121,241,401,199,305,109,196
"2011","Birmingham 042A","E01009084","Total",515,184,46,138,261,104,161,57,104
"2011","Birmingham 042B","E01009085","Total",505,141,39,102,265,112,144,67,77
"2011","Birmingham 042C","E01009087","Total",582,214,26,188,182,88,160,28,132
"2011","Birmingham 042D","E01009089","Total",495,161,30,131,218,95,146,56,90
"2011","Birmingham 042E","E01009090","Total",540,170,35,135,226,106,180,58,122
"2011","Birmingham 043A","E01009201","Total",695,346,88,258,229,103,251,60,191
"2011","Birmingham 043B","E01009202","Total",593,247,84,163,246,114,169,46,123
"2011","Birmingham 043C","E01009203","Total",1145,622,268,354,547,300,327,83,244
"2011","Birmingham 044A","E01009082","Total",500,191,45,146,217,78,157,50,107
"2011","Birmingham 044B","E01009086","Total",605,181,39,142,254,124,168,56,112
"2011","Birmingham 044C","E01009480","Total",583,233,90,143,275,146,159,54,105
"2011","Birmingham 044D","E01009481","Total",696,238,65,173,343,176,184,69,115
"2011","Birmingham 044E","E01009486","Total",587,184,58,126,300,162,151,57,94
"2011","Birmingham 044F","E01009487","Total",604,202,67,135,331,175,182,71,111
"2011","Birmingham 045A","E01009088","Total",711,337,31,306,178,78,249,32,217
"2011","Birmingham 045B","E01009091","Total",663,256,42,214,207,96,210,41,169
"2011","Birmingham 045C","E01009305","Total",753,345,88,257,261,122,248,49,199
"2011","Birmingham 045D","E01009307","Total",759,412,81,331,209,90,290,39,251
"2011","Birmingham 045E","E01009309","Total",657,332,79,253,201,80,259,53,206
"2011","Birmingham 046A","E01009304","Total",836,379,67,312,260,119,287,57,230
"2011","Birmingham 046B","E01009306","Total",684,322,67,255,210,71,253,54,199
"2011","Birmingham 046C","E01009308","Total",805,372,104,268,328,156,282,61,221
"2011","Birmingham 046D","E01009310","Total",803,362,95,267,286,113,284,56,228
"2011","Birmingham 047A","E01009348","Total",801,265,69,196,286,133,206,56,150
"2011","Birmingham 047B","E01009358","Total",691,289,59,230,262,128,206,53,153
"2011","Birmingham 047C","E01009359","Total",710,300,103,197,297,134,189,59,130
"2011","Birmingham 047D","E01009360","Total",920,313,119,194,399,175,217,76,141
"2011","Birmingham 047E","E01009361","Total",827,380,144,236,372,199,259,82,177
"2011","Birmingham 048A","E01009478","Total",655,293,103,190,280,149,216,75,141
"2011","Birmingham 048B","E01009479","Total",607,287,113,174,313,162,220,76,144
"2011","Birmingham 048C","E01009482","Total",472,189,75,114,253,141,147,61,86
"2011","Birmingham 048D","E01009484","Total",515,236,96,140,258,133,166,70,96
"2011","Birmingham 048E","E01009485","Total",488,200,76,124,272,135,144,72,72
"2011","Birmingham 049A","E01008906","Total",476,191,94,97,286,150,152,75,77
"2011","Birmingham 049B","E01008911","Total",596,292,153,139,304,147,138,52,86
"2011","Birmingham 049D","E01009347","Total",755,355,109,246,265,126,206,47,159
"2011","Birmingham 049E","E01033559","Total",769,132,8,124,59,38,77,8,69
"2011","Birmingham 049F","E01033638","Total",668,345,118,227,280,152,198,49,149
"2011","Birmingham 050A","E01008910","Total",661,320,128,192,310,154,204,76,128
"2011","Birmingham 050B","E01008913","Total",681,340,67,273,238,104,205,49,156
"2011","Birmingham 050C","E01008914","Total",895,391,131,260,304,180,182,58,124
"2011","Birmingham 050E","E01033561","Total",492,255,53,202,114,60,104,16,88
"2011","Birmingham 050F","E01033617","Total",407,227,8,219,20,19,31,3,28
"2011","Birmingham 051A","E01009194","Total",679,250,107,143,398,192,213,100,113
"2011","Birmingham 051B","E01009483","Total",504,212,82,130,279,135,152,65,87
"2011","Birmingham 051C","E01009488","Total",688,333,131,202,332,169,214,65,149
"2011","Birmingham 051D","E01009489","Total",526,212,96,116,321,177,147,72,75
"2011","Birmingham 051E","E01009491","Total",470,191,81,110,239,127,165,75,90
"2011","Birmingham 052B","E01009192","Total",614,181,77,104,384,192,180,92,88
"2011","Birmingham 052D","E01009199","Total",577,186,54,132,223,126,114,37,77
"2011","Birmingham 052E","E01009204","Total",706,334,120,214,303,145,229,62,167
"2011","Birmingham 052F","E01033644","Total",810,334,178,156,464,230,238,113,125
"2011","Birmingham 053A","E01009151","Total",614,193,86,107,321,158,151,55,96
"2011","Birmingham 053B","E01009152","Total",624,224,54,170,251,119,185,54,131
"2011","Birmingham 053C","E01009153","Total",850,313,78,235,266,122,214,58,156
"2011","Birmingham 053D","E01009345","Total",527,231,108,123,272,128,144,59,85
"2011","Birmingham 053E","E01009346","Total",540,197,103,94,281,140,143,66,77
"2011","Birmingham 054A","E01009092","Total",632,273,109,164,308,136,188,61,127
"2011","Birmingham 054B","E01009093","Total",648,276,105,171,280,137,214,57,157
"2011","Birmingham 054C","E01009094","Total",532,215,77,138,223,113,165,56,109
"2011","Birmingham 054D","E01009298","Total",577,214,97,117,287,132,161,61,100
"2011","Birmingham 054E","E01009311","Total",583,201,86,115,285,121,173,66,107
"2011","Birmingham 054F","E01009511","Total",507,227,70,157,213,85,185,51,134
"2011","Birmingham 055A","E01009475","Total",589,251,110,141,318,158,173,65,108
"2011","Birmingham 055B","E01009476","Total",570,247,68,179,275,143,196,63,133
"2011","Birmingham 055C","E01009477","Total",573,242,79,163,261,126,173,64,109
"2011","Birmingham 055D","E01009490","Total",669,309,100,209,282,146,210,63,147
"2011","Birmingham 055E","E01009492","Total",542,217,80,137,262,136,182,68,114
"2011","Birmingham 056A","E01009095","Total",637,234,48,186,247,113,189,42,147
"2011","Birmingham 056B","E01009507","Total",606,283,51,232,195,111,210,43,167
"2011","Birmingham 056C","E01009508","Total",597,200,33,167,186,82,173,38,135
"2011","Birmingham 056D","E01009509","Total",634,226,50,176,239,118,173,40,133
"2011","Birmingham 056E","E01009510","Total",670,383,65,318,197,89,250,45,205
"2011","Birmingham 057A","E01009297","Total",727,311,41,270,188,76,274,48,226
"2011","Birmingham 057B","E01009299","Total",646,276,74,202,247,112,215,56,159
"2011","Birmingham 057C","E01009300","Total",713,313,117,196,292,129,213,55,158
"2011","Birmingham 057D","E01009301","Total",806,415,78,337,214,107,276,41,235
"2011","Birmingham 057E","E01009303","Total",723,313,52,261,194,108,242,40,202
"2011","Birmingham 058A","E01009195","Total",678,254,113,141,396,192,195,88,107
"2011","Birmingham 058C","E01009197","Total",452,148,63,85,275,137,120,66,54
"2011","Birmingham 058D","E01009198","Total",449,168,91,77,290,168,117,64,53
"2011","Birmingham 058E","E01033647","Total",403,140,56,84,229,133,98,45,53
"2011","Birmingham 058F","E01033649","Total",465,147,66,81,291,165,118,58,60
"2011","Birmingham 060A","E01009138","Total",547,146,42,104,216,97,130,44,86
"2011","Birmingham 060B","E01009139","Total",576,140,27,113,201,99,132,39,93
"2011","Birmingham 060C","E01009140","Total",732,236,31,205,195,79,171,37,134
"2011","Birmingham 060D","E01009145","Total",719,166,39,127,261,123,151,59,92
"2011","Birmingham 060E","E01009147","Total",657,197,26,171,142,77,131,26,105
"2011","Birmingham 062A","E01009512","Total",610,214,51,163,245,102,187,56,131
"2011","Birmingham 062B","E01009514","Total",594,271,74,197,208,88,221,57,164
"2011","Birmingham 062C","E01009516","Total",531,199,38,161,197,92,171,39,132
"2011","Birmingham 062D","E01009517","Total",665,235,48,187,260,98,222,60,162
"2011","Birmingham 063A","E01009325","Total",493,199,88,111,283,133,144,67,77
"2011","Birmingham 063D","E01009342","Total",438,122,38,84,233,102,127,47,80
"2011","Birmingham 063E","E01009343","Total",525,217,82,135,254,137,158,51,107
"2011","Birmingham 063F","E01033642","Total",820,312,130,182,478,234,260,117,143
"2011","Birmingham 064A","E01008986","Total",859,256,45,211,183,96,134,27,107
"2011","Birmingham 064B","E01008987","Total",637,253,30,223,107,37,182,21,161
"2011","Birmingham 064C","E01008988","Total",975,245,31,214,165,75,171,29,142
"2011","Birmingham 064D","E01008989","Total",930,338,35,303,146,67,206,24,182
"2011","Birmingham 064E","E01008990","Total",468,124,8,116,104,48,86,8,78
"2011","Birmingham 064F","E01008991","Total",581,184,3,181,170,78,119,20,99
"2011","Birmingham 066A","E01008882","Total",687,304,74,230,272,134,234,48,186
"2011","Birmingham 066B","E01008896","Total",564,232,83,149,247,124,164,56,108
"2011","Birmingham 066C","E01008898","Total",563,210,69,141,276,128,182,60,122
"2011","Birmingham 066D","E01009326","Total",560,198,71,127,276,145,157,60,97
"2011","Birmingham 066E","E01009341","Total",544,243,82,161,247,139,165,47,118
"2011","Birmingham 066F","E01009513","Total",616,242,61,181,258,124,195,61,134
"2011","Birmingham 067A","E01008881","Total",619,259,38,221,202,91,211,39,172
"2011","Birmingham 067B","E01008897","Total",602,215,37,178,230,97,207,55,152
"2011","Birmingham 067C","E01009515","Total",637,261,25,236,165,66,203,26,177
"2011","Birmingham 067D","E01009518","Total",697,264,21,243,176,69,210,34,176
"2011","Birmingham 067E","E01009521","Total",613,152,18,134,207,79,149,30,119
"2011","Birmingham 069A","E01009302","Total",635,252,26,226,152,55,186,22,164
"2011","Birmingham 069B","E01009314","Total",661,296,46,250,197,66,236,42,194
"2011","Birmingham 069C","E01009321","Total",791,420,107,313,290,136,327,70,257
"2011","Birmingham 069D","E01009322","Total",603,281,66,215,205,86,201,38,163
"2011","Birmingham 069E","E01009323","Total",569,240,49,191,205,81,205,54,151
"2011","Birmingham 070A","E01009329","Total",645,243,81,162,314,148,223,84,139
"2011","Birmingham 070B","E01009334","Total",425,130,38,92,242,109,165,80,85
"2011","Birmingham 070C","E01009337","Total",479,162,70,92,256,135,125,54,71
"2011","Birmingham 070D","E01009338","Total",408,141,57,84,226,124,107,55,52
"2011","Birmingham 070E","E01009380","Total",465,184,84,100,266,151,136,62,74
"2011","Birmingham 071A","E01009362","Total",516,277,88,189,195,98,137,42,95
"2011","Birmingham 071B","E01009363","Total",547,216,56,160,209,106,187,54,133
"2011","Birmingham 071C","E01009364","Total",515,250,100,150,228,120,156,58,98
"2011","Birmingham 071D","E01009365","Total",554,278,79,199,202,106,199,63,136
"2011","Birmingham 071E","E01009379","Total",686,394,62,332,194,94,313,53,260
"2011","Birmingham 072A","E01009312","Total",614,218,18,200,195,60,177,29,148
"2011","Birmingham 072B","E01009324","Total",727,274,25,249,199,78,224,31,193
"2011","Birmingham 072C","E01009519","Total",606,188,15,173,190,71,157,31,126
"2011","Birmingham 072D","E01009520","Total",717,224,12,212,217,71,186,39,147
"2011","Birmingham 073A","E01009066","Total",601,173,4,169,179,54,134,21,113
"2011","Birmingham 073B","E01009070","Total",687,200,12,188,197,88,157,21,136
"2011","Birmingham 073C","E01009252","Total",621,145,15,130,166,67,126,21,105
"2011","Birmingham 073D","E01009260","Total",640,247,6,241,150,54,171,22,149
"2011","Birmingham 073E","E01009261","Total",667,211,16,195,187,84,178,29,149
"2011","Birmingham 074A","E01008984","Total",754,380,45,335,160,93,236,34,202
"2011","Birmingham 074B","E01008994","Total",673,225,21,204,134,61,145,19,126
"2011","Birmingham 074C","E01008996","Total",599,291,75,216,227,108,195,44,151
"2011","Birmingham 074D","E01008997","Total",599,213,30,183,169,51,156,31,125
"2011","Birmingham 075A","E01009065","Total",661,151,7,144,209,99,117,23,94
"2011","Birmingham 075B","E01009067","Total",677,177,2,175,167,72,144,16,128
"2011","Birmingham 075C","E01009068","Total",714,182,15,167,139,46,136,16,120
"2011","Birmingham 075D","E01009069","Total",823,205,11,194,124,60,154,8,146
"2011","Birmingham 075E","E01009072","Total",802,221,13,208,147,66,190,13,177
"2011","Birmingham 076A","E01008885","Total",504,141,20,121,178,66,135,27,108
"2011","Birmingham 076B","E01008886","Total",714,259,24,235,199,107,212,27,185
"2011","Birmingham 076C","E01008888","Total",639,151,19,132,233,93,133,27,106
"2011","Birmingham 076D","E01009313","Total",630,224,34,190,206,72,184,31,153
"2011","Birmingham 077A","E01009368","Total",417,187,55,132,184,102,147,49,98
"2011","Birmingham 077D","E01009371","Total",478,187,87,100,275,121,131,68,63
"2011","Birmingham 077E","E01009397","Total",450,169,87,82,256,116,136,58,78
"2011","Birmingham 077F","E01033650","Total",671,253,98,155,366,190,218,89,129
"2011","Birmingham 078A","E01008883","Total",651,244,65,179,270,135,206,65,141
"2011","Birmingham 078B","E01008884","Total",682,250,87,163,310,166,185,55,130
"2011","Birmingham 078C","E01008887","Total",626,223,62,161,224,120,161,45,116
"2011","Birmingham 078D","E01008889","Total",659,229,39,190,208,99,176,36,140
"2011","Birmingham 079A","E01008982","Total",667,177,19,158,119,65,116,20,96
"2011","Birmingham 079C","E01008992","Total",482,139,7,132,123,49,95,18,77
"2011","Birmingham 079E","E01009283","Total",593,150,17,133,166,71,111,24,87
"2011","Birmingham 079F","E01033631","Total",836,221,16,205,189,78,141,27,114
"2011","Birmingham 080A","E01009249","Total",629,212,39,173,212,77,173,35,138
"2011","Birmingham 080B","E01009250","Total",689,238,42,196,198,84,202,41,161
"2011","Birmingham 080C","E01009251","Total",627,188,10,178,176,73,148,21,127
"2011","Birmingham 080D","E01009253","Total",624,205,38,167,205,68,150,31,119
"2011","Birmingham 080E","E01009255","Total",633,233,48,185,238,95,180,45,135
"2011","Birmingham 080F","E01009257","Total",596,241,67,174,228,108,179,39,140
"2011","Birmingham 081A","E01009315","Total",783,355,25,330,148,67,250,22,228
"2011","Birmingham 081B","E01009316","Total",683,215,27,188,209,75,198,43,155
"2011","Birmingham 081C","E01009317","Total",760,325,72,253,237,109,230,44,186
"2011","Birmingham 081D","E01009318","Total",627,172,19,153,186,81,135,22,113
"2011","Birmingham 081E","E01009319","Total",653,171,9,162,195,67,141,27,114
"2011","Birmingham 081F","E01009320","Total",609,204,31,173,181,72,160,29,131
"2011","Birmingham 082A","E01009372","Total",420,140,81,59,263,143,123,70,53
"2011","Birmingham 082B","E01009373","Total",466,187,83,104,276,142,168,78,90
"2011","Birmingham 082D","E01009396","Total",478,141,49,92,259,131,151,73,78
"2011","Birmingham 082F","E01033643","Total",814,315,138,177,456,235,246,113,133
"2011","Birmingham 083A","E01009367","Total",490,204,68,136,213,103,133,48,85
"2011","Birmingham 083B","E01009375","Total",522,206,83,123,292,139,153,67,86
"2011","Birmingham 083C","E01009377","Total",452,235,99,136,212,123,154,56,98
"2011","Birmingham 083D","E01009383","Total",418,133,36,97,162,66,124,52,72
"2011","Birmingham 083E","E01009399","Total",416,161,83,78,247,126,117,68,49
"2011","Birmingham 084A","E01009366","Total",517,206,71,135,238,114,155,58,97
"2011","Birmingham 084B","E01009374","Total",423,198,47,151,152,75,166,40,126
"2011","Birmingham 084C","E01009376","Total",564,234,74,160,231,107,177,65,112
"2011","Birmingham 084F","E01033648","Total",826,311,100,211,367,184,249,89,160
"2011","Birmingham 085A","E01009073","Total",657,345,172,173,341,184,168,55,113
"2011","Birmingham 085B","E01009074","Total",667,263,86,177,266,110,199,69,130
"2011","Birmingham 085C","E01009254","Total",669,255,33,222,188,80,198,29,169
"2011","Birmingham 085D","E01009256","Total",663,243,51,192,219,104,183,35,148
"2011","Birmingham 085E","E01009258","Total",661,308,89,219,236,102,226,48,178
"2011","Birmingham 087B","E01009071","Total",789,346,27,319,155,65,215,19,196
"2011","Birmingham 087C","E01009075","Total",829,418,44,374,128,66,253,14,239
"2011","Birmingham 087E","E01009078","Total",626,241,22,219,129,52,152,19,133
"2011","Birmingham 087F","E01033562","Total",1045,453,53,400,230,106,261,28,233
"2011","Birmingham 088C","E01009183","Total",572,117,12,105,186,75,106,28,78
"2011","Birmingham 088D","E01009186","Total",760,230,24,206,194,85,173,31,142
"2011","Birmingham 088E","E01033645","Total",863,286,114,172,440,201,271,125,146
"2011","Birmingham 089A","E01008890","Total",705,199,35,164,221,100,186,37,149
"2011","Birmingham 089B","E01008891","Total",689,223,26,197,199,80,199,40,159
"2011","Birmingham 089C","E01008892","Total",518,161,58,103,228,104,147,60,87
"2011","Birmingham 089D","E01008893","Total",725,199,29,170,213,107,185,35,150
"2011","Birmingham 089E","E01008894","Total",658,277,17,260,116,51,211,17,194
"2011","Birmingham 089F","E01008895","Total",771,174,32,142,252,129,152,37,115
"2011","Birmingham 089G","E01009015","Total",786,272,33,239,213,103,239,34,205
"2011","Birmingham 090A","E01009014","Total",657,198,64,134,303,141,196,68,128
"2011","Birmingham 090B","E01009018","Total",697,265,34,231,175,75,187,26,161
"2011","Birmingham 090C","E01009026","Total",581,235,107,128,276,158,175,59,116
"2011","Birmingham 090D","E01009028","Total",622,239,71,168,276,152,191,62,129
"2011","Birmingham 090E","E01009029","Total",528,183,67,116,237,125,150,43,107
"2011","Birmingham 092A","E01009182","Total",666,247,38,209,154,69,198,34,164
"2011","Birmingham 092B","E01009184","Total",724,206,18,188,142,65,185,28,157
"2011","Birmingham 092C","E01009187","Total",686,233,15,218,159,56,176,22,154
"2011","Birmingham 092D","E01009188","Total",665,206,13,193,181,60,176,27,149
"2011","Birmingham 092E","E01009384","Total",725,304,43,261,131,65,222,20,202
"2011","Birmingham 092F","E01009385","Total",615,195,22,173,94,48,148,21,127
"2011","Birmingham 093A","E01009185","Total",736,203,6,197,135,51,194,22,172
"2011","Birmingham 093B","E01009389","Total",474,150,21,129,193,71,158,67,91
"2011","Birmingham 093C","E01009390","Total",659,219,36,183,149,73,172,37,135
"2011","Birmingham 093D","E01009394","Total",755,199,19,180,158,85,142,31,111
"2011","Birmingham 094A","E01008918","Total",753,365,68,297,241,127,256,46,210
"2011","Birmingham 094B","E01008920","Total",556,174,31,143,189,79,140,35,105
"2011","Birmingham 094C","E01008921","Total",630,238,51,187,172,55,186,39,147
"2011","Birmingham 094D","E01008931","Total",647,285,66,219,223,98,217,50,167
"2011","Birmingham 094E","E01009259","Total",670,329,105,224,256,109,224,66,158
"2011","Birmingham 095A","E01008919","Total",704,288,56,232,216,98,206,41,165
"2011","Birmingham 095B","E01009064","Total",600,217,55,162,206,86,164,38,126
"2011","Birmingham 095C","E01009077","Total",718,266,48,218,204,88,190,37,153
"2011","Birmingham 095D","E01009291","Total",624,227,65,162,227,110,173,46,127
"2011","Birmingham 095E","E01009500","Total",637,301,87,214,219,86,208,51,157
"2011","Birmingham 096A","E01009284","Total",664,276,35,241,108,51,134,20,114
"2011","Birmingham 096C","E01009286","Total",504,180,17,163,47,25,71,9,62
"2011","Birmingham 096E","E01009289","Total",561,217,13,204,52,27,89,8,81
"2011","Birmingham 096F","E01009290","Total",465,165,7,158,30,16,57,3,54
"2011","Birmingham 096G","E01033634","Total",800,342,37,305,80,42,112,15,97
"2011","Birmingham 097A","E01009017","Total",491,155,32,123,215,100,137,41,96
"2011","Birmingham 097B","E01009043","Total",652,241,56,185,258,100,217,61,156
"2011","Birmingham 097C","E01009044","Total",463,133,35,98,220,107,124,43,81
"2011","Birmingham 097D","E01009045","Total",598,241,49,192,228,92,207,52,155
"2011","Birmingham 097E","E01009046","Total",610,213,18,195,213,82,195,50,145
"2011","Birmingham 097F","E01009395","Total",566,196,35,161,200,100,162,45,117
"2011","Birmingham 098A","E01009016","Total",732,379,32,347,174,65,314,33,281
"2011","Birmingham 098B","E01009022","Total",612,198,55,143,254,101,185,52,133
"2011","Birmingham 098C","E01009023","Total",572,157,27,130,238,105,140,40,100
"2011","Birmingham 098D","E01009030","Total",480,149,19,130,182,65,164,48,116
"2011","Birmingham 099A","E01009281","Total",660,285,16,269,154,54,223,24,199
"2011","Birmingham 099B","E01009292","Total",666,163,20,143,183,92,129,20,109
"2011","Birmingham 099C","E01009294","Total",809,305,73,232,238,133,214,45,169
"2011","Birmingham 099D","E01009295","Total",677,297,18,279,133,58,195,24,171
"2011","Birmingham 100A","E01009280","Total",571,164,16,148,154,60,137,23,114
"2011","Birmingham 100B","E01009282","Total",639,200,29,171,162,71,143,29,114
"2011","Birmingham 100C","E01009288","Total",437,157,7,150,90,38,108,13,95
"2011","Birmingham 100D","E01009293","Total",601,199,25,174,137,64,138,23,115
"2011","Birmingham 100E","E01009296","Total",581,176,31,145,132,55,123,26,97
"2011","Birmingham 101A","E01008924","Total",623,235,23,212,163,61,180,28,152
"2011","Birmingham 101B","E01009501","Total",629,251,81,170,242,111,196,52,144
"2011","Birmingham 101C","E01009502","Total",648,285,57,228,214,97,238,49,189
"2011","Birmingham 101D","E01009503","Total",615,236,62,174,225,90,186,43,143
"2011","Birmingham 101E","E01009505","Total",690,317,72,245,226,88,237,53,184
"2011","Birmingham 102A","E01008917","Total",523,142,18,124,174,74,138,34,104
"2011","Birmingham 102B","E01008923","Total",637,313,66,247,197,92,219,30,189
"2011","Birmingham 102C","E01008925","Total",515,129,15,114,160,43,100,24,76
"2011","Birmingham 102D","E01008927","Total",644,275,61,214,194,80,203,40,163
"2011","Birmingham 102E","E01008928","Total",684,326,64,262,210,81,258,56,202
"2011","Birmingham 103A","E01009019","Total",612,233,66,167,248,118,203,51,152
"2011","Birmingham 103B","E01009020","Total",557,209,46,163,203,66,184,46,138
"2011","Birmingham 103C","E01009021","Total",654,245,78,167,278,120,199,60,139
"2011","Birmingham 103D","E01009024","Total",606,227,65,162,240,114,168,40,128
"2011","Birmingham 103E","E01009025","Total",584,216,47,169,235,82,204,57,147
"2011","Birmingham 103F","E01009033","Total",677,257,72,185,259,123,189,54,135
"2011","Birmingham 104A","E01009175","Total",593,127,21,106,178,60,124,23,101
"2011","Birmingham 104B","E01009177","Total",647,149,17,132,203,113,146,37,109
"2011","Birmingham 104C","E01009178","Total",707,205,29,176,208,105,173,29,144
"2011","Birmingham 104D","E01009179","Total",651,193,16,177,194,56,193,40,153
"2011","Birmingham 104E","E01009189","Total",605,154,20,134,197,97,138,27,111
"2011","Birmingham 105A","E01008933","Total",549,174,44,130,212,92,147,51,96
"2011","Birmingham 105B","E01008934","Total",547,194,14,180,160,58,131,23,108
"2011","Birmingham 105C","E01009031","Total",601,194,17,177,200,74,169,28,141
"2011","Birmingham 105D","E01009037","Total",700,275,14,261,168,67,225,32,193
"2011","Birmingham 105E","E01009176","Total",670,245,31,214,192,80,204,34,170
"2011","Birmingham 106C","E01008929","Total",676,329,67,262,213,93,263,50,213
"2011","Birmingham 106D","E01008930","Total",605,181,56,125,227,102,155,43,112
"2011","Birmingham 106E","E01009495","Total",501,237,81,156,187,91,157,49,108
"2011","Birmingham 106F","E01033629","Total",1071,506,105,401,349,138,352,67,285
"2011","Birmingham 107A","E01008953","Total",638,198,48,150,219,102,171,33,138
"2011","Birmingham 107B","E01008963","Total",572,161,27,134,181,81,155,40,115
"2011","Birmingham 107C","E01008964","Total",634,257,36,221,174,77,238,33,205
"2011","Birmingham 107D","E01008965","Total",587,134,11,123,187,77,134,23,111
"2011","Birmingham 107E","E01008966","Total",688,283,66,217,246,100,225,49,176
"2011","Birmingham 108A","E01009032","Total",587,165,18,147,226,93,150,42,108
"2011","Birmingham 108B","E01009034","Total",533,149,23,126,205,75,158,53,105
"2011","Birmingham 108C","E01009035","Total",637,178,36,142,244,111,173,54,119
"2011","Birmingham 108D","E01009036","Total",540,167,19,148,182,65,127,25,102
"2011","Birmingham 109A","E01009494","Total",629,326,123,203,286,131,231,69,162
"2011","Birmingham 109B","E01009496","Total",627,250,17,233,150,62,198,30,168
"2011","Birmingham 109C","E01009497","Total",728,242,48,194,255,111,189,40,149
"2011","Birmingham 109D","E01009504","Total",619,267,24,243,171,76,186,32,154
"2011","Birmingham 109E","E01009506","Total",635,238,16,222,163,58,169,30,139
"2011","Birmingham 110A","E01008967","Total",665,231,12,219,198,64,173,28,145
"2011","Birmingham 110B","E01008968","Total",697,252,12,240,219,75,192,38,154
"2011","Birmingham 110C","E01008970","Total",621,239,66,173,252,108,167,53,114
"2011","Birmingham 110D","E01008981","Total",587,194,8,186,183,60,179,33,146
"2011","Birmingham 111A","E01008932","Total",670,275,53,222,197,82,227,46,181
"2011","Birmingham 111B","E01008935","Total",675,298,75,223,230,101,238,55,183
"2011","Birmingham 111C","E01008936","Total",643,279,37,242,197,74,211,32,179
"2011","Birmingham 111D","E01008938","Total",588,219,71,148,229,107,169,51,118
"2011","Birmingham 111E","E01008939","Total",673,251,51,200,214,95,215,44,171
"2011","Birmingham 112A","E01008951","Total",574,177,14,163,208,69,171,39,132
"2011","Birmingham 112B","E01008952","Total",761,166,30,136,181,76,144,28,116
"2011","Birmingham 112C","E01008955","Total",666,167,13,154,174,71,135,24,111
"2011","Birmingham 112D","E01008956","Total",577,181,15,166,209,76,171,33,138
"2011","Birmingham 112E","E01008957","Total",708,177,34,143,205,89,179,36,143
"2011","Birmingham 113A","E01008950","Total",718,373,20,353,140,47,246,18,228
"2011","Birmingham 113B","E01008954","Total",585,257,20,237,141,43,162,20,142
"2011","Birmingham 113C","E01008958","Total",787,419,45,374,172,55,317,37,280
"2011","Birmingham 113D","E01009493","Total",792,373,75,298,198,123,245,28,217
"2011","Birmingham 115A","E01008937","Total",607,259,38,221,175,69,222,46,176
"2011","Birmingham 115B","E01008940","Total",594,247,70,177,214,91,184,57,127
"2011","Birmingham 115C","E01008941","Total",585,247,70,177,219,102,201,60,141
"2011","Birmingham 115D","E01008944","Total",733,281,60,221,236,119,205,43,162
"2011","Birmingham 116A","E01008959","Total",790,314,32,282,223,70,238,38,200
"2011","Birmingham 116B","E01008960","Total",625,135,8,127,237,83,155,32,123
"2011","Birmingham 116C","E01008961","Total",738,226,14,212,154,58,190,24,166
"2011","Birmingham 116D","E01008962","Total",818,354,131,223,303,152,236,68,168
"2011","Birmingham 117A","E01008942","Total",618,214,54,160,250,104,194,48,146
"2011","Birmingham 117B","E01008943","Total",562,183,47,136,199,78,176,59,117
"2011","Birmingham 117C","E01008969","Total",697,203,15,188,211,104,174,23,151
"2011","Birmingham 117D","E01008971","Total",716,226,40,186,231,93,172,43,129
"2011","Birmingham 118A","E01008972","Total",741,294,69,225,273,108,253,61,192
"2011","Birmingham 118B","E01008973","Total",848,247,34,213,256,99,252,58,194
"2011","Birmingham 118C","E01008974","Total",1153,270,67,203,442,225,212,64,148
"2011","Birmingham 118D","E01008975","Total",669,229,9,220,176,64,186,25,161
"2011","Birmingham 119A","E01009172","Total",548,200,54,146,208,87,171,49,122
"2011","Birmingham 119B","E01009173","Total",656,258,79,179,263,102,208,55,153
"2011","Birmingham 119C","E01009174","Total",533,202,51,151,190,86,157,39,118
"2011","Birmingham 119D","E01009498","Total",688,297,95,202,257,109,207,48,159
"2011","Birmingham 119E","E01009499","Total",673,229,53,176,268,91,190,56,134
"2011","Birmingham 120A","E01009205","Total",615,182,13,169,186,56,161,32,129
"2011","Birmingham 120B","E01009206","Total",658,226,25,201,199,68,163,29,134
"2011","Birmingham 120C","E01009211","Total",676,175,10,165,154,58,150,26,124
"2011","Birmingham 120D","E01009218","Total",635,268,11,257,188,61,213,30,183
"2011","Birmingham 120E","E01009219","Total",609,198,52,146,230,102,166,38,128
"2011","Birmingham 121A","E01008976","Total",679,333,62,271,205,82,237,41,196
"2011","Birmingham 121B","E01008978","Total",744,495,120,375,214,131,304,59,245
"2011","Birmingham 121C","E01008979","Total",765,368,65,303,198,81,305,49,256
"2011","Birmingham 121D","E01008980","Total",681,341,75,266,227,92,252,55,197
"2011","Birmingham 122A","E01008945","Total",745,226,48,178,249,118,217,54,163
"2011","Birmingham 122B","E01008946","Total",643,238,16,222,174,68,200,28,172
"2011","Birmingham 122C","E01008947","Total",543,158,31,127,195,81,116,27,89
"2011","Birmingham 122D","E01008948","Total",627,221,23,198,161,63,179,29,150
"2011","Birmingham 122E","E01008949","Total",515,160,10,150,152,45,138,23,115
"2011","Birmingham 123A","E01008977","Total",698,217,49,168,208,90,173,34,139
"2011","Birmingham 123B","E01009109","Total",516,245,128,117,276,144,152,65,87
"2011","Birmingham 123C","E01009119","Total",641,244,24,220,169,60,202,38,164
"2011","Birmingham 123D","E01009120","Total",628,215,41,174,183,87,154,26,128
"2011","Birmingham 124A","E01009162","Total",653,224,46,178,212,90,164,32,132
"2011","Birmingham 124B","E01009207","Total",663,198,18,180,198,80,171,25,146
"2011","Birmingham 124C","E01009208","Total",618,170,18,152,191,65,161,31,130
"2011","Birmingham 124D","E01009209","Total",975,317,50,267,285,127,256,52,204
"2011","Birmingham 124E","E01009213","Total",699,311,26,285,159,68,239,37,202
"2011","Birmingham 125B","E01009155","Total",602,283,57,226,148,47,222,39,183
"2011","Birmingham 125D","E01009157","Total",632,283,81,202,216,101,214,52,162
"2011","Birmingham 125E","E01009160","Total",736,387,122,265,269,143,231,51,180
"2011","Birmingham 125F","E01009161","Total",617,257,36,221,186,66,211,35,176
"2011","Birmingham 125G","E01033633","Total",986,403,103,300,331,135,345,69,276
"2011","Birmingham 126A","E01009117","Total",820,390,150,240,370,202,296,79,217
"2011","Birmingham 126B","E01009210","Total",796,288,75,213,262,108,197,41,156
"2011","Birmingham 126C","E01009212","Total",767,314,63,251,246,106,249,53,196
"2011","Birmingham 126D","E01009214","Total",788,384,72,312,241,101,287,61,226
"2011","Birmingham 126E","E01009215","Total",884,451,91,360,225,115,319,44,275
"2011","Birmingham 127A","E01009108","Total",557,204,27,177,147,52,153,32,121
"2011","Birmingham 127B","E01009111","Total",550,163,20,143,178,70,133,37,96
"2011","Birmingham 127C","E01009112","Total",600,243,33,210,193,77,203,37,166
"2011","Birmingham 127D","E01009116","Total",579,216,5,211,145,46,153,18,135
"2011","Birmingham 127E","E01009118","Total",677,266,33,233,169,63,223,48,175
"2011","Birmingham 128A","E01009107","Total",829,412,126,286,290,174,264,53,211
"2011","Birmingham 128B","E01009110","Total",649,239,64,175,217,93,211,53,158
"2011","Birmingham 128C","E01009113","Total",624,336,96,240,221,95,257,55,202
"2011","Birmingham 128D","E01009114","Total",680,302,57,245,198,87,256,58,198
"2011","Birmingham 128E","E01009115","Total",618,290,55,235,166,67,225,41,184
"2011","Birmingham 129A","E01009158","Total",762,227,61,166,295,137,183,49,134
"2011","Birmingham 129B","E01009163","Total",635,276,71,205,205,94,194,44,150
"2011","Birmingham 129C","E01009165","Total",659,240,43,197,187,88,180,40,140
"2011","Birmingham 129D","E01009169","Total",682,203,35,168,263,104,182,38,144
"2011","Birmingham 130A","E01009159","Total",753,197,38,159,238,87,175,35,140
"2011","Birmingham 130B","E01009164","Total",634,206,40,166,198,82,176,38,138
"2011","Birmingham 130C","E01009167","Total",603,167,33,134,229,87,147,48,99
"2011","Birmingham 130D","E01009171","Total",694,270,63,207,241,91,203,38,165
"2011","Birmingham 131A","E01009166","Total",559,190,49,141,189,78,142,37,105
"2011","Birmingham 131B","E01009168","Total",621,187,23,164,183,61,157,46,111
"2011","Birmingham 131C","E01009170","Total",627,180,15,165,188,59,154,23,131
"2011","Birmingham 131D","E01009216","Total",816,301,58,243,274,121,234,51,183
"2011","Birmingham 131E","E01009217","Total",660,198,17,181,214,68,156,35,121
"2011","Birmingham 132A","E01009039","Total",641,181,9,172,221,108,163,29,134
"2011","Birmingham 132B","E01009040","Total",628,163,19,144,231,91,150,37,113
"2011","Birmingham 132C","E01009041","Total",627,157,16,141,228,83,151,40,111
"2011","Birmingham 132D","E01009042","Total",539,142,29,113,199,97,130,33,97
"2011","Birmingham 132E","E01032589","Total",578,207,26,181,177,76,159,31,128
"2011","Birmingham 133A","E01009262","Total",520,93,14,79,219,83,137,44,93
"2011","Birmingham 133B","E01009267","Total",567,181,20,161,184,81,188,39,149
"2011","Birmingham 133C","E01009276","Total",528,152,12,140,200,52,130,37,93
"2011","Birmingham 133D","E01009278","Total",540,124,17,107,234,84,155,60,95
"2011","Birmingham 133E","E01009279","Total",445,108,27,81,208,77,109,50,59
"2011","Birmingham 133F","E01032591","Total",483,129,14,115,192,68,144,51,93
"2011","Birmingham 134A","E01008995","Total",725,371,72,299,189,99,234,32,202
"2011","Birmingham 134B","E01033557","Total",836,140,3,137,54,45,61,4,57
"2011","Birmingham 134C","E01033624","Total",498,154,42,112,109,59,74,18,56
"2011","Birmingham 134D","E01033626","Total",556,195,26,169,100,58,97,11,86
"2011","Birmingham 134E","E01033640","Total",564,234,82,152,216,100,146,53,93
"2011","Birmingham 135A","E01009378","Total",1060,345,61,284,196,113,221,30,191
"2011","Birmingham 135B","E01033567","Total",712,225,9,216,41,35,52,4,48
"2011","Birmingham 135C","E01033615","Total",616,150,5,145,37,26,43,5,38
"2011","Birmingham 135D","E01033616","Total",714,317,11,306,34,22,186,5,181
"2011","Birmingham 136A","E01009143","Total",660,388,111,277,224,114,193,31,162
"2011","Birmingham 136B","E01009146","Total",892,462,39,423,122,65,267,26,241
"2011","Birmingham 136C","E01033564","Total",770,179,15,164,58,38,57,5,52
"2011","Birmingham 136D","E01033639","Total",828,311,95,216,252,121,207,53,154
"2011","Birmingham 137A","E01009141","Total",825,390,104,286,258,113,246,55,191
"2011","Birmingham 137B","E01033565","Total",623,90,2,88,23,17,29,3,26
"2011","Birmingham 137C","E01033618","Total",745,85,6,79,50,42,39,6,33
"2011","Birmingham 137D","E01033619","Total",605,94,20,74,77,42,53,15,38
"2011","Birmingham 137E","E01033627","Total",573,198,37,161,113,59,124,14,110
"2011","Birmingham 138A","E01033620","Total",702,265,6,259,26,21,50,1,49
"2011","Birmingham 138B","E01033622","Total",901,162,8,154,58,34,80,3,77
"2011","Birmingham 138C","E01033623","Total",772,216,11,205,27,13,121,5,116
"2011","Birmingham 138D","E01033625","Total",1058,254,8,246,47,40,41,3,38
"2011","Birmingham 139A","E01009200","Total",659,272,92,180,290,144,161,57,104
"2011","Birmingham 139B","E01009327","Total",412,163,75,88,243,123,124,70,54
"2011","Birmingham 139C","E01009328","Total",525,176,76,100,303,152,190,102,88
"2011","Birmingham 139D","E01009331","Total",557,178,71,107,311,172,165,75,90
"2011","Birmingham 139E","E01009332","Total",539,234,80,154,247,123,187,65,122
"2011","Birmingham 139F","E01009333","Total",436,178,84,94,256,144,122,56,66
"2011","Birmingham 139G","E01009335","Total",479,166,64,102,267,127,130,59,71
"2011","Birmingham 139H","E01009344","Total",460,170,76,94,253,129,135,53,82
"2011","Birmingham 140A","E01009339","Total",455,185,59,126,222,116,141,50,91
"2011","Birmingham 140B","E01009340","Total",941,292,109,183,438,253,212,86,126
"2011","Birmingham 140C","E01009382","Total",448,161,64,97,235,122,123,48,75
"2011","Birmingham 140D","E01009391","Total",522,177,72,105,263,147,133,55,78
"2011","Birmingham 140E","E01009392","Total",444,132,46,86,232,112,136,68,68
"2011","Birmingham 140F","E01009393","Total",473,167,74,93,264,146,122,60,62
"2011","Birmingham 140G","E01033641","Total",891,276,111,165,482,284,233,94,139
"2011","Coventry 001A","E01009589","Total",591,172,43,129,217,101,144,36,108
"2011","Coventry 001F","E01032536","Total",852,252,38,214,260,101,237,53,184
"2011","Coventry 001G","E01032537","Total",831,322,42,280,248,114,217,40,177
"2011","Coventry 001H","E01032538","Total",994,353,82,271,335,164,285,60,225
"2011","Coventry 002A","E01009590","Total",523,165,17,148,182,57,160,46,114
"2011","Coventry 002B","E01009591","Total",580,143,37,106,232,84,151,38,113
"2011","Coventry 002C","E01009593","Total",633,216,24,192,203,84,173,41,132
"2011","Coventry 002D","E01009598","Total",642,264,15,249,165,53,176,30,146
"2011","Coventry 004A","E01009604","Total",566,214,50,164,219,95,188,51,137
"2011","Coventry 004B","E01009605","Total",650,307,86,221,241,115,212,55,157
"2011","Coventry 004C","E01009607","Total",803,434,75,359,202,120,276,41,235
"2011","Coventry 004D","E01009608","Total",621,222,63,159,243,111,200,56,144
"2011","Coventry 004E","E01009610","Total",637,266,51,215,219,85,202,41,161
"2011","Coventry 005A","E01009564","Total",587,252,95,157,256,142,173,55,118
"2011","Coventry 005B","E01009575","Total",481,174,66,108,218,101,146,48,98
"2011","Coventry 005C","E01009606","Total",537,173,32,141,199,87,152,27,125
"2011","Coventry 005D","E01009609","Total",610,248,91,157,265,129,210,56,154
"2011","Coventry 006A","E01009524","Total",680,309,19,290,183,55,264,34,230
"2011","Coventry 006B","E01009525","Total",575,209,16,193,174,64,183,32,151
"2011","Coventry 006C","E01009527","Total",654,190,25,165,242,92,164,39,125
"2011","Coventry 006D","E01009594","Total",532,161,16,145,164,51,141,29,112
"2011","Coventry 007A","E01009577","Total",527,254,97,157,223,104,164,36,128
"2011","Coventry 007B","E01009579","Total",695,357,116,241,281,156,233,41,192
"2011","Coventry 007C","E01009581","Total",638,321,81,240,238,118,235,53,182
"2011","Coventry 007D","E01009584","Total",603,264,49,215,191,91,155,31,124
"2011","Coventry 007E","E01009585","Total",390,204,105,99,198,103,125,52,73
"2011","Coventry 007F","E01009709","Total",429,247,78,169,171,87,161,40,121
"2011","Coventry 008A","E01009576","Total",684,220,30,190,218,98,199,31,168
"2011","Coventry 008B","E01009578","Total",564,151,12,139,166,67,116,20,96
"2011","Coventry 008C","E01009582","Total",738,236,20,216,225,92,204,28,176
"2011","Coventry 008D","E01009583","Total",672,246,38,208,227,98,171,33,138
"2011","Coventry 008E","E01009586","Total",651,202,21,181,220,91,182,46,136
"2011","Coventry 009A","E01009565","Total",458,155,50,105,232,121,148,48,100
"2011","Coventry 009B","E01009566","Total",569,213,88,125,262,145,128,49,79
"2011","Coventry 009C","E01009567","Total",660,298,82,216,286,165,193,61,132
"2011","Coventry 009D","E01009568","Total",541,195,64,131,268,132,160,61,99
"2011","Coventry 010A","E01009523","Total",609,226,2,224,149,42,150,19,131
"2011","Coventry 010B","E01009526","Total",599,190,15,175,208,77,152,33,119
"2011","Coventry 010C","E01009528","Total",679,271,11,260,180,64,171,21,150
"2011","Coventry 010D","E01009531","Total",761,335,31,304,175,71,221,27,194
"2011","Coventry 011A","E01009587","Total",572,199,49,150,239,122,151,46,105
"2011","Coventry 011B","E01009624","Total",622,187,53,134,255,129,151,44,107
"2011","Coventry 011C","E01009625","Total",867,238,62,176,362,163,216,55,161
"2011","Coventry 011D","E01009626","Total",632,179,38,141,228,113,160,38,122
"2011","Coventry 012A","E01009622","Total",655,246,85,161,302,137,209,73,136
"2011","Coventry 012B","E01009623","Total",678,269,59,210,217,106,189,36,153
"2011","Coventry 012C","E01009627","Total",712,279,50,229,204,98,233,45,188
"2011","Coventry 012D","E01009628","Total",632,231,31,200,191,77,187,32,155
"2011","Coventry 013A","E01009599","Total",607,272,30,242,141,83,193,17,176
"2011","Coventry 013B","E01009663","Total",633,280,27,253,154,79,195,27,168
"2011","Coventry 013C","E01009710","Total",634,217,18,199,164,66,148,17,131
"2011","Coventry 013D","E01009711","Total",600,250,22,228,164,65,174,26,148
"2011","Coventry 014A","E01009522","Total",647,304,31,273,177,75,239,30,209
"2011","Coventry 014B","E01009529","Total",621,170,17,153,213,75,152,22,130
"2011","Coventry 014C","E01009530","Total",561,163,16,147,203,75,150,31,119
"2011","Coventry 014D","E01009645","Total",572,139,21,118,215,88,123,32,91
"2011","Coventry 015A","E01009569","Total",494,188,74,114,206,109,155,42,113
"2011","Coventry 015B","E01009570","Total",596,252,86,166,257,128,172,65,107
"2011","Coventry 015C","E01009571","Total",673,351,82,269,220,133,223,39,184
"2011","Coventry 015D","E01009572","Total",797,362,157,205,372,230,207,68,139
"2011","Coventry 015E","E01009573","Total",525,228,70,158,225,131,169,55,114
"2011","Coventry 015F","E01009574","Total",559,262,81,181,246,142,171,55,116
"2011","Coventry 016A","E01009655","Total",789,272,62,210,288,159,211,42,169
"2011","Coventry 016B","E01009656","Total",713,301,59,242,220,95,215,40,175
"2011","Coventry 016C","E01009659","Total",765,326,84,242,255,135,214,50,164
"2011","Coventry 016D","E01009662","Total",569,194,21,173,171,68,174,34,140
"2011","Coventry 016E","E01009664","Total",578,181,40,141,219,111,153,44,109
"2011","Coventry 017A","E01009643","Total",591,128,11,117,211,84,124,19,105
"2011","Coventry 017B","E01009644","Total",679,187,15,172,224,96,170,35,135
"2011","Coventry 017C","E01009647","Total",785,239,22,217,196,90,203,38,165
"2011","Coventry 017D","E01009648","Total",607,145,16,129,227,100,137,36,101
"2011","Coventry 017E","E01009652","Total",619,235,13,222,163,60,177,20,157
"2011","Coventry 017F","E01009653","Total",625,220,18,202,212,83,164,29,135
"2011","Coventry 018A","E01009613","Total",502,131,9,122,173,53,120,28,92
"2011","Coventry 018B","E01009657","Total",627,182,36,146,222,90,145,31,114
"2011","Coventry 018C","E01009712","Total",620,188,37,151,224,93,151,41,110
"2011","Coventry 018D","E01009714","Total",576,145,16,129,241,91,131,35,96
"2011","Coventry 018E","E01009716","Total",649,180,22,158,256,99,176,40,136
"2011","Coventry 019A","E01009580","Total",547,227,17,210,127,58,158,20,138
"2011","Coventry 019B","E01009713","Total",521,145,26,119,196,82,122,34,88
"2011","Coventry 019C","E01009715","Total",588,211,26,185,184,83,149,25,124
"2011","Coventry 019D","E01009717","Total",585,160,13,147,195,80,138,21,117
"2011","Coventry 019E","E01009718","Total",885,469,55,414,197,98,314,36,278
"2011","Coventry 020A","E01009629","Total",1079,322,81,241,367,220,190,50,140
"2011","Coventry 020B","E01009630","Total",708,240,57,183,247,117,178,42,136
"2011","Coventry 020C","E01009631","Total",577,246,49,197,180,78,180,45,135
"2011","Coventry 020D","E01009632","Total",943,441,40,401,120,77,270,15,255
"2011","Coventry 020E","E01009650","Total",790,339,23,316,92,50,133,16,117
"2011","Coventry 021A","E01009614","Total",585,159,18,141,199,72,131,37,94
"2011","Coventry 021B","E01009654","Total",710,177,30,147,263,109,137,33,104
"2011","Coventry 021C","E01009658","Total",585,170,27,143,189,78,146,30,116
"2011","Coventry 021D","E01009660","Total",658,210,28,182,207,86,157,39,118
"2011","Coventry 022A","E01009646","Total",619,162,16,146,215,90,112,24,88
"2011","Coventry 022B","E01009692","Total",531,246,8,238,130,37,140,15,125
"2011","Coventry 022C","E01009693","Total",692,248,16,232,181,66,186,37,149
"2011","Coventry 022D","E01009694","Total",623,248,14,234,172,74,180,33,147
"2011","Coventry 023A","E01009695","Total",754,345,6,339,149,47,201,18,183
"2011","Coventry 023B","E01009696","Total",640,230,11,219,157,54,145,22,123
"2011","Coventry 023C","E01009704","Total",596,159,7,152,178,45,113,26,87
"2011","Coventry 023D","E01009705","Total",578,179,7,172,167,54,117,16,101
"2011","Coventry 024A","E01009636","Total",967,346,75,271,267,159,174,39,135
"2011","Coventry 024B","E01009637","Total",481,219,94,125,244,112,120,46,74
"2011","Coventry 024C","E01009638","Total",732,427,113,314,218,124,242,47,195
"2011","Coventry 024D","E01009639","Total",545,201,62,139,248,144,159,52,107
"2011","Coventry 024E","E01009640","Total",707,331,118,213,311,183,163,55,108
"2011","Coventry 024F","E01009641","Total",902,483,79,404,179,101,205,37,168
"2011","Coventry 025A","E01009697","Total",644,221,10,211,166,73,153,23,130
"2011","Coventry 025B","E01009698","Total",624,208,8,200,173,56,147,25,122
"2011","Coventry 025C","E01009703","Total",1144,275,59,216,378,176,235,49,186
"2011","Coventry 025D","E01009706","Total",656,227,12,215,168,66,171,28,143
"2011","Coventry 026A","E01009649","Total",582,167,20,147,181,82,144,22,122
"2011","Coventry 026B","E01009684","Total",680,246,36,210,171,77,202,28,174
"2011","Coventry 026C","E01009685","Total",714,213,15,198,199,73,193,28,165
"2011","Coventry 026D","E01009686","Total",692,178,5,173,205,81,163,32,131
"2011","Coventry 026E","E01009687","Total",600,152,15,137,170,88,114,28,86
"2011","Coventry 027A","E01009615","Total",678,201,17,184,182,83,153,35,118
"2011","Coventry 027B","E01009616","Total",608,178,27,151,205,79,145,36,109
"2011","Coventry 027C","E01009617","Total",473,138,29,109,163,71,129,28,101
"2011","Coventry 027D","E01009618","Total",612,153,20,133,217,64,160,49,111
"2011","Coventry 027E","E01009620","Total",608,202,24,178,179,74,168,35,133
"2011","Coventry 027F","E01009621","Total",536,170,37,133,189,86,132,39,93
"2011","Coventry 028A","E01009633","Total",713,261,56,205,184,91,149,38,111
"2011","Coventry 028B","E01009634","Total",679,253,32,221,139,70,122,22,100
"2011","Coventry 028C","E01009635","Total",886,406,49,357,151,79,158,26,132
"2011","Coventry 028D","E01009661","Total",793,317,65,252,223,103,195,36,159
"2011","Coventry 029A","E01009674","Total",674,274,69,205,222,105,204,57,147
"2011","Coventry 029B","E01009699","Total",624,264,28,236,162,71,186,33,153
"2011","Coventry 029C","E01009700","Total",831,416,84,332,210,103,255,37,218
"2011","Coventry 029D","E01009701","Total",729,326,60,266,210,82,248,49,199
"2011","Coventry 029E","E01009702","Total",729,347,75,272,215,120,226,37,189
"2011","Coventry 030A","E01009688","Total",601,221,25,196,119,57,143,25,118
"2011","Coventry 030B","E01009689","Total",717,207,19,188,89,45,124,8,116
"2011","Coventry 030C","E01009690","Total",660,232,19,213,115,56,123,20,103
"2011","Coventry 030D","E01009691","Total",631,183,23,160,95,51,120,14,106
"2011","Coventry 031A","E01009548","Total",1038,376,47,329,210,110,212,27,185
"2011","Coventry 031B","E01009553","Total",687,310,15,295,73,31,118,15,103
"2011","Coventry 031C","E01009642","Total",963,565,41,524,80,40,182,21,161
"2011","Coventry 031D","E01009651","Total",874,425,74,351,177,99,271,37,234
"2011","Coventry 032A","E01009676","Total",600,169,27,142,198,88,138,30,108
"2011","Coventry 032B","E01009681","Total",535,190,11,179,138,47,129,18,111
"2011","Coventry 032C","E01009682","Total",601,189,18,171,184,86,157,33,124
"2011","Coventry 032D","E01009683","Total",560,161,43,118,193,98,125,30,95
"2011","Coventry 033A","E01009532","Total",577,210,19,191,161,63,146,20,126
"2011","Coventry 033B","E01009535","Total",558,228,10,218,139,44,147,18,129
"2011","Coventry 033C","E01009536","Total",613,235,10,225,151,65,175,34,141
"2011","Coventry 033D","E01009543","Total",560,44,5,39,267,91,88,28,60
"2011","Coventry 033E","E01009707","Total",727,151,16,135,266,118,155,38,117
"2011","Coventry 033F","E01009708","Total",626,197,11,186,167,73,164,27,137
"2011","Coventry 034A","E01009554","Total",571,149,4,145,134,50,116,14,102
"2011","Coventry 034B","E01009555","Total",601,202,15,187,150,48,128,18,110
"2011","Coventry 034C","E01009556","Total",772,288,12,276,144,51,177,12,165
"2011","Coventry 034D","E01009557","Total",539,197,2,195,121,34,139,24,115
"2011","Coventry 034E","E01009558","Total",643,130,9,121,183,61,87,20,67
"2011","Coventry 034F","E01009559","Total",606,314,6,308,123,28,165,23,142
"2011","Coventry 035C","E01009537","Total",612,225,49,176,204,101,182,42,140
"2011","Coventry 035D","E01009538","Total",601,216,45,171,197,77,182,34,148
"2011","Coventry 035E","E01009611","Total",772,290,118,172,401,225,180,50,130
"2011","Coventry 035F","E01009612","Total",566,223,62,161,210,104,183,44,139
"2011","Coventry 035G","E01032527","Total",631,185,41,144,231,80,164,40,124
"2011","Coventry 035H","E01032528","Total",697,309,63,246,214,111,218,37,181
"2011","Coventry 036C","E01009679","Total",614,314,51,263,159,59,227,46,181
"2011","Coventry 036E","E01032531","Total",1147,542,128,414,410,203,411,83,328
"2011","Coventry 036F","E01032532","Total",533,193,20,173,151,42,139,23,116
"2011","Coventry 036G","E01032533","Total",643,132,19,113,248,90,118,37,81
"2011","Coventry 037B","E01009549","Total",668,228,12,216,175,75,180,24,156
"2011","Coventry 037C","E01009550","Total",770,218,27,191,237,119,157,34,123
"2011","Coventry 037E","E01009552","Total",719,313,30,283,194,89,240,28,212
"2011","Coventry 037F","E01032534","Total",756,316,42,274,247,111,236,51,185
"2011","Coventry 037G","E01032535","Total",485,155,17,138,143,52,121,21,100
"2011","Coventry 038A","E01009544","Total",749,297,26,271,168,77,216,25,191
"2011","Coventry 038D","E01009619","Total",831,283,54,229,206,118,198,40,158
"2011","Coventry 038E","E01032529","Total",693,255,33,222,133,69,172,18,154
"2011","Coventry 038F","E01032530","Total",817,258,18,240,214,92,207,17,190
"2011","Coventry 039A","E01009539","Total",774,407,83,324,243,125,271,53,218
"2011","Coventry 039B","E01009540","Total",779,343,132,211,344,194,234,77,157
"2011","Coventry 039C","E01009541","Total",816,398,57,341,161,78,254,16,238
"2011","Coventry 039D","E01009542","Total",893,485,77,408,218,109,319,50,269
"2011","Coventry 040A","E01009560","Total",547,182,6,176,174,43,133,31,102
"2011","Coventry 040B","E01009561","Total",767,355,28,327,166,63,244,24,220
"2011","Coventry 040C","E01009562","Total",709,312,13,299,169,56,208,25,183
"2011","Coventry 040D","E01009563","Total",619,206,10,196,212,85,145,28,117
"2011","Coventry 040E","E01009672","Total",822,330,9,321,233,55,225,40,185
"2011","Coventry 041A","E01009666","Total",503,148,6,142,185,58,111,26,85
"2011","Coventry 041B","E01009667","Total",575,291,9,282,113,24,180,20,160
"2011","Coventry 041C","E01009668","Total",630,172,15,157,249,73,141,29,112
"2011","Coventry 041D","E01009670","Total",673,194,11,183,242,70,139,26,113
"2011","Coventry 042A","E01009665","Total",475,190,6,184,101,34,113,18,95
"2011","Coventry 042B","E01009669","Total",462,105,6,99,199,50,99,31,68
"2011","Coventry 042C","E01009671","Total",410,89,4,85,152,51,78,24,54
"2011","Coventry 042F","E01033058","Total",911,452,34,418,163,62,271,33,238
"2011","Coventry 043A","E01009588","Total",681,335,49,286,209,92,269,37,232
"2011","Coventry 043B","E01009592","Total",640,212,76,136,281,139,166,61,105
"2011","Coventry 043C","E01009596","Total",564,178,58,120,228,95,161,34,127
"2011","Coventry 043D","E01009597","Total",642,213,64,149,262,130,163,51,112
"2011","Coventry 043E","E01032587","Total",670,212,67,145,288,130,175,51,124
"2011","Dudley 001A","E01009763","Total",690,226,64,162,305,117,185,62,123
"2011","Dudley 001B","E01009764","Total",571,194,13,181,168,54,139,30,109
"2011","Dudley 001C","E01009767","Total",615,248,29,219,176,74,203,32,171
"2011","Dudley 001D","E01009769","Total",708,344,83,261,238,122,228,40,188
"2011","Dudley 001E","E01009770","Total",634,270,45,225,180,83,204,32,172
"2011","Dudley 002A","E01009773","Total",665,269,30,239,191,67,224,46,178
"2011","Dudley 002B","E01009777","Total",612,235,25,210,187,57,205,40,165
"2011","Dudley 002C","E01009778","Total",621,173,16,157,207,68,165,35,130
"2011","Dudley 002D","E01009895","Total",611,244,16,228,173,63,190,23,167
"2011","Dudley 003A","E01009896","Total",606,239,13,226,161,48,154,27,127
"2011","Dudley 003B","E01009897","Total",606,249,5,244,155,49,150,21,129
"2011","Dudley 003C","E01009898","Total",652,286,11,275,128,28,195,20,175
"2011","Dudley 003D","E01009901","Total",585,239,4,235,139,40,163,18,145
"2011","Dudley 003E","E01009902","Total",533,192,3,189,122,37,121,11,110
"2011","Dudley 004A","E01009765","Total",641,200,22,178,197,65,174,29,145
"2011","Dudley 004B","E01009766","Total",672,235,29,206,197,78,189,32,157
"2011","Dudley 004C","E01009768","Total",626,266,26,240,167,57,225,30,195
"2011","Dudley 004D","E01009771","Total",640,302,5,297,112,34,222,12,210
"2011","Dudley 004E","E01009775","Total",597,239,49,190,223,72,166,36,130
"2011","Dudley 004F","E01009776","Total",590,209,20,189,182,62,173,35,138
"2011","Dudley 005A","E01009758","Total",664,289,63,226,239,115,222,49,173
"2011","Dudley 005B","E01009760","Total",505,180,34,146,184,79,153,43,110
"2011","Dudley 005C","E01009772","Total",480,150,64,86,213,82,118,40,78
"2011","Dudley 005D","E01009774","Total",625,215,22,193,188,69,178,38,140
"2011","Dudley 005E","E01009788","Total",705,291,47,244,204,70,236,34,202
"2011","Dudley 006B","E01009756","Total",527,205,47,158,204,67,158,43,115
"2011","Dudley 006C","E01009757","Total",645,220,46,174,200,74,179,41,138
"2011","Dudley 006D","E01009759","Total",526,219,9,210,120,43,155,26,129
"2011","Dudley 006F","E01009762","Total",489,229,99,130,241,104,151,42,109
"2011","Dudley 006G","E01033187","Total",837,399,170,229,381,192,263,87,176
"2011","Dudley 007A","E01009781","Total",890,345,43,302,239,103,232,37,195
"2011","Dudley 007B","E01009786","Total",626,251,60,191,219,109,196,45,151
"2011","Dudley 007C","E01009789","Total",643,205,8,197,156,48,145,14,131
"2011","Dudley 007D","E01009790","Total",667,253,26,227,192,81,215,43,172
"2011","Dudley 008A","E01009779","Total",675,279,9,270,123,49,214,18,196
"2011","Dudley 008B","E01009782","Total",632,241,49,192,221,95,184,33,151
"2011","Dudley 008C","E01009783","Total",597,229,45,184,197,70,181,39,142
"2011","Dudley 008D","E01009785","Total",634,282,1,281,134,40,179,16,163
"2011","Dudley 008E","E01009899","Total",625,266,4,262,141,45,160,16,144
"2011","Dudley 008F","E01009900","Total",633,297,2,295,137,44,161,12,149
"2011","Dudley 009A","E01009780","Total",745,77,12,65,338,105,93,36,57
"2011","Dudley 009B","E01009784","Total",625,83,8,75,251,91,100,37,63
"2011","Dudley 009C","E01009787","Total",585,126,8,118,210,49,129,33,96
"2011","Dudley 009D","E01009880","Total",569,117,15,102,222,78,131,36,95
"2011","Dudley 009E","E01009882","Total",542,174,28,146,189,78,156,32,124
"2011","Dudley 010A","E01009891","Total",615,247,87,160,259,132,184,53,131
"2011","Dudley 010B","E01009892","Total",632,304,69,235,188,72,227,43,184
"2011","Dudley 010C","E01009893","Total",607,273,103,170,293,151,207,63,144
"2011","Dudley 010D","E01009894","Total",696,239,37,202,238,108,218,40,178
"2011","Dudley 011A","E01009844","Total",608,270,59,211,198,96,194,40,154
"2011","Dudley 011B","E01009879","Total",802,252,43,209,263,114,218,49,169
"2011","Dudley 011C","E01009881","Total",1131,569,46,523,198,95,389,27,362
"2011","Dudley 011D","E01009885","Total",682,319,59,260,189,97,212,41,171
"2011","Dudley 012A","E01009816","Total",607,227,15,212,158,47,161,23,138
"2011","Dudley 012B","E01009817","Total",544,228,2,226,148,39,160,22,138
"2011","Dudley 012C","E01009819","Total",662,150,14,136,204,71,124,25,99
"2011","Dudley 012D","E01009820","Total",644,224,16,208,179,59,173,30,143
"2011","Dudley 013A","E01009748","Total",649,296,83,213,256,123,211,48,163
"2011","Dudley 013B","E01009839","Total",582,223,52,171,200,83,176,43,133
"2011","Dudley 013C","E01009883","Total",569,242,53,189,200,79,198,51,147
"2011","Dudley 013D","E01009884","Total",645,245,35,210,209,93,171,44,127
"2011","Dudley 013E","E01009886","Total",833,458,33,425,164,61,347,31,316
"2011","Dudley 014A","E01009814","Total",515,183,7,176,142,37,128,14,114
"2011","Dudley 014B","E01009815","Total",498,139,1,138,168,30,108,20,88
"2011","Dudley 014C","E01009818","Total",511,236,19,217,127,42,161,18,143
"2011","Dudley 014D","E01009821","Total",602,261,7,254,129,47,172,18,154
"2011","Dudley 014E","E01009822","Total",657,274,10,264,136,46,202,24,178
"2011","Dudley 015A","E01009887","Total",637,222,44,178,228,100,189,58,131
"2011","Dudley 015B","E01009888","Total",660,217,29,188,199,83,193,34,159
"2011","Dudley 015C","E01009889","Total",681,307,79,228,236,106,209,52,157
"2011","Dudley 015D","E01009890","Total",665,270,72,198,260,110,220,50,170
"2011","Dudley 016A","E01009749","Total",594,186,13,173,145,55,132,23,109
"2011","Dudley 016B","E01009750","Total",595,230,32,198,174,60,192,34,158
"2011","Dudley 016C","E01009823","Total",537,150,6,144,155,42,123,17,106
"2011","Dudley 016D","E01009824","Total",703,283,43,240,222,84,223,42,181
"2011","Dudley 017A","E01009751","Total",651,268,43,225,188,79,200,34,166
"2011","Dudley 017B","E01009752","Total",595,225,64,161,227,102,194,56,138
"2011","Dudley 017C","E01009753","Total",615,261,79,182,259,105,200,48,152
"2011","Dudley 017D","E01009754","Total",640,228,50,178,221,107,189,44,145
"2011","Dudley 017E","E01009841","Total",631,280,67,213,225,105,219,47,172
"2011","Dudley 018A","E01009840","Total",533,200,52,148,204,103,134,32,102
"2011","Dudley 018B","E01009842","Total",902,404,55,349,212,99,285,45,240
"2011","Dudley 018C","E01009843","Total",659,234,29,205,193,68,200,30,170
"2011","Dudley 018D","E01009871","Total",833,270,44,226,201,94,227,35,192
"2011","Dudley 018E","E01009875","Total",623,236,47,189,205,86,183,33,150
"2011","Dudley 019A","E01009825","Total",604,223,17,206,168,48,184,23,161
"2011","Dudley 019B","E01009826","Total",638,254,4,250,146,45,171,17,154
"2011","Dudley 019C","E01009827","Total",633,232,2,230,199,42,167,29,138
"2011","Dudley 019D","E01009828","Total",573,238,27,211,153,41,153,34,119
"2011","Dudley 019E","E01009829","Total",635,218,5,213,176,59,173,20,153
"2011","Dudley 019F","E01009830","Total",624,223,10,213,184,41,162,25,137
"2011","Dudley 020A","E01009872","Total",615,251,51,200,215,73,185,41,144
"2011","Dudley 020B","E01009873","Total",620,225,25,200,169,56,196,33,163
"2011","Dudley 020C","E01009874","Total",581,203,60,143,230,76,182,58,124
"2011","Dudley 020D","E01009876","Total",653,226,35,191,219,84,190,46,144
"2011","Dudley 020E","E01009877","Total",633,270,69,201,214,95,197,45,152
"2011","Dudley 021A","E01009911","Total",611,202,5,197,129,40,134,17,117
"2011","Dudley 021B","E01009912","Total",691,194,20,174,218,91,147,27,120
"2011","Dudley 021C","E01009913","Total",648,267,10,257,185,70,215,29,186
"2011","Dudley 021D","E01009914","Total",593,220,3,217,155,52,155,21,134
"2011","Dudley 021E","E01009915","Total",712,170,5,165,175,73,137,16,121
"2011","Dudley 021F","E01009916","Total",725,228,22,206,202,71,198,33,165
"2011","Dudley 022A","E01009741","Total",1179,521,101,420,282,146,348,49,299
"2011","Dudley 022B","E01009744","Total",872,326,54,272,238,122,240,38,202
"2011","Dudley 022C","E01009746","Total",688,286,49,237,194,101,234,53,181
"2011","Dudley 022D","E01009747","Total",661,170,40,130,222,97,176,51,125
"2011","Dudley 023A","E01009731","Total",679,136,17,119,197,74,132,30,102
"2011","Dudley 023B","E01009740","Total",669,186,68,118,277,125,166,54,112
"2011","Dudley 023C","E01009742","Total",647,275,41,234,217,100,221,44,177
"2011","Dudley 023D","E01009743","Total",696,290,71,219,274,114,231,58,173
"2011","Dudley 023E","E01009745","Total",727,204,10,194,195,72,181,27,154
"2011","Dudley 024A","E01009917","Total",498,144,7,137,149,50,122,24,98
"2011","Dudley 024B","E01009918","Total",600,241,35,206,194,65,205,31,174
"2011","Dudley 024C","E01009919","Total",502,168,4,164,125,37,127,22,105
"2011","Dudley 024D","E01009920","Total",621,131,4,127,175,70,122,18,104
"2011","Dudley 025A","E01009864","Total",600,175,30,145,231,87,153,34,119
"2011","Dudley 025B","E01009865","Total",644,301,32,269,189,84,222,27,195
"2011","Dudley 025C","E01009866","Total",732,244,31,213,209,101,178,24,154
"2011","Dudley 025D","E01009867","Total",694,272,32,240,212,82,189,30,159
"2011","Dudley 025E","E01009878","Total",764,206,24,182,272,130,206,49,157
"2011","Dudley 026A","E01009791","Total",662,260,22,238,173,65,203,26,177
"2011","Dudley 026B","E01009792","Total",632,214,38,176,221,85,178,34,144
"2011","Dudley 026C","E01009795","Total",705,220,36,184,225,120,175,32,143
"2011","Dudley 026D","E01009796","Total",604,189,17,172,176,57,167,30,137
"2011","Dudley 026E","E01009798","Total",716,235,24,211,201,84,183,36,147
"2011","Dudley 027A","E01009719","Total",558,153,20,133,181,74,145,37,108
"2011","Dudley 027B","E01009722","Total",618,192,9,183,156,61,118,15,103
"2011","Dudley 027C","E01009727","Total",503,97,7,90,178,58,113,28,85
"2011","Dudley 027D","E01009728","Total",501,117,9,108,161,55,119,22,97
"2011","Dudley 027E","E01009729","Total",620,231,30,201,194,74,173,37,136
"2011","Dudley 028A","E01009720","Total",528,81,9,72,195,56,89,24,65
"2011","Dudley 028B","E01009723","Total",466,91,8,83,163,47,103,25,78
"2011","Dudley 028C","E01009724","Total",623,130,9,121,177,69,123,19,104
"2011","Dudley 028D","E01009730","Total",606,88,7,81,210,70,103,23,80
"2011","Dudley 029A","E01009903","Total",621,230,6,224,155,55,133,19,114
"2011","Dudley 029B","E01009904","Total",625,241,5,236,149,58,191,24,167
"2011","Dudley 029C","E01009909","Total",630,269,12,257,141,52,205,22,183
"2011","Dudley 029D","E01009910","Total",711,329,49,280,196,86,229,26,203
"2011","Dudley 030A","E01009793","Total",527,135,13,122,194,54,121,33,88
"2011","Dudley 030B","E01009794","Total",629,269,9,260,154,63,189,23,166
"2011","Dudley 030C","E01009797","Total",645,275,16,259,152,54,196,22,174
"2011","Dudley 030D","E01009801","Total",667,247,7,240,177,59,174,15,159
"2011","Dudley 031A","E01009721","Total",866,293,31,262,207,99,235,29,206
"2011","Dudley 031B","E01009725","Total",595,237,65,172,220,92,172,49,123
"2011","Dudley 031C","E01009726","Total",535,140,11,129,159,61,131,24,107
"2011","Dudley 031D","E01009834","Total",694,270,32,238,194,87,212,35,177
"2011","Dudley 032A","E01009833","Total",498,197,59,138,193,102,142,45,97
"2011","Dudley 032B","E01009835","Total",498,136,37,99,217,101,116,40,76
"2011","Dudley 032C","E01009869","Total",675,177,19,158,194,68,157,26,131
"2011","Dudley 032D","E01009870","Total",668,139,10,129,134,46,112,17,95
"2011","Dudley 033A","E01009809","Total",669,280,57,223,226,98,245,52,193
"2011","Dudley 033B","E01009813","Total",638,231,32,199,218,91,188,40,148
"2011","Dudley 033C","E01009861","Total",646,204,42,162,204,86,160,36,124
"2011","Dudley 033D","E01009862","Total",724,266,50,216,218,100,215,42,173
"2011","Dudley 033E","E01009863","Total",702,184,57,127,284,130,148,47,101
"2011","Dudley 033F","E01009868","Total",671,242,36,206,211,105,186,46,140
"2011","Dudley 034A","E01009734","Total",686,277,28,249,172,66,224,25,199
"2011","Dudley 034B","E01009735","Total",631,166,12,154,192,62,119,23,96
"2011","Dudley 034C","E01009736","Total",602,224,14,210,156,56,133,22,111
"2011","Dudley 034D","E01009737","Total",664,229,11,218,159,58,168,25,143
"2011","Dudley 034E","E01009738","Total",607,230,29,201,207,80,202,40,162
"2011","Dudley 035A","E01009856","Total",901,331,36,295,249,104,255,35,220
"2011","Dudley 035B","E01009905","Total",647,201,13,188,151,54,146,24,122
"2011","Dudley 035C","E01009906","Total",860,373,35,338,179,76,311,37,274
"2011","Dudley 035D","E01009907","Total",637,201,24,177,190,75,148,27,121
"2011","Dudley 035E","E01009908","Total",679,167,12,155,212,76,156,30,126
"2011","Dudley 036A","E01009800","Total",635,253,9,244,178,53,175,15,160
"2011","Dudley 036B","E01009802","Total",668,247,19,228,211,74,183,34,149
"2011","Dudley 036C","E01009803","Total",653,252,5,247,170,53,164,29,135
"2011","Dudley 036D","E01009804","Total",534,145,5,140,129,35,110,17,93
"2011","Dudley 037A","E01009831","Total",638,283,35,248,168,60,246,41,205
"2011","Dudley 037B","E01009836","Total",859,432,98,334,240,143,314,51,263
"2011","Dudley 037C","E01009837","Total",618,221,45,176,191,87,180,45,135
"2011","Dudley 037D","E01009838","Total",658,257,56,201,228,91,204,46,158
"2011","Dudley 038A","E01009847","Total",607,211,11,200,166,50,161,24,137
"2011","Dudley 038B","E01009848","Total",622,220,20,200,180,64,176,27,149
"2011","Dudley 038C","E01009849","Total",653,227,32,195,189,57,204,32,172
"2011","Dudley 038D","E01009851","Total",625,229,7,222,155,48,173,25,148
"2011","Dudley 039A","E01009732","Total",719,239,32,207,205,80,200,42,158
"2011","Dudley 039B","E01009733","Total",929,471,91,380,224,123,311,38,273
"2011","Dudley 039C","E01009739","Total",640,207,30,177,209,84,178,44,134
"2011","Dudley 039D","E01009799","Total",658,260,15,245,170,57,184,23,161
"2011","Dudley 039E","E01009805","Total",613,201,17,184,149,45,141,22,119
"2011","Dudley 039F","E01009806","Total",672,215,15,200,142,43,171,24,147
"2011","Dudley 040A","E01009854","Total",632,217,3,214,158,46,124,15,109
"2011","Dudley 040B","E01009857","Total",694,266,40,226,211,94,201,43,158
"2011","Dudley 040C","E01009858","Total",593,225,8,217,110,38,157,15,142
"2011","Dudley 040D","E01009859","Total",643,183,6,177,193,68,140,21,119
"2011","Dudley 041A","E01009845","Total",628,233,4,229,159,44,150,9,141
"2011","Dudley 041B","E01009846","Total",617,243,22,221,160,48,191,32,159
"2011","Dudley 041C","E01009850","Total",664,231,6,225,165,68,166,25,141
"2011","Dudley 041D","E01009852","Total",601,240,7,233,153,46,141,18,123
"2011","Dudley 042A","E01009832","Total",659,287,63,224,233,93,231,47,184
"2011","Dudley 042B","E01009853","Total",628,284,2,282,117,38,160,12,148
"2011","Dudley 042C","E01009855","Total",637,249,5,244,157,52,156,24,132
"2011","Dudley 042D","E01009860","Total",646,245,11,234,144,49,169,25,144
"2011","Dudley 043A","E01009807","Total",755,328,2,326,201,62,218,25,193
"2011","Dudley 043B","E01009808","Total",602,179,4,175,159,43,140,21,119
"2011","Dudley 043C","E01009810","Total",764,314,24,290,201,69,219,35,184
"2011","Dudley 043D","E01009811","Total",663,243,18,225,190,60,162,18,144
"2011","Dudley 043E","E01009812","Total",577,157,6,151,190,60,139,21,118
"2011","Sandwell 001A","E01010085","Total",606,192,26,166,184,75,155,29,126
"2011","Sandwell 001B","E01010086","Total",690,257,49,208,257,108,225,54,171
"2011","Sandwell 001C","E01010087","Total",615,223,53,170,248,87,181,59,122
"2011","Sandwell 001D","E01010088","Total",557,171,44,127,207,91,155,39,116
"2011","Sandwell 001E","E01010089","Total",697,268,71,197,272,96,233,60,173
"2011","Sandwell 002A","E01009969","Total",774,254,81,173,327,148,216,67,149
"2011","Sandwell 002B","E01009970","Total",629,266,37,229,200,67,211,42,169
"2011","Sandwell 002C","E01009971","Total",670,259,62,197,267,104,219,54,165
"2011","Sandwell 002D","E01009973","Total",761,144,33,111,373,168,197,81,116
"2011","Sandwell 003A","E01009960","Total",649,289,36,253,193,88,234,43,191
"2011","Sandwell 003B","E01009961","Total",534,190,6,184,138,47,139,25,114
"2011","Sandwell 003C","E01009966","Total",467,195,64,131,188,82,152,43,109
"2011","Sandwell 003D","E01009967","Total",770,275,46,229,252,126,206,44,162
"2011","Sandwell 003E","E01010092","Total",781,307,39,268,259,99,237,47,190
"2011","Sandwell 004A","E01009962","Total",499,212,59,153,185,75,177,41,136
"2011","Sandwell 004B","E01009963","Total",497,207,58,149,191,74,162,36,126
"2011","Sandwell 004C","E01009964","Total",564,245,88,157,234,95,180,58,122
"2011","Sandwell 004D","E01009965","Total",471,200,78,122,230,88,152,55,97
"2011","Sandwell 005A","E01010090","Total",708,301,69,232,218,93,204,52,152
"2011","Sandwell 005B","E01010091","Total",634,253,23,230,168,70,216,31,185
"2011","Sandwell 005C","E01010096","Total",714,375,30,345,149,55,282,29,253
"2011","Sandwell 005D","E01010097","Total",731,323,30,293,177,69,240,32,208
"2011","Sandwell 006A","E01009968","Total",646,225,15,210,156,57,153,22,131
"2011","Sandwell 006B","E01009972","Total",723,282,9,273,204,70,197,26,171
"2011","Sandwell 006C","E01009974","Total",608,203,7,196,156,41,161,19,142
"2011","Sandwell 006D","E01009975","Total",658,239,16,223,189,59,181,33,148
"2011","Sandwell 007A","E01010030","Total",654,342,78,264,213,90,222,40,182
"2011","Sandwell 007B","E01010034","Total",507,76,10,66,178,48,87,18,69
"2011","Sandwell 007C","E01010035","Total",589,210,10,200,131,39,141,20,121
"2011","Sandwell 007D","E01010036","Total",615,188,74,114,286,128,151,53,98
"2011","Sandwell 009A","E01009982","Total",528,199,62,137,233,88,154,41,113
"2011","Sandwell 009B","E01009983","Total",570,236,50,186,196,83,172,49,123
"2011","Sandwell 009C","E01010029","Total",536,289,80,209,208,85,172,38,134
"2011","Sandwell 009D","E01010037","Total",407,174,55,119,179,71,131,39,92
"2011","Sandwell 010A","E01009991","Total",797,301,71,230,318,136,222,51,171
"2011","Sandwell 010B","E01009994","Total",620,243,50,193,201,75,194,51,143
"2011","Sandwell 010C","E01009995","Total",612,223,56,167,228,114,163,37,126
"2011","Sandwell 010D","E01009996","Total",654,299,53,246,200,78,241,46,195
"2011","Sandwell 010E","E01009997","Total",627,204,51,153,251,111,181,49,132
"2011","Sandwell 010F","E01009998","Total",772,301,81,220,311,153,254,64,190
"2011","Sandwell 011A","E01010008","Total",627,239,23,216,207,71,174,38,136
"2011","Sandwell 011B","E01010010","Total",598,243,48,195,172,69,191,46,145
"2011","Sandwell 011C","E01010011","Total",688,215,17,198,205,76,152,26,126
"2011","Sandwell 011D","E01010012","Total",564,205,9,196,163,64,165,30,135
"2011","Sandwell 012A","E01010007","Total",507,169,20,149,171,66,143,30,113
"2011","Sandwell 012B","E01010009","Total",541,180,22,158,202,70,167,41,126
"2011","Sandwell 012C","E01010013","Total",513,198,17,181,141,47,136,24,112
"2011","Sandwell 012D","E01010014","Total",713,265,13,252,176,64,190,31,159
"2011","Sandwell 013A","E01010093","Total",477,188,26,162,144,55,149,28,121
"2011","Sandwell 013B","E01010094","Total",485,118,29,89,198,75,150,44,106
"2011","Sandwell 013C","E01010095","Total",488,170,48,122,190,79,143,39,104
"2011","Sandwell 013D","E01010098","Total",748,384,50,334,220,93,312,51,261
"2011","Sandwell 013E","E01010099","Total",655,233,32,201,199,83,190,38,152
"2011","Sandwell 013F","E01010100","Total",666,199,30,169,218,108,181,45,136
"2011","Sandwell 014A","E01009978","Total",625,250,51,199,214,73,211,54,157
"2011","Sandwell 014B","E01010031","Total",720,343,80,263,229,127,212,31,181
"2011","Sandwell 014C","E01010032","Total",467,203,103,100,244,115,170,59,111
"2011","Sandwell 014D","E01010033","Total",767,392,58,334,189,86,249,37,212
"2011","Sandwell 014E","E01010074","Total",953,308,74,234,323,161,221,49,172
"2011","Sandwell 015A","E01010066","Total",651,344,44,300,187,88,265,37,228
"2011","Sandwell 015B","E01010067","Total",641,260,59,201,213,120,191,47,144
"2011","Sandwell 015C","E01010068","Total",620,224,36,188,203,90,190,43,147
"2011","Sandwell 015D","E01010070","Total",719,263,34,229,189,86,224,29,195
"2011","Sandwell 015E","E01010075","Total",446,61,19,42,238,96,85,35,50
"2011","Sandwell 015F","E01010076","Total",578,317,48,269,151,71,229,31,198
"2011","Sandwell 016A","E01009976","Total",980,176,37,139,362,173,174,45,129
"2011","Sandwell 016B","E01009977","Total",711,194,43,151,257,118,152,34,118
"2011","Sandwell 016C","E01009979","Total",797,445,61,384,171,65,339,46,293
"2011","Sandwell 016D","E01009980","Total",825,256,63,193,313,143,219,56,163
"2011","Sandwell 016E","E01010069","Total",627,131,34,97,271,120,145,39,106
"2011","Sandwell 016F","E01010071","Total",682,241,52,189,234,101,209,42,167
"2011","Sandwell 017A","E01009947","Total",788,291,42,249,234,85,232,39,193
"2011","Sandwell 017B","E01009992","Total",615,223,46,177,242,90,177,37,140
"2011","Sandwell 017C","E01009993","Total",715,306,75,231,247,114,237,61,176
"2011","Sandwell 017D","E01010103","Total",782,334,65,269,250,119,261,44,217
"2011","Sandwell 017E","E01010104","Total",827,417,33,384,157,65,314,35,279
"2011","Sandwell 017F","E01010105","Total",517,152,22,130,180,81,149,38,111
"2011","Sandwell 018A","E01009981","Total",716,298,65,233,248,122,249,65,184
"2011","Sandwell 018C","E01009985","Total",674,312,53,259,221,101,234,56,178
"2011","Sandwell 018E","E01032887","Total",979,399,97,302,365,179,330,93,237
"2011","Sandwell 019A","E01009986","Total",453,181,34,147,164,71,134,34,100
"2011","Sandwell 019B","E01009987","Total",471,223,58,165,168,93,176,42,134
"2011","Sandwell 019C","E01009989","Total",642,284,49,235,210,105,224,49,175
"2011","Sandwell 019D","E01010106","Total",486,176,38,138,178,96,162,40,122
"2011","Sandwell 020A","E01009988","Total",734,348,61,287,243,106,278,60,218
"2011","Sandwell 020B","E01010101","Total",872,404,39,365,201,95,272,31,241
"2011","Sandwell 020C","E01010102","Total",683,310,42,268,214,93,243,39,204
"2011","Sandwell 020D","E01010107","Total",663,301,65,236,228,108,212,53,159
"2011","Sandwell 021A","E01010015","Total",619,202,22,180,206,94,186,38,148
"2011","Sandwell 021B","E01010016","Total",578,161,44,117,240,105,148,53,95
"2011","Sandwell 021C","E01010018","Total",862,257,66,191,314,157,223,52,171
"2011","Sandwell 021D","E01010072","Total",931,261,74,187,355,207,217,63,154
"2011","Sandwell 021E","E01010073","Total",593,180,57,123,206,86,151,40,111
"2011","Sandwell 022A","E01010077","Total",651,285,49,236,213,96,210,36,174
"2011","Sandwell 022B","E01010079","Total",612,176,18,158,190,87,123,18,105
"2011","Sandwell 022C","E01010080","Total",695,271,103,168,297,167,184,51,133
"2011","Sandwell 022D","E01010081","Total",626,167,11,156,186,59,131,20,111
"2011","Sandwell 022E","E01010082","Total",852,182,33,149,347,143,184,56,128
"2011","Sandwell 022F","E01010083","Total",674,238,41,197,237,99,192,47,145
"2011","Sandwell 022G","E01010084","Total",546,216,79,137,255,107,146,43,103
"2011","Sandwell 023A","E01010046","Total",581,208,94,114,332,166,170,81,89
"2011","Sandwell 023B","E01010047","Total",564,188,48,140,241,129,170,59,111
"2011","Sandwell 023C","E01010048","Total",514,176,48,128,218,106,132,50,82
"2011","Sandwell 023D","E01010049","Total",568,224,53,171,197,102,161,37,124
"2011","Sandwell 023E","E01010050","Total",496,173,31,142,192,80,161,44,117
"2011","Sandwell 023F","E01010052","Total",475,195,46,149,202,111,161,50,111
"2011","Sandwell 023G","E01010053","Total",576,232,89,143,299,132,197,77,120
"2011","Sandwell 024A","E01010017","Total",841,367,56,311,223,115,291,47,244
"2011","Sandwell 024B","E01010019","Total",621,233,70,163,245,134,197,69,128
"2011","Sandwell 024C","E01010020","Total",668,259,63,196,263,118,213,54,159
"2011","Sandwell 024D","E01010021","Total",654,238,56,182,248,104,200,41,159
"2011","Sandwell 025A","E01010039","Total",499,188,53,135,209,91,158,42,116
"2011","Sandwell 025B","E01010043","Total",592,200,14,186,174,53,154,31,123
"2011","Sandwell 025C","E01010044","Total",582,239,48,191,197,82,166,28,138
"2011","Sandwell 025D","E01010078","Total",517,197,8,189,108,30,132,14,118
"2011","Sandwell 026A","E01010059","Total",612,167,62,105,291,140,140,61,79
"2011","Sandwell 026B","E01010061","Total",523,180,68,112,261,126,137,46,91
"2011","Sandwell 026C","E01010062","Total",659,330,69,261,221,103,264,53,211
"2011","Sandwell 026D","E01010063","Total",775,384,158,226,343,179,253,85,168
"2011","Sandwell 026E","E01010064","Total",683,289,63,226,266,137,229,51,178
"2011","Sandwell 026F","E01010065","Total",845,232,117,115,444,240,194,87,107
"2011","Sandwell 027A","E01009934","Total",590,244,53,191,208,88,192,45,147
"2011","Sandwell 027B","E01009935","Total",885,423,58,365,261,128,305,44,261
"2011","Sandwell 027C","E01009936","Total",669,225,14,211,185,59,169,28,141
"2011","Sandwell 027D","E01010004","Total",773,315,41,274,177,80,244,34,210
"2011","Sandwell 028A","E01010054","Total",868,471,80,391,245,132,350,46,304
"2011","Sandwell 028B","E01010055","Total",643,200,62,138,263,139,152,53,99
"2011","Sandwell 028C","E01010056","Total",629,275,52,223,215,91,243,45,198
"2011","Sandwell 028D","E01010057","Total",658,290,61,229,247,110,248,53,195
"2011","Sandwell 028E","E01010060","Total",689,269,71,198,268,142,186,46,140
"2011","Sandwell 029A","E01010038","Total",669,239,65,174,268,122,169,42,127
"2011","Sandwell 029B","E01010040","Total",572,229,26,203,176,62,164,43,121
"2011","Sandwell 029C","E01010041","Total",744,365,72,293,235,101,223,50,173
"2011","Sandwell 029D","E01010045","Total",625,234,50,184,226,78,183,39,144
"2011","Sandwell 030A","E01010000","Total",674,270,28,242,179,61,209,35,174
"2011","Sandwell 030B","E01010002","Total",817,205,31,174,298,137,187,45,142
"2011","Sandwell 030C","E01010003","Total",712,337,56,281,183,86,252,30,222
"2011","Sandwell 030D","E01010005","Total",572,186,31,155,184,90,149,24,125
"2011","Sandwell 030E","E01010006","Total",640,206,22,184,214,75,182,31,151
"2011","Sandwell 031A","E01009938","Total",668,245,41,204,230,80,225,55,170
"2011","Sandwell 031B","E01009943","Total",478,174,50,124,198,72,163,43,120
"2011","Sandwell 031C","E01009944","Total",575,244,57,187,216,80,197,49,148
"2011","Sandwell 031D","E01010051","Total",465,176,34,142,175,67,146,26,120
"2011","Sandwell 031E","E01010058","Total",681,267,43,224,218,81,209,41,168
"2011","Sandwell 032A","E01009937","Total",599,220,51,169,231,75,194,47,147
"2011","Sandwell 032B","E01009939","Total",669,216,22,194,234,88,194,46,148
"2011","Sandwell 032C","E01009940","Total",618,248,42,206,200,72,208,48,160
"2011","Sandwell 032D","E01009941","Total",596,223,29,194,195,78,193,34,159
"2011","Sandwell 032E","E01009942","Total",627,232,52,180,231,78,224,54,170
"2011","Sandwell 033A","E01009929","Total",723,338,69,269,250,104,258,50,208
"2011","Sandwell 033B","E01009930","Total",634,271,47,224,209,79,194,41,153
"2011","Sandwell 033C","E01009931","Total",900,220,25,195,283,127,221,44,177
"2011","Sandwell 033D","E01009932","Total",809,374,33,341,206,96,296,22,274
"2011","Sandwell 033E","E01009999","Total",527,183,33,150,182,68,137,30,107
"2011","Sandwell 034A","E01009921","Total",715,187,22,165,192,103,133,23,110
"2011","Sandwell 034B","E01009922","Total",503,168,23,145,170,58,138,19,119
"2011","Sandwell 034C","E01009924","Total",616,143,14,129,163,93,127,19,108
"2011","Sandwell 034D","E01009925","Total",560,126,7,119,166,74,124,22,102
"2011","Sandwell 034E","E01009926","Total",615,155,25,130,190,98,146,26,120
"2011","Sandwell 034F","E01009927","Total",714,193,18,175,190,110,157,22,135
"2011","Sandwell 034G","E01009928","Total",756,214,64,150,243,128,182,44,138
"2011","Sandwell 035A","E01009933","Total",541,174,43,131,212,90,152,42,110
"2011","Sandwell 035B","E01009952","Total",885,376,73,303,267,144,272,58,214
"2011","Sandwell 035C","E01009955","Total",812,303,41,262,212,105,235,48,187
"2011","Sandwell 035D","E01009956","Total",678,251,35,216,214,95,214,30,184
"2011","Sandwell 035E","E01009959","Total",591,174,10,164,166,57,137,16,121
"2011","Sandwell 035F","E01010042","Total",775,301,46,255,231,110,235,54,181
"2011","Sandwell 036A","E01009923","Total",574,194,21,173,181,58,165,33,132
"2011","Sandwell 036B","E01010024","Total",618,213,7,206,169,54,153,25,128
"2011","Sandwell 036C","E01010026","Total",704,282,27,255,212,75,251,47,204
"2011","Sandwell 036D","E01010027","Total",587,169,8,161,194,66,141,35,106
"2011","Sandwell 037A","E01010001","Total",705,324,44,280,222,89,272,57,215
"2011","Sandwell 037B","E01010022","Total",620,210,24,186,194,69,170,33,137
"2011","Sandwell 037C","E01010023","Total",767,290,21,269,190,63,220,23,197
"2011","Sandwell 037D","E01010025","Total",677,302,42,260,203,82,250,44,206
"2011","Sandwell 037E","E01010028","Total",606,234,40,194,202,75,207,44,163
"2011","Sandwell 038A","E01009953","Total",790,318,35,283,201,83,263,37,226
"2011","Sandwell 038B","E01009954","Total",718,319,45,274,203,78,239,39,200
"2011","Sandwell 038C","E01009957","Total",634,251,84,167,248,129,196,49,147
"2011","Sandwell 038D","E01009958","Total",641,203,13,190,192,49,147,21,126
"2011","Sandwell 039A","E01009946","Total",657,224,15,209,184,75,178,31,147
"2011","Sandwell 039B","E01009948","Total",585,193,9,184,155,44,146,24,122
"2011","Sandwell 039C","E01009949","Total",578,196,6,190,178,67,154,30,124
"2011","Sandwell 039D","E01009950","Total",639,229,27,202,187,56,209,36,173
"2011","Sandwell 039E","E01009951","Total",1004,465,105,360,285,170,304,45,259
"2011","Sandwell 039F","E01032592","Total",714,262,34,228,221,91,203,45,158
"2011","Solihull 001A","E01010118","Total",508,152,17,135,143,44,137,21,116
"2011","Solihull 001B","E01010120","Total",656,256,29,227,152,58,207,22,185
"2011","Solihull 001C","E01010121","Total",605,250,12,238,127,37,165,14,151
"2011","Solihull 001D","E01010122","Total",600,243,12,231,116,33,157,15,142
"2011","Solihull 002A","E01010235","Total",564,217,64,153,221,88,182,55,127
"2011","Solihull 002B","E01010236","Total",665,295,103,192,256,124,191,49,142
"2011","Solihull 002C","E01010239","Total",630,236,53,183,226,80,211,50,161
"2011","Solihull 002D","E01010240","Total",582,238,49,189,196,88,171,31,140
"2011","Solihull 003A","E01010117","Total",533,151,9,142,160,40,125,23,102
"2011","Solihull 003B","E01010119","Total",604,231,5,226,163,45,173,25,148
"2011","Solihull 003C","E01010123","Total",583,205,3,202,159,40,175,16,159
"2011","Solihull 003D","E01010124","Total",619,220,7,213,133,50,175,25,150
"2011","Solihull 004A","E01010146","Total",649,265,70,195,246,82,193,51,142
"2011","Solihull 004B","E01010234","Total",539,258,76,182,199,106,180,37,143
"2011","Solihull 004C","E01010237","Total",760,266,49,217,262,93,204,34,170
"2011","Solihull 004D","E01010238","Total",666,290,63,227,200,91,220,35,185
"2011","Solihull 005A","E01010145","Total",648,283,36,247,179,66,201,35,166
"2011","Solihull 005B","E01010147","Total",641,278,119,159,279,142,165,42,123
"2011","Solihull 005C","E01010148","Total",732,314,90,224,307,123,249,80,169
"2011","Solihull 005D","E01010149","Total",572,194,16,178,154,43,153,26,127
"2011","Solihull 006A","E01010125","Total",711,354,69,285,202,93,258,30,228
"2011","Solihull 006B","E01010129","Total",695,334,88,246,225,101,247,41,206
"2011","Solihull 006C","E01010139","Total",400,153,29,124,124,44,126,24,102
"2011","Solihull 006D","E01010141","Total",656,313,83,230,213,104,185,38,147
"2011","Solihull 007A","E01010140","Total",645,293,75,218,220,90,218,48,170
"2011","Solihull 007B","E01010142","Total",641,323,85,238,231,105,229,49,180
"2011","Solihull 007C","E01010143","Total",658,292,59,233,219,94,218,34,184
"2011","Solihull 007D","E01010144","Total",740,280,31,249,205,93,237,38,199
"2011","Solihull 008A","E01010111","Total",668,289,71,218,230,105,212,45,167
"2011","Solihull 008B","E01010126","Total",661,300,65,235,215,109,194,35,159
"2011","Solihull 008C","E01010127","Total",749,238,52,186,269,134,185,47,138
"2011","Solihull 008D","E01010128","Total",586,216,46,170,215,85,165,40,125
"2011","Solihull 008E","E01010130","Total",820,379,112,267,288,144,258,59,199
"2011","Solihull 008F","E01010131","Total",632,271,62,209,212,88,193,40,153
"2011","Solihull 009A","E01010109","Total",550,158,5,153,148,48,152,32,120
"2011","Solihull 009B","E01010110","Total",574,160,15,145,181,40,138,27,111
"2011","Solihull 009C","E01010112","Total",675,186,37,149,218,87,145,30,115
"2011","Solihull 009D","E01010113","Total",555,220,36,184,162,68,173,34,139
"2011","Solihull 009E","E01010114","Total",730,246,15,231,200,65,219,37,182
"2011","Solihull 010A","E01010157","Total",597,152,10,142,182,72,122,24,98
"2011","Solihull 010B","E01010159","Total",531,166,22,144,197,83,138,38,100
"2011","Solihull 010C","E01010162","Total",623,221,13,208,163,60,161,19,142
"2011","Solihull 010D","E01010163","Total",551,151,15,136,192,68,124,27,97
"2011","Solihull 011A","E01010132","Total",623,257,20,237,173,60,184,32,152
"2011","Solihull 011B","E01010133","Total",696,340,18,322,154,52,216,24,192
"2011","Solihull 011C","E01010134","Total",585,218,16,202,178,61,167,27,140
"2011","Solihull 011D","E01010135","Total",655,254,17,237,165,56,181,22,159
"2011","Solihull 011E","E01010138","Total",601,189,13,176,171,61,133,22,111
"2011","Solihull 012A","E01010136","Total",522,146,12,134,178,59,124,22,102
"2011","Solihull 012B","E01010137","Total",647,302,18,284,140,56,260,23,237
"2011","Solihull 012C","E01010158","Total",637,275,46,229,194,78,250,39,211
"2011","Solihull 012D","E01010160","Total",636,227,17,210,173,57,191,28,163
"2011","Solihull 012E","E01010161","Total",616,197,7,190,183,64,159,26,133
"2011","Solihull 013A","E01010174","Total",655,197,23,174,206,76,160,34,126
"2011","Solihull 013B","E01010175","Total",710,233,11,222,204,60,162,19,143
"2011","Solihull 013C","E01010177","Total",577,208,16,192,163,53,163,26,137
"2011","Solihull 013D","E01010178","Total",894,394,32,362,191,78,299,29,270
"2011","Solihull 014A","E01010172","Total",585,184,5,179,197,49,150,25,125
"2011","Solihull 014B","E01010173","Total",549,162,6,156,190,59,120,25,95
"2011","Solihull 014C","E01010176","Total",473,119,6,113,172,57,82,14,68
"2011","Solihull 014D","E01010179","Total",773,332,9,323,139,47,219,18,201
"2011","Solihull 015A","E01010115","Total",667,177,17,160,190,62,152,29,123
"2011","Solihull 015B","E01010116","Total",522,113,9,104,176,42,93,28,65
"2011","Solihull 015C","E01010227","Total",799,266,5,261,175,61,203,21,182
"2011","Solihull 015D","E01010228","Total",671,208,12,196,209,78,161,33,128
"2011","Solihull 015E","E01010232","Total",954,274,46,228,291,137,214,46,168
"2011","Solihull 016A","E01010195","Total",585,202,5,197,205,77,108,16,92
"2011","Solihull 016B","E01010226","Total",844,414,12,402,134,70,264,10,254
"2011","Solihull 016C","E01010229","Total",553,195,5,190,177,64,132,17,115
"2011","Solihull 016D","E01010230","Total",759,283,39,244,228,96,232,40,192
"2011","Solihull 016E","E01010231","Total",661,229,6,223,204,76,138,16,122
"2011","Solihull 016F","E01010233","Total",763,222,29,193,220,104,212,43,169
"2011","Solihull 017A","E01010108","Total",857,270,12,258,230,79,178,17,161
"2011","Solihull 017B","E01010164","Total",654,202,6,196,159,50,145,17,128
"2011","Solihull 017C","E01010165","Total",712,289,10,279,146,62,211,28,183
"2011","Solihull 017D","E01010167","Total",637,172,13,159,163,54,149,26,123
"2011","Solihull 018A","E01010199","Total",701,225,7,218,256,64,179,36,143
"2011","Solihull 018B","E01010200","Total",663,330,15,315,169,65,226,32,194
"2011","Solihull 018C","E01010201","Total",616,211,7,204,205,57,171,28,143
"2011","Solihull 018D","E01010204","Total",653,281,38,243,148,58,236,35,201
"2011","Solihull 018E","E01010205","Total",543,157,9,148,199,49,133,35,98
"2011","Solihull 018F","E01010206","Total",632,183,17,166,247,84,148,33,115
"2011","Solihull 019A","E01010192","Total",683,236,8,228,162,42,154,17,137
"2011","Solihull 019B","E01010196","Total",624,214,3,211,205,57,139,25,114
"2011","Solihull 019C","E01010197","Total",638,229,3,226,204,46,171,31,140
"2011","Solihull 019D","E01010198","Total",742,318,7,311,163,47,213,17,196
"2011","Solihull 021A","E01010218","Total",634,299,27,272,132,39,229,20,209
"2011","Solihull 021B","E01010219","Total",698,249,20,229,198,71,189,30,159
"2011","Solihull 021C","E01010221","Total",695,266,10,256,146,63,199,24,175
"2011","Solihull 021D","E01010222","Total",618,197,6,191,162,59,145,22,123
"2011","Solihull 022A","E01010191","Total",771,249,10,239,199,51,185,32,153
"2011","Solihull 022B","E01010202","Total",612,204,6,198,203,62,131,24,107
"2011","Solihull 022C","E01010203","Total",747,245,21,224,220,86,183,30,153
"2011","Solihull 022D","E01010209","Total",696,200,20,180,228,86,155,32,123
"2011","Solihull 022E","E01010213","Total",648,218,20,198,194,65,192,31,161
"2011","Solihull 023A","E01010208","Total",643,250,9,241,187,57,183,23,160
"2011","Solihull 023B","E01010210","Total",639,219,4,215,166,39,153,19,134
"2011","Solihull 023C","E01010211","Total",663,303,13,290,130,36,233,27,206
"2011","Solihull 023D","E01010217","Total",630,210,7,203,161,53,153,19,134
"2011","Solihull 024A","E01010190","Total",669,170,6,164,237,69,113,23,90
"2011","Solihull 024B","E01010193","Total",477,100,2,98,192,44,72,19,53
"2011","Solihull 024C","E01010194","Total",653,131,9,122,244,70,86,17,69
"2011","Solihull 024D","E01010207","Total",600,170,8,162,165,43,140,31,109
"2011","Solihull 025A","E01010166","Total",550,187,6,181,183,44,111,20,91
"2011","Solihull 025B","E01010168","Total",793,225,7,218,242,73,176,32,144
"2011","Solihull 025C","E01010169","Total",669,252,7,245,205,56,165,25,140
"2011","Solihull 025D","E01010170","Total",554,133,3,130,212,58,89,27,62
"2011","Solihull 025E","E01010171","Total",535,164,16,148,173,42,127,25,102
"2011","Solihull 026A","E01010151","Total",802,347,12,335,167,51,221,16,205
"2011","Solihull 026B","E01010152","Total",502,134,2,132,177,57,84,18,66
"2011","Solihull 026C","E01010153","Total",618,244,3,241,167,45,131,16,115
"2011","Solihull 026D","E01010154","Total",677,263,6,257,158,43,154,24,130
"2011","Solihull 026E","E01010155","Total",659,237,11,226,180,57,155,20,135
"2011","Solihull 026F","E01010156","Total",630,209,6,203,194,48,137,28,109
"2011","Solihull 027A","E01010212","Total",486,105,5,100,171,47,93,22,71
"2011","Solihull 027B","E01010214","Total",505,129,7,122,138,48,100,17,83
"2011","Solihull 027C","E01010215","Total",675,176,9,167,203,73,133,22,111
"2011","Solihull 027D","E01010216","Total",603,116,11,105,192,75,96,22,74
"2011","Solihull 028A","E01010150","Total",647,223,3,220,205,70,142,24,118
"2011","Solihull 028B","E01010184","Total",615,221,18,203,183,63,159,18,141
"2011","Solihull 028C","E01010185","Total",611,219,8,211,190,40,148,26,122
"2011","Solihull 028D","E01010186","Total",799,232,9,223,277,94,173,36,137
"2011","Solihull 028E","E01010187","Total",510,93,7,86,253,62,87,38,49
"2011","Solihull 028F","E01010188","Total",685,245,1,244,207,51,140,19,121
"2011","Solihull 029A","E01010180","Total",520,162,7,155,162,57,123,17,106
"2011","Solihull 029B","E01010181","Total",749,149,11,138,286,105,133,43,90
"2011","Solihull 029D","E01010183","Total",531,149,8,141,158,47,103,18,85
"2011","Solihull 029E","E01010189","Total",634,179,10,169,205,59,120,16,104
"2011","Solihull 029F","E01032885","Total",665,50,17,33,135,81,35,7,28
"2011","Solihull 029G","E01032886","Total",775,76,11,65,310,131,96,34,62
"2011","Solihull 030A","E01010220","Total",659,198,15,183,234,99,160,37,123
"2011","Solihull 030B","E01010223","Total",486,157,20,137,154,58,122,21,101
"2011","Solihull 030C","E01010225","Total",580,151,15,136,226,77,136,29,107
"2011","Solihull 030D","E01032590","Total",668,196,12,184,226,83,153,30,123
"2011","Walsall 001A","E01010301","Total",631,242,49,193,185,75,200,33,167
"2011","Walsall 001B","E01010303","Total",604,201,20,181,178,65,174,26,148
"2011","Walsall 001C","E01010306","Total",779,202,25,177,259,108,190,44,146
"2011","Walsall 001D","E01010307","Total",675,147,18,129,285,90,153,39,114
"2011","Walsall 002A","E01010302","Total",638,278,36,242,185,73,237,46,191
"2011","Walsall 002B","E01010304","Total",732,304,29,275,181,61,231,30,201
"2011","Walsall 002C","E01010305","Total",523,201,51,150,190,72,151,49,102
"2011","Walsall 002D","E01010308","Total",591,296,26,270,137,46,238,28,210
"2011","Walsall 003A","E01010345","Total",482,192,8,184,97,34,138,11,127
"2011","Walsall 003B","E01010346","Total",525,124,7,117,185,54,124,27,97
"2011","Walsall 003C","E01010347","Total",642,306,58,248,187,80,236,39,197
"2011","Walsall 003D","E01010350","Total",570,161,17,144,209,66,139,36,103
"2011","Walsall 004A","E01010249","Total",737,206,49,157,260,116,181,43,138
"2011","Walsall 004B","E01010250","Total",584,223,16,207,154,57,146,22,124
"2011","Walsall 004C","E01010252","Total",745,275,35,240,230,87,204,35,169
"2011","Walsall 004D","E01010254","Total",617,225,25,200,174,65,169,25,144
"2011","Walsall 005A","E01010348","Total",623,241,24,217,191,71,180,28,152
"2011","Walsall 005B","E01010349","Total",612,305,20,285,125,34,217,23,194
"2011","Walsall 005C","E01010351","Total",743,305,17,288,174,60,233,43,190
"2011","Walsall 005D","E01010352","Total",664,280,13,267,176,46,168,22,146
"2011","Walsall 006A","E01010284","Total",667,304,45,259,189,70,233,35,198
"2011","Walsall 006B","E01010285","Total",737,335,29,306,178,55,235,34,201
"2011","Walsall 006C","E01010286","Total",649,324,82,242,234,86,220,56,164
"2011","Walsall 006D","E01010290","Total",782,410,28,382,156,55,266,29,237
"2011","Walsall 007A","E01010251","Total",517,111,6,105,179,47,108,30,78
"2011","Walsall 007B","E01010253","Total",536,237,24,213,146,48,152,21,131
"2011","Walsall 007C","E01010255","Total",614,271,8,263,116,39,180,20,160
"2011","Walsall 007D","E01010256","Total",668,239,18,221,176,61,187,35,152
"2011","Walsall 007E","E01010257","Total",514,196,5,191,122,42,135,16,119
"2011","Walsall 008A","E01010292","Total",832,389,45,344,174,82,291,26,265
"2011","Walsall 008B","E01010294","Total",667,302,44,258,190,74,237,38,199
"2011","Walsall 008C","E01010296","Total",596,92,12,80,216,64,121,32,89
"2011","Walsall 008D","E01010297","Total",587,204,3,201,162,46,155,22,133
"2011","Walsall 009A","E01010291","Total",548,240,70,170,210,83,178,48,130
"2011","Walsall 009B","E01010293","Total",728,388,38,350,154,62,281,33,248
"2011","Walsall 009C","E01010298","Total",486,165,27,138,147,50,134,25,109
"2011","Walsall 009D","E01010299","Total",604,270,77,193,248,108,193,42,151
"2011","Walsall 009E","E01010300","Total",653,332,62,270,191,89,260,42,218
"2011","Walsall 010A","E01010319","Total",485,101,11,90,172,45,112,21,91
"2011","Walsall 010B","E01010321","Total",636,244,32,212,192,80,187,29,158
"2011","Walsall 010C","E01010353","Total",674,288,31,257,170,62,202,27,175
"2011","Walsall 010D","E01010354","Total",656,269,32,237,175,68,195,36,159
"2011","Walsall 011A","E01010395","Total",508,97,8,89,171,45,109,17,92
"2011","Walsall 011B","E01010397","Total",617,265,73,192,232,95,208,44,164
"2011","Walsall 011C","E01010398","Total",624,144,11,133,213,70,135,38,97
"2011","Walsall 011D","E01010399","Total",637,161,26,135,204,78,163,42,121
"2011","Walsall 012A","E01010282","Total",513,204,67,137,208,90,166,50,116
"2011","Walsall 012B","E01010287","Total",637,264,35,229,174,73,207,31,176
"2011","Walsall 012C","E01010288","Total",630,267,69,198,239,110,205,60,145
"2011","Walsall 012D","E01010289","Total",621,307,90,217,227,97,197,48,149
"2011","Walsall 013B","E01010277","Total",618,260,67,193,226,94,175,32,143
"2011","Walsall 013D","E01010283","Total",692,262,99,163,302,145,197,63,134
"2011","Walsall 013E","E01032889","Total",696,336,112,224,268,125,222,59,163
"2011","Walsall 014A","E01010393","Total",588,215,13,202,165,49,155,24,131
"2011","Walsall 014B","E01010394","Total",531,145,16,129,180,73,150,39,111
"2011","Walsall 014C","E01010396","Total",630,224,23,201,202,85,192,33,159
"2011","Walsall 014D","E01010400","Total",945,464,84,380,247,144,284,31,253
"2011","Walsall 015A","E01010241","Total",1039,403,25,378,233,89,235,33,202
"2011","Walsall 015B","E01010242","Total",801,402,37,365,194,79,277,30,247
"2011","Walsall 015C","E01010243","Total",688,321,10,311,155,49,203,16,187
"2011","Walsall 015D","E01010244","Total",633,290,67,223,242,123,182,35,147
"2011","Walsall 016A","E01010320","Total",594,218,24,194,161,58,180,31,149
"2011","Walsall 016B","E01010322","Total",676,244,33,211,190,82,206,28,178
"2011","Walsall 016C","E01010323","Total",623,247,25,222,168,61,216,31,185
"2011","Walsall 016D","E01010324","Total",659,224,29,195,190,80,182,30,152
"2011","Walsall 017A","E01010271","Total",687,268,93,175,278,132,196,49,147
"2011","Walsall 017B","E01010272","Total",727,355,78,277,212,100,239,35,204
"2011","Walsall 017C","E01010273","Total",627,295,88,207,247,121,205,41,164
"2011","Walsall 017D","E01010295","Total",615,282,54,228,187,78,213,46,167
"2011","Walsall 018B","E01010279","Total",708,318,83,235,253,127,227,50,177
"2011","Walsall 018D","E01010374","Total",631,262,85,177,269,129,193,55,138
"2011","Walsall 018E","E01010375","Total",735,243,90,153,345,178,188,74,114
"2011","Walsall 018F","E01032888","Total",1013,505,137,368,365,157,391,88,303
"2011","Walsall 019A","E01010378","Total",476,130,12,118,146,61,128,19,109
"2011","Walsall 019B","E01010379","Total",559,205,11,194,126,44,165,21,144
"2011","Walsall 019C","E01010382","Total",658,269,31,238,164,64,199,36,163
"2011","Walsall 019D","E01010383","Total",693,327,44,283,184,78,239,27,212
"2011","Walsall 020A","E01010376","Total",488,109,9,100,158,45,117,28,89
"2011","Walsall 020B","E01010377","Total",619,225,27,198,189,69,186,32,154
"2011","Walsall 020C","E01010380","Total",683,297,5,292,123,33,214,23,191
"2011","Walsall 020D","E01010381","Total",661,266,36,230,185,72,193,38,155
"2011","Walsall 021A","E01010267","Total",715,218,21,197,219,98,180,33,147
"2011","Walsall 021B","E01010268","Total",579,202,71,131,267,150,147,52,95
"2011","Walsall 021C","E01010274","Total",605,271,83,188,240,117,205,48,157
"2011","Walsall 021D","E01010275","Total",641,310,61,249,207,94,217,37,180
"2011","Walsall 022A","E01010245","Total",649,254,4,250,172,50,194,27,167
"2011","Walsall 022B","E01010246","Total",623,196,10,186,193,56,162,35,127
"2011","Walsall 022C","E01010247","Total",701,301,17,284,184,55,210,30,180
"2011","Walsall 022D","E01010248","Total",649,228,6,222,179,47,155,26,129
"2011","Walsall 022E","E01010388","Total",560,170,7,163,156,37,135,20,115
"2011","Walsall 023A","E01010258","Total",727,360,108,252,272,133,247,58,189
"2011","Walsall 023B","E01010259","Total",647,242,23,219,188,67,183,33,150
"2011","Walsall 023C","E01010260","Total",674,288,55,233,203,83,237,44,193
"2011","Walsall 023D","E01010266","Total",511,185,66,119,210,87,173,47,126
"2011","Walsall 024A","E01010317","Total",674,282,6,276,142,42,178,26,152
"2011","Walsall 024B","E01010318","Total",770,359,45,314,166,74,223,32,191
"2011","Walsall 024C","E01010325","Total",695,222,24,198,195,77,194,39,155
"2011","Walsall 024D","E01010369","Total",902,389,54,335,198,118,283,52,231
"2011","Walsall 025A","E01010401","Total",620,286,72,214,209,88,195,44,151
"2011","Walsall 025B","E01010403","Total",683,226,82,144,288,129,168,53,115
"2011","Walsall 025C","E01010404","Total",728,237,69,168,265,121,204,65,139
"2011","Walsall 025D","E01010407","Total",628,227,49,178,209,81,177,34,143
"2011","Walsall 025E","E01010408","Total",649,226,64,162,224,98,168,38,130
"2011","Walsall 026A","E01010269","Total",530,215,77,138,251,144,158,54,104
"2011","Walsall 026B","E01010270","Total",674,257,50,207,238,95,230,52,178
"2011","Walsall 026C","E01010362","Total",623,255,77,178,250,102,196,52,144
"2011","Walsall 026D","E01010363","Total",758,280,77,203,259,134,211,52,159
"2011","Walsall 027A","E01010402","Total",668,193,31,162,249,100,187,45,142
"2011","Walsall 027B","E01010405","Total",703,238,45,193,214,95,213,50,163
"2011","Walsall 027C","E01010406","Total",1090,374,79,295,384,215,306,71,235
"2011","Walsall 027D","E01010409","Total",632,228,61,167,220,107,189,44,145
"2011","Walsall 028A","E01010385","Total",642,223,6,217,164,42,136,21,115
"2011","Walsall 028B","E01010386","Total",725,335,5,330,150,41,211,14,197
"2011","Walsall 028C","E01010387","Total",629,227,8,219,178,49,157,30,127
"2011","Walsall 028D","E01010392","Total",656,227,10,217,168,50,165,22,143
"2011","Walsall 029A","E01010326","Total",583,170,16,154,194,69,148,43,105
"2011","Walsall 029B","E01010327","Total",561,152,55,97,279,131,135,52,83
"2011","Walsall 029C","E01010328","Total",534,197,6,191,160,51,136,24,112
"2011","Walsall 029D","E01010330","Total",635,229,35,194,189,87,161,34,127
"2011","Walsall 030A","E01010368","Total",1023,467,81,386,204,118,298,41,257
"2011","Walsall 030B","E01010370","Total",846,343,55,288,230,114,225,43,182
"2011","Walsall 030C","E01010371","Total",886,437,118,319,316,154,250,65,185
"2011","Walsall 030D","E01010372","Total",623,267,37,230,178,88,226,40,186
"2011","Walsall 030E","E01010373","Total",527,149,18,131,175,66,127,28,99
"2011","Walsall 031A","E01010361","Total",556,139,31,108,186,76,117,35,82
"2011","Walsall 031B","E01010364","Total",505,195,64,131,232,97,152,51,101
"2011","Walsall 031C","E01010365","Total",589,280,61,219,210,128,207,42,165
"2011","Walsall 031D","E01010366","Total",664,314,76,238,252,115,235,59,176
"2011","Walsall 031E","E01010367","Total",622,284,70,214,240,117,222,61,161
"2011","Walsall 032A","E01010384","Total",576,175,9,166,187,66,125,29,96
"2011","Walsall 032B","E01010389","Total",591,220,8,212,165,51,147,30,117
"2011","Walsall 032C","E01010390","Total",707,210,1,209,204,83,144,16,128
"2011","Walsall 032D","E01010391","Total",792,222,7,215,249,101,162,26,136
"2011","Walsall 033A","E01010261","Total",658,253,66,187,253,123,182,39,143
"2011","Walsall 033B","E01010263","Total",507,165,52,113,250,115,141,64,77
"2011","Walsall 033C","E01010264","Total",637,243,33,210,200,90,213,41,172
"2011","Walsall 033D","E01010265","Total",641,239,87,152,298,166,175,56,119
"2011","Walsall 034A","E01010336","Total",532,175,29,146,214,99,159,53,106
"2011","Walsall 034B","E01010340","Total",563,231,63,168,255,138,180,51,129
"2011","Walsall 034C","E01010341","Total",481,187,53,134,246,127,146,62,84
"2011","Walsall 034D","E01010342","Total",508,176,77,99,245,130,146,59,87
"2011","Walsall 034E","E01010343","Total",467,155,43,112,232,123,128,57,71
"2011","Walsall 034F","E01010344","Total",599,260,66,194,240,123,180,49,131
"2011","Walsall 035A","E01010331","Total",631,251,5,246,169,58,166,26,140
"2011","Walsall 035B","E01010332","Total",653,209,7,202,190,62,190,35,155
"2011","Walsall 035C","E01010333","Total",646,246,6,240,178,60,169,25,144
"2011","Walsall 035D","E01010334","Total",568,194,3,191,187,64,143,29,114
"2011","Walsall 036A","E01010262","Total",652,208,43,165,230,106,179,45,134
"2011","Walsall 036B","E01010309","Total",739,276,84,192,285,134,218,67,151
"2011","Walsall 036C","E01010311","Total",715,314,57,257,215,115,240,32,208
"2011","Walsall 036D","E01010316","Total",635,258,85,173,253,120,213,54,159
"2011","Walsall 037A","E01010335","Total",643,255,85,170,264,112,191,58,133
"2011","Walsall 037B","E01010337","Total",547,190,25,165,176,78,177,33,144
"2011","Walsall 037C","E01010338","Total",545,162,47,115,254,113,150,44,106
"2011","Walsall 037D","E01010339","Total",522,162,23,139,207,81,147,41,106
"2011","Walsall 038A","E01010310","Total",608,234,73,161,248,90,210,64,146
"2011","Walsall 038B","E01010312","Total",709,282,65,217,261,132,215,54,161
"2011","Walsall 038C","E01010313","Total",548,215,61,154,219,95,168,54,114
"2011","Walsall 038D","E01010314","Total",641,310,53,257,197,86,256,44,212
"2011","Walsall 038E","E01010315","Total",575,241,51,190,176,77,168,32,136
"2011","Walsall 039A","E01010329","Total",651,261,10,251,178,51,178,28,150
"2011","Walsall 039B","E01010355","Total",612,275,15,260,170,40,184,28,156
"2011","Walsall 039C","E01010356","Total",621,234,10,224,176,45,194,34,160
"2011","Walsall 039D","E01010357","Total",770,231,26,205,226,83,171,29,142
"2011","Walsall 039E","E01010358","Total",624,220,15,205,171,48,172,25,147
"2011","Walsall 039F","E01010359","Total",647,198,20,178,223,64,161,26,135
"2011","Walsall 039G","E01010360","Total",614,223,19,204,181,62,168,22,146
"2011","Wolverhampton 001A","E01010434","Total",733,251,52,199,224,91,204,35,169
"2011","Wolverhampton 001B","E01010436","Total",611,194,9,185,134,43,155,15,140
"2011","Wolverhampton 001C","E01010437","Total",487,92,2,90,147,41,98,11,87
"2011","Wolverhampton 001D","E01010438","Total",632,260,19,241,128,52,175,24,151
"2011","Wolverhampton 001E","E01010439","Total",538,234,40,194,172,63,154,31,123
"2011","Wolverhampton 001F","E01010440","Total",710,359,49,310,188,64,295,37,258
"2011","Wolverhampton 001G","E01010441","Total",557,241,65,176,194,75,165,37,128
"2011","Wolverhampton 002A","E01010495","Total",790,342,44,298,217,91,247,39,208
"2011","Wolverhampton 002B","E01010497","Total",468,112,12,100,151,42,103,28,75
"2011","Wolverhampton 002C","E01010499","Total",519,153,27,126,188,60,124,30,94
"2011","Wolverhampton 002D","E01010500","Total",482,190,80,110,246,103,151,53,98
"2011","Wolverhampton 003A","E01010496","Total",646,249,46,203,215,79,197,35,162
"2011","Wolverhampton 003B","E01010498","Total",648,132,13,119,160,56,128,28,100
"2011","Wolverhampton 003C","E01010541","Total",650,287,80,207,233,88,210,39,171
"2011","Wolverhampton 003D","E01010543","Total",604,264,81,183,235,92,191,55,136
"2011","Wolverhampton 004A","E01010456","Total",499,244,151,93,303,148,135,62,73
"2011","Wolverhampton 004B","E01010457","Total",660,246,25,221,200,81,200,33,167
"2011","Wolverhampton 004C","E01010462","Total",639,282,74,208,235,100,186,40,146
"2011","Wolverhampton 004D","E01010481","Total",539,236,100,136,245,118,173,56,117
"2011","Wolverhampton 005A","E01010555","Total",725,344,51,293,187,71,248,34,214
"2011","Wolverhampton 005B","E01010556","Total",607,205,25,180,203,69,186,27,159
"2011","Wolverhampton 005C","E01010557","Total",607,261,13,248,146,38,186,24,162
"2011","Wolverhampton 005D","E01010559","Total",670,331,33,298,163,62,235,28,207
"2011","Wolverhampton 005E","E01010560","Total",775,388,50,338,199,74,286,46,240
"2011","Wolverhampton 006A","E01010435","Total",548,228,72,156,227,120,145,37,108
"2011","Wolverhampton 006B","E01010501","Total",604,233,45,188,205,74,173,37,136
"2011","Wolverhampton 006C","E01010502","Total",512,154,18,136,174,67,116,25,91
"2011","Wolverhampton 006D","E01010503","Total",606,214,29,185,166,64,184,26,158
"2011","Wolverhampton 007A","E01010482","Total",503,235,77,158,204,79,177,55,122
"2011","Wolverhampton 007B","E01010483","Total",496,227,110,117,257,106,168,61,107
"2011","Wolverhampton 007C","E01010484","Total",506,208,75,133,217,88,163,46,117
"2011","Wolverhampton 007D","E01010485","Total",624,277,118,159,299,180,182,73,109
"2011","Wolverhampton 008A","E01010458","Total",785,315,35,280,213,69,271,31,240
"2011","Wolverhampton 008B","E01010459","Total",624,193,26,167,209,82,172,37,135
"2011","Wolverhampton 008C","E01010460","Total",641,206,18,188,213,68,180,38,142
"2011","Wolverhampton 008D","E01010461","Total",616,202,20,182,190,63,159,34,125
"2011","Wolverhampton 008E","E01010566","Total",743,331,38,293,231,97,254,40,214
"2011","Wolverhampton 009A","E01010539","Total",657,187,42,145,227,92,120,21,99
"2011","Wolverhampton 009B","E01010540","Total",618,230,6,224,135,37,168,13,155
"2011","Wolverhampton 009C","E01010542","Total",627,194,31,163,215,79,161,35,126
"2011","Wolverhampton 009D","E01010544","Total",609,240,10,230,164,52,160,28,132
"2011","Wolverhampton 009E","E01010545","Total",659,189,23,166,231,84,157,35,122
"2011","Wolverhampton 010A","E01010554","Total",630,268,13,255,142,35,201,28,173
"2011","Wolverhampton 010B","E01010558","Total",702,304,18,286,173,62,228,20,208
"2011","Wolverhampton 010C","E01010562","Total",740,347,46,301,175,83,243,30,213
"2011","Wolverhampton 010D","E01010563","Total",702,328,64,264,203,87,229,32,197
"2011","Wolverhampton 010E","E01010567","Total",663,281,39,242,189,72,226,36,190
"2011","Wolverhampton 011A","E01010478","Total",518,225,82,143,227,118,133,39,94
"2011","Wolverhampton 011B","E01010479","Total",576,225,67,158,226,85,166,48,118
"2011","Wolverhampton 011C","E01010480","Total",486,144,33,111,201,81,105,21,84
"2011","Wolverhampton 011D","E01010486","Total",635,299,144,155,333,149,206,83,123
"2011","Wolverhampton 012A","E01010474","Total",613,231,44,187,231,83,217,52,165
"2011","Wolverhampton 012B","E01010561","Total",620,214,13,201,187,66,159,26,133
"2011","Wolverhampton 012C","E01010564","Total",782,272,63,209,286,113,233,54,179
"2011","Wolverhampton 012D","E01010565","Total",747,233,18,215,223,73,188,39,149
"2011","Wolverhampton 013A","E01010522","Total",661,243,92,151,278,136,173,61,112
"2011","Wolverhampton 013B","E01010523","Total",611,190,42,148,209,88,180,45,135
"2011","Wolverhampton 013C","E01010524","Total",632,291,66,225,224,96,205,43,162
"2011","Wolverhampton 013D","E01010525","Total",522,178,69,109,228,124,137,47,90
"2011","Wolverhampton 014A","E01010546","Total",526,179,3,176,149,38,125,16,109
"2011","Wolverhampton 014B","E01010547","Total",744,343,13,330,123,50,198,15,183
"2011","Wolverhampton 014C","E01010548","Total",734,394,16,378,133,48,276,21,255
"2011","Wolverhampton 014D","E01010549","Total",616,220,26,194,194,74,180,39,141
"2011","Wolverhampton 014E","E01010553","Total",655,270,14,256,180,63,162,29,133
"2011","Wolverhampton 015A","E01010471","Total",858,404,78,326,243,142,243,33,210
"2011","Wolverhampton 015B","E01010472","Total",781,302,94,208,302,129,228,58,170
"2011","Wolverhampton 015C","E01010473","Total",1193,612,186,426,374,219,337,74,263
"2011","Wolverhampton 015D","E01010475","Total",654,237,38,199,206,80,173,44,129
"2011","Wolverhampton 015E","E01010476","Total",872,336,86,250,257,130,231,49,182
"2011","Wolverhampton 015F","E01010477","Total",701,250,75,175,268,126,198,40,158
"2011","Wolverhampton 016A","E01010526","Total",486,164,64,100,214,126,115,43,72
"2011","Wolverhampton 016B","E01010527","Total",769,317,74,243,253,125,227,57,170
"2011","Wolverhampton 016C","E01010528","Total",503,259,38,221,85,61,151,21,130
"2011","Wolverhampton 016D","E01010529","Total",603,255,48,207,148,82,156,39,117
"2011","Wolverhampton 017A","E01010506","Total",888,291,29,262,145,66,187,28,159
"2011","Wolverhampton 017B","E01010508","Total",708,246,27,219,116,50,197,22,175
"2011","Wolverhampton 017C","E01010510","Total",779,243,21,222,156,65,167,24,143
"2011","Wolverhampton 017D","E01010511","Total",604,207,43,164,190,95,181,42,139
"2011","Wolverhampton 017E","E01010512","Total",632,193,16,177,149,60,162,33,129
"2011","Wolverhampton 018A","E01010442","Total",512,212,51,161,170,69,156,37,119
"2011","Wolverhampton 018B","E01010443","Total",659,313,106,207,278,120,210,72,138
"2011","Wolverhampton 018C","E01010444","Total",594,252,25,227,124,43,183,23,160
"2011","Wolverhampton 018D","E01010445","Total",502,222,81,141,215,82,159,47,112
"2011","Wolverhampton 018E","E01010447","Total",863,349,44,305,213,101,262,33,229
"2011","Wolverhampton 018F","E01010448","Total",709,309,45,264,173,63,216,34,182
"2011","Wolverhampton 019A","E01010509","Total",742,319,34,285,173,74,241,28,213
"2011","Wolverhampton 019B","E01010550","Total",641,218,7,211,161,42,146,23,123
"2011","Wolverhampton 019C","E01010551","Total",785,304,14,290,149,58,193,24,169
"2011","Wolverhampton 019D","E01010552","Total",809,322,28,294,223,69,242,39,203
"2011","Wolverhampton 020A","E01010463","Total",728,279,49,230,196,98,204,47,157
"2011","Wolverhampton 020B","E01010464","Total",844,497,48,449,157,71,288,21,267
"2011","Wolverhampton 020C","E01010465","Total",600,209,53,156,230,112,157,41,116
"2011","Wolverhampton 020D","E01010466","Total",558,222,58,164,220,101,158,52,106
"2011","Wolverhampton 020E","E01010470","Total",624,275,40,235,177,69,179,39,140
"2011","Wolverhampton 020F","E01010521","Total",1068,410,63,347,194,113,200,28,172
"2011","Wolverhampton 021A","E01010487","Total",611,176,8,168,209,76,147,26,121
"2011","Wolverhampton 021B","E01010488","Total",631,283,21,262,158,48,218,27,191
"2011","Wolverhampton 021C","E01010493","Total",623,208,29,179,218,66,154,30,124
"2011","Wolverhampton 021D","E01010504","Total",517,203,6,197,102,35,139,16,123
"2011","Wolverhampton 021E","E01010505","Total",511,151,4,147,130,48,112,19,93
"2011","Wolverhampton 021F","E01010507","Total",638,266,4,262,125,44,167,11,156
"2011","Wolverhampton 022A","E01010418","Total",580,153,16,137,190,66,125,27,98
"2011","Wolverhampton 022B","E01010421","Total",605,301,90,211,236,91,212,59,153
"2011","Wolverhampton 022C","E01010423","Total",660,323,74,249,210,79,232,45,187
"2011","Wolverhampton 022D","E01010424","Total",616,201,28,173,194,83,153,40,113
"2011","Wolverhampton 023A","E01010417","Total",729,351,62,289,217,105,228,36,192
"2011","Wolverhampton 023B","E01010419","Total",576,223,52,171,189,76,177,42,135
"2011","Wolverhampton 023C","E01010420","Total",515,219,45,174,177,71,154,37,117
"2011","Wolverhampton 023D","E01010425","Total",530,198,32,166,167,66,166,34,132
"2011","Wolverhampton 023E","E01010446","Total",709,295,42,253,179,76,236,35,201
"2011","Wolverhampton 026A","E01010467","Total",628,221,35,186,157,54,171,22,149
"2011","Wolverhampton 026B","E01010468","Total",591,186,17,169,179,63,161,26,135
"2011","Wolverhampton 026C","E01010469","Total",598,147,15,132,170,67,126,19,107
"2011","Wolverhampton 026D","E01010516","Total",529,147,15,132,184,65,140,31,109
"2011","Wolverhampton 026E","E01010518","Total",629,226,12,214,178,65,197,30,167
"2011","Wolverhampton 027A","E01010414","Total",960,485,100,385,265,120,352,61,291
"2011","Wolverhampton 027B","E01010415","Total",596,238,101,137,295,144,171,60,111
"2011","Wolverhampton 027C","E01010416","Total",702,363,85,278,228,101,254,54,200
"2011","Wolverhampton 027D","E01010422","Total",643,268,33,235,178,65,210,36,174
"2011","Wolverhampton 028A","E01010489","Total",659,285,27,258,181,57,207,30,177
"2011","Wolverhampton 028B","E01010490","Total",941,473,75,398,231,85,361,46,315
"2011","Wolverhampton 028C","E01010491","Total",627,255,40,215,200,76,188,41,147
"2011","Wolverhampton 028D","E01010492","Total",510,123,14,109,172,57,117,25,92
"2011","Wolverhampton 028E","E01010494","Total",601,187,11,176,210,75,149,35,114
"2011","Wolverhampton 029A","E01010449","Total",921,322,118,204,373,162,258,77,181
"2011","Wolverhampton 029B","E01010450","Total",760,358,77,281,220,96,255,38,217
"2011","Wolverhampton 029C","E01010451","Total",594,162,28,134,211,89,146,34,112
"2011","Wolverhampton 029D","E01010452","Total",700,279,62,217,234,95,224,44,180
"2011","Wolverhampton 029E","E01010455","Total",846,466,112,354,272,137,296,54,242
"2011","Wolverhampton 030A","E01010427","Total",535,187,33,154,190,70,144,35,109
"2011","Wolverhampton 030B","E01010431","Total",477,120,12,108,189,63,141,40,101
"2011","Wolverhampton 030C","E01010432","Total",507,167,18,149,172,50,159,41,118
"2011","Wolverhampton 030D","E01010519","Total",539,128,13,115,188,67,111,26,85
"2011","Wolverhampton 030E","E01010520","Total",664,248,16,232,177,58,182,32,150
"2011","Wolverhampton 031A","E01010513","Total",638,304,9,295,149,53,198,25,173
"2011","Wolverhampton 031B","E01010514","Total",651,170,19,151,222,93,139,34,105
"2011","Wolverhampton 031C","E01010515","Total",669,198,16,182,204,82,169,34,135
"2011","Wolverhampton 031D","E01010517","Total",622,210,35,175,213,74,181,38,143
"2011","Wolverhampton 032A","E01010533","Total",729,307,78,229,253,123,232,51,181
"2011","Wolverhampton 032B","E01010535","Total",641,288,67,221,234,87,200,55,145
"2011","Wolverhampton 032C","E01010536","Total",639,252,21,231,176,51,186,32,154
"2011","Wolverhampton 032D","E01010537","Total",657,266,1,265,138,45,181,17,164
"2011","Wolverhampton 033A","E01010410","Total",793,391,78,313,214,105,270,47,223
"2011","Wolverhampton 033B","E01010411","Total",633,249,50,199,239,97,203,50,153
"2011","Wolverhampton 033C","E01010412","Total",826,284,67,217,275,130,215,40,175
"2011","Wolverhampton 033D","E01010413","Total",727,368,75,293,230,96,254,56,198
"2011","Wolverhampton 034A","E01010531","Total",744,328,37,291,224,97,248,39,209
"2011","Wolverhampton 034B","E01010532","Total",673,268,36,232,218,72,192,44,148
"2011","Wolverhampton 034C","E01010534","Total",475,90,17,73,213,79,122,41,81
"2011","Wolverhampton 034D","E01010538","Total",623,224,39,185,224,79,187,45,142
"2011","Wolverhampton 035A","E01010426","Total",530,177,21,156,147,51,159,42,117
"2011","Wolverhampton 035B","E01010428","Total",508,184,54,130,195,91,118,40,78
"2011","Wolverhampton 035C","E01010429","Total",453,171,29,142,165,58,133,37,96
"2011","Wolverhampton 035D","E01010430","Total",669,270,64,206,241,104,195,60,135
"2011","Wolverhampton 035E","E01010433","Total",430,221,43,178,138,70,147,28,119
"2011","Wolverhampton 035F","E01010453","Total",726,312,100,212,326,139,226,65,161
"2011","Wolverhampton 035G","E01010454","Total",623,279,96,183,238,99,184,52,132
"2011","Wolverhampton 035H","E01010530","Total",532,226,71,155,193,115,141,33,108
"2011","Bromsgrove 001A","E01032138","Total",549,186,4,182,163,52,110,16,94
"2011","Bromsgrove 001B","E01032139","Total",662,211,8,203,247,72,133,21,112
"2011","Bromsgrove 001C","E01032140","Total",705,258,15,243,245,75,149,21,128
"2011","Bromsgrove 001D","E01032141","Total",588,187,11,176,184,46,121,20,101
"2011","Bromsgrove 002A","E01032136","Total",506,131,1,130,144,44,91,16,75
"2011","Bromsgrove 002B","E01032137","Total",650,210,11,199,186,71,166,29,137
"2011","Bromsgrove 002C","E01032168","Total",477,193,9,184,125,40,143,21,122
"2011","Bromsgrove 002D","E01032169","Total",494,155,3,152,103,27,119,10,109
"2011","Bromsgrove 002E","E01032176","Total",903,250,6,244,206,62,210,23,187
"2011","Bromsgrove 003A","E01032126","Total",856,327,12,315,220,67,275,40,235
"2011","Bromsgrove 003B","E01032170","Total",556,122,15,107,210,69,120,38,82
"2011","Bromsgrove 003C","E01032171","Total",624,274,8,266,163,35,206,27,179
"2011","Bromsgrove 003D","E01032172","Total",638,215,20,195,180,56,172,28,144
"2011","Bromsgrove 004A","E01032133","Total",740,303,39,264,206,93,230,46,184
"2011","Bromsgrove 004B","E01032135","Total",638,153,4,149,214,56,124,20,104
"2011","Bromsgrove 004C","E01032145","Total",626,218,4,214,151,55,165,23,142
"2011","Bromsgrove 004D","E01032147","Total",565,280,9,271,101,33,191,14,177
"2011","Bromsgrove 005A","E01032134","Total",626,205,9,196,153,48,179,25,154
"2011","Bromsgrove 005B","E01032146","Total",670,238,6,232,169,45,172,19,153
"2011","Bromsgrove 005C","E01032177","Total",469,135,5,130,121,48,97,14,83
"2011","Bromsgrove 005D","E01032178","Total",543,211,2,209,130,49,136,19,117
"2011","Bromsgrove 006A","E01032142","Total",607,176,8,168,194,68,116,21,95
"2011","Bromsgrove 006B","E01032143","Total",534,164,4,160,153,39,100,16,84
"2011","Bromsgrove 006C","E01032144","Total",764,273,8,265,218,58,175,19,156
"2011","Bromsgrove 006D","E01032149","Total",478,134,4,130,157,48,87,18,69
"2011","Bromsgrove 007A","E01032127","Total",686,180,10,170,190,77,160,33,127
"2011","Bromsgrove 007B","E01032128","Total",616,188,20,168,176,64,151,31,120
"2011","Bromsgrove 007C","E01032129","Total",522,151,26,125,212,59,157,41,116
"2011","Bromsgrove 007D","E01032152","Total",603,240,32,208,173,57,183,33,150
"2011","Bromsgrove 008A","E01032148","Total",437,118,2,116,128,37,90,19,71
"2011","Bromsgrove 008B","E01032150","Total",621,204,4,200,165,53,135,20,115
"2011","Bromsgrove 008C","E01032151","Total",573,169,5,164,152,46,141,21,120
"2011","Bromsgrove 008D","E01032153","Total",609,191,11,180,175,63,144,22,122
"2011","Bromsgrove 008E","E01032155","Total",651,139,2,137,256,84,125,29,96
"2011","Bromsgrove 009A","E01032122","Total",771,219,14,205,234,79,193,37,156
"2011","Bromsgrove 009B","E01032123","Total",657,242,5,237,127,35,184,23,161
"2011","Bromsgrove 009C","E01032124","Total",674,227,15,212,192,65,173,23,150
"2011","Bromsgrove 009D","E01032125","Total",615,201,10,191,166,65,150,18,132
"2011","Bromsgrove 010A","E01032154","Total",663,88,7,81,276,96,87,25,62
"2011","Bromsgrove 010B","E01032159","Total",774,310,12,298,172,67,246,26,220
"2011","Bromsgrove 010C","E01032160","Total",762,255,13,242,172,55,207,23,184
"2011","Bromsgrove 010D","E01032161","Total",620,221,36,185,194,74,188,38,150
"2011","Bromsgrove 011A","E01032156","Total",722,222,20,202,141,66,167,27,140
"2011","Bromsgrove 011B","E01032157","Total",1033,614,21,593,127,55,429,18,411
"2011","Bromsgrove 011C","E01032173","Total",648,159,17,142,218,67,132,30,102
"2011","Bromsgrove 011D","E01032175","Total",659,205,8,197,176,48,170,32,138
"2011","Bromsgrove 012A","E01032158","Total",651,239,4,235,131,43,170,15,155
"2011","Bromsgrove 012B","E01032162","Total",752,254,13,241,257,94,195,35,160
"2011","Bromsgrove 012D","E01033059","Total",582,52,9,43,280,105,73,28,45
"2011","Bromsgrove 012E","E01033061","Total",653,122,5,117,312,135,108,32,76
"2011","Bromsgrove 013A","E01032130","Total",1148,232,42,190,409,191,224,58,166
"2011","Bromsgrove 013B","E01032131","Total",664,236,70,166,273,118,175,45,130
"2011","Bromsgrove 013C","E01032132","Total",960,384,47,337,292,127,332,55,277
"2011","Bromsgrove 013D","E01032174","Total",646,210,38,172,210,87,164,30,134
"2011","Bromsgrove 014C","E01032166","Total",955,326,8,318,209,72,256,34,222
"2011","Bromsgrove 014E","E01033060","Total",439,82,4,78,124,35,79,18,61
"2011","Bromsgrove 014F","E01033062","Total",914,169,4,165,304,84,163,43,120
"2011","Bromsgrove 014G","E01033243","Total",542,110,4,106,139,39,92,16,76
"2011","Malvern Hills 001A","E01032193","Total",912,294,22,272,222,70,233,29,204
"2011","Malvern Hills 001B","E01032212","Total",812,235,9,226,213,68,205,34,171
"2011","Malvern Hills 001C","E01032213","Total",660,214,5,209,134,32,168,25,143
"2011","Malvern Hills 001D","E01032214","Total",1018,430,36,394,244,86,332,41,291
"2011","Malvern Hills 002A","E01032181","Total",891,316,12,304,191,63,216,22,194
"2011","Malvern Hills 002B","E01032190","Total",783,285,16,269,212,60,194,30,164
"2011","Malvern Hills 002C","E01032199","Total",737,257,13,244,201,57,195,26,169
"2011","Malvern Hills 002D","E01032223","Total",824,246,13,233,229,67,157,23,134
"2011","Malvern Hills 003A","E01032179","Total",704,203,15,188,177,51,160,21,139
"2011","Malvern Hills 003B","E01032180","Total",767,256,18,238,180,58,182,25,157
"2011","Malvern Hills 003C","E01032182","Total",801,265,7,258,212,58,196,25,171
"2011","Malvern Hills 003D","E01032183","Total",570,184,3,181,170,45,143,22,121
"2011","Malvern Hills 004A","E01032194","Total",665,281,36,245,168,67,214,32,182
"2011","Malvern Hills 004B","E01032195","Total",752,299,17,282,180,64,221,30,191
"2011","Malvern Hills 004C","E01032196","Total",750,312,14,298,146,41,245,25,220
"2011","Malvern Hills 004D","E01032197","Total",714,288,22,266,164,74,209,18,191
"2011","Malvern Hills 005A","E01032205","Total",471,193,9,184,111,33,133,16,117
"2011","Malvern Hills 005B","E01032206","Total",556,240,7,233,109,41,166,22,144
"2011","Malvern Hills 005C","E01032207","Total",622,200,4,196,164,46,144,23,121
"2011","Malvern Hills 005D","E01032217","Total",644,241,10,231,150,45,187,28,159
"2011","Malvern Hills 006A","E01032188","Total",799,252,34,218,282,103,209,54,155
"2011","Malvern Hills 006B","E01032189","Total",837,286,21,265,228,96,213,32,181
"2011","Malvern Hills 006C","E01032220","Total",668,180,9,171,165,46,148,20,128
"2011","Malvern Hills 006D","E01032221","Total",548,170,8,162,122,26,118,20,98
"2011","Malvern Hills 006E","E01032222","Total",603,171,19,152,193,69,144,27,117
"2011","Malvern Hills 007A","E01032201","Total",648,276,53,223,230,82,183,50,133
"2011","Malvern Hills 007B","E01032202","Total",739,324,63,261,252,101,261,58,203
"2011","Malvern Hills 007C","E01032203","Total",698,261,16,245,165,52,229,30,199
"2011","Malvern Hills 007D","E01032204","Total",655,291,94,197,271,129,224,56,168
"2011","Malvern Hills 008A","E01032191","Total",946,308,7,301,239,79,202,22,180
"2011","Malvern Hills 008B","E01032192","Total",688,276,21,255,175,56,174,17,157
"2011","Malvern Hills 008C","E01032211","Total",792,309,7,302,149,41,212,23,189
"2011","Malvern Hills 009A","E01032184","Total",799,427,12,415,123,29,258,21,237
"2011","Malvern Hills 009B","E01032185","Total",620,296,11,285,142,33,184,24,160
"2011","Malvern Hills 009C","E01032186","Total",526,197,12,185,136,49,136,16,120
"2011","Malvern Hills 009D","E01032187","Total",785,333,35,298,210,97,281,36,245
"2011","Malvern Hills 010A","E01032208","Total",737,304,13,291,110,33,188,20,168
"2011","Malvern Hills 010B","E01032209","Total",571,220,5,215,70,19,131,5,126
"2011","Malvern Hills 010C","E01032210","Total",498,211,6,205,106,37,136,13,123
"2011","Malvern Hills 010D","E01032218","Total",654,220,12,208,156,46,163,25,138
"2011","Malvern Hills 010E","E01032219","Total",769,261,8,253,153,54,141,14,127
"2011","Malvern Hills 011A","E01032198","Total",821,252,10,242,204,54,201,35,166
"2011","Malvern Hills 011B","E01032200","Total",833,285,13,272,212,58,207,26,181
"2011","Malvern Hills 011C","E01032215","Total",556,264,15,249,115,37,195,26,169
"2011","Malvern Hills 011D","E01032216","Total",769,269,9,260,156,51,185,19,166
"2011","Redditch 001A","E01032226","Total",814,202,32,170,253,105,170,42,128
"2011","Redditch 001B","E01032227","Total",467,160,2,158,85,21,98,8,90
"2011","Redditch 001C","E01032243","Total",579,146,2,144,138,44,109,11,98
"2011","Redditch 001D","E01032244","Total",541,167,15,152,150,54,169,35,134
"2011","Redditch 002A","E01032240","Total",554,164,42,122,182,89,148,38,110
"2011","Redditch 002B","E01032241","Total",503,133,44,89,215,104,116,30,86
"2011","Redditch 002C","E01032242","Total",590,147,32,115,181,90,135,26,109
"2011","Redditch 002D","E01032245","Total",665,283,40,243,167,84,208,30,178
"2011","Redditch 003A","E01032232","Total",781,308,66,242,244,98,265,55,210
"2011","Redditch 003B","E01032233","Total",1171,146,34,112,479,235,176,62,114
"2011","Redditch 003C","E01032234","Total",734,290,66,224,243,105,220,54,166
"2011","Redditch 003D","E01032235","Total",755,321,90,231,280,138,258,63,195
"2011","Redditch 004A","E01032224","Total",689,186,48,138,237,122,168,50,118
"2011","Redditch 004B","E01032225","Total",503,211,49,162,172,82,170,39,131
"2011","Redditch 004C","E01032239","Total",690,190,41,149,245,135,170,39,131
"2011","Redditch 004D","E01032262","Total",860,286,73,213,311,138,257,68,189
"2011","Redditch 005A","E01032273","Total",565,130,6,124,155,49,126,18,108
"2011","Redditch 005B","E01032275","Total",606,171,20,151,162,73,160,19,141
"2011","Redditch 005C","E01032277","Total",514,137,37,100,174,61,134,36,98
"2011","Redditch 005D","E01032278","Total",726,284,86,198,267,135,241,57,184
"2011","Redditch 006A","E01032236","Total",807,246,35,211,202,87,229,43,186
"2011","Redditch 006B","E01032237","Total",635,166,10,156,163,65,153,22,131
"2011","Redditch 006C","E01032238","Total",511,136,8,128,148,53,131,24,107
"2011","Redditch 006D","E01032264","Total",641,166,30,136,250,115,160,39,121
"2011","Redditch 007A","E01032255","Total",557,169,5,164,182,62,151,26,125
"2011","Redditch 007B","E01032263","Total",725,252,26,226,206,74,202,42,160
"2011","Redditch 007C","E01032266","Total",675,167,22,145,175,70,159,28,131
"2011","Redditch 007D","E01032274","Total",518,105,3,102,152,59,128,21,107
"2011","Redditch 008A","E01032259","Total",621,200,7,193,169,54,204,34,170
"2011","Redditch 008B","E01032269","Total",758,261,13,248,177,65,211,33,178
"2011","Redditch 008C","E01032270","Total",525,128,2,126,172,49,98,17,81
"2011","Redditch 008D","E01032271","Total",522,122,2,120,174,47,91,22,69
"2011","Redditch 008E","E01032272","Total",535,154,5,149,140,54,144,11,133
"2011","Redditch 009A","E01032253","Total",476,108,11,97,154,57,121,25,96
"2011","Redditch 009B","E01032265","Total",643,232,35,197,230,99,197,39,158
"2011","Redditch 009C","E01032267","Total",637,165,40,125,241,89,160,51,109
"2011","Redditch 009D","E01032268","Total",480,104,7,97,139,38,110,14,96
"2011","Redditch 009E","E01032276","Total",595,112,7,105,178,69,120,18,102
"2011","Redditch 010A","E01032250","Total",514,160,57,103,212,98,145,39,106
"2011","Redditch 010B","E01032251","Total",702,179,53,126,259,122,137,34,103
"2011","Redditch 010C","E01032252","Total",569,254,75,179,225,94,186,44,142
"2011","Redditch 010D","E01032254","Total",606,176,24,152,205,92,164,35,129
"2011","Redditch 011A","E01032256","Total",644,215,27,188,205,69,187,27,160
"2011","Redditch 011B","E01032257","Total",573,118,18,100,195,74,93,20,73
"2011","Redditch 011C","E01032258","Total",705,247,7,240,160,55,201,26,175
"2011","Redditch 011D","E01032260","Total",675,292,43,249,185,73,225,34,191
"2011","Redditch 012A","E01032246","Total",558,162,9,153,170,67,124,23,101
"2011","Redditch 012B","E01032247","Total",637,213,18,195,174,61,174,26,148
"2011","Redditch 012C","E01032248","Total",543,104,3,101,210,60,98,29,69
"2011","Redditch 012D","E01032249","Total",686,148,12,136,210,85,131,28,103
"2011","Redditch 012E","E01032261","Total",583,202,7,195,152,44,157,18,139
"2011","Redditch 013A","E01032228","Total",566,117,4,113,161,49,121,25,96
"2011","Redditch 013B","E01032229","Total",634,175,27,148,194,85,143,25,118
"2011","Redditch 013C","E01032230","Total",596,155,7,148,186,48,133,26,107
"2011","Redditch 013D","E01032231","Total",763,254,14,240,198,77,212,27,185
"2011","Worcester 001A","E01032296","Total",724,203,19,184,184,88,156,25,131
"2011","Worcester 001B","E01032297","Total",663,203,8,195,194,72,156,26,130
"2011","Worcester 001C","E01032298","Total",777,315,1,314,178,66,208,19,189
"2011","Worcester 001D","E01032299","Total",675,160,7,153,184,73,150,25,125
"2011","Worcester 001E","E01032300","Total",655,229,6,223,175,72,159,16,143
"2011","Worcester 002A","E01032303","Total",478,196,54,142,181,87,139,36,103
"2011","Worcester 002B","E01032304","Total",627,283,72,211,215,111,203,42,161
"2011","Worcester 002C","E01032331","Total",663,304,54,250,170,76,234,34,200
"2011","Worcester 002D","E01032332","Total",611,314,66,248,166,91,247,37,210
"2011","Worcester 003A","E01032330","Total",602,153,14,139,139,68,110,9,101
"2011","Worcester 003B","E01032334","Total",1008,148,27,121,357,151,156,42,114
"2011","Worcester 003C","E01032335","Total",575,73,6,67,270,109,82,23,59
"2011","Worcester 003D","E01032336","Total",644,86,13,73,232,95,83,22,61
"2011","Worcester 004A","E01032279","Total",532,131,22,109,177,72,109,26,83
"2011","Worcester 004B","E01032312","Total",669,148,23,125,172,69,151,31,120
"2011","Worcester 004C","E01032327","Total",767,222,12,210,157,60,175,10,165
"2011","Worcester 004D","E01032328","Total",625,202,24,178,188,69,185,28,157
"2011","Worcester 004E","E01032329","Total",871,288,11,277,217,57,228,33,195
"2011","Worcester 005A","E01032301","Total",623,215,23,192,150,78,166,28,138
"2011","Worcester 005B","E01032302","Total",544,218,48,170,161,74,196,36,160
"2011","Worcester 005C","E01032310","Total",596,165,32,133,184,85,156,26,130
"2011","Worcester 005D","E01032311","Total",626,245,64,181,230,90,184,50,134
"2011","Worcester 005E","E01032313","Total",500,195,68,127,200,87,181,47,134
"2011","Worcester 005F","E01032333","Total",760,248,110,138,360,212,174,48,126
"2011","Worcester 006A","E01032314","Total",448,125,4,121,117,34,102,11,91
"2011","Worcester 006B","E01032315","Total",512,180,8,172,107,39,113,9,104
"2011","Worcester 006C","E01032316","Total",498,206,6,200,108,36,116,9,107
"2011","Worcester 006D","E01032317","Total",648,249,5,244,145,48,187,23,164
"2011","Worcester 007A","E01032280","Total",800,218,13,205,174,64,178,16,162
"2011","Worcester 007B","E01032281","Total",632,140,15,125,156,82,121,26,95
"2011","Worcester 007C","E01032282","Total",897,225,23,202,139,69,167,17,150
"2011","Worcester 007E","E01033246","Total",625,218,10,208,100,47,176,12,164
"2011","Worcester 007F","E01033247","Total",600,155,7,148,42,28,98,5,93
"2011","Worcester 008A","E01032337","Total",729,120,5,115,260,104,119,29,90
"2011","Worcester 008B","E01032338","Total",804,101,24,77,352,148,118,35,83
"2011","Worcester 008C","E01032339","Total",618,94,7,87,279,86,105,29,76
"2011","Worcester 009A","E01032318","Total",628,280,88,192,251,122,188,41,147
"2011","Worcester 009B","E01032319","Total",703,249,6,243,161,60,189,24,165
"2011","Worcester 009C","E01032320","Total",655,163,16,147,201,91,138,30,108
"2011","Worcester 009D","E01032321","Total",601,211,37,174,199,78,177,40,137
"2011","Worcester 009E","E01032322","Total",957,424,16,408,160,76,343,27,316
"2011","Worcester 010A","E01032305","Total",688,166,23,143,208,86,149,28,121
"2011","Worcester 010B","E01032306","Total",608,160,38,122,212,101,145,44,101
"2011","Worcester 010C","E01032307","Total",642,228,60,168,247,118,205,58,147
"2011","Worcester 010D","E01032309","Total",641,230,33,197,239,93,192,38,154
"2011","Worcester 011A","E01032285","Total",739,195,11,184,231,96,143,21,122
"2011","Worcester 011B","E01032292","Total",616,132,28,104,199,98,124,34,90
"2011","Worcester 011D","E01032294","Total",580,165,10,155,174,77,143,29,114
"2011","Worcester 011E","E01033248","Total",658,257,15,242,61,38,173,11,162
"2011","Worcester 011F","E01033249","Total",669,239,28,211,114,67,161,18,143
"2011","Worcester 012A","E01032286","Total",650,168,20,148,221,82,148,40,108
"2011","Worcester 012B","E01032287","Total",664,170,16,154,197,70,139,22,117
"2011","Worcester 012C","E01032288","Total",647,204,11,193,188,74,176,25,151
"2011","Worcester 012D","E01032289","Total",625,250,4,246,129,34,165,11,154
"2011","Worcester 012E","E01032290","Total",666,254,17,237,176,64,181,25,156
"2011","Worcester 013A","E01032283","Total",694,243,25,218,199,72,178,36,142
"2011","Worcester 013B","E01032284","Total",826,267,9,258,205,76,178,22,156
"2011","Worcester 013C","E01032295","Total",1157,275,38,237,262,131,208,37,171
"2011","Worcester 013D","E01032308","Total",620,186,8,178,188,65,128,24,104
"2011","Worcester 014A","E01032323","Total",606,174,10,164,208,77,137,29,108
"2011","Worcester 014B","E01032324","Total",613,118,7,111,190,71,104,22,82
"2011","Worcester 014C","E01032325","Total",659,89,13,76,256,93,105,30,75
"2011","Worcester 014D","E01032326","Total",604,178,7,171,185,70,144,21,123
"2011","Wychavon 001A","E01032354","Total",987,289,15,274,302,92,247,46,201
"2011","Wychavon 001B","E01032386","Total",533,158,7,151,141,41,120,21,99
"2011","Wychavon 001C","E01032387","Total",598,196,16,180,156,62,142,19,123
"2011","Wychavon 001D","E01032401","Total",647,227,5,222,142,54,162,14,148
"2011","Wychavon 002A","E01032368","Total",505,191,34,157,164,67,142,37,105
"2011","Wychavon 002B","E01032369","Total",601,187,63,124,248,119,153,40,113
"2011","Wychavon 002C","E01032370","Total",498,147,24,123,171,63,130,31,99
"2011","Wychavon 002D","E01032371","Total",581,206,20,186,164,65,186,26,160
"2011","Wychavon 003A","E01032359","Total",1034,541,20,521,127,51,384,25,359
"2011","Wychavon 003B","E01032360","Total",811,292,27,265,253,93,210,37,173
"2011","Wychavon 003C","E01032361","Total",742,208,6,202,170,72,152,17,135
"2011","Wychavon 004A","E01032357","Total",510,180,14,166,131,54,146,20,126
"2011","Wychavon 004B","E01032358","Total",650,246,20,226,168,64,206,30,176
"2011","Wychavon 004C","E01032365","Total",765,309,42,267,248,90,222,43,179
"2011","Wychavon 004D","E01032367","Total",636,243,12,231,163,52,178,25,153
"2011","Wychavon 005A","E01032362","Total",748,188,10,178,287,92,152,31,121
"2011","Wychavon 005B","E01032363","Total",606,163,3,160,159,35,106,16,90
"2011","Wychavon 005C","E01032364","Total",643,145,2,143,221,55,114,24,90
"2011","Wychavon 005D","E01032366","Total",733,282,12,270,165,60,191,22,169
"2011","Wychavon 006A","E01032399","Total",713,235,16,219,194,67,190,29,161
"2011","Wychavon 006B","E01032400","Total",879,251,21,230,285,96,172,27,145
"2011","Wychavon 006C","E01032404","Total",1003,343,17,326,248,72,245,34,211
"2011","Wychavon 007A","E01032345","Total",585,143,5,138,177,54,96,19,77
"2011","Wychavon 007B","E01032346","Total",539,144,9,135,169,58,104,17,87
"2011","Wychavon 007C","E01032395","Total",502,130,3,127,130,30,104,14,90
"2011","Wychavon 007D","E01032417","Total",617,185,9,176,159,45,153,24,129
"2011","Wychavon 008A","E01032392","Total",653,230,8,222,136,34,164,16,148
"2011","Wychavon 008B","E01032393","Total",639,229,9,220,168,52,139,14,125
"2011","Wychavon 008C","E01032394","Total",487,145,4,141,122,28,94,11,83
"2011","Wychavon 008D","E01032416","Total",433,111,5,106,115,26,100,13,87
"2011","Wychavon 009A","E01032355","Total",493,142,13,129,134,43,119,20,99
"2011","Wychavon 009B","E01032356","Total",459,135,6,129,139,51,99,12,87
"2011","Wychavon 009C","E01032402","Total",538,70,12,58,270,91,54,17,37
"2011","Wychavon 009D","E01032403","Total",595,150,7,143,168,54,131,18,113
"2011","Wychavon 010A","E01032375","Total",509,210,12,198,116,31,127,18,109
"2011","Wychavon 010B","E01032382","Total",532,163,9,154,136,31,137,19,118
"2011","Wychavon 010C","E01032383","Total",594,212,7,205,121,27,136,14,122
"2011","Wychavon 010D","E01032410","Total",570,201,5,196,130,35,132,18,114
"2011","Wychavon 010E","E01032411","Total",649,255,24,231,193,52,191,36,155
"2011","Wychavon 011A","E01032390","Total",538,149,11,138,166,52,129,31,98
"2011","Wychavon 011B","E01032391","Total",444,139,20,119,146,43,121,23,98
"2011","Wychavon 011C","E01032414","Total",647,256,13,243,171,53,189,35,154
"2011","Wychavon 011D","E01032415","Total",505,119,4,115,151,53,110,21,89
"2011","Wychavon 012A","E01032405","Total",600,232,16,216,129,59,164,20,144
"2011","Wychavon 012B","E01032406","Total",781,358,30,328,127,53,265,26,239
"2011","Wychavon 012C","E01032407","Total",618,232,17,215,148,48,198,31,167
"2011","Wychavon 012D","E01032408","Total",613,257,6,251,124,36,174,16,158
"2011","Wychavon 012E","E01032409","Total",673,241,18,223,170,66,226,30,196
"2011","Wychavon 013A","E01032340","Total",585,203,26,177,171,60,169,24,145
"2011","Wychavon 013B","E01032341","Total",522,154,8,146,131,48,135,25,110
"2011","Wychavon 013C","E01032349","Total",631,178,14,164,155,43,156,21,135
"2011","Wychavon 013D","E01032350","Total",465,141,8,133,116,34,114,24,90
"2011","Wychavon 013E","E01032388","Total",555,185,5,180,143,45,159,25,134
"2011","Wychavon 013F","E01032389","Total",535,194,18,176,150,53,161,32,129
"2011","Wychavon 014A","E01032343","Total",1139,307,26,281,269,122,253,40,213
"2011","Wychavon 014B","E01032377","Total",889,346,25,321,209,104,261,24,237
"2011","Wychavon 014C","E01032378","Total",748,271,36,235,221,98,218,37,181
"2011","Wychavon 015A","E01032376","Total",631,187,5,182,163,38,134,17,117
"2011","Wychavon 015B","E01032384","Total",546,168,20,148,161,60,135,27,108
"2011","Wychavon 015C","E01032385","Total",622,323,10,313,83,38,199,12,187
"2011","Wychavon 015D","E01032396","Total",623,112,9,103,263,97,116,30,86
"2011","Wychavon 016A","E01032342","Total",601,147,26,121,221,101,130,40,90
"2011","Wychavon 016B","E01032344","Total",606,195,12,183,163,53,130,27,103
"2011","Wychavon 016C","E01032379","Total",729,166,16,150,259,82,154,30,124
"2011","Wychavon 016D","E01032380","Total",683,274,14,260,159,55,193,26,167
"2011","Wychavon 017A","E01032381","Total",798,244,29,215,245,106,217,27,190
"2011","Wychavon 017B","E01032397","Total",748,273,31,242,199,84,206,37,169
"2011","Wychavon 017C","E01032398","Total",664,91,22,69,279,112,102,35,67
"2011","Wychavon 018A","E01032351","Total",748,371,3,368,103,34,213,10,203
"2011","Wychavon 018B","E01032352","Total",653,229,10,219,145,45,171,21,150
"2011","Wychavon 018C","E01032353","Total",763,316,21,295,163,64,207,26,181
"2011","Wychavon 018D","E01032374","Total",532,159,5,154,146,41,132,15,117
"2011","Wychavon 019A","E01032347","Total",547,180,7,173,168,47,131,16,115
"2011","Wychavon 019B","E01032348","Total",513,169,5,164,138,42,123,17,106
"2011","Wychavon 019C","E01032372","Total",610,197,6,191,169,41,146,22,124
"2011","Wychavon 019D","E01032373","Total",533,177,1,176,123,37,102,10,92
"2011","Wychavon 019E","E01032412","Total",557,197,8,189,124,46,144,18,126
"2011","Wychavon 019F","E01032413","Total",454,167,5,162,121,27,114,16,98
"2011","Wyre Forest 001A","E01032431","Total",656,208,6,202,125,43,144,16,128
"2011","Wyre Forest 001B","E01032432","Total",556,214,16,198,124,43,142,13,129
"2011","Wyre Forest 001C","E01032433","Total",526,150,7,143,158,47,96,16,80
"2011","Wyre Forest 001D","E01032439","Total",599,243,11,232,141,47,159,15,144
"2011","Wyre Forest 001E","E01032440","Total",532,227,18,209,145,52,168,22,146
"2011","Wyre Forest 001F","E01032479","Total",935,394,16,378,194,60,318,33,285
"2011","Wyre Forest 002A","E01032441","Total",527,179,8,171,130,45,116,14,102
"2011","Wyre Forest 002B","E01032442","Total",596,125,13,112,195,70,128,31,97
"2011","Wyre Forest 002C","E01032443","Total",619,283,2,281,114,32,186,13,173
"2011","Wyre Forest 002D","E01032444","Total",511,156,16,140,144,54,118,14,104
"2011","Wyre Forest 002E","E01032445","Total",657,273,33,240,187,79,229,37,192
"2011","Wyre Forest 003A","E01032436","Total",660,221,17,204,172,56,158,20,138
"2011","Wyre Forest 003B","E01032438","Total",657,194,6,188,156,48,165,16,149
"2011","Wyre Forest 003C","E01032446","Total",615,206,9,197,163,51,160,20,140
"2011","Wyre Forest 003D","E01032447","Total",639,124,13,111,182,82,121,23,98
"2011","Wyre Forest 003E","E01032448","Total",476,141,6,135,153,50,123,28,95
"2011","Wyre Forest 004A","E01032434","Total",711,288,94,194,265,137,195,46,149
"2011","Wyre Forest 004B","E01032435","Total",649,245,41,204,177,86,212,42,170
"2011","Wyre Forest 004C","E01032437","Total",735,248,67,181,261,108,189,48,141
"2011","Wyre Forest 004D","E01032450","Total",1101,376,50,326,279,139,306,32,274
"2011","Wyre Forest 005A","E01032430","Total",731,260,18,242,169,63,205,23,182
"2011","Wyre Forest 005B","E01032480","Total",780,273,11,262,196,63,198,23,175
"2011","Wyre Forest 005C","E01032481","Total",796,337,15,322,166,55,258,23,235
"2011","Wyre Forest 005D","E01032482","Total",626,215,6,209,150,47,150,20,130
"2011","Wyre Forest 006A","E01032451","Total",658,253,6,247,139,42,171,16,155
"2011","Wyre Forest 006B","E01032452","Total",636,240,5,235,159,52,157,23,134
"2011","Wyre Forest 006C","E01032453","Total",755,363,44,319,219,83,283,44,239
"2011","Wyre Forest 006D","E01032454","Total",766,264,13,251,161,59,210,25,185
"2011","Wyre Forest 007A","E01032449","Total",721,193,46,147,220,112,174,36,138
"2011","Wyre Forest 007B","E01032464","Total",762,390,42,348,170,73,311,30,281
"2011","Wyre Forest 007C","E01032465","Total",613,271,76,195,234,82,209,54,155
"2011","Wyre Forest 007D","E01032466","Total",661,246,13,233,103,31,178,19,159
"2011","Wyre Forest 007E","E01032467","Total",523,198,8,190,98,33,130,11,119
"2011","Wyre Forest 007F","E01032468","Total",510,183,5,178,98,30,136,18,118
"2011","Wyre Forest 008A","E01032474","Total",832,252,47,205,237,126,179,39,140
"2011","Wyre Forest 008B","E01032475","Total",729,156,20,136,226,106,138,28,110
"2011","Wyre Forest 008C","E01032476","Total",624,218,17,201,167,74,158,18,140
"2011","Wyre Forest 008D","E01032477","Total",519,204,6,198,112,36,128,16,112
"2011","Wyre Forest 008E","E01032478","Total",643,251,44,207,210,82,193,46,147
"2011","Wyre Forest 009A","E01032469","Total",652,273,61,212,231,102,230,53,177
"2011","Wyre Forest 009B","E01032470","Total",784,318,47,271,219,87,246,37,209
"2011","Wyre Forest 009C","E01032471","Total",634,323,113,210,254,126,212,69,143
"2011","Wyre Forest 010A","E01032418","Total",604,167,10,157,139,50,141,24,117
"2011","Wyre Forest 010B","E01032419","Total",576,240,7,233,122,31,167,21,146
"2011","Wyre Forest 010C","E01032420","Total",511,105,13,92,161,58,88,15,73
"2011","Wyre Forest 010D","E01032421","Total",482,122,10,112,155,44,107,20,87
"2011","Wyre Forest 010E","E01032422","Total",644,152,65,87,268,120,142,47,95
"2011","Wyre Forest 011A","E01032427","Total",676,260,10,250,167,62,193,25,168
"2011","Wyre Forest 011B","E01032428","Total",880,319,10,309,126,38,209,12,197
"2011","Wyre Forest 011C","E01032429","Total",679,268,11,257,143,44,161,15,146
"2011","Wyre Forest 011D","E01032472","Total",500,161,5,156,107,36,127,16,111
"2011","Wyre Forest 011E","E01032473","Total",513,179,17,162,141,43,152,28,124
"2011","Wyre Forest 012A","E01032455","Total",631,234,11,223,165,45,183,23,160
"2011","Wyre Forest 012B","E01032456","Total",514,176,30,146,163,68,147,33,114
"2011","Wyre Forest 012C","E01032457","Total",530,193,14,179,177,63,140,29,111
"2011","Wyre Forest 012D","E01032458","Total",611,264,6,258,123,41,194,27,167
"2011","Wyre Forest 012E","E01032459","Total",608,222,20,202,181,61,142,25,117
"2011","Wyre Forest 013A","E01032460","Total",885,337,21,316,212,71,266,25,241
"2011","Wyre Forest 013B","E01032461","Total",926,258,30,228,233,88,208,33,175
"2011","Wyre Forest 013C","E01032462","Total",942,270,35,235,306,135,205,39,166
"2011","Wyre Forest 013D","E01032463","Total",744,305,10,295,147,45,231,22,209
"2011","Wyre Forest 014A","E01032423","Total",669,299,19,280,141,49,202,17,185
"2011","Wyre Forest 014B","E01032424","Total",638,300,65,235,193,88,199,32,167
"2011","Wyre Forest 014C","E01032425","Total",644,276,17,259,142,54,190,19,171
"2011","Wyre Forest 014D","E01032426","Total",666,264,14,250,146,42,195,25,170
"2011","Bedford 001A","E01017540","Total",591,152,8,144,163,41,125,16,109
"2011","Bedford 001B","E01017541","Total",520,146,7,139,152,41,109,20,89
"2011","Bedford 001C","E01017544","Total",577,191,4,187,170,46,146,23,123
"2011","Bedford 001D","E01017545","Total",587,138,10,128,212,52,101,25,76
"2011","Bedford 002A","E01017464","Total",620,207,5,202,163,41,144,15,129
"2011","Bedford 002B","E01017465","Total",616,229,14,215,151,43,139,20,119
"2011","Bedford 002C","E01017503","Total",507,141,9,132,169,59,121,26,95
"2011","Bedford 002D","E01017504","Total",833,243,14,229,276,87,180,34,146
"2011","Bedford 002E","E01017546","Total",505,144,9,135,151,52,120,13,107
"2011","Bedford 002F","E01017547","Total",633,189,11,178,163,41,154,27,127
"2011","Bedford 003A","E01017478","Total",718,216,13,203,217,59,160,26,134
"2011","Bedford 003B","E01017479","Total",624,263,8,255,126,45,185,16,169
"2011","Bedford 003C","E01017480","Total",746,187,25,162,318,129,140,44,96
"2011","Bedford 003D","E01017481","Total",485,156,27,129,176,72,122,27,95
"2011","Bedford 003E","E01017528","Total",948,266,22,244,357,108,208,44,164
"2011","Bedford 004B","E01017495","Total",829,225,18,207,271,114,191,40,151
"2011","Bedford 004C","E01017496","Total",642,220,14,206,161,51,179,21,158
"2011","Bedford 004D","E01017542","Total",589,169,16,153,161,38,129,23,106
"2011","Bedford 004E","E01017543","Total",590,142,3,139,157,54,112,19,93
"2011","Bedford 004F","E01033431","Total",482,80,33,47,272,131,65,35,30
"2011","Bedford 004G","E01033432","Total",925,305,26,279,280,120,198,20,178
"2011","Bedford 005A","E01017453","Total",623,254,16,238,151,62,200,18,182
"2011","Bedford 005B","E01017454","Total",588,192,22,170,176,58,148,32,116
"2011","Bedford 005C","E01017455","Total",651,239,13,226,157,61,164,18,146
"2011","Bedford 005D","E01017456","Total",634,285,8,277,149,33,187,18,169
"2011","Bedford 005E","E01017457","Total",487,167,14,153,162,51,132,27,105
"2011","Bedford 005F","E01017458","Total",514,129,11,118,180,64,118,27,91
"2011","Bedford 006A","E01017529","Total",509,154,11,143,149,52,134,23,111
"2011","Bedford 006B","E01017530","Total",578,197,0,197,141,41,120,13,107
"2011","Bedford 006C","E01017531","Total",583,256,32,224,167,57,207,43,164
"2011","Bedford 006D","E01017532","Total",505,196,6,190,140,38,120,20,100
"2011","Bedford 006E","E01017533","Total",485,160,3,157,104,28,112,14,98
"2011","Bedford 006F","E01017534","Total",644,255,7,248,165,40,155,13,142
"2011","Bedford 007A","E01017488","Total",637,294,11,283,142,48,195,27,168
"2011","Bedford 007B","E01017489","Total",614,234,76,158,273,117,189,50,139
"2011","Bedford 007C","E01017490","Total",611,258,50,208,201,78,201,48,153
"2011","Bedford 007D","E01017491","Total",641,213,7,206,189,76,157,22,135
"2011","Bedford 007E","E01017492","Total",606,212,67,145,231,106,159,34,125
"2011","Bedford 007F","E01017493","Total",653,157,54,103,293,127,129,54,75
"2011","Bedford 008A","E01017459","Total",687,209,9,200,225,76,146,25,121
"2011","Bedford 008B","E01017460","Total",650,172,13,159,207,51,94,7,87
"2011","Bedford 008C","E01017461","Total",734,154,36,118,279,122,104,32,72
"2011","Bedford 008D","E01017462","Total",613,166,3,163,228,67,137,22,115
"2011","Bedford 008E","E01017463","Total",601,254,5,249,134,39,173,22,151
"2011","Bedford 009A","E01017482","Total",621,215,12,203,128,44,147,14,133
"2011","Bedford 009B","E01017483","Total",600,217,7,210,138,50,155,24,131
"2011","Bedford 009C","E01017484","Total",503,169,9,160,72,25,119,10,109
"2011","Bedford 009D","E01017485","Total",622,107,9,98,170,73,101,21,80
"2011","Bedford 010A","E01017497","Total",581,116,26,90,156,69,111,28,83
"2011","Bedford 010B","E01017498","Total",505,132,15,117,162,56,102,18,84
"2011","Bedford 010C","E01017499","Total",599,155,13,142,121,58,130,15,115
"2011","Bedford 010D","E01017500","Total",591,201,19,182,92,48,167,17,150
"2011","Bedford 010E","E01017501","Total",619,272,13,259,93,50,187,19,168
"2011","Bedford 010F","E01017502","Total",842,453,26,427,127,64,333,23,310
"2011","Bedford 011A","E01017524","Total",632,201,16,185,210,71,154,23,131
"2011","Bedford 011B","E01017525","Total",493,158,26,132,159,62,116,18,98
"2011","Bedford 011C","E01017526","Total",604,114,17,97,224,97,102,33,69
"2011","Bedford 011D","E01017527","Total",530,134,18,116,163,65,110,25,85
"2011","Bedford 012A","E01017466","Total",754,222,32,190,207,109,157,24,133
"2011","Bedford 012B","E01017467","Total",613,170,10,160,145,63,144,21,123
"2011","Bedford 012C","E01017468","Total",596,132,13,119,167,73,103,16,87
"2011","Bedford 012D","E01017469","Total",842,225,12,213,166,67,173,19,154
"2011","Bedford 012E","E01017470","Total",503,115,10,105,162,57,101,21,80
"2011","Bedford 012F","E01017471","Total",772,313,25,288,136,83,231,20,211
"2011","Bedford 013A","E01017535","Total",475,145,26,119,206,77,106,27,79
"2011","Bedford 013B","E01017536","Total",820,191,76,115,366,205,160,78,82
"2011","Bedford 013C","E01017537","Total",480,179,37,142,197,92,150,43,107
"2011","Bedford 013D","E01017538","Total",524,175,53,122,251,120,137,58,79
"2011","Bedford 013E","E01017539","Total",502,149,34,115,205,109,132,41,91
"2011","Bedford 014A","E01017518","Total",604,173,43,130,226,113,142,32,110
"2011","Bedford 014B","E01017519","Total",642,267,74,193,233,117,204,47,157
"2011","Bedford 014C","E01017520","Total",625,151,22,129,190,70,145,39,106
"2011","Bedford 014D","E01017521","Total",622,183,30,153,208,87,152,44,108
"2011","Bedford 014E","E01017522","Total",858,313,56,257,221,124,241,38,203
"2011","Bedford 014F","E01017523","Total",589,209,92,117,285,149,169,49,120
"2011","Bedford 015A","E01017472","Total",510,167,61,106,238,124,140,47,93
"2011","Bedford 015B","E01017473","Total",929,177,48,129,294,160,133,36,97
"2011","Bedford 015C","E01017474","Total",628,163,46,117,254,145,148,54,94
"2011","Bedford 015D","E01017475","Total",553,141,24,117,218,96,126,29,97
"2011","Bedford 015E","E01017476","Total",543,184,26,158,172,70,163,37,126
"2011","Bedford 015F","E01017477","Total",518,271,62,209,192,72,189,37,152
"2011","Bedford 016A","E01017509","Total",501,181,25,156,183,64,168,39,129
"2011","Bedford 016B","E01017510","Total",657,187,23,164,181,79,160,27,133
"2011","Bedford 016C","E01017511","Total",485,121,16,105,169,58,118,28,90
"2011","Bedford 016D","E01017512","Total",537,124,24,100,203,82,130,42,88
"2011","Bedford 017A","E01017505","Total",645,217,30,187,190,77,168,39,129
"2011","Bedford 017B","E01017506","Total",664,199,38,161,230,119,173,35,138
"2011","Bedford 017C","E01017507","Total",519,128,24,104,189,65,140,31,109
"2011","Bedford 017D","E01017508","Total",663,169,21,148,214,90,147,34,113
"2011","Bedford 018A","E01017513","Total",549,128,17,111,204,93,117,30,87
"2011","Bedford 018B","E01017514","Total",650,248,44,204,222,93,211,52,159
"2011","Bedford 018C","E01017515","Total",626,237,39,198,214,75,174,40,134
"2011","Bedford 018D","E01017516","Total",559,142,12,130,186,72,133,22,111
"2011","Bedford 018E","E01017517","Total",598,136,23,113,229,80,124,34,90
"2011","Bedford 019A","E01017486","Total",685,180,28,152,258,114,152,39,113
"2011","Bedford 019B","E01017487","Total",672,142,49,93,319,146,138,62,76
"2011","Bedford 019C","E01017548","Total",750,197,44,153,255,129,154,38,116
"2011","Bedford 019D","E01017549","Total",652,257,6,251,139,54,181,23,158
"2011","Bedford 019E","E01017550","Total",988,194,36,158,382,157,181,55,126
"2011","Bedford 020A","E01017551","Total",532,131,14,117,207,56,110,30,80
"2011","Bedford 020B","E01017552","Total",499,144,16,128,162,56,147,30,117
"2011","Bedford 020C","E01017553","Total",482,125,11,114,172,48,102,21,81
"2011","Bedford 020D","E01017554","Total",640,279,19,260,157,47,220,22,198
"2011","Central Bedfordshire 001A","E01017433","Total",648,233,39,194,236,96,210,40,170
"2011","Central Bedfordshire 001B","E01017434","Total",694,175,21,154,220,93,161,24,137
"2011","Central Bedfordshire 001C","E01017436","Total",894,153,12,141,340,131,131,41,90
"2011","Central Bedfordshire 002A","E01017430","Total",600,191,24,167,177,76,164,37,127
"2011","Central Bedfordshire 002B","E01017431","Total",678,191,22,169,180,85,157,32,125
"2011","Central Bedfordshire 002C","E01017432","Total",565,121,6,115,161,51,125,25,100
"2011","Central Bedfordshire 002D","E01017435","Total",713,218,27,191,226,96,177,33,144
"2011","Central Bedfordshire 003A","E01017425","Total",430,110,7,103,113,35,90,12,78
"2011","Central Bedfordshire 003B","E01017426","Total",574,159,6,153,154,53,110,15,95
"2011","Central Bedfordshire 003C","E01017427","Total",719,192,16,176,209,81,162,22,140
"2011","Central Bedfordshire 003D","E01017428","Total",681,198,10,188,216,82,157,25,132
"2011","Central Bedfordshire 003E","E01017429","Total",625,132,7,125,169,64,122,22,100
"2011","Central Bedfordshire 004A","E01017412","Total",611,149,14,135,182,46,134,16,118
"2011","Central Bedfordshire 004B","E01017422","Total",626,201,18,183,171,50,137,31,106
"2011","Central Bedfordshire 004C","E01017423","Total",639,203,8,195,165,59,160,20,140
"2011","Central Bedfordshire 004D","E01017424","Total",568,171,12,159,146,38,119,21,98
"2011","Central Bedfordshire 005A","E01017383","Total",848,174,19,155,248,108,143,27,116
"2011","Central Bedfordshire 005B","E01017384","Total",670,212,30,182,235,106,191,37,154
"2011","Central Bedfordshire 005C","E01017385","Total",849,265,19,246,166,81,209,21,188
"2011","Central Bedfordshire 005D","E01017386","Total",756,186,22,164,243,124,168,27,141
"2011","Central Bedfordshire 005E","E01017387","Total",508,110,13,97,185,60,105,26,79
"2011","Central Bedfordshire 005F","E01017388","Total",555,144,26,118,167,63,139,21,118
"2011","Central Bedfordshire 006A","E01017381","Total",616,203,6,197,153,57,131,19,112
"2011","Central Bedfordshire 006B","E01017382","Total",573,202,18,184,189,58,169,28,141
"2011","Central Bedfordshire 006C","E01017389","Total",739,145,23,122,302,107,135,42,93
"2011","Central Bedfordshire 006D","E01017390","Total",801,234,51,183,300,106,199,45,154
"2011","Central Bedfordshire 007A","E01017379","Total",520,171,9,162,134,49,136,25,111
"2011","Central Bedfordshire 007B","E01017380","Total",517,151,2,149,147,54,94,18,76
"2011","Central Bedfordshire 007C","E01017394","Total",584,153,14,139,200,71,133,29,104
"2011","Central Bedfordshire 007F","E01017397","Total",670,207,16,191,198,79,156,27,129
"2011","Central Bedfordshire 007G","E01033194","Total",775,259,53,206,260,123,156,31,125
"2011","Central Bedfordshire 008A","E01017410","Total",485,150,3,147,123,43,115,14,101
"2011","Central Bedfordshire 008B","E01017411","Total",624,177,13,164,188,63,141,26,115
"2011","Central Bedfordshire 008C","E01017419","Total",604,163,4,159,209,65,121,23,98
"2011","Central Bedfordshire 008D","E01017420","Total",649,207,6,201,183,53,171,25,146
"2011","Central Bedfordshire 008E","E01017421","Total",706,229,10,219,222,61,157,26,131
"2011","Central Bedfordshire 009A","E01017416","Total",781,177,20,157,264,99,159,37,122
"2011","Central Bedfordshire 009B","E01017417","Total",905,158,22,136,373,129,157,45,112
"2011","Central Bedfordshire 009C","E01017418","Total",650,206,23,183,187,63,190,33,157
"2011","Central Bedfordshire 009D","E01017451","Total",582,138,10,128,178,65,124,19,105
"2011","Central Bedfordshire 009E","E01017452","Total",581,243,6,237,112,33,145,9,136
"2011","Central Bedfordshire 010A","E01017376","Total",811,132,13,119,249,121,142,28,114
"2011","Central Bedfordshire 010B","E01017377","Total",760,147,17,130,270,109,130,37,93
"2011","Central Bedfordshire 010C","E01017378","Total",773,249,27,222,227,92,227,45,182
"2011","Central Bedfordshire 010D","E01017413","Total",722,203,8,195,185,54,171,32,139
"2011","Central Bedfordshire 010E","E01017414","Total",720,217,21,196,221,89,161,20,141
"2011","Central Bedfordshire 010F","E01017415","Total",776,206,13,193,250,96,158,33,125
"2011","Central Bedfordshire 011A","E01017437","Total",665,188,26,162,208,83,145,26,119
"2011","Central Bedfordshire 011B","E01017438","Total",670,157,7,150,227,88,148,28,120
"2011","Central Bedfordshire 011C","E01017439","Total",632,122,13,109,267,96,134,35,99
"2011","Central Bedfordshire 011D","E01017440","Total",622,198,27,171,181,93,160,26,134
"2011","Central Bedfordshire 011E","E01017441","Total",620,110,10,100,296,111,117,31,86
"2011","Central Bedfordshire 011F","E01017444","Total",792,228,8,220,222,66,168,25,143
"2011","Central Bedfordshire 012A","E01017371","Total",547,213,3,210,156,46,121,12,109
"2011","Central Bedfordshire 012B","E01017372","Total",647,201,14,187,196,68,166,22,144
"2011","Central Bedfordshire 012C","E01017373","Total",560,118,8,110,228,57,110,27,83
"2011","Central Bedfordshire 012D","E01017374","Total",573,124,5,119,205,66,86,26,60
"2011","Central Bedfordshire 012E","E01017375","Total",639,202,7,195,172,56,160,15,145
"2011","Central Bedfordshire 013A","E01017391","Total",538,137,11,126,188,73,148,28,120
"2011","Central Bedfordshire 013B","E01017392","Total",623,196,5,191,162,43,128,22,106
"2011","Central Bedfordshire 013C","E01017393","Total",680,167,6,161,221,64,136,23,113
"2011","Central Bedfordshire 013D","E01017442","Total",814,163,14,149,277,102,160,34,126
"2011","Central Bedfordshire 013E","E01017443","Total",698,132,13,119,261,135,112,26,86
"2011","Central Bedfordshire 014A","E01017446","Total",726,212,21,191,230,87,182,26,156
"2011","Central Bedfordshire 014B","E01017447","Total",843,205,13,192,284,114,167,32,135
"2011","Central Bedfordshire 014D","E01017449","Total",625,181,9,172,164,66,143,23,120
"2011","Central Bedfordshire 014E","E01033188","Total",577,151,10,141,184,79,133,19,114
"2011","Central Bedfordshire 014F","E01033189","Total",611,79,14,65,252,153,72,26,46
"2011","Central Bedfordshire 014G","E01033190","Total",596,72,13,59,214,148,61,17,44
"2011","Central Bedfordshire 015A","E01017399","Total",570,82,11,71,234,85,74,23,51
"2011","Central Bedfordshire 015B","E01017400","Total",641,266,40,226,200,73,225,38,187
"2011","Central Bedfordshire 015C","E01017401","Total",522,110,8,102,167,46,107,21,86
"2011","Central Bedfordshire 015D","E01017402","Total",654,233,5,228,185,65,149,26,123
"2011","Central Bedfordshire 016A","E01017403","Total",604,159,12,147,196,68,130,28,102
"2011","Central Bedfordshire 016B","E01017404","Total",493,93,3,90,162,50,87,15,72
"2011","Central Bedfordshire 016C","E01017405","Total",611,117,10,107,177,72,109,21,88
"2011","Central Bedfordshire 016D","E01017406","Total",631,103,8,95,221,76,92,19,73
"2011","Central Bedfordshire 016E","E01017407","Total",681,123,5,118,193,77,119,25,94
"2011","Central Bedfordshire 017A","E01017398","Total",932,245,17,228,297,102,189,28,161
"2011","Central Bedfordshire 017B","E01017408","Total",416,98,3,95,140,43,95,15,80
"2011","Central Bedfordshire 017C","E01017409","Total",505,175,5,170,141,31,136,21,115
"2011","Central Bedfordshire 017D","E01017445","Total",732,213,12,201,218,56,163,24,139
"2011","Central Bedfordshire 017E","E01017450","Total",866,203,16,187,289,102,188,39,149
"2011","Central Bedfordshire 018A","E01017558","Total",737,143,13,130,271,85,124,30,94
"2011","Central Bedfordshire 018B","E01017559","Total",666,224,18,206,231,68,180,39,141
"2011","Central Bedfordshire 018C","E01017560","Total",619,220,7,213,183,61,157,25,132
"2011","Central Bedfordshire 018D","E01017616","Total",952,194,34,160,352,147,154,37,117
"2011","Central Bedfordshire 019A","E01017577","Total",928,259,18,241,244,92,189,30,159
"2011","Central Bedfordshire 019B","E01017615","Total",878,280,10,270,209,47,208,29,179
"2011","Central Bedfordshire 019C","E01017620","Total",740,174,12,162,233,61,152,33,119
"2011","Central Bedfordshire 019D","E01017621","Total",651,205,7,198,210,64,147,29,118
"2011","Central Bedfordshire 019E","E01017622","Total",681,236,34,202,239,76,190,47,143
"2011","Central Bedfordshire 020A","E01017603","Total",641,161,12,149,173,73,132,18,114
"2011","Central Bedfordshire 020B","E01017604","Total",641,119,9,110,227,74,121,26,95
"2011","Central Bedfordshire 020C","E01017605","Total",500,146,60,86,229,110,137,43,94
"2011","Central Bedfordshire 020D","E01017606","Total",644,231,4,227,143,38,150,11,139
"2011","Central Bedfordshire 020E","E01017607","Total",507,158,7,151,145,53,94,20,74
"2011","Central Bedfordshire 021A","E01017555","Total",955,312,35,277,229,103,258,32,226
"2011","Central Bedfordshire 021B","E01017556","Total",672,127,16,111,211,101,113,31,82
"2011","Central Bedfordshire 021C","E01017557","Total",919,379,46,333,191,85,296,30,266
"2011","Central Bedfordshire 021D","E01017608","Total",719,204,25,179,200,86,179,33,146
"2011","Central Bedfordshire 021E","E01017609","Total",683,247,79,168,283,133,175,50,125
"2011","Central Bedfordshire 022A","E01017589","Total",787,189,31,158,186,85,164,21,143
"2011","Central Bedfordshire 022B","E01017590","Total",655,244,8,236,144,53,183,17,166
"2011","Central Bedfordshire 022C","E01017591","Total",733,198,11,187,204,73,157,34,123
"2011","Central Bedfordshire 022D","E01017610","Total",446,120,3,117,132,45,86,11,75
"2011","Central Bedfordshire 023A","E01017611","Total",510,99,4,95,163,56,79,18,61
"2011","Central Bedfordshire 023B","E01017612","Total",531,100,2,98,178,71,94,26,68
"2011","Central Bedfordshire 023C","E01017613","Total",604,175,10,165,168,55,131,23,108
"2011","Central Bedfordshire 023D","E01017614","Total",588,121,7,114,197,70,121,20,101
"2011","Central Bedfordshire 025A","E01017600","Total",817,145,44,101,285,133,155,52,103
"2011","Central Bedfordshire 025B","E01017601","Total",490,158,64,94,231,104,123,42,81
"2011","Central Bedfordshire 025C","E01017602","Total",620,215,47,168,219,98,196,50,146
"2011","Central Bedfordshire 025D","E01017618","Total",611,230,86,144,277,109,174,62,112
"2011","Central Bedfordshire 025E","E01017619","Total",787,267,98,169,346,133,226,62,164
"2011","Central Bedfordshire 024A","E01017573","Total",586,203,6,197,149,52,144,20,124
"2011","Central Bedfordshire 024C","E01017575","Total",1076,244,37,207,372,162,182,36,146
"2011","Central Bedfordshire 024D","E01017576","Total",547,146,19,127,180,70,142,22,120
"2011","Central Bedfordshire 024E","E01033191","Total",564,64,26,38,241,134,76,30,46
"2011","Central Bedfordshire 024F","E01033192","Total",571,53,32,21,277,195,59,30,29
"2011","Central Bedfordshire 024G","E01033193","Total",602,101,26,75,241,123,78,28,50
"2011","Central Bedfordshire 026A","E01017578","Total",684,167,20,147,213,94,154,34,120
"2011","Central Bedfordshire 026B","E01017579","Total",597,187,30,157,199,73,177,32,145
"2011","Central Bedfordshire 026C","E01017580","Total",885,214,98,116,389,174,182,66,116
"2011","Central Bedfordshire 026D","E01017581","Total",798,283,44,239,222,91,234,41,193
"2011","Central Bedfordshire 026E","E01017617","Total",509,175,23,152,157,53,138,21,117
"2011","Central Bedfordshire 027A","E01017582","Total",601,172,9,163,183,64,117,18,99
"2011","Central Bedfordshire 027B","E01017583","Total",720,186,19,167,258,89,151,39,112
"2011","Central Bedfordshire 027C","E01017584","Total",787,262,25,237,257,92,191,52,139
"2011","Central Bedfordshire 027D","E01017585","Total",540,166,9,157,163,47,139,28,111
"2011","Central Bedfordshire 028A","E01017566","Total",605,209,3,206,155,37,137,20,117
"2011","Central Bedfordshire 028B","E01017595","Total",464,168,37,131,158,47,145,40,105
"2011","Central Bedfordshire 028C","E01017596","Total",605,219,47,172,226,97,177,50,127
"2011","Central Bedfordshire 028D","E01017597","Total",612,216,37,179,184,68,176,39,137
"2011","Central Bedfordshire 028E","E01017598","Total",408,100,8,92,136,52,102,21,81
"2011","Central Bedfordshire 028F","E01017599","Total",863,216,66,150,323,138,198,50,148
"2011","Central Bedfordshire 029A","E01017565","Total",618,247,3,244,174,36,185,28,157
"2011","Central Bedfordshire 029B","E01017567","Total",695,227,43,184,245,90,178,40,138
"2011","Central Bedfordshire 029C","E01017568","Total",874,275,53,222,256,129,225,38,187
"2011","Central Bedfordshire 029D","E01017569","Total",750,237,27,210,205,92,192,23,169
"2011","Central Bedfordshire 029E","E01017570","Total",925,223,30,193,240,100,196,32,164
"2011","Central Bedfordshire 030A","E01017592","Total",699,251,28,223,195,74,192,34,158
"2011","Central Bedfordshire 030B","E01017593","Total",643,247,18,229,178,68,178,36,142
"2011","Central Bedfordshire 030C","E01017594","Total",864,331,153,178,421,220,239,75,164
"2011","Central Bedfordshire 031A","E01017623","Total",751,222,23,199,218,73,153,30,123
"2011","Central Bedfordshire 031B","E01017624","Total",723,171,21,150,260,85,126,39,87
"2011","Central Bedfordshire 031C","E01017625","Total",647,240,5,235,169,36,130,12,118
"2011","Central Bedfordshire 031D","E01017626","Total",665,170,3,167,195,49,131,25,106
"2011","Central Bedfordshire 032A","E01017571","Total",527,198,23,175,130,49,129,22,107
"2011","Central Bedfordshire 032B","E01017572","Total",569,139,5,134,164,56,99,20,79
"2011","Central Bedfordshire 032C","E01017586","Total",614,196,13,183,161,60,139,13,126
"2011","Central Bedfordshire 032D","E01017587","Total",666,242,10,232,134,42,159,20,139
"2011","Central Bedfordshire 032E","E01017588","Total",538,193,6,187,98,32,155,13,142
"2011","Central Bedfordshire 033A","E01017561","Total",591,154,8,146,168,52,114,22,92
"2011","Central Bedfordshire 033B","E01017562","Total",697,302,18,284,144,46,236,25,211
"2011","Central Bedfordshire 033C","E01017563","Total",672,235,11,224,169,60,153,25,128
"2011","Central Bedfordshire 033D","E01017564","Total",604,146,8,138,161,65,130,26,104
"2011","Luton 001A","E01015706","Total",604,199,10,189,159,74,137,16,121
"2011","Luton 001B","E01015707","Total",585,134,2,132,176,68,97,17,80
"2011","Luton 001C","E01015708","Total",510,114,8,106,183,55,86,18,68
"2011","Luton 001D","E01015709","Total",629,149,8,141,169,68,119,25,94
"2011","Luton 001E","E01015710","Total",643,149,17,132,198,78,110,22,88
"2011","Luton 001F","E01015770","Total",491,136,1,135,133,38,119,19,100
"2011","Luton 002A","E01015801","Total",746,256,74,182,286,148,149,38,111
"2011","Luton 002B","E01015803","Total",592,176,13,163,166,69,138,24,114
"2011","Luton 002C","E01015804","Total",713,226,71,155,277,134,157,50,107
"2011","Luton 002D","E01015805","Total",491,156,8,148,160,45,115,24,91
"2011","Luton 003A","E01015769","Total",496,149,27,122,150,59,115,26,89
"2011","Luton 003B","E01015771","Total",577,258,63,195,228,106,190,48,142
"2011","Luton 003C","E01015772","Total",534,172,61,111,226,94,138,52,86
"2011","Luton 003D","E01015773","Total",461,148,62,86,240,107,130,53,77
"2011","Luton 003E","E01015774","Total",518,180,67,113,234,114,123,34,89
"2011","Luton 003F","E01015802","Total",608,234,62,172,244,114,188,60,128
"2011","Luton 004A","E01015744","Total",643,237,41,196,196,81,194,42,152
"2011","Luton 004B","E01015746","Total",621,246,10,236,158,63,189,22,167
"2011","Luton 004C","E01015747","Total",486,137,8,129,172,49,102,29,73
"2011","Luton 004D","E01015748","Total",720,316,23,293,167,61,209,34,175
"2011","Luton 005A","E01015749","Total",700,272,93,179,304,153,207,67,140
"2011","Luton 005B","E01015751","Total",624,216,53,163,238,100,183,59,124
"2011","Luton 005C","E01015752","Total",478,144,34,110,166,66,119,28,91
"2011","Luton 005D","E01015753","Total",615,137,31,106,208,86,120,26,94
"2011","Luton 005E","E01015754","Total",768,358,72,286,248,110,273,60,213
"2011","Luton 005F","E01015755","Total",687,283,16,267,191,63,210,34,176
"2011","Luton 006A","E01015764","Total",593,207,8,199,154,47,117,18,99
"2011","Luton 006B","E01015765","Total",658,203,45,158,246,113,148,29,119
"2011","Luton 006C","E01015766","Total",555,135,29,106,250,93,104,34,70
"2011","Luton 006D","E01015767","Total",595,179,24,155,205,73,135,31,104
"2011","Luton 006E","E01015768","Total",580,209,17,192,176,63,171,39,132
"2011","Luton 006F","E01015783","Total",524,143,44,99,265,127,136,43,93
"2011","Luton 006G","E01015785","Total",820,229,37,192,293,153,188,48,140
"2011","Luton 007A","E01015693","Total",514,121,10,111,203,73,115,34,81
"2011","Luton 007B","E01015694","Total",497,152,10,142,173,79,139,34,105
"2011","Luton 007C","E01015695","Total",494,101,16,85,214,99,103,37,66
"2011","Luton 007D","E01015696","Total",505,77,23,54,240,111,72,28,44
"2011","Luton 007E","E01015697","Total",659,141,13,128,278,105,136,30,106
"2011","Luton 007F","E01015745","Total",557,204,9,195,183,60,130,25,105
"2011","Luton 008A","E01015797","Total",506,149,7,142,152,45,105,22,83
"2011","Luton 008B","E01015798","Total",539,180,29,151,187,66,167,39,128
"2011","Luton 008C","E01015799","Total",574,173,11,162,165,62,127,19,108
"2011","Luton 008D","E01015800","Total",627,168,17,151,205,83,135,22,113
"2011","Luton 008E","E01015812","Total",524,99,13,86,181,62,95,30,65
"2011","Luton 008F","E01015813","Total",688,288,18,270,134,51,231,20,211
"2011","Luton 009A","E01015756","Total",647,152,42,110,256,136,126,31,95
"2011","Luton 009B","E01015757","Total",613,265,48,217,212,86,199,44,155
"2011","Luton 009C","E01015758","Total",524,97,47,50,251,102,118,46,72
"2011","Luton 009D","E01015759","Total",617,279,43,236,205,82,222,35,187
"2011","Luton 009E","E01015760","Total",611,263,54,209,228,101,224,46,178
"2011","Luton 009F","E01015761","Total",606,219,52,167,246,111,167,40,127
"2011","Luton 010A","E01015700","Total",773,209,46,163,322,174,210,73,137
"2011","Luton 010B","E01015701","Total",509,113,43,70,306,174,130,69,61
"2011","Luton 010C","E01015704","Total",570,160,81,79,348,203,140,77,63
"2011","Luton 010D","E01015782","Total",636,189,43,146,278,131,147,47,100
"2011","Luton 010E","E01015784","Total",532,107,39,68,312,174,129,59,70
"2011","Luton 010F","E01015786","Total",564,156,45,111,295,151,140,67,73
"2011","Luton 011A","E01015711","Total",514,132,29,103,230,112,118,38,80
"2011","Luton 011B","E01015712","Total",631,199,25,174,204,117,143,34,109
"2011","Luton 011C","E01015715","Total",496,144,58,86,294,159,125,63,62
"2011","Luton 011D","E01015716","Total",616,154,65,89,289,132,127,47,80
"2011","Luton 011E","E01015717","Total",512,132,39,93,232,125,125,44,81
"2011","Luton 011F","E01015750","Total",718,162,45,117,318,162,141,57,84
"2011","Luton 012A","E01015740","Total",568,120,13,107,184,98,117,25,92
"2011","Luton 012B","E01015775","Total",704,206,13,193,201,78,137,20,117
"2011","Luton 012C","E01015776","Total",736,263,36,227,241,99,208,42,166
"2011","Luton 012D","E01015777","Total",683,172,21,151,237,96,141,40,101
"2011","Luton 012E","E01015778","Total",682,135,17,118,238,97,130,35,95
"2011","Luton 012F","E01015796","Total",667,281,12,269,127,31,198,23,175
"2011","Luton 013A","E01015713","Total",517,195,26,169,153,76,165,31,134
"2011","Luton 013B","E01015714","Total",631,211,15,196,202,100,164,24,140
"2011","Luton 013C","E01015718","Total",680,200,19,181,188,86,135,24,111
"2011","Luton 013D","E01015762","Total",670,228,19,209,211,91,179,32,147
"2011","Luton 013E","E01015763","Total",639,260,21,239,174,75,195,27,168
"2011","Luton 014A","E01015721","Total",656,220,18,202,188,81,176,30,146
"2011","Luton 014B","E01015722","Total",522,141,27,114,182,74,113,31,82
"2011","Luton 014C","E01015806","Total",554,93,20,73,194,69,88,24,64
"2011","Luton 014D","E01015808","Total",626,120,14,106,193,96,115,27,88
"2011","Luton 014E","E01015809","Total",502,81,6,75,183,56,93,26,67
"2011","Luton 014F","E01015810","Total",514,92,50,42,243,100,80,35,45
"2011","Luton 014G","E01015811","Total",580,84,14,70,182,88,90,29,61
"2011","Luton 015A","E01015703","Total",490,131,38,93,273,145,146,68,78
"2011","Luton 015B","E01015726","Total",574,164,72,92,322,167,162,84,78
"2011","Luton 015C","E01015731","Total",553,147,57,90,287,164,133,70,63
"2011","Luton 015D","E01015787","Total",570,154,51,103,267,158,134,51,83
"2011","Luton 015E","E01015788","Total",456,125,47,78,277,141,135,65,70
"2011","Luton 016A","E01015719","Total",552,151,9,142,165,79,116,22,94
"2011","Luton 016B","E01015720","Total",554,171,49,122,202,82,164,43,121
"2011","Luton 016C","E01015723","Total",494,112,27,85,185,77,138,38,100
"2011","Luton 016D","E01015779","Total",494,163,43,120,203,66,147,45,102
"2011","Luton 016E","E01015780","Total",630,130,23,107,216,92,137,37,100
"2011","Luton 016F","E01015781","Total",533,136,37,99,221,99,128,41,87
"2011","Luton 016G","E01015807","Total",532,189,40,149,186,56,161,39,122
"2011","Luton 017A","E01015698","Total",532,155,48,107,251,136,128,46,82
"2011","Luton 017B","E01015699","Total",617,215,56,159,256,140,150,58,92
"2011","Luton 017C","E01015702","Total",472,131,50,81,265,149,120,65,55
"2011","Luton 017D","E01015705","Total",561,171,77,94,250,172,85,34,51
"2011","Luton 017E","E01015725","Total",496,200,83,117,272,167,137,51,86
"2011","Luton 017F","E01015727","Total",450,114,44,70,249,139,98,52,46
"2011","Luton 018A","E01015739","Total",963,256,31,225,199,128,174,31,143
"2011","Luton 018B","E01015741","Total",1022,352,53,299,260,142,240,51,189
"2011","Luton 018C","E01015742","Total",739,167,30,137,216,112,132,25,107
"2011","Luton 018D","E01015743","Total",687,241,48,193,173,85,141,27,114
"2011","Luton 018E","E01015789","Total",832,483,63,420,193,100,299,24,275
"2011","Luton 018F","E01015794","Total",1054,367,21,346,143,100,194,19,175
"2011","Luton 019A","E01015724","Total",658,156,54,102,340,195,142,75,67
"2011","Luton 019B","E01015728","Total",515,161,48,113,268,145,126,52,74
"2011","Luton 019C","E01015729","Total",595,188,49,139,221,122,123,38,85
"2011","Luton 019D","E01015730","Total",743,208,75,133,325,212,161,64,97
"2011","Luton 020A","E01015732","Total",514,181,59,122,225,95,164,54,110
"2011","Luton 020B","E01015733","Total",608,248,54,194,255,118,233,59,174
"2011","Luton 020C","E01015734","Total",716,183,24,159,242,111,173,36,137
"2011","Luton 020D","E01015735","Total",690,176,43,133,226,125,137,32,105
"2011","Luton 020E","E01015736","Total",689,316,53,263,219,94,270,47,223
"2011","Luton 020F","E01015737","Total",503,151,38,113,214,84,128,42,86
"2011","Luton 021A","E01015738","Total",788,216,23,193,183,99,174,20,154
"2011","Luton 021B","E01015790","Total",613,177,28,149,193,91,134,31,103
"2011","Luton 021C","E01015791","Total",1115,424,73,351,267,174,256,31,225
"2011","Luton 021D","E01015792","Total",691,167,31,136,197,116,125,24,101
"2011","Luton 021E","E01015793","Total",644,166,25,141,200,85,132,24,108
"2011","Luton 021F","E01015795","Total",985,322,57,265,221,134,166,34,132
"2011","Peterborough 001A","E01015629","Total",671,207,10,197,234,50,154,24,130
"2011","Peterborough 001B","E01015635","Total",632,217,6,211,159,42,143,17,126
"2011","Peterborough 001C","E01015636","Total",474,146,7,139,134,24,120,24,96
"2011","Peterborough 001D","E01015679","Total",823,239,10,229,209,57,200,26,174
"2011","Peterborough 002A","E01015678","Total",568,113,15,98,207,90,121,32,89
"2011","Peterborough 002B","E01015680","Total",640,225,58,167,235,92,181,40,141
"2011","Peterborough 002C","E01015681","Total",594,110,11,99,217,60,115,27,88
"2011","Peterborough 002D","E01015682","Total",664,177,16,161,202,57,149,21,128
"2011","Peterborough 003A","E01015630","Total",612,145,13,132,183,59,130,30,100
"2011","Peterborough 003B","E01015631","Total",524,131,4,127,169,66,96,18,78
"2011","Peterborough 003C","E01015659","Total",839,145,23,122,283,119,136,36,100
"2011","Peterborough 003D","E01015684","Total",607,231,1,230,133,42,145,16,129
"2011","Peterborough 003E","E01015685","Total",693,229,6,223,168,59,158,17,141
"2011","Peterborough 004A","E01015589","Total",668,219,10,209,208,57,143,40,103
"2011","Peterborough 004B","E01015590","Total",531,201,9,192,134,37,137,22,115
"2011","Peterborough 004C","E01015626","Total",535,44,12,32,270,152,93,48,45
"2011","Peterborough 004D","E01015628","Total",746,116,20,96,244,112,130,34,96
"2011","Peterborough 005A","E01015617","Total",560,153,11,142,146,61,114,11,103
"2011","Peterborough 005B","E01015618","Total",451,141,8,133,141,44,134,27,107
"2011","Peterborough 005C","E01015619","Total",871,283,37,246,283,112,225,49,176
"2011","Peterborough 005D","E01015620","Total",685,199,11,188,217,87,158,31,127
"2011","Peterborough 006A","E01015674","Total",669,262,38,224,206,85,236,39,197
"2011","Peterborough 006B","E01015675","Total",665,221,21,200,195,77,174,29,145
"2011","Peterborough 006C","E01015676","Total",690,226,26,200,179,87,170,22,148
"2011","Peterborough 006D","E01015683","Total",849,377,10,367,168,53,269,31,238
"2011","Peterborough 006E","E01015686","Total",711,313,6,307,139,38,199,20,179
"2011","Peterborough 007A","E01015607","Total",633,257,57,200,201,96,211,38,173
"2011","Peterborough 007B","E01015609","Total",664,252,86,166,298,143,171,48,123
"2011","Peterborough 007C","E01015656","Total",666,271,46,225,203,91,200,33,167
"2011","Peterborough 007D","E01015657","Total",735,230,102,128,328,174,170,46,124
"2011","Peterborough 007E","E01015658","Total",633,280,67,213,236,118,221,49,172
"2011","Peterborough 007F","E01015660","Total",740,291,39,252,209,93,221,30,191
"2011","Peterborough 008A","E01015605","Total",641,289,47,242,227,106,252,55,197
"2011","Peterborough 008B","E01015608","Total",633,251,38,213,200,93,198,44,154
"2011","Peterborough 008C","E01015610","Total",664,261,46,215,228,106,220,35,185
"2011","Peterborough 008D","E01015633","Total",982,439,71,368,288,146,339,64,275
"2011","Peterborough 008E","E01015634","Total",765,343,42,301,219,124,268,37,231
"2011","Peterborough 009A","E01015593","Total",571,208,55,153,214,111,169,40,129
"2011","Peterborough 009B","E01015596","Total",594,178,54,124,253,110,159,68,91
"2011","Peterborough 009C","E01015662","Total",485,127,53,74,228,95,111,42,69
"2011","Peterborough 009D","E01015663","Total",649,296,59,237,209,103,216,44,172
"2011","Peterborough 009E","E01015664","Total",668,252,99,153,289,150,169,52,117
"2011","Peterborough 010A","E01015603","Total",772,227,47,180,313,172,204,55,149
"2011","Peterborough 010B","E01015604","Total",506,121,49,72,292,163,123,68,55
"2011","Peterborough 010C","E01015632","Total",731,224,54,170,275,155,180,39,141
"2011","Peterborough 010D","E01015661","Total",611,214,44,170,210,104,166,38,128
"2011","Peterborough 010E","E01015677","Total",474,126,22,104,146,72,101,21,80
"2011","Peterborough 011A","E01015591","Total",587,175,21,154,180,65,145,39,106
"2011","Peterborough 011B","E01015592","Total",644,195,33,162,207,110,181,28,153
"2011","Peterborough 011C","E01015594","Total",752,226,36,190,238,104,172,40,132
"2011","Peterborough 011D","E01015595","Total",677,275,38,237,191,89,206,25,181
"2011","Peterborough 011E","E01015597","Total",612,208,73,135,255,111,173,46,127
"2011","Peterborough 012A","E01015601","Total",514,113,30,83,299,162,138,78,60
"2011","Peterborough 012B","E01015651","Total",658,163,18,145,267,128,149,51,98
"2011","Peterborough 012C","E01015652","Total",596,134,26,108,264,152,158,53,105
"2011","Peterborough 012D","E01015653","Total",650,182,21,161,201,76,156,34,122
"2011","Peterborough 012E","E01015654","Total",866,269,37,232,316,150,242,54,188
"2011","Peterborough 013A","E01015606","Total",721,256,33,223,200,89,206,30,176
"2011","Peterborough 013B","E01015611","Total",914,365,55,310,253,122,286,56,230
"2011","Peterborough 013C","E01015613","Total",666,209,52,157,236,129,125,31,94
"2011","Peterborough 013D","E01015614","Total",737,142,34,108,276,145,143,34,109
"2011","Peterborough 013E","E01015615","Total",678,288,38,250,204,89,226,37,189
"2011","Peterborough 013F","E01015616","Total",652,268,69,199,264,129,195,53,142
"2011","Peterborough 014A","E01015599","Total",729,254,41,213,232,125,200,46,154
"2011","Peterborough 014B","E01015600","Total",547,189,36,153,231,144,163,47,116
"2011","Peterborough 014C","E01015602","Total",892,278,31,247,205,107,200,29,171
"2011","Peterborough 014D","E01015612","Total",859,277,46,231,276,144,213,35,178
"2011","Peterborough 014E","E01015655","Total",808,167,24,143,245,110,144,42,102
"2011","Peterborough 015A","E01015598","Total",633,188,6,182,161,53,140,22,118
"2011","Peterborough 015B","E01015687","Total",640,251,9,242,160,62,168,28,140
"2011","Peterborough 015C","E01015689","Total",617,243,6,237,139,48,159,22,137
"2011","Peterborough 015D","E01015690","Total",462,153,4,149,126,36,106,23,83
"2011","Peterborough 015E","E01015691","Total",500,202,14,188,136,49,131,24,107
"2011","Peterborough 016A","E01015622","Total",1093,267,41,226,276,160,239,30,209
"2011","Peterborough 016C","E01015665","Total",574,159,15,144,206,107,141,31,110
"2011","Peterborough 016D","E01015688","Total",658,218,21,197,140,70,152,20,132
"2011","Peterborough 016E","E01015692","Total",469,119,27,92,188,95,101,31,70
"2011","Peterborough 016F","E01033173","Total",733,72,14,58,319,168,94,29,65
"2011","Peterborough 016G","E01033182","Total",636,176,49,127,214,97,151,30,121
"2011","Peterborough 017A","E01015621","Total",929,223,28,195,238,129,211,45,166
"2011","Peterborough 017B","E01015623","Total",744,228,37,191,225,102,185,38,147
"2011","Peterborough 017C","E01015624","Total",729,166,21,145,198,89,163,36,127
"2011","Peterborough 017D","E01015666","Total",622,262,23,239,136,61,208,25,183
"2011","Peterborough 017E","E01015668","Total",817,255,52,203,246,123,198,43,155
"2011","Peterborough 018A","E01015627","Total",749,253,10,243,198,57,161,29,132
"2011","Peterborough 018B","E01015644","Total",787,139,31,108,277,110,171,50,121
"2011","Peterborough 018C","E01015645","Total",708,164,12,152,188,76,157,25,132
"2011","Peterborough 018D","E01015646","Total",881,351,5,346,164,51,210,31,179
"2011","Peterborough 018E","E01015648","Total",607,225,3,222,131,40,151,17,134
"2011","Peterborough 019A","E01015667","Total",550,143,19,124,178,78,129,23,106
"2011","Peterborough 019B","E01015669","Total",602,213,14,199,153,50,180,30,150
"2011","Peterborough 019C","E01015670","Total",601,240,14,226,159,52,186,21,165
"2011","Peterborough 019D","E01015671","Total",719,259,10,249,161,62,180,30,150
"2011","Peterborough 019E","E01015672","Total",657,200,9,191,219,76,147,29,118
"2011","Peterborough 019F","E01015673","Total",648,271,50,221,227,105,196,44,152
"2011","Peterborough 021A","E01015637","Total",562,199,74,125,215,100,160,50,110
"2011","Peterborough 021B","E01015639","Total",678,273,57,216,208,95,214,49,165
"2011","Peterborough 021C","E01015640","Total",590,149,39,110,191,85,145,42,103
"2011","Peterborough 021D","E01015641","Total",497,175,43,132,168,78,139,34,105
"2011","Peterborough 021E","E01015642","Total",576,206,78,128,244,122,165,40,125
"2011","Peterborough 021F","E01015647","Total",629,307,59,248,196,88,264,48,216
"2011","Peterborough 022A","E01015638","Total",609,242,17,225,149,54,168,24,144
"2011","Peterborough 022B","E01015650","Total",863,203,20,183,257,97,176,28,148
"2011","Peterborough 022C","E01033174","Total",549,176,49,127,208,113,118,20,98
"2011","Peterborough 022D","E01033179","Total",620,177,38,139,239,125,122,25,97
"2011","Peterborough 022E","E01033181","Total",564,64,21,43,277,127,80,41,39
"2011","Peterborough 023A","E01015643","Total",583,180,28,152,174,78,152,28,124
"2011","Peterborough 023B","E01033175","Total",529,64,18,46,273,93,76,38,38
"2011","Peterborough 023C","E01033176","Total",575,70,24,46,264,109,75,29,46
"2011","Peterborough 023D","E01033177","Total",546,63,26,37,252,132,65,30,35
"2011","Peterborough 023E","E01033178","Total",559,101,64,37,308,186,82,42,40
"2011","Peterborough 023F","E01033180","Total",581,89,59,30,301,171,79,46,33
"2011","Southend-on-Sea 001A","E01015833","Total",623,225,12,213,171,65,143,21,122
"2011","Southend-on-Sea 001B","E01015834","Total",622,215,14,201,158,56,152,17,135
"2011","Southend-on-Sea 001C","E01015835","Total",723,282,31,251,214,93,186,29,157
"2011","Southend-on-Sea 001D","E01015836","Total",635,238,8,230,175,55,159,22,137
"2011","Southend-on-Sea 001E","E01015837","Total",730,249,11,238,204,75,202,26,176
"2011","Southend-on-Sea 001F","E01015838","Total",649,270,6,264,153,44,157,21,136
"2011","Southend-on-Sea 002A","E01015863","Total",999,301,25,276,296,126,255,45,210
"2011","Southend-on-Sea 002B","E01015864","Total",596,245,11,234,144,45,181,22,159
"2011","Southend-on-Sea 002C","E01015865","Total",649,260,14,246,143,42,211,27,184
"2011","Southend-on-Sea 002D","E01015866","Total",669,237,7,230,161,60,178,19,159
"2011","Southend-on-Sea 002E","E01015867","Total",640,308,51,257,175,67,243,44,199
"2011","Southend-on-Sea 002F","E01015868","Total",652,212,39,173,209,81,178,45,133
"2011","Southend-on-Sea 003A","E01015814","Total",624,268,20,248,153,58,205,23,182
"2011","Southend-on-Sea 003B","E01015815","Total",625,183,14,169,199,60,135,33,102
"2011","Southend-on-Sea 003C","E01015816","Total",770,373,6,367,112,40,236,12,224
"2011","Southend-on-Sea 003D","E01015817","Total",730,339,10,329,137,55,238,20,218
"2011","Southend-on-Sea 003E","E01015818","Total",797,361,19,342,165,59,225,25,200
"2011","Southend-on-Sea 003F","E01015819","Total",627,250,42,208,192,76,184,29,155
"2011","Southend-on-Sea 004A","E01015857","Total",663,255,6,249,172,49,183,26,157
"2011","Southend-on-Sea 004B","E01015858","Total",714,234,10,224,195,69,184,20,164
"2011","Southend-on-Sea 004C","E01015859","Total",800,292,14,278,216,75,246,36,210
"2011","Southend-on-Sea 004D","E01015860","Total",626,191,14,177,184,61,146,20,126
"2011","Southend-on-Sea 004E","E01015861","Total",753,314,33,281,203,87,259,46,213
"2011","Southend-on-Sea 004F","E01015862","Total",652,201,41,160,219,103,155,37,118
"2011","Southend-on-Sea 005A","E01015820","Total",613,249,48,201,198,72,204,38,166
"2011","Southend-on-Sea 005B","E01015821","Total",720,270,11,259,171,54,216,32,184
"2011","Southend-on-Sea 005C","E01015822","Total",485,154,8,146,150,52,130,16,114
"2011","Southend-on-Sea 005D","E01015823","Total",673,187,15,172,215,80,155,30,125
"2011","Southend-on-Sea 005E","E01015824","Total",615,229,50,179,220,78,210,48,162
"2011","Southend-on-Sea 005F","E01015825","Total",600,220,19,201,189,78,187,43,144
"2011","Southend-on-Sea 005G","E01015826","Total",573,206,12,194,162,53,163,30,133
"2011","Southend-on-Sea 006A","E01015869","Total",634,199,41,158,235,100,157,33,124
"2011","Southend-on-Sea 006B","E01015870","Total",663,191,29,162,238,85,165,37,128
"2011","Southend-on-Sea 006C","E01015871","Total",657,250,32,218,187,61,199,31,168
"2011","Southend-on-Sea 006D","E01015872","Total",685,205,35,170,234,93,176,40,136
"2011","Southend-on-Sea 006E","E01015873","Total",540,149,29,120,185,93,121,28,93
"2011","Southend-on-Sea 006F","E01015874","Total",716,218,26,192,220,89,188,29,159
"2011","Southend-on-Sea 006G","E01015875","Total",751,339,53,286,221,97,264,33,231
"2011","Southend-on-Sea 007A","E01015901","Total",589,135,45,90,212,108,114,24,90
"2011","Southend-on-Sea 007B","E01015902","Total",647,142,32,110,254,130,136,36,100
"2011","Southend-on-Sea 007C","E01015903","Total",675,175,46,129,249,109,151,46,105
"2011","Southend-on-Sea 007D","E01015904","Total",695,178,29,149,228,113,149,24,125
"2011","Southend-on-Sea 007E","E01015905","Total",583,161,31,130,194,81,130,29,101
"2011","Southend-on-Sea 007F","E01015906","Total",605,156,32,124,211,83,138,34,104
"2011","Southend-on-Sea 007G","E01015907","Total",592,149,24,125,196,100,145,21,124
"2011","Southend-on-Sea 008A","E01015908","Total",647,197,6,191,216,84,129,20,109
"2011","Southend-on-Sea 008B","E01015909","Total",627,148,7,141,198,86,96,10,86
"2011","Southend-on-Sea 008C","E01015910","Total",623,199,6,193,195,65,100,14,86
"2011","Southend-on-Sea 008D","E01015911","Total",511,165,7,158,170,52,101,15,86
"2011","Southend-on-Sea 008E","E01015912","Total",639,233,5,228,185,58,165,18,147
"2011","Southend-on-Sea 008F","E01015913","Total",793,265,17,248,188,80,160,13,147
"2011","Southend-on-Sea 009A","E01015883","Total",566,220,5,215,166,53,142,21,121
"2011","Southend-on-Sea 009B","E01015884","Total",923,341,71,270,292,147,245,50,195
"2011","Southend-on-Sea 009C","E01015885","Total",711,323,8,315,175,66,165,19,146
"2011","Southend-on-Sea 009D","E01015886","Total",638,330,74,256,215,88,246,47,199
"2011","Southend-on-Sea 009E","E01015887","Total",583,233,62,171,234,91,193,58,135
"2011","Southend-on-Sea 009F","E01015888","Total",644,304,20,284,141,43,184,28,156
"2011","Southend-on-Sea 010A","E01015895","Total",1053,524,76,448,235,129,400,41,359
"2011","Southend-on-Sea 010B","E01015896","Total",853,322,60,262,269,133,272,57,215
"2011","Southend-on-Sea 010C","E01015897","Total",884,354,69,285,252,99,310,44,266
"2011","Southend-on-Sea 010D","E01015898","Total",757,298,54,244,232,102,253,58,195
"2011","Southend-on-Sea 010E","E01015899","Total",800,242,44,198,253,102,218,42,176
"2011","Southend-on-Sea 010F","E01015900","Total",618,165,33,132,209,99,147,27,120
"2011","Southend-on-Sea 011A","E01015845","Total",683,147,14,133,239,103,110,28,82
"2011","Southend-on-Sea 011B","E01015846","Total",797,207,16,191,221,113,156,22,134
"2011","Southend-on-Sea 011C","E01015847","Total",797,174,29,145,243,119,137,21,116
"2011","Southend-on-Sea 011D","E01015848","Total",902,324,9,315,136,64,204,12,192
"2011","Southend-on-Sea 011E","E01015849","Total",754,173,16,157,227,100,152,29,123
"2011","Southend-on-Sea 011F","E01015850","Total",675,144,14,130,247,115,121,33,88
"2011","Southend-on-Sea 012A","E01015827","Total",662,210,8,202,151,64,142,23,119
"2011","Southend-on-Sea 012B","E01015828","Total",826,265,17,248,113,61,201,8,193
"2011","Southend-on-Sea 012C","E01015829","Total",643,137,9,128,197,94,121,21,100
"2011","Southend-on-Sea 012D","E01015830","Total",625,180,7,173,193,74,124,18,106
"2011","Southend-on-Sea 012E","E01015831","Total",840,176,27,149,218,92,188,34,154
"2011","Southend-on-Sea 012F","E01015832","Total",773,341,10,331,119,48,211,11,200
"2011","Southend-on-Sea 013A","E01015876","Total",884,242,24,218,280,114,201,34,167
"2011","Southend-on-Sea 013B","E01015877","Total",819,308,42,266,225,98,247,41,206
"2011","Southend-on-Sea 013C","E01015878","Total",581,137,26,111,187,67,127,31,96
"2011","Southend-on-Sea 013D","E01015879","Total",587,204,54,150,221,87,184,46,138
"2011","Southend-on-Sea 013E","E01015880","Total",660,296,62,234,202,80,262,59,203
"2011","Southend-on-Sea 013F","E01015881","Total",566,203,19,184,164,57,155,27,128
"2011","Southend-on-Sea 013G","E01015882","Total",685,239,68,171,242,92,201,56,145
"2011","Southend-on-Sea 014A","E01015839","Total",761,273,45,228,220,98,218,43,175
"2011","Southend-on-Sea 014B","E01015840","Total",714,207,55,152,232,111,188,45,143
"2011","Southend-on-Sea 014C","E01015841","Total",1071,345,82,263,297,159,214,37,177
"2011","Southend-on-Sea 014D","E01015842","Total",905,428,112,316,294,152,314,58,256
"2011","Southend-on-Sea 014E","E01015843","Total",714,227,50,177,231,121,186,36,150
"2011","Southend-on-Sea 014F","E01015844","Total",922,363,27,336,184,88,303,23,280
"2011","Southend-on-Sea 015A","E01015851","Total",1016,474,15,459,81,49,294,12,282
"2011","Southend-on-Sea 015B","E01015852","Total",860,300,42,258,170,95,227,31,196
"2011","Southend-on-Sea 015C","E01015853","Total",907,311,18,293,157,93,235,19,216
"2011","Southend-on-Sea 015D","E01015854","Total",748,206,58,148,242,120,155,34,121
"2011","Southend-on-Sea 015E","E01015855","Total",888,262,48,214,245,131,189,37,152
"2011","Southend-on-Sea 015F","E01015856","Total",780,200,26,174,188,109,157,35,122
"2011","Southend-on-Sea 016A","E01015889","Total",610,267,5,262,132,38,165,18,147
"2011","Southend-on-Sea 016B","E01015890","Total",626,233,7,226,173,38,162,25,137
"2011","Southend-on-Sea 016C","E01015891","Total",658,218,24,194,162,78,170,22,148
"2011","Southend-on-Sea 016D","E01015892","Total",636,147,12,135,246,105,141,23,118
"2011","Southend-on-Sea 016E","E01015893","Total",793,472,5,467,105,30,258,12,246
"2011","Southend-on-Sea 016F","E01015894","Total",598,198,5,193,186,67,140,19,121
"2011","Southend-on-Sea 017A","E01015914","Total",502,149,6,143,164,41,88,14,74
"2011","Southend-on-Sea 017B","E01015915","Total",621,225,14,211,164,51,147,28,119
"2011","Southend-on-Sea 017C","E01015916","Total",544,230,82,148,254,114,177,69,108
"2011","Southend-on-Sea 017D","E01015917","Total",622,248,71,177,254,98,222,74,148
"2011","Southend-on-Sea 017E","E01015918","Total",531,139,26,113,207,89,138,34,104
"2011","Southend-on-Sea 017F","E01015919","Total",505,176,21,155,186,67,131,27,104
"2011","Southend-on-Sea 017G","E01015920","Total",638,275,12,263,147,44,191,27,164
"2011","Thurrock 001A","E01015943","Total",601,188,7,181,162,51,152,23,129
"2011","Thurrock 001B","E01015944","Total",525,234,8,226,125,36,144,12,132
"2011","Thurrock 001C","E01015946","Total",624,204,14,190,176,60,147,24,123
"2011","Thurrock 001D","E01015997","Total",503,107,6,101,153,50,97,15,82
"2011","Thurrock 001E","E01015999","Total",490,99,5,94,182,67,84,16,68
"2011","Thurrock 002A","E01015945","Total",490,198,14,184,126,36,131,19,112
"2011","Thurrock 002B","E01015983","Total",624,244,17,227,147,62,150,20,130
"2011","Thurrock 002C","E01015987","Total",576,213,40,173,210,81,174,39,135
"2011","Thurrock 002D","E01015988","Total",610,282,36,246,192,76,212,35,177
"2011","Thurrock 002E","E01015998","Total",595,171,9,162,208,78,133,25,108
"2011","Thurrock 003A","E01015984","Total",488,144,13,131,152,40,106,21,85
"2011","Thurrock 003B","E01015985","Total",636,324,17,307,135,48,223,28,195
"2011","Thurrock 003C","E01015986","Total",620,237,52,185,215,80,199,51,148
"2011","Thurrock 003D","E01015990","Total",581,194,20,174,170,45,178,28,150
"2011","Thurrock 003E","E01016001","Total",513,140,10,130,167,55,92,13,79
"2011","Thurrock 004A","E01015977","Total",728,201,19,182,242,97,162,34,128
"2011","Thurrock 004B","E01015978","Total",491,134,5,129,136,44,105,18,87
"2011","Thurrock 004C","E01015979","Total",528,70,11,59,195,73,79,24,55
"2011","Thurrock 004D","E01015980","Total",623,192,13,179,180,56,142,31,111
"2011","Thurrock 005A","E01015989","Total",672,171,27,144,208,100,144,34,110
"2011","Thurrock 005B","E01015991","Total",585,201,15,186,161,58,140,22,118
"2011","Thurrock 005C","E01015992","Total",784,194,35,159,268,107,199,41,158
"2011","Thurrock 005D","E01016000","Total",600,165,17,148,183,77,135,16,119
"2011","Thurrock 005E","E01016002","Total",521,116,5,111,146,52,101,21,80
"2011","Thurrock 006A","E01015932","Total",569,176,38,138,226,85,157,39,118
"2011","Thurrock 006B","E01015971","Total",681,251,32,219,184,90,195,31,164
"2011","Thurrock 006C","E01015972","Total",697,258,33,225,223,73,235,41,194
"2011","Thurrock 006D","E01015973","Total",696,241,48,193,262,112,188,41,147
"2011","Thurrock 006E","E01015974","Total",557,118,15,103,187,81,119,20,99
"2011","Thurrock 006F","E01015975","Total",627,162,23,139,202,84,143,39,104
"2011","Thurrock 007A","E01015927","Total",663,200,54,146,303,134,188,57,131
"2011","Thurrock 007B","E01015928","Total",653,202,33,169,243,95,185,41,144
"2011","Thurrock 007C","E01015929","Total",654,256,40,216,206,91,236,48,188
"2011","Thurrock 007D","E01015930","Total",664,180,33,147,267,122,177,42,135
"2011","Thurrock 007E","E01015931","Total",663,249,48,201,194,95,184,30,154
"2011","Thurrock 007F","E01015976","Total",785,290,57,233,257,118,243,49,194
"2011","Thurrock 008A","E01015922","Total",591,230,38,192,195,60,197,45,152
"2011","Thurrock 008B","E01015923","Total",653,175,35,140,215,92,163,27,136
"2011","Thurrock 008C","E01015924","Total",600,180,29,151,219,74,167,50,117
"2011","Thurrock 008D","E01015925","Total",624,202,14,188,193,75,145,25,120
"2011","Thurrock 008E","E01015926","Total",658,241,17,224,180,82,189,23,166
"2011","Thurrock 009A","E01015957","Total",593,237,18,219,206,71,213,41,172
"2011","Thurrock 009B","E01015958","Total",480,141,17,124,171,58,131,27,104
"2011","Thurrock 009C","E01015993","Total",646,280,21,259,201,61,199,30,169
"2011","Thurrock 009D","E01015994","Total",643,290,28,262,199,68,215,43,172
"2011","Thurrock 009E","E01015995","Total",615,178,7,171,191,50,151,30,121
"2011","Thurrock 009F","E01015996","Total",622,237,27,210,222,76,213,40,173
"2011","Thurrock 010A","E01015963","Total",494,202,49,153,203,96,134,33,101
"2011","Thurrock 010B","E01015964","Total",598,201,9,192,181,52,159,27,132
"2011","Thurrock 010C","E01015965","Total",597,224,5,219,141,50,169,20,149
"2011","Thurrock 010D","E01015966","Total",630,244,12,232,170,55,170,21,149
"2011","Thurrock 012A","E01015933","Total",635,240,20,220,175,73,187,35,152
"2011","Thurrock 012B","E01015934","Total",523,164,55,109,229,92,154,40,114
"2011","Thurrock 012C","E01015935","Total",607,226,46,180,207,78,186,45,141
"2011","Thurrock 012D","E01015936","Total",686,310,30,280,185,62,244,34,210
"2011","Thurrock 012E","E01015937","Total",688,274,10,264,155,47,217,35,182
"2011","Thurrock 012F","E01015938","Total",796,368,112,256,333,177,233,60,173
"2011","Thurrock 013A","E01015947","Total",548,119,38,81,219,92,125,34,91
"2011","Thurrock 013B","E01015948","Total",605,156,32,124,212,78,128,26,102
"2011","Thurrock 013C","E01015949","Total",612,104,25,79,262,102,137,42,95
"2011","Thurrock 013D","E01015950","Total",682,178,13,165,201,75,139,22,117
"2011","Thurrock 014A","E01015960","Total",544,193,8,185,169,49,161,25,136
"2011","Thurrock 014B","E01015967","Total",591,130,12,118,197,79,133,20,113
"2011","Thurrock 014C","E01015968","Total",607,174,12,162,159,56,172,23,149
"2011","Thurrock 014D","E01015969","Total",766,241,11,230,206,91,180,21,159
"2011","Thurrock 014E","E01015970","Total",491,119,14,105,177,71,103,24,79
"2011","Thurrock 015A","E01015921","Total",548,105,25,80,164,90,89,19,70
"2011","Thurrock 015B","E01016011","Total",677,141,38,103,214,127,119,23,96
"2011","Thurrock 015C","E01016012","Total",928,229,76,153,378,223,202,56,146
"2011","Thurrock 015D","E01016013","Total",1015,203,71,132,323,211,143,31,112
"2011","Thurrock 015E","E01016014","Total",1009,245,108,137,435,232,201,71,130
"2011","Thurrock 015F","E01016015","Total",606,122,23,99,243,93,133,40,93
"2011","Thurrock 016A","E01015955","Total",641,118,27,91,219,99,106,36,70
"2011","Thurrock 016B","E01015956","Total",807,171,46,125,271,133,160,27,133
"2011","Thurrock 016C","E01015959","Total",634,203,34,169,193,75,141,24,117
"2011","Thurrock 016D","E01015961","Total",617,161,21,140,203,89,151,34,117
"2011","Thurrock 016E","E01015962","Total",621,164,55,109,251,127,149,40,109
"2011","Thurrock 017A","E01015951","Total",657,137,55,82,284,152,113,32,81
"2011","Thurrock 017B","E01015952","Total",818,187,62,125,324,173,144,46,98
"2011","Thurrock 017C","E01015953","Total",1002,199,58,141,289,184,169,42,127
"2011","Thurrock 017D","E01015954","Total",989,282,106,176,380,235,228,56,172
"2011","Thurrock 018A","E01016003","Total",774,212,48,164,264,135,176,40,136
"2011","Thurrock 018B","E01016004","Total",677,296,70,226,241,112,204,46,158
"2011","Thurrock 018C","E01016005","Total",553,148,54,94,233,109,134,38,96
"2011","Thurrock 018D","E01016006","Total",648,304,140,164,328,187,178,60,118
"2011","Thurrock 018E","E01016007","Total",522,185,54,131,193,80,177,44,133
"2011","Thurrock 018F","E01016008","Total",592,147,44,103,221,105,128,31,97
"2011","Thurrock 018G","E01016009","Total",652,243,66,177,242,108,189,52,137
"2011","Thurrock 018H","E01016010","Total",503,187,57,130,230,89,174,53,121
"2011","Thurrock 019A","E01015982","Total",895,72,27,45,458,235,101,49,52
"2011","Thurrock 019B","E01033610","Total",563,37,16,21,298,166,45,14,31
"2011","Thurrock 019C","E01033611","Total",637,54,23,31,270,178,46,14,32
"2011","Thurrock 019D","E01033613","Total",585,52,15,37,264,145,56,24,32
"2011","Thurrock 020A","E01015939","Total",557,74,17,57,245,92,77,26,51
"2011","Thurrock 020B","E01015941","Total",513,48,7,41,252,119,62,24,38
"2011","Thurrock 020C","E01015942","Total",563,87,21,66,240,110,79,29,50
"2011","Thurrock 020D","E01033612","Total",595,74,22,52,255,127,70,22,48
"2011","Thurrock 020E","E01033614","Total",613,64,15,49,350,176,82,40,42
"2011","Cambridge 001A","E01017975","Total",687,247,40,207,198,106,193,35,158
"2011","Cambridge 001B","E01017976","Total",636,122,10,112,164,73,125,21,104
"2011","Cambridge 001C","E01017977","Total",769,191,33,158,195,94,147,17,130
"2011","Cambridge 001D","E01017978","Total",657,229,43,186,183,100,197,24,173
"2011","Cambridge 001E","E01017979","Total",671,198,38,160,182,93,195,26,169
"2011","Cambridge 001F","E01017980","Total",498,118,11,107,123,57,103,18,85
"2011","Cambridge 002A","E01017949","Total",683,152,12,140,134,68,119,14,105
"2011","Cambridge 002B","E01017950","Total",568,111,7,104,116,59,79,16,63
"2011","Cambridge 002C","E01017951","Total",660,216,22,194,154,71,195,17,178
"2011","Cambridge 002D","E01017952","Total",684,255,27,228,181,94,185,27,158
"2011","Cambridge 002E","E01017953","Total",690,258,22,236,149,72,211,26,185
"2011","Cambridge 002F","E01017954","Total",601,211,32,179,186,90,157,30,127
"2011","Cambridge 003B","E01017971","Total",666,169,34,135,203,83,171,39,132
"2011","Cambridge 003C","E01017972","Total",676,187,15,172,166,71,160,31,129
"2011","Cambridge 003D","E01017973","Total",729,216,27,189,184,85,180,38,142
"2011","Cambridge 003E","E01017974","Total",694,191,29,162,191,87,181,35,146
"2011","Cambridge 003F","E01032792","Total",617,130,25,105,156,85,107,25,82
"2011","Cambridge 003G","E01032802","Total",656,222,10,212,107,54,173,13,160
"2011","Cambridge 004A","E01018006","Total",773,203,5,198,128,64,171,15,156
"2011","Cambridge 004B","E01018007","Total",585,129,6,123,189,58,109,16,93
"2011","Cambridge 004C","E01018008","Total",654,145,10,135,173,85,134,19,115
"2011","Cambridge 004D","E01018009","Total",833,234,25,209,152,80,185,18,167
"2011","Cambridge 004E","E01018010","Total",884,192,7,185,146,58,127,11,116
"2011","Cambridge 005A","E01017955","Total",647,201,7,194,130,63,148,12,136
"2011","Cambridge 005B","E01017956","Total",536,186,10,176,139,51,96,22,74
"2011","Cambridge 005C","E01017957","Total",507,138,7,131,91,51,68,8,60
"2011","Cambridge 005D","E01017958","Total",392,177,12,165,63,34,113,8,105
"2011","Cambridge 006A","E01017943","Total",740,138,22,116,171,84,116,18,98
"2011","Cambridge 006B","E01017944","Total",575,151,29,122,177,99,157,26,131
"2011","Cambridge 006C","E01017945","Total",768,188,27,161,186,106,153,26,127
"2011","Cambridge 006D","E01017946","Total",643,223,43,180,195,95,197,39,158
"2011","Cambridge 006E","E01017947","Total",682,213,28,185,186,88,195,29,166
"2011","Cambridge 006F","E01017948","Total",698,241,65,176,242,145,210,36,174
"2011","Cambridge 007C","E01017983","Total",906,231,5,226,151,69,175,12,163
"2011","Cambridge 007D","E01017984","Total",701,242,27,215,165,67,108,15,93
"2011","Cambridge 007E","E01017985","Total",706,220,22,198,218,80,141,19,122
"2011","Cambridge 007F","E01017986","Total",304,112,11,101,61,18,68,4,64
"2011","Cambridge 007G","E01032797","Total",755,257,15,242,92,43,134,13,121
"2011","Cambridge 008A","E01017987","Total",678,164,9,155,142,55,121,9,112
"2011","Cambridge 008B","E01017988","Total",557,111,3,108,128,54,73,15,58
"2011","Cambridge 008C","E01017989","Total",933,177,21,156,194,90,144,22,122
"2011","Cambridge 008D","E01017990","Total",598,98,5,93,119,61,65,9,56
"2011","Cambridge 008E","E01017991","Total",600,224,12,212,93,35,166,13,153
"2011","Cambridge 009A","E01017997","Total",957,204,24,180,208,110,224,40,184
"2011","Cambridge 009B","E01017998","Total",720,141,10,131,129,73,119,13,106
"2011","Cambridge 009C","E01017999","Total",696,172,20,152,174,86,173,25,148
"2011","Cambridge 009D","E01018000","Total",725,125,3,122,144,86,116,16,100
"2011","Cambridge 009E","E01018001","Total",759,143,2,141,133,69,131,12,119
"2011","Cambridge 010A","E01017965","Total",745,274,13,261,158,66,236,27,209
"2011","Cambridge 010B","E01017966","Total",1107,251,20,231,221,95,181,34,147
"2011","Cambridge 010C","E01017967","Total",650,198,26,172,194,84,169,31,138
"2011","Cambridge 010D","E01017968","Total",668,220,6,214,154,59,185,14,171
"2011","Cambridge 010E","E01017969","Total",618,156,18,138,195,86,142,25,117
"2011","Cambridge 011A","E01017959","Total",686,183,12,171,189,89,169,23,146
"2011","Cambridge 011B","E01017960","Total",555,177,34,143,185,92,177,26,151
"2011","Cambridge 011C","E01017961","Total",583,208,18,190,154,77,173,24,149
"2011","Cambridge 011D","E01017962","Total",662,198,24,174,196,104,187,25,162
"2011","Cambridge 011E","E01017963","Total",678,214,19,195,204,94,178,26,152
"2011","Cambridge 011F","E01017964","Total",512,146,6,140,166,60,114,20,94
"2011","Cambridge 012A","E01018002","Total",754,212,10,202,170,77,169,25,144
"2011","Cambridge 012B","E01018003","Total",621,169,11,158,199,74,155,29,126
"2011","Cambridge 012D","E01018005","Total",772,250,18,232,135,70,135,11,124
"2011","Cambridge 012E","E01032794","Total",644,247,10,237,109,35,165,15,150
"2011","Cambridge 012F","E01032795","Total",681,146,20,126,177,77,111,18,93
"2011","Cambridge 013A","E01017992","Total",727,231,12,219,230,107,194,30,164
"2011","Cambridge 013B","E01017993","Total",967,262,5,257,185,67,144,30,114
"2011","Cambridge 013C","E01017994","Total",640,208,35,173,216,77,178,39,139
"2011","Cambridge 013D","E01017995","Total",563,193,3,190,171,53,121,20,101
"2011","Cambridge 013E","E01017996","Total",527,130,6,124,154,57,94,16,78
"2011","East Cambridgeshire 001A","E01018042","Total",643,252,22,230,161,72,195,30,165
"2011","East Cambridgeshire 001B","E01018043","Total",836,247,23,224,272,122,189,24,165
"2011","East Cambridgeshire 001C","E01018044","Total",744,224,21,203,193,83,166,22,144
"2011","East Cambridgeshire 001D","E01018045","Total",526,100,13,87,169,67,101,23,78
"2011","East Cambridgeshire 001E","E01018046","Total",835,253,39,214,320,147,216,48,168
"2011","East Cambridgeshire 002A","E01018020","Total",586,116,7,109,174,57,129,23,106
"2011","East Cambridgeshire 002B","E01018021","Total",595,160,5,155,190,60,156,23,133
"2011","East Cambridgeshire 002C","E01018022","Total",592,191,14,177,156,52,163,25,138
"2011","East Cambridgeshire 002D","E01018055","Total",849,208,7,201,236,96,166,30,136
"2011","East Cambridgeshire 002E","E01018056","Total",792,216,34,182,257,114,188,45,143
"2011","East Cambridgeshire 003A","E01018027","Total",736,240,7,233,206,96,184,22,162
"2011","East Cambridgeshire 003C","E01018029","Total",1105,222,22,200,330,185,178,40,138
"2011","East Cambridgeshire 003D","E01018032","Total",1034,279,10,269,318,128,234,35,199
"2011","East Cambridgeshire 003E","E01018033","Total",911,388,17,371,187,80,266,27,239
"2011","East Cambridgeshire 003F","E01033426","Total",514,86,16,70,269,129,77,25,52
"2011","East Cambridgeshire 003G","E01033430","Total",597,197,48,149,231,86,172,49,123
"2011","East Cambridgeshire 004A","E01018024","Total",515,185,2,183,99,37,136,13,123
"2011","East Cambridgeshire 004B","E01018025","Total",722,250,9,241,117,60,197,12,185
"2011","East Cambridgeshire 004C","E01018026","Total",662,194,4,190,122,49,123,14,109
"2011","East Cambridgeshire 004D","E01018030","Total",416,140,12,128,126,64,88,12,76
"2011","East Cambridgeshire 004F","E01033425","Total",700,90,16,74,350,191,95,32,63
"2011","East Cambridgeshire 004G","E01033428","Total",627,136,7,129,186,92,113,18,95
"2011","East Cambridgeshire 005A","E01018036","Total",714,217,12,205,203,84,181,29,152
"2011","East Cambridgeshire 005B","E01018037","Total",542,115,6,109,172,50,114,26,88
"2011","East Cambridgeshire 005C","E01018038","Total",616,153,7,146,219,75,134,31,103
"2011","East Cambridgeshire 005D","E01018039","Total",533,168,7,161,162,55,128,22,106
"2011","East Cambridgeshire 005E","E01018053","Total",697,195,10,185,188,79,185,25,160
"2011","East Cambridgeshire 005F","E01018054","Total",922,230,14,216,283,107,212,29,183
"2011","East Cambridgeshire 006A","E01018047","Total",768,202,29,173,246,115,204,36,168
"2011","East Cambridgeshire 006C","E01018049","Total",677,180,14,166,215,76,156,27,129
"2011","East Cambridgeshire 006D","E01018050","Total",549,119,9,110,181,65,122,17,105
"2011","East Cambridgeshire 006E","E01018051","Total",687,209,20,189,208,98,155,32,123
"2011","East Cambridgeshire 006F","E01018052","Total",808,229,10,219,182,86,216,28,188
"2011","East Cambridgeshire 006G","E01033427","Total",482,48,15,33,231,120,72,23,49
"2011","East Cambridgeshire 006H","E01033429","Total",811,151,16,135,236,116,154,28,126
"2011","East Cambridgeshire 007A","E01018034","Total",616,147,6,141,199,66,119,26,93
"2011","East Cambridgeshire 007B","E01018035","Total",965,268,27,241,258,105,224,26,198
"2011","East Cambridgeshire 007C","E01018040","Total",502,133,7,126,156,62,103,18,85
"2011","East Cambridgeshire 007D","E01018041","Total",451,130,16,114,145,60,120,20,100
"2011","East Cambridgeshire 008A","E01018013","Total",739,265,4,261,217,73,186,20,166
"2011","East Cambridgeshire 008B","E01018014","Total",747,185,8,177,258,89,164,32,132
"2011","East Cambridgeshire 008C","E01018015","Total",563,134,5,129,169,63,111,16,95
"2011","East Cambridgeshire 008D","E01018016","Total",582,212,17,195,181,79,182,31,151
"2011","East Cambridgeshire 009A","E01018011","Total",1003,260,18,242,293,97,212,32,180
"2011","East Cambridgeshire 009B","E01018012","Total",563,196,12,184,172,62,159,25,134
"2011","East Cambridgeshire 009C","E01018057","Total",827,234,12,222,235,76,184,31,153
"2011","East Cambridgeshire 011A","E01018017","Total",599,226,14,212,134,53,159,18,141
"2011","East Cambridgeshire 011B","E01018019","Total",444,141,4,137,108,39,85,8,77
"2011","East Cambridgeshire 011C","E01018023","Total",919,218,22,196,292,99,175,35,140
"2011","East Cambridgeshire 011D","E01032611","Total",751,179,8,171,203,86,149,24,125
"2011","Fenland 001A","E01018094","Total",778,370,45,325,180,73,245,38,207
"2011","Fenland 001B","E01018095","Total",656,241,23,218,156,64,179,32,147
"2011","Fenland 001C","E01018096","Total",730,290,13,277,148,56,208,21,187
"2011","Fenland 001D","E01018097","Total",611,227,11,216,131,34,188,31,157
"2011","Fenland 002A","E01018063","Total",950,340,62,278,296,125,248,47,201
"2011","Fenland 002B","E01018073","Total",926,337,31,306,242,89,257,32,225
"2011","Fenland 002C","E01018107","Total",641,257,57,200,233,92,207,46,161
"2011","Fenland 002D","E01018108","Total",776,332,82,250,302,157,211,59,152
"2011","Fenland 002E","E01018109","Total",773,290,44,246,233,115,182,40,142
"2011","Fenland 003A","E01018069","Total",744,251,27,224,204,86,166,19,147
"2011","Fenland 003B","E01018070","Total",748,267,45,222,239,106,205,36,169
"2011","Fenland 003C","E01018071","Total",787,360,29,331,191,77,267,35,232
"2011","Fenland 003E","E01018093","Total",1008,373,50,323,280,96,290,45,245
"2011","Fenland 003F","E01018103","Total",469,192,43,149,176,84,160,39,121
"2011","Fenland 003G","E01018104","Total",511,187,8,179,129,35,149,26,123
"2011","Fenland 003H","E01033111","Total",656,302,28,274,142,62,221,23,198
"2011","Fenland 003I","E01033112","Total",594,256,16,240,100,39,183,14,169
"2011","Fenland 004A","E01018066","Total",636,277,25,252,148,60,183,27,156
"2011","Fenland 004B","E01018067","Total",764,263,26,237,209,76,217,37,180
"2011","Fenland 004C","E01018068","Total",594,199,28,171,173,63,164,32,132
"2011","Fenland 004D","E01018090","Total",740,292,36,256,190,78,233,36,197
"2011","Fenland 004E","E01018091","Total",588,198,21,177,159,46,167,33,134
"2011","Fenland 004F","E01018092","Total",728,279,26,253,194,67,220,36,184
"2011","Fenland 005A","E01018081","Total",579,185,22,163,181,53,174,42,132
"2011","Fenland 005B","E01018082","Total",811,309,19,290,218,85,229,37,192
"2011","Fenland 005C","E01018083","Total",772,232,42,190,295,138,195,47,148
"2011","Fenland 005D","E01018084","Total",904,363,18,345,214,79,259,39,220
"2011","Fenland 006A","E01018064","Total",836,269,26,243,247,85,221,37,184
"2011","Fenland 006B","E01018072","Total",669,222,38,184,228,87,172,32,140
"2011","Fenland 006C","E01018074","Total",522,187,8,179,135,48,135,19,116
"2011","Fenland 006D","E01018075","Total",525,242,37,205,161,54,169,29,140
"2011","Fenland 006E","E01018098","Total",593,232,9,223,127,48,172,18,154
"2011","Fenland 006F","E01018099","Total",524,165,12,153,153,47,134,23,111
"2011","Fenland 006G","E01018100","Total",600,225,23,202,138,51,168,23,145
"2011","Fenland 006H","E01018101","Total",592,196,13,183,137,42,144,22,122
"2011","Fenland 007A","E01018077","Total",873,325,28,297,196,93,251,30,221
"2011","Fenland 007B","E01018078","Total",805,454,44,410,183,65,322,31,291
"2011","Fenland 007C","E01018079","Total",789,375,22,353,176,71,253,32,221
"2011","Fenland 007D","E01018080","Total",977,331,36,295,288,119,240,45,195
"2011","Fenland 008A","E01018058","Total",700,261,20,241,178,52,184,25,159
"2011","Fenland 008B","E01018059","Total",550,148,10,138,140,46,114,18,96
"2011","Fenland 008C","E01018060","Total",753,189,32,157,249,87,182,44,138
"2011","Fenland 008D","E01018061","Total",506,122,10,112,174,57,131,29,102
"2011","Fenland 009A","E01018085","Total",701,274,12,262,184,58,192,27,165
"2011","Fenland 009B","E01018086","Total",723,274,28,246,196,86,190,35,155
"2011","Fenland 009C","E01018087","Total",941,429,29,400,204,72,317,35,282
"2011","Fenland 009D","E01018088","Total",703,304,15,289,160,50,199,30,169
"2011","Fenland 010A","E01018065","Total",920,274,20,254,247,75,255,47,208
"2011","Fenland 010B","E01018076","Total",866,252,27,225,254,96,216,38,178
"2011","Fenland 010C","E01018111","Total",941,372,33,339,247,86,257,34,223
"2011","Fenland 011A","E01018062","Total",1056,356,27,329,308,112,312,55,257
"2011","Fenland 011B","E01018102","Total",1148,346,49,297,359,151,286,65,221
"2011","Fenland 011C","E01018105","Total",544,197,15,182,142,48,168,25,143
"2011","Fenland 011D","E01018106","Total",693,184,15,169,178,71,168,32,136
"2011","Fenland 011E","E01018110","Total",1096,378,37,341,316,118,281,49,232
"2011","Huntingdonshire 001A","E01018212","Total",679,212,35,177,219,88,191,34,157
"2011","Huntingdonshire 001B","E01018213","Total",741,150,37,113,257,102,145,39,106
"2011","Huntingdonshire 001C","E01018214","Total",798,235,37,198,282,109,196,44,152
"2011","Huntingdonshire 001D","E01018215","Total",559,127,13,114,174,62,113,21,92
"2011","Huntingdonshire 001E","E01018216","Total",934,190,17,173,355,142,188,50,138
"2011","Huntingdonshire 001F","E01018217","Total",737,262,13,249,167,57,202,18,184
"2011","Huntingdonshire 002A","E01018127","Total",633,174,17,157,162,53,128,19,109
"2011","Huntingdonshire 002B","E01018128","Total",511,164,9,155,122,29,116,20,96
"2011","Huntingdonshire 002C","E01018200","Total",637,153,12,141,217,59,130,29,101
"2011","Huntingdonshire 002D","E01018201","Total",600,132,13,119,209,79,114,25,89
"2011","Huntingdonshire 003A","E01018156","Total",678,219,10,209,187,66,156,20,136
"2011","Huntingdonshire 003B","E01018157","Total",795,186,26,160,263,94,179,42,137
"2011","Huntingdonshire 003C","E01018158","Total",844,326,23,303,173,63,267,28,239
"2011","Huntingdonshire 003D","E01018159","Total",553,140,12,128,177,54,123,30,93
"2011","Huntingdonshire 003E","E01018160","Total",689,262,40,222,209,85,232,43,189
"2011","Huntingdonshire 004A","E01018191","Total",473,130,8,122,159,50,115,27,88
"2011","Huntingdonshire 004B","E01018192","Total",556,142,5,137,161,49,127,17,110
"2011","Huntingdonshire 004C","E01018193","Total",492,109,6,103,131,40,101,18,83
"2011","Huntingdonshire 004D","E01018194","Total",581,161,8,153,165,54,137,25,112
"2011","Huntingdonshire 004E","E01018195","Total",539,161,21,140,178,64,142,23,119
"2011","Huntingdonshire 005A","E01018208","Total",674,191,21,170,192,80,164,34,130
"2011","Huntingdonshire 005B","E01018209","Total",598,155,19,136,183,57,132,32,100
"2011","Huntingdonshire 005C","E01018210","Total",592,186,15,171,173,58,152,22,130
"2011","Huntingdonshire 005D","E01018211","Total",689,190,6,184,231,80,168,36,132
"2011","Huntingdonshire 006A","E01018196","Total",510,136,4,132,129,46,121,16,105
"2011","Huntingdonshire 006B","E01018197","Total",656,174,14,160,204,83,161,28,133
"2011","Huntingdonshire 006C","E01018198","Total",674,154,12,142,192,47,143,29,114
"2011","Huntingdonshire 006D","E01018199","Total",604,137,9,128,181,59,124,33,91
"2011","Huntingdonshire 006E","E01018206","Total",714,83,18,65,314,145,124,54,70
"2011","Huntingdonshire 006F","E01018207","Total",617,146,15,131,180,71,140,24,116
"2011","Huntingdonshire 007A","E01018121","Total",513,120,4,116,166,45,96,14,82
"2011","Huntingdonshire 007B","E01018122","Total",494,174,5,169,137,45,144,19,125
"2011","Huntingdonshire 007C","E01018123","Total",641,146,8,138,185,70,130,27,103
"2011","Huntingdonshire 007D","E01018124","Total",766,184,11,173,258,88,173,37,136
"2011","Huntingdonshire 008A","E01018143","Total",692,275,27,248,206,79,220,43,177
"2011","Huntingdonshire 008B","E01018144","Total",565,189,58,131,237,107,135,27,108
"2011","Huntingdonshire 008C","E01018145","Total",481,128,42,86,181,88,139,37,102
"2011","Huntingdonshire 008D","E01018146","Total",764,164,50,114,317,147,154,47,107
"2011","Huntingdonshire 008E","E01018147","Total",579,142,55,87,258,126,137,58,79
"2011","Huntingdonshire 009A","E01018139","Total",571,140,27,113,200,73,131,25,106
"2011","Huntingdonshire 009B","E01018140","Total",507,147,8,139,140,49,112,19,93
"2011","Huntingdonshire 009C","E01018141","Total",682,171,5,166,183,69,137,27,110
"2011","Huntingdonshire 009D","E01018142","Total",626,269,23,246,160,64,172,23,149
"2011","Huntingdonshire 010B","E01018113","Total",583,155,14,141,191,57,107,21,86
"2011","Huntingdonshire 010D","E01018116","Total",492,128,2,126,177,59,96,18,78
"2011","Huntingdonshire 010E","E01018117","Total",761,331,9,322,157,51,238,20,218
"2011","Huntingdonshire 010F","E01018118","Total",787,166,12,154,280,100,132,32,100
"2011","Huntingdonshire 010G","E01033433","Total",808,274,12,262,204,77,206,24,182
"2011","Huntingdonshire 011A","E01018161","Total",578,110,7,103,185,68,105,18,87
"2011","Huntingdonshire 011B","E01018162","Total",619,109,24,85,219,92,104,26,78
"2011","Huntingdonshire 011C","E01018163","Total",597,95,26,69,214,89,106,36,70
"2011","Huntingdonshire 011D","E01018164","Total",534,121,9,112,154,67,105,16,89
"2011","Huntingdonshire 011E","E01018165","Total",557,123,8,115,148,64,102,16,86
"2011","Huntingdonshire 011F","E01018170","Total",601,219,7,212,154,49,165,27,138
"2011","Huntingdonshire 011G","E01018171","Total",586,156,9,147,165,60,130,22,108
"2011","Huntingdonshire 012A","E01018138","Total",924,250,17,233,209,102,221,22,199
"2011","Huntingdonshire 012B","E01018148","Total",896,111,31,80,455,205,128,51,77
"2011","Huntingdonshire 012C","E01018149","Total",539,68,10,58,249,90,84,38,46
"2011","Huntingdonshire 012D","E01018150","Total",665,112,21,91,253,101,136,37,99
"2011","Huntingdonshire 012E","E01018151","Total",905,226,15,211,170,98,174,15,159
"2011","Huntingdonshire 013A","E01018166","Total",652,226,13,213,178,73,158,22,136
"2011","Huntingdonshire 013B","E01018167","Total",584,177,4,173,180,47,135,28,107
"2011","Huntingdonshire 013C","E01018168","Total",1081,422,16,406,147,77,297,18,279
"2011","Huntingdonshire 013D","E01018169","Total",621,197,27,170,192,76,153,25,128
"2011","Huntingdonshire 014A","E01018131","Total",634,205,17,188,189,75,176,24,152
"2011","Huntingdonshire 014B","E01018132","Total",809,288,6,282,150,62,211,14,197
"2011","Huntingdonshire 014C","E01018133","Total",662,156,12,144,232,98,147,28,119
"2011","Huntingdonshire 014D","E01018134","Total",774,146,23,123,267,115,108,25,83
"2011","Huntingdonshire 015A","E01018125","Total",605,156,9,147,195,51,127,26,101
"2011","Huntingdonshire 015B","E01018126","Total",631,147,14,133,208,55,127,24,103
"2011","Huntingdonshire 015C","E01018152","Total",598,145,12,133,187,55,127,26,101
"2011","Huntingdonshire 015D","E01018153","Total",757,227,16,211,236,70,153,23,130
"2011","Huntingdonshire 016A","E01018129","Total",649,161,12,149,184,70,138,26,112
"2011","Huntingdonshire 016B","E01018130","Total",698,157,9,148,215,90,147,25,122
"2011","Huntingdonshire 016C","E01018202","Total",639,256,3,253,150,67,153,15,138
"2011","Huntingdonshire 016D","E01018203","Total",621,198,2,196,140,47,131,15,116
"2011","Huntingdonshire 016E","E01018204","Total",541,157,7,150,181,64,107,18,89
"2011","Huntingdonshire 016F","E01018205","Total",826,284,4,280,168,52,179,22,157
"2011","Huntingdonshire 017A","E01018115","Total",567,162,1,161,138,45,129,19,110
"2011","Huntingdonshire 017B","E01018119","Total",638,175,9,166,174,47,126,24,102
"2011","Huntingdonshire 017C","E01018120","Total",757,296,14,282,212,71,189,34,155
"2011","Huntingdonshire 017D","E01018137","Total",695,167,14,153,225,82,144,27,117
"2011","Huntingdonshire 018A","E01018135","Total",1151,237,70,167,457,247,174,47,127
"2011","Huntingdonshire 018B","E01018136","Total",690,173,5,168,207,67,141,22,119
"2011","Huntingdonshire 018C","E01018154","Total",720,221,17,204,213,84,156,23,133
"2011","Huntingdonshire 018D","E01018155","Total",641,183,4,179,146,48,147,17,130
"2011","Huntingdonshire 019A","E01018187","Total",1022,395,25,370,187,87,272,24,248
"2011","Huntingdonshire 019B","E01018188","Total",634,202,13,189,187,56,162,24,138
"2011","Huntingdonshire 019C","E01018189","Total",502,142,3,139,170,58,105,27,78
"2011","Huntingdonshire 019D","E01018190","Total",627,205,19,186,196,85,164,34,130
"2011","Huntingdonshire 020A","E01018172","Total",625,239,2,237,141,41,152,17,135
"2011","Huntingdonshire 020B","E01018173","Total",509,81,14,67,163,74,68,24,44
"2011","Huntingdonshire 020C","E01018174","Total",689,196,17,179,187,64,145,21,124
"2011","Huntingdonshire 020D","E01018175","Total",549,132,5,127,162,49,98,21,77
"2011","Huntingdonshire 020E","E01018176","Total",484,139,3,136,142,34,84,17,67
"2011","Huntingdonshire 021A","E01018181","Total",1167,208,20,188,376,177,200,46,154
"2011","Huntingdonshire 021B","E01018182","Total",583,108,16,92,201,85,106,37,69
"2011","Huntingdonshire 021C","E01018183","Total",618,179,38,141,202,79,148,40,108
"2011","Huntingdonshire 021D","E01018184","Total",508,147,37,110,205,75,127,33,94
"2011","Huntingdonshire 021E","E01018185","Total",724,244,10,234,176,61,184,24,160
"2011","Huntingdonshire 021F","E01018186","Total",734,194,18,176,221,78,186,32,154
"2011","Huntingdonshire 022A","E01018177","Total",647,182,5,177,148,61,157,28,129
"2011","Huntingdonshire 022B","E01018178","Total",629,200,7,193,165,64,160,17,143
"2011","Huntingdonshire 022C","E01018179","Total",598,175,25,150,179,85,154,36,118
"2011","Huntingdonshire 022D","E01018180","Total",573,182,40,142,191,80,144,30,114
"2011","South Cambridgeshire 001A","E01018304","Total",781,206,15,191,250,109,184,33,151
"2011","South Cambridgeshire 001B","E01018305","Total",539,161,6,155,169,50,125,23,102
"2011","South Cambridgeshire 001C","E01018306","Total",583,127,7,120,223,78,92,14,78
"2011","South Cambridgeshire 001D","E01018307","Total",847,181,8,173,262,104,157,26,131
"2011","South Cambridgeshire 002A","E01018233","Total",658,182,5,177,185,74,156,23,133
"2011","South Cambridgeshire 002B","E01018234","Total",655,152,7,145,201,76,116,21,95
"2011","South Cambridgeshire 002C","E01018235","Total",702,197,5,192,227,88,178,24,154
"2011","South Cambridgeshire 002D","E01018236","Total",643,194,10,184,211,75,174,23,151
"2011","South Cambridgeshire 003A","E01018237","Total",624,145,14,131,185,64,129,23,106
"2011","South Cambridgeshire 003B","E01018266","Total",1095,217,15,202,362,189,187,33,154
"2011","South Cambridgeshire 003C","E01018284","Total",522,115,3,112,155,54,103,18,85
"2011","South Cambridgeshire 003D","E01018285","Total",474,103,7,96,160,56,112,26,86
"2011","South Cambridgeshire 004A","E01018298","Total",493,49,9,40,238,131,59,16,43
"2011","South Cambridgeshire 004B","E01018299","Total",731,203,15,188,199,90,163,21,142
"2011","South Cambridgeshire 004C","E01018300","Total",501,164,3,161,117,46,126,11,115
"2011","South Cambridgeshire 004D","E01018301","Total",565,139,3,136,162,55,109,14,95
"2011","South Cambridgeshire 005A","E01018221","Total",749,139,4,135,198,77,134,24,110
"2011","South Cambridgeshire 005B","E01018222","Total",591,141,4,137,162,41,123,22,101
"2011","South Cambridgeshire 005C","E01018223","Total",799,203,12,191,237,92,185,30,155
"2011","South Cambridgeshire 006A","E01018257","Total",585,213,13,200,161,49,190,29,161
"2011","South Cambridgeshire 006B","E01018258","Total",683,219,7,212,205,74,176,27,149
"2011","South Cambridgeshire 006C","E01018259","Total",534,129,10,119,164,53,93,17,76
"2011","South Cambridgeshire 006D","E01018260","Total",772,247,8,239,174,59,195,20,175
"2011","South Cambridgeshire 006F","E01018262","Total",549,146,3,143,167,52,111,15,96
"2011","South Cambridgeshire 006G","E01033120","Total",530,109,25,84,194,76,103,31,72
"2011","South Cambridgeshire 006H","E01033121","Total",558,73,36,37,244,149,82,36,46
"2011","South Cambridgeshire 007A","E01018272","Total",503,94,5,89,190,62,96,20,76
"2011","South Cambridgeshire 007B","E01018273","Total",683,237,16,221,172,69,176,18,158
"2011","South Cambridgeshire 007C","E01018274","Total",703,73,13,60,236,105,90,23,67
"2011","South Cambridgeshire 007D","E01018297","Total",737,173,9,164,184,68,154,20,134
"2011","South Cambridgeshire 009A","E01018224","Total",591,169,9,160,177,75,141,20,121
"2011","South Cambridgeshire 009B","E01018225","Total",494,197,2,195,109,26,145,13,132
"2011","South Cambridgeshire 009C","E01018248","Total",712,162,8,154,242,107,134,30,104
"2011","South Cambridgeshire 009D","E01018249","Total",453,161,3,158,101,42,128,9,119
"2011","South Cambridgeshire 009E","E01018250","Total",522,180,7,173,136,57,124,10,114
"2011","South Cambridgeshire 010A","E01018231","Total",972,227,10,217,345,121,178,47,131
"2011","South Cambridgeshire 010B","E01018232","Total",948,286,12,274,303,76,211,36,175
"2011","South Cambridgeshire 010C","E01018251","Total",484,83,8,75,159,47,95,19,76
"2011","South Cambridgeshire 010D","E01018252","Total",533,98,12,86,208,66,108,29,79
"2011","South Cambridgeshire 010E","E01018255","Total",458,132,6,126,146,32,97,17,80
"2011","South Cambridgeshire 011A","E01018242","Total",564,205,9,196,145,52,160,25,135
"2011","South Cambridgeshire 011B","E01018243","Total",659,129,14,115,249,103,112,31,81
"2011","South Cambridgeshire 011C","E01018244","Total",662,226,5,221,167,57,154,20,134
"2011","South Cambridgeshire 011D","E01018286","Total",667,157,16,141,218,93,145,33,112
"2011","South Cambridgeshire 011E","E01018287","Total",586,88,10,78,170,96,83,11,72
"2011","South Cambridgeshire 011F","E01018296","Total",464,146,5,141,122,35,124,17,107
"2011","South Cambridgeshire 012A","E01018292","Total",556,158,7,151,169,68,112,10,102
"2011","South Cambridgeshire 012B","E01018293","Total",628,241,7,234,174,62,173,20,153
"2011","South Cambridgeshire 012C","E01018294","Total",844,277,17,260,171,72,221,31,190
"2011","South Cambridgeshire 012D","E01018295","Total",645,214,9,205,188,65,167,17,150
"2011","South Cambridgeshire 013A","E01018245","Total",694,190,7,183,191,71,169,26,143
"2011","South Cambridgeshire 013B","E01018246","Total",714,216,13,203,180,58,172,27,145
"2011","South Cambridgeshire 013C","E01018247","Total",637,153,7,146,192,66,135,29,106
"2011","South Cambridgeshire 013D","E01018275","Total",974,314,14,300,273,88,214,25,189
"2011","South Cambridgeshire 014A","E01018240","Total",483,148,7,141,161,48,132,25,107
"2011","South Cambridgeshire 014B","E01018253","Total",428,121,4,117,134,53,87,14,73
"2011","South Cambridgeshire 014C","E01018254","Total",563,185,10,175,148,62,129,19,110
"2011","South Cambridgeshire 014D","E01018256","Total",626,200,12,188,178,56,140,19,121
"2011","South Cambridgeshire 014E","E01018291","Total",492,162,5,157,152,57,119,16,103
"2011","South Cambridgeshire 015A","E01018279","Total",673,260,16,244,144,52,220,26,194
"2011","South Cambridgeshire 015B","E01018280","Total",611,171,8,163,148,50,167,24,143
"2011","South Cambridgeshire 015C","E01018281","Total",692,219,14,205,163,74,198,28,170
"2011","South Cambridgeshire 015D","E01018282","Total",522,114,1,113,165,71,95,11,84
"2011","South Cambridgeshire 015E","E01018283","Total",494,105,7,98,160,58,98,15,83
"2011","South Cambridgeshire 016A","E01018218","Total",718,213,9,204,205,61,141,18,123
"2011","South Cambridgeshire 016B","E01018219","Total",563,166,6,160,189,51,124,23,101
"2011","South Cambridgeshire 016C","E01018220","Total",596,144,10,134,172,46,136,20,116
"2011","South Cambridgeshire 016D","E01018263","Total",598,148,8,140,187,70,119,16,103
"2011","South Cambridgeshire 016E","E01018264","Total",653,232,16,216,190,69,171,21,150
"2011","South Cambridgeshire 016F","E01018265","Total",703,184,3,181,222,79,164,25,139
"2011","South Cambridgeshire 017A","E01018238","Total",578,167,12,155,178,73,128,22,106
"2011","South Cambridgeshire 017B","E01018239","Total",546,156,8,148,177,67,108,13,95
"2011","South Cambridgeshire 017C","E01018288","Total",494,162,7,155,144,39,126,18,108
"2011","South Cambridgeshire 017D","E01018289","Total",472,104,4,100,132,56,90,10,80
"2011","South Cambridgeshire 017E","E01018302","Total",614,109,8,101,190,80,112,19,93
"2011","South Cambridgeshire 017F","E01018303","Total",511,168,10,158,148,45,127,17,110
"2011","South Cambridgeshire 018A","E01018241","Total",485,113,0,113,141,60,108,21,87
"2011","South Cambridgeshire 018B","E01018267","Total",1003,347,11,336,275,103,266,38,228
"2011","South Cambridgeshire 018C","E01018268","Total",733,158,12,146,258,81,144,45,99
"2011","South Cambridgeshire 018D","E01018269","Total",597,200,12,188,157,64,189,26,163
"2011","South Cambridgeshire 018E","E01018270","Total",445,121,5,116,127,35,93,14,79
"2011","South Cambridgeshire 018F","E01018271","Total",566,168,6,162,162,63,140,22,118
"2011","South Cambridgeshire 019A","E01018226","Total",474,84,6,78,211,99,70,19,51
"2011","South Cambridgeshire 019B","E01018227","Total",747,186,18,168,263,90,161,37,124
"2011","South Cambridgeshire 019C","E01018228","Total",663,177,11,166,208,63,147,29,118
"2011","South Cambridgeshire 019D","E01018290","Total",987,256,12,244,289,101,230,31,199
"2011","South Cambridgeshire 020A","E01033113","Total",452,114,26,88,188,108,105,26,79
"2011","South Cambridgeshire 020B","E01033114","Total",561,60,22,38,271,124,72,34,38
"2011","South Cambridgeshire 020C","E01033115","Total",467,46,16,30,266,146,66,34,32
"2011","South Cambridgeshire 020D","E01033117","Total",468,50,19,31,241,123,60,31,29
"2011","South Cambridgeshire 020E","E01033119","Total",660,66,24,42,324,187,70,31,39
"2011","South Cambridgeshire 021A","E01018276","Total",583,149,13,136,198,97,173,29,144
"2011","South Cambridgeshire 021B","E01018277","Total",709,167,4,163,198,64,164,34,130
"2011","South Cambridgeshire 021C","E01018278","Total",664,135,7,128,251,98,143,23,120
"2011","South Cambridgeshire 021D","E01033116","Total",641,158,16,142,235,98,136,32,104
"2011","South Cambridgeshire 021E","E01033118","Total",575,87,6,81,209,88,101,24,77
"2011","Basildon 001A","E01021237","Total",518,158,8,150,180,63,91,15,76
"2011","Basildon 001B","E01021238","Total",520,142,7,135,193,54,101,24,77
"2011","Basildon 001C","E01021242","Total",482,128,4,124,151,48,84,12,72
"2011","Basildon 001D","E01021250","Total",632,190,3,187,186,58,131,12,119
"2011","Basildon 001E","E01021251","Total",603,149,6,143,206,57,100,23,77
"2011","Basildon 002A","E01021245","Total",638,230,28,202,180,83,214,38,176
"2011","Basildon 002B","E01021246","Total",652,230,3,227,160,68,151,16,135
"2011","Basildon 002C","E01021248","Total",620,160,10,150,203,79,101,22,79
"2011","Basildon 002D","E01021249","Total",622,159,7,152,199,71,91,17,74
"2011","Basildon 002E","E01021252","Total",637,174,7,167,176,71,131,13,118
"2011","Basildon 003A","E01021239","Total",522,159,8,151,190,61,88,21,67
"2011","Basildon 003B","E01021240","Total",787,231,12,219,191,81,147,16,131
"2011","Basildon 003C","E01021241","Total",650,212,23,189,212,86,153,27,126
"2011","Basildon 003D","E01021243","Total",668,167,7,160,220,75,130,26,104
"2011","Basildon 003E","E01021247","Total",657,277,5,272,165,57,165,16,149
"2011","Basildon 004A","E01021244","Total",633,247,7,240,168,71,148,20,128
"2011","Basildon 004B","E01021253","Total",675,243,13,230,209,77,140,20,120
"2011","Basildon 004C","E01021255","Total",632,269,6,263,141,48,192,21,171
"2011","Basildon 004D","E01021256","Total",608,226,4,222,163,47,168,21,147
"2011","Basildon 004E","E01021258","Total",785,311,16,295,174,70,239,23,216
"2011","Basildon 005A","E01021334","Total",690,268,14,254,184,69,178,21,157
"2011","Basildon 005B","E01021336","Total",740,299,15,284,176,55,204,21,183
"2011","Basildon 005C","E01021338","Total",615,219,29,190,186,87,155,27,128
"2011","Basildon 005D","E01021339","Total",649,268,28,240,153,65,203,22,181
"2011","Basildon 006A","E01021264","Total",519,146,11,135,155,45,111,18,93
"2011","Basildon 006B","E01021329","Total",691,294,10,284,135,57,211,11,200
"2011","Basildon 006C","E01021330","Total",656,233,7,226,177,57,158,22,136
"2011","Basildon 006D","E01021332","Total",608,230,6,224,142,39,168,24,144
"2011","Basildon 006E","E01021333","Total",637,234,1,233,148,45,162,22,140
"2011","Basildon 007A","E01021335","Total",515,91,8,83,206,57,91,26,65
"2011","Basildon 007B","E01021337","Total",615,242,3,239,138,36,171,25,146
"2011","Basildon 007C","E01021340","Total",659,190,8,182,195,71,130,16,114
"2011","Basildon 007D","E01021341","Total",653,204,11,193,192,79,144,17,127
"2011","Basildon 007E","E01021345","Total",764,91,13,78,357,178,105,34,71
"2011","Basildon 008A","E01021331","Total",639,178,8,170,174,54,169,29,140
"2011","Basildon 008B","E01021342","Total",714,273,26,247,198,92,227,33,194
"2011","Basildon 008C","E01021343","Total",746,111,34,77,300,125,103,33,70
"2011","Basildon 008D","E01021344","Total",859,136,20,116,345,154,130,42,88
"2011","Basildon 008E","E01021346","Total",856,175,15,160,273,128,160,31,129
"2011","Basildon 009A","E01021254","Total",550,185,4,181,160,46,111,13,98
"2011","Basildon 009B","E01021257","Total",615,219,8,211,177,54,167,30,137
"2011","Basildon 009C","E01021259","Total",636,174,11,163,179,69,121,19,102
"2011","Basildon 009D","E01021260","Total",803,218,30,188,260,139,158,36,122
"2011","Basildon 010A","E01021261","Total",687,185,27,158,215,83,149,35,114
"2011","Basildon 010B","E01021262","Total",747,237,16,221,176,75,199,18,181
"2011","Basildon 010C","E01021263","Total",789,150,21,129,270,113,118,27,91
"2011","Basildon 010D","E01021274","Total",806,266,29,237,208,102,215,28,187
"2011","Basildon 010E","E01021279","Total",662,214,62,152,251,101,170,46,124
"2011","Basildon 011A","E01021301","Total",618,215,63,152,226,96,173,39,134
"2011","Basildon 011B","E01021303","Total",592,193,34,159,164,73,165,19,146
"2011","Basildon 011C","E01021307","Total",586,145,38,107,184,81,129,33,96
"2011","Basildon 011D","E01021308","Total",489,73,9,64,172,70,88,22,66
"2011","Basildon 011E","E01021309","Total",610,140,30,110,182,87,117,23,94
"2011","Basildon 011F","E01021312","Total",559,149,17,132,163,40,138,28,110
"2011","Basildon 012A","E01021265","Total",630,232,32,200,195,80,179,29,150
"2011","Basildon 012B","E01021267","Total",766,329,42,287,198,74,221,21,200
"2011","Basildon 012C","E01021269","Total",653,212,37,175,230,93,196,53,143
"2011","Basildon 012D","E01021270","Total",625,200,39,161,213,87,184,39,145
"2011","Basildon 012E","E01021272","Total",650,222,47,175,233,110,190,36,154
"2011","Basildon 013A","E01021271","Total",685,233,85,148,283,142,202,56,146
"2011","Basildon 013B","E01021302","Total",623,280,96,184,241,116,228,60,168
"2011","Basildon 013C","E01021304","Total",612,268,59,209,183,85,215,39,176
"2011","Basildon 013D","E01021305","Total",613,253,50,203,187,70,226,40,186
"2011","Basildon 013E","E01021306","Total",609,239,52,187,187,73,209,38,171
"2011","Basildon 014A","E01021273","Total",763,304,36,268,187,91,209,26,183
"2011","Basildon 014B","E01021275","Total",676,233,20,213,177,56,182,30,152
"2011","Basildon 014C","E01021276","Total",690,235,28,207,159,71,189,30,159
"2011","Basildon 014D","E01021277","Total",664,234,29,205,159,66,183,30,153
"2011","Basildon 014E","E01021278","Total",790,303,48,255,228,119,235,33,202
"2011","Basildon 015A","E01021266","Total",735,310,45,265,212,100,242,39,203
"2011","Basildon 015B","E01021268","Total",651,327,47,280,178,70,247,39,208
"2011","Basildon 015C","E01021318","Total",925,336,71,265,282,145,259,51,208
"2011","Basildon 015D","E01021320","Total",652,195,37,158,221,81,176,41,135
"2011","Basildon 015E","E01021321","Total",697,254,43,211,221,95,180,36,144
"2011","Basildon 016A","E01021286","Total",706,206,65,141,256,121,181,40,141
"2011","Basildon 016B","E01021288","Total",606,248,143,105,371,169,148,64,84
"2011","Basildon 016C","E01021289","Total",707,207,56,151,273,120,194,53,141
"2011","Basildon 016D","E01021290","Total",669,290,141,149,325,132,201,73,128
"2011","Basildon 016E","E01021291","Total",784,304,53,251,213,105,237,35,202
"2011","Basildon 017A","E01021287","Total",613,179,28,151,216,71,150,39,111
"2011","Basildon 017B","E01021292","Total",632,238,37,201,191,71,177,30,147
"2011","Basildon 017C","E01021293","Total",736,260,33,227,227,98,197,30,167
"2011","Basildon 017D","E01021298","Total",656,229,37,192,211,82,164,26,138
"2011","Basildon 017E","E01021319","Total",717,282,41,241,208,100,200,24,176
"2011","Basildon 018A","E01021313","Total",588,176,15,161,130,36,149,16,133
"2011","Basildon 018B","E01021314","Total",572,214,52,162,192,73,173,34,139
"2011","Basildon 018C","E01021315","Total",679,284,45,239,183,61,228,41,187
"2011","Basildon 018D","E01021316","Total",702,321,46,275,181,78,291,42,249
"2011","Basildon 018E","E01021317","Total",668,247,57,190,222,103,196,42,154
"2011","Basildon 019A","E01021322","Total",627,230,49,181,201,79,175,45,130
"2011","Basildon 019B","E01021323","Total",673,286,106,180,293,121,201,57,144
"2011","Basildon 019C","E01021324","Total",667,283,77,206,267,104,187,60,127
"2011","Basildon 019D","E01021325","Total",642,270,95,175,246,115,189,39,150
"2011","Basildon 019E","E01021327","Total",741,324,60,264,227,96,239,54,185
"2011","Basildon 020A","E01021294","Total",645,220,20,200,210,66,160,22,138
"2011","Basildon 020B","E01021295","Total",705,264,39,225,224,102,225,41,184
"2011","Basildon 020C","E01021296","Total",772,280,28,252,218,98,226,33,193
"2011","Basildon 020D","E01021297","Total",693,201,41,160,218,89,155,30,125
"2011","Basildon 020E","E01021299","Total",600,205,4,201,150,37,158,24,134
"2011","Basildon 021A","E01021280","Total",627,93,18,75,233,92,86,27,59
"2011","Basildon 021B","E01021281","Total",598,163,8,155,154,56,132,25,107
"2011","Basildon 021C","E01021282","Total",619,193,15,178,160,55,115,18,97
"2011","Basildon 021D","E01021283","Total",647,185,45,140,203,86,167,31,136
"2011","Basildon 021E","E01021284","Total",579,86,15,71,245,84,96,24,72
"2011","Basildon 021F","E01021285","Total",532,104,10,94,197,63,76,25,51
"2011","Basildon 022A","E01021300","Total",852,295,70,225,282,133,230,46,184
"2011","Basildon 022B","E01021310","Total",700,216,20,196,120,62,171,20,151
"2011","Basildon 022C","E01021311","Total",613,271,27,244,135,48,205,32,173
"2011","Basildon 022D","E01021326","Total",720,213,56,157,247,113,184,41,143
"2011","Basildon 022E","E01021328","Total",635,222,55,167,222,81,180,47,133
"2011","Braintree 001A","E01021375","Total",473,119,10,109,137,49,104,18,86
"2011","Braintree 001B","E01021376","Total",556,154,9,145,165,47,127,19,108
"2011","Braintree 001C","E01021414","Total",884,267,27,240,236,77,213,30,183
"2011","Braintree 001D","E01021430","Total",836,238,26,212,284,116,197,36,161
"2011","Braintree 002A","E01021398","Total",627,188,8,180,165,40,149,16,133
"2011","Braintree 002B","E01021406","Total",952,299,15,284,219,63,217,33,184
"2011","Braintree 002C","E01021407","Total",921,286,16,270,245,72,198,23,175
"2011","Braintree 003A","E01021382","Total",524,166,3,163,139,46,145,23,122
"2011","Braintree 003B","E01021397","Total",742,184,18,166,208,61,173,26,147
"2011","Braintree 003C","E01021399","Total",675,242,24,218,198,67,195,32,163
"2011","Braintree 003D","E01021400","Total",747,230,17,213,191,66,203,29,174
"2011","Braintree 004A","E01021387","Total",1015,331,18,313,229,106,265,29,236
"2011","Braintree 004B","E01021388","Total",720,241,23,218,205,72,196,38,158
"2011","Braintree 004C","E01021391","Total",692,279,87,192,286,131,209,54,155
"2011","Braintree 004D","E01021392","Total",754,231,18,213,189,86,200,32,168
"2011","Braintree 004E","E01021393","Total",650,200,19,181,185,84,151,23,128
"2011","Braintree 005A","E01021404","Total",892,275,17,258,209,65,213,38,175
"2011","Braintree 005B","E01021411","Total",536,184,8,176,140,37,126,14,112
"2011","Braintree 005C","E01021412","Total",595,148,11,137,182,59,127,22,105
"2011","Braintree 005D","E01021413","Total",525,145,8,137,131,47,126,13,113
"2011","Braintree 006A","E01021389","Total",719,235,14,221,257,91,183,36,147
"2011","Braintree 006B","E01021390","Total",664,218,10,208,170,73,151,18,133
"2011","Braintree 006C","E01021408","Total",699,225,10,215,175,58,171,28,143
"2011","Braintree 006D","E01021409","Total",720,186,10,176,256,83,121,30,91
"2011","Braintree 006E","E01021410","Total",719,277,35,242,208,93,183,25,158
"2011","Braintree 007A","E01021349","Total",491,66,15,51,201,72,81,28,53
"2011","Braintree 007B","E01021351","Total",559,72,7,65,259,86,87,26,61
"2011","Braintree 007C","E01021352","Total",589,127,16,111,235,94,106,28,78
"2011","Braintree 007D","E01021355","Total",825,264,25,239,210,92,186,27,159
"2011","Braintree 007E","E01021356","Total",545,169,8,161,155,51,145,19,126
"2011","Braintree 007F","E01021381","Total",513,206,7,199,99,33,132,10,122
"2011","Braintree 008A","E01021354","Total",548,199,46,153,176,87,158,26,132
"2011","Braintree 008B","E01021357","Total",636,200,18,182,178,52,180,30,150
"2011","Braintree 008C","E01021358","Total",919,349,90,259,331,159,285,54,231
"2011","Braintree 008D","E01021359","Total",866,322,70,252,286,125,273,48,225
"2011","Braintree 009A","E01021350","Total",712,227,11,216,197,77,157,22,135
"2011","Braintree 009B","E01021353","Total",807,276,29,247,214,106,224,27,197
"2011","Braintree 009D","E01021365","Total",1133,380,37,343,237,110,298,23,275
"2011","Braintree 009E","E01033458","Total",691,152,25,127,157,99,138,15,123
"2011","Braintree 009F","E01033459","Total",876,272,41,231,215,111,238,44,194
"2011","Braintree 010A","E01021364","Total",677,161,17,144,223,87,147,28,119
"2011","Braintree 010B","E01021366","Total",597,178,9,169,188,56,125,26,99
"2011","Braintree 010C","E01021383","Total",712,130,21,109,361,96,135,53,82
"2011","Braintree 010D","E01021405","Total",898,221,25,196,288,102,181,32,149
"2011","Braintree 011A","E01021368","Total",682,224,33,191,184,84,186,34,152
"2011","Braintree 011B","E01021370","Total",717,287,61,226,234,97,245,48,197
"2011","Braintree 011C","E01021372","Total",769,185,31,154,250,112,170,37,133
"2011","Braintree 011D","E01021373","Total",1041,266,40,226,322,177,209,47,162
"2011","Braintree 011E","E01021374","Total",600,208,47,161,207,77,187,52,135
"2011","Braintree 012A","E01021360","Total",781,267,56,211,270,118,216,36,180
"2011","Braintree 012B","E01021361","Total",647,144,21,123,212,100,111,26,85
"2011","Braintree 012C","E01021367","Total",572,195,46,149,238,69,150,37,113
"2011","Braintree 012D","E01021369","Total",1078,225,70,155,490,233,191,62,129
"2011","Braintree 012E","E01021380","Total",963,336,24,312,254,95,247,40,207
"2011","Braintree 013A","E01021347","Total",918,252,29,223,344,124,188,40,148
"2011","Braintree 013B","E01021371","Total",698,192,20,172,226,107,140,28,112
"2011","Braintree 013C","E01021384","Total",845,170,18,152,376,139,142,45,97
"2011","Braintree 013D","E01021385","Total",515,98,22,76,232,71,90,26,64
"2011","Braintree 013E","E01021386","Total",564,93,11,82,257,85,75,23,52
"2011","Braintree 014A","E01021377","Total",729,236,13,223,214,86,151,27,124
"2011","Braintree 014B","E01021378","Total",792,346,18,328,182,86,266,23,243
"2011","Braintree 014C","E01021379","Total",707,183,10,173,236,85,144,30,114
"2011","Braintree 014D","E01021401","Total",661,255,24,231,177,67,181,23,158
"2011","Braintree 014E","E01021402","Total",824,209,17,192,290,82,156,23,133
"2011","Braintree 014F","E01021403","Total",626,154,11,143,195,75,123,23,100
"2011","Braintree 015A","E01021362","Total",577,146,7,139,184,58,138,31,107
"2011","Braintree 015B","E01021417","Total",657,203,19,184,180,87,178,36,142
"2011","Braintree 015C","E01021418","Total",549,167,52,115,231,109,130,50,80
"2011","Braintree 015D","E01021419","Total",712,251,23,228,208,70,204,41,163
"2011","Braintree 015E","E01021426","Total",588,210,53,157,179,94,124,32,92
"2011","Braintree 015F","E01021428","Total",623,233,5,228,124,47,162,16,146
"2011","Braintree 016A","E01021423","Total",596,168,50,118,261,129,136,45,91
"2011","Braintree 016B","E01021425","Total",596,172,50,122,249,109,140,50,90
"2011","Braintree 016C","E01021427","Total",538,170,34,136,179,80,168,40,128
"2011","Braintree 016D","E01021429","Total",528,164,34,130,173,70,139,33,106
"2011","Braintree 017A","E01021415","Total",743,385,28,357,137,62,262,22,240
"2011","Braintree 017B","E01021416","Total",769,238,9,229,150,69,201,22,179
"2011","Braintree 017C","E01021420","Total",730,188,20,168,207,75,172,30,142
"2011","Braintree 017E","E01021422","Total",787,328,23,305,182,61,264,32,232
"2011","Braintree 017F","E01033460","Total",567,159,14,145,137,61,125,13,112
"2011","Braintree 017G","E01033461","Total",580,52,20,32,236,131,75,28,47
"2011","Braintree 017H","E01033462","Total",479,116,20,96,142,87,98,20,78
"2011","Braintree 018A","E01021348","Total",640,199,20,179,184,67,159,35,124
"2011","Braintree 018B","E01021394","Total",664,251,24,227,157,59,187,27,160
"2011","Braintree 018C","E01021395","Total",614,226,13,213,170,60,159,22,137
"2011","Braintree 018D","E01021396","Total",535,140,6,134,140,46,112,23,89
"2011","Braintree 018E","E01021424","Total",811,189,26,163,287,124,167,33,134
"2011","Brentwood 001A","E01021441","Total",573,173,18,155,202,49,135,31,104
"2011","Brentwood 001B","E01021442","Total",514,163,6,157,172,36,140,22,118
"2011","Brentwood 001C","E01021443","Total",541,140,14,126,160,53,140,32,108
"2011","Brentwood 001D","E01021444","Total",633,200,14,186,189,58,144,29,115
"2011","Brentwood 001E","E01021469","Total",462,159,7,152,129,29,100,13,87
"2011","Brentwood 001F","E01021470","Total",406,128,16,112,133,27,100,18,82
"2011","Brentwood 001G","E01021471","Total",613,224,6,218,187,47,164,25,139
"2011","Brentwood 002A","E01021457","Total",611,219,11,208,145,33,174,18,156
"2011","Brentwood 002B","E01021458","Total",777,310,14,296,172,54,198,18,180
"2011","Brentwood 002C","E01021459","Total",525,206,4,202,153,43,120,15,105
"2011","Brentwood 002D","E01021460","Total",675,223,19,204,189,60,179,27,152
"2011","Brentwood 003A","E01021448","Total",640,266,22,244,176,54,197,22,175
"2011","Brentwood 003B","E01021449","Total",638,204,18,186,198,55,186,25,161
"2011","Brentwood 003C","E01021450","Total",793,241,15,226,279,74,191,40,151
"2011","Brentwood 003D","E01021451","Total",623,202,45,157,254,91,165,45,120
"2011","Brentwood 003E","E01021452","Total",620,244,10,234,158,55,181,23,158
"2011","Brentwood 004A","E01021431","Total",633,158,11,147,206,79,132,21,111
"2011","Brentwood 004B","E01021432","Total",698,205,44,161,244,101,187,38,149
"2011","Brentwood 004C","E01021434","Total",512,153,18,135,175,69,120,31,89
"2011","Brentwood 004D","E01021461","Total",620,218,40,178,196,74,192,42,150
"2011","Brentwood 004E","E01021464","Total",599,198,14,184,167,61,169,23,146
"2011","Brentwood 005A","E01021447","Total",966,352,17,335,307,86,183,34,149
"2011","Brentwood 005B","E01021453","Total",519,175,7,168,146,49,107,9,98
"2011","Brentwood 005C","E01021455","Total",519,198,11,187,154,33,92,13,79
"2011","Brentwood 005D","E01021465","Total",816,258,8,250,220,98,158,15,143
"2011","Brentwood 005E","E01021466","Total",656,198,6,192,229,64,113,18,95
"2011","Brentwood 005F","E01021467","Total",668,208,3,205,235,77,126,22,104
"2011","Brentwood 006A","E01021438","Total",784,184,8,176,259,93,155,27,128
"2011","Brentwood 006B","E01021462","Total",568,171,7,164,162,56,143,17,126
"2011","Brentwood 006C","E01021463","Total",629,235,11,224,174,48,176,33,143
"2011","Brentwood 006D","E01021468","Total",768,221,13,208,237,81,169,27,142
"2011","Brentwood 007A","E01021433","Total",919,267,21,246,225,102,179,24,155
"2011","Brentwood 007B","E01021436","Total",1138,337,15,322,192,90,242,22,220
"2011","Brentwood 007C","E01021439","Total",1149,235,38,197,280,136,206,37,169
"2011","Brentwood 007E","E01021475","Total",666,134,9,125,206,92,120,24,96
"2011","Brentwood 007F","E01033063","Total",569,85,17,68,199,92,71,29,42
"2011","Brentwood 007G","E01033064","Total",686,204,22,182,169,83,164,25,139
"2011","Brentwood 008A","E01021435","Total",777,271,33,238,267,93,236,57,179
"2011","Brentwood 008B","E01021437","Total",728,275,51,224,250,115,228,39,189
"2011","Brentwood 008C","E01021472","Total",725,218,34,184,166,84,162,21,141
"2011","Brentwood 008D","E01021473","Total",517,134,6,128,137,54,103,14,89
"2011","Brentwood 008E","E01021474","Total",613,193,3,190,199,72,129,19,110
"2011","Brentwood 009A","E01021445","Total",842,235,11,224,261,66,199,45,154
"2011","Brentwood 009B","E01021446","Total",671,240,10,230,149,47,193,29,164
"2011","Brentwood 009C","E01021454","Total",536,123,10,113,168,55,107,15,92
"2011","Brentwood 009D","E01021456","Total",511,116,4,112,135,40,97,18,79
"2011","Castle Point 001A","E01021513","Total",643,225,14,211,176,56,153,26,127
"2011","Castle Point 001B","E01021514","Total",610,176,15,161,184,73,155,23,132
"2011","Castle Point 001C","E01021515","Total",493,136,15,121,182,60,99,28,71
"2011","Castle Point 001D","E01021525","Total",668,213,31,182,188,84,161,34,127
"2011","Castle Point 001E","E01021527","Total",674,238,9,229,190,65,164,24,140
"2011","Castle Point 002A","E01021509","Total",649,275,7,268,141,42,193,20,173
"2011","Castle Point 002B","E01021510","Total",670,313,12,301,138,56,199,22,177
"2011","Castle Point 002C","E01021511","Total",533,189,11,178,154,54,125,28,97
"2011","Castle Point 002D","E01021528","Total",586,191,11,180,163,43,145,22,123
"2011","Castle Point 002E","E01021531","Total",556,168,17,151,162,49,119,24,95
"2011","Castle Point 003A","E01021476","Total",770,269,19,250,232,74,216,40,176
"2011","Castle Point 003B","E01021477","Total",629,220,6,214,173,54,151,24,127
"2011","Castle Point 003C","E01021478","Total",666,225,9,216,206,49,144,28,116
"2011","Castle Point 003D","E01021516","Total",542,173,11,162,157,61,120,19,101
"2011","Castle Point 004A","E01021479","Total",592,204,8,196,180,57,145,23,122
"2011","Castle Point 004B","E01021481","Total",562,169,8,161,187,49,126,26,100
"2011","Castle Point 004C","E01021483","Total",688,240,9,231,196,63,157,25,132
"2011","Castle Point 004D","E01021512","Total",648,223,12,211,172,51,147,16,131
"2011","Castle Point 004E","E01021526","Total",650,211,11,200,181,64,155,23,132
"2011","Castle Point 005A","E01021517","Total",711,300,11,289,162,53,201,22,179
"2011","Castle Point 005B","E01021519","Total",636,265,8,257,144,36,179,14,165
"2011","Castle Point 005C","E01021530","Total",614,254,5,249,156,43,170,17,153
"2011","Castle Point 005D","E01021532","Total",645,258,4,254,123,42,179,15,164
"2011","Castle Point 006A","E01021482","Total",607,210,6,204,174,50,151,22,129
"2011","Castle Point 006B","E01021518","Total",940,367,22,345,215,74,266,26,240
"2011","Castle Point 006C","E01021520","Total",671,236,16,220,187,54,197,27,170
"2011","Castle Point 006D","E01021529","Total",646,246,22,224,191,59,215,31,184
"2011","Castle Point 007A","E01021480","Total",706,204,17,187,231,79,132,27,105
"2011","Castle Point 007B","E01021521","Total",607,196,7,189,158,54,158,21,137
"2011","Castle Point 007C","E01021522","Total",711,209,25,184,208,85,173,29,144
"2011","Castle Point 007D","E01021523","Total",602,270,9,261,131,35,170,16,154
"2011","Castle Point 007E","E01021524","Total",644,225,7,218,165,55,195,30,165
"2011","Castle Point 008A","E01021487","Total",593,247,12,235,147,55,204,24,180
"2011","Castle Point 008B","E01021494","Total",598,190,22,168,170,73,161,19,142
"2011","Castle Point 008C","E01021504","Total",503,76,15,61,214,66,97,33,64
"2011","Castle Point 008D","E01021505","Total",496,97,12,85,171,55,117,22,95
"2011","Castle Point 008E","E01021506","Total",519,134,23,111,194,90,123,29,94
"2011","Castle Point 009A","E01021492","Total",761,289,25,264,203,83,220,35,185
"2011","Castle Point 009B","E01021493","Total",702,284,21,263,155,58,208,13,195
"2011","Castle Point 009C","E01021495","Total",1141,762,7,755,104,41,443,13,430
"2011","Castle Point 009D","E01021496","Total",590,230,35,195,176,79,169,30,139
"2011","Castle Point 010A","E01021485","Total",494,210,40,170,147,45,184,38,146
"2011","Castle Point 010B","E01021486","Total",462,173,61,112,191,73,134,36,98
"2011","Castle Point 010C","E01021488","Total",611,269,32,237,163,45,210,29,181
"2011","Castle Point 010D","E01021503","Total",519,162,34,128,187,74,155,36,119
"2011","Castle Point 010E","E01021507","Total",619,243,80,163,242,77,189,40,149
"2011","Castle Point 010F","E01021508","Total",442,81,38,43,225,71,76,27,49
"2011","Castle Point 011A","E01021484","Total",589,265,18,247,129,42,181,21,160
"2011","Castle Point 011B","E01021498","Total",596,209,11,198,123,39,171,15,156
"2011","Castle Point 011C","E01021499","Total",660,233,12,221,146,48,152,12,140
"2011","Castle Point 011D","E01021501","Total",630,259,13,246,128,45,220,29,191
"2011","Castle Point 011E","E01021502","Total",985,353,35,318,264,109,253,42,211
"2011","Castle Point 012A","E01021489","Total",623,240,20,220,140,46,174,24,150
"2011","Castle Point 012B","E01021490","Total",663,269,30,239,174,62,203,34,169
"2011","Castle Point 012C","E01021491","Total",662,230,31,199,195,54,171,27,144
"2011","Castle Point 012D","E01021497","Total",659,267,18,249,153,49,192,24,168
"2011","Castle Point 012E","E01021500","Total",754,284,26,258,190,67,227,21,206
"2011","Chelmsford 001A","E01021538","Total",998,212,26,186,407,175,189,55,134
"2011","Chelmsford 001B","E01021539","Total",534,169,14,155,154,45,132,23,109
"2011","Chelmsford 001C","E01021540","Total",636,171,6,165,163,46,144,20,124
"2011","Chelmsford 001D","E01021541","Total",637,268,17,251,154,56,210,26,184
"2011","Chelmsford 002A","E01021542","Total",839,232,16,216,238,102,164,30,134
"2011","Chelmsford 002B","E01021543","Total",650,186,7,179,192,67,128,20,108
"2011","Chelmsford 002C","E01021587","Total",616,231,6,225,141,55,150,15,135
"2011","Chelmsford 002D","E01021590","Total",588,142,5,137,178,62,94,15,79
"2011","Chelmsford 002E","E01021591","Total",643,178,6,172,161,63,140,13,127
"2011","Chelmsford 003A","E01021550","Total",570,141,8,133,152,50,121,18,103
"2011","Chelmsford 003B","E01021597","Total",590,183,31,152,193,91,154,43,111
"2011","Chelmsford 003C","E01021598","Total",660,267,40,227,201,71,206,42,164
"2011","Chelmsford 003D","E01021600","Total",441,116,5,111,135,45,67,9,58
"2011","Chelmsford 003E","E01021601","Total",685,268,38,230,194,91,221,36,185
"2011","Chelmsford 004A","E01021616","Total",553,109,8,101,178,51,90,17,73
"2011","Chelmsford 004B","E01021617","Total",599,184,15,169,168,64,164,23,141
"2011","Chelmsford 004C","E01021619","Total",634,149,9,140,210,72,137,27,110
"2011","Chelmsford 004D","E01021620","Total",643,134,16,118,176,81,116,22,94
"2011","Chelmsford 004E","E01021623","Total",514,144,11,133,158,57,109,19,90
"2011","Chelmsford 004F","E01021624","Total",503,212,3,209,130,42,118,12,106
"2011","Chelmsford 005A","E01021536","Total",700,242,24,218,185,79,175,23,152
"2011","Chelmsford 005B","E01021537","Total",787,222,8,214,206,68,163,22,141
"2011","Chelmsford 005D","E01021568","Total",627,224,16,208,171,50,122,13,109
"2011","Chelmsford 005E","E01033142","Total",747,89,25,64,391,175,111,60,51
"2011","Chelmsford 005F","E01033144","Total",619,65,24,41,332,127,82,40,42
"2011","Chelmsford 006A","E01021576","Total",611,224,96,128,290,109,158,52,106
"2011","Chelmsford 006B","E01021588","Total",623,263,26,237,170,74,210,36,174
"2011","Chelmsford 006C","E01021589","Total",665,210,28,182,212,80,150,27,123
"2011","Chelmsford 006D","E01021592","Total",678,290,60,230,205,94,209,38,171
"2011","Chelmsford 006E","E01021596","Total",698,300,45,255,212,111,248,43,205
"2011","Chelmsford 007A","E01021618","Total",572,90,10,80,215,76,94,31,63
"2011","Chelmsford 007B","E01021621","Total",616,76,13,63,230,109,89,28,61
"2011","Chelmsford 007C","E01021622","Total",632,267,4,263,154,51,138,12,126
"2011","Chelmsford 007D","E01021625","Total",615,218,9,209,162,46,149,15,134
"2011","Chelmsford 007E","E01021626","Total",554,141,9,132,168,63,110,16,94
"2011","Chelmsford 008A","E01021544","Total",617,119,15,104,183,82,84,16,68
"2011","Chelmsford 008B","E01021545","Total",641,131,6,125,253,110,106,22,84
"2011","Chelmsford 008C","E01021546","Total",608,160,17,143,204,75,153,30,123
"2011","Chelmsford 008D","E01021547","Total",702,96,10,86,192,78,106,31,75
"2011","Chelmsford 008E","E01021628","Total",665,152,23,129,232,101,130,42,88
"2011","Chelmsford 008F","E01021629","Total",677,189,24,165,215,101,155,27,128
"2011","Chelmsford 009A","E01021573","Total",700,186,11,175,201,86,150,36,114
"2011","Chelmsford 009B","E01021575","Total",717,170,23,147,180,90,138,23,115
"2011","Chelmsford 009C","E01021599","Total",728,195,15,180,231,89,140,28,112
"2011","Chelmsford 009E","E01021631","Total",787,290,47,243,263,117,227,45,182
"2011","Chelmsford 009F","E01033138","Total",638,167,27,140,196,92,137,37,100
"2011","Chelmsford 009G","E01033139","Total",639,97,29,68,179,109,97,21,76
"2011","Chelmsford 010A","E01021574","Total",1010,182,26,156,150,103,121,15,106
"2011","Chelmsford 010B","E01021578","Total",859,157,21,136,183,108,124,16,108
"2011","Chelmsford 010D","E01021582","Total",976,209,24,185,174,98,165,28,137
"2011","Chelmsford 010E","E01021627","Total",588,206,4,202,112,55,130,15,115
"2011","Chelmsford 010F","E01033140","Total",627,151,15,136,106,65,104,5,99
"2011","Chelmsford 010G","E01033141","Total",604,202,10,192,72,34,141,7,134
"2011","Chelmsford 011A","E01021551","Total",557,194,15,179,156,48,127,21,106
"2011","Chelmsford 011B","E01021632","Total",601,258,15,243,134,46,155,27,128
"2011","Chelmsford 011C","E01021633","Total",514,199,7,192,95,29,119,11,108
"2011","Chelmsford 011D","E01021634","Total",614,182,7,175,184,51,123,20,103
"2011","Chelmsford 011E","E01021635","Total",625,245,6,239,125,44,169,14,155
"2011","Chelmsford 011F","E01021636","Total",510,233,27,206,131,35,181,24,157
"2011","Chelmsford 012A","E01021556","Total",677,188,7,181,209,90,134,23,111
"2011","Chelmsford 012B","E01021577","Total",613,167,13,154,198,79,117,21,96
"2011","Chelmsford 012C","E01021579","Total",608,121,10,111,205,92,107,25,82
"2011","Chelmsford 012D","E01021580","Total",505,107,5,102,221,79,96,22,74
"2011","Chelmsford 012E","E01021584","Total",471,168,3,165,137,37,111,18,93
"2011","Chelmsford 013A","E01021548","Total",542,124,1,123,151,59,119,16,103
"2011","Chelmsford 013B","E01021560","Total",781,313,9,304,157,53,200,20,180
"2011","Chelmsford 013C","E01021561","Total",752,253,5,248,203,76,164,25,139
"2011","Chelmsford 013D","E01021564","Total",638,259,10,249,145,49,146,16,130
"2011","Chelmsford 013E","E01021571","Total",595,192,12,180,190,47,135,25,110
"2011","Chelmsford 014A","E01021562","Total",800,279,21,258,216,79,202,23,179
"2011","Chelmsford 014B","E01021563","Total",809,302,41,261,204,105,231,28,203
"2011","Chelmsford 014C","E01021565","Total",681,259,57,202,235,100,215,48,167
"2011","Chelmsford 014D","E01021566","Total",697,219,13,206,220,91,161,23,138
"2011","Chelmsford 014F","E01033137","Total",647,155,27,128,222,103,111,21,90
"2011","Chelmsford 014G","E01033145","Total",575,203,22,181,176,64,169,36,133
"2011","Chelmsford 015A","E01021557","Total",487,94,4,90,162,58,91,16,75
"2011","Chelmsford 015B","E01021558","Total",502,120,3,117,141,42,94,14,80
"2011","Chelmsford 015C","E01021583","Total",603,146,20,126,235,88,101,28,73
"2011","Chelmsford 015D","E01021585","Total",492,140,8,132,155,52,113,18,95
"2011","Chelmsford 015E","E01021586","Total",614,184,7,177,186,67,131,25,106
"2011","Chelmsford 016A","E01021533","Total",926,251,6,245,280,86,208,29,179
"2011","Chelmsford 016B","E01021535","Total",685,192,16,176,233,76,154,34,120
"2011","Chelmsford 016C","E01021569","Total",640,214,7,207,192,57,146,31,115
"2011","Chelmsford 016D","E01021570","Total",763,276,10,266,208,53,146,19,127
"2011","Chelmsford 016E","E01021572","Total",633,231,27,204,199,74,164,29,135
"2011","Chelmsford 017A","E01021552","Total",673,296,18,278,165,58,206,24,182
"2011","Chelmsford 017B","E01021553","Total",570,177,22,155,173,57,133,26,107
"2011","Chelmsford 017C","E01021554","Total",653,228,44,184,192,97,168,33,135
"2011","Chelmsford 017D","E01021555","Total",532,161,8,153,156,52,111,14,97
"2011","Chelmsford 017E","E01021559","Total",578,173,6,167,179,48,124,14,110
"2011","Chelmsford 018B","E01021602","Total",754,290,11,279,171,49,190,19,171
"2011","Chelmsford 018D","E01021604","Total",861,224,21,203,316,106,168,31,137
"2011","Chelmsford 018E","E01033143","Total",1176,454,10,444,226,67,287,30,257
"2011","Chelmsford 019A","E01021611","Total",528,101,5,96,219,83,103,27,76
"2011","Chelmsford 019B","E01021612","Total",608,184,11,173,185,60,127,17,110
"2011","Chelmsford 019C","E01021613","Total",853,214,16,198,218,86,195,27,168
"2011","Chelmsford 019D","E01021614","Total",646,148,12,136,211,85,136,25,111
"2011","Chelmsford 019E","E01021615","Total",622,165,12,153,183,75,115,14,101
"2011","Chelmsford 020A","E01021605","Total",469,85,10,75,160,49,68,14,54
"2011","Chelmsford 020B","E01021606","Total",593,115,21,94,238,75,116,34,82
"2011","Chelmsford 020C","E01021607","Total",648,125,19,106,220,79,127,30,97
"2011","Chelmsford 020D","E01021608","Total",547,153,10,143,146,52,112,14,98
"2011","Chelmsford 020E","E01021609","Total",515,100,5,95,176,54,86,14,72
"2011","Chelmsford 020F","E01021610","Total",571,139,15,124,171,58,115,21,94
"2011","Chelmsford 021A","E01021593","Total",666,272,6,266,166,51,170,18,152
"2011","Chelmsford 021B","E01021594","Total",679,215,14,201,166,47,176,23,153
"2011","Chelmsford 021C","E01021595","Total",708,265,12,253,160,47,180,25,155
"2011","Colchester 001A","E01021655","Total",529,152,3,149,148,39,119,19,100
"2011","Colchester 001B","E01021656","Total",682,249,15,234,171,47,170,37,133
"2011","Colchester 001C","E01021659","Total",826,234,12,222,251,89,194,35,159
"2011","Colchester 001D","E01021661","Total",659,166,10,156,226,88,135,31,104
"2011","Colchester 002A","E01021668","Total",801,190,29,161,213,103,146,23,123
"2011","Colchester 002B","E01021669","Total",716,205,51,154,234,105,175,45,130
"2011","Colchester 002C","E01021670","Total",630,203,56,147,254,105,135,47,88
"2011","Colchester 002D","E01021671","Total",596,191,18,173,174,47,151,26,125
"2011","Colchester 002F","E01033720","Total",775,110,39,71,342,167,112,35,77
"2011","Colchester 002G","E01033721","Total",654,66,8,58,350,175,83,29,54
"2011","Colchester 003A","E01021660","Total",574,147,9,138,181,48,119,20,99
"2011","Colchester 003B","E01021728","Total",656,223,4,219,191,50,148,18,130
"2011","Colchester 003C","E01021729","Total",708,193,16,177,226,79,173,29,144
"2011","Colchester 003D","E01021730","Total",682,222,24,198,205,62,171,36,135
"2011","Colchester 004A","E01021679","Total",991,188,42,146,335,181,178,49,129
"2011","Colchester 004B","E01021680","Total",1090,238,37,201,409,216,208,50,158
"2011","Colchester 004C","E01021681","Total",1184,218,33,185,360,178,146,33,113
"2011","Colchester 004D","E01021682","Total",1148,255,23,232,355,165,198,44,154
"2011","Colchester 007A","E01021646","Total",1019,307,25,282,193,92,197,29,168
"2011","Colchester 007B","E01021647","Total",811,252,27,225,192,89,175,29,146
"2011","Colchester 007C","E01021648","Total",1127,364,47,317,242,136,250,28,222
"2011","Colchester 007D","E01021649","Total",1050,361,39,322,182,107,254,25,229
"2011","Colchester 007E","E01021650","Total",954,158,24,134,224,109,127,30,97
"2011","Colchester 008A","E01021696","Total",747,394,76,318,214,111,280,44,236
"2011","Colchester 008B","E01021697","Total",705,292,42,250,203,92,237,32,205
"2011","Colchester 008C","E01021698","Total",457,145,49,96,162,68,106,32,74
"2011","Colchester 008D","E01021699","Total",647,283,44,239,167,64,228,35,193
"2011","Colchester 008E","E01021700","Total",582,242,85,157,228,107,150,40,110
"2011","Colchester 008G","E01033719","Total",544,265,36,229,82,65,45,9,36
"2011","Colchester 008H","E01033722","Total",586,214,49,165,148,74,116,25,91
"2011","Colchester 009A","E01021673","Total",623,288,7,281,139,35,167,21,146
"2011","Colchester 009B","E01021674","Total",519,126,20,106,215,80,130,32,98
"2011","Colchester 009C","E01021675","Total",526,165,10,155,160,60,123,28,95
"2011","Colchester 009D","E01021676","Total",643,247,9,238,161,43,159,17,142
"2011","Colchester 010A","E01021654","Total",733,187,11,176,237,72,169,36,133
"2011","Colchester 010B","E01021662","Total",636,179,8,171,182,53,134,17,117
"2011","Colchester 010C","E01021663","Total",458,150,5,145,111,37,104,17,87
"2011","Colchester 010D","E01021677","Total",494,146,5,141,130,35,116,24,92
"2011","Colchester 010E","E01021678","Total",559,133,7,126,166,58,122,28,94
"2011","Colchester 011A","E01021683","Total",558,184,35,149,137,84,115,17,98
"2011","Colchester 011B","E01021684","Total",703,195,24,171,188,102,161,28,133
"2011","Colchester 011C","E01021685","Total",838,237,75,162,267,138,151,43,108
"2011","Colchester 011D","E01021686","Total",981,346,74,272,226,127,218,21,197
"2011","Colchester 011E","E01021687","Total",757,170,34,136,225,128,135,33,102
"2011","Colchester 011F","E01021688","Total",600,135,30,105,192,93,128,32,96
"2011","Colchester 012A","E01021718","Total",665,126,10,116,195,75,125,23,102
"2011","Colchester 012B","E01021719","Total",663,253,10,243,176,61,181,17,164
"2011","Colchester 012C","E01021720","Total",704,298,23,275,173,76,247,24,223
"2011","Colchester 012D","E01021721","Total",773,235,15,220,259,84,151,23,128
"2011","Colchester 012E","E01021722","Total",701,235,18,217,211,69,201,27,174
"2011","Colchester 013A","E01021651","Total",731,165,25,140,238,113,155,32,123
"2011","Colchester 013B","E01021652","Total",647,177,7,170,181,51,118,18,100
"2011","Colchester 013C","E01021653","Total",486,92,8,84,209,49,82,25,57
"2011","Colchester 013D","E01021717","Total",719,180,22,158,246,101,134,28,106
"2011","Colchester 014A","E01021689","Total",614,265,14,251,180,43,210,34,176
"2011","Colchester 014B","E01021690","Total",500,99,12,87,178,46,104,23,81
"2011","Colchester 014C","E01021691","Total",641,272,8,264,140,37,178,16,162
"2011","Colchester 014D","E01021692","Total",603,215,3,212,161,33,156,21,135
"2011","Colchester 014E","E01021693","Total",718,343,11,332,173,39,201,28,173
"2011","Colchester 015A","E01021711","Total",577,236,39,197,171,74,201,28,173
"2011","Colchester 015C","E01021713","Total",474,210,23,187,135,42,176,25,151
"2011","Colchester 015D","E01021714","Total",671,123,42,81,319,171,103,42,61
"2011","Colchester 015E","E01021715","Total",578,150,27,123,219,67,160,45,115
"2011","Colchester 015G","E01033723","Total",863,104,44,60,561,358,136,62,74
"2011","Colchester 016A","E01021657","Total",720,200,27,173,214,97,173,23,150
"2011","Colchester 016B","E01021658","Total",442,134,15,119,131,48,111,22,89
"2011","Colchester 016C","E01021664","Total",884,278,30,248,244,108,191,34,157
"2011","Colchester 016D","E01021665","Total",612,240,49,191,188,82,196,37,159
"2011","Colchester 016E","E01021666","Total",627,200,15,185,147,60,163,23,140
"2011","Colchester 016F","E01021667","Total",619,237,43,194,192,78,187,39,148
"2011","Colchester 017A","E01021736","Total",516,199,19,180,129,42,115,17,98
"2011","Colchester 017B","E01021737","Total",582,220,21,199,140,57,149,23,126
"2011","Colchester 017C","E01021738","Total",967,278,12,266,225,88,229,28,201
"2011","Colchester 017D","E01021739","Total",648,202,10,192,155,59,148,9,139
"2011","Colchester 017E","E01021740","Total",744,293,17,276,183,74,182,18,164
"2011","Colchester 018A","E01021637","Total",471,120,12,108,139,53,124,23,101
"2011","Colchester 018B","E01021638","Total",506,172,49,123,182,67,160,41,119
"2011","Colchester 018C","E01021639","Total",750,182,42,140,256,122,170,46,124
"2011","Colchester 018D","E01021640","Total",481,120,26,94,157,64,117,34,83
"2011","Colchester 018E","E01021641","Total",590,197,30,167,176,81,170,31,139
"2011","Colchester 018F","E01021642","Total",836,251,48,203,277,118,234,46,188
"2011","Colchester 019A","E01021643","Total",927,216,12,204,336,107,187,35,152
"2011","Colchester 019B","E01021644","Total",670,191,8,183,194,77,156,35,121
"2011","Colchester 019C","E01021645","Total",583,170,8,162,171,65,125,15,110
"2011","Colchester 019D","E01021694","Total",592,172,2,170,148,49,112,18,94
"2011","Colchester 019E","E01021695","Total",459,147,7,140,123,43,132,21,111
"2011","Colchester 020A","E01021723","Total",720,295,18,277,158,68,197,12,185
"2011","Colchester 020B","E01021724","Total",739,296,14,282,179,49,234,26,208
"2011","Colchester 020C","E01021725","Total",528,185,5,180,120,31,152,18,134
"2011","Colchester 020D","E01021726","Total",679,273,33,240,175,55,218,39,179
"2011","Colchester 020E","E01021727","Total",627,218,2,216,152,48,138,15,123
"2011","Colchester 021A","E01021731","Total",638,271,12,259,134,48,173,22,151
"2011","Colchester 021B","E01021732","Total",705,299,21,278,188,64,237,38,199
"2011","Colchester 021C","E01021733","Total",657,267,13,254,144,57,162,23,139
"2011","Colchester 021D","E01021734","Total",631,297,8,289,115,29,177,18,159
"2011","Colchester 021E","E01021735","Total",669,324,5,319,110,37,208,9,199
"2011","Colchester 022D","E01021702","Total",591,204,20,184,143,61,139,18,121
"2011","Colchester 022E","E01021703","Total",491,199,66,133,210,75,143,34,109
"2011","Colchester 022F","E01021704","Total",661,218,41,177,202,76,174,42,132
"2011","Colchester 022G","E01021705","Total",765,199,21,178,228,76,171,43,128
"2011","Colchester 022H","E01021706","Total",598,171,20,151,134,71,121,21,100
"2011","Colchester 022I","E01021707","Total",591,226,17,209,158,51,179,24,155
"2011","Colchester 022A","E01021708","Total",629,217,5,212,131,43,161,20,141
"2011","Colchester 022B","E01021709","Total",632,274,9,265,138,31,176,24,152
"2011","Colchester 022C","E01021710","Total",771,257,11,246,216,63,173,19,154
"2011","Epping Forest 001A","E01021768","Total",865,248,23,225,251,89,203,27,176
"2011","Epping Forest 001B","E01021795","Total",935,172,11,161,227,97,137,21,116
"2011","Epping Forest 001C","E01021797","Total",523,138,8,130,146,50,109,18,91
"2011","Epping Forest 001D","E01021798","Total",638,234,13,221,183,63,174,29,145
"2011","Epping Forest 001E","E01021799","Total",706,238,30,208,195,80,191,31,160
"2011","Epping Forest 002A","E01021741","Total",784,202,18,184,227,75,202,39,163
"2011","Epping Forest 002B","E01021792","Total",482,160,5,155,126,33,117,17,100
"2011","Epping Forest 002C","E01021793","Total",616,227,9,218,136,45,147,18,129
"2011","Epping Forest 002D","E01021794","Total",484,172,11,161,138,47,129,16,113
"2011","Epping Forest 002E","E01021801","Total",876,264,19,245,246,82,188,24,164
"2011","Epping Forest 003A","E01021769","Total",852,235,21,214,266,75,197,42,155
"2011","Epping Forest 003B","E01021796","Total",868,272,13,259,241,65,198,28,170
"2011","Epping Forest 003C","E01021800","Total",862,222,29,193,254,81,168,34,134
"2011","Epping Forest 004A","E01021753","Total",629,210,14,196,168,62,162,16,146
"2011","Epping Forest 004B","E01021754","Total",615,230,16,214,180,53,146,23,123
"2011","Epping Forest 004C","E01021755","Total",479,197,8,189,115,37,124,16,108
"2011","Epping Forest 004D","E01021802","Total",903,303,48,255,300,131,240,35,205
"2011","Epping Forest 005A","E01021760","Total",655,226,14,212,171,58,170,16,154
"2011","Epping Forest 005B","E01021761","Total",744,220,40,180,241,96,150,38,112
"2011","Epping Forest 005C","E01021762","Total",611,253,21,232,163,67,209,24,185
"2011","Epping Forest 005D","E01021763","Total",653,215,17,198,190,83,179,24,155
"2011","Epping Forest 006A","E01021756","Total",612,157,15,142,200,78,126,32,94
"2011","Epping Forest 006B","E01021757","Total",795,264,6,258,133,57,171,14,157
"2011","Epping Forest 006C","E01021758","Total",749,278,16,262,143,61,214,25,189
"2011","Epping Forest 006D","E01021759","Total",608,150,12,138,203,91,144,34,110
"2011","Epping Forest 007A","E01021811","Total",602,222,33,189,184,69,188,33,155
"2011","Epping Forest 007B","E01021813","Total",581,199,7,192,138,48,154,13,141
"2011","Epping Forest 007C","E01021814","Total",604,191,20,171,183,75,157,18,139
"2011","Epping Forest 007D","E01021815","Total",603,174,21,153,209,70,162,30,132
"2011","Epping Forest 007E","E01021816","Total",609,265,26,239,147,58,210,20,190
"2011","Epping Forest 008A","E01021807","Total",591,173,20,153,215,101,140,28,112
"2011","Epping Forest 008B","E01021808","Total",617,209,41,168,210,94,140,30,110
"2011","Epping Forest 008C","E01021809","Total",616,204,17,187,157,60,184,31,153
"2011","Epping Forest 008D","E01021810","Total",788,149,46,103,270,136,128,28,100
"2011","Epping Forest 008E","E01021817","Total",1066,316,63,253,362,158,233,46,187
"2011","Epping Forest 009A","E01021806","Total",1002,360,17,343,201,71,273,20,253
"2011","Epping Forest 009B","E01021812","Total",579,223,10,213,113,28,163,20,143
"2011","Epping Forest 009C","E01021818","Total",912,286,27,259,203,101,240,38,202
"2011","Epping Forest 010A","E01021770","Total",907,326,27,299,225,84,246,33,213
"2011","Epping Forest 010B","E01021803","Total",536,184,7,177,153,42,156,19,137
"2011","Epping Forest 010C","E01021804","Total",586,169,10,159,150,50,110,13,97
"2011","Epping Forest 010D","E01021805","Total",491,174,6,168,163,55,104,12,92
"2011","Epping Forest 011A","E01021774","Total",617,209,38,171,202,81,168,31,137
"2011","Epping Forest 011B","E01021775","Total",631,232,41,191,205,78,195,44,151
"2011","Epping Forest 011C","E01021776","Total",717,345,24,321,138,58,269,25,244
"2011","Epping Forest 011D","E01021777","Total",567,206,23,183,179,63,159,23,136
"2011","Epping Forest 011E","E01021778","Total",571,166,33,133,206,85,142,35,107
"2011","Epping Forest 011F","E01021779","Total",702,237,33,204,183,86,196,37,159
"2011","Epping Forest 012A","E01021786","Total",520,124,7,117,150,58,80,8,72
"2011","Epping Forest 012B","E01021787","Total",629,143,7,136,196,56,100,11,89
"2011","Epping Forest 012C","E01021788","Total",624,199,15,184,190,70,143,31,112
"2011","Epping Forest 012D","E01021789","Total",526,143,12,131,193,61,110,20,90
"2011","Epping Forest 012E","E01021790","Total",556,152,33,119,230,105,143,37,106
"2011","Epping Forest 012F","E01021791","Total",660,187,18,169,197,73,118,19,99
"2011","Epping Forest 013A","E01021771","Total",713,275,48,227,232,109,205,39,166
"2011","Epping Forest 013B","E01021772","Total",599,220,22,198,169,58,148,27,121
"2011","Epping Forest 013C","E01021773","Total",595,167,28,139,218,90,143,36,107
"2011","Epping Forest 013D","E01021783","Total",639,173,15,158,204,71,141,24,117
"2011","Epping Forest 013E","E01021784","Total",642,178,13,165,212,88,136,23,113
"2011","Epping Forest 014A","E01021780","Total",523,127,7,120,204,58,91,15,76
"2011","Epping Forest 014B","E01021781","Total",633,171,10,161,173,72,120,15,105
"2011","Epping Forest 014C","E01021782","Total",639,202,8,194,156,53,153,10,143
"2011","Epping Forest 014D","E01021785","Total",662,201,50,151,245,94,140,26,114
"2011","Epping Forest 015A","E01021742","Total",513,147,24,123,206,86,103,18,85
"2011","Epping Forest 015B","E01021743","Total",824,304,17,287,190,86,235,15,220
"2011","Epping Forest 015C","E01021744","Total",648,167,24,143,213,80,109,21,88
"2011","Epping Forest 015D","E01021745","Total",655,161,12,149,199,82,123,16,107
"2011","Epping Forest 015E","E01021746","Total",859,255,20,235,224,95,180,16,164
"2011","Epping Forest 015F","E01021747","Total",643,184,13,171,194,80,116,19,97
"2011","Epping Forest 015G","E01021748","Total",752,191,25,166,230,107,124,21,103
"2011","Epping Forest 016A","E01021749","Total",912,273,11,262,226,80,217,30,187
"2011","Epping Forest 016B","E01021750","Total",476,132,12,120,130,42,107,18,89
"2011","Epping Forest 016C","E01021751","Total",444,106,4,102,163,47,83,20,63
"2011","Epping Forest 016D","E01021752","Total",564,138,30,108,214,71,110,34,76
"2011","Epping Forest 017A","E01021764","Total",720,236,98,138,358,170,170,52,118
"2011","Epping Forest 017B","E01021765","Total",646,182,25,157,206,73,134,24,110
"2011","Epping Forest 017C","E01021766","Total",498,142,23,119,172,63,112,26,86
"2011","Epping Forest 017D","E01021767","Total",638,204,8,196,185,59,138,16,122
"2011","Harlow 001A","E01021854","Total",732,230,19,211,179,73,178,31,147
"2011","Harlow 001B","E01021855","Total",601,222,22,200,168,71,165,32,133
"2011","Harlow 001C","E01021856","Total",610,190,13,177,176,64,153,28,125
"2011","Harlow 001D","E01021857","Total",1069,305,27,278,319,137,227,29,198
"2011","Harlow 002A","E01021844","Total",525,161,26,135,188,63,157,37,120
"2011","Harlow 002B","E01021845","Total",621,241,44,197,210,86,190,30,160
"2011","Harlow 002C","E01021846","Total",573,200,54,146,206,86,160,38,122
"2011","Harlow 002D","E01021847","Total",616,244,29,215,177,80,218,31,187
"2011","Harlow 002E","E01021848","Total",690,242,36,206,198,88,188,32,156
"2011","Harlow 003A","E01021849","Total",670,251,36,215,206,89,218,37,181
"2011","Harlow 003B","E01021850","Total",617,231,32,199,193,92,169,30,139
"2011","Harlow 003C","E01021851","Total",713,244,50,194,192,99,184,37,147
"2011","Harlow 003D","E01021852","Total",670,266,38,228,223,99,211,41,170
"2011","Harlow 003E","E01021853","Total",590,205,25,180,147,68,181,31,150
"2011","Harlow 004A","E01021839","Total",633,207,27,180,175,77,156,23,133
"2011","Harlow 004B","E01021840","Total",623,190,32,158,193,78,159,33,126
"2011","Harlow 004C","E01021841","Total",539,163,29,134,189,84,118,23,95
"2011","Harlow 004D","E01021842","Total",634,214,41,173,230,107,156,33,123
"2011","Harlow 004E","E01021843","Total",940,236,37,199,262,157,165,33,132
"2011","Harlow 005A","E01021824","Total",641,100,12,88,305,147,101,35,66
"2011","Harlow 005B","E01021825","Total",648,95,22,73,282,123,97,30,67
"2011","Harlow 005C","E01021826","Total",645,122,9,113,240,103,108,29,79
"2011","Harlow 005D","E01021827","Total",715,148,28,120,253,119,122,31,91
"2011","Harlow 005E","E01021828","Total",864,115,18,97,405,193,105,39,66
"2011","Harlow 006A","E01021819","Total",638,226,39,187,196,80,184,33,151
"2011","Harlow 006B","E01021820","Total",644,238,36,202,202,71,180,34,146
"2011","Harlow 006C","E01021822","Total",626,204,34,170,219,105,172,41,131
"2011","Harlow 006D","E01021823","Total",759,276,52,224,249,120,209,44,165
"2011","Harlow 006E","E01021870","Total",577,212,21,191,155,56,179,33,146
"2011","Harlow 007A","E01021831","Total",641,257,31,226,171,71,193,26,167
"2011","Harlow 007B","E01021868","Total",674,234,25,209,208,77,190,36,154
"2011","Harlow 007C","E01021869","Total",558,201,26,175,167,65,142,26,116
"2011","Harlow 007D","E01021871","Total",629,239,41,198,186,82,188,34,154
"2011","Harlow 007E","E01021872","Total",829,302,50,252,260,137,181,47,134
"2011","Harlow 008A","E01021821","Total",640,259,33,226,173,72,223,30,193
"2011","Harlow 008B","E01021834","Total",654,237,45,192,199,89,169,29,140
"2011","Harlow 008C","E01021835","Total",607,213,29,184,200,83,157,28,129
"2011","Harlow 008D","E01021836","Total",644,238,45,193,193,79,197,38,159
"2011","Harlow 008E","E01021837","Total",635,231,24,207,169,66,181,24,157
"2011","Harlow 009A","E01021829","Total",651,188,24,164,178,64,169,41,128
"2011","Harlow 009B","E01021830","Total",493,172,11,161,135,45,112,21,91
"2011","Harlow 009C","E01021832","Total",514,109,7,102,151,57,97,15,82
"2011","Harlow 009D","E01021833","Total",522,187,13,174,146,57,149,26,123
"2011","Harlow 009E","E01021865","Total",568,147,22,125,161,75,155,26,129
"2011","Harlow 010A","E01021838","Total",605,204,30,174,190,64,168,30,138
"2011","Harlow 010B","E01021858","Total",640,226,44,182,203,106,179,38,141
"2011","Harlow 010C","E01021859","Total",615,203,54,149,218,115,147,30,117
"2011","Harlow 010D","E01021860","Total",598,187,47,140,205,91,145,36,109
"2011","Harlow 010E","E01021861","Total",491,168,42,126,190,62,136,51,85
"2011","Harlow 011A","E01021862","Total",626,209,41,168,206,77,157,38,119
"2011","Harlow 011B","E01021863","Total",621,193,47,146,213,96,154,39,115
"2011","Harlow 011C","E01021864","Total",549,150,49,101,204,97,137,34,103
"2011","Harlow 011D","E01021866","Total",609,155,21,134,173,89,143,13,130
"2011","Harlow 011E","E01021867","Total",584,152,8,144,144,38,112,12,100
"2011","Maldon 001A","E01021908","Total",857,244,12,232,226,74,199,34,165
"2011","Maldon 001B","E01021909","Total",536,161,7,154,145,44,136,19,117
"2011","Maldon 001C","E01021910","Total",637,203,13,190,163,57,166,28,138
"2011","Maldon 001D","E01021911","Total",473,149,5,144,130,27,117,22,95
"2011","Maldon 002A","E01021882","Total",842,297,17,280,197,62,231,29,202
"2011","Maldon 002B","E01021883","Total",651,179,13,166,205,79,141,26,115
"2011","Maldon 002C","E01021912","Total",830,321,12,309,220,63,149,13,136
"2011","Maldon 002D","E01021913","Total",589,184,9,175,166,41,130,18,112
"2011","Maldon 003A","E01021884","Total",604,127,17,110,163,75,115,18,97
"2011","Maldon 003B","E01021885","Total",475,134,5,129,131,46,107,14,93
"2011","Maldon 003C","E01021886","Total",601,150,17,133,176,70,131,35,96
"2011","Maldon 003D","E01021887","Total",864,191,16,175,318,130,148,30,118
"2011","Maldon 003E","E01021888","Total",821,325,45,280,238,117,259,43,216
"2011","Maldon 004A","E01021889","Total",930,356,49,307,286,98,289,58,231
"2011","Maldon 004B","E01021890","Total",905,374,28,346,186,75,285,31,254
"2011","Maldon 004C","E01021891","Total",743,347,10,337,115,31,236,14,222
"2011","Maldon 004D","E01021892","Total",481,242,29,213,123,54,195,25,170
"2011","Maldon 005A","E01021893","Total",592,150,5,145,219,67,101,27,74
"2011","Maldon 005B","E01021894","Total",498,174,26,148,163,51,132,32,100
"2011","Maldon 005C","E01021895","Total",492,131,14,117,156,54,110,22,88
"2011","Maldon 005D","E01021896","Total",494,132,5,127,174,44,93,19,74
"2011","Maldon 005E","E01021897","Total",484,118,8,110,147,26,112,20,92
"2011","Maldon 005F","E01021898","Total",587,275,10,265,123,46,196,19,177
"2011","Maldon 006A","E01021901","Total",794,271,11,260,203,85,240,35,205
"2011","Maldon 006B","E01021904","Total",562,158,17,141,197,76,136,31,105
"2011","Maldon 006C","E01021905","Total",499,162,20,142,156,56,160,28,132
"2011","Maldon 006D","E01021906","Total",642,197,28,169,194,72,179,40,139
"2011","Maldon 006E","E01021907","Total",886,265,7,258,219,78,217,29,188
"2011","Maldon 007A","E01021873","Total",513,141,13,128,156,39,115,24,91
"2011","Maldon 007B","E01021874","Total",530,139,17,122,173,52,143,32,111
"2011","Maldon 007C","E01021875","Total",639,280,6,274,110,36,175,10,165
"2011","Maldon 007D","E01021899","Total",513,125,9,116,173,49,109,22,87
"2011","Maldon 007E","E01021900","Total",442,139,6,133,142,39,133,27,106
"2011","Maldon 007F","E01021902","Total",668,172,11,161,212,45,149,33,116
"2011","Maldon 007G","E01021903","Total",624,191,11,180,168,48,145,23,122
"2011","Maldon 008C","E01021878","Total",633,292,9,283,131,48,198,26,172
"2011","Maldon 008D","E01021879","Total",628,231,18,213,168,58,161,29,132
"2011","Maldon 008E","E01021880","Total",782,336,19,317,126,55,236,21,215
"2011","Maldon 008F","E01021881","Total",526,172,9,163,138,53,116,10,106
"2011","Maldon 008G","E01033057","Total",950,339,26,313,264,82,247,41,206
"2011","Rochford 001A","E01021942","Total",825,430,11,419,99,32,288,14,274
"2011","Rochford 001B","E01021943","Total",707,256,7,249,175,38,216,33,183
"2011","Rochford 001C","E01021944","Total",633,192,11,181,173,49,150,21,129
"2011","Rochford 001D","E01021945","Total",621,213,6,207,156,47,175,33,142
"2011","Rochford 002A","E01021914","Total",800,229,9,220,258,70,189,42,147
"2011","Rochford 002B","E01021927","Total",490,124,10,114,159,44,101,32,69
"2011","Rochford 002C","E01021928","Total",668,225,4,221,163,45,176,14,162
"2011","Rochford 002D","E01021929","Total",579,126,6,120,230,69,123,29,94
"2011","Rochford 002E","E01021931","Total",585,255,6,249,123,46,179,14,165
"2011","Rochford 003A","E01021933","Total",509,156,5,151,168,52,123,20,103
"2011","Rochford 003B","E01021934","Total",528,173,6,167,166,51,130,24,106
"2011","Rochford 003C","E01021935","Total",533,186,2,184,157,50,144,19,125
"2011","Rochford 003D","E01021936","Total",784,363,7,356,176,52,272,28,244
"2011","Rochford 003E","E01021937","Total",700,219,16,203,213,73,160,28,132
"2011","Rochford 003F","E01021938","Total",641,255,2,253,146,46,163,15,148
"2011","Rochford 003G","E01021939","Total",671,233,3,230,194,64,178,22,156
"2011","Rochford 003H","E01021940","Total",789,244,12,232,258,64,157,30,127
"2011","Rochford 003I","E01021941","Total",774,200,5,195,245,73,148,34,114
"2011","Rochford 004A","E01021915","Total",515,120,14,106,152,53,127,26,101
"2011","Rochford 004B","E01021916","Total",415,132,12,120,138,50,123,23,100
"2011","Rochford 004C","E01021953","Total",564,215,80,135,257,102,191,62,129
"2011","Rochford 004D","E01021955","Total",885,371,55,316,248,124,270,47,223
"2011","Rochford 005A","E01021918","Total",568,128,6,122,203,66,100,23,77
"2011","Rochford 005B","E01021919","Total",517,181,4,177,136,43,122,13,109
"2011","Rochford 005C","E01021925","Total",653,220,16,204,199,62,173,24,149
"2011","Rochford 005D","E01021960","Total",759,273,6,267,228,66,162,26,136
"2011","Rochford 005E","E01021961","Total",636,247,6,241,152,51,147,18,129
"2011","Rochford 006A","E01021920","Total",737,134,20,114,281,117,108,26,82
"2011","Rochford 006B","E01021926","Total",860,232,15,217,293,152,181,37,144
"2011","Rochford 006C","E01021957","Total",622,219,25,194,172,73,213,33,180
"2011","Rochford 006D","E01021958","Total",518,95,6,89,171,84,73,16,57
"2011","Rochford 006E","E01021959","Total",635,148,21,127,248,94,124,35,89
"2011","Rochford 007A","E01021930","Total",665,172,12,160,147,75,148,22,126
"2011","Rochford 007B","E01021932","Total",634,199,13,186,180,69,161,25,136
"2011","Rochford 007C","E01021952","Total",602,203,11,192,159,61,158,23,135
"2011","Rochford 007D","E01021954","Total",604,178,19,159,200,78,170,31,139
"2011","Rochford 007E","E01021956","Total",628,210,23,187,166,68,184,32,152
"2011","Rochford 008A","E01021950","Total",594,201,10,191,166,62,165,29,136
"2011","Rochford 008B","E01021951","Total",509,196,7,189,153,56,141,26,115
"2011","Rochford 008C","E01021962","Total",507,195,23,172,139,56,128,16,112
"2011","Rochford 008D","E01021963","Total",520,173,12,161,160,53,113,28,85
"2011","Rochford 008E","E01021964","Total",667,236,7,229,182,59,179,24,155
"2011","Rochford 008F","E01021966","Total",794,365,20,345,193,69,251,17,234
"2011","Rochford 009A","E01021946","Total",551,151,5,146,170,55,121,25,96
"2011","Rochford 009B","E01021947","Total",499,179,4,175,127,38,129,17,112
"2011","Rochford 009C","E01021948","Total",524,157,11,146,174,61,105,27,78
"2011","Rochford 009D","E01021949","Total",604,216,5,211,158,53,155,22,133
"2011","Rochford 009E","E01021965","Total",963,355,7,348,251,90,257,33,224
"2011","Rochford 010A","E01021917","Total",704,181,18,163,229,83,161,28,133
"2011","Rochford 010B","E01021921","Total",591,145,20,125,185,56,145,32,113
"2011","Rochford 010C","E01021922","Total",669,285,23,262,195,72,228,36,192
"2011","Rochford 010D","E01021923","Total",520,145,16,129,172,53,125,24,101
"2011","Rochford 010E","E01021924","Total",494,133,9,124,160,47,97,17,80
"2011","Tendring 001A","E01021997","Total",663,309,54,255,155,62,216,38,178
"2011","Tendring 001B","E01021998","Total",631,247,41,206,160,62,183,27,156
"2011","Tendring 001C","E01021999","Total",752,314,44,270,211,72,227,32,195
"2011","Tendring 001D","E01022001","Total",827,372,59,313,205,100,247,32,215
"2011","Tendring 002A","E01022000","Total",646,241,30,211,217,85,160,36,124
"2011","Tendring 002C","E01022006","Total",732,346,54,292,215,84,271,51,220
"2011","Tendring 002D","E01022007","Total",653,217,37,180,222,94,161,38,123
"2011","Tendring 002F","E01033051","Total",1096,496,59,437,280,117,357,48,309
"2011","Tendring 003A","E01021978","Total",906,302,14,288,236,76,228,40,188
"2011","Tendring 003B","E01022013","Total",650,192,5,187,165,59,151,31,120
"2011","Tendring 003C","E01022014","Total",584,241,18,223,153,44,187,27,160
"2011","Tendring 003D","E01022015","Total",608,155,7,148,181,63,135,25,110
"2011","Tendring 003E","E01022019","Total",560,163,5,158,142,46,122,22,100
"2011","Tendring 003F","E01022020","Total",901,324,19,305,172,64,236,24,212
"2011","Tendring 003G","E01022021","Total",603,207,24,183,169,70,153,28,125
"2011","Tendring 004A","E01021991","Total",418,141,11,130,100,26,100,11,89
"2011","Tendring 004B","E01021992","Total",476,168,22,146,136,52,127,23,104
"2011","Tendring 004C","E01022002","Total",791,324,35,289,241,80,217,34,183
"2011","Tendring 004D","E01022004","Total",748,338,20,318,169,59,205,33,172
"2011","Tendring 004E","E01022005","Total",757,303,19,284,190,66,214,24,190
"2011","Tendring 004F","E01022028","Total",546,205,19,186,148,49,167,36,131
"2011","Tendring 005A","E01021971","Total",416,127,7,120,109,24,104,11,93
"2011","Tendring 005B","E01021972","Total",491,133,11,122,149,54,132,28,104
"2011","Tendring 005C","E01022051","Total",575,181,8,173,143,38,146,25,121
"2011","Tendring 005D","E01022052","Total",600,213,11,202,171,57,160,16,144
"2011","Tendring 006A","E01021985","Total",660,372,12,360,103,45,184,10,174
"2011","Tendring 006B","E01021986","Total",726,405,17,388,109,29,225,20,205
"2011","Tendring 006C","E01022054","Total",629,327,35,292,148,50,229,30,199
"2011","Tendring 006D","E01022055","Total",642,403,15,388,97,31,253,20,233
"2011","Tendring 006E","E01022056","Total",766,367,45,322,183,78,286,48,238
"2011","Tendring 007A","E01021973","Total",471,178,10,168,127,33,131,25,106
"2011","Tendring 007B","E01021974","Total",483,146,13,133,131,46,141,22,119
"2011","Tendring 007C","E01022016","Total",839,444,15,429,134,45,260,25,235
"2011","Tendring 007D","E01022017","Total",575,201,7,194,161,60,172,26,146
"2011","Tendring 007E","E01022018","Total",624,262,16,246,139,51,209,23,186
"2011","Tendring 008A","E01021987","Total",593,355,23,332,106,35,205,22,183
"2011","Tendring 008B","E01021994","Total",606,401,8,393,67,22,239,7,232
"2011","Tendring 008C","E01021995","Total",634,371,13,358,124,47,216,19,197
"2011","Tendring 008D","E01021996","Total",615,353,16,337,148,39,207,24,183
"2011","Tendring 008E","E01022009","Total",640,292,7,285,110,32,180,17,163
"2011","Tendring 008F","E01022010","Total",704,342,15,327,148,47,229,34,195
"2011","Tendring 008G","E01022011","Total",742,311,27,284,191,67,209,33,176
"2011","Tendring 008H","E01022012","Total",1001,675,33,642,127,41,377,28,349
"2011","Tendring 009A","E01021967","Total",836,311,19,292,224,74,210,36,174
"2011","Tendring 009B","E01021983","Total",611,242,7,235,116,27,174,22,152
"2011","Tendring 009C","E01021993","Total",944,358,19,339,251,83,249,31,218
"2011","Tendring 009D","E01022053","Total",710,215,8,207,181,58,159,30,129
"2011","Tendring 010A","E01021984","Total",1004,568,25,543,145,57,369,30,339
"2011","Tendring 010B","E01022039","Total",657,312,44,268,184,60,225,40,185
"2011","Tendring 010C","E01022040","Total",816,458,30,428,155,50,270,35,235
"2011","Tendring 010D","E01022041","Total",711,393,25,368,122,42,251,26,225
"2011","Tendring 011A","E01021979","Total",624,261,26,235,197,52,196,42,154
"2011","Tendring 011B","E01021980","Total",770,330,16,314,175,62,202,22,180
"2011","Tendring 011C","E01021981","Total",793,325,11,314,183,66,235,31,204
"2011","Tendring 011D","E01021982","Total",830,267,37,230,238,104,183,26,157
"2011","Tendring 011E","E01022046","Total",686,326,22,304,150,48,224,23,201
"2011","Tendring 012A","E01022008","Total",1002,606,24,582,147,49,402,30,372
"2011","Tendring 012B","E01022033","Total",733,446,9,437,77,29,251,14,237
"2011","Tendring 012C","E01022034","Total",772,466,24,442,114,34,264,19,245
"2011","Tendring 012D","E01022035","Total",698,385,10,375,107,25,204,13,191
"2011","Tendring 013A","E01021975","Total",644,288,33,255,190,76,199,42,157
"2011","Tendring 013B","E01021976","Total",613,270,15,255,158,61,215,18,197
"2011","Tendring 013C","E01021977","Total",710,330,41,289,184,72,238,38,200
"2011","Tendring 013D","E01022022","Total",602,232,34,198,205,62,166,42,124
"2011","Tendring 013E","E01022044","Total",743,373,25,348,152,51,249,31,218
"2011","Tendring 014A","E01022042","Total",687,372,55,317,183,70,232,38,194
"2011","Tendring 014B","E01022043","Total",751,302,72,230,283,122,230,51,179
"2011","Tendring 014C","E01022048","Total",705,379,23,356,129,46,249,27,222
"2011","Tendring 014D","E01022049","Total",618,291,33,258,179,52,205,29,176
"2011","Tendring 014E","E01022050","Total",870,477,39,438,160,69,337,23,314
"2011","Tendring 015A","E01022023","Total",645,282,46,236,196,87,195,33,162
"2011","Tendring 015B","E01022024","Total",642,276,43,233,187,72,232,37,195
"2011","Tendring 015C","E01022030","Total",759,485,74,411,178,72,337,48,289
"2011","Tendring 015D","E01022031","Total",577,307,120,187,246,112,203,56,147
"2011","Tendring 015E","E01022032","Total",715,357,72,285,242,77,251,63,188
"2011","Tendring 016A","E01021970","Total",825,431,60,371,204,105,326,41,285
"2011","Tendring 016B","E01022025","Total",776,473,49,424,117,59,303,30,273
"2011","Tendring 016C","E01022026","Total",630,278,62,216,214,79,211,53,158
"2011","Tendring 016D","E01022027","Total",788,407,42,365,168,66,282,30,252
"2011","Tendring 017A","E01021968","Total",729,300,69,231,274,124,230,66,164
"2011","Tendring 017B","E01021969","Total",587,240,39,201,195,82,196,37,159
"2011","Tendring 017C","E01022036","Total",571,255,20,235,120,45,167,23,144
"2011","Tendring 017D","E01022037","Total",622,341,15,326,106,40,227,18,209
"2011","Tendring 017E","E01022038","Total",632,317,39,278,167,65,226,39,187
"2011","Tendring 018A","E01021988","Total",1029,684,88,596,156,66,467,54,413
"2011","Tendring 018B","E01021989","Total",757,495,14,481,78,27,279,21,258
"2011","Tendring 018C","E01021990","Total",842,532,27,505,103,40,331,21,310
"2011","Tendring 018D","E01022045","Total",681,377,26,351,140,45,243,27,216
"2011","Tendring 018E","E01022047","Total",578,255,15,240,122,46,182,19,163
"2011","Uttlesford 001A","E01022057","Total",674,170,15,155,231,67,129,28,101
"2011","Uttlesford 001B","E01022075","Total",715,212,5,207,226,79,141,18,123
"2011","Uttlesford 001C","E01022077","Total",637,158,9,149,199,67,127,19,108
"2011","Uttlesford 001D","E01022094","Total",679,179,5,174,227,75,140,23,117
"2011","Uttlesford 002A","E01022074","Total",584,162,23,139,208,74,127,23,104
"2011","Uttlesford 002B","E01022076","Total",939,424,9,415,141,57,300,17,283
"2011","Uttlesford 002C","E01022078","Total",622,197,29,168,206,70,162,35,127
"2011","Uttlesford 002D","E01022079","Total",750,230,20,210,205,76,179,22,157
"2011","Uttlesford 002E","E01022080","Total",633,89,13,76,210,77,114,24,90
"2011","Uttlesford 002F","E01022081","Total",963,340,24,316,300,126,241,40,201
"2011","Uttlesford 002G","E01022082","Total",667,143,11,132,221,71,116,18,98
"2011","Uttlesford 003A","E01022061","Total",568,165,10,155,172,42,111,9,102
"2011","Uttlesford 003B","E01022071","Total",652,161,9,152,227,62,128,22,106
"2011","Uttlesford 003C","E01022072","Total",733,195,9,186,246,75,150,26,124
"2011","Uttlesford 003D","E01022073","Total",628,170,14,156,208,60,159,33,126
"2011","Uttlesford 003E","E01022098","Total",609,142,4,138,182,54,134,23,111
"2011","Uttlesford 004A","E01022092","Total",716,188,8,180,200,71,141,23,118
"2011","Uttlesford 004B","E01022093","Total",719,242,24,218,221,66,188,30,158
"2011","Uttlesford 004C","E01022097","Total",713,193,13,180,246,55,168,34,134
"2011","Uttlesford 004D","E01022099","Total",785,128,9,119,320,129,138,37,101
"2011","Uttlesford 005A","E01022062","Total",786,183,12,171,261,78,167,39,128
"2011","Uttlesford 005B","E01022063","Total",622,160,18,142,185,83,128,23,105
"2011","Uttlesford 005C","E01022083","Total",684,183,8,175,183,65,131,15,116
"2011","Uttlesford 005D","E01022084","Total",610,156,6,150,200,73,148,27,121
"2011","Uttlesford 005E","E01022085","Total",691,137,11,126,192,90,139,30,109
"2011","Uttlesford 005F","E01022087","Total",715,131,16,115,241,128,125,33,92
"2011","Uttlesford 005G","E01022089","Total",603,144,6,138,203,62,103,24,79
"2011","Uttlesford 006A","E01022086","Total",524,144,26,118,177,77,130,26,104
"2011","Uttlesford 006B","E01022090","Total",923,199,32,167,321,152,195,43,152
"2011","Uttlesford 006C","E01022091","Total",910,220,17,203,309,123,189,40,149
"2011","Uttlesford 006D","E01022095","Total",602,143,7,136,194,75,109,29,80
"2011","Uttlesford 007B","E01022067","Total",926,297,15,282,185,75,211,17,194
"2011","Uttlesford 007C","E01022068","Total",618,163,17,146,234,63,127,27,100
"2011","Uttlesford 007D","E01033054","Total",468,126,18,108,165,71,109,18,91
"2011","Uttlesford 007E","E01033055","Total",542,116,10,106,225,60,97,28,69
"2011","Uttlesford 007F","E01033056","Total",521,174,20,154,169,65,145,28,117
"2011","Uttlesford 008A","E01022058","Total",636,137,10,127,223,72,134,31,103
"2011","Uttlesford 008B","E01022064","Total",676,189,6,183,204,65,153,30,123
"2011","Uttlesford 008D","E01022069","Total",661,228,10,218,154,54,185,17,168
"2011","Uttlesford 008E","E01022088","Total",609,159,9,150,177,38,142,20,122
"2011","Uttlesford 008F","E01033052","Total",621,182,12,170,219,80,164,29,135
"2011","Uttlesford 008G","E01033053","Total",622,50,14,36,367,207,58,34,24
"2011","Uttlesford 009A","E01022059","Total",622,170,7,163,195,62,127,32,95
"2011","Uttlesford 009B","E01022060","Total",696,179,10,169,245,84,161,34,127
"2011","Uttlesford 009C","E01022070","Total",712,208,13,195,259,79,160,27,133
"2011","Uttlesford 009D","E01022096","Total",730,185,15,170,224,86,158,30,128
"2011","Broxbourne 001A","E01023316","Total",512,129,4,125,180,53,104,28,76
"2011","Broxbourne 001B","E01023317","Total",906,214,46,168,380,153,138,39,99
"2011","Broxbourne 001C","E01023318","Total",597,145,16,129,211,63,125,30,95
"2011","Broxbourne 001D","E01023319","Total",633,227,8,219,153,57,143,21,122
"2011","Broxbourne 002A","E01023327","Total",551,168,33,135,206,88,139,40,99
"2011","Broxbourne 002B","E01023328","Total",509,130,27,103,207,74,100,27,73
"2011","Broxbourne 002C","E01023329","Total",502,150,11,139,162,60,137,23,114
"2011","Broxbourne 002D","E01023330","Total",607,172,49,123,232,108,133,30,103
"2011","Broxbourne 002E","E01023331","Total",598,169,25,144,211,79,166,37,129
"2011","Broxbourne 003A","E01023320","Total",982,318,25,293,214,113,224,31,193
"2011","Broxbourne 003B","E01023321","Total",842,299,11,288,211,86,203,17,186
"2011","Broxbourne 003C","E01023322","Total",745,179,25,154,247,118,148,29,119
"2011","Broxbourne 003D","E01023323","Total",798,306,29,277,189,81,238,26,212
"2011","Broxbourne 004A","E01023289","Total",525,140,4,136,208,48,99,21,78
"2011","Broxbourne 004B","E01023290","Total",632,230,9,221,204,64,145,22,123
"2011","Broxbourne 004C","E01023291","Total",612,189,3,186,163,55,118,11,107
"2011","Broxbourne 004D","E01023292","Total",629,189,12,177,170,53,135,13,122
"2011","Broxbourne 005A","E01023340","Total",722,182,40,142,240,92,144,31,113
"2011","Broxbourne 005B","E01023341","Total",719,207,14,193,221,76,170,34,136
"2011","Broxbourne 005C","E01023342","Total",1109,288,96,192,439,250,200,56,144
"2011","Broxbourne 005D","E01023343","Total",728,232,97,135,314,148,171,53,118
"2011","Broxbourne 005E","E01023344","Total",762,209,22,187,229,86,174,30,144
"2011","Broxbourne 006A","E01023307","Total",539,128,16,112,216,67,107,25,82
"2011","Broxbourne 006B","E01023308","Total",632,141,5,136,210,66,116,18,98
"2011","Broxbourne 006C","E01023309","Total",621,150,6,144,215,57,134,28,106
"2011","Broxbourne 006D","E01023310","Total",881,308,107,201,371,180,215,60,155
"2011","Broxbourne 007A","E01023311","Total",653,198,12,186,181,61,139,18,121
"2011","Broxbourne 007B","E01023312","Total",576,108,21,87,234,66,96,26,70
"2011","Broxbourne 007C","E01023313","Total",630,228,2,226,171,54,166,21,145
"2011","Broxbourne 007D","E01023315","Total",627,79,22,57,314,122,82,38,44
"2011","Broxbourne 008A","E01023302","Total",685,306,30,276,178,56,229,33,196
"2011","Broxbourne 008B","E01023303","Total",618,161,33,128,224,85,138,36,102
"2011","Broxbourne 008C","E01023304","Total",638,234,30,204,207,86,170,37,133
"2011","Broxbourne 008D","E01023305","Total",504,118,20,98,211,66,108,34,74
"2011","Broxbourne 008E","E01023306","Total",619,169,15,154,172,64,147,26,121
"2011","Broxbourne 009A","E01023314","Total",510,142,21,121,157,57,109,27,82
"2011","Broxbourne 009B","E01023324","Total",519,131,16,115,171,66,131,33,98
"2011","Broxbourne 009C","E01023325","Total",620,191,21,170,182,94,185,35,150
"2011","Broxbourne 009D","E01023326","Total",666,235,37,198,226,91,213,38,175
"2011","Broxbourne 010A","E01023297","Total",507,150,19,131,163,73,108,26,82
"2011","Broxbourne 010B","E01023298","Total",651,250,15,235,182,74,157,26,131
"2011","Broxbourne 010C","E01023299","Total",671,198,14,184,213,86,154,25,129
"2011","Broxbourne 010D","E01023300","Total",632,260,39,221,181,90,186,32,154
"2011","Broxbourne 010E","E01023301","Total",683,190,41,149,232,106,154,28,126
"2011","Broxbourne 011A","E01023293","Total",661,217,28,189,228,88,166,39,127
"2011","Broxbourne 011B","E01023294","Total",712,320,43,277,187,70,242,35,207
"2011","Broxbourne 011C","E01023295","Total",567,190,21,169,177,62,172,37,135
"2011","Broxbourne 011D","E01023296","Total",636,213,23,190,228,77,174,42,132
"2011","Broxbourne 012A","E01023332","Total",888,337,38,299,256,125,250,40,210
"2011","Broxbourne 012B","E01023333","Total",786,248,54,194,260,106,183,41,142
"2011","Broxbourne 012C","E01023334","Total",688,252,10,242,185,62,183,27,156
"2011","Broxbourne 012D","E01023335","Total",655,204,9,195,203,65,182,35,147
"2011","Broxbourne 013A","E01023336","Total",821,204,50,154,290,127,203,57,146
"2011","Broxbourne 013B","E01023337","Total",650,200,45,155,222,96,145,38,107
"2011","Broxbourne 013C","E01023338","Total",1098,431,99,332,315,165,289,52,237
"2011","Broxbourne 013D","E01023339","Total",594,228,61,167,218,78,192,54,138
"2011","Dacorum 001A","E01023430","Total",490,131,3,128,141,43,98,20,78
"2011","Dacorum 001B","E01023431","Total",502,120,8,112,138,51,89,7,82
"2011","Dacorum 001C","E01023432","Total",579,141,13,128,186,76,115,16,99
"2011","Dacorum 001D","E01023433","Total",676,173,24,149,193,85,135,28,107
"2011","Dacorum 002A","E01023423","Total",549,154,8,146,169,63,127,17,110
"2011","Dacorum 002B","E01023424","Total",564,129,6,123,192,64,126,25,101
"2011","Dacorum 002C","E01023425","Total",522,130,9,121,183,61,102,13,89
"2011","Dacorum 002D","E01023426","Total",715,195,12,183,156,61,152,19,133
"2011","Dacorum 003A","E01023418","Total",628,229,20,209,173,66,212,31,181
"2011","Dacorum 003B","E01023419","Total",830,154,21,133,301,121,153,37,116
"2011","Dacorum 003C","E01023420","Total",611,191,7,184,190,56,122,23,99
"2011","Dacorum 004A","E01023352","Total",1015,296,16,280,300,106,209,30,179
"2011","Dacorum 004B","E01023421","Total",642,176,6,170,191,68,110,19,91
"2011","Dacorum 004C","E01023422","Total",484,160,4,156,150,41,88,16,72
"2011","Dacorum 005A","E01023434","Total",663,141,25,116,202,101,118,29,89
"2011","Dacorum 005B","E01023435","Total",690,103,22,81,201,106,114,21,93
"2011","Dacorum 005C","E01023436","Total",483,103,6,97,144,59,109,21,88
"2011","Dacorum 005D","E01023437","Total",680,184,73,111,241,128,155,47,108
"2011","Dacorum 006A","E01023355","Total",620,201,7,194,185,63,113,22,91
"2011","Dacorum 006B","E01023356","Total",457,155,4,151,128,35,88,14,74
"2011","Dacorum 006C","E01023416","Total",652,235,4,231,153,56,143,10,133
"2011","Dacorum 006D","E01023417","Total",665,268,6,262,164,76,196,13,183
"2011","Dacorum 007A","E01023393","Total",884,353,34,319,185,79,264,25,239
"2011","Dacorum 007B","E01023394","Total",506,103,25,78,173,79,119,34,85
"2011","Dacorum 007C","E01023395","Total",628,157,42,115,225,99,152,38,114
"2011","Dacorum 007D","E01023396","Total",594,144,34,110,200,87,129,37,92
"2011","Dacorum 007E","E01023397","Total",518,154,49,105,192,88,132,35,97
"2011","Dacorum 008A","E01023401","Total",720,203,60,143,272,142,179,38,141
"2011","Dacorum 008B","E01023402","Total",654,221,27,194,204,95,173,24,149
"2011","Dacorum 008C","E01023403","Total",670,268,29,239,175,90,207,25,182
"2011","Dacorum 008D","E01023404","Total",529,185,60,125,203,97,144,34,110
"2011","Dacorum 008E","E01023405","Total",621,228,49,179,226,104,194,42,152
"2011","Dacorum 009A","E01023361","Total",924,232,14,218,162,101,169,14,155
"2011","Dacorum 009B","E01023362","Total",790,275,5,270,201,76,187,23,164
"2011","Dacorum 009C","E01023363","Total",629,119,3,116,239,105,85,21,64
"2011","Dacorum 009D","E01023364","Total",509,167,5,162,163,58,99,13,86
"2011","Dacorum 010A","E01023390","Total",874,274,40,234,286,126,209,32,177
"2011","Dacorum 010B","E01023391","Total",693,193,29,164,260,95,131,28,103
"2011","Dacorum 010C","E01023399","Total",848,294,14,280,164,89,210,20,190
"2011","Dacorum 011A","E01023392","Total",633,187,24,163,219,75,174,37,137
"2011","Dacorum 011B","E01023427","Total",649,202,36,166,246,96,175,46,129
"2011","Dacorum 011C","E01023428","Total",625,110,7,103,188,65,102,23,79
"2011","Dacorum 011D","E01023429","Total",800,334,35,299,217,89,252,35,217
"2011","Dacorum 012A","E01023369","Total",622,244,30,214,211,103,179,24,155
"2011","Dacorum 012B","E01023370","Total",726,150,15,135,252,131,116,18,98
"2011","Dacorum 012C","E01023371","Total",514,116,15,101,224,69,97,24,73
"2011","Dacorum 012D","E01023372","Total",539,174,6,168,196,69,106,18,88
"2011","Dacorum 013A","E01023345","Total",651,166,25,141,198,85,155,33,122
"2011","Dacorum 013B","E01023346","Total",534,197,33,164,175,92,126,27,99
"2011","Dacorum 013C","E01023347","Total",514,178,11,167,130,49,138,18,120
"2011","Dacorum 013D","E01023348","Total",688,293,51,242,219,110,232,43,189
"2011","Dacorum 014A","E01023365","Total",566,124,7,117,139,72,89,8,81
"2011","Dacorum 014B","E01023366","Total",645,144,19,125,220,97,125,19,106
"2011","Dacorum 014C","E01023367","Total",405,122,3,119,163,53,74,14,60
"2011","Dacorum 014D","E01023368","Total",677,160,9,151,274,124,108,20,88
"2011","Dacorum 015A","E01023349","Total",780,268,48,220,275,124,229,48,181
"2011","Dacorum 015B","E01023350","Total",661,233,42,191,219,84,173,21,152
"2011","Dacorum 015C","E01023351","Total",663,202,29,173,211,114,152,30,122
"2011","Dacorum 015D","E01023398","Total",1077,204,24,180,307,136,147,35,112
"2011","Dacorum 015E","E01023400","Total",878,328,19,309,167,73,238,17,221
"2011","Dacorum 016A","E01023383","Total",597,166,20,146,194,60,145,32,113
"2011","Dacorum 016B","E01023384","Total",780,245,38,207,263,121,174,37,137
"2011","Dacorum 016C","E01023385","Total",687,243,8,235,182,45,203,32,171
"2011","Dacorum 017A","E01023409","Total",633,224,21,203,174,74,169,37,132
"2011","Dacorum 017B","E01023410","Total",540,220,7,213,138,27,111,16,95
"2011","Dacorum 017C","E01023411","Total",594,183,34,149,214,91,141,31,110
"2011","Dacorum 017D","E01023412","Total",498,186,4,182,124,31,120,16,104
"2011","Dacorum 017E","E01023413","Total",536,126,29,97,198,83,114,27,87
"2011","Dacorum 018B","E01023354","Total",691,152,15,137,218,76,131,31,100
"2011","Dacorum 018C","E01023379","Total",675,187,8,179,203,79,145,28,117
"2011","Dacorum 018D","E01023380","Total",481,102,8,94,138,61,94,26,68
"2011","Dacorum 018E","E01023381","Total",516,162,4,158,156,45,113,16,97
"2011","Dacorum 018F","E01023382","Total",678,230,18,212,200,79,169,20,149
"2011","Dacorum 018G","E01033022","Total",663,76,15,61,141,81,61,16,45
"2011","Dacorum 018H","E01033023","Total",736,172,12,160,161,87,155,21,134
"2011","Dacorum 019A","E01023386","Total",608,181,24,157,187,71,174,35,139
"2011","Dacorum 019B","E01023387","Total",502,125,31,94,214,88,119,33,86
"2011","Dacorum 019C","E01023388","Total",652,175,22,153,214,90,144,32,112
"2011","Dacorum 019D","E01023389","Total",659,174,16,158,213,74,125,24,101
"2011","Dacorum 020A","E01023357","Total",675,276,50,226,230,95,227,53,174
"2011","Dacorum 020B","E01023358","Total",521,153,33,120,225,83,133,29,104
"2011","Dacorum 020C","E01023359","Total",670,193,45,148,289,113,176,55,121
"2011","Dacorum 020D","E01023360","Total",543,119,15,104,221,86,124,31,93
"2011","Dacorum 020E","E01023414","Total",595,148,15,133,201,87,134,29,105
"2011","Dacorum 020F","E01023415","Total",537,173,21,152,177,54,138,33,105
"2011","Dacorum 021A","E01023373","Total",505,156,5,151,160,55,119,20,99
"2011","Dacorum 021B","E01023374","Total",612,144,4,140,190,68,123,18,105
"2011","Dacorum 021C","E01023375","Total",641,223,16,207,197,57,133,22,111
"2011","Dacorum 021D","E01023376","Total",534,128,13,115,162,65,109,19,90
"2011","Dacorum 021E","E01023377","Total",499,157,6,151,141,35,95,16,79
"2011","Dacorum 021F","E01023378","Total",590,141,4,137,200,56,108,26,82
"2011","Dacorum 022A","E01023406","Total",872,280,17,263,239,88,206,29,177
"2011","Dacorum 022B","E01023407","Total",640,176,17,159,216,78,128,26,102
"2011","Dacorum 022C","E01023408","Total",623,172,13,159,220,62,108,25,83
"2011","East Hertfordshire 001A","E01023462","Total",524,122,14,108,166,58,109,20,89
"2011","East Hertfordshire 001B","E01023464","Total",806,198,4,194,288,87,164,39,125
"2011","East Hertfordshire 001C","E01023465","Total",559,145,12,133,185,64,119,35,84
"2011","East Hertfordshire 001D","E01023466","Total",764,245,8,237,209,69,204,25,179
"2011","East Hertfordshire 002A","E01023467","Total",975,298,13,285,279,76,223,38,185
"2011","East Hertfordshire 002B","E01023494","Total",481,141,10,131,150,41,105,17,88
"2011","East Hertfordshire 002C","E01023495","Total",498,126,7,119,163,48,113,17,96
"2011","East Hertfordshire 002D","E01023508","Total",578,140,9,131,193,59,114,27,87
"2011","East Hertfordshire 002E","E01023509","Total",552,147,24,123,205,68,112,29,83
"2011","East Hertfordshire 003A","E01023452","Total",482,78,15,63,242,69,71,24,47
"2011","East Hertfordshire 003B","E01023453","Total",538,126,5,121,199,66,87,22,65
"2011","East Hertfordshire 003C","E01023454","Total",504,93,9,84,198,68,61,12,49
"2011","East Hertfordshire 003D","E01023455","Total",538,149,12,137,181,56,105,16,89
"2011","East Hertfordshire 003E","E01023463","Total",497,153,1,152,143,45,107,17,90
"2011","East Hertfordshire 003F","E01023493","Total",933,200,17,183,345,114,184,50,134
"2011","East Hertfordshire 004A","E01023449","Total",669,189,5,184,208,73,123,25,98
"2011","East Hertfordshire 004B","E01023450","Total",989,290,15,275,199,78,229,22,207
"2011","East Hertfordshire 004C","E01023451","Total",929,277,8,269,250,106,199,26,173
"2011","East Hertfordshire 005A","E01023438","Total",583,136,12,124,204,83,119,31,88
"2011","East Hertfordshire 005B","E01023439","Total",504,146,20,126,176,46,125,27,98
"2011","East Hertfordshire 005C","E01023440","Total",647,221,11,210,204,46,137,22,115
"2011","East Hertfordshire 005D","E01023441","Total",491,86,9,77,159,57,68,16,52
"2011","East Hertfordshire 005E","E01023442","Total",798,170,22,148,295,107,147,40,107
"2011","East Hertfordshire 006A","E01023498","Total",1103,293,21,272,341,135,244,41,203
"2011","East Hertfordshire 006B","E01023506","Total",578,176,16,160,164,54,135,19,116
"2011","East Hertfordshire 006C","E01023507","Total",627,146,7,139,210,69,109,23,86
"2011","East Hertfordshire 007A","E01023443","Total",647,161,9,152,205,72,139,23,116
"2011","East Hertfordshire 007B","E01023444","Total",681,165,12,153,224,106,140,24,116
"2011","East Hertfordshire 007C","E01023445","Total",701,224,27,197,234,82,193,36,157
"2011","East Hertfordshire 007D","E01023446","Total",1135,276,19,257,230,129,213,14,199
"2011","East Hertfordshire 007E","E01023447","Total",484,156,44,112,192,67,148,34,114
"2011","East Hertfordshire 007F","E01023448","Total",585,112,17,95,234,77,94,26,68
"2011","East Hertfordshire 008A","E01023456","Total",511,74,8,66,228,83,103,28,75
"2011","East Hertfordshire 008B","E01023457","Total",610,111,8,103,219,79,115,29,86
"2011","East Hertfordshire 008C","E01023458","Total",520,112,14,98,175,49,103,21,82
"2011","East Hertfordshire 008D","E01023459","Total",518,102,0,102,179,57,84,19,65
"2011","East Hertfordshire 008E","E01023460","Total",548,124,9,115,226,67,88,19,69
"2011","East Hertfordshire 008F","E01023461","Total",515,62,7,55,300,76,61,29,32
"2011","East Hertfordshire 009A","E01023491","Total",528,144,9,135,156,48,114,17,97
"2011","East Hertfordshire 009B","E01023492","Total",586,159,14,145,179,61,124,24,100
"2011","East Hertfordshire 009C","E01023496","Total",442,110,12,98,147,48,103,23,80
"2011","East Hertfordshire 009D","E01023497","Total",648,214,11,203,202,69,180,30,150
"2011","East Hertfordshire 010A","E01023485","Total",954,284,13,271,250,76,213,30,183
"2011","East Hertfordshire 010B","E01023486","Total",989,258,16,242,307,96,217,31,186
"2011","East Hertfordshire 010E","E01033609","Total",971,266,23,243,317,118,227,38,189
"2011","East Hertfordshire 011A","E01023499","Total",755,253,22,231,229,77,218,39,179
"2011","East Hertfordshire 011B","E01023500","Total",615,160,3,157,186,48,134,22,112
"2011","East Hertfordshire 011C","E01023501","Total",679,202,12,190,179,51,125,19,106
"2011","East Hertfordshire 011D","E01023502","Total",799,205,14,191,214,91,161,35,126
"2011","East Hertfordshire 011E","E01023503","Total",739,221,7,214,196,62,140,25,115
"2011","East Hertfordshire 012A","E01023512","Total",834,177,16,161,231,106,136,23,113
"2011","East Hertfordshire 012B","E01023513","Total",590,199,21,178,193,84,164,29,135
"2011","East Hertfordshire 012C","E01023514","Total",907,252,24,228,170,91,194,19,175
"2011","East Hertfordshire 012D","E01023518","Total",705,191,36,155,275,128,167,41,126
"2011","East Hertfordshire 012E","E01023519","Total",668,172,30,142,250,104,127,36,91
"2011","East Hertfordshire 012F","E01023520","Total",664,204,12,192,215,87,124,22,102
"2011","East Hertfordshire 013A","E01023510","Total",605,168,5,163,183,61,128,20,108
"2011","East Hertfordshire 013B","E01023511","Total",815,226,19,207,149,82,170,15,155
"2011","East Hertfordshire 013C","E01023515","Total",670,105,8,97,200,86,101,21,80
"2011","East Hertfordshire 013D","E01023516","Total",874,177,8,169,264,90,147,28,119
"2011","East Hertfordshire 013E","E01023517","Total",679,198,13,185,209,84,139,17,122
"2011","East Hertfordshire 014A","E01023470","Total",906,209,6,203,182,93,162,16,146
"2011","East Hertfordshire 014B","E01023471","Total",536,152,9,143,165,71,107,13,94
"2011","East Hertfordshire 014C","E01023472","Total",606,213,25,188,176,74,183,32,151
"2011","East Hertfordshire 014D","E01023473","Total",598,216,3,213,165,61,131,12,119
"2011","East Hertfordshire 014E","E01023474","Total",624,141,6,135,223,108,111,17,94
"2011","East Hertfordshire 015A","E01023487","Total",624,255,40,215,179,72,199,33,166
"2011","East Hertfordshire 015B","E01023488","Total",706,283,90,193,255,124,191,37,154
"2011","East Hertfordshire 015C","E01023489","Total",641,166,7,159,140,65,126,5,121
"2011","East Hertfordshire 015D","E01023490","Total",478,121,18,103,189,74,91,22,69
"2011","East Hertfordshire 016A","E01023482","Total",751,91,14,77,348,145,68,25,43
"2011","East Hertfordshire 016B","E01023483","Total",740,140,11,129,288,99,158,31,127
"2011","East Hertfordshire 016C","E01023484","Total",638,152,25,127,228,80,143,24,119
"2011","East Hertfordshire 017A","E01023475","Total",623,186,29,157,205,81,174,29,145
"2011","East Hertfordshire 017B","E01023476","Total",599,199,11,188,183,57,119,17,102
"2011","East Hertfordshire 017C","E01023477","Total",922,153,15,138,290,115,132,29,103
"2011","East Hertfordshire 017D","E01023478","Total",961,230,12,218,165,82,160,18,142
"2011","East Hertfordshire 017E","E01023479","Total",705,148,18,130,188,82,119,29,90
"2011","East Hertfordshire 018A","E01023468","Total",532,88,3,85,180,45,87,16,71
"2011","East Hertfordshire 018B","E01023469","Total",606,179,22,157,202,78,150,30,120
"2011","East Hertfordshire 018C","E01023480","Total",675,224,14,210,183,55,171,21,150
"2011","East Hertfordshire 018D","E01023481","Total",480,91,4,87,157,46,62,10,52
"2011","East Hertfordshire 018E","E01023504","Total",574,177,20,157,175,62,155,16,139
"2011","East Hertfordshire 018F","E01023505","Total",734,128,14,114,209,90,117,26,91
"2011","Hertsmere 001A","E01023576","Total",599,245,5,240,117,28,154,16,138
"2011","Hertsmere 001B","E01023577","Total",719,288,11,277,162,46,194,22,172
"2011","Hertsmere 001C","E01023578","Total",651,253,5,248,154,33,156,11,145
"2011","Hertsmere 001D","E01023579","Total",586,179,16,163,168,67,126,21,105
"2011","Hertsmere 001E","E01023580","Total",708,243,18,225,205,79,165,24,141
"2011","Hertsmere 002A","E01023567","Total",743,187,12,175,289,99,154,31,123
"2011","Hertsmere 002B","E01023568","Total",634,256,6,250,166,47,175,27,148
"2011","Hertsmere 002C","E01023569","Total",601,176,22,154,216,62,135,27,108
"2011","Hertsmere 002D","E01023570","Total",610,183,17,166,173,58,167,26,141
"2011","Hertsmere 003A","E01023571","Total",597,228,8,220,155,53,131,18,113
"2011","Hertsmere 003B","E01023572","Total",618,185,19,166,163,58,148,20,128
"2011","Hertsmere 003C","E01023573","Total",524,193,27,166,148,57,156,20,136
"2011","Hertsmere 003D","E01023574","Total",654,223,57,166,237,101,202,58,144
"2011","Hertsmere 003E","E01023575","Total",647,204,13,191,166,52,161,22,139
"2011","Hertsmere 004A","E01023581","Total",488,61,5,56,209,91,73,22,51
"2011","Hertsmere 004B","E01023582","Total",617,131,35,96,269,115,131,51,80
"2011","Hertsmere 004C","E01023583","Total",563,159,36,123,184,79,128,24,104
"2011","Hertsmere 004D","E01023584","Total",433,129,10,119,126,40,106,18,88
"2011","Hertsmere 005A","E01023523","Total",613,138,10,128,243,68,91,23,68
"2011","Hertsmere 005B","E01023524","Total",516,134,5,129,216,50,84,18,66
"2011","Hertsmere 005C","E01023525","Total",748,217,18,199,203,84,165,26,139
"2011","Hertsmere 005D","E01023526","Total",665,155,8,147,230,70,124,18,106
"2011","Hertsmere 005E","E01023527","Total",601,220,26,194,194,76,152,23,129
"2011","Hertsmere 006A","E01023534","Total",613,171,27,144,234,83,156,31,125
"2011","Hertsmere 006B","E01023535","Total",667,200,35,165,232,87,200,37,163
"2011","Hertsmere 006C","E01023536","Total",786,381,76,305,235,120,251,37,214
"2011","Hertsmere 006D","E01023537","Total",645,188,25,163,235,85,169,32,137
"2011","Hertsmere 006E","E01023538","Total",774,311,36,275,213,104,280,33,247
"2011","Hertsmere 007A","E01023529","Total",559,152,33,119,228,100,153,38,115
"2011","Hertsmere 007B","E01023530","Total",557,200,44,156,180,98,159,31,128
"2011","Hertsmere 007C","E01023531","Total",779,209,35,174,279,144,202,40,162
"2011","Hertsmere 007D","E01023532","Total",661,166,17,149,214,121,136,19,117
"2011","Hertsmere 007E","E01023533","Total",617,207,44,163,236,98,172,30,142
"2011","Hertsmere 008A","E01023552","Total",599,160,17,143,227,66,153,30,123
"2011","Hertsmere 008B","E01023553","Total",584,110,8,102,209,76,78,16,62
"2011","Hertsmere 008C","E01023554","Total",695,162,35,127,226,109,130,23,107
"2011","Hertsmere 008D","E01023555","Total",713,225,39,186,219,87,183,42,141
"2011","Hertsmere 009A","E01023544","Total",489,119,25,94,166,77,95,21,74
"2011","Hertsmere 009B","E01023545","Total",580,100,18,82,158,86,97,19,78
"2011","Hertsmere 009C","E01023546","Total",722,177,32,145,262,131,191,37,154
"2011","Hertsmere 009D","E01023547","Total",695,232,46,186,245,96,198,51,147
"2011","Hertsmere 010A","E01023528","Total",629,118,15,103,188,86,103,19,84
"2011","Hertsmere 010B","E01023564","Total",641,133,21,112,235,121,124,28,96
"2011","Hertsmere 010C","E01023565","Total",621,147,16,131,246,93,118,25,93
"2011","Hertsmere 010D","E01023566","Total",514,102,4,98,220,66,93,21,72
"2011","Hertsmere 011A","E01023539","Total",1163,204,52,152,421,248,167,40,127
"2011","Hertsmere 011B","E01023540","Total",634,190,25,165,224,103,161,23,138
"2011","Hertsmere 011C","E01023541","Total",712,139,12,127,273,133,129,23,106
"2011","Hertsmere 011D","E01023542","Total",652,160,34,126,247,97,148,34,114
"2011","Hertsmere 011E","E01023543","Total",577,174,34,140,176,70,161,28,133
"2011","Hertsmere 012A","E01023558","Total",752,187,11,176,213,87,156,29,127
"2011","Hertsmere 012B","E01023559","Total",586,124,5,119,192,54,108,23,85
"2011","Hertsmere 012C","E01023560","Total",604,226,34,192,213,89,209,40,169
"2011","Hertsmere 012D","E01023561","Total",641,178,28,150,232,96,157,28,129
"2011","Hertsmere 012E","E01023562","Total",557,156,8,148,194,57,103,17,86
"2011","Hertsmere 012F","E01023563","Total",634,175,18,157,199,74,121,19,102
"2011","Hertsmere 013A","E01023548","Total",790,262,11,251,178,64,174,18,156
"2011","Hertsmere 013B","E01023549","Total",782,292,18,274,181,65,232,20,212
"2011","Hertsmere 013C","E01023550","Total",648,165,5,160,224,87,139,19,120
"2011","Hertsmere 013D","E01023551","Total",542,133,7,126,191,58,118,23,95
"2011","Hertsmere 013E","E01023556","Total",623,179,15,164,208,71,158,27,131
"2011","Hertsmere 013F","E01023557","Total",606,153,13,140,213,70,119,29,90
"2011","North Hertfordshire 001A","E01023660","Total",1047,335,17,318,224,116,276,27,249
"2011","North Hertfordshire 001B","E01023661","Total",521,153,24,129,187,62,147,29,118
"2011","North Hertfordshire 001C","E01023662","Total",607,84,14,70,238,85,110,33,77
"2011","North Hertfordshire 002A","E01023654","Total",647,143,9,134,176,76,114,19,95
"2011","North Hertfordshire 002B","E01023655","Total",623,189,10,179,161,64,168,25,143
"2011","North Hertfordshire 002C","E01023656","Total",999,241,16,225,246,113,220,35,185
"2011","North Hertfordshire 002D","E01023657","Total",1018,265,7,258,317,158,179,33,146
"2011","North Hertfordshire 002E","E01023658","Total",638,201,16,185,215,84,155,33,122
"2011","North Hertfordshire 002F","E01023659","Total",506,104,1,103,161,46,91,15,76
"2011","North Hertfordshire 003A","E01023635","Total",616,248,24,224,187,71,176,31,145
"2011","North Hertfordshire 003B","E01023636","Total",783,286,28,258,230,93,212,30,182
"2011","North Hertfordshire 003C","E01023637","Total",870,422,42,380,205,91,322,46,276
"2011","North Hertfordshire 003D","E01023638","Total",666,225,30,195,185,85,181,26,155
"2011","North Hertfordshire 004A","E01023587","Total",497,80,5,75,147,49,77,15,62
"2011","North Hertfordshire 004B","E01023588","Total",544,135,4,131,187,68,89,18,71
"2011","North Hertfordshire 004C","E01023589","Total",800,284,12,272,186,60,214,20,194
"2011","North Hertfordshire 004D","E01023590","Total",738,200,16,184,225,84,156,35,121
"2011","North Hertfordshire 004E","E01023591","Total",627,200,9,191,188,53,153,21,132
"2011","North Hertfordshire 004F","E01023592","Total",556,178,37,141,243,83,139,42,97
"2011","North Hertfordshire 004G","E01023593","Total",613,208,30,178,193,89,154,27,127
"2011","North Hertfordshire 005A","E01023585","Total",465,137,8,129,127,44,110,11,99
"2011","North Hertfordshire 005B","E01023586","Total",646,187,12,175,180,64,125,15,110
"2011","North Hertfordshire 005C","E01023597","Total",491,114,10,104,134,38,97,17,80
"2011","North Hertfordshire 005D","E01023598","Total",549,150,18,132,185,81,109,21,88
"2011","North Hertfordshire 005F","E01023600","Total",574,159,17,142,161,53,139,24,115
"2011","North Hertfordshire 005G","E01023663","Total",839,212,21,191,259,67,181,29,152
"2011","North Hertfordshire 005H","E01033024","Total",535,40,7,33,282,128,57,31,26
"2011","North Hertfordshire 005I","E01033025","Total",519,62,10,52,222,131,48,13,35
"2011","North Hertfordshire 005J","E01033026","Total",573,69,11,58,230,139,76,23,53
"2011","North Hertfordshire 005K","E01033027","Total",605,66,26,40,220,138,70,22,48
"2011","North Hertfordshire 006A","E01023630","Total",618,187,36,151,220,91,165,43,122
"2011","North Hertfordshire 006B","E01023631","Total",712,215,40,175,238,114,198,43,155
"2011","North Hertfordshire 006C","E01023632","Total",560,153,17,136,173,73,126,24,102
"2011","North Hertfordshire 006D","E01023633","Total",616,173,29,144,195,87,138,29,109
"2011","North Hertfordshire 006E","E01023634","Total",609,209,8,201,124,47,146,19,127
"2011","North Hertfordshire 007A","E01023649","Total",641,175,18,157,143,59,120,21,99
"2011","North Hertfordshire 007B","E01023650","Total",606,184,40,144,218,91,170,37,133
"2011","North Hertfordshire 007C","E01023651","Total",483,140,13,127,166,59,106,19,87
"2011","North Hertfordshire 007D","E01023652","Total",605,246,43,203,209,83,177,36,141
"2011","North Hertfordshire 008A","E01023644","Total",717,277,9,268,179,61,190,22,168
"2011","North Hertfordshire 008B","E01023645","Total",642,238,22,216,189,54,180,31,149
"2011","North Hertfordshire 008C","E01023646","Total",507,157,45,112,243,97,142,51,91
"2011","North Hertfordshire 008D","E01023647","Total",597,213,9,204,181,54,152,24,128
"2011","North Hertfordshire 008E","E01023648","Total",470,160,5,155,120,33,111,18,93
"2011","North Hertfordshire 009A","E01023639","Total",541,171,12,159,164,57,119,26,93
"2011","North Hertfordshire 009B","E01023640","Total",560,252,40,212,154,65,177,28,149
"2011","North Hertfordshire 009C","E01023641","Total",579,221,41,180,177,75,182,40,142
"2011","North Hertfordshire 009D","E01023642","Total",497,157,7,150,151,49,109,26,83
"2011","North Hertfordshire 009E","E01023643","Total",495,157,27,130,192,56,130,33,97
"2011","North Hertfordshire 010A","E01023601","Total",1103,266,28,238,210,96,222,26,196
"2011","North Hertfordshire 010B","E01023602","Total",637,105,13,92,220,110,111,23,88
"2011","North Hertfordshire 010C","E01023603","Total",611,139,13,126,231,105,113,22,91
"2011","North Hertfordshire 010D","E01023604","Total",536,139,9,130,187,75,124,21,103
"2011","North Hertfordshire 010E","E01023605","Total",728,136,30,106,176,84,114,25,89
"2011","North Hertfordshire 011A","E01023617","Total",622,210,5,205,182,64,151,26,125
"2011","North Hertfordshire 011B","E01023618","Total",602,177,26,151,203,83,136,35,101
"2011","North Hertfordshire 011C","E01023619","Total",730,123,8,115,175,88,114,17,97
"2011","North Hertfordshire 011D","E01023620","Total",528,185,26,159,185,57,150,35,115
"2011","North Hertfordshire 011E","E01023621","Total",591,152,21,131,176,71,121,24,97
"2011","North Hertfordshire 012A","E01023611","Total",664,259,45,214,235,89,197,54,143
"2011","North Hertfordshire 012B","E01023612","Total",739,164,18,146,236,105,145,31,114
"2011","North Hertfordshire 012C","E01023613","Total",763,300,55,245,235,112,227,34,193
"2011","North Hertfordshire 012D","E01023614","Total",806,218,6,212,243,82,143,29,114
"2011","North Hertfordshire 012E","E01023615","Total",652,226,5,221,169,56,137,19,118
"2011","North Hertfordshire 012F","E01023616","Total",1036,335,14,321,188,88,242,19,223
"2011","North Hertfordshire 013A","E01023606","Total",780,247,23,224,219,89,180,30,150
"2011","North Hertfordshire 013B","E01023607","Total",588,184,8,176,198,75,114,14,100
"2011","North Hertfordshire 013C","E01023608","Total",634,253,2,251,178,60,163,23,140
"2011","North Hertfordshire 013D","E01023609","Total",714,193,12,181,170,59,144,18,126
"2011","North Hertfordshire 013E","E01023610","Total",500,62,1,61,220,82,71,20,51
"2011","North Hertfordshire 014A","E01023594","Total",972,325,20,305,267,94,235,38,197
"2011","North Hertfordshire 014B","E01023622","Total",455,131,7,124,147,35,109,14,95
"2011","North Hertfordshire 014C","E01023623","Total",596,165,9,156,166,59,124,20,104
"2011","North Hertfordshire 014D","E01023624","Total",524,127,12,115,163,65,111,22,89
"2011","North Hertfordshire 014E","E01023625","Total",425,98,2,96,127,24,78,14,64
"2011","North Hertfordshire 014F","E01023653","Total",887,267,20,247,289,106,192,34,158
"2011","North Hertfordshire 015A","E01023595","Total",679,196,4,192,181,64,152,27,125
"2011","North Hertfordshire 015B","E01023596","Total",492,195,7,188,132,34,138,19,119
"2011","North Hertfordshire 015C","E01023626","Total",862,249,14,235,262,91,170,32,138
"2011","North Hertfordshire 015D","E01023627","Total",671,152,11,141,190,61,127,20,107
"2011","North Hertfordshire 015E","E01023628","Total",750,165,7,158,228,96,144,31,113
"2011","North Hertfordshire 015F","E01023629","Total",782,240,20,220,209,82,189,31,158
"2011","St Albans 001A","E01023690","Total",608,174,5,169,254,98,131,24,107
"2011","St Albans 001B","E01023691","Total",502,125,6,119,240,72,67,12,55
"2011","St Albans 001C","E01023692","Total",502,135,26,109,195,74,98,21,77
"2011","St Albans 001D","E01023693","Total",523,140,6,134,172,61,92,13,79
"2011","St Albans 001E","E01023694","Total",509,123,5,118,239,84,72,19,53
"2011","St Albans 002A","E01023685","Total",645,133,9,124,263,124,106,22,84
"2011","St Albans 002B","E01023686","Total",523,124,4,120,240,94,69,20,49
"2011","St Albans 002C","E01023687","Total",604,178,35,143,217,79,162,37,125
"2011","St Albans 002D","E01023688","Total",626,181,18,163,201,89,138,29,109
"2011","St Albans 002E","E01023689","Total",509,135,3,132,210,83,94,16,78
"2011","St Albans 003A","E01023699","Total",597,213,3,210,191,77,115,14,101
"2011","St Albans 003B","E01023700","Total",472,145,5,140,185,57,81,17,64
"2011","St Albans 003C","E01023701","Total",845,292,13,279,208,95,166,15,151
"2011","St Albans 003D","E01023702","Total",682,152,1,151,235,120,115,20,95
"2011","St Albans 003E","E01023703","Total",518,118,5,113,238,105,78,23,55
"2011","St Albans 004A","E01023746","Total",626,186,55,131,241,118,157,43,114
"2011","St Albans 004B","E01023747","Total",735,226,7,219,245,95,164,27,137
"2011","St Albans 004C","E01023748","Total",565,213,10,203,153,40,122,18,104
"2011","St Albans 004D","E01023749","Total",656,217,13,204,215,81,148,31,117
"2011","St Albans 005A","E01023695","Total",613,187,3,184,213,82,124,25,99
"2011","St Albans 005B","E01023696","Total",633,216,11,205,224,71,108,19,89
"2011","St Albans 005C","E01023697","Total",792,201,14,187,257,125,156,30,126
"2011","St Albans 005D","E01023698","Total",601,150,1,149,224,79,110,20,90
"2011","St Albans 006A","E01023722","Total",582,160,7,153,165,70,119,20,99
"2011","St Albans 006B","E01023723","Total",677,206,24,182,234,85,194,45,149
"2011","St Albans 006C","E01023724","Total",703,245,10,235,178,67,169,14,155
"2011","St Albans 006D","E01023725","Total",572,147,6,141,205,80,94,18,76
"2011","St Albans 007A","E01023713","Total",680,169,15,154,267,107,150,34,116
"2011","St Albans 007B","E01023734","Total",651,138,7,131,224,76,99,20,79
"2011","St Albans 007C","E01023735","Total",799,202,11,191,215,79,176,29,147
"2011","St Albans 007D","E01023736","Total",648,166,13,153,172,66,130,24,106
"2011","St Albans 008A","E01023709","Total",728,229,9,220,208,63,199,28,171
"2011","St Albans 008B","E01023710","Total",542,144,3,141,194,55,117,22,95
"2011","St Albans 008C","E01023711","Total",605,199,12,187,211,70,154,30,124
"2011","St Albans 008D","E01023712","Total",738,193,22,171,227,91,159,37,122
"2011","St Albans 009A","E01023669","Total",670,194,50,144,265,119,158,43,115
"2011","St Albans 009B","E01023670","Total",811,149,17,132,323,178,122,29,93
"2011","St Albans 009C","E01023671","Total",735,242,27,215,260,99,224,45,179
"2011","St Albans 009D","E01023672","Total",664,135,17,118,276,103,123,35,88
"2011","St Albans 010A","E01023673","Total",501,107,7,100,205,68,71,20,51
"2011","St Albans 010B","E01023714","Total",638,168,4,164,263,63,104,22,82
"2011","St Albans 010C","E01023715","Total",525,119,7,112,232,83,109,27,82
"2011","St Albans 010D","E01023716","Total",841,153,7,146,287,157,145,26,119
"2011","St Albans 011A","E01023666","Total",773,143,27,116,176,102,123,31,92
"2011","St Albans 011B","E01023674","Total",723,113,11,102,274,153,110,30,80
"2011","St Albans 011C","E01023675","Total",501,145,3,142,193,48,96,25,71
"2011","St Albans 011D","E01023676","Total",1000,207,31,176,259,139,152,24,128
"2011","St Albans 012A","E01023726","Total",827,121,5,116,173,126,110,14,96
"2011","St Albans 012B","E01023727","Total",1024,287,23,264,165,107,224,15,209
"2011","St Albans 012C","E01023728","Total",956,184,9,175,261,130,151,25,126
"2011","St Albans 012D","E01023729","Total",854,153,25,128,224,114,136,27,109
"2011","St Albans 013A","E01023664","Total",649,120,12,108,270,99,111,32,79
"2011","St Albans 013B","E01023665","Total",592,116,4,112,229,102,107,25,82
"2011","St Albans 013C","E01023667","Total",568,99,12,87,190,103,78,27,51
"2011","St Albans 013D","E01023668","Total",475,91,5,86,222,63,103,31,72
"2011","St Albans 014A","E01023742","Total",557,202,2,200,156,69,111,13,98
"2011","St Albans 014B","E01023743","Total",777,213,5,208,190,86,137,14,123
"2011","St Albans 014C","E01023744","Total",614,247,3,244,160,50,131,13,118
"2011","St Albans 014D","E01023745","Total",759,189,5,184,231,108,139,20,119
"2011","St Albans 015A","E01023677","Total",458,89,25,64,234,98,95,36,59
"2011","St Albans 015B","E01023678","Total",725,148,18,130,281,136,107,25,82
"2011","St Albans 015C","E01023679","Total",593,149,15,134,180,61,137,30,107
"2011","St Albans 015D","E01023680","Total",506,143,17,126,183,61,109,25,84
"2011","St Albans 016A","E01023681","Total",689,240,30,210,168,83,204,20,184
"2011","St Albans 016B","E01023682","Total",651,177,15,162,206,85,139,24,115
"2011","St Albans 016C","E01023683","Total",670,246,34,212,235,116,200,38,162
"2011","St Albans 016D","E01023684","Total",672,206,5,201,176,71,126,14,112
"2011","St Albans 017A","E01023737","Total",509,124,20,104,162,79,136,29,107
"2011","St Albans 017B","E01023738","Total",635,200,33,167,204,108,193,41,152
"2011","St Albans 017C","E01023739","Total",544,155,18,137,192,103,144,25,119
"2011","St Albans 017D","E01023740","Total",654,144,16,128,158,79,91,13,78
"2011","St Albans 017E","E01023741","Total",633,105,10,95,225,120,113,29,84
"2011","St Albans 018A","E01023704","Total",755,163,18,145,208,105,140,30,110
"2011","St Albans 018B","E01023705","Total",613,161,29,132,240,107,200,53,147
"2011","St Albans 018C","E01023706","Total",649,183,20,163,217,72,144,28,116
"2011","St Albans 018E","E01023708","Total",647,196,12,184,194,74,164,41,123
"2011","St Albans 018F","E01033028","Total",515,92,17,75,221,82,96,34,62
"2011","St Albans 018G","E01033029","Total",584,83,24,59,256,120,79,32,47
"2011","St Albans 019A","E01023718","Total",698,248,10,238,214,75,159,26,133
"2011","St Albans 019B","E01023719","Total",471,152,11,141,144,60,115,17,98
"2011","St Albans 019C","E01023720","Total",804,189,25,164,252,128,162,31,131
"2011","St Albans 019D","E01023721","Total",540,143,7,136,177,64,135,25,110
"2011","St Albans 020A","E01023717","Total",487,110,3,107,160,51,102,19,83
"2011","St Albans 020B","E01023730","Total",672,222,4,218,231,81,169,32,137
"2011","St Albans 020C","E01023731","Total",610,183,9,174,181,69,141,27,114
"2011","St Albans 020D","E01023732","Total",666,204,9,195,183,58,161,27,134
"2011","St Albans 020E","E01023733","Total",645,207,9,198,188,37,160,26,134
"2011","Stevenage 001A","E01023787","Total",546,130,25,105,197,94,107,27,80
"2011","Stevenage 001B","E01023788","Total",629,205,37,168,226,102,167,40,127
"2011","Stevenage 001C","E01023789","Total",751,194,63,131,325,151,160,55,105
"2011","Stevenage 001D","E01023790","Total",633,133,40,93,270,106,162,54,108
"2011","Stevenage 002A","E01023776","Total",1122,298,38,260,288,155,202,27,175
"2011","Stevenage 002B","E01023777","Total",759,205,13,192,226,95,159,35,124
"2011","Stevenage 002C","E01023778","Total",664,220,42,178,243,106,190,46,144
"2011","Stevenage 002D","E01023799","Total",504,126,24,102,179,53,105,28,77
"2011","Stevenage 002E","E01023800","Total",793,226,19,207,214,94,193,30,163
"2011","Stevenage 002F","E01023801","Total",914,167,63,104,412,198,145,54,91
"2011","Stevenage 003A","E01023771","Total",683,156,16,140,215,72,136,27,109
"2011","Stevenage 003B","E01023772","Total",755,199,30,169,203,83,166,24,142
"2011","Stevenage 003C","E01023773","Total",526,131,48,83,227,99,101,35,66
"2011","Stevenage 003D","E01023774","Total",668,200,32,168,225,79,172,40,132
"2011","Stevenage 004A","E01023767","Total",613,90,9,81,184,63,87,25,62
"2011","Stevenage 004B","E01023768","Total",679,109,6,103,236,81,108,30,78
"2011","Stevenage 004C","E01023769","Total",704,223,14,209,215,90,189,29,160
"2011","Stevenage 004D","E01023770","Total",636,135,10,125,170,52,101,20,81
"2011","Stevenage 005A","E01023795","Total",676,223,27,196,174,75,172,22,150
"2011","Stevenage 005B","E01023796","Total",724,273,25,248,167,78,230,31,199
"2011","Stevenage 005C","E01023797","Total",569,181,24,157,172,67,147,27,120
"2011","Stevenage 005D","E01023798","Total",642,155,23,132,183,87,119,17,102
"2011","Stevenage 006A","E01023775","Total",940,345,30,315,214,94,258,34,224
"2011","Stevenage 006B","E01023779","Total",678,227,46,181,221,95,174,30,144
"2011","Stevenage 006C","E01023780","Total",650,222,11,211,163,56,171,30,141
"2011","Stevenage 006D","E01023781","Total",782,279,35,244,211,101,198,28,170
"2011","Stevenage 006E","E01023782","Total",639,240,23,217,156,48,185,23,162
"2011","Stevenage 007A","E01023759","Total",591,176,29,147,225,87,122,32,90
"2011","Stevenage 007B","E01023760","Total",615,190,27,163,198,78,128,28,100
"2011","Stevenage 007C","E01023761","Total",866,215,46,169,331,131,195,59,136
"2011","Stevenage 007D","E01023762","Total",638,205,20,185,216,81,163,36,127
"2011","Stevenage 008A","E01023755","Total",630,191,31,160,220,80,154,39,115
"2011","Stevenage 008B","E01023756","Total",602,177,48,129,259,107,152,38,114
"2011","Stevenage 008C","E01023757","Total",753,258,55,203,269,118,194,39,155
"2011","Stevenage 008D","E01023758","Total",1056,520,67,453,216,128,342,34,308
"2011","Stevenage 009A","E01023750","Total",615,258,26,232,135,56,215,17,198
"2011","Stevenage 009B","E01023751","Total",467,135,26,109,169,78,103,23,80
"2011","Stevenage 009C","E01023752","Total",505,151,29,122,206,77,108,25,83
"2011","Stevenage 009D","E01023753","Total",636,114,8,106,194,70,97,19,78
"2011","Stevenage 009E","E01023754","Total",471,107,23,84,223,76,98,44,54
"2011","Stevenage 010A","E01023791","Total",620,198,26,172,203,73,165,34,131
"2011","Stevenage 010B","E01023792","Total",608,180,45,135,261,118,154,42,112
"2011","Stevenage 010C","E01023793","Total",616,224,52,172,215,92,193,42,151
"2011","Stevenage 010D","E01023794","Total",623,195,30,165,214,83,164,34,130
"2011","Stevenage 011A","E01023783","Total",694,204,34,170,215,91,170,37,133
"2011","Stevenage 011B","E01023784","Total",680,235,26,209,209,86,184,36,148
"2011","Stevenage 011C","E01023785","Total",675,206,53,153,227,104,165,38,127
"2011","Stevenage 011D","E01023786","Total",624,193,30,163,209,85,156,25,131
"2011","Stevenage 012A","E01023763","Total",594,125,13,112,187,66,113,20,93
"2011","Stevenage 012B","E01023764","Total",632,217,20,197,149,55,169,21,148
"2011","Stevenage 012C","E01023765","Total",596,226,20,206,192,62,178,37,141
"2011","Stevenage 012D","E01023766","Total",612,203,44,159,226,97,154,30,124
"2011","Three Rivers 001A","E01023802","Total",739,198,9,189,230,98,169,37,132
"2011","Three Rivers 001B","E01023803","Total",610,216,5,211,192,51,161,24,137
"2011","Three Rivers 001C","E01023804","Total",627,223,28,195,189,79,174,24,150
"2011","Three Rivers 001D","E01023807","Total",611,191,15,176,180,49,181,43,138
"2011","Three Rivers 001E","E01023808","Total",1151,250,26,224,303,152,181,29,152
"2011","Three Rivers 002A","E01023829","Total",620,198,43,155,255,97,177,47,130
"2011","Three Rivers 002B","E01023830","Total",748,268,17,251,149,78,202,17,185
"2011","Three Rivers 002C","E01023832","Total",683,140,22,118,249,101,109,25,84
"2011","Three Rivers 002D","E01023833","Total",912,161,24,137,351,136,160,34,126
"2011","Three Rivers 002E","E01023834","Total",573,142,13,129,216,64,136,31,105
"2011","Three Rivers 003A","E01023823","Total",586,201,12,189,168,47,137,20,117
"2011","Three Rivers 003B","E01023824","Total",738,237,5,232,253,84,185,34,151
"2011","Three Rivers 003C","E01023831","Total",749,144,18,126,300,110,140,43,97
"2011","Three Rivers 003D","E01023854","Total",788,244,9,235,199,60,173,22,151
"2011","Three Rivers 004A","E01023812","Total",486,121,8,113,179,48,85,17,68
"2011","Three Rivers 004B","E01023813","Total",489,96,5,91,195,37,92,26,66
"2011","Three Rivers 004C","E01023814","Total",500,239,3,236,128,34,155,13,142
"2011","Three Rivers 004D","E01023851","Total",762,212,10,202,153,67,133,19,114
"2011","Three Rivers 005A","E01023815","Total",590,160,11,149,214,90,108,19,89
"2011","Three Rivers 005B","E01023816","Total",496,160,7,153,175,64,101,24,77
"2011","Three Rivers 005C","E01023817","Total",592,151,6,145,182,51,117,15,102
"2011","Three Rivers 005D","E01023818","Total",506,159,4,155,183,44,109,16,93
"2011","Three Rivers 006A","E01023819","Total",678,169,21,148,216,93,135,22,113
"2011","Three Rivers 006B","E01023820","Total",537,192,4,188,149,43,133,12,121
"2011","Three Rivers 006C","E01023821","Total",493,135,3,132,171,63,114,24,90
"2011","Three Rivers 006D","E01023822","Total",528,160,2,158,194,76,114,17,97
"2011","Three Rivers 006E","E01023825","Total",898,174,14,160,315,115,176,41,135
"2011","Three Rivers 006F","E01023826","Total",547,157,7,150,202,75,128,26,102
"2011","Three Rivers 007A","E01023847","Total",783,168,26,142,280,129,137,19,118
"2011","Three Rivers 007B","E01023848","Total",624,167,29,138,247,108,140,35,105
"2011","Three Rivers 007C","E01023850","Total",775,226,8,218,122,73,183,7,176
"2011","Three Rivers 007D","E01023852","Total",591,186,9,177,188,69,129,13,116
"2011","Three Rivers 007E","E01023853","Total",744,214,5,209,267,87,123,23,100
"2011","Three Rivers 008A","E01023827","Total",860,268,53,215,341,149,196,46,150
"2011","Three Rivers 008B","E01023828","Total",612,224,39,185,229,98,173,36,137
"2011","Three Rivers 008C","E01023845","Total",695,171,39,132,260,88,150,30,120
"2011","Three Rivers 008D","E01023846","Total",569,134,10,124,187,58,114,23,91
"2011","Three Rivers 009A","E01023835","Total",534,162,14,148,167,59,130,11,119
"2011","Three Rivers 009B","E01023836","Total",629,188,22,166,181,71,169,27,142
"2011","Three Rivers 009C","E01023837","Total",649,142,22,120,212,110,134,31,103
"2011","Three Rivers 009D","E01023838","Total",502,150,29,121,192,83,131,24,107
"2011","Three Rivers 010A","E01023805","Total",638,187,39,148,253,90,194,53,141
"2011","Three Rivers 010B","E01023809","Total",761,301,18,283,167,65,227,26,201
"2011","Three Rivers 010C","E01023810","Total",731,259,12,247,176,51,197,30,167
"2011","Three Rivers 010D","E01023811","Total",624,202,7,195,142,52,152,19,133
"2011","Three Rivers 011A","E01023839","Total",764,191,4,187,269,66,151,26,125
"2011","Three Rivers 011B","E01023840","Total",560,127,7,120,171,59,92,17,75
"2011","Three Rivers 011C","E01023841","Total",541,106,8,98,165,46,100,17,83
"2011","Three Rivers 011D","E01023849","Total",600,219,8,211,144,48,129,17,112
"2011","Three Rivers 012A","E01023806","Total",861,232,31,201,319,134,237,54,183
"2011","Three Rivers 012B","E01023842","Total",618,201,45,156,237,89,180,35,145
"2011","Three Rivers 012C","E01023843","Total",829,252,42,210,292,140,217,43,174
"2011","Three Rivers 012D","E01023844","Total",777,320,67,253,260,143,234,42,192
"2011","Watford 001A","E01023904","Total",777,212,24,188,263,95,178,29,149
"2011","Watford 001B","E01023905","Total",842,234,30,204,270,103,204,54,150
"2011","Watford 001C","E01023906","Total",630,210,30,180,196,67,187,22,165
"2011","Watford 001D","E01023907","Total",753,186,11,175,201,90,136,24,112
"2011","Watford 002A","E01023890","Total",511,101,6,95,158,63,92,21,71
"2011","Watford 002B","E01023891","Total",513,145,43,102,232,79,126,39,87
"2011","Watford 002C","E01023892","Total",506,115,18,97,188,58,98,23,75
"2011","Watford 002D","E01023893","Total",728,231,14,217,207,70,171,36,135
"2011","Watford 002E","E01023894","Total",534,114,10,104,212,64,104,30,74
"2011","Watford 003A","E01023873","Total",539,158,32,126,189,90,150,30,120
"2011","Watford 003B","E01023874","Total",493,165,22,143,179,74,129,30,99
"2011","Watford 003C","E01023875","Total",813,253,8,245,207,72,193,22,171
"2011","Watford 003D","E01023876","Total",723,249,87,162,315,159,191,39,152
"2011","Watford 003E","E01023877","Total",661,209,29,180,217,75,199,36,163
"2011","Watford 004A","E01023868","Total",678,229,30,199,246,95,201,34,167
"2011","Watford 004B","E01023869","Total",481,111,26,85,177,76,109,24,85
"2011","Watford 004C","E01023870","Total",475,126,38,88,215,81,133,50,83
"2011","Watford 004D","E01023871","Total",507,85,12,73,149,65,92,20,72
"2011","Watford 004E","E01023872","Total",633,128,12,116,233,96,112,32,80
"2011","Watford 005A","E01023895","Total",753,94,8,86,179,99,106,20,86
"2011","Watford 005B","E01023896","Total",472,97,10,87,188,73,84,17,67
"2011","Watford 005C","E01023897","Total",673,273,11,262,177,65,215,24,191
"2011","Watford 005D","E01023898","Total",558,125,7,118,210,68,91,14,77
"2011","Watford 006A","E01023855","Total",808,138,29,109,229,132,128,30,98
"2011","Watford 006B","E01023856","Total",994,166,23,143,315,169,163,36,127
"2011","Watford 006C","E01023857","Total",578,154,39,115,230,96,155,48,107
"2011","Watford 006D","E01023858","Total",781,104,22,82,227,109,112,23,89
"2011","Watford 007A","E01023878","Total",764,247,12,235,226,73,184,27,157
"2011","Watford 007B","E01023879","Total",969,229,33,196,281,165,169,29,140
"2011","Watford 007C","E01023880","Total",855,236,14,222,179,88,168,18,150
"2011","Watford 007D","E01023881","Total",585,131,4,127,199,78,128,27,101
"2011","Watford 008A","E01023886","Total",1108,194,43,151,394,189,169,49,120
"2011","Watford 008B","E01023887","Total",621,215,10,205,202,57,146,28,118
"2011","Watford 008C","E01023888","Total",580,152,18,134,213,77,118,26,92
"2011","Watford 008D","E01023889","Total",629,203,7,196,250,89,133,24,109
"2011","Watford 009A","E01023859","Total",989,190,31,159,269,180,161,23,138
"2011","Watford 009B","E01023860","Total",889,233,43,190,215,119,215,39,176
"2011","Watford 009C","E01023861","Total",1117,238,20,218,194,123,200,19,181
"2011","Watford 009D","E01023862","Total",953,245,18,227,225,127,208,27,181
"2011","Watford 010A","E01023899","Total",532,97,14,83,206,115,108,34,74
"2011","Watford 010B","E01023900","Total",557,93,10,83,221,113,112,30,82
"2011","Watford 010C","E01023901","Total",720,117,26,91,289,184,88,20,68
"2011","Watford 010D","E01023902","Total",613,95,9,86,194,90,85,20,65
"2011","Watford 010E","E01023903","Total",549,113,16,97,240,113,111,30,81
"2011","Watford 011A","E01023863","Total",686,117,17,100,225,110,114,29,85
"2011","Watford 011B","E01023864","Total",649,152,26,126,191,102,136,24,112
"2011","Watford 011C","E01023865","Total",626,201,49,152,268,108,184,55,129
"2011","Watford 011D","E01023866","Total",618,206,62,144,266,138,158,36,122
"2011","Watford 011E","E01023867","Total",881,157,38,119,294,151,151,33,118
"2011","Watford 012A","E01023882","Total",649,168,8,160,192,73,133,22,111
"2011","Watford 012B","E01023883","Total",661,266,30,236,212,75,210,38,172
"2011","Watford 012C","E01023884","Total",789,172,18,154,243,110,133,22,111
"2011","Watford 012D","E01023885","Total",678,143,8,135,233,77,125,30,95
"2011","Welwyn Hatfield 001A","E01023965","Total",531,155,8,147,183,55,98,19,79
"2011","Welwyn Hatfield 001B","E01023966","Total",654,223,8,215,172,47,131,18,113
"2011","Welwyn Hatfield 001C","E01023967","Total",576,157,12,145,162,60,134,19,115
"2011","Welwyn Hatfield 001D","E01023971","Total",626,193,3,190,215,58,109,22,87
"2011","Welwyn Hatfield 002B","E01023968","Total",506,170,8,162,138,35,106,20,86
"2011","Welwyn Hatfield 002C","E01023969","Total",617,231,8,223,135,43,156,14,142
"2011","Welwyn Hatfield 002D","E01023970","Total",596,218,30,188,194,83,156,34,122
"2011","Welwyn Hatfield 002E","E01033310","Total",630,95,16,79,265,128,88,21,67
"2011","Welwyn Hatfield 002F","E01033313","Total",534,88,14,74,214,81,93,21,72
"2011","Welwyn Hatfield 003A","E01023959","Total",567,186,3,183,185,64,100,18,82
"2011","Welwyn Hatfield 003B","E01023960","Total",646,216,24,192,210,79,165,34,131
"2011","Welwyn Hatfield 003C","E01023961","Total",621,218,33,185,204,88,155,30,125
"2011","Welwyn Hatfield 003D","E01023962","Total",574,191,17,174,213,63,163,36,127
"2011","Welwyn Hatfield 004A","E01023912","Total",607,184,10,174,178,77,146,26,120
"2011","Welwyn Hatfield 004B","E01023913","Total",568,156,22,134,177,87,126,21,105
"2011","Welwyn Hatfield 004C","E01023914","Total",754,329,30,299,206,65,263,32,231
"2011","Welwyn Hatfield 004D","E01023915","Total",652,177,27,150,231,106,165,40,125
"2011","Welwyn Hatfield 005A","E01023950","Total",620,109,12,97,213,58,111,30,81
"2011","Welwyn Hatfield 005B","E01023951","Total",784,299,32,267,187,80,210,31,179
"2011","Welwyn Hatfield 005C","E01023952","Total",861,262,17,245,192,100,221,23,198
"2011","Welwyn Hatfield 005D","E01023953","Total",613,136,15,121,175,70,95,14,81
"2011","Welwyn Hatfield 006A","E01023916","Total",700,203,20,183,261,98,166,28,138
"2011","Welwyn Hatfield 006B","E01023917","Total",763,267,6,261,202,75,180,11,169
"2011","Welwyn Hatfield 006C","E01023918","Total",963,485,14,471,149,69,316,12,304
"2011","Welwyn Hatfield 006D","E01023919","Total",571,173,7,166,219,64,117,19,98
"2011","Welwyn Hatfield 007A","E01023954","Total",711,234,51,183,259,117,201,58,143
"2011","Welwyn Hatfield 007B","E01023955","Total",516,163,37,126,220,97,127,35,92
"2011","Welwyn Hatfield 007C","E01023956","Total",511,128,35,93,212,86,123,38,85
"2011","Welwyn Hatfield 007D","E01023957","Total",633,149,34,115,240,115,141,38,103
"2011","Welwyn Hatfield 007E","E01023958","Total",564,207,69,138,242,95,154,42,112
"2011","Welwyn Hatfield 008A","E01023943","Total",590,157,29,128,230,88,148,45,103
"2011","Welwyn Hatfield 008B","E01023944","Total",839,243,38,205,309,142,208,36,172
"2011","Welwyn Hatfield 008C","E01023945","Total",638,194,21,173,223,97,171,39,132
"2011","Welwyn Hatfield 008D","E01023946","Total",665,151,13,138,207,85,126,30,96
"2011","Welwyn Hatfield 009A","E01023939","Total",526,217,15,202,138,61,168,20,148
"2011","Welwyn Hatfield 009B","E01023940","Total",718,245,27,218,244,107,184,36,148
"2011","Welwyn Hatfield 009C","E01023941","Total",1168,236,47,189,425,234,195,56,139
"2011","Welwyn Hatfield 009D","E01023942","Total",606,160,25,135,256,103,129,39,90
"2011","Welwyn Hatfield 010A","E01023929","Total",642,201,25,176,186,86,182,35,147
"2011","Welwyn Hatfield 010B","E01023930","Total",678,223,29,194,218,106,196,30,166
"2011","Welwyn Hatfield 010D","E01023938","Total",603,167,6,161,160,65,129,26,103
"2011","Welwyn Hatfield 010E","E01033308","Total",649,234,29,205,121,79,68,11,57
"2011","Welwyn Hatfield 010F","E01033311","Total",614,165,13,152,193,86,135,16,119
"2011","Welwyn Hatfield 010G","E01033314","Total",645,146,30,116,236,135,84,23,61
"2011","Welwyn Hatfield 011A","E01023924","Total",639,218,26,192,136,67,175,22,153
"2011","Welwyn Hatfield 011B","E01023925","Total",549,145,12,133,123,44,107,16,91
"2011","Welwyn Hatfield 011C","E01023926","Total",740,213,6,207,174,78,160,18,142
"2011","Welwyn Hatfield 011D","E01023927","Total",685,193,48,145,262,128,158,36,122
"2011","Welwyn Hatfield 012A","E01023920","Total",762,265,43,222,190,75,203,38,165
"2011","Welwyn Hatfield 012B","E01023921","Total",881,275,46,229,212,133,199,28,171
"2011","Welwyn Hatfield 012C","E01023922","Total",635,214,47,167,219,109,144,29,115
"2011","Welwyn Hatfield 012D","E01023923","Total",687,239,23,216,160,63,146,23,123
"2011","Welwyn Hatfield 013A","E01023932","Total",587,175,37,138,159,56,114,29,85
"2011","Welwyn Hatfield 013B","E01023934","Total",485,124,23,101,134,65,92,20,72
"2011","Welwyn Hatfield 013C","E01023935","Total",449,148,10,138,109,46,111,22,89
"2011","Welwyn Hatfield 013D","E01023936","Total",783,255,43,212,233,99,168,39,129
"2011","Welwyn Hatfield 013E","E01023937","Total",491,204,18,186,87,30,127,12,115
"2011","Welwyn Hatfield 014A","E01023933","Total",635,226,31,195,150,70,162,18,144
"2011","Welwyn Hatfield 014B","E01023963","Total",1021,360,32,328,235,78,292,37,255
"2011","Welwyn Hatfield 014C","E01023964","Total",617,203,4,199,148,47,147,19,128
"2011","Welwyn Hatfield 015A","E01023908","Total",599,190,9,181,188,49,122,21,101
"2011","Welwyn Hatfield 015B","E01023909","Total",418,116,11,105,152,37,65,14,51
"2011","Welwyn Hatfield 015C","E01023910","Total",520,142,7,135,154,36,101,14,87
"2011","Welwyn Hatfield 015D","E01023911","Total",687,249,11,238,189,67,183,24,159
"2011","Welwyn Hatfield 016A","E01023947","Total",702,233,17,216,187,56,168,21,147
"2011","Welwyn Hatfield 016B","E01023948","Total",644,239,8,231,163,51,160,15,145
"2011","Welwyn Hatfield 016C","E01023949","Total",747,265,6,259,223,54,136,16,120
"2011","Breckland 001A","E01026436","Total",968,326,19,307,233,96,267,35,232
"2011","Breckland 001C","E01026461","Total",573,219,5,214,117,35,157,13,144
"2011","Breckland 001E","E01026483","Total",491,173,7,166,114,35,128,13,115
"2011","Breckland 001F","E01033042","Total",864,261,20,241,263,110,187,28,159
"2011","Breckland 002A","E01026442","Total",922,357,18,339,223,84,279,42,237
"2011","Breckland 002B","E01026443","Total",834,282,27,255,242,77,232,42,190
"2011","Breckland 002C","E01026445","Total",1001,432,24,408,217,76,294,30,264
"2011","Breckland 002D","E01026462","Total",937,337,21,316,219,64,244,29,215
"2011","Breckland 003A","E01026428","Total",1070,367,54,313,392,137,278,76,202
"2011","Breckland 003B","E01026429","Total",701,282,16,266,166,65,223,20,203
"2011","Breckland 003C","E01026430","Total",692,283,19,264,196,74,186,35,151
"2011","Breckland 003D","E01026431","Total",492,233,9,224,115,39,159,21,138
"2011","Breckland 004A","E01026446","Total",877,456,13,443,168,54,272,31,241
"2011","Breckland 004B","E01026452","Total",711,276,15,261,178,56,194,22,172
"2011","Breckland 004C","E01026453","Total",628,200,14,186,156,51,182,34,148
"2011","Breckland 004D","E01026454","Total",627,102,9,93,248,92,119,31,88
"2011","Breckland 005A","E01026425","Total",851,396,55,341,240,86,266,53,213
"2011","Breckland 005B","E01026426","Total",1179,460,62,398,304,111,346,48,298
"2011","Breckland 005C","E01026427","Total",939,365,27,338,241,105,254,35,219
"2011","Breckland 005D","E01026432","Total",633,252,8,244,160,58,155,25,130
"2011","Breckland 005E","E01026433","Total",613,137,29,108,213,119,121,33,88
"2011","Breckland 005F","E01026434","Total",915,325,18,307,212,79,245,31,214
"2011","Breckland 006A","E01026479","Total",640,226,16,210,153,53,187,26,161
"2011","Breckland 006B","E01026480","Total",658,255,12,243,144,52,155,17,138
"2011","Breckland 006C","E01026481","Total",481,127,15,112,138,60,113,28,85
"2011","Breckland 006D","E01026484","Total",583,185,9,176,151,57,153,23,130
"2011","Breckland 006E","E01026485","Total",452,136,5,131,115,35,103,21,82
"2011","Breckland 007A","E01026455","Total",825,378,39,339,209,87,280,42,238
"2011","Breckland 007B","E01026456","Total",493,212,7,205,103,38,132,13,119
"2011","Breckland 007C","E01026457","Total",605,343,5,338,74,25,188,11,177
"2011","Breckland 007D","E01026458","Total",673,308,42,266,186,83,190,30,160
"2011","Breckland 007E","E01026459","Total",662,349,38,311,132,59,226,21,205
"2011","Breckland 008A","E01026437","Total",540,250,11,239,107,37,160,21,139
"2011","Breckland 008B","E01026438","Total",432,152,11,141,106,32,113,20,93
"2011","Breckland 008C","E01026451","Total",891,358,26,332,218,73,261,45,216
"2011","Breckland 008D","E01026495","Total",572,250,20,230,127,54,168,26,142
"2011","Breckland 008E","E01026496","Total",496,233,3,230,87,36,141,12,129
"2011","Breckland 009A","E01026486","Total",705,347,21,326,145,55,224,21,203
"2011","Breckland 009B","E01026487","Total",618,159,25,134,233,105,132,39,93
"2011","Breckland 009C","E01026488","Total",548,242,21,221,106,48,195,21,174
"2011","Breckland 009D","E01026489","Total",625,325,9,316,110,40,194,16,178
"2011","Breckland 009E","E01026490","Total",730,356,9,347,146,46,210,22,188
"2011","Breckland 010A","E01026419","Total",481,147,8,139,128,46,125,19,106
"2011","Breckland 010B","E01026420","Total",470,160,13,147,123,35,120,24,96
"2011","Breckland 010D","E01026464","Total",499,152,15,137,144,45,114,28,86
"2011","Breckland 010E","E01026491","Total",907,244,5,239,209,74,200,24,176
"2011","Breckland 010F","E01033040","Total",398,89,52,37,207,129,72,35,37
"2011","Breckland 010G","E01033041","Total",400,81,24,57,143,57,96,30,66
"2011","Breckland 011A","E01026422","Total",911,385,8,377,172,59,247,20,227
"2011","Breckland 011B","E01026423","Total",751,207,27,180,239,94,166,26,140
"2011","Breckland 011C","E01026447","Total",716,302,39,263,195,65,251,38,213
"2011","Breckland 011D","E01026449","Total",793,216,16,200,235,92,167,25,142
"2011","Breckland 011E","E01026450","Total",722,232,18,214,225,77,186,37,149
"2011","Breckland 012A","E01026424","Total",884,306,11,295,219,84,241,24,217
"2011","Breckland 012B","E01026444","Total",894,311,25,286,208,73,250,41,209
"2011","Breckland 012C","E01026492","Total",563,189,15,174,146,66,147,20,127
"2011","Breckland 012D","E01026493","Total",499,179,10,169,112,35,124,17,107
"2011","Breckland 013A","E01026421","Total",738,255,9,246,190,64,198,31,167
"2011","Breckland 013B","E01026435","Total",866,211,14,197,263,85,207,41,166
"2011","Breckland 013C","E01026448","Total",867,211,15,196,323,114,162,38,124
"2011","Breckland 014A","E01026439","Total",692,258,10,248,154,53,158,16,142
"2011","Breckland 014B","E01026440","Total",463,107,12,95,152,49,90,21,69
"2011","Breckland 014C","E01026441","Total",651,260,22,238,165,56,191,32,159
"2011","Breckland 014D","E01026494","Total",936,283,13,270,238,65,228,34,194
"2011","Breckland 015A","E01026465","Total",771,299,47,252,225,105,215,35,180
"2011","Breckland 015B","E01026466","Total",719,195,31,164,277,125,206,48,158
"2011","Breckland 015C","E01026467","Total",765,273,126,147,394,188,214,91,123
"2011","Breckland 016A","E01026468","Total",1042,352,18,334,222,97,259,25,234
"2011","Breckland 016B","E01026469","Total",665,207,9,198,193,81,161,28,133
"2011","Breckland 016C","E01026470","Total",1062,166,20,146,404,198,158,45,113
"2011","Breckland 016D","E01026471","Total",507,107,9,98,157,78,91,14,77
"2011","Breckland 016E","E01026472","Total",489,107,4,103,139,58,110,18,92
"2011","Breckland 016F","E01026473","Total",564,107,13,94,223,87,119,31,88
"2011","Breckland 017A","E01026474","Total",673,229,43,186,227,105,191,43,148
"2011","Breckland 017B","E01026475","Total",628,217,22,195,177,77,165,28,137
"2011","Breckland 017C","E01026476","Total",566,181,47,134,214,83,157,44,113
"2011","Breckland 017D","E01026477","Total",579,211,57,154,222,87,187,62,125
"2011","Breckland 017E","E01026478","Total",641,242,61,181,247,115,220,64,156
"2011","Broadland 001A","E01026499","Total",764,381,31,350,142,52,275,22,253
"2011","Broadland 001B","E01026500","Total",736,278,6,272,194,59,180,19,161
"2011","Broadland 001C","E01026501","Total",680,263,17,246,138,42,169,19,150
"2011","Broadland 001D","E01026502","Total",518,176,6,170,114,39,120,15,105
"2011","Broadland 001E","E01026503","Total",649,266,6,260,130,43,162,15,147
"2011","Broadland 002A","E01026522","Total",595,190,12,178,184,55,144,27,117
"2011","Broadland 002B","E01026523","Total",769,221,34,187,235,71,187,23,164
"2011","Broadland 002C","E01026524","Total",616,181,11,170,144,63,152,20,132
"2011","Broadland 002D","E01026525","Total",451,117,8,109,101,32,112,17,95
"2011","Broadland 002E","E01026547","Total",636,220,11,209,171,59,184,34,150
"2011","Broadland 002F","E01026548","Total",533,175,17,158,174,68,122,22,100
"2011","Broadland 003A","E01026514","Total",630,185,13,172,182,56,139,26,113
"2011","Broadland 003B","E01026515","Total",451,142,5,137,114,45,117,14,103
"2011","Broadland 003C","E01026516","Total",563,219,14,205,131,51,179,26,153
"2011","Broadland 003D","E01026517","Total",602,195,10,185,151,55,142,19,123
"2011","Broadland 004A","E01026533","Total",521,193,8,185,113,28,128,19,109
"2011","Broadland 004B","E01026534","Total",628,154,18,136,211,83,158,37,121
"2011","Broadland 004C","E01026535","Total",663,180,14,166,200,75,180,19,161
"2011","Broadland 004D","E01026536","Total",653,192,14,178,219,72,172,38,134
"2011","Broadland 004E","E01026537","Total",573,74,13,61,234,79,94,39,55
"2011","Broadland 005A","E01026549","Total",797,301,17,284,176,65,225,26,199
"2011","Broadland 005B","E01026550","Total",437,107,6,101,150,43,94,23,71
"2011","Broadland 005C","E01026551","Total",496,158,6,152,127,38,112,14,98
"2011","Broadland 005D","E01026552","Total",606,218,2,216,125,41,142,13,129
"2011","Broadland 006A","E01026562","Total",453,113,7,106,179,50,90,25,65
"2011","Broadland 006B","E01026563","Total",556,84,19,65,224,76,96,23,73
"2011","Broadland 006C","E01026564","Total",564,133,16,117,229,72,100,30,70
"2011","Broadland 006D","E01026565","Total",511,75,18,57,180,77,81,25,56
"2011","Broadland 006E","E01026566","Total",634,192,10,182,179,58,135,24,111
"2011","Broadland 006F","E01026567","Total",758,366,7,359,132,34,203,21,182
"2011","Broadland 006G","E01026568","Total",625,170,6,164,204,49,148,27,121
"2011","Broadland 007A","E01026518","Total",535,100,15,85,244,86,92,29,63
"2011","Broadland 007B","E01026519","Total",735,149,11,138,250,92,148,32,116
"2011","Broadland 007C","E01026520","Total",503,234,8,226,95,27,145,12,133
"2011","Broadland 007D","E01026521","Total",505,201,5,196,118,38,120,13,107
"2011","Broadland 008A","E01026545","Total",644,164,12,152,234,111,123,31,92
"2011","Broadland 008B","E01026546","Total",584,157,2,155,175,45,133,20,113
"2011","Broadland 008C","E01026578","Total",762,190,23,167,279,112,168,36,132
"2011","Broadland 008D","E01026579","Total",638,210,11,199,146,33,148,27,121
"2011","Broadland 008E","E01026580","Total",708,348,13,335,135,36,198,22,176
"2011","Broadland 009A","E01026540","Total",644,250,2,248,129,40,175,10,165
"2011","Broadland 009B","E01026541","Total",1027,330,43,287,340,152,283,50,233
"2011","Broadland 009C","E01026542","Total",651,246,11,235,152,58,153,18,135
"2011","Broadland 009D","E01026543","Total",634,227,5,222,149,40,162,20,142
"2011","Broadland 009E","E01026544","Total",722,168,16,152,194,78,128,26,102
"2011","Broadland 010A","E01026526","Total",649,287,5,282,128,41,200,21,179
"2011","Broadland 010B","E01026527","Total",664,308,5,303,114,28,188,12,176
"2011","Broadland 010C","E01026528","Total",602,269,13,256,122,34,186,21,165
"2011","Broadland 010D","E01026529","Total",722,276,10,266,145,41,235,26,209
"2011","Broadland 011A","E01026530","Total",747,280,12,268,168,51,214,20,194
"2011","Broadland 011B","E01026531","Total",748,292,3,289,163,57,206,20,186
"2011","Broadland 011C","E01026532","Total",738,248,9,239,181,59,205,22,183
"2011","Broadland 012A","E01026553","Total",611,210,11,199,158,71,186,27,159
"2011","Broadland 012B","E01026554","Total",504,145,7,138,131,39,115,19,96
"2011","Broadland 012C","E01026555","Total",610,230,18,212,168,46,170,20,150
"2011","Broadland 012D","E01026556","Total",639,191,17,174,162,73,152,25,127
"2011","Broadland 013A","E01026557","Total",637,252,0,252,114,41,180,12,168
"2011","Broadland 013B","E01026558","Total",614,252,5,247,104,37,166,16,150
"2011","Broadland 013C","E01026559","Total",626,226,9,217,150,46,178,18,160
"2011","Broadland 013D","E01026560","Total",633,292,0,292,123,48,177,17,160
"2011","Broadland 013E","E01026561","Total",650,284,3,281,99,36,168,11,157
"2011","Broadland 014A","E01026504","Total",627,201,9,192,167,60,138,17,121
"2011","Broadland 014B","E01026505","Total",605,246,16,230,153,48,206,26,180
"2011","Broadland 014C","E01026506","Total",590,236,8,228,139,44,156,18,138
"2011","Broadland 014D","E01026507","Total",568,186,4,182,158,60,143,18,125
"2011","Broadland 014E","E01026512","Total",553,188,13,175,146,41,144,15,129
"2011","Broadland 014F","E01026513","Total",578,199,15,184,169,56,151,25,126
"2011","Broadland 015A","E01026569","Total",719,352,9,343,140,55,247,13,234
"2011","Broadland 015B","E01026570","Total",727,308,6,302,168,52,222,22,200
"2011","Broadland 015C","E01026571","Total",655,237,5,232,163,54,160,11,149
"2011","Broadland 015D","E01026572","Total",638,226,4,222,160,53,149,13,136
"2011","Broadland 015E","E01026573","Total",623,268,13,255,154,44,222,26,196
"2011","Broadland 016A","E01026574","Total",683,129,15,114,270,99,129,36,93
"2011","Broadland 016B","E01026575","Total",732,264,23,241,194,75,191,33,158
"2011","Broadland 016C","E01026576","Total",808,114,22,92,352,148,111,34,77
"2011","Broadland 016D","E01026577","Total",775,228,18,210,188,74,138,15,123
"2011","Broadland 017A","E01026508","Total",641,239,19,220,160,52,170,23,147
"2011","Broadland 017B","E01026509","Total",684,222,4,218,155,47,162,24,138
"2011","Broadland 017C","E01026510","Total",700,260,9,251,149,41,167,17,150
"2011","Broadland 017D","E01026511","Total",467,135,14,121,126,36,127,24,103
"2011","Broadland 018A","E01026497","Total",679,257,13,244,154,58,172,19,153
"2011","Broadland 018B","E01026498","Total",606,284,18,266,138,44,192,25,167
"2011","Broadland 018C","E01026538","Total",648,253,21,232,169,69,184,28,156
"2011","Broadland 018D","E01026539","Total",676,197,24,173,195,73,182,28,154
"2011","Great Yarmouth 001A","E01026605","Total",699,297,15,282,141,48,195,21,174
"2011","Great Yarmouth 001B","E01026606","Total",708,327,19,308,135,29,236,32,204
"2011","Great Yarmouth 001C","E01026607","Total",710,298,21,277,180,48,246,40,206
"2011","Great Yarmouth 001D","E01026627","Total",617,271,8,263,131,32,177,24,153
"2011","Great Yarmouth 001E","E01026628","Total",595,225,12,213,135,37,169,29,140
"2011","Great Yarmouth 001F","E01026629","Total",630,232,13,219,181,60,189,40,149
"2011","Great Yarmouth 002A","E01026608","Total",522,188,17,171,132,42,146,23,123
"2011","Great Yarmouth 002B","E01026609","Total",496,130,11,119,125,41,114,21,93
"2011","Great Yarmouth 002C","E01026636","Total",674,268,12,256,140,37,190,26,164
"2011","Great Yarmouth 002D","E01026637","Total",822,327,15,312,182,58,220,33,187
"2011","Great Yarmouth 002E","E01026638","Total",639,245,28,217,208,65,199,42,157
"2011","Great Yarmouth 003A","E01026589","Total",614,234,17,217,176,70,171,26,145
"2011","Great Yarmouth 003B","E01026590","Total",670,289,12,277,121,43,173,11,162
"2011","Great Yarmouth 003C","E01026591","Total",803,373,18,355,166,50,261,34,227
"2011","Great Yarmouth 003D","E01026592","Total",700,387,29,358,104,27,255,29,226
"2011","Great Yarmouth 003E","E01026593","Total",590,269,9,260,121,39,171,21,150
"2011","Great Yarmouth 003F","E01026594","Total",761,322,30,292,220,89,225,41,184
"2011","Great Yarmouth 004A","E01026599","Total",574,207,33,174,177,69,163,31,132
"2011","Great Yarmouth 004B","E01026639","Total",598,208,25,183,170,55,143,24,119
"2011","Great Yarmouth 004C","E01026640","Total",756,422,24,398,139,48,308,28,280
"2011","Great Yarmouth 004D","E01026641","Total",625,313,71,242,222,61,231,53,178
"2011","Great Yarmouth 005A","E01026595","Total",789,341,67,274,223,108,243,41,202
"2011","Great Yarmouth 005B","E01026596","Total",683,251,27,224,211,92,203,35,168
"2011","Great Yarmouth 005C","E01026597","Total",888,436,91,345,267,126,325,68,257
"2011","Great Yarmouth 005D","E01026598","Total",707,262,59,203,186,91,182,31,151
"2011","Great Yarmouth 006A","E01026622","Total",632,325,119,206,267,115,228,80,148
"2011","Great Yarmouth 006B","E01026623","Total",663,268,45,223,161,69,184,23,161
"2011","Great Yarmouth 006C","E01026624","Total",829,389,80,309,221,114,275,53,222
"2011","Great Yarmouth 006D","E01026625","Total",773,440,134,306,286,152,283,59,224
"2011","Great Yarmouth 006E","E01026626","Total",866,387,85,302,239,122,249,49,200
"2011","Great Yarmouth 007A","E01026600","Total",628,253,54,199,200,81,182,39,143
"2011","Great Yarmouth 007B","E01026633","Total",729,240,64,176,281,136,187,55,132
"2011","Great Yarmouth 007C","E01026634","Total",612,210,64,146,230,111,174,49,125
"2011","Great Yarmouth 007D","E01026635","Total",958,340,96,244,360,179,258,74,184
"2011","Great Yarmouth 008A","E01026581","Total",656,156,10,146,240,73,139,35,104
"2011","Great Yarmouth 008B","E01026582","Total",842,290,13,277,227,87,204,30,174
"2011","Great Yarmouth 008C","E01026583","Total",565,205,11,194,144,51,167,24,143
"2011","Great Yarmouth 008D","E01026584","Total",669,320,10,310,140,42,226,27,199
"2011","Great Yarmouth 009A","E01026601","Total",664,215,52,163,217,93,161,35,126
"2011","Great Yarmouth 009B","E01026602","Total",702,328,26,302,145,43,229,18,211
"2011","Great Yarmouth 009C","E01026603","Total",742,356,108,248,287,110,284,72,212
"2011","Great Yarmouth 009D","E01026604","Total",726,352,80,272,218,84,277,45,232
"2011","Great Yarmouth 009E","E01026632","Total",786,317,35,282,197,93,237,47,190
"2011","Great Yarmouth 010A","E01026610","Total",666,179,29,150,224,88,140,31,109
"2011","Great Yarmouth 010B","E01026611","Total",648,287,10,277,116,30,192,15,177
"2011","Great Yarmouth 010C","E01026612","Total",1065,448,29,419,298,117,313,39,274
"2011","Great Yarmouth 010D","E01026630","Total",670,226,55,171,258,98,176,52,124
"2011","Great Yarmouth 010E","E01026631","Total",777,265,57,208,244,110,203,40,163
"2011","Great Yarmouth 011A","E01026617","Total",581,276,23,253,137,50,206,35,171
"2011","Great Yarmouth 011B","E01026618","Total",685,266,30,236,186,78,198,31,167
"2011","Great Yarmouth 011C","E01026619","Total",596,287,71,216,230,99,212,64,148
"2011","Great Yarmouth 011D","E01026620","Total",641,369,54,315,168,73,280,45,235
"2011","Great Yarmouth 011E","E01026621","Total",553,231,49,182,187,53,174,47,127
"2011","Great Yarmouth 012A","E01026613","Total",561,178,7,171,125,44,134,22,112
"2011","Great Yarmouth 012B","E01026614","Total",713,265,12,253,133,39,212,18,194
"2011","Great Yarmouth 012C","E01026615","Total",558,182,6,176,135,46,145,20,125
"2011","Great Yarmouth 012D","E01026616","Total",491,107,13,94,171,65,125,33,92
"2011","Great Yarmouth 013A","E01026585","Total",589,255,11,244,131,40,176,14,162
"2011","Great Yarmouth 013B","E01026586","Total",499,255,19,236,113,32,199,25,174
"2011","Great Yarmouth 013C","E01026587","Total",729,232,16,216,219,86,178,30,148
"2011","Great Yarmouth 013D","E01026588","Total",1145,420,23,397,292,100,314,46,268
"2011","King's Lynn and West Norfolk 001A","E01026680","Total",769,530,18,512,84,27,313,20,293
"2011","King's Lynn and West Norfolk 001B","E01026681","Total",686,372,13,359,103,37,197,15,182
"2011","King's Lynn and West Norfolk 001C","E01026682","Total",552,296,7,289,89,30,179,13,166
"2011","King's Lynn and West Norfolk 001D","E01026683","Total",654,294,22,272,106,38,181,14,167
"2011","King's Lynn and West Norfolk 002A","E01026645","Total",665,295,5,290,65,24,183,10,173
"2011","King's Lynn and West Norfolk 002B","E01026646","Total",844,415,25,390,141,55,251,32,219
"2011","King's Lynn and West Norfolk 002C","E01026656","Total",837,329,27,302,180,73,228,37,191
"2011","King's Lynn and West Norfolk 002D","E01026695","Total",984,382,15,367,188,69,274,30,244
"2011","King's Lynn and West Norfolk 003A","E01026676","Total",818,435,12,423,118,36,256,20,236
"2011","King's Lynn and West Norfolk 003B","E01026677","Total",727,383,21,362,152,45,268,32,236
"2011","King's Lynn and West Norfolk 003C","E01026678","Total",755,419,11,408,112,39,234,16,218
"2011","King's Lynn and West Norfolk 003D","E01026701","Total",779,428,8,420,113,29,266,21,245
"2011","King's Lynn and West Norfolk 003E","E01026702","Total",617,282,10,272,112,58,194,19,175
"2011","King's Lynn and West Norfolk 003F","E01026703","Total",532,213,13,200,117,39,152,22,130
"2011","King's Lynn and West Norfolk 004A","E01026653","Total",840,434,10,424,140,41,252,16,236
"2011","King's Lynn and West Norfolk 004B","E01026654","Total",741,364,25,339,164,45,225,34,191
"2011","King's Lynn and West Norfolk 004C","E01026655","Total",659,322,10,312,116,36,191,20,171
"2011","King's Lynn and West Norfolk 004D","E01026718","Total",1008,375,16,359,200,66,292,33,259
"2011","King's Lynn and West Norfolk 005A","E01026691","Total",457,151,12,139,144,46,109,23,86
"2011","King's Lynn and West Norfolk 005B","E01026692","Total",519,125,6,119,174,64,94,22,72
"2011","King's Lynn and West Norfolk 005C","E01026708","Total",551,211,9,202,148,39,127,17,110
"2011","King's Lynn and West Norfolk 005D","E01026709","Total",765,270,13,257,234,94,157,23,134
"2011","King's Lynn and West Norfolk 005E","E01026710","Total",485,180,4,176,117,29,111,14,97
"2011","King's Lynn and West Norfolk 006A","E01026669","Total",746,305,7,298,149,56,204,15,189
"2011","King's Lynn and West Norfolk 006B","E01026670","Total",586,158,35,123,225,91,119,34,85
"2011","King's Lynn and West Norfolk 006C","E01026671","Total",532,148,9,139,172,50,107,19,88
"2011","King's Lynn and West Norfolk 006D","E01026672","Total",625,210,7,203,162,50,171,31,140
"2011","King's Lynn and West Norfolk 006E","E01026673","Total",633,145,10,135,203,80,111,31,80
"2011","King's Lynn and West Norfolk 007A","E01026687","Total",661,327,60,267,235,103,266,47,219
"2011","King's Lynn and West Norfolk 007B","E01026688","Total",526,201,78,123,250,123,154,41,113
"2011","King's Lynn and West Norfolk 007C","E01026689","Total",640,182,31,151,172,80,163,32,131
"2011","King's Lynn and West Norfolk 007D","E01026690","Total",586,255,66,189,232,114,208,55,153
"2011","King's Lynn and West Norfolk 008A","E01026647","Total",925,381,18,363,209,69,281,39,242
"2011","King's Lynn and West Norfolk 008B","E01026711","Total",602,221,44,177,207,68,180,46,134
"2011","King's Lynn and West Norfolk 008C","E01026712","Total",690,236,9,227,179,51,195,28,167
"2011","King's Lynn and West Norfolk 008D","E01026713","Total",629,201,6,195,136,44,153,22,131
"2011","King's Lynn and West Norfolk 009A","E01026666","Total",726,294,62,232,259,94,251,73,178
"2011","King's Lynn and West Norfolk 009B","E01026667","Total",673,188,9,179,176,66,151,27,124
"2011","King's Lynn and West Norfolk 009C","E01026668","Total",634,184,16,168,186,66,158,31,127
"2011","King's Lynn and West Norfolk 009D","E01026693","Total",814,287,14,273,222,70,223,31,192
"2011","King's Lynn and West Norfolk 010A","E01026662","Total",923,289,116,173,414,217,223,74,149
"2011","King's Lynn and West Norfolk 010B","E01026663","Total",714,283,45,238,268,113,223,40,183
"2011","King's Lynn and West Norfolk 010C","E01026664","Total",949,205,27,178,300,157,169,27,142
"2011","King's Lynn and West Norfolk 010D","E01026714","Total",793,219,12,207,241,88,176,34,142
"2011","King's Lynn and West Norfolk 011A","E01026698","Total",1024,440,24,416,140,68,318,17,301
"2011","King's Lynn and West Norfolk 011B","E01026699","Total",848,372,23,349,146,80,306,21,285
"2011","King's Lynn and West Norfolk 011C","E01026700","Total",689,235,27,208,136,64,201,26,175
"2011","King's Lynn and West Norfolk 011D","E01026704","Total",686,251,77,174,251,118,191,55,136
"2011","King's Lynn and West Norfolk 011E","E01026705","Total",638,211,24,187,201,103,173,40,133
"2011","King's Lynn and West Norfolk 011F","E01026706","Total",633,176,18,158,196,76,162,42,120
"2011","King's Lynn and West Norfolk 012A","E01026665","Total",984,375,23,352,243,90,279,39,240
"2011","King's Lynn and West Norfolk 012B","E01026674","Total",482,191,8,183,98,19,124,19,105
"2011","King's Lynn and West Norfolk 012C","E01026675","Total",508,168,7,161,148,47,124,20,104
"2011","King's Lynn and West Norfolk 012D","E01026694","Total",1078,416,24,392,240,81,289,34,255
"2011","King's Lynn and West Norfolk 013A","E01026684","Total",461,153,10,143,121,33,139,23,116
"2011","King's Lynn and West Norfolk 013B","E01026685","Total",554,236,9,227,123,34,152,12,140
"2011","King's Lynn and West Norfolk 013C","E01026719","Total",907,297,25,272,250,89,269,49,220
"2011","King's Lynn and West Norfolk 013D","E01026720","Total",526,181,8,173,138,43,146,29,117
"2011","King's Lynn and West Norfolk 013E","E01026721","Total",513,199,21,178,157,49,169,36,133
"2011","King's Lynn and West Norfolk 014A","E01026642","Total",561,246,5,241,131,46,173,26,147
"2011","King's Lynn and West Norfolk 014B","E01026643","Total",596,203,10,193,132,37,155,21,134
"2011","King's Lynn and West Norfolk 014C","E01026644","Total",644,27,8,19,397,266,70,40,30
"2011","King's Lynn and West Norfolk 014D","E01026723","Total",661,247,9,238,168,51,146,19,127
"2011","King's Lynn and West Norfolk 014E","E01026724","Total",724,311,17,294,160,71,193,21,172
"2011","King's Lynn and West Norfolk 014F","E01026725","Total",615,220,19,201,144,51,191,21,170
"2011","King's Lynn and West Norfolk 015A","E01026696","Total",449,150,23,127,150,57,140,35,105
"2011","King's Lynn and West Norfolk 015B","E01026697","Total",550,200,13,187,129,42,170,29,141
"2011","King's Lynn and West Norfolk 015C","E01026722","Total",1021,314,27,287,308,123,253,44,209
"2011","King's Lynn and West Norfolk 015D","E01026726","Total",858,311,22,289,225,78,242,34,208
"2011","King's Lynn and West Norfolk 016A","E01026659","Total",675,244,19,225,188,82,198,26,172
"2011","King's Lynn and West Norfolk 016B","E01026660","Total",697,294,14,280,183,71,185,24,161
"2011","King's Lynn and West Norfolk 016C","E01026661","Total",606,221,14,207,161,55,183,34,149
"2011","King's Lynn and West Norfolk 016D","E01026715","Total",595,193,20,173,145,56,161,21,140
"2011","King's Lynn and West Norfolk 016E","E01026716","Total",793,340,40,300,200,71,270,29,241
"2011","King's Lynn and West Norfolk 016F","E01026717","Total",603,189,22,167,177,62,162,42,120
"2011","King's Lynn and West Norfolk 017C","E01026686","Total",1014,521,17,504,178,76,309,29,280
"2011","King's Lynn and West Norfolk 017D","E01026707","Total",1148,793,2,791,73,30,416,7,409
"2011","King's Lynn and West Norfolk 017E","E01033036","Total",621,199,28,171,234,96,137,40,97
"2011","King's Lynn and West Norfolk 017F","E01033037","Total",608,168,42,126,237,93,123,47,76
"2011","King's Lynn and West Norfolk 017G","E01033038","Total",779,310,48,262,202,93,211,28,183
"2011","King's Lynn and West Norfolk 017H","E01033039","Total",467,203,7,196,89,33,159,17,142
"2011","King's Lynn and West Norfolk 018A","E01026679","Total",996,346,25,321,241,88,277,34,243
"2011","King's Lynn and West Norfolk 018B","E01026727","Total",1096,380,17,363,241,92,278,29,249
"2011","King's Lynn and West Norfolk 018C","E01026728","Total",967,343,21,322,230,72,276,51,225
"2011","King's Lynn and West Norfolk 019A","E01026648","Total",655,219,20,199,176,65,183,31,152
"2011","King's Lynn and West Norfolk 019B","E01026649","Total",661,206,16,190,183,76,174,27,147
"2011","King's Lynn and West Norfolk 019C","E01026650","Total",439,78,12,66,183,96,72,20,52
"2011","King's Lynn and West Norfolk 019D","E01026651","Total",971,325,28,297,257,89,268,35,233
"2011","King's Lynn and West Norfolk 019E","E01026652","Total",525,192,19,173,154,64,153,28,125
"2011","North Norfolk 001A","E01026770","Total",1003,510,14,496,134,50,357,21,336
"2011","North Norfolk 001B","E01026771","Total",748,366,22,344,149,51,265,16,249
"2011","North Norfolk 001C","E01026772","Total",786,445,12,433,159,46,206,20,186
"2011","North Norfolk 001D","E01026773","Total",950,498,24,474,186,66,291,36,255
"2011","North Norfolk 002A","E01026739","Total",964,442,10,432,166,53,253,24,229
"2011","North Norfolk 002B","E01026763","Total",628,280,29,251,158,62,183,31,152
"2011","North Norfolk 002C","E01026764","Total",648,317,7,310,68,18,179,10,169
"2011","North Norfolk 002D","E01026765","Total",618,269,13,256,112,39,181,22,159
"2011","North Norfolk 003A","E01026734","Total",619,244,15,229,82,43,183,15,168
"2011","North Norfolk 003B","E01026735","Total",675,355,13,342,79,41,221,7,214
"2011","North Norfolk 003C","E01026736","Total",603,328,19,309,118,51,213,23,190
"2011","North Norfolk 003D","E01026777","Total",532,271,11,260,83,37,163,19,144
"2011","North Norfolk 003E","E01026778","Total",726,453,14,439,79,29,259,21,238
"2011","North Norfolk 003F","E01026779","Total",568,208,32,176,202,83,167,43,124
"2011","North Norfolk 004A","E01026741","Total",927,479,19,460,131,35,268,12,256
"2011","North Norfolk 004B","E01026742","Total",693,462,10,452,75,27,211,6,205
"2011","North Norfolk 004C","E01026743","Total",1114,580,42,538,205,94,410,54,356
"2011","North Norfolk 005A","E01026762","Total",1054,482,24,458,189,61,308,38,270
"2011","North Norfolk 005B","E01026766","Total",975,372,21,351,206,63,266,38,228
"2011","North Norfolk 005C","E01026781","Total",984,464,13,451,163,44,277,23,254
"2011","North Norfolk 006A","E01026731","Total",493,314,6,308,62,16,179,10,169
"2011","North Norfolk 006B","E01026732","Total",566,221,9,212,118,36,132,18,114
"2011","North Norfolk 006C","E01026733","Total",1033,405,33,372,245,77,301,43,258
"2011","North Norfolk 006D","E01026737","Total",1011,321,16,305,248,76,269,39,230
"2011","North Norfolk 007A","E01026738","Total",1082,459,22,437,235,65,323,43,280
"2011","North Norfolk 007B","E01026750","Total",639,340,20,320,115,46,223,14,209
"2011","North Norfolk 007C","E01026751","Total",674,366,21,345,130,37,221,31,190
"2011","North Norfolk 007D","E01026752","Total",625,263,16,247,126,38,182,23,159
"2011","North Norfolk 008A","E01026729","Total",934,294,23,271,238,77,232,39,193
"2011","North Norfolk 008B","E01026730","Total",1067,401,25,376,272,107,299,42,257
"2011","North Norfolk 008C","E01026788","Total",569,220,13,207,125,48,127,15,112
"2011","North Norfolk 009A","E01026780","Total",1123,361,29,332,271,116,293,43,250
"2011","North Norfolk 009B","E01026782","Total",1008,390,20,370,201,57,304,40,264
"2011","North Norfolk 009C","E01026787","Total",442,152,20,132,130,38,128,29,99
"2011","North Norfolk 010A","E01026753","Total",732,372,44,328,191,82,278,40,238
"2011","North Norfolk 010B","E01026754","Total",616,210,27,183,197,69,165,33,132
"2011","North Norfolk 010C","E01026755","Total",555,322,10,312,94,23,199,19,180
"2011","North Norfolk 010D","E01026756","Total",529,231,38,193,157,73,158,22,136
"2011","North Norfolk 010E","E01026757","Total",677,220,11,209,180,69,162,22,140
"2011","North Norfolk 010F","E01026758","Total",648,241,18,223,150,54,164,23,141
"2011","North Norfolk 010G","E01026759","Total",551,251,23,228,149,57,157,34,123
"2011","North Norfolk 010H","E01026760","Total",584,234,7,227,129,41,159,12,147
"2011","North Norfolk 010I","E01026761","Total",705,328,23,305,157,59,209,27,182
"2011","North Norfolk 011A","E01026745","Total",760,310,13,297,166,67,238,27,211
"2011","North Norfolk 011B","E01026746","Total",747,249,8,241,171,58,175,20,155
"2011","North Norfolk 011C","E01026747","Total",628,251,16,235,143,67,191,27,164
"2011","North Norfolk 011D","E01026748","Total",667,302,7,295,126,48,175,9,166
"2011","North Norfolk 011E","E01026749","Total",682,316,38,278,196,77,214,26,188
"2011","North Norfolk 012A","E01026740","Total",1085,436,25,411,205,74,303,29,274
"2011","North Norfolk 012B","E01026767","Total",528,182,7,175,115,40,154,28,126
"2011","North Norfolk 012C","E01026768","Total",508,81,13,68,158,88,82,17,65
"2011","North Norfolk 012D","E01026789","Total",495,132,10,122,136,44,111,18,93
"2011","North Norfolk 012E","E01026790","Total",479,158,17,141,133,50,129,17,112
"2011","North Norfolk 013A","E01026774","Total",640,222,19,203,151,41,149,22,127
"2011","North Norfolk 013B","E01026775","Total",575,287,35,252,152,55,195,32,163
"2011","North Norfolk 013C","E01026776","Total",776,321,26,295,147,60,216,22,194
"2011","North Norfolk 013D","E01026786","Total",957,353,18,335,207,65,256,32,224
"2011","North Norfolk 014A","E01026744","Total",952,494,14,480,134,45,335,32,303
"2011","North Norfolk 014B","E01026769","Total",982,459,18,441,174,58,288,36,252
"2011","North Norfolk 014C","E01026783","Total",836,383,6,377,120,37,256,23,233
"2011","North Norfolk 014D","E01026784","Total",464,199,21,178,112,32,159,26,133
"2011","North Norfolk 014E","E01026785","Total",607,276,8,268,101,42,187,14,173
"2011","Norwich 001A","E01026797","Total",1070,243,46,197,313,178,209,43,166
"2011","Norwich 001B","E01026798","Total",670,237,44,193,212,92,177,35,142
"2011","Norwich 001C","E01026799","Total",626,190,47,143,201,102,167,35,132
"2011","Norwich 001D","E01026800","Total",901,358,83,275,272,155,259,51,208
"2011","Norwich 001E","E01026801","Total",684,227,11,216,162,61,179,26,153
"2011","Norwich 001F","E01026802","Total",785,261,24,237,181,89,226,30,196
"2011","Norwich 002A","E01026828","Total",664,235,66,169,264,137,208,57,151
"2011","Norwich 002B","E01026829","Total",857,280,91,189,274,154,211,49,162
"2011","Norwich 002C","E01026830","Total",682,308,35,273,133,71,196,20,176
"2011","Norwich 002D","E01026831","Total",632,121,9,112,110,54,100,17,83
"2011","Norwich 002E","E01026832","Total",498,190,62,128,212,96,141,47,94
"2011","Norwich 002F","E01026833","Total",696,331,62,269,197,103,223,36,187
"2011","Norwich 002G","E01026834","Total",644,266,52,214,216,94,213,42,171
"2011","Norwich 003A","E01026841","Total",726,140,20,120,149,86,131,17,114
"2011","Norwich 003B","E01026842","Total",818,163,18,145,152,91,148,18,130
"2011","Norwich 003C","E01026843","Total",902,300,48,252,221,110,260,35,225
"2011","Norwich 003D","E01026844","Total",823,279,61,218,220,112,216,44,172
"2011","Norwich 003E","E01026845","Total",786,121,25,96,169,94,121,20,101
"2011","Norwich 003F","E01026846","Total",811,189,30,159,161,91,158,17,141
"2011","Norwich 004A","E01026803","Total",638,310,45,265,161,80,212,29,183
"2011","Norwich 004B","E01026804","Total",633,275,27,248,155,63,172,29,143
"2011","Norwich 004C","E01026805","Total",639,286,41,245,180,77,220,39,181
"2011","Norwich 004D","E01026806","Total",508,181,8,173,107,38,140,9,131
"2011","Norwich 004E","E01026807","Total",523,144,30,114,156,71,113,25,88
"2011","Norwich 004F","E01026808","Total",516,221,78,143,204,91,154,46,108
"2011","Norwich 004G","E01026809","Total",762,373,52,321,167,95,266,32,234
"2011","Norwich 005A","E01026791","Total",661,284,68,216,189,92,207,36,171
"2011","Norwich 005B","E01026792","Total",627,241,39,202,179,95,173,30,143
"2011","Norwich 005C","E01026793","Total",625,241,85,156,274,141,188,59,129
"2011","Norwich 005D","E01026794","Total",844,235,52,183,253,128,196,38,158
"2011","Norwich 005F","E01026796","Total",650,281,55,226,173,75,209,55,154
"2011","Norwich 005G","E01033435","Total",705,170,66,104,257,145,107,36,71
"2011","Norwich 005H","E01033436","Total",596,271,52,219,171,91,193,38,155
"2011","Norwich 006A","E01026863","Total",771,246,33,213,167,86,162,27,135
"2011","Norwich 006B","E01026864","Total",657,208,38,170,203,97,157,29,128
"2011","Norwich 006C","E01026865","Total",805,300,79,221,285,137,239,65,174
"2011","Norwich 006D","E01026866","Total",767,245,24,221,142,62,183,24,159
"2011","Norwich 006E","E01026867","Total",562,225,77,148,224,99,172,54,118
"2011","Norwich 006F","E01026868","Total",565,213,83,130,239,123,165,66,99
"2011","Norwich 006G","E01026869","Total",657,312,66,246,209,106,217,43,174
"2011","Norwich 007A","E01026822","Total",1228,549,36,513,116,72,357,21,336
"2011","Norwich 007B","E01026823","Total",1099,329,19,310,92,44,279,14,265
"2011","Norwich 007C","E01026824","Total",868,406,33,373,117,74,299,26,273
"2011","Norwich 007D","E01026825","Total",718,237,23,214,107,53,212,22,190
"2011","Norwich 007E","E01026826","Total",864,397,39,358,122,63,313,25,288
"2011","Norwich 007F","E01026827","Total",931,526,61,465,146,81,366,27,339
"2011","Norwich 009A","E01026835","Total",643,139,19,120,129,57,98,6,92
"2011","Norwich 009B","E01026836","Total",646,135,6,129,171,62,107,19,88
"2011","Norwich 009C","E01026837","Total",735,197,11,186,127,58,138,11,127
"2011","Norwich 009D","E01026838","Total",645,163,11,152,175,69,100,12,88
"2011","Norwich 009E","E01026839","Total",668,129,12,117,125,58,91,14,77
"2011","Norwich 009F","E01026840","Total",759,144,19,125,143,60,107,24,83
"2011","Norwich 010A","E01026858","Total",745,409,47,362,155,66,262,27,235
"2011","Norwich 010B","E01026859","Total",640,251,63,188,244,115,162,48,114
"2011","Norwich 010C","E01026860","Total",470,226,18,208,85,34,120,17,103
"2011","Norwich 010D","E01026861","Total",549,235,58,177,179,64,144,36,108
"2011","Norwich 010E","E01026862","Total",497,195,32,163,155,47,155,34,121
"2011","Norwich 011A","E01026852","Total",598,184,2,182,128,49,139,15,124
"2011","Norwich 011B","E01026853","Total",1011,454,31,423,146,84,356,22,334
"2011","Norwich 011D","E01026855","Total",773,227,9,218,117,55,156,12,144
"2011","Norwich 011E","E01026856","Total",847,195,18,177,134,51,150,15,135
"2011","Norwich 011F","E01026857","Total",751,326,15,311,125,31,198,12,186
"2011","Norwich 011G","E01033434","Total",615,138,7,131,78,46,90,10,80
"2011","Norwich 011H","E01033437","Total",786,392,44,348,137,51,292,22,270
"2011","Norwich 012A","E01026810","Total",635,281,15,266,130,46,190,20,170
"2011","Norwich 012B","E01026811","Total",723,339,3,336,142,46,195,19,176
"2011","Norwich 012C","E01026812","Total",639,206,8,198,156,55,138,16,122
"2011","Norwich 012D","E01026813","Total",635,286,6,280,131,41,151,11,140
"2011","Norwich 012E","E01026814","Total",653,273,27,246,150,61,201,29,172
"2011","Norwich 012F","E01026815","Total",648,212,8,204,168,50,125,16,109
"2011","Norwich 013A","E01026816","Total",934,277,31,246,160,77,223,28,195
"2011","Norwich 013B","E01026817","Total",706,332,36,296,152,73,238,28,210
"2011","Norwich 013C","E01026818","Total",626,235,53,182,205,82,194,46,148
"2011","Norwich 013D","E01026819","Total",625,235,55,180,208,81,194,46,148
"2011","Norwich 013E","E01026820","Total",755,354,58,296,227,104,274,61,213
"2011","Norwich 013F","E01026821","Total",712,316,38,278,182,79,250,39,211
"2011","Norwich 014A","E01033438","Total",878,445,12,433,68,32,280,8,272
"2011","Norwich 014B","E01033439","Total",763,151,15,136,87,47,127,15,112
"2011","Norwich 014C","E01033440","Total",662,187,12,175,80,39,139,9,130
"2011","Norwich 014D","E01033441","Total",773,166,18,148,66,31,94,14,80
"2011","Norwich 015A","E01026848","Total",1015,485,97,388,233,107,348,41,307
"2011","Norwich 015B","E01026849","Total",913,202,8,194,134,69,163,13,150
"2011","Norwich 015C","E01026850","Total",952,238,33,205,184,110,171,20,151
"2011","South Norfolk 001A","E01026916","Total",896,339,9,330,186,61,231,28,203
"2011","South Norfolk 001B","E01026917","Total",668,303,10,293,126,57,223,17,206
"2011","South Norfolk 001C","E01026918","Total",770,285,11,274,160,62,193,21,172
"2011","South Norfolk 001E","E01026924","Total",674,258,15,243,162,54,187,24,163
"2011","South Norfolk 001F","E01026925","Total",923,292,56,236,298,139,226,48,178
"2011","South Norfolk 001G","E01033538","Total",860,84,46,38,342,236,94,45,49
"2011","South Norfolk 001H","E01033540","Total",666,244,19,225,154,79,166,23,143
"2011","South Norfolk 002A","E01026881","Total",626,159,11,148,157,68,120,11,109
"2011","South Norfolk 002B","E01026882","Total",855,319,18,301,245,117,180,30,150
"2011","South Norfolk 002C","E01026883","Total",680,238,10,228,187,69,143,23,120
"2011","South Norfolk 002D","E01026895","Total",598,156,15,141,174,88,125,21,104
"2011","South Norfolk 002E","E01026896","Total",486,134,5,129,132,37,102,12,90
"2011","South Norfolk 003A","E01026905","Total",521,297,14,283,88,38,228,19,209
"2011","South Norfolk 003B","E01026906","Total",593,237,8,229,125,40,151,16,135
"2011","South Norfolk 003C","E01026907","Total",795,258,16,242,229,82,170,18,152
"2011","South Norfolk 003D","E01026908","Total",598,103,22,81,232,88,93,23,70
"2011","South Norfolk 004A","E01026909","Total",650,279,22,257,145,58,204,29,175
"2011","South Norfolk 004B","E01026910","Total",649,216,7,209,161,57,162,24,138
"2011","South Norfolk 004C","E01026947","Total",509,120,10,110,164,54,109,21,88
"2011","South Norfolk 004D","E01026948","Total",486,135,10,125,173,45,118,14,104
"2011","South Norfolk 005A","E01026870","Total",873,396,16,380,149,56,262,14,248
"2011","South Norfolk 005B","E01026871","Total",570,200,3,197,138,35,130,12,118
"2011","South Norfolk 005C","E01026921","Total",631,238,9,229,130,43,154,15,139
"2011","South Norfolk 005D","E01026922","Total",689,305,26,279,175,64,210,28,182
"2011","South Norfolk 006A","E01026875","Total",448,134,5,129,138,45,94,15,79
"2011","South Norfolk 006B","E01026876","Total",652,265,12,253,155,40,168,22,146
"2011","South Norfolk 006C","E01026926","Total",662,250,7,243,169,59,177,23,154
"2011","South Norfolk 006D","E01026927","Total",788,264,7,257,230,72,168,29,139
"2011","South Norfolk 006E","E01026928","Total",629,262,12,250,152,71,179,20,159
"2011","South Norfolk 006F","E01026936","Total",625,238,12,226,155,48,158,17,141
"2011","South Norfolk 006G","E01026937","Total",629,195,14,181,201,76,150,23,127
"2011","South Norfolk 007A","E01026884","Total",486,161,26,135,146,49,122,35,87
"2011","South Norfolk 007B","E01026885","Total",555,138,15,123,195,55,119,28,91
"2011","South Norfolk 007C","E01026933","Total",1113,280,32,248,391,169,243,56,187
"2011","South Norfolk 007D","E01026945","Total",870,172,23,149,363,129,154,43,111
"2011","South Norfolk 007E","E01026946","Total",496,236,6,230,96,33,159,19,140
"2011","South Norfolk 008A","E01026879","Total",499,188,17,171,154,53,143,20,123
"2011","South Norfolk 008B","E01026880","Total",605,241,9,232,154,42,150,16,134
"2011","South Norfolk 008C","E01026911","Total",529,232,12,220,132,45,171,23,148
"2011","South Norfolk 008D","E01026912","Total",650,218,22,196,193,53,161,30,131
"2011","South Norfolk 008E","E01026929","Total",553,187,6,181,131,30,128,19,109
"2011","South Norfolk 008F","E01026930","Total",615,193,14,179,183,51,155,33,122
"2011","South Norfolk 009A","E01026913","Total",714,207,12,195,199,88,182,24,158
"2011","South Norfolk 009B","E01026914","Total",614,194,8,186,159,48,137,24,113
"2011","South Norfolk 009C","E01026915","Total",796,210,13,197,245,127,149,24,125
"2011","South Norfolk 009D","E01026919","Total",625,196,28,168,210,98,138,21,117
"2011","South Norfolk 009E","E01026920","Total",469,133,2,131,124,37,105,10,95
"2011","South Norfolk 009F","E01026941","Total",506,152,4,148,134,33,99,14,85
"2011","South Norfolk 009G","E01026942","Total",449,122,9,113,138,49,102,19,83
"2011","South Norfolk 010A","E01026898","Total",601,229,12,217,152,66,153,16,137
"2011","South Norfolk 010B","E01026899","Total",602,196,13,183,162,54,173,31,142
"2011","South Norfolk 010C","E01026943","Total",654,220,11,209,144,41,173,27,146
"2011","South Norfolk 010D","E01026944","Total",461,145,15,130,148,43,121,24,97
"2011","South Norfolk 011A","E01026877","Total",638,201,10,191,170,55,159,23,136
"2011","South Norfolk 011B","E01026878","Total",473,134,16,118,159,59,109,29,80
"2011","South Norfolk 011C","E01026897","Total",1099,337,12,325,294,102,256,42,214
"2011","South Norfolk 011D","E01026938","Total",852,238,21,217,240,91,201,35,166
"2011","South Norfolk 011E","E01026939","Total",703,184,14,170,217,84,148,30,118
"2011","South Norfolk 011F","E01026940","Total",719,208,25,183,260,112,186,37,149
"2011","South Norfolk 012A","E01026892","Total",557,201,15,186,158,48,151,24,127
"2011","South Norfolk 012B","E01026893","Total",460,195,7,188,85,13,134,13,121
"2011","South Norfolk 012C","E01026894","Total",1033,363,24,339,253,91,273,49,224
"2011","South Norfolk 012D","E01026903","Total",480,139,7,132,132,42,101,17,84
"2011","South Norfolk 012E","E01026904","Total",562,195,14,181,156,56,165,21,144
"2011","South Norfolk 013A","E01026872","Total",980,343,33,310,235,101,229,37,192
"2011","South Norfolk 013B","E01026900","Total",692,320,19,301,137,60,231,26,205
"2011","South Norfolk 013C","E01026901","Total",606,225,12,213,146,57,153,22,131
"2011","South Norfolk 013D","E01026902","Total",878,344,25,319,179,76,225,17,208
"2011","South Norfolk 014A","E01026873","Total",511,147,10,137,126,46,137,20,117
"2011","South Norfolk 014B","E01026874","Total",610,180,15,165,159,56,150,26,124
"2011","South Norfolk 014C","E01026886","Total",564,169,5,164,128,37,126,21,105
"2011","South Norfolk 014D","E01026887","Total",607,170,12,158,166,71,135,15,120
"2011","South Norfolk 014E","E01026934","Total",463,171,11,160,100,40,120,17,103
"2011","South Norfolk 014F","E01026935","Total",566,200,10,190,134,54,137,23,114
"2011","South Norfolk 015A","E01026888","Total",778,395,28,367,156,47,286,23,263
"2011","South Norfolk 015B","E01026889","Total",719,291,8,283,131,51,184,18,166
"2011","South Norfolk 015D","E01026891","Total",815,366,36,330,179,82,230,23,207
"2011","South Norfolk 015E","E01026931","Total",471,141,5,136,142,44,111,22,89
"2011","South Norfolk 015F","E01026932","Total",535,171,12,159,146,55,132,18,114
"2011","South Norfolk 015G","E01033539","Total",620,167,21,146,186,84,120,15,105
"2011","South Norfolk 015H","E01033541","Total",657,227,13,214,154,60,165,17,148
"2011","Babergh 001A","E01029876","Total",899,327,26,301,227,86,227,23,204
"2011","Babergh 001B","E01029898","Total",884,424,15,409,137,44,269,18,251
"2011","Babergh 001C","E01029907","Total",955,329,20,309,207,55,223,28,195
"2011","Babergh 002A","E01029881","Total",833,255,17,238,245,72,198,40,158
"2011","Babergh 002B","E01029884","Total",666,198,25,173,205,73,154,28,126
"2011","Babergh 002C","E01029885","Total",939,298,17,281,212,81,228,34,194
"2011","Babergh 003A","E01029900","Total",734,318,13,305,152,51,248,26,222
"2011","Babergh 003B","E01029901","Total",1025,347,10,337,182,68,233,23,210
"2011","Babergh 003C","E01029917","Total",812,282,14,268,235,87,179,31,148
"2011","Babergh 004A","E01029892","Total",848,324,44,280,220,97,228,36,192
"2011","Babergh 004B","E01029893","Total",1018,302,22,280,378,170,214,38,176
"2011","Babergh 004C","E01029894","Total",517,160,5,155,139,49,108,17,91
"2011","Babergh 004D","E01029895","Total",476,151,7,144,146,46,103,21,82
"2011","Babergh 004E","E01029896","Total",615,280,14,266,163,46,189,22,167
"2011","Babergh 004F","E01029911","Total",918,304,8,296,237,80,209,26,183
"2011","Babergh 005A","E01029877","Total",513,148,4,144,141,56,118,16,102
"2011","Babergh 005B","E01029878","Total",514,175,6,169,116,38,123,14,109
"2011","Babergh 005C","E01029879","Total",624,184,7,177,164,46,166,24,142
"2011","Babergh 005D","E01029908","Total",686,100,7,93,234,115,93,22,71
"2011","Babergh 005E","E01029909","Total",733,124,17,107,193,96,124,26,98
"2011","Babergh 005F","E01029910","Total",504,155,35,120,164,56,140,34,106
"2011","Babergh 006A","E01029880","Total",743,247,10,237,174,57,192,32,160
"2011","Babergh 006B","E01029921","Total",537,200,8,192,126,35,129,20,109
"2011","Babergh 006C","E01029922","Total",544,197,18,179,132,39,151,29,122
"2011","Babergh 006D","E01029923","Total",582,151,14,137,169,60,128,21,107
"2011","Babergh 007A","E01029912","Total",726,283,45,238,202,101,219,39,180
"2011","Babergh 007B","E01029913","Total",546,314,6,308,72,24,183,7,176
"2011","Babergh 007C","E01029914","Total",666,179,47,132,252,116,165,46,119
"2011","Babergh 007D","E01029915","Total",514,162,10,152,137,41,141,29,112
"2011","Babergh 007E","E01029916","Total",506,160,39,121,189,72,140,30,110
"2011","Babergh 007F","E01029918","Total",544,202,17,185,105,46,150,11,139
"2011","Babergh 007G","E01029919","Total",668,248,17,231,150,56,143,19,124
"2011","Babergh 007H","E01029920","Total",1004,465,28,437,161,72,346,28,318
"2011","Babergh 008A","E01029886","Total",507,205,18,187,132,54,151,27,124
"2011","Babergh 008B","E01029887","Total",792,249,13,236,209,70,188,29,159
"2011","Babergh 008C","E01029888","Total",495,164,27,137,167,66,137,24,113
"2011","Babergh 008D","E01029889","Total",503,174,46,128,199,80,128,43,85
"2011","Babergh 008E","E01029890","Total",485,87,13,74,207,56,103,36,67
"2011","Babergh 008F","E01029891","Total",782,200,28,172,268,119,156,34,122
"2011","Babergh 009A","E01029875","Total",901,300,17,283,246,72,202,35,167
"2011","Babergh 009B","E01029899","Total",764,252,12,240,187,65,169,16,153
"2011","Babergh 009C","E01029902","Total",896,278,7,271,224,64,203,33,170
"2011","Babergh 009D","E01029906","Total",819,293,16,277,194,77,187,23,164
"2011","Babergh 010A","E01029870","Total",479,151,22,129,157,61,122,21,101
"2011","Babergh 010B","E01029872","Total",585,195,2,193,152,51,137,19,118
"2011","Babergh 010C","E01029882","Total",621,246,6,240,176,46,160,20,140
"2011","Babergh 010D","E01029883","Total",850,319,11,308,211,52,193,20,173
"2011","Babergh 010E","E01029903","Total",561,181,5,176,166,51,115,17,98
"2011","Babergh 010F","E01029904","Total",608,235,8,227,161,42,156,16,140
"2011","Babergh 010G","E01029905","Total",464,142,2,140,117,40,116,13,103
"2011","Babergh 011A","E01029871","Total",622,252,9,243,128,40,183,21,162
"2011","Babergh 011B","E01029873","Total",965,361,27,334,225,64,252,40,212
"2011","Babergh 011C","E01029874","Total",727,193,15,178,229,67,150,35,115
"2011","Babergh 011D","E01029897","Total",803,242,6,236,234,57,189,26,163
"2011","Forest Heath 001A","E01029926","Total",796,381,12,369,129,54,249,19,230
"2011","Forest Heath 001B","E01029927","Total",1015,347,53,294,310,135,279,46,233
"2011","Forest Heath 001C","E01029928","Total",804,226,25,201,228,114,173,27,146
"2011","Forest Heath 001D","E01029929","Total",1019,392,29,363,254,104,303,33,270
"2011","Forest Heath 001E","E01029930","Total",644,209,16,193,183,73,148,24,124
"2011","Forest Heath 002C","E01029942","Total",660,203,15,188,149,64,156,15,141
"2011","Forest Heath 002E","E01029944","Total",752,278,22,256,182,60,196,31,165
"2011","Forest Heath 002F","E01033453","Total",938,187,34,153,373,217,147,25,122
"2011","Forest Heath 003E","E01029945","Total",796,194,10,184,210,83,181,29,152
"2011","Forest Heath 003F","E01032523","Total",426,41,13,28,201,106,48,11,37
"2011","Forest Heath 003G","E01032524","Total",411,100,7,93,119,48,99,16,83
"2011","Forest Heath 003H","E01032525","Total",1003,177,33,144,461,222,145,29,116
"2011","Forest Heath 003I","E01032526","Total",701,173,9,164,184,71,152,22,130
"2011","Forest Heath 004A","E01029938","Total",528,125,45,80,221,88,129,44,85
"2011","Forest Heath 004B","E01029939","Total",640,150,11,139,195,80,125,14,111
"2011","Forest Heath 004C","E01029940","Total",617,208,34,174,196,76,187,42,145
"2011","Forest Heath 004D","E01029946","Total",906,277,47,230,302,130,217,42,175
"2011","Forest Heath 004E","E01029947","Total",1064,367,11,356,196,84,265,27,238
"2011","Forest Heath 005A","E01029941","Total",775,209,13,196,220,88,174,29,145
"2011","Forest Heath 005C","E01029957","Total",728,208,9,199,168,64,152,23,129
"2011","Forest Heath 005D","E01033451","Total",622,52,28,24,245,149,51,25,26
"2011","Forest Heath 005E","E01033452","Total",583,99,10,89,199,100,95,23,72
"2011","Forest Heath 005F","E01033454","Total",543,74,18,56,165,83,95,22,73
"2011","Forest Heath 006A","E01029937","Total",871,277,10,267,210,92,190,27,163
"2011","Forest Heath 006B","E01029953","Total",613,167,29,138,183,75,149,25,124
"2011","Forest Heath 006C","E01029954","Total",1122,359,54,305,323,164,276,55,221
"2011","Forest Heath 006D","E01029955","Total",874,193,20,173,197,95,194,28,166
"2011","Forest Heath 006E","E01029956","Total",544,81,12,69,186,102,93,28,65
"2011","Forest Heath 008A","E01029925","Total",870,250,10,240,139,73,153,11,142
"2011","Forest Heath 008B","E01029949","Total",637,184,17,167,154,58,155,22,133
"2011","Forest Heath 008C","E01029950","Total",795,236,44,192,247,124,216,36,180
"2011","Forest Heath 008D","E01029951","Total",616,201,11,190,132,50,146,19,127
"2011","Forest Heath 008E","E01029952","Total",524,153,11,142,120,50,116,17,99
"2011","Forest Heath 008F","E01032612","Total",939,173,14,159,205,114,150,21,129
"2011","Ipswich 001A","E01030032","Total",511,159,48,111,240,93,148,52,96
"2011","Ipswich 001B","E01030033","Total",654,247,6,241,148,51,165,23,142
"2011","Ipswich 001C","E01030034","Total",630,247,9,238,131,41,159,11,148
"2011","Ipswich 001D","E01030035","Total",647,238,66,172,272,97,200,62,138
"2011","Ipswich 001E","E01030036","Total",776,403,47,356,197,65,318,49,269
"2011","Ipswich 002A","E01029973","Total",631,255,6,249,139,51,173,20,153
"2011","Ipswich 002B","E01029974","Total",613,156,10,146,190,64,143,24,119
"2011","Ipswich 002C","E01029975","Total",518,188,9,179,162,60,141,18,123
"2011","Ipswich 002D","E01029976","Total",639,213,13,200,171,70,198,33,165
"2011","Ipswich 002E","E01029977","Total",633,200,6,194,177,62,166,24,142
"2011","Ipswich 003A","E01030027","Total",906,182,34,148,282,145,185,44,141
"2011","Ipswich 003B","E01030028","Total",668,195,36,159,212,94,167,32,135
"2011","Ipswich 003C","E01030029","Total",658,251,56,195,217,94,189,49,140
"2011","Ipswich 003D","E01030030","Total",898,246,55,191,291,130,194,46,148
"2011","Ipswich 003E","E01030031","Total",647,276,60,216,219,102,212,46,166
"2011","Ipswich 004A","E01029997","Total",630,197,15,182,245,84,168,38,130
"2011","Ipswich 004B","E01029998","Total",758,311,61,250,273,90,245,69,176
"2011","Ipswich 004C","E01029999","Total",624,151,7,144,254,102,135,36,99
"2011","Ipswich 004D","E01030000","Total",637,131,15,116,240,100,120,26,94
"2011","Ipswich 004E","E01030001","Total",647,273,14,259,163,54,217,34,183
"2011","Ipswich 005A","E01030007","Total",662,149,17,132,238,94,107,31,76
"2011","Ipswich 005B","E01030008","Total",520,164,2,162,160,45,109,14,95
"2011","Ipswich 005C","E01030009","Total",591,206,4,202,152,55,137,13,124
"2011","Ipswich 005D","E01030010","Total",955,334,39,295,231,116,250,27,223
"2011","Ipswich 005E","E01030011","Total",675,254,7,247,174,50,155,19,136
"2011","Ipswich 006A","E01030022","Total",930,198,46,152,304,153,189,48,141
"2011","Ipswich 006B","E01030023","Total",835,182,48,134,277,166,162,31,131
"2011","Ipswich 006C","E01030024","Total",1057,398,38,360,220,114,256,26,230
"2011","Ipswich 006D","E01030025","Total",834,255,31,224,184,93,191,23,168
"2011","Ipswich 006E","E01030026","Total",707,198,55,143,267,139,182,44,138
"2011","Ipswich 007A","E01029958","Total",645,178,22,156,188,93,146,26,120
"2011","Ipswich 007C","E01029960","Total",839,190,21,169,235,104,164,31,133
"2011","Ipswich 007D","E01029961","Total",603,138,24,114,239,94,132,35,97
"2011","Ipswich 007E","E01029962","Total",696,143,33,110,209,102,125,38,87
"2011","Ipswich 007F","E01033124","Total",440,104,3,101,24,15,83,3,80
"2011","Ipswich 007G","E01033125","Total",632,196,26,170,75,49,116,9,107
"2011","Ipswich 007H","E01033129","Total",646,224,27,197,122,57,157,20,137
"2011","Ipswich 008A","E01030002","Total",937,312,20,292,221,88,253,33,220
"2011","Ipswich 008B","E01030003","Total",713,173,17,156,239,94,155,31,124
"2011","Ipswich 008C","E01030004","Total",498,121,8,113,173,50,108,24,84
"2011","Ipswich 008D","E01030005","Total",930,207,50,157,382,200,187,56,131
"2011","Ipswich 008E","E01030006","Total",843,291,25,266,260,118,235,35,200
"2011","Ipswich 009A","E01029963","Total",640,238,6,232,172,45,160,28,132
"2011","Ipswich 009B","E01029964","Total",522,114,11,103,165,71,117,28,89
"2011","Ipswich 009C","E01029965","Total",621,240,8,232,169,63,178,30,148
"2011","Ipswich 009D","E01029966","Total",621,237,8,229,145,48,176,18,158
"2011","Ipswich 009E","E01029967","Total",613,327,6,321,109,34,190,15,175
"2011","Ipswich 010A","E01029984","Total",613,173,65,108,235,105,162,61,101
"2011","Ipswich 010B","E01029985","Total",1078,248,50,198,244,125,192,39,153
"2011","Ipswich 010C","E01029986","Total",665,263,61,202,230,99,185,38,147
"2011","Ipswich 010D","E01029987","Total",622,258,32,226,199,87,200,34,166
"2011","Ipswich 010E","E01029988","Total",920,321,46,275,224,101,254,37,217
"2011","Ipswich 011B","E01029990","Total",713,147,37,110,239,108,134,34,100
"2011","Ipswich 011C","E01029991","Total",675,199,10,189,182,90,158,24,134
"2011","Ipswich 011D","E01029992","Total",608,173,10,163,154,74,166,24,142
"2011","Ipswich 011E","E01033123","Total",809,189,40,149,223,124,172,21,151
"2011","Ipswich 011F","E01033126","Total",768,86,21,65,150,120,58,10,48
"2011","Ipswich 012A","E01029968","Total",674,182,40,142,190,89,148,35,113
"2011","Ipswich 012B","E01029969","Total",555,149,26,123,168,75,123,27,96
"2011","Ipswich 012C","E01029970","Total",757,217,18,199,195,87,194,29,165
"2011","Ipswich 012D","E01029971","Total",637,258,47,211,182,80,211,40,171
"2011","Ipswich 012F","E01033122","Total",664,199,76,123,222,135,131,30,101
"2011","Ipswich 012G","E01033130","Total",633,232,19,213,98,57,140,13,127
"2011","Ipswich 013A","E01030012","Total",624,361,31,330,101,35,232,16,216
"2011","Ipswich 013B","E01030013","Total",604,268,24,244,154,71,240,26,214
"2011","Ipswich 013C","E01030014","Total",602,273,34,239,163,62,227,32,195
"2011","Ipswich 013D","E01030015","Total",530,167,7,160,140,53,130,22,108
"2011","Ipswich 013E","E01030016","Total",633,219,24,195,149,49,159,21,138
"2011","Ipswich 014B","E01029994","Total",636,294,70,224,226,82,235,46,189
"2011","Ipswich 014C","E01029995","Total",654,152,10,142,183,83,141,20,121
"2011","Ipswich 014D","E01029996","Total",637,216,58,158,216,88,177,47,130
"2011","Ipswich 014E","E01033127","Total",604,123,52,71,243,145,98,36,62
"2011","Ipswich 014F","E01033128","Total",485,111,19,92,149,71,91,13,78
"2011","Ipswich 014G","E01033131","Total",554,183,57,126,221,90,164,50,114
"2011","Ipswich 015A","E01030017","Total",633,250,26,224,160,68,189,22,167
"2011","Ipswich 015B","E01030018","Total",667,273,76,197,223,119,202,44,158
"2011","Ipswich 015C","E01030019","Total",644,211,17,194,188,69,158,26,132
"2011","Ipswich 015D","E01030020","Total",609,213,20,193,160,62,149,20,129
"2011","Ipswich 015E","E01030021","Total",673,296,67,229,198,115,189,33,156
"2011","Ipswich 016A","E01029978","Total",547,167,23,144,167,85,153,31,122
"2011","Ipswich 016B","E01029979","Total",645,301,81,220,245,97,223,51,172
"2011","Ipswich 016C","E01029980","Total",701,274,95,179,285,157,219,61,158
"2011","Ipswich 016D","E01029981","Total",513,142,17,125,128,66,110,15,95
"2011","Ipswich 016E","E01029982","Total",526,180,61,119,226,91,180,56,124
"2011","Ipswich 016F","E01029983","Total",656,177,10,167,197,87,172,32,140
"2011","Mid Suffolk 001A","E01030052","Total",969,383,26,357,250,89,280,41,239
"2011","Mid Suffolk 001B","E01030058","Total",868,293,18,275,221,64,220,31,189
"2011","Mid Suffolk 001C","E01030064","Total",922,281,9,272,241,84,187,20,167
"2011","Mid Suffolk 001D","E01030088","Total",475,127,5,122,136,41,107,23,84
"2011","Mid Suffolk 002A","E01030039","Total",557,153,7,146,174,56,118,23,95
"2011","Mid Suffolk 002B","E01030054","Total",508,149,7,142,142,38,90,12,78
"2011","Mid Suffolk 002C","E01030055","Total",577,151,6,145,161,54,131,21,110
"2011","Mid Suffolk 002D","E01030066","Total",680,261,12,249,168,50,188,32,156
"2011","Mid Suffolk 002E","E01030067","Total",566,186,9,177,146,40,128,17,111
"2011","Mid Suffolk 002F","E01030068","Total",717,203,9,194,197,68,156,24,132
"2011","Mid Suffolk 003A","E01030053","Total",985,337,23,314,250,87,255,34,221
"2011","Mid Suffolk 003B","E01030082","Total",1136,433,19,414,271,74,292,36,256
"2011","Mid Suffolk 003C","E01030090","Total",969,257,13,244,278,97,202,31,171
"2011","Mid Suffolk 004A","E01030040","Total",489,146,9,137,135,47,116,16,100
"2011","Mid Suffolk 004B","E01030049","Total",673,223,10,213,203,62,169,34,135
"2011","Mid Suffolk 004C","E01030050","Total",836,184,11,173,285,114,157,25,132
"2011","Mid Suffolk 004D","E01030084","Total",646,217,5,212,169,42,131,14,117
"2011","Mid Suffolk 004E","E01030085","Total",681,195,10,185,210,80,154,21,133
"2011","Mid Suffolk 005A","E01030037","Total",512,161,14,147,146,61,123,23,100
"2011","Mid Suffolk 005B","E01030038","Total",499,170,7,163,150,47,131,19,112
"2011","Mid Suffolk 005C","E01030059","Total",961,312,20,292,247,83,242,45,197
"2011","Mid Suffolk 005D","E01030081","Total",1008,399,17,382,228,73,293,34,259
"2011","Mid Suffolk 006A","E01030051","Total",726,277,17,260,193,78,222,33,189
"2011","Mid Suffolk 006B","E01030056","Total",949,361,14,347,227,76,281,37,244
"2011","Mid Suffolk 006C","E01030065","Total",866,272,10,262,228,88,187,23,164
"2011","Mid Suffolk 006D","E01030086","Total",472,129,20,109,156,53,95,27,68
"2011","Mid Suffolk 006E","E01030089","Total",835,308,19,289,214,59,244,38,206
"2011","Mid Suffolk 007A","E01030048","Total",1029,376,28,348,295,86,297,37,260
"2011","Mid Suffolk 007B","E01030057","Total",910,219,13,206,276,81,212,40,172
"2011","Mid Suffolk 007C","E01030083","Total",918,257,12,245,265,84,198,34,164
"2011","Mid Suffolk 007D","E01030087","Total",514,143,12,131,169,54,133,31,102
"2011","Mid Suffolk 008A","E01030073","Total",747,402,37,365,162,68,278,27,251
"2011","Mid Suffolk 008B","E01030077","Total",680,333,43,290,175,77,247,39,208
"2011","Mid Suffolk 008C","E01030079","Total",642,258,54,204,236,91,215,45,170
"2011","Mid Suffolk 008D","E01030080","Total",667,239,24,215,203,69,177,30,147
"2011","Mid Suffolk 009A","E01030063","Total",903,265,15,250,276,90,236,40,196
"2011","Mid Suffolk 009B","E01030069","Total",543,140,8,132,130,44,120,18,102
"2011","Mid Suffolk 009C","E01030072","Total",747,258,16,242,174,68,175,24,151
"2011","Mid Suffolk 009D","E01030075","Total",618,109,9,100,263,96,101,32,69
"2011","Mid Suffolk 010A","E01030060","Total",738,238,15,223,220,84,168,22,146
"2011","Mid Suffolk 010B","E01030071","Total",684,206,15,191,150,62,171,20,151
"2011","Mid Suffolk 010D","E01030076","Total",640,181,25,156,187,73,144,27,117
"2011","Mid Suffolk 010E","E01030078","Total",724,152,13,139,219,89,146,38,108
"2011","Mid Suffolk 010F","E01033316","Total",624,68,22,46,263,156,77,29,48
"2011","Mid Suffolk 010G","E01033317","Total",651,111,23,88,239,127,116,36,80
"2011","Mid Suffolk 010H","E01033319","Total",726,105,18,87,305,155,94,31,63
"2011","Mid Suffolk 011A","E01030041","Total",921,279,7,272,213,70,222,29,193
"2011","Mid Suffolk 011B","E01030043","Total",536,121,11,110,162,65,89,17,72
"2011","Mid Suffolk 011C","E01030061","Total",761,355,9,346,156,52,265,22,243
"2011","Mid Suffolk 011D","E01030062","Total",624,226,6,220,132,60,158,19,139
"2011","Mid Suffolk 011E","E01030070","Total",539,99,6,93,237,136,101,26,75
"2011","Mid Suffolk 012A","E01030042","Total",667,214,8,206,154,48,156,25,131
"2011","Mid Suffolk 012B","E01030044","Total",563,238,8,230,96,31,167,16,151
"2011","Mid Suffolk 012C","E01030045","Total",706,221,6,215,212,64,180,32,148
"2011","Mid Suffolk 012D","E01030046","Total",647,197,6,191,184,62,150,27,123
"2011","Mid Suffolk 012E","E01030047","Total",555,146,11,135,150,51,146,21,125
"2011","St Edmundsbury 001A","E01030095","Total",485,141,9,132,132,45,81,12,69
"2011","St Edmundsbury 001B","E01030096","Total",608,195,8,187,157,53,171,34,137
"2011","St Edmundsbury 001C","E01030097","Total",504,191,15,176,125,41,135,19,116
"2011","St Edmundsbury 001D","E01030145","Total",598,176,12,164,171,43,143,31,112
"2011","St Edmundsbury 001E","E01030146","Total",500,254,7,247,107,52,167,14,153
"2011","St Edmundsbury 002A","E01030094","Total",594,177,20,157,170,57,137,23,114
"2011","St Edmundsbury 002B","E01030121","Total",889,278,25,253,303,107,236,55,181
"2011","St Edmundsbury 002C","E01030132","Total",438,59,4,55,226,138,62,22,40
"2011","St Edmundsbury 002D","E01030133","Total",606,160,8,152,177,75,160,29,131
"2011","St Edmundsbury 003A","E01030130","Total",543,203,34,169,161,62,148,31,117
"2011","St Edmundsbury 003B","E01030131","Total",507,197,49,148,190,76,158,45,113
"2011","St Edmundsbury 003C","E01030139","Total",765,297,54,243,242,81,259,57,202
"2011","St Edmundsbury 003D","E01030140","Total",503,136,25,111,165,56,107,33,74
"2011","St Edmundsbury 003E","E01030141","Total",638,180,27,153,226,103,141,34,107
"2011","St Edmundsbury 004A","E01030103","Total",861,327,10,317,177,52,213,18,195
"2011","St Edmundsbury 004B","E01030104","Total",894,322,5,317,223,60,213,23,190
"2011","St Edmundsbury 004C","E01030138","Total",975,307,28,279,270,88,251,38,213
"2011","St Edmundsbury 005B","E01030127","Total",514,83,5,78,169,83,59,13,46
"2011","St Edmundsbury 005C","E01030128","Total",610,77,7,70,201,84,78,21,57
"2011","St Edmundsbury 005D","E01030129","Total",581,139,5,134,177,63,108,17,91
"2011","St Edmundsbury 005E","E01033044","Total",520,44,16,28,268,125,47,19,28
"2011","St Edmundsbury 005F","E01033045","Total",402,51,17,34,188,89,47,27,20
"2011","St Edmundsbury 005G","E01033050","Total",521,85,6,79,197,93,73,16,57
"2011","St Edmundsbury 006A","E01030091","Total",950,319,14,305,113,58,217,12,205
"2011","St Edmundsbury 006B","E01030093","Total",776,253,13,240,142,51,183,27,156
"2011","St Edmundsbury 006D","E01030137","Total",737,170,17,153,172,82,146,17,129
"2011","St Edmundsbury 006E","E01033043","Total",616,204,19,185,143,67,160,23,137
"2011","St Edmundsbury 006F","E01033046","Total",605,204,13,191,100,54,162,13,149
"2011","St Edmundsbury 006G","E01033047","Total",500,107,7,100,146,47,105,22,83
"2011","St Edmundsbury 007A","E01030092","Total",813,288,28,260,190,78,198,22,176
"2011","St Edmundsbury 007B","E01030123","Total",646,228,41,187,226,96,189,45,144
"2011","St Edmundsbury 007C","E01030124","Total",731,295,3,292,136,40,184,18,166
"2011","St Edmundsbury 007D","E01030125","Total",635,229,20,209,171,62,187,33,154
"2011","St Edmundsbury 007E","E01030148","Total",515,146,2,144,137,42,134,16,118
"2011","St Edmundsbury 007F","E01030149","Total",625,203,7,196,168,51,166,29,137
"2011","St Edmundsbury 008A","E01030098","Total",966,323,12,311,276,98,225,32,193
"2011","St Edmundsbury 008B","E01030100","Total",868,271,13,258,216,58,199,37,162
"2011","St Edmundsbury 008C","E01030119","Total",934,296,11,285,262,92,230,31,199
"2011","St Edmundsbury 008D","E01030134","Total",470,122,5,117,131,53,100,16,84
"2011","St Edmundsbury 008E","E01030135","Total",538,153,1,152,139,42,133,15,118
"2011","St Edmundsbury 009B","E01030142","Total",736,299,9,290,157,57,171,17,154
"2011","St Edmundsbury 009C","E01030143","Total",661,182,14,168,204,101,155,33,122
"2011","St Edmundsbury 009D","E01030144","Total",535,196,7,189,140,49,145,19,126
"2011","St Edmundsbury 009E","E01030147","Total",681,305,7,298,110,45,181,16,165
"2011","St Edmundsbury 009F","E01033048","Total",650,258,20,238,130,61,194,21,173
"2011","St Edmundsbury 009G","E01033049","Total",653,277,3,274,79,34,200,12,188
"2011","St Edmundsbury 010A","E01030099","Total",863,319,10,309,186,63,204,18,186
"2011","St Edmundsbury 010B","E01030101","Total",950,399,12,387,202,74,283,30,253
"2011","St Edmundsbury 010C","E01030150","Total",909,274,12,262,216,69,204,30,174
"2011","St Edmundsbury 011A","E01030120","Total",923,306,7,299,221,80,237,30,207
"2011","St Edmundsbury 011B","E01030122","Total",798,272,14,258,226,82,191,32,159
"2011","St Edmundsbury 011C","E01030151","Total",822,234,9,225,208,76,163,24,139
"2011","St Edmundsbury 012A","E01030109","Total",753,300,50,250,283,143,209,49,160
"2011","St Edmundsbury 012B","E01030110","Total",1152,349,52,297,407,195,281,65,216
"2011","St Edmundsbury 012C","E01030111","Total",530,156,8,148,176,48,137,21,116
"2011","St Edmundsbury 012D","E01030112","Total",741,203,12,191,183,76,188,26,162
"2011","St Edmundsbury 013A","E01030115","Total",877,230,62,168,377,181,217,62,155
"2011","St Edmundsbury 013B","E01030116","Total",828,153,18,135,357,133,139,41,98
"2011","St Edmundsbury 013C","E01030117","Total",652,112,10,102,243,104,127,34,93
"2011","St Edmundsbury 013D","E01030118","Total",654,166,29,137,255,120,143,30,113
"2011","St Edmundsbury 014A","E01030105","Total",713,174,27,147,234,114,173,36,137
"2011","St Edmundsbury 014B","E01030106","Total",1018,275,58,217,358,165,246,52,194
"2011","St Edmundsbury 014C","E01030107","Total",638,164,7,157,179,53,138,21,117
"2011","St Edmundsbury 014D","E01030108","Total",710,212,39,173,245,107,186,34,152
"2011","St Edmundsbury 014E","E01030113","Total",828,283,27,256,236,111,227,31,196
"2011","St Edmundsbury 014F","E01030114","Total",546,144,46,98,254,104,145,47,98
"2011","Suffolk Coastal 001A","E01030201","Total",913,275,16,259,208,78,248,37,211
"2011","Suffolk Coastal 001B","E01030219","Total",903,360,18,342,172,66,264,27,237
"2011","Suffolk Coastal 001C","E01030222","Total",905,415,13,402,139,47,256,26,230
"2011","Suffolk Coastal 002A","E01030154","Total",877,285,13,272,241,61,188,27,161
"2011","Suffolk Coastal 002B","E01030172","Total",713,250,11,239,201,49,175,34,141
"2011","Suffolk Coastal 002C","E01030173","Total",686,311,7,304,145,47,216,16,200
"2011","Suffolk Coastal 002D","E01030174","Total",545,147,11,136,163,35,119,22,97
"2011","Suffolk Coastal 002E","E01030176","Total",852,271,17,254,201,51,228,36,192
"2011","Suffolk Coastal 003A","E01030186","Total",598,226,9,217,130,32,175,26,149
"2011","Suffolk Coastal 003B","E01030208","Total",586,267,13,254,118,35,170,19,151
"2011","Suffolk Coastal 003C","E01030209","Total",763,335,14,321,147,63,226,18,208
"2011","Suffolk Coastal 003D","E01030210","Total",860,315,40,275,293,124,243,59,184
"2011","Suffolk Coastal 003E","E01030212","Total",863,323,15,308,177,58,235,23,212
"2011","Suffolk Coastal 004A","E01030152","Total",1043,584,4,580,109,42,322,9,313
"2011","Suffolk Coastal 004B","E01030153","Total",665,296,6,290,79,26,183,7,176
"2011","Suffolk Coastal 004C","E01030187","Total",656,247,29,218,187,75,194,30,164
"2011","Suffolk Coastal 004D","E01030188","Total",783,271,28,243,186,77,192,29,163
"2011","Suffolk Coastal 004E","E01030189","Total",712,242,25,217,201,79,197,25,172
"2011","Suffolk Coastal 005A","E01030193","Total",677,218,7,211,191,68,123,21,102
"2011","Suffolk Coastal 005B","E01030194","Total",812,329,20,309,169,62,246,26,220
"2011","Suffolk Coastal 005C","E01030195","Total",670,225,9,216,182,34,143,27,116
"2011","Suffolk Coastal 005D","E01030220","Total",959,411,18,393,216,65,297,33,264
"2011","Suffolk Coastal 006A","E01030175","Total",967,359,26,333,268,95,224,35,189
"2011","Suffolk Coastal 006B","E01030200","Total",894,286,21,265,258,78,219,35,184
"2011","Suffolk Coastal 006C","E01030221","Total",833,249,9,240,189,52,197,15,182
"2011","Suffolk Coastal 007C","E01030199","Total",836,301,7,294,179,56,226,31,195
"2011","Suffolk Coastal 007F","E01033443","Total",527,92,7,85,206,100,101,23,78
"2011","Suffolk Coastal 007G","E01033445","Total",649,115,13,102,257,111,130,43,87
"2011","Suffolk Coastal 007H","E01033446","Total",871,282,6,276,196,62,218,29,189
"2011","Suffolk Coastal 007I","E01033448","Total",544,183,11,172,138,38,146,24,122
"2011","Suffolk Coastal 007J","E01033449","Total",662,129,19,110,237,87,149,37,112
"2011","Suffolk Coastal 008A","E01030155","Total",855,275,26,249,259,88,201,50,151
"2011","Suffolk Coastal 008B","E01030185","Total",886,387,57,330,268,91,275,55,220
"2011","Suffolk Coastal 008C","E01030203","Total",948,517,9,508,168,44,321,17,304
"2011","Suffolk Coastal 008D","E01030211","Total",1103,511,30,481,173,59,291,15,276
"2011","Suffolk Coastal 009A","E01030179","Total",1015,206,20,186,438,189,197,58,139
"2011","Suffolk Coastal 009B","E01030180","Total",553,150,12,138,197,72,126,33,93
"2011","Suffolk Coastal 009C","E01030183","Total",883,391,7,384,172,59,271,27,244
"2011","Suffolk Coastal 009D","E01030184","Total",818,401,22,379,182,62,277,39,238
"2011","Suffolk Coastal 009E","E01030207","Total",673,291,5,286,143,40,197,19,178
"2011","Suffolk Coastal 010A","E01030181","Total",724,102,10,92,314,118,108,37,71
"2011","Suffolk Coastal 010C","E01030190","Total",806,367,6,361,166,45,232,23,209
"2011","Suffolk Coastal 010D","E01030191","Total",783,275,14,261,186,60,204,27,177
"2011","Suffolk Coastal 010E","E01030192","Total",609,172,5,167,171,53,149,25,124
"2011","Suffolk Coastal 010F","E01030198","Total",570,202,9,193,118,37,140,14,126
"2011","Suffolk Coastal 010G","E01033442","Total",546,44,13,31,315,157,61,22,39
"2011","Suffolk Coastal 010H","E01033444","Total",512,36,10,26,291,138,61,38,23
"2011","Suffolk Coastal 010I","E01033447","Total",585,202,8,194,202,69,129,20,109
"2011","Suffolk Coastal 011A","E01030196","Total",677,134,10,124,227,88,127,35,92
"2011","Suffolk Coastal 011B","E01030197","Total",691,273,1,272,135,37,178,22,156
"2011","Suffolk Coastal 011C","E01030204","Total",728,232,4,228,233,62,145,24,121
"2011","Suffolk Coastal 011D","E01030205","Total",463,69,5,64,209,61,69,21,48
"2011","Suffolk Coastal 011E","E01030206","Total",634,282,3,279,156,48,168,27,141
"2011","Suffolk Coastal 012A","E01030171","Total",784,211,17,194,236,81,199,42,157
"2011","Suffolk Coastal 012B","E01030214","Total",531,114,14,100,185,70,111,30,81
"2011","Suffolk Coastal 012C","E01030215","Total",633,227,18,209,143,59,187,25,162
"2011","Suffolk Coastal 012D","E01030216","Total",627,222,6,216,150,57,180,20,160
"2011","Suffolk Coastal 012E","E01030217","Total",564,197,12,185,146,54,145,20,125
"2011","Suffolk Coastal 012F","E01030218","Total",625,191,15,176,180,61,145,29,116
"2011","Suffolk Coastal 013C","E01030158","Total",679,364,5,359,86,23,177,8,169
"2011","Suffolk Coastal 013D","E01030159","Total",648,254,15,239,181,57,186,31,155
"2011","Suffolk Coastal 013E","E01030164","Total",650,279,7,272,142,35,193,29,164
"2011","Suffolk Coastal 013F","E01030166","Total",674,330,5,325,130,37,171,19,152
"2011","Suffolk Coastal 013G","E01033450","Total",1119,558,11,547,202,69,365,26,339
"2011","Suffolk Coastal 014A","E01030160","Total",699,329,23,306,156,61,242,30,212
"2011","Suffolk Coastal 014B","E01030161","Total",611,210,35,175,208,89,166,36,130
"2011","Suffolk Coastal 014C","E01030168","Total",662,295,34,261,178,70,244,27,217
"2011","Suffolk Coastal 014D","E01030169","Total",746,228,56,172,231,105,179,37,142
"2011","Suffolk Coastal 014E","E01030170","Total",759,369,49,320,199,80,284,49,235
"2011","Suffolk Coastal 015A","E01030162","Total",634,265,20,245,124,57,187,16,171
"2011","Suffolk Coastal 015B","E01030163","Total",656,243,46,197,183,71,198,33,165
"2011","Suffolk Coastal 015C","E01030165","Total",762,297,17,280,168,60,208,22,186
"2011","Suffolk Coastal 015D","E01030167","Total",609,264,10,254,145,56,186,19,167
"2011","Waveney 001A","E01030240","Total",745,367,11,356,120,39,252,22,230
"2011","Waveney 001B","E01030241","Total",659,315,8,307,116,46,193,21,172
"2011","Waveney 001C","E01030242","Total",594,248,5,243,130,41,156,14,142
"2011","Waveney 001D","E01030259","Total",470,135,3,132,127,35,121,21,100
"2011","Waveney 001E","E01030260","Total",427,122,11,111,113,31,85,10,75
"2011","Waveney 002A","E01030261","Total",606,303,62,241,189,76,226,38,188
"2011","Waveney 002B","E01030262","Total",566,241,22,219,141,46,186,28,158
"2011","Waveney 002C","E01030277","Total",480,227,45,182,160,60,184,44,140
"2011","Waveney 002D","E01030279","Total",591,298,68,230,192,63,217,42,175
"2011","Waveney 002E","E01030281","Total",948,318,49,269,332,135,227,52,175
"2011","Waveney 003A","E01030266","Total",711,310,29,281,210,78,215,32,183
"2011","Waveney 003B","E01030267","Total",570,237,29,208,170,67,175,38,137
"2011","Waveney 003C","E01030271","Total",687,346,8,338,106,31,218,19,199
"2011","Waveney 003D","E01030278","Total",714,404,31,373,136,55,231,20,211
"2011","Waveney 003E","E01030280","Total",624,268,6,262,137,52,171,11,160
"2011","Waveney 004A","E01030246","Total",609,196,35,161,213,100,156,24,132
"2011","Waveney 004B","E01030248","Total",618,219,48,171,205,94,182,50,132
"2011","Waveney 004C","E01030249","Total",747,287,62,225,244,110,219,47,172
"2011","Waveney 004D","E01030250","Total",881,397,83,314,248,130,276,46,230
"2011","Waveney 004E","E01030264","Total",612,215,53,162,203,103,165,37,128
"2011","Waveney 004F","E01030265","Total",612,214,48,166,201,91,190,41,149
"2011","Waveney 005A","E01030255","Total",503,156,33,123,183,78,122,28,94
"2011","Waveney 005B","E01030263","Total",666,352,14,338,106,30,241,24,217
"2011","Waveney 005C","E01030270","Total",683,283,26,257,198,74,186,27,159
"2011","Waveney 005D","E01030289","Total",674,293,33,260,158,67,226,29,197
"2011","Waveney 005E","E01030290","Total",677,343,24,319,147,60,221,22,199
"2011","Waveney 006A","E01030233","Total",641,239,2,237,153,48,168,23,145
"2011","Waveney 006B","E01030235","Total",631,265,3,262,143,55,183,21,162
"2011","Waveney 006C","E01030268","Total",529,176,11,165,161,49,121,19,102
"2011","Waveney 006D","E01030269","Total",752,327,7,320,141,50,211,26,185
"2011","Waveney 006E","E01030288","Total",619,300,7,293,122,37,180,22,158
"2011","Waveney 007A","E01030247","Total",859,488,49,439,139,69,323,23,300
"2011","Waveney 007B","E01030254","Total",615,220,56,164,224,105,169,36,133
"2011","Waveney 007C","E01030256","Total",623,254,18,236,145,59,162,19,143
"2011","Waveney 007D","E01030258","Total",809,430,41,389,148,55,317,32,285
"2011","Waveney 007E","E01030276","Total",590,219,22,197,140,51,171,19,152
"2011","Waveney 008A","E01030257","Total",637,260,27,233,182,72,208,28,180
"2011","Waveney 008B","E01030274","Total",619,382,24,358,107,43,255,24,231
"2011","Waveney 008C","E01030275","Total",487,181,16,165,115,39,142,25,117
"2011","Waveney 008D","E01030287","Total",657,364,34,330,140,52,239,32,207
"2011","Waveney 008E","E01030291","Total",589,282,77,205,204,89,202,60,142
"2011","Waveney 009A","E01030234","Total",662,192,77,115,282,126,146,44,102
"2011","Waveney 009B","E01030236","Total",793,332,28,304,196,86,264,34,230
"2011","Waveney 009C","E01030237","Total",1118,293,16,277,398,152,232,56,176
"2011","Waveney 009D","E01030238","Total",717,194,17,177,272,103,180,43,137
"2011","Waveney 010A","E01030223","Total",816,383,23,360,192,73,263,31,232
"2011","Waveney 010B","E01030224","Total",770,383,23,360,149,53,255,33,222
"2011","Waveney 010C","E01030225","Total",846,343,32,311,166,73,242,23,219
"2011","Waveney 010D","E01030227","Total",620,305,46,259,182,79,223,46,177
"2011","Waveney 010E","E01030228","Total",776,336,17,319,177,70,226,26,200
"2011","Waveney 011A","E01030226","Total",774,251,35,216,273,107,182,41,141
"2011","Waveney 011B","E01030286","Total",896,288,15,273,222,77,222,37,185
"2011","Waveney 011C","E01030292","Total",645,265,9,256,165,54,179,24,155
"2011","Waveney 011D","E01030293","Total",693,260,7,253,201,56,168,31,137
"2011","Waveney 011E","E01030294","Total",641,245,22,223,190,78,188,29,159
"2011","Waveney 012A","E01030239","Total",727,129,22,107,314,130,136,53,83
"2011","Waveney 012B","E01030251","Total",700,282,28,254,171,48,204,35,169
"2011","Waveney 012C","E01030252","Total",815,395,19,376,143,52,284,26,258
"2011","Waveney 012D","E01030253","Total",787,355,38,317,209,74,250,48,202
"2011","Waveney 012E","E01030272","Total",752,387,14,373,134,32,259,27,232
"2011","Waveney 012F","E01030273","Total",739,402,10,392,104,41,261,21,240
"2011","Waveney 013A","E01030230","Total",926,386,19,367,173,68,260,27,233
"2011","Waveney 013B","E01030231","Total",657,235,35,200,201,83,184,32,152
"2011","Waveney 013C","E01030232","Total",682,243,23,220,211,87,177,35,142
"2011","Waveney 013D","E01030285","Total",925,285,11,274,245,71,251,35,216
"2011","Waveney 014A","E01030282","Total",661,383,10,373,51,23,232,8,224
"2011","Waveney 014B","E01030283","Total",577,248,18,230,147,55,172,19,153
"2011","Waveney 014C","E01030284","Total",609,338,6,332,93,26,177,9,168
"2011","Waveney 014D","E01030295","Total",981,336,27,309,237,80,232,40,192
"2011","Waveney 015A","E01030229","Total",949,389,28,361,215,61,265,36,229
"2011","Waveney 015B","E01030243","Total",656,253,19,234,167,64,190,30,160
"2011","Waveney 015C","E01030244","Total",879,442,15,427,113,35,308,20,288
"2011","Waveney 015D","E01030245","Total",763,380,7,373,131,49,218,13,205
"2011","Camden 001A","E01000907","Total",627,219,65,154,191,78,193,44,149
"2011","Camden 001B","E01000908","Total",827,284,41,243,188,88,235,29,206
"2011","Camden 001C","E01000909","Total",661,184,16,168,163,61,186,35,151
"2011","Camden 001D","E01000912","Total",700,246,49,197,177,73,223,44,179
"2011","Camden 001E","E01000913","Total",722,139,6,133,181,66,120,13,107
"2011","Camden 002A","E01000893","Total",715,146,12,134,179,79,129,16,113
"2011","Camden 002B","E01000894","Total",619,125,9,116,154,85,94,14,80
"2011","Camden 002C","E01000895","Total",841,241,9,232,166,81,190,20,170
"2011","Camden 002D","E01000896","Total",756,165,16,149,182,85,114,16,98
"2011","Camden 002E","E01000899","Total",698,150,10,140,199,86,103,13,90
"2011","Camden 003A","E01000910","Total",588,111,11,100,154,63,122,17,105
"2011","Camden 003B","E01000911","Total",663,195,37,158,188,85,162,24,138
"2011","Camden 003C","E01000921","Total",946,174,37,137,184,88,161,42,119
"2011","Camden 003D","E01000923","Total",656,166,18,148,158,76,156,28,128
"2011","Camden 003E","E01000928","Total",682,176,40,136,186,85,166,34,132
"2011","Camden 004A","E01000878","Total",550,156,16,140,127,62,89,10,79
"2011","Camden 004B","E01000879","Total",602,139,10,129,140,77,98,14,84
"2011","Camden 004C","E01000880","Total",621,103,11,92,221,116,69,9,60
"2011","Camden 004D","E01000884","Total",577,132,16,116,197,89,94,13,81
"2011","Camden 004E","E01000885","Total",592,137,12,125,166,79,108,15,93
"2011","Camden 005A","E01000871","Total",632,134,21,113,187,84,108,24,84
"2011","Camden 005B","E01000872","Total",913,209,36,173,161,75,181,24,157
"2011","Camden 005C","E01000873","Total",710,153,16,137,168,89,114,14,100
"2011","Camden 005D","E01000874","Total",704,132,8,124,162,89,99,13,86
"2011","Camden 005E","E01000877","Total",726,137,11,126,151,91,103,18,85
"2011","Camden 006A","E01000886","Total",606,125,30,95,184,70,123,38,85
"2011","Camden 006B","E01000887","Total",690,150,24,126,145,62,148,20,128
"2011","Camden 006C","E01000888","Total",697,185,22,163,193,93,155,18,137
"2011","Camden 006D","E01000892","Total",823,215,44,171,211,105,194,52,142
"2011","Camden 006E","E01000903","Total",686,203,16,187,141,80,179,24,155
"2011","Camden 007A","E01000889","Total",657,251,69,182,224,82,235,65,170
"2011","Camden 007B","E01000890","Total",767,369,70,299,199,82,315,56,259
"2011","Camden 007C","E01000891","Total",672,321,81,240,201,86,251,59,192
"2011","Camden 007D","E01000901","Total",703,265,100,165,289,130,223,74,149
"2011","Camden 007E","E01000922","Total",653,194,38,156,131,66,149,29,120
"2011","Camden 007F","E01000927","Total",734,178,37,141,156,83,146,22,124
"2011","Camden 008A","E01000881","Total",632,135,16,119,141,77,111,25,86
"2011","Camden 008B","E01000882","Total",728,96,4,92,146,77,83,9,74
"2011","Camden 008C","E01000883","Total",638,171,16,155,118,67,99,12,87
"2011","Camden 008D","E01000897","Total",721,146,5,141,188,96,119,17,102
"2011","Camden 008E","E01000898","Total",850,207,22,185,152,76,181,27,154
"2011","Camden 009A","E01000866","Total",926,266,45,221,209,88,245,49,196
"2011","Camden 009B","E01000870","Total",774,232,41,191,181,70,226,48,178
"2011","Camden 009C","E01000924","Total",795,179,21,158,136,68,148,25,123
"2011","Camden 009D","E01000925","Total",629,266,69,197,211,94,226,59,167
"2011","Camden 009E","E01000926","Total",698,164,37,127,144,72,129,22,107
"2011","Camden 010A","E01000969","Total",954,174,17,157,170,95,124,18,106
"2011","Camden 010B","E01000970","Total",831,133,8,125,67,35,88,5,83
"2011","Camden 010C","E01000971","Total",649,127,11,116,149,94,108,15,93
"2011","Camden 010D","E01000972","Total",949,318,72,246,224,92,261,57,204
"2011","Camden 010E","E01000973","Total",894,195,42,153,154,73,157,33,124
"2011","Camden 011A","E01000842","Total",724,175,8,167,128,75,104,6,98
"2011","Camden 011B","E01000844","Total",870,183,11,172,187,140,127,13,114
"2011","Camden 011C","E01000848","Total",805,156,4,152,143,83,117,10,107
"2011","Camden 011D","E01000849","Total",862,204,10,194,132,74,118,7,111
"2011","Camden 012A","E01000900","Total",757,223,50,173,196,89,205,43,162
"2011","Camden 012B","E01000902","Total",590,237,62,175,195,94,191,49,142
"2011","Camden 012C","E01000904","Total",918,302,78,224,229,99,255,55,200
"2011","Camden 012D","E01000905","Total",812,376,108,268,268,114,295,74,221
"2011","Camden 012E","E01000906","Total",788,186,14,172,106,50,134,17,117
"2011","Camden 013A","E01000875","Total",839,220,35,185,146,61,173,36,137
"2011","Camden 013B","E01000876","Total",800,273,59,214,179,81,231,47,184
"2011","Camden 013C","E01000931","Total",873,322,68,254,213,108,241,43,198
"2011","Camden 013D","E01000932","Total",947,223,33,190,130,77,216,22,194
"2011","Camden 013E","E01000974","Total",821,235,44,191,155,71,187,40,147
"2011","Camden 014A","E01000843","Total",846,234,60,174,215,149,122,23,99
"2011","Camden 014B","E01000845","Total",731,157,17,140,132,62,106,24,82
"2011","Camden 014C","E01000846","Total",616,241,60,181,212,88,172,36,136
"2011","Camden 014D","E01000847","Total",677,212,53,159,229,125,143,31,112
"2011","Camden 015A","E01000864","Total",717,159,28,131,140,67,139,22,117
"2011","Camden 015B","E01000865","Total",451,115,6,109,85,31,91,7,84
"2011","Camden 015C","E01000867","Total",675,220,38,182,143,75,172,28,144
"2011","Camden 015D","E01000868","Total",584,199,48,151,206,119,188,40,148
"2011","Camden 015E","E01000869","Total",967,241,33,208,183,100,193,36,157
"2011","Camden 016A","E01000962","Total",745,107,15,92,151,99,78,12,66
"2011","Camden 016B","E01000964","Total",713,173,35,138,169,83,150,25,125
"2011","Camden 016C","E01000965","Total",764,175,26,149,132,77,126,18,108
"2011","Camden 016D","E01000966","Total",675,89,7,82,144,82,84,16,68
"2011","Camden 016E","E01000968","Total",760,177,22,155,109,75,139,20,119
"2011","Camden 017A","E01000960","Total",841,223,34,189,183,97,164,36,128
"2011","Camden 017B","E01000961","Total",652,248,64,184,209,105,179,46,133
"2011","Camden 017C","E01000963","Total",851,252,28,224,202,104,153,25,128
"2011","Camden 017D","E01000967","Total",619,149,15,134,162,70,132,16,116
"2011","Camden 018A","E01000857","Total",686,181,18,163,144,63,154,24,130
"2011","Camden 018B","E01000858","Total",775,277,79,198,227,78,231,69,162
"2011","Camden 018C","E01000859","Total",807,135,8,127,151,68,131,17,114
"2011","Camden 018D","E01000860","Total",797,312,12,300,101,46,208,13,195
"2011","Camden 018E","E01000862","Total",816,142,15,127,156,68,117,11,106
"2011","Camden 019A","E01000856","Total",628,178,44,134,182,72,172,48,124
"2011","Camden 019B","E01000861","Total",729,176,26,150,124,46,176,30,146
"2011","Camden 019C","E01000957","Total",765,250,60,190,181,97,188,39,149
"2011","Camden 019D","E01000958","Total",835,247,73,174,243,121,177,61,116
"2011","Camden 019E","E01000959","Total",698,300,51,249,182,81,235,51,184
"2011","Camden 020A","E01000929","Total",685,255,70,185,230,100,216,72,144
"2011","Camden 020B","E01000930","Total",1076,492,65,427,186,93,335,34,301
"2011","Camden 020C","E01000933","Total",821,198,27,171,123,66,181,24,157
"2011","Camden 020D","E01000934","Total",732,280,59,221,185,89,206,43,163
"2011","Camden 020E","E01000935","Total",624,220,66,154,211,90,172,46,126
"2011","Camden 021A","E01000863","Total",667,110,15,95,94,43,93,17,76
"2011","Camden 021B","E01000946","Total",715,226,32,194,142,63,137,27,110
"2011","Camden 021C","E01000947","Total",871,263,29,234,119,52,193,20,173
"2011","Camden 021D","E01000948","Total",846,251,32,219,160,69,211,28,183
"2011","Camden 022A","E01000952","Total",675,244,58,186,189,76,205,39,166
"2011","Camden 022B","E01000953","Total",708,317,45,272,170,82,258,40,218
"2011","Camden 022C","E01000954","Total",642,282,100,182,253,126,204,48,156
"2011","Camden 022D","E01000955","Total",657,315,57,258,197,95,207,35,172
"2011","Camden 022E","E01000956","Total",608,203,55,148,176,78,159,46,113
"2011","Camden 023A","E01000944","Total",667,291,48,243,155,63,164,27,137
"2011","Camden 023B","E01000945","Total",611,175,20,155,128,80,134,28,106
"2011","Camden 023C","E01000949","Total",739,240,47,193,198,87,209,48,161
"2011","Camden 023D","E01000950","Total",550,225,54,171,187,79,176,42,134
"2011","Camden 023E","E01000951","Total",603,274,46,228,178,80,203,45,158
"2011","Camden 024A","E01000936","Total",536,182,46,136,161,70,143,43,100
"2011","Camden 024B","E01000938","Total",737,212,37,175,165,110,147,20,127
"2011","Camden 024C","E01000939","Total",446,190,40,150,130,58,129,32,97
"2011","Camden 024D","E01000940","Total",534,258,39,219,116,58,127,24,103
"2011","Camden 025A","E01000853","Total",840,409,26,383,135,70,289,26,263
"2011","Camden 025B","E01000937","Total",502,194,8,186,67,43,97,9,88
"2011","Camden 025C","E01000941","Total",557,217,45,172,148,63,194,27,167
"2011","Camden 025D","E01000942","Total",686,254,16,238,62,32,123,11,112
"2011","Camden 025E","E01000943","Total",596,228,11,217,65,26,100,9,91
"2011","Camden 026A","E01000850","Total",664,199,11,188,62,37,117,15,102
"2011","Camden 026B","E01000851","Total",861,234,9,225,71,35,119,8,111
"2011","Camden 026C","E01000852","Total",625,350,6,344,37,15,97,9,88
"2011","Camden 026D","E01000854","Total",718,291,12,279,109,66,157,32,125
"2011","Camden 027A","E01000915","Total",635,223,51,172,152,62,176,34,142
"2011","Camden 027B","E01000916","Total",881,232,37,195,143,61,170,32,138
"2011","Camden 027C","E01000917","Total",913,374,82,292,231,106,281,59,222
"2011","Camden 027D","E01000920","Total",946,256,34,222,160,80,210,39,171
"2011","Camden 028A","E01000855","Total",1111,327,7,320,48,22,152,5,147
"2011","Camden 028B","E01000914","Total",970,325,14,311,82,36,178,23,155
"2011","Camden 028C","E01000918","Total",935,302,22,280,130,55,212,28,184
"2011","Camden 028D","E01000919","Total",834,234,19,215,109,32,160,15,145
"2011","City of London 001A","E01000001","Total",876,217,4,213,80,39,126,9,117
"2011","City of London 001B","E01000002","Total",830,189,4,185,106,48,122,19,103
"2011","City of London 001C","E01000003","Total",817,275,12,263,89,48,207,17,190
"2011","City of London 001E","E01000005","Total",467,143,13,130,105,34,130,21,109
"2011","City of London 001F","E01032739","Total",676,77,5,72,31,12,40,5,35
"2011","City of London 001G","E01032740","Total",719,95,0,95,21,14,33,0,33
"2011","Hackney 001A","E01001808","Total",558,119,25,94,243,190,91,24,67
"2011","Hackney 001B","E01001809","Total",610,183,30,153,236,137,148,28,120
"2011","Hackney 001C","E01001814","Total",559,107,29,78,218,141,103,29,74
"2011","Hackney 001D","E01001823","Total",538,161,47,114,262,132,115,41,74
"2011","Hackney 001E","E01001825","Total",428,94,16,78,216,145,97,24,73
"2011","Hackney 002A","E01001714","Total",632,243,61,182,186,84,196,36,160
"2011","Hackney 002D","E01001811","Total",646,279,54,225,205,92,213,38,175
"2011","Hackney 002E","E01001813","Total",525,214,73,141,168,69,151,37,114
"2011","Hackney 002F","E01033701","Total",760,334,100,234,244,81,251,67,184
"2011","Hackney 003A","E01001799","Total",485,100,18,82,204,121,89,35,54
"2011","Hackney 003B","E01001802","Total",471,152,35,117,165,78,121,29,92
"2011","Hackney 003C","E01001804","Total",464,116,36,80,197,115,111,42,69
"2011","Hackney 003D","E01001807","Total",693,192,41,151,209,119,163,42,121
"2011","Hackney 003E","E01001812","Total",614,198,49,149,237,153,173,36,137
"2011","Hackney 004A","E01001725","Total",573,166,45,121,247,146,123,42,81
"2011","Hackney 004B","E01001726","Total",464,147,58,89,210,98,129,51,78
"2011","Hackney 004C","E01001800","Total",643,244,49,195,241,163,188,38,150
"2011","Hackney 004D","E01001824","Total",539,185,56,129,230,119,156,37,119
"2011","Hackney 004E","E01001826","Total",585,199,55,144,244,148,181,60,121
"2011","Hackney 006A","E01001723","Total",671,119,22,97,219,120,147,49,98
"2011","Hackney 006B","E01001724","Total",980,171,41,130,226,138,148,26,122
"2011","Hackney 006C","E01001727","Total",573,110,33,77,240,136,119,37,82
"2011","Hackney 006D","E01001768","Total",719,157,35,122,187,81,154,40,114
"2011","Hackney 006E","E01001769","Total",662,159,24,135,153,63,123,24,99
"2011","Hackney 007A","E01001715","Total",673,113,17,96,93,54,97,11,86
"2011","Hackney 007B","E01001716","Total",633,172,39,133,117,56,144,36,108
"2011","Hackney 007C","E01001717","Total",427,86,30,56,142,51,97,31,66
"2011","Hackney 007D","E01001718","Total",824,97,12,85,108,57,87,18,69
"2011","Hackney 007E","E01001719","Total",484,154,28,126,115,41,148,37,111
"2011","Hackney 007F","E01001720","Total",785,114,20,94,129,68,104,24,80
"2011","Hackney 008A","E01001742","Total",789,221,63,158,234,107,215,46,169
"2011","Hackney 008B","E01001801","Total",588,206,36,170,203,129,170,31,139
"2011","Hackney 008C","E01001803","Total",719,145,33,112,231,112,148,37,111
"2011","Hackney 008D","E01001806","Total",714,213,45,168,181,83,191,36,155
"2011","Hackney 009A","E01001741","Total",599,110,24,86,191,100,109,24,85
"2011","Hackney 009B","E01001805","Total",510,91,18,73,129,70,91,17,74
"2011","Hackney 009C","E01001829","Total",696,117,20,97,216,111,111,27,84
"2011","Hackney 009D","E01001831","Total",745,185,22,163,144,69,172,30,142
"2011","Hackney 009E","E01001832","Total",642,144,26,118,154,80,138,32,106
"2011","Hackney 010A","E01001764","Total",696,207,55,152,185,89,169,47,122
"2011","Hackney 010B","E01001765","Total",722,317,78,239,243,97,235,49,186
"2011","Hackney 010D","E01001767","Total",628,162,51,111,210,95,149,45,104
"2011","Hackney 010E","E01001770","Total",784,298,72,226,237,120,239,54,185
"2011","Hackney 010F","E01033703","Total",625,213,43,170,144,72,166,28,138
"2011","Hackney 010G","E01033713","Total",601,174,49,125,157,84,131,19,112
"2011","Hackney 011A","E01001792","Total",620,186,39,147,196,86,180,50,130
"2011","Hackney 011B","E01001793","Total",656,177,41,136,188,87,156,35,121
"2011","Hackney 011C","E01001794","Total",656,139,22,117,185,83,137,35,102
"2011","Hackney 011D","E01001795","Total",571,150,26,124,149,75,95,14,81
"2011","Hackney 011E","E01001796","Total",737,209,45,164,173,81,154,27,127
"2011","Hackney 012A","E01001736","Total",707,148,30,118,195,101,119,28,91
"2011","Hackney 012B","E01001737","Total",754,135,28,107,213,109,123,21,102
"2011","Hackney 012C","E01001738","Total",785,150,25,125,194,107,149,25,124
"2011","Hackney 012D","E01001739","Total",898,207,30,177,232,115,189,34,155
"2011","Hackney 013A","E01001786","Total",717,276,111,165,314,157,181,63,118
"2011","Hackney 013B","E01001787","Total",628,313,87,226,229,104,225,44,181
"2011","Hackney 013C","E01001788","Total",670,323,75,248,245,124,246,63,183
"2011","Hackney 013D","E01001790","Total",492,187,66,121,226,93,133,44,89
"2011","Hackney 014A","E01001740","Total",624,251,85,166,213,102,186,54,132
"2011","Hackney 014B","E01001747","Total",943,240,48,192,179,91,190,33,157
"2011","Hackney 014C","E01001830","Total",932,328,58,270,169,76,242,40,202
"2011","Hackney 014D","E01001833","Total",931,252,69,183,265,124,208,49,159
"2011","Hackney 014E","E01001834","Total",862,182,54,128,220,112,173,45,128
"2011","Hackney 014F","E01001835","Total",483,83,10,73,127,66,84,21,63
"2011","Hackney 015A","E01001733","Total",701,180,45,135,208,118,136,31,105
"2011","Hackney 015B","E01001785","Total",569,194,54,140,171,72,153,32,121
"2011","Hackney 015C","E01001789","Total",646,165,45,120,214,96,147,38,109
"2011","Hackney 015D","E01001791","Total",500,153,55,98,201,92,138,38,100
"2011","Hackney 016A","E01001745","Total",958,310,99,211,295,132,224,57,167
"2011","Hackney 016B","E01001746","Total",632,221,94,127,306,134,149,55,94
"2011","Hackney 016C","E01001757","Total",654,202,74,128,272,137,164,51,113
"2011","Hackney 016D","E01001758","Total",884,299,89,210,293,149,225,70,155
"2011","Hackney 016E","E01001759","Total",750,232,58,174,182,90,214,56,158
"2011","Hackney 016F","E01001761","Total",869,327,52,275,177,71,273,46,227
"2011","Hackney 017A","E01001731","Total",1033,287,77,210,270,136,212,55,157
"2011","Hackney 017B","E01001734","Total",849,231,54,177,187,95,171,32,139
"2011","Hackney 017C","E01001760","Total",765,213,54,159,177,69,194,41,153
"2011","Hackney 017D","E01001762","Total",820,213,43,170,162,78,161,22,139
"2011","Hackney 018A","E01001846","Total",535,214,38,176,151,60,185,33,152
"2011","Hackney 018B","E01001847","Total",467,166,47,119,147,62,139,34,105
"2011","Hackney 018C","E01001848","Total",655,261,63,198,195,93,195,41,154
"2011","Hackney 018D","E01001849","Total",977,293,114,179,295,142,191,59,132
"2011","Hackney 019A","E01001729","Total",863,305,107,198,325,156,242,81,161
"2011","Hackney 019B","E01001730","Total",801,340,102,238,284,140,207,62,145
"2011","Hackney 019C","E01001732","Total",696,271,112,159,273,105,171,55,116
"2011","Hackney 019D","E01001735","Total",661,213,44,169,189,90,181,37,144
"2011","Hackney 019E","E01001838","Total",705,337,114,223,281,139,204,62,142
"2011","Hackney 019F","E01001850","Total",676,271,111,160,296,165,197,60,137
"2011","Hackney 020A","E01001748","Total",1090,251,46,205,184,76,199,31,168
"2011","Hackney 020B","E01001749","Total",743,163,31,132,178,94,126,20,106
"2011","Hackney 020C","E01001763","Total",742,231,46,185,183,85,173,28,145
"2011","Hackney 020D","E01001816","Total",640,182,47,135,207,86,141,37,104
"2011","Hackney 020E","E01001819","Total",684,209,31,178,173,69,195,35,160
"2011","Hackney 021B","E01001744","Total",786,231,44,187,195,77,213,39,174
"2011","Hackney 021C","E01001750","Total",782,206,44,162,183,67,167,36,131
"2011","Hackney 021D","E01001751","Total",676,108,10,98,116,55,91,6,85
"2011","Hackney 021E","E01001756","Total",987,225,25,200,139,79,158,22,136
"2011","Hackney 021F","E01033698","Total",613,290,54,236,140,60,239,45,194
"2011","Hackney 021G","E01033699","Total",585,117,18,99,90,49,83,18,65
"2011","Hackney 021H","E01033700","Total",697,139,33,106,97,63,102,23,79
"2011","Hackney 021I","E01033707","Total",614,155,27,128,100,41,146,27,119
"2011","Hackney 022A","E01001836","Total",857,251,52,199,236,113,212,45,167
"2011","Hackney 022B","E01001840","Total",715,276,78,198,240,96,200,43,157
"2011","Hackney 022C","E01001841","Total",626,212,38,174,169,77,179,26,153
"2011","Hackney 022D","E01001844","Total",812,259,49,210,197,96,145,30,115
"2011","Hackney 022E","E01001845","Total",680,282,77,205,214,83,225,46,179
"2011","Hackney 023B","E01001837","Total",665,116,21,95,152,89,119,18,101
"2011","Hackney 023C","E01001839","Total",941,211,66,145,217,100,147,38,109
"2011","Hackney 023D","E01001842","Total",631,195,71,124,232,90,168,59,109
"2011","Hackney 023E","E01001843","Total",502,155,42,113,181,68,126,32,94
"2011","Hackney 023F","E01033704","Total",763,90,28,62,149,84,87,36,51
"2011","Hackney 023G","E01033712","Total",661,149,59,90,181,96,113,24,89
"2011","Hackney 024A","E01001772","Total",459,197,52,145,144,63,144,36,108
"2011","Hackney 024B","E01001774","Total",875,221,91,130,248,120,155,49,106
"2011","Hackney 024C","E01001775","Total",759,293,85,208,223,97,219,53,166
"2011","Hackney 024D","E01001815","Total",692,264,66,198,209,86,225,54,171
"2011","Hackney 024E","E01001820","Total",599,224,53,171,164,63,194,39,155
"2011","Hackney 024F","E01001821","Total",644,255,61,194,178,73,211,40,171
"2011","Hackney 025A","E01001752","Total",1060,202,50,152,209,96,179,36,143
"2011","Hackney 025B","E01001753","Total",687,268,88,180,245,130,182,45,137
"2011","Hackney 025C","E01001754","Total",1135,307,88,219,259,123,225,57,168
"2011","Hackney 025D","E01001755","Total",724,247,85,162,256,117,177,63,114
"2011","Hackney 025E","E01001773","Total",860,285,77,208,226,100,219,53,166
"2011","Hackney 025F","E01001776","Total",634,261,48,213,148,59,243,35,208
"2011","Hackney 026A","E01001779","Total",1121,341,98,243,269,135,244,50,194
"2011","Hackney 026B","E01001781","Total",731,321,87,234,208,70,240,41,199
"2011","Hackney 026C","E01001782","Total",1053,225,66,159,226,94,190,50,140
"2011","Hackney 026D","E01001783","Total",863,348,86,262,256,113,240,54,186
"2011","Hackney 027B","E01001777","Total",1043,300,88,212,242,101,203,53,150
"2011","Hackney 027D","E01001780","Total",916,337,69,268,190,92,256,52,204
"2011","Hackney 027E","E01001784","Total",797,256,72,184,210,98,199,55,144
"2011","Hackney 027F","E01033706","Total",764,115,25,90,90,52,67,18,49
"2011","Hackney 027G","E01033708","Total",862,82,6,76,51,29,45,8,37
"2011","Hackney 027H","E01033709","Total",789,182,43,139,151,73,134,28,106
"2011","Hackney 027I","E01033711","Total",501,110,13,97,46,17,67,8,59
"2011","Hackney 028A","E01001798","Total",694,280,74,206,256,128,206,51,155
"2011","Hackney 028B","E01001828","Total",831,299,105,194,326,156,211,59,152
"2011","Hackney 028C","E01033702","Total",480,130,52,78,166,110,92,32,60
"2011","Hackney 028D","E01033705","Total",576,186,68,118,211,91,148,49,99
"2011","Hackney 028E","E01033710","Total",532,138,56,82,184,118,91,27,64
"2011","Hackney 029A","E01001722","Total",860,268,65,203,257,146,220,47,173
"2011","Hackney 029B","E01001728","Total",627,166,76,90,363,242,122,39,83
"2011","Hackney 029C","E01001822","Total",706,292,70,222,258,127,224,47,177
"2011","Hackney 029D","E01001827","Total",716,302,82,220,271,139,213,47,166
"2011","Hammersmith and Fulham 001A","E01001874","Total",966,296,51,245,185,88,216,32,184
"2011","Hammersmith and Fulham 001B","E01001875","Total",666,255,80,175,229,105,191,54,137
"2011","Hammersmith and Fulham 001C","E01001876","Total",834,263,109,154,267,126,160,58,102
"2011","Hammersmith and Fulham 001D","E01001877","Total",603,157,30,127,151,73,141,25,116
"2011","Hammersmith and Fulham 001E","E01001878","Total",605,223,81,142,241,99,153,41,112
"2011","Hammersmith and Fulham 002A","E01001955","Total",674,260,94,166,259,115,209,63,146
"2011","Hammersmith and Fulham 002B","E01001957","Total",605,217,88,129,261,103,186,64,122
"2011","Hammersmith and Fulham 002C","E01001958","Total",614,220,88,132,264,113,182,62,120
"2011","Hammersmith and Fulham 002D","E01001961","Total",540,201,84,117,251,123,166,49,117
"2011","Hammersmith and Fulham 003A","E01001954","Total",649,221,51,170,184,98,189,39,150
"2011","Hammersmith and Fulham 003B","E01001956","Total",603,187,44,143,192,77,154,35,119
"2011","Hammersmith and Fulham 003C","E01001959","Total",588,209,68,141,213,90,180,45,135
"2011","Hammersmith and Fulham 003D","E01001960","Total",750,153,41,112,174,108,112,16,96
"2011","Hammersmith and Fulham 004A","E01001943","Total",905,230,50,180,160,85,176,25,151
"2011","Hammersmith and Fulham 004B","E01001944","Total",869,387,76,311,193,94,274,43,231
"2011","Hammersmith and Fulham 004C","E01001945","Total",754,199,36,163,184,104,168,28,140
"2011","Hammersmith and Fulham 004D","E01001946","Total",702,174,36,138,159,81,152,28,124
"2011","Hammersmith and Fulham 005A","E01001862","Total",830,244,53,191,192,97,215,40,175
"2011","Hammersmith and Fulham 005B","E01001940","Total",740,225,48,177,167,82,183,31,152
"2011","Hammersmith and Fulham 005C","E01001941","Total",717,118,24,94,111,49,102,17,85
"2011","Hammersmith and Fulham 005D","E01001942","Total",865,195,22,173,171,105,165,19,146
"2011","Hammersmith and Fulham 006A","E01001858","Total",732,209,38,171,166,71,180,38,142
"2011","Hammersmith and Fulham 006B","E01001860","Total",795,267,60,207,188,90,191,35,156
"2011","Hammersmith and Fulham 006C","E01001861","Total",654,182,39,143,171,90,146,23,123
"2011","Hammersmith and Fulham 006D","E01001863","Total",671,142,28,114,161,93,112,21,91
"2011","Hammersmith and Fulham 006E","E01001864","Total",761,219,20,199,156,88,176,24,152
"2011","Hammersmith and Fulham 007A","E01001852","Total",956,167,18,149,113,60,122,10,112
"2011","Hammersmith and Fulham 007B","E01001853","Total",695,116,15,101,146,68,93,12,81
"2011","Hammersmith and Fulham 007C","E01001854","Total",887,194,29,165,146,79,145,19,126
"2011","Hammersmith and Fulham 007D","E01001857","Total",733,265,48,217,150,77,227,37,190
"2011","Hammersmith and Fulham 008A","E01001859","Total",1140,263,91,172,334,196,184,55,129
"2011","Hammersmith and Fulham 008B","E01001865","Total",651,136,29,107,186,101,121,23,98
"2011","Hammersmith and Fulham 008C","E01001927","Total",557,128,10,118,167,60,105,14,91
"2011","Hammersmith and Fulham 008D","E01001930","Total",842,295,34,261,168,69,250,27,223
"2011","Hammersmith and Fulham 009A","E01001895","Total",674,143,23,120,175,85,140,19,121
"2011","Hammersmith and Fulham 009B","E01001896","Total",669,174,31,143,124,54,126,16,110
"2011","Hammersmith and Fulham 009C","E01001897","Total",619,120,22,98,187,92,118,24,94
"2011","Hammersmith and Fulham 009D","E01001929","Total",597,126,10,116,148,89,89,12,77
"2011","Hammersmith and Fulham 010A","E01001851","Total",696,106,12,94,189,118,100,13,87
"2011","Hammersmith and Fulham 010B","E01001855","Total",894,171,20,151,141,82,99,19,80
"2011","Hammersmith and Fulham 010C","E01001856","Total",730,189,40,149,201,79,160,29,131
"2011","Hammersmith and Fulham 010D","E01001869","Total",574,123,8,115,145,63,89,5,84
"2011","Hammersmith and Fulham 010E","E01001873","Total",689,178,38,140,167,78,154,37,117
"2011","Hammersmith and Fulham 011A","E01001928","Total",722,205,28,177,227,97,170,29,141
"2011","Hammersmith and Fulham 011B","E01001931","Total",709,194,56,138,180,90,137,34,103
"2011","Hammersmith and Fulham 011C","E01001932","Total",757,181,33,148,140,73,136,19,117
"2011","Hammersmith and Fulham 011D","E01001933","Total",635,179,30,149,135,49,122,19,103
"2011","Hammersmith and Fulham 012A","E01001866","Total",704,172,16,156,139,53,129,15,114
"2011","Hammersmith and Fulham 012B","E01001867","Total",612,197,8,189,75,41,119,6,113
"2011","Hammersmith and Fulham 012C","E01001868","Total",603,204,49,155,165,61,162,39,123
"2011","Hammersmith and Fulham 012D","E01001870","Total",1009,241,25,216,120,64,145,24,121
"2011","Hammersmith and Fulham 012E","E01001871","Total",769,219,14,205,100,42,116,10,106
"2011","Hammersmith and Fulham 012F","E01001872","Total",759,178,14,164,112,65,105,17,88
"2011","Hammersmith and Fulham 013A","E01001893","Total",504,168,48,120,147,51,115,21,94
"2011","Hammersmith and Fulham 013B","E01001894","Total",602,192,40,152,115,47,167,22,145
"2011","Hammersmith and Fulham 013C","E01001898","Total",736,160,16,144,133,71,122,20,102
"2011","Hammersmith and Fulham 013D","E01001899","Total",691,297,53,244,141,58,230,33,197
"2011","Hammersmith and Fulham 013E","E01001900","Total",723,230,42,188,168,73,180,39,141
"2011","Hammersmith and Fulham 014A","E01001889","Total",593,139,15,124,107,60,101,13,88
"2011","Hammersmith and Fulham 014B","E01001910","Total",840,174,16,158,84,39,115,11,104
"2011","Hammersmith and Fulham 014C","E01001913","Total",774,108,8,100,72,47,79,8,71
"2011","Hammersmith and Fulham 014D","E01001914","Total",887,181,17,164,93,58,117,9,108
"2011","Hammersmith and Fulham 015A","E01001885","Total",538,210,60,150,193,68,174,41,133
"2011","Hammersmith and Fulham 015B","E01001908","Total",875,190,24,166,98,61,99,8,91
"2011","Hammersmith and Fulham 015C","E01001909","Total",821,216,28,188,161,71,187,31,156
"2011","Hammersmith and Fulham 015D","E01001911","Total",751,251,76,175,239,102,210,49,161
"2011","Hammersmith and Fulham 015E","E01001912","Total",600,203,62,141,191,75,156,48,108
"2011","Hammersmith and Fulham 016A","E01001886","Total",628,192,51,141,174,86,126,39,87
"2011","Hammersmith and Fulham 016B","E01001887","Total",658,224,32,192,130,43,183,26,157
"2011","Hammersmith and Fulham 016C","E01001890","Total",950,235,18,217,128,81,98,11,87
"2011","Hammersmith and Fulham 016D","E01001892","Total",605,192,40,152,147,72,166,37,129
"2011","Hammersmith and Fulham 017A","E01001880","Total",757,214,23,191,127,59,156,27,129
"2011","Hammersmith and Fulham 017B","E01001881","Total",681,128,13,115,137,72,100,10,90
"2011","Hammersmith and Fulham 017C","E01001882","Total",702,112,11,101,126,85,85,18,67
"2011","Hammersmith and Fulham 017D","E01001883","Total",734,240,35,205,107,44,143,17,126
"2011","Hammersmith and Fulham 017E","E01001884","Total",931,307,32,275,155,79,232,19,213
"2011","Hammersmith and Fulham 018A","E01001888","Total",644,177,9,168,135,73,164,19,145
"2011","Hammersmith and Fulham 018B","E01001891","Total",863,178,21,157,127,78,101,18,83
"2011","Hammersmith and Fulham 018C","E01001917","Total",684,199,8,191,128,67,176,11,165
"2011","Hammersmith and Fulham 018D","E01001918","Total",622,135,21,114,181,106,103,20,83
"2011","Hammersmith and Fulham 018E","E01001919","Total",639,166,18,148,211,86,112,18,94
"2011","Hammersmith and Fulham 019A","E01001879","Total",633,196,25,171,127,51,137,21,116
"2011","Hammersmith and Fulham 019B","E01001901","Total",695,134,20,114,188,110,95,14,81
"2011","Hammersmith and Fulham 019C","E01001902","Total",814,214,24,190,123,61,163,19,144
"2011","Hammersmith and Fulham 019D","E01001903","Total",681,202,43,159,175,89,157,33,124
"2011","Hammersmith and Fulham 020A","E01001920","Total",828,343,32,311,111,49,263,14,249
"2011","Hammersmith and Fulham 020B","E01001921","Total",663,153,19,134,163,79,109,20,89
"2011","Hammersmith and Fulham 020C","E01001922","Total",671,142,15,127,177,91,94,17,77
"2011","Hammersmith and Fulham 020D","E01001923","Total",653,161,23,138,155,72,113,18,95
"2011","Hammersmith and Fulham 020E","E01001924","Total",604,98,13,85,183,96,67,10,57
"2011","Hammersmith and Fulham 021A","E01001947","Total",591,214,87,127,227,91,184,57,127
"2011","Hammersmith and Fulham 021B","E01001948","Total",922,158,45,113,209,115,115,24,91
"2011","Hammersmith and Fulham 021C","E01001949","Total",658,95,17,78,163,84,72,14,58
"2011","Hammersmith and Fulham 021D","E01001950","Total",636,95,12,83,177,104,59,7,52
"2011","Hammersmith and Fulham 021E","E01001951","Total",705,155,22,133,143,68,115,19,96
"2011","Hammersmith and Fulham 021F","E01001953","Total",610,167,27,140,111,46,135,21,114
"2011","Hammersmith and Fulham 022A","E01001904","Total",681,119,14,105,148,92,98,16,82
"2011","Hammersmith and Fulham 022B","E01001905","Total",750,156,10,146,159,101,132,13,119
"2011","Hammersmith and Fulham 022C","E01001906","Total",656,114,14,100,107,61,91,11,80
"2011","Hammersmith and Fulham 022D","E01001907","Total",563,89,10,79,140,76,77,13,64
"2011","Hammersmith and Fulham 023A","E01001935","Total",927,219,32,187,213,115,195,30,165
"2011","Hammersmith and Fulham 023C","E01001939","Total",985,325,70,255,229,94,221,31,190
"2011","Hammersmith and Fulham 023D","E01032788","Total",496,116,29,87,138,63,105,16,89
"2011","Hammersmith and Fulham 023E","E01032789","Total",586,110,33,77,137,70,69,20,49
"2011","Hammersmith and Fulham 023F","E01032790","Total",557,190,46,144,151,81,88,16,72
"2011","Hammersmith and Fulham 024A","E01001915","Total",608,152,12,140,175,75,109,14,95
"2011","Hammersmith and Fulham 024B","E01001916","Total",689,219,10,209,111,45,133,8,125
"2011","Hammersmith and Fulham 024C","E01001926","Total",613,110,9,101,148,92,73,13,60
"2011","Hammersmith and Fulham 024D","E01001952","Total",809,163,17,146,98,64,127,12,115
"2011","Hammersmith and Fulham 025A","E01001925","Total",624,107,12,95,212,106,69,14,55
"2011","Hammersmith and Fulham 025B","E01001934","Total",699,223,46,177,204,81,174,42,132
"2011","Hammersmith and Fulham 025C","E01001937","Total",760,153,20,133,183,106,98,17,81
"2011","Hammersmith and Fulham 025D","E01001938","Total",616,165,62,103,209,111,123,34,89
"2011","Haringey 001A","E01001969","Total",857,280,65,215,220,129,206,35,171
"2011","Haringey 001B","E01001971","Total",784,321,102,219,286,101,244,70,174
"2011","Haringey 001C","E01001974","Total",959,237,30,207,238,120,175,36,139
"2011","Haringey 001D","E01001975","Total",776,166,30,136,201,113,116,24,92
"2011","Haringey 002A","E01002036","Total",637,263,84,179,253,98,186,51,135
"2011","Haringey 002B","E01002037","Total",697,297,83,214,241,121,204,51,153
"2011","Haringey 002C","E01002039","Total",639,304,139,165,306,118,188,59,129
"2011","Haringey 002D","E01002040","Total",740,258,90,168,307,147,198,63,135
"2011","Haringey 004A","E01001962","Total",641,148,25,123,269,120,129,32,97
"2011","Haringey 004B","E01001970","Total",728,214,76,138,276,98,185,56,129
"2011","Haringey 004C","E01001972","Total",749,226,51,175,204,88,207,40,167
"2011","Haringey 004D","E01001973","Total",943,261,56,205,297,127,238,46,192
"2011","Haringey 005A","E01002090","Total",531,163,50,113,229,87,150,52,98
"2011","Haringey 005B","E01002093","Total",645,266,91,175,281,93,218,71,147
"2011","Haringey 005C","E01002096","Total",583,242,76,166,257,87,203,60,143
"2011","Haringey 005D","E01002097","Total",592,197,103,94,310,104,155,60,95
"2011","Haringey 006A","E01002091","Total",635,333,110,223,253,93,230,67,163
"2011","Haringey 006B","E01002092","Total",689,235,105,130,284,138,157,39,118
"2011","Haringey 006C","E01002094","Total",541,182,78,104,255,93,159,61,98
"2011","Haringey 006D","E01002095","Total",604,211,90,121,282,106,173,60,113
"2011","Haringey 007A","E01002098","Total",604,147,26,121,141,65,140,27,113
"2011","Haringey 007B","E01002101","Total",698,186,45,141,215,115,134,36,98
"2011","Haringey 007C","E01002102","Total",752,202,56,146,207,107,153,27,126
"2011","Haringey 007D","E01002105","Total",861,240,50,190,207,115,186,48,138
"2011","Haringey 008A","E01002099","Total",813,341,108,233,299,133,254,67,187
"2011","Haringey 008B","E01002100","Total",680,207,66,141,256,130,162,50,112
"2011","Haringey 008C","E01002103","Total",646,178,52,126,213,98,141,43,98
"2011","Haringey 008D","E01002104","Total",501,141,38,103,165,67,131,32,99
"2011","Haringey 009A","E01001963","Total",691,141,24,117,254,110,134,39,95
"2011","Haringey 009B","E01001964","Total",667,106,21,85,198,89,90,29,61
"2011","Haringey 009C","E01001965","Total",657,109,17,92,239,108,130,33,97
"2011","Haringey 009D","E01001966","Total",535,93,11,82,205,70,105,26,79
"2011","Haringey 010A","E01002027","Total",552,178,51,127,171,74,145,42,103
"2011","Haringey 010B","E01002028","Total",645,184,63,121,200,68,158,42,116
"2011","Haringey 010C","E01002032","Total",759,268,98,170,273,110,236,69,167
"2011","Haringey 010D","E01002033","Total",709,247,93,154,265,109,200,64,136
"2011","Haringey 011A","E01001976","Total",635,197,63,134,262,113,156,36,120
"2011","Haringey 011B","E01001977","Total",605,206,64,142,235,108,161,45,116
"2011","Haringey 011C","E01001978","Total",819,306,79,227,284,117,221,60,161
"2011","Haringey 011D","E01001979","Total",846,320,118,202,320,147,199,74,125
"2011","Haringey 012A","E01002074","Total",849,322,106,216,357,163,233,63,170
"2011","Haringey 012B","E01002077","Total",686,243,113,130,336,150,163,66,97
"2011","Haringey 012C","E01002079","Total",539,165,67,98,234,108,106,30,76
"2011","Haringey 012D","E01002081","Total",615,274,69,205,219,90,214,57,157
"2011","Haringey 013A","E01002082","Total",568,238,87,151,260,71,186,54,132
"2011","Haringey 013B","E01002086","Total",605,172,45,127,194,73,161,37,124
"2011","Haringey 013C","E01002088","Total",688,217,52,165,204,95,155,31,124
"2011","Haringey 013D","E01002089","Total",644,287,85,202,263,92,182,53,129
"2011","Haringey 014A","E01001967","Total",633,111,13,98,220,76,105,19,86
"2011","Haringey 014B","E01001968","Total",778,150,13,137,214,84,145,17,128
"2011","Haringey 014C","E01001996","Total",698,143,15,128,210,78,134,27,107
"2011","Haringey 014D","E01001997","Total",730,120,11,109,157,72,109,19,90
"2011","Haringey 015A","E01002075","Total",595,196,85,111,264,113,133,44,89
"2011","Haringey 015B","E01002076","Total",639,222,97,125,283,121,185,64,121
"2011","Haringey 015C","E01002078","Total",951,305,96,209,309,132,244,66,178
"2011","Haringey 015D","E01002080","Total",510,137,32,105,154,80,125,26,99
"2011","Haringey 016A","E01002026","Total",711,317,76,241,227,87,257,63,194
"2011","Haringey 016B","E01002029","Total",740,237,73,164,228,105,192,54,138
"2011","Haringey 016C","E01002030","Total",658,178,49,129,177,78,148,36,112
"2011","Haringey 016D","E01002031","Total",764,219,41,178,185,92,180,34,146
"2011","Haringey 017A","E01001991","Total",766,116,24,92,215,92,91,14,77
"2011","Haringey 017B","E01001992","Total",672,143,7,136,202,70,131,21,110
"2011","Haringey 017C","E01001993","Total",609,151,9,142,257,99,131,25,106
"2011","Haringey 017D","E01001995","Total",898,243,78,165,391,173,211,73,138
"2011","Haringey 018A","E01001980","Total",673,198,60,138,273,117,171,57,114
"2011","Haringey 018B","E01001981","Total",601,165,53,112,214,86,137,45,92
"2011","Haringey 018C","E01001982","Total",676,207,60,147,222,108,174,39,135
"2011","Haringey 018D","E01001983","Total",612,159,43,116,234,88,143,44,99
"2011","Haringey 019A","E01002083","Total",543,162,21,141,114,52,137,21,116
"2011","Haringey 019B","E01002084","Total",619,182,28,154,168,78,146,33,113
"2011","Haringey 019C","E01002085","Total",821,232,65,167,244,124,183,45,138
"2011","Haringey 019D","E01002087","Total",714,230,46,184,179,90,191,31,160
"2011","Haringey 020B","E01002014","Total",797,181,41,140,172,84,130,22,108
"2011","Haringey 020C","E01002015","Total",668,234,39,195,158,54,189,29,160
"2011","Haringey 020D","E01002018","Total",602,197,42,155,216,89,165,37,128
"2011","Haringey 020E","E01033085","Total",908,168,51,117,186,83,139,32,107
"2011","Haringey 020F","E01033086","Total",488,227,76,151,169,64,188,55,133
"2011","Haringey 021A","E01002020","Total",706,159,32,127,189,75,127,29,98
"2011","Haringey 021B","E01002022","Total",867,115,10,105,152,65,108,18,90
"2011","Haringey 021C","E01002023","Total",609,154,12,142,190,68,124,19,105
"2011","Haringey 021D","E01002025","Total",670,108,12,96,234,100,85,21,64
"2011","Haringey 022A","E01002013","Total",595,119,22,97,198,100,111,31,80
"2011","Haringey 022B","E01002019","Total",503,104,5,99,158,59,90,15,75
"2011","Haringey 022C","E01002021","Total",603,144,16,128,175,66,125,19,106
"2011","Haringey 022D","E01002024","Total",534,130,12,118,170,65,126,19,107
"2011","Haringey 023A","E01001998","Total",865,182,23,159,174,97,146,21,125
"2011","Haringey 023B","E01001999","Total",819,208,45,163,183,109,164,22,142
"2011","Haringey 023C","E01002003","Total",929,297,82,215,263,123,181,36,145
"2011","Haringey 023D","E01002004","Total",710,168,29,139,185,94,147,30,117
"2011","Haringey 024A","E01002067","Total",700,267,65,202,221,100,207,49,158
"2011","Haringey 024B","E01002069","Total",880,317,37,280,211,87,244,43,201
"2011","Haringey 024C","E01002070","Total",789,205,66,139,264,118,175,39,136
"2011","Haringey 024D","E01002073","Total",681,225,63,162,244,130,204,54,150
"2011","Haringey 025A","E01002066","Total",781,264,94,170,307,126,233,65,168
"2011","Haringey 025B","E01002068","Total",739,233,51,182,197,105,174,30,144
"2011","Haringey 025C","E01002071","Total",675,266,99,167,250,98,190,42,148
"2011","Haringey 025D","E01002072","Total",680,236,75,161,213,100,192,45,147
"2011","Haringey 026A","E01002043","Total",742,198,68,130,258,152,167,41,126
"2011","Haringey 026B","E01002045","Total",803,222,65,157,283,132,203,51,152
"2011","Haringey 026C","E01002046","Total",676,244,55,189,221,89,202,41,161
"2011","Haringey 026D","E01002049","Total",705,220,58,162,245,98,184,54,130
"2011","Haringey 027A","E01002042","Total",541,121,13,108,140,68,126,24,102
"2011","Haringey 027B","E01002044","Total",693,170,18,152,151,77,127,32,95
"2011","Haringey 027C","E01002047","Total",592,147,21,126,116,62,132,28,104
"2011","Haringey 027D","E01002048","Total",690,189,50,139,208,103,161,38,123
"2011","Haringey 028A","E01002016","Total",864,199,45,154,247,99,188,33,155
"2011","Haringey 028B","E01002017","Total",751,136,24,112,184,92,121,21,100
"2011","Haringey 028C","E01002059","Total",710,211,46,165,237,98,188,50,138
"2011","Haringey 028D","E01002060","Total",763,124,17,107,218,94,116,22,94
"2011","Haringey 029A","E01002050","Total",467,97,32,65,251,148,99,33,66
"2011","Haringey 029B","E01002051","Total",667,196,44,152,207,96,147,33,114
"2011","Haringey 029C","E01002052","Total",526,125,35,90,268,171,137,47,90
"2011","Haringey 029D","E01002055","Total",456,94,26,68,208,135,94,25,69
"2011","Haringey 030A","E01001994","Total",760,171,16,155,175,70,148,25,123
"2011","Haringey 030B","E01002008","Total",643,166,15,151,188,72,128,21,107
"2011","Haringey 030C","E01002010","Total",718,191,31,160,206,93,170,40,130
"2011","Haringey 030D","E01002011","Total",761,161,23,138,170,83,139,28,111
"2011","Haringey 031A","E01002000","Total",690,137,26,111,186,112,134,28,106
"2011","Haringey 031B","E01002001","Total",677,126,20,106,133,62,130,27,103
"2011","Haringey 031C","E01002002","Total",781,183,45,138,179,87,153,36,117
"2011","Haringey 031D","E01002058","Total",681,162,36,126,165,77,136,31,105
"2011","Haringey 032A","E01002053","Total",663,234,60,174,226,84,190,46,144
"2011","Haringey 032B","E01002054","Total",697,273,99,174,284,118,215,53,162
"2011","Haringey 032C","E01002056","Total",841,269,63,206,228,105,230,46,184
"2011","Haringey 032D","E01002057","Total",557,159,57,102,181,80,132,39,93
"2011","Haringey 033A","E01001984","Total",867,186,10,176,151,85,137,15,122
"2011","Haringey 033B","E01001985","Total",769,137,9,128,187,98,106,17,89
"2011","Haringey 033C","E01001987","Total",805,144,11,133,211,96,101,19,82
"2011","Haringey 033D","E01001989","Total",766,157,13,144,213,98,128,21,107
"2011","Haringey 034A","E01001986","Total",744,129,14,115,196,94,103,18,85
"2011","Haringey 034B","E01001988","Total",881,158,17,141,178,90,152,21,131
"2011","Haringey 034C","E01001990","Total",982,123,17,106,168,87,139,22,117
"2011","Haringey 034D","E01002062","Total",855,121,20,101,174,81,134,33,101
"2011","Haringey 035A","E01002005","Total",818,84,15,69,154,92,82,15,67
"2011","Haringey 035B","E01002006","Total",808,129,20,109,150,76,102,21,81
"2011","Haringey 035C","E01002007","Total",799,193,12,181,148,67,123,19,104
"2011","Haringey 035D","E01002009","Total",708,125,9,116,168,74,98,11,87
"2011","Haringey 036A","E01002061","Total",703,105,22,83,165,78,113,32,81
"2011","Haringey 036B","E01002063","Total",713,162,40,122,187,84,127,34,93
"2011","Haringey 036C","E01002064","Total",648,158,50,108,164,64,142,32,110
"2011","Haringey 036D","E01002065","Total",815,156,17,139,114,61,161,21,140
"2011","Haringey 037A","E01002034","Total",811,355,118,237,306,140,234,55,179
"2011","Haringey 037B","E01002038","Total",692,314,113,201,276,106,197,48,149
"2011","Haringey 037C","E01002041","Total",736,321,106,215,279,140,215,47,168
"2011","Haringey 037D","E01032575","Total",672,231,102,129,299,142,165,65,100
"2011","Islington 001A","E01002755","Total",635,261,62,199,170,74,216,48,168
"2011","Islington 001B","E01002756","Total",610,155,25,130,139,56,144,24,120
"2011","Islington 001C","E01002758","Total",709,277,94,183,226,115,198,54,144
"2011","Islington 001D","E01002804","Total",754,261,74,187,221,83,204,47,157
"2011","Islington 001E","E01002807","Total",824,270,64,206,212,88,207,30,177
"2011","Islington 001F","E01002811","Total",694,252,66,186,225,127,187,34,153
"2011","Islington 002A","E01002753","Total",626,194,36,158,134,57,152,24,128
"2011","Islington 002B","E01002754","Total",614,137,28,109,172,74,121,17,104
"2011","Islington 002C","E01002757","Total",590,180,65,115,220,101,140,43,97
"2011","Islington 002D","E01002759","Total",659,146,29,117,166,71,140,27,113
"2011","Islington 002E","E01002760","Total",626,266,88,178,209,96,212,60,152
"2011","Islington 002F","E01002772","Total",871,256,51,205,183,98,200,34,166
"2011","Islington 003A","E01002735","Total",777,218,48,170,163,71,204,38,166
"2011","Islington 003B","E01002805","Total",758,186,32,154,123,57,142,26,116
"2011","Islington 003C","E01002806","Total",721,216,33,183,169,77,195,36,159
"2011","Islington 003D","E01002808","Total",857,241,57,184,195,109,192,35,157
"2011","Islington 003E","E01002809","Total",700,210,52,158,195,94,173,44,129
"2011","Islington 003F","E01002810","Total",748,252,49,203,198,97,206,40,166
"2011","Islington 004A","E01002768","Total",851,279,41,238,162,71,226,24,202
"2011","Islington 004B","E01002770","Total",718,199,45,154,142,61,163,20,143
"2011","Islington 004C","E01002771","Total",659,187,47,140,186,77,160,34,126
"2011","Islington 004D","E01002773","Total",696,315,51,264,146,69,293,39,254
"2011","Islington 004E","E01002774","Total",1005,295,53,242,223,101,249,53,196
"2011","Islington 005A","E01002732","Total",821,314,75,239,221,95,302,76,226
"2011","Islington 005B","E01002734","Total",696,272,97,175,271,139,183,60,123
"2011","Islington 005C","E01002736","Total",595,265,72,193,198,88,182,43,139
"2011","Islington 005D","E01002737","Total",788,336,120,216,286,158,253,54,199
"2011","Islington 005E","E01002751","Total",880,316,79,237,217,114,213,42,171
"2011","Islington 006A","E01002742","Total",675,113,18,95,163,83,118,24,94
"2011","Islington 006B","E01002747","Total",675,137,17,120,160,77,153,36,117
"2011","Islington 006C","E01002748","Total",667,223,59,164,178,78,178,39,139
"2011","Islington 006D","E01002749","Total",534,156,56,100,188,90,118,28,90
"2011","Islington 006F","E01033493","Total",701,51,5,46,52,30,45,6,39
"2011","Islington 006G","E01033494","Total",630,124,11,113,125,72,93,13,80
"2011","Islington 007A","E01002730","Total",812,274,44,230,135,69,191,22,169
"2011","Islington 007B","E01002731","Total",1164,272,52,220,190,88,207,37,170
"2011","Islington 007C","E01002733","Total",598,109,22,87,116,61,95,15,80
"2011","Islington 007D","E01002763","Total",603,212,21,191,95,42,176,14,162
"2011","Islington 008A","E01002769","Total",847,289,26,263,179,72,170,28,142
"2011","Islington 008B","E01002785","Total",840,250,47,203,237,117,165,34,131
"2011","Islington 008C","E01002788","Total",916,232,25,207,171,85,178,27,151
"2011","Islington 008D","E01002789","Total",810,141,21,120,208,97,151,30,121
"2011","Islington 009A","E01002738","Total",839,256,40,216,187,90,193,32,161
"2011","Islington 009B","E01002741","Total",656,258,60,198,197,85,215,51,164
"2011","Islington 009C","E01002743","Total",726,211,57,154,195,89,138,37,101
"2011","Islington 009D","E01002744","Total",722,176,14,162,135,63,170,18,152
"2011","Islington 009E","E01002752","Total",651,189,51,138,172,64,156,38,118
"2011","Islington 010A","E01002764","Total",796,266,67,199,200,72,229,41,188
"2011","Islington 010B","E01002783","Total",718,268,61,207,139,66,239,39,200
"2011","Islington 010C","E01002784","Total",732,246,70,176,215,99,196,52,144
"2011","Islington 010D","E01002786","Total",828,281,61,220,191,93,249,32,217
"2011","Islington 010E","E01002787","Total",578,174,40,134,124,46,140,24,116
"2011","Islington 011C","E01002762","Total",889,211,33,178,159,69,193,32,161
"2011","Islington 011D","E01002767","Total",982,367,74,293,230,85,285,39,246
"2011","Islington 011E","E01033486","Total",425,128,43,85,105,39,110,32,78
"2011","Islington 011F","E01033487","Total",595,81,31,50,96,63,42,7,35
"2011","Islington 011G","E01033488","Total",557,190,33,157,114,47,139,28,111
"2011","Islington 011H","E01033491","Total",869,231,45,186,138,68,169,25,144
"2011","Islington 011I","E01033492","Total",687,88,28,60,91,60,72,20,52
"2011","Islington 012A","E01002777","Total",833,213,28,185,136,63,199,36,163
"2011","Islington 012B","E01002778","Total",743,338,129,209,263,143,216,65,151
"2011","Islington 012C","E01002779","Total",820,174,40,134,175,92,154,28,126
"2011","Islington 012D","E01002781","Total",598,198,59,139,167,64,159,50,109
"2011","Islington 012E","E01002782","Total",616,252,102,150,237,96,190,61,129
"2011","Islington 013A","E01002739","Total",816,183,21,162,192,106,179,30,149
"2011","Islington 013B","E01002740","Total",806,139,15,124,194,97,133,20,113
"2011","Islington 013C","E01002745","Total",681,161,26,135,145,57,139,23,116
"2011","Islington 013D","E01002795","Total",863,187,50,137,195,75,164,46,118
"2011","Islington 013E","E01002796","Total",496,127,18,109,90,28,109,24,85
"2011","Islington 014A","E01002716","Total",1079,412,124,288,287,113,295,77,218
"2011","Islington 014B","E01002718","Total",799,153,16,137,121,53,131,18,113
"2011","Islington 014C","E01002721","Total",839,258,60,198,170,77,201,31,170
"2011","Islington 014D","E01002775","Total",683,136,26,110,116,53,139,17,122
"2011","Islington 014E","E01002776","Total",774,241,76,165,210,88,183,33,150
"2011","Islington 014F","E01002780","Total",763,209,50,159,175,92,180,45,135
"2011","Islington 015A","E01002708","Total",917,322,78,244,181,82,213,36,177
"2011","Islington 015B","E01002712","Total",535,163,34,129,117,54,134,36,98
"2011","Islington 015C","E01002713","Total",820,402,63,339,168,73,322,41,281
"2011","Islington 015D","E01002765","Total",980,364,115,249,281,120,290,79,211
"2011","Islington 015E","E01002766","Total",811,353,77,276,198,76,255,58,197
"2011","Islington 016A","E01002717","Total",590,171,27,144,141,62,147,29,118
"2011","Islington 016B","E01002719","Total",737,209,27,182,141,65,170,29,141
"2011","Islington 016C","E01002720","Total",993,406,156,250,363,152,297,88,209
"2011","Islington 016D","E01002790","Total",706,279,57,222,147,69,220,39,181
"2011","Islington 016E","E01002791","Total",762,192,30,162,129,59,147,18,129
"2011","Islington 016F","E01002793","Total",957,317,67,250,192,89,261,48,213
"2011","Islington 017A","E01002698","Total",1056,238,50,188,189,92,199,39,160
"2011","Islington 017B","E01002699","Total",775,208,31,177,132,56,155,27,128
"2011","Islington 017C","E01002700","Total",640,114,16,98,140,65,90,16,74
"2011","Islington 017D","E01002714","Total",771,142,22,120,160,70,128,25,103
"2011","Islington 017E","E01002792","Total",877,178,33,145,170,81,131,23,108
"2011","Islington 018A","E01002722","Total",668,259,51,208,146,56,216,37,179
"2011","Islington 018B","E01002797","Total",872,286,57,229,174,78,217,37,180
"2011","Islington 018C","E01002798","Total",922,216,33,183,175,91,191,37,154
"2011","Islington 018D","E01002799","Total",880,326,95,231,225,108,231,42,189
"2011","Islington 018E","E01002800","Total",435,190,68,122,157,53,148,42,106
"2011","Islington 019A","E01002694","Total",669,272,100,172,222,83,220,67,153
"2011","Islington 019B","E01002697","Total",709,295,57,238,192,89,227,50,177
"2011","Islington 019C","E01002709","Total",751,279,62,217,159,63,203,41,162
"2011","Islington 019D","E01002710","Total",679,236,63,173,202,88,184,34,150
"2011","Islington 019E","E01002715","Total",682,288,76,212,195,100,199,46,153
"2011","Islington 020A","E01002696","Total",895,192,32,160,150,79,161,29,132
"2011","Islington 020B","E01002794","Total",862,207,22,185,129,54,186,20,166
"2011","Islington 020C","E01002801","Total",806,188,24,164,126,55,139,19,120
"2011","Islington 020D","E01002802","Total",706,155,22,133,125,61,139,19,120
"2011","Islington 020E","E01002803","Total",935,234,37,197,168,77,203,38,165
"2011","Islington 021A","E01002695","Total",795,203,46,157,121,60,143,24,119
"2011","Islington 021B","E01002711","Total",963,227,42,185,145,67,166,26,140
"2011","Islington 021C","E01002727","Total",871,243,41,202,137,60,189,19,170
"2011","Islington 021D","E01002728","Total",509,178,29,149,101,47,140,22,118
"2011","Islington 021E","E01002729","Total",702,190,24,166,123,60,152,19,133
"2011","Islington 022B","E01002707","Total",901,309,39,270,116,56,156,23,133
"2011","Islington 022C","E01002723","Total",781,307,45,262,159,73,212,44,168
"2011","Islington 022D","E01002724","Total",1025,204,15,189,93,55,114,12,102
"2011","Islington 022E","E01002725","Total",572,192,42,150,134,58,165,29,136
"2011","Islington 022F","E01002726","Total",825,243,56,187,165,80,188,38,150
"2011","Islington 022G","E01033489","Total",776,175,15,160,62,45,56,6,50
"2011","Islington 022H","E01033490","Total",703,242,44,198,111,65,102,26,76
"2011","Islington 023A","E01002701","Total",718,263,51,212,145,58,189,24,165
"2011","Islington 023B","E01002702","Total",870,334,76,258,215,96,205,36,169
"2011","Islington 023C","E01002703","Total",774,283,65,218,174,75,188,38,150
"2011","Islington 023D","E01002704","Total",1035,319,54,265,206,109,217,33,184
"2011","Islington 023E","E01002706","Total",925,311,71,240,219,113,201,42,159
"2011","Kensington and Chelsea 001A","E01002852","Total",861,304,92,212,252,96,228,45,183
"2011","Kensington and Chelsea 001B","E01002853","Total",470,210,49,161,137,49,176,47,129
"2011","Kensington and Chelsea 001C","E01002854","Total",488,208,47,161,149,55,160,36,124
"2011","Kensington and Chelsea 001D","E01002855","Total",764,298,60,238,194,71,246,39,207
"2011","Kensington and Chelsea 001E","E01002857","Total",580,242,73,169,193,66,211,49,162
"2011","Kensington and Chelsea 002A","E01002904","Total",524,238,52,186,175,50,191,41,150
"2011","Kensington and Chelsea 002B","E01002905","Total",672,251,66,185,194,77,235,48,187
"2011","Kensington and Chelsea 002C","E01002906","Total",707,249,57,192,199,62,210,51,159
"2011","Kensington and Chelsea 002D","E01002907","Total",551,257,94,163,237,87,200,60,140
"2011","Kensington and Chelsea 003A","E01002876","Total",744,231,28,203,195,84,190,29,161
"2011","Kensington and Chelsea 003B","E01002877","Total",647,238,100,138,279,99,204,65,139
"2011","Kensington and Chelsea 003C","E01002878","Total",868,248,32,216,155,59,195,24,171
"2011","Kensington and Chelsea 003D","E01002908","Total",602,186,31,155,161,82,133,19,114
"2011","Kensington and Chelsea 003E","E01002909","Total",1152,318,34,284,198,86,242,25,217
"2011","Kensington and Chelsea 004A","E01002829","Total",788,209,38,171,130,49,194,24,170
"2011","Kensington and Chelsea 004B","E01002830","Total",917,316,45,271,165,68,238,29,209
"2011","Kensington and Chelsea 004C","E01002831","Total",961,288,40,248,190,87,226,32,194
"2011","Kensington and Chelsea 004D","E01002832","Total",910,256,58,198,184,73,187,32,155
"2011","Kensington and Chelsea 004E","E01002856","Total",941,294,39,255,156,70,247,24,223
"2011","Kensington and Chelsea 005A","E01002870","Total",693,305,59,246,160,59,266,37,229
"2011","Kensington and Chelsea 005B","E01002872","Total",726,347,36,311,161,63,262,25,237
"2011","Kensington and Chelsea 005C","E01002879","Total",695,255,60,195,190,60,215,48,167
"2011","Kensington and Chelsea 005D","E01002880","Total",653,257,83,174,228,88,205,60,145
"2011","Kensington and Chelsea 005E","E01002881","Total",544,202,48,154,174,70,159,37,122
"2011","Kensington and Chelsea 006A","E01002882","Total",703,199,19,180,134,61,136,9,127
"2011","Kensington and Chelsea 006B","E01002883","Total",802,204,36,168,180,80,128,17,111
"2011","Kensington and Chelsea 006C","E01002884","Total",710,158,6,152,89,61,96,8,88
"2011","Kensington and Chelsea 006D","E01002885","Total",950,213,20,193,92,47,93,10,83
"2011","Kensington and Chelsea 006E","E01002886","Total",781,157,6,151,142,70,99,7,92
"2011","Kensington and Chelsea 007A","E01002833","Total",793,174,13,161,128,63,90,10,80
"2011","Kensington and Chelsea 007B","E01002871","Total",742,150,22,128,192,97,85,16,69
"2011","Kensington and Chelsea 007C","E01002873","Total",632,167,23,144,139,62,114,22,92
"2011","Kensington and Chelsea 007D","E01002874","Total",648,156,25,131,162,68,115,23,92
"2011","Kensington and Chelsea 007E","E01002875","Total",681,183,14,169,133,58,125,14,111
"2011","Kensington and Chelsea 008A","E01002824","Total",684,134,5,129,149,71,73,11,62
"2011","Kensington and Chelsea 008B","E01002825","Total",827,205,26,179,204,111,115,24,91
"2011","Kensington and Chelsea 008C","E01002826","Total",798,217,19,198,128,78,105,9,96
"2011","Kensington and Chelsea 008D","E01002827","Total",903,164,6,158,186,110,105,7,98
"2011","Kensington and Chelsea 008E","E01002828","Total",710,187,8,179,114,56,115,9,106
"2011","Kensington and Chelsea 009A","E01002864","Total",580,160,20,140,191,73,88,8,80
"2011","Kensington and Chelsea 009B","E01002866","Total",848,199,44,155,190,75,146,24,122
"2011","Kensington and Chelsea 009C","E01002867","Total",998,276,54,222,216,103,180,41,139
"2011","Kensington and Chelsea 009D","E01002868","Total",725,168,9,159,170,85,78,11,67
"2011","Kensington and Chelsea 009E","E01002869","Total",768,204,39,165,139,59,138,15,123
"2011","Kensington and Chelsea 010A","E01002887","Total",807,195,6,189,91,47,73,11,62
"2011","Kensington and Chelsea 010B","E01002889","Total",579,132,5,127,106,59,74,8,66
"2011","Kensington and Chelsea 010C","E01002890","Total",705,162,10,152,234,105,84,14,70
"2011","Kensington and Chelsea 010D","E01002891","Total",718,187,20,167,141,70,67,7,60
"2011","Kensington and Chelsea 010E","E01002892","Total",920,218,15,203,174,105,71,9,62
"2011","Kensington and Chelsea 011A","E01002813","Total",835,195,13,182,162,95,98,9,89
"2011","Kensington and Chelsea 011B","E01002815","Total",755,248,27,221,125,70,125,14,111
"2011","Kensington and Chelsea 011C","E01002816","Total",693,167,6,161,105,51,75,11,64
"2011","Kensington and Chelsea 011D","E01002817","Total",709,197,27,170,166,77,108,15,93
"2011","Kensington and Chelsea 011E","E01002865","Total",544,132,22,110,177,85,61,12,49
"2011","Kensington and Chelsea 012A","E01002818","Total",1170,328,12,316,133,79,114,5,109
"2011","Kensington and Chelsea 012B","E01002819","Total",853,224,12,212,112,60,86,11,75
"2011","Kensington and Chelsea 012C","E01002859","Total",866,190,13,177,146,75,80,10,70
"2011","Kensington and Chelsea 012D","E01002860","Total",777,176,10,166,125,68,71,9,62
"2011","Kensington and Chelsea 012E","E01002863","Total",792,187,4,183,116,62,92,3,89
"2011","Kensington and Chelsea 013A","E01002812","Total",895,255,22,233,188,110,110,16,94
"2011","Kensington and Chelsea 013B","E01002834","Total",718,190,16,174,136,70,95,14,81
"2011","Kensington and Chelsea 013C","E01002839","Total",978,336,17,319,97,51,176,7,169
"2011","Kensington and Chelsea 013D","E01002850","Total",682,195,20,175,110,55,98,6,92
"2011","Kensington and Chelsea 013E","E01002888","Total",1149,331,16,315,123,67,94,7,87
"2011","Kensington and Chelsea 014A","E01002821","Total",692,176,11,165,122,63,74,13,61
"2011","Kensington and Chelsea 014B","E01002823","Total",701,269,31,238,139,54,202,25,177
"2011","Kensington and Chelsea 014C","E01002858","Total",749,311,42,269,92,40,156,35,121
"2011","Kensington and Chelsea 014D","E01002861","Total",771,217,13,204,115,59,120,8,112
"2011","Kensington and Chelsea 014E","E01002862","Total",977,362,32,330,132,66,211,20,191
"2011","Kensington and Chelsea 015A","E01002814","Total",905,292,65,227,224,95,213,51,162
"2011","Kensington and Chelsea 015B","E01002847","Total",872,193,18,175,109,62,113,12,101
"2011","Kensington and Chelsea 015C","E01002848","Total",894,257,22,235,109,54,173,19,154
"2011","Kensington and Chelsea 015D","E01002851","Total",918,376,20,356,104,47,261,20,241
"2011","Kensington and Chelsea 016A","E01002820","Total",666,156,8,148,101,57,54,6,48
"2011","Kensington and Chelsea 016B","E01002822","Total",621,140,8,132,116,56,71,6,65
"2011","Kensington and Chelsea 016C","E01002835","Total",784,195,13,182,139,83,67,8,59
"2011","Kensington and Chelsea 016D","E01002836","Total",795,205,6,199,110,52,78,11,67
"2011","Kensington and Chelsea 016E","E01002837","Total",717,142,6,136,114,59,40,7,33
"2011","Kensington and Chelsea 017A","E01002846","Total",781,218,23,195,96,49,153,12,141
"2011","Kensington and Chelsea 017B","E01002849","Total",787,193,20,173,132,64,106,15,91
"2011","Kensington and Chelsea 017C","E01002893","Total",987,302,32,270,133,66,180,13,167
"2011","Kensington and Chelsea 017D","E01002894","Total",773,141,11,130,110,52,93,14,79
"2011","Kensington and Chelsea 017E","E01002898","Total",739,191,15,176,178,87,96,7,89
"2011","Kensington and Chelsea 018A","E01002899","Total",768,246,17,229,108,50,183,20,163
"2011","Kensington and Chelsea 018B","E01002900","Total",682,143,17,126,133,62,70,15,55
"2011","Kensington and Chelsea 018C","E01002901","Total",560,202,11,191,72,36,109,6,103
"2011","Kensington and Chelsea 018D","E01002902","Total",1009,258,20,238,121,56,134,16,118
"2011","Kensington and Chelsea 018E","E01002903","Total",691,122,7,115,144,68,68,10,58
"2011","Kensington and Chelsea 019A","E01002844","Total",745,222,11,211,109,42,133,7,126
"2011","Kensington and Chelsea 019B","E01002845","Total",738,249,18,231,111,52,191,18,173
"2011","Kensington and Chelsea 019C","E01002910","Total",756,251,17,234,110,52,150,13,137
"2011","Kensington and Chelsea 019D","E01002911","Total",767,152,18,134,172,86,68,14,54
"2011","Kensington and Chelsea 019E","E01002914","Total",741,182,9,173,131,64,85,5,80
"2011","Kensington and Chelsea 020A","E01002838","Total",579,137,9,128,94,54,56,5,51
"2011","Kensington and Chelsea 020B","E01002895","Total",610,103,13,90,162,61,58,9,49
"2011","Kensington and Chelsea 020C","E01002896","Total",875,143,4,139,164,85,81,14,67
"2011","Kensington and Chelsea 020D","E01002897","Total",732,166,19,147,104,61,124,14,110
"2011","Kensington and Chelsea 020E","E01002912","Total",809,186,15,171,125,73,96,7,89
"2011","Kensington and Chelsea 021A","E01002840","Total",691,317,51,266,151,63,213,37,176
"2011","Kensington and Chelsea 021B","E01002841","Total",712,210,30,180,126,64,166,17,149
"2011","Kensington and Chelsea 021C","E01002842","Total",514,228,56,172,159,66,202,42,160
"2011","Kensington and Chelsea 021D","E01002843","Total",610,257,41,216,145,51,207,24,183
"2011","Kensington and Chelsea 021E","E01002913","Total",932,243,35,208,183,83,140,19,121
"2011","Lambeth 002A","E01003015","Total",730,242,60,182,188,67,174,36,138
"2011","Lambeth 002B","E01003108","Total",755,241,57,184,197,89,195,41,154
"2011","Lambeth 002C","E01003110","Total",849,198,38,160,160,75,148,31,117
"2011","Lambeth 002D","E01003111","Total",638,240,60,180,203,81,191,50,141
"2011","Lambeth 002E","E01003112","Total",771,277,54,223,151,68,206,32,174
"2011","Lambeth 003A","E01003101","Total",685,153,42,111,184,69,127,30,97
"2011","Lambeth 003B","E01003105","Total",780,255,63,192,206,91,199,46,153
"2011","Lambeth 003C","E01003106","Total",911,219,44,175,235,106,180,35,145
"2011","Lambeth 003D","E01003107","Total",929,188,37,151,168,69,147,18,129
"2011","Lambeth 003E","E01003109","Total",1093,324,87,237,247,114,244,52,192
"2011","Lambeth 004A","E01003102","Total",844,192,25,167,114,52,153,18,135
"2011","Lambeth 004C","E01003104","Total",777,162,33,129,128,58,145,32,113
"2011","Lambeth 004D","E01003122","Total",870,217,53,164,167,82,162,30,132
"2011","Lambeth 004E","E01003129","Total",808,159,43,116,159,69,133,24,109
"2011","Lambeth 004F","E01033207","Total",766,267,42,225,163,64,204,26,178
"2011","Lambeth 004G","E01033208","Total",1018,246,47,199,135,93,102,20,82
"2011","Lambeth 005A","E01003098","Total",645,162,37,125,173,65,128,28,100
"2011","Lambeth 005B","E01003099","Total",666,132,45,87,166,67,110,28,82
"2011","Lambeth 005C","E01003100","Total",878,101,13,88,98,62,87,8,79
"2011","Lambeth 005D","E01003180","Total",662,172,33,139,155,66,167,22,145
"2011","Lambeth 005E","E01003183","Total",631,213,46,167,163,59,174,37,137
"2011","Lambeth 006A","E01003097","Total",724,251,50,201,184,73,198,31,167
"2011","Lambeth 006B","E01003121","Total",691,248,68,180,254,94,176,49,127
"2011","Lambeth 006C","E01003123","Total",683,112,14,98,145,59,103,23,80
"2011","Lambeth 006D","E01003124","Total",619,158,44,114,153,61,126,34,92
"2011","Lambeth 006E","E01003125","Total",692,236,89,147,283,130,182,52,130
"2011","Lambeth 007A","E01003181","Total",644,202,58,144,158,71,171,39,132
"2011","Lambeth 007B","E01003184","Total",586,221,86,135,238,96,160,52,108
"2011","Lambeth 007C","E01003185","Total",768,204,41,163,162,75,161,29,132
"2011","Lambeth 007D","E01003186","Total",876,167,31,136,198,79,158,29,129
"2011","Lambeth 007E","E01003187","Total",626,194,38,156,173,49,178,45,133
"2011","Lambeth 008A","E01003089","Total",689,172,65,107,256,98,133,51,82
"2011","Lambeth 008B","E01003091","Total",668,169,66,103,210,73,124,35,89
"2011","Lambeth 008C","E01003092","Total",717,231,84,147,239,90,193,57,136
"2011","Lambeth 008D","E01003126","Total",645,180,52,128,213,84,157,50,107
"2011","Lambeth 008E","E01003128","Total",664,218,63,155,189,83,161,41,120
"2011","Lambeth 009A","E01003046","Total",743,246,91,155,273,113,168,52,116
"2011","Lambeth 009B","E01003048","Total",741,288,98,190,291,129,189,41,148
"2011","Lambeth 009C","E01003075","Total",685,253,78,175,255,97,188,45,143
"2011","Lambeth 009D","E01003182","Total",720,209,47,162,203,96,180,38,142
"2011","Lambeth 009E","E01003188","Total",554,190,58,132,176,72,150,38,112
"2011","Lambeth 010A","E01003088","Total",737,166,47,119,200,83,146,42,104
"2011","Lambeth 010B","E01003093","Total",949,324,142,182,374,200,200,61,139
"2011","Lambeth 010C","E01003094","Total",675,171,33,138,130,49,173,36,137
"2011","Lambeth 010D","E01003096","Total",926,164,20,144,89,36,138,14,124
"2011","Lambeth 010E","E01003127","Total",755,172,31,141,182,75,153,31,122
"2011","Lambeth 011A","E01003045","Total",728,265,90,175,282,105,218,59,159
"2011","Lambeth 011B","E01003047","Total",751,228,54,174,172,79,166,28,138
"2011","Lambeth 011C","E01003049","Total",668,209,75,134,243,120,153,46,107
"2011","Lambeth 011D","E01003059","Total",625,179,56,123,210,85,139,38,101
"2011","Lambeth 011E","E01003060","Total",632,215,61,154,209,82,191,43,148
"2011","Lambeth 011F","E01003061","Total",568,132,24,108,122,51,95,16,79
"2011","Lambeth 012A","E01003034","Total",723,155,37,118,195,100,133,27,106
"2011","Lambeth 012B","E01003035","Total",710,115,25,90,95,37,118,19,99
"2011","Lambeth 012C","E01003036","Total",737,170,37,133,167,78,144,23,121
"2011","Lambeth 012D","E01003090","Total",1043,179,31,148,143,63,158,35,123
"2011","Lambeth 012E","E01003095","Total",760,146,29,117,184,75,115,18,97
"2011","Lambeth 013A","E01003037","Total",606,199,47,152,143,66,168,33,135
"2011","Lambeth 013B","E01003038","Total",689,104,7,97,121,61,100,15,85
"2011","Lambeth 013C","E01003039","Total",945,114,21,93,165,92,103,12,91
"2011","Lambeth 013D","E01003040","Total",594,125,18,107,119,57,99,18,81
"2011","Lambeth 013E","E01003042","Total",502,153,25,128,88,35,111,11,100
"2011","Lambeth 014A","E01003072","Total",769,214,21,193,223,99,169,34,135
"2011","Lambeth 014B","E01003073","Total",698,204,55,149,227,112,170,39,131
"2011","Lambeth 014C","E01003076","Total",836,161,46,115,211,104,143,34,109
"2011","Lambeth 014D","E01003077","Total",786,138,31,107,188,83,135,28,107
"2011","Lambeth 014E","E01003078","Total",634,139,17,122,181,75,133,27,106
"2011","Lambeth 015A","E01003019","Total",914,164,20,144,157,87,148,17,131
"2011","Lambeth 015B","E01003053","Total",757,116,19,97,97,47,119,14,105
"2011","Lambeth 015C","E01003054","Total",819,101,20,81,74,30,70,5,65
"2011","Lambeth 015D","E01003056","Total",838,182,46,136,133,44,143,21,122
"2011","Lambeth 015E","E01003058","Total",820,148,33,115,121,48,112,20,92
"2011","Lambeth 016A","E01003020","Total",771,163,39,124,180,81,161,27,134
"2011","Lambeth 016B","E01003050","Total",773,201,44,157,128,60,147,24,123
"2011","Lambeth 016C","E01003052","Total",758,253,92,161,258,103,194,59,135
"2011","Lambeth 016D","E01003055","Total",790,226,16,210,93,45,182,14,168
"2011","Lambeth 016E","E01003176","Total",780,255,96,159,290,146,192,55,137
"2011","Lambeth 017A","E01003029","Total",860,183,26,157,129,79,130,15,115
"2011","Lambeth 017B","E01003032","Total",759,227,49,178,173,64,184,33,151
"2011","Lambeth 017C","E01003041","Total",678,175,53,122,174,70,153,32,121
"2011","Lambeth 017D","E01003057","Total",724,215,64,151,170,83,187,34,153
"2011","Lambeth 018A","E01003043","Total",685,159,18,141,133,63,150,21,129
"2011","Lambeth 018B","E01003044","Total",606,204,54,150,177,74,147,25,122
"2011","Lambeth 018C","E01003051","Total",675,203,75,128,215,85,148,48,100
"2011","Lambeth 018D","E01003071","Total",1004,134,32,102,226,123,147,29,118
"2011","Lambeth 018E","E01003074","Total",1096,228,54,174,280,132,189,37,152
"2011","Lambeth 019A","E01003026","Total",656,79,17,62,109,61,86,11,75
"2011","Lambeth 019B","E01003027","Total",480,51,7,44,156,98,50,10,40
"2011","Lambeth 019C","E01003028","Total",563,116,31,85,181,103,100,20,80
"2011","Lambeth 019D","E01003030","Total",783,80,15,65,154,96,80,15,65
"2011","Lambeth 019E","E01003033","Total",594,87,18,69,176,92,83,18,65
"2011","Lambeth 020A","E01003018","Total",999,160,28,132,168,88,142,19,123
"2011","Lambeth 020B","E01003171","Total",827,209,54,155,163,89,161,28,133
"2011","Lambeth 020C","E01003173","Total",694,131,14,117,160,76,141,27,114
"2011","Lambeth 020D","E01003177","Total",703,148,50,98,181,92,110,22,88
"2011","Lambeth 020E","E01003178","Total",712,133,14,119,126,63,130,15,115
"2011","Lambeth 021A","E01003021","Total",663,244,59,185,180,73,175,31,144
"2011","Lambeth 021B","E01003022","Total",770,169,28,141,168,78,151,23,128
"2011","Lambeth 021C","E01003023","Total",1063,198,49,149,233,127,170,23,147
"2011","Lambeth 021D","E01003024","Total",766,210,78,132,266,117,163,38,125
"2011","Lambeth 021E","E01003025","Total",842,212,64,148,279,121,174,30,144
"2011","Lambeth 022A","E01003136","Total",735,169,39,130,183,87,141,26,115
"2011","Lambeth 022B","E01003137","Total",676,214,72,142,205,105,146,30,116
"2011","Lambeth 022C","E01003159","Total",599,149,39,110,187,76,151,36,115
"2011","Lambeth 022D","E01003160","Total",558,165,69,96,231,97,148,47,101
"2011","Lambeth 022E","E01003162","Total",830,276,99,177,359,153,222,59,163
"2011","Lambeth 023A","E01003031","Total",720,161,43,118,155,85,122,27,95
"2011","Lambeth 023B","E01003156","Total",665,171,29,142,173,81,154,24,130
"2011","Lambeth 023C","E01003157","Total",577,94,20,74,192,116,98,28,70
"2011","Lambeth 023D","E01003158","Total",737,109,11,98,133,94,105,16,89
"2011","Lambeth 023E","E01003161","Total",498,138,29,109,146,91,97,20,77
"2011","Lambeth 023F","E01003163","Total",588,164,29,135,173,79,129,22,107
"2011","Lambeth 024A","E01003132","Total",536,196,58,138,201,79,165,61,104
"2011","Lambeth 024B","E01003172","Total",815,222,66,156,261,121,189,41,148
"2011","Lambeth 024C","E01003174","Total",829,254,116,138,345,146,192,69,123
"2011","Lambeth 024D","E01003175","Total",608,196,68,128,248,87,170,56,114
"2011","Lambeth 024E","E01003179","Total",654,205,79,126,289,107,149,45,104
"2011","Lambeth 025A","E01003164","Total",935,220,68,152,296,154,171,38,133
"2011","Lambeth 025B","E01003165","Total",712,200,47,153,221,105,156,36,120
"2011","Lambeth 025C","E01003168","Total",647,250,63,187,220,96,200,46,154
"2011","Lambeth 025D","E01003169","Total",1071,266,65,201,305,168,199,43,156
"2011","Lambeth 025E","E01003170","Total",797,208,11,197,244,127,174,20,154
"2011","Lambeth 026A","E01003130","Total",739,136,21,115,184,97,123,18,105
"2011","Lambeth 026B","E01003131","Total",617,125,19,106,163,68,97,18,79
"2011","Lambeth 026C","E01003135","Total",724,209,34,175,185,86,196,28,168
"2011","Lambeth 026D","E01003138","Total",689,91,5,86,147,86,91,11,80
"2011","Lambeth 026E","E01003151","Total",820,302,100,202,308,136,220,48,172
"2011","Lambeth 027A","E01003079","Total",757,212,68,144,265,120,154,44,110
"2011","Lambeth 027B","E01003080","Total",663,138,27,111,216,124,114,35,79
"2011","Lambeth 027C","E01003133","Total",765,179,32,147,220,119,132,25,107
"2011","Lambeth 027D","E01003134","Total",619,157,24,133,191,77,131,27,104
"2011","Lambeth 027E","E01003152","Total",761,142,27,115,249,129,121,26,95
"2011","Lambeth 028A","E01003064","Total",660,96,30,66,205,113,80,25,55
"2011","Lambeth 028B","E01003066","Total",741,223,59,164,249,118,191,47,144
"2011","Lambeth 028C","E01003081","Total",768,211,47,164,250,111,148,37,111
"2011","Lambeth 028D","E01003166","Total",1020,211,62,149,328,182,172,38,134
"2011","Lambeth 028E","E01003167","Total",681,145,14,131,241,114,120,21,99
"2011","Lambeth 029A","E01003116","Total",634,158,29,129,182,82,161,30,131
"2011","Lambeth 029B","E01003117","Total",841,195,39,156,180,98,168,31,137
"2011","Lambeth 029C","E01003118","Total",688,152,11,141,184,82,137,24,113
"2011","Lambeth 029D","E01003153","Total",929,132,22,110,155,96,121,15,106
"2011","Lambeth 029E","E01003155","Total",750,149,18,131,190,105,125,31,94
"2011","Lambeth 030A","E01003083","Total",594,148,18,130,189,82,142,22,120
"2011","Lambeth 030B","E01003084","Total",673,133,32,101,227,128,102,29,73
"2011","Lambeth 030C","E01003085","Total",697,213,35,178,236,97,168,36,132
"2011","Lambeth 030D","E01003149","Total",694,124,20,104,208,117,126,24,102
"2011","Lambeth 030E","E01003154","Total",786,249,62,187,265,121,194,49,145
"2011","Lambeth 031A","E01003065","Total",666,268,72,196,233,125,190,40,150
"2011","Lambeth 031B","E01003068","Total",657,197,73,124,277,151,160,48,112
"2011","Lambeth 031C","E01003082","Total",651,231,41,190,210,101,181,39,142
"2011","Lambeth 031D","E01003086","Total",647,242,93,149,268,120,165,52,113
"2011","Lambeth 031E","E01003087","Total",611,223,92,131,295,143,165,50,115
"2011","Lambeth 032A","E01003113","Total",817,147,49,98,225,135,126,35,91
"2011","Lambeth 032B","E01003114","Total",765,146,35,111,219,122,127,36,91
"2011","Lambeth 032C","E01003119","Total",813,129,25,104,201,121,136,36,100
"2011","Lambeth 032D","E01003120","Total",961,229,44,185,237,148,173,37,136
"2011","Lambeth 032E","E01003148","Total",762,150,42,108,231,136,126,31,95
"2011","Lambeth 032F","E01003150","Total",769,234,62,172,239,136,171,33,138
"2011","Lambeth 033A","E01003062","Total",795,181,38,143,195,98,134,19,115
"2011","Lambeth 033B","E01003063","Total",664,240,54,186,199,101,172,30,142
"2011","Lambeth 033C","E01003067","Total",599,126,32,94,213,106,133,36,97
"2011","Lambeth 033D","E01003069","Total",520,154,44,110,205,95,122,38,84
"2011","Lambeth 033E","E01003070","Total",655,226,75,151,224,98,176,47,129
"2011","Lambeth 034A","E01003115","Total",669,135,43,92,215,126,101,25,76
"2011","Lambeth 034B","E01003141","Total",723,224,46,178,248,133,170,35,135
"2011","Lambeth 034C","E01003144","Total",520,108,13,95,191,79,102,26,76
"2011","Lambeth 034D","E01003145","Total",783,198,35,163,173,87,146,23,123
"2011","Lambeth 034E","E01003147","Total",797,196,31,165,271,146,159,40,119
"2011","Lambeth 035A","E01003139","Total",542,128,34,94,199,100,99,23,76
"2011","Lambeth 035B","E01003140","Total",492,115,29,86,186,76,124,37,87
"2011","Lambeth 035C","E01003142","Total",453,153,39,114,181,68,112,36,76
"2011","Lambeth 035D","E01003143","Total",516,176,38,138,188,73,168,45,123
"2011","Lambeth 035E","E01003146","Total",524,124,43,81,210,88,132,42,90
"2011","Lambeth 036A","E01003013","Total",854,165,6,159,94,60,70,6,64
"2011","Lambeth 036B","E01003014","Total",678,196,22,174,118,51,177,24,153
"2011","Lambeth 036C","E01003016","Total",526,179,13,166,60,19,75,11,64
"2011","Lambeth 036D","E01003017","Total",862,255,30,225,147,62,212,29,183
"2011","Lambeth 036E","E01032582","Total",920,252,41,211,141,66,175,25,150
"2011","Lewisham 001A","E01003244","Total",618,208,84,124,293,147,140,46,94
"2011","Lewisham 001B","E01003245","Total",584,188,99,89,275,112,143,60,83
"2011","Lewisham 001C","E01003247","Total",685,124,16,108,113,50,99,25,74
"2011","Lewisham 001D","E01003249","Total",897,267,65,202,233,102,205,47,158
"2011","Lewisham 001E","E01003250","Total",763,222,59,163,205,92,169,38,131
"2011","Lewisham 002A","E01003246","Total",559,156,55,101,192,71,133,47,86
"2011","Lewisham 002B","E01003248","Total",718,216,84,132,231,113,141,32,109
"2011","Lewisham 002C","E01003251","Total",777,277,109,168,330,147,200,59,141
"2011","Lewisham 002D","E01003252","Total",613,250,96,154,278,113,166,64,102
"2011","Lewisham 002E","E01003253","Total",669,238,63,175,177,87,174,36,138
"2011","Lewisham 003A","E01003297","Total",767,170,61,109,216,143,96,33,63
"2011","Lewisham 003B","E01003299","Total",609,181,70,111,219,95,140,49,91
"2011","Lewisham 003C","E01003301","Total",767,119,32,87,234,120,118,35,83
"2011","Lewisham 003D","E01003302","Total",710,234,62,172,220,97,160,36,124
"2011","Lewisham 003E","E01003305","Total",513,144,39,105,170,67,153,29,124
"2011","Lewisham 005A","E01003207","Total",615,196,43,153,174,66,146,19,127
"2011","Lewisham 005B","E01003209","Total",778,224,53,171,220,108,158,46,112
"2011","Lewisham 005C","E01003210","Total",850,170,33,137,174,90,129,23,106
"2011","Lewisham 005D","E01003212","Total",867,240,41,199,182,78,210,32,178
"2011","Lewisham 005E","E01003215","Total",666,151,26,125,154,100,96,16,80
"2011","Lewisham 006A","E01003338","Total",771,295,71,224,226,106,199,35,164
"2011","Lewisham 006B","E01003339","Total",763,220,48,172,210,94,170,30,140
"2011","Lewisham 006C","E01003340","Total",797,149,25,124,159,67,122,32,90
"2011","Lewisham 006D","E01003341","Total",581,99,29,70,184,72,134,30,104
"2011","Lewisham 006E","E01003343","Total",626,145,30,115,164,70,135,29,106
"2011","Lewisham 007A","E01003199","Total",801,140,26,114,203,116,134,30,104
"2011","Lewisham 007B","E01003201","Total",680,207,55,152,233,97,171,47,124
"2011","Lewisham 007C","E01003204","Total",603,129,33,96,173,88,92,21,71
"2011","Lewisham 007D","E01003205","Total",502,197,60,137,221,68,156,35,121
"2011","Lewisham 007E","E01003206","Total",698,131,23,108,199,116,112,22,90
"2011","Lewisham 008B","E01003211","Total",753,163,29,134,161,93,142,24,118
"2011","Lewisham 008C","E01003213","Total",813,153,29,124,209,115,132,31,101
"2011","Lewisham 008D","E01003214","Total",745,187,49,138,244,121,170,38,132
"2011","Lewisham 008E","E01033324","Total",642,198,37,161,181,72,167,32,135
"2011","Lewisham 008F","E01033325","Total",706,53,2,51,60,53,39,1,38
"2011","Lewisham 009A","E01003198","Total",639,178,28,150,181,97,150,29,121
"2011","Lewisham 009B","E01003200","Total",756,163,11,152,147,77,140,20,120
"2011","Lewisham 009C","E01003202","Total",764,192,8,184,143,78,123,10,113
"2011","Lewisham 009D","E01003203","Total",980,263,30,233,193,102,211,24,187
"2011","Lewisham 010A","E01003336","Total",577,209,56,153,224,92,183,52,131
"2011","Lewisham 010B","E01003337","Total",600,163,65,98,298,162,121,36,85
"2011","Lewisham 010C","E01003342","Total",702,126,40,86,211,122,124,29,95
"2011","Lewisham 010D","E01003344","Total",719,143,22,121,188,83,143,32,111
"2011","Lewisham 010E","E01003345","Total",719,123,29,94,183,101,135,22,113
"2011","Lewisham 011A","E01003273","Total",666,127,31,96,203,78,133,30,103
"2011","Lewisham 011B","E01003277","Total",778,166,35,131,208,89,135,20,115
"2011","Lewisham 011C","E01003278","Total",805,174,27,147,189,73,161,25,136
"2011","Lewisham 011D","E01003279","Total",654,134,17,117,174,71,159,30,129
"2011","Lewisham 012A","E01003288","Total",794,300,50,250,219,114,211,34,177
"2011","Lewisham 012C","E01003290","Total",725,229,46,183,191,92,175,41,134
"2011","Lewisham 012D","E01003291","Total",682,282,83,199,239,112,228,48,180
"2011","Lewisham 012E","E01003296","Total",1021,217,57,160,236,129,159,38,121
"2011","Lewisham 012F","E01033327","Total",679,157,29,128,146,86,128,20,108
"2011","Lewisham 012G","E01033341","Total",551,167,75,92,206,120,110,37,73
"2011","Lewisham 013A","E01003282","Total",1047,228,43,185,253,131,207,40,167
"2011","Lewisham 013B","E01003283","Total",923,187,13,174,271,150,167,32,135
"2011","Lewisham 013C","E01003284","Total",748,173,31,142,229,104,152,42,110
"2011","Lewisham 013D","E01003286","Total",786,311,49,262,231,121,248,34,214
"2011","Lewisham 014A","E01003272","Total",798,177,26,151,214,122,143,32,111
"2011","Lewisham 014B","E01003274","Total",721,130,36,94,231,112,117,33,84
"2011","Lewisham 014C","E01003275","Total",640,197,50,147,240,95,182,52,130
"2011","Lewisham 014D","E01003276","Total",700,140,40,100,305,135,154,55,99
"2011","Lewisham 015A","E01003225","Total",590,112,13,99,207,83,103,20,83
"2011","Lewisham 015B","E01003231","Total",687,161,27,134,210,107,131,31,100
"2011","Lewisham 015C","E01003232","Total",649,140,16,124,236,97,123,24,99
"2011","Lewisham 015D","E01003233","Total",669,144,29,115,206,112,117,27,90
"2011","Lewisham 016A","E01003280","Total",651,217,63,154,242,115,171,36,135
"2011","Lewisham 016B","E01003281","Total",601,174,15,159,210,91,144,28,116
"2011","Lewisham 016C","E01003285","Total",767,193,22,171,193,85,144,27,117
"2011","Lewisham 016D","E01003287","Total",797,152,15,137,248,119,176,35,141
"2011","Lewisham 017A","E01003292","Total",702,133,26,107,187,98,122,21,101
"2011","Lewisham 017B","E01003293","Total",676,185,49,136,205,115,143,38,105
"2011","Lewisham 017D","E01003295","Total",653,170,48,122,235,101,113,21,92
"2011","Lewisham 017E","E01033320","Total",645,169,38,131,191,96,134,35,99
"2011","Lewisham 017F","E01033322","Total",594,88,25,63,121,71,76,14,62
"2011","Lewisham 018A","E01003319","Total",752,243,58,185,267,146,207,50,157
"2011","Lewisham 018B","E01003320","Total",650,202,53,149,230,107,175,41,134
"2011","Lewisham 018C","E01003323","Total",624,171,41,130,204,95,155,35,120
"2011","Lewisham 018D","E01003325","Total",722,231,83,148,283,155,137,29,108
"2011","Lewisham 019A","E01003226","Total",709,130,24,106,213,110,133,26,107
"2011","Lewisham 019B","E01003227","Total",678,149,25,124,209,104,122,24,98
"2011","Lewisham 019C","E01003228","Total",673,137,21,116,189,114,111,21,90
"2011","Lewisham 019D","E01003229","Total",742,275,48,227,207,99,198,29,169
"2011","Lewisham 019E","E01003230","Total",866,229,59,170,273,109,194,38,156
"2011","Lewisham 020A","E01003317","Total",688,165,28,137,249,143,141,37,104
"2011","Lewisham 020B","E01003318","Total",705,187,55,132,217,107,142,26,116
"2011","Lewisham 020C","E01003321","Total",810,231,45,186,282,161,223,36,187
"2011","Lewisham 020D","E01003322","Total",593,154,30,124,179,90,159,34,125
"2011","Lewisham 020E","E01003324","Total",713,243,57,186,207,118,205,39,166
"2011","Lewisham 021A","E01003254","Total",602,125,11,114,166,75,110,16,94
"2011","Lewisham 021B","E01003255","Total",964,177,36,141,192,100,128,26,102
"2011","Lewisham 021C","E01003260","Total",681,142,15,127,267,148,147,40,107
"2011","Lewisham 021D","E01003261","Total",619,143,35,108,213,105,116,26,90
"2011","Lewisham 021E","E01003262","Total",624,147,38,109,202,97,123,28,95
"2011","Lewisham 022A","E01003217","Total",622,168,35,133,244,112,134,44,90
"2011","Lewisham 022B","E01003218","Total",539,121,30,91,210,75,131,33,98
"2011","Lewisham 022C","E01003220","Total",604,145,33,112,195,94,113,21,92
"2011","Lewisham 022D","E01003222","Total",629,176,36,140,235,76,161,48,113
"2011","Lewisham 022E","E01003224","Total",626,131,30,101,234,95,125,28,97
"2011","Lewisham 023A","E01003263","Total",739,274,58,216,252,128,205,34,171
"2011","Lewisham 023B","E01003268","Total",718,182,30,152,210,103,166,40,126
"2011","Lewisham 023C","E01003269","Total",647,185,44,141,221,101,158,34,124
"2011","Lewisham 023D","E01003270","Total",678,137,17,120,210,76,141,29,112
"2011","Lewisham 023E","E01003271","Total",637,143,7,136,203,76,148,22,126
"2011","Lewisham 024A","E01003307","Total",627,170,36,134,213,101,147,35,112
"2011","Lewisham 024B","E01003308","Total",734,190,50,140,279,110,165,45,120
"2011","Lewisham 024C","E01003314","Total",683,120,32,88,211,100,115,27,88
"2011","Lewisham 024D","E01003315","Total",599,146,31,115,155,85,111,23,88
"2011","Lewisham 024E","E01003316","Total",609,142,24,118,200,88,124,30,94
"2011","Lewisham 025A","E01003216","Total",689,153,28,125,252,105,165,32,133
"2011","Lewisham 025B","E01003219","Total",631,164,16,148,216,74,140,25,115
"2011","Lewisham 025C","E01003221","Total",769,210,43,167,267,130,158,35,123
"2011","Lewisham 025D","E01003223","Total",603,164,28,136,214,77,128,27,101
"2011","Lewisham 026A","E01003346","Total",598,218,57,161,245,84,147,31,116
"2011","Lewisham 026B","E01003349","Total",541,205,65,140,256,106,165,53,112
"2011","Lewisham 026C","E01003351","Total",592,235,57,178,252,108,166,45,121
"2011","Lewisham 026D","E01003354","Total",701,166,38,128,250,116,139,44,95
"2011","Lewisham 027A","E01003309","Total",645,249,70,179,218,88,187,48,139
"2011","Lewisham 027B","E01003310","Total",756,214,60,154,196,89,170,43,127
"2011","Lewisham 027C","E01003311","Total",605,153,26,127,192,90,133,36,97
"2011","Lewisham 027D","E01003312","Total",779,184,41,143,228,110,155,38,117
"2011","Lewisham 027E","E01003313","Total",670,199,69,130,261,140,153,38,115
"2011","Lewisham 028A","E01003256","Total",931,290,60,230,271,137,212,29,183
"2011","Lewisham 028B","E01003257","Total",735,252,45,207,216,103,187,25,162
"2011","Lewisham 028C","E01003258","Total",594,202,80,122,273,115,142,53,89
"2011","Lewisham 028D","E01003259","Total",756,200,35,165,207,126,141,25,116
"2011","Lewisham 029A","E01003193","Total",666,226,30,196,204,87,203,42,161
"2011","Lewisham 029B","E01003194","Total",716,252,53,199,238,88,226,46,180
"2011","Lewisham 029C","E01003195","Total",637,171,41,130,217,100,144,43,101
"2011","Lewisham 029D","E01003196","Total",624,214,56,158,262,100,201,44,157
"2011","Lewisham 029E","E01003197","Total",625,231,66,165,256,108,207,59,148
"2011","Lewisham 030A","E01003347","Total",638,248,121,127,362,147,174,72,102
"2011","Lewisham 030B","E01003348","Total",571,201,35,166,200,75,160,36,124
"2011","Lewisham 030C","E01003350","Total",519,193,57,136,234,87,169,53,116
"2011","Lewisham 030D","E01003352","Total",735,283,50,233,251,91,222,45,177
"2011","Lewisham 030E","E01003353","Total",632,179,30,149,219,74,149,34,115
"2011","Lewisham 031A","E01003264","Total",728,272,45,227,213,95,198,32,166
"2011","Lewisham 031B","E01003265","Total",680,225,80,145,248,124,138,36,102
"2011","Lewisham 031C","E01003266","Total",757,340,62,278,239,105,269,50,219
"2011","Lewisham 031D","E01003267","Total",598,230,61,169,244,94,199,57,142
"2011","Lewisham 033A","E01003329","Total",666,155,38,117,239,111,138,38,100
"2011","Lewisham 033B","E01003330","Total",662,272,87,185,257,128,178,38,140
"2011","Lewisham 033C","E01003331","Total",572,211,37,174,174,67,172,42,130
"2011","Lewisham 033D","E01003332","Total",679,204,33,171,187,90,156,25,131
"2011","Lewisham 033E","E01003334","Total",778,221,38,183,197,101,195,26,169
"2011","Lewisham 034A","E01003189","Total",624,247,83,164,277,122,202,49,153
"2011","Lewisham 034B","E01003190","Total",809,272,101,171,358,185,201,77,124
"2011","Lewisham 034C","E01003191","Total",665,230,80,150,244,112,155,36,119
"2011","Lewisham 034D","E01003192","Total",741,309,73,236,247,133,231,50,181
"2011","Lewisham 035A","E01003326","Total",638,183,29,154,198,101,134,28,106
"2011","Lewisham 035B","E01003327","Total",714,169,37,132,208,99,149,35,114
"2011","Lewisham 035C","E01003328","Total",833,267,48,219,207,111,213,36,177
"2011","Lewisham 035D","E01003333","Total",657,184,32,152,205,108,151,30,121
"2011","Lewisham 035E","E01003335","Total",594,202,46,156,216,91,169,34,135
"2011","Lewisham 037A","E01003236","Total",648,256,87,169,275,137,174,43,131
"2011","Lewisham 037B","E01003237","Total",608,228,71,157,246,95,183,52,131
"2011","Lewisham 037C","E01003238","Total",565,205,68,137,254,112,146,48,98
"2011","Lewisham 037D","E01003239","Total",564,202,52,150,232,108,146,36,110
"2011","Lewisham 037E","E01032564","Total",508,181,57,124,228,99,141,39,102
"2011","Lewisham 038A","E01003235","Total",523,198,30,168,169,64,161,30,131
"2011","Lewisham 038B","E01003240","Total",725,246,72,174,283,133,206,54,152
"2011","Lewisham 038C","E01003241","Total",695,299,29,270,182,69,233,30,203
"2011","Lewisham 038D","E01003243","Total",581,230,51,179,198,93,161,30,131
"2011","Lewisham 038E","E01032565","Total",644,291,48,243,201,101,217,32,185
"2011","Lewisham 039A","E01003298","Total",475,141,58,83,188,95,112,35,77
"2011","Lewisham 039B","E01003300","Total",561,181,55,126,196,91,141,35,106
"2011","Lewisham 039C","E01003303","Total",560,151,39,112,179,94,112,31,81
"2011","Lewisham 039D","E01003304","Total",903,230,56,174,206,105,187,45,142
"2011","Lewisham 039E","E01032579","Total",711,228,55,173,189,83,171,36,135
"2011","Newham 001A","E01003543","Total",850,175,55,120,334,172,159,56,103
"2011","Newham 001B","E01003544","Total",664,159,55,104,255,119,147,39,108
"2011","Newham 001C","E01003546","Total",588,158,67,91,293,133,146,60,86
"2011","Newham 001D","E01003550","Total",631,188,47,141,224,108,162,36,126
"2011","Newham 002A","E01003576","Total",710,279,80,199,291,164,203,49,154
"2011","Newham 002B","E01003581","Total",486,129,47,82,251,105,113,46,67
"2011","Newham 002C","E01003582","Total",499,168,59,109,226,107,125,37,88
"2011","Newham 002D","E01003583","Total",539,162,59,103,269,134,145,55,90
"2011","Newham 003A","E01003578","Total",601,170,69,101,279,160,108,30,78
"2011","Newham 003B","E01003584","Total",638,157,49,108,268,122,152,57,95
"2011","Newham 003C","E01003586","Total",509,133,30,103,206,101,124,29,95
"2011","Newham 003D","E01003590","Total",572,197,44,153,210,102,170,37,133
"2011","Newham 004A","E01003579","Total",499,146,38,108,253,124,122,44,78
"2011","Newham 004B","E01003585","Total",407,104,39,65,201,112,124,56,68
"2011","Newham 004C","E01003587","Total",823,223,64,159,331,173,185,45,140
"2011","Newham 004D","E01003591","Total",671,231,78,153,277,144,178,54,124
"2011","Newham 005A","E01003528","Total",431,140,48,92,213,108,133,47,86
"2011","Newham 005B","E01003575","Total",491,144,58,86,246,121,151,69,82
"2011","Newham 005C","E01003577","Total",673,291,112,179,329,155,213,72,141
"2011","Newham 005D","E01003580","Total",615,213,75,138,303,147,170,56,114
"2011","Newham 006A","E01003545","Total",644,189,47,142,228,106,160,41,119
"2011","Newham 006B","E01003548","Total",852,247,45,202,259,128,203,43,160
"2011","Newham 006C","E01003549","Total",790,206,49,157,232,112,191,49,142
"2011","Newham 006D","E01003557","Total",651,156,31,125,230,120,134,45,89
"2011","Newham 007A","E01003547","Total",699,166,29,137,237,101,160,47,113
"2011","Newham 007B","E01003555","Total",500,119,19,100,185,99,135,43,92
"2011","Newham 007C","E01003561","Total",481,124,46,78,221,109,111,48,63
"2011","Newham 007D","E01003567","Total",540,154,37,117,229,113,138,58,80
"2011","Newham 008A","E01003556","Total",629,203,45,158,201,105,149,41,108
"2011","Newham 008B","E01003558","Total",491,156,41,115,197,100,113,41,72
"2011","Newham 008C","E01003570","Total",585,180,49,131,235,118,150,59,91
"2011","Newham 008D","E01003571","Total",586,157,53,104,274,132,145,61,84
"2011","Newham 008E","E01003572","Total",446,107,32,75,222,105,96,37,59
"2011","Newham 009A","E01003551","Total",586,122,36,86,221,112,115,49,66
"2011","Newham 009B","E01003553","Total",733,270,79,191,243,113,184,43,141
"2011","Newham 009C","E01003554","Total",623,143,21,122,172,78,148,32,116
"2011","Newham 009D","E01003559","Total",1001,186,50,136,291,158,170,43,127
"2011","Newham 010A","E01003529","Total",597,124,28,96,253,125,149,46,103
"2011","Newham 010B","E01003530","Total",468,97,24,73,208,91,110,35,75
"2011","Newham 010C","E01003531","Total",516,128,38,90,226,118,144,50,94
"2011","Newham 010D","E01003532","Total",513,132,35,97,220,96,130,49,81
"2011","Newham 010E","E01003534","Total",643,176,56,120,307,143,173,72,101
"2011","Newham 011A","E01003533","Total",482,127,30,97,213,120,129,54,75
"2011","Newham 011B","E01003560","Total",448,108,37,71,208,97,112,45,67
"2011","Newham 011C","E01003563","Total",538,136,39,97,259,118,119,51,68
"2011","Newham 011D","E01003588","Total",454,126,37,89,221,105,122,53,69
"2011","Newham 011E","E01003589","Total",512,139,43,96,229,126,112,44,68
"2011","Newham 012A","E01003616","Total",658,160,35,125,165,61,175,37,138
"2011","Newham 012B","E01003617","Total",1103,247,45,202,251,134,219,38,181
"2011","Newham 012C","E01003618","Total",823,181,42,139,210,112,156,41,115
"2011","Newham 012D","E01003619","Total",1087,372,64,308,225,112,180,36,144
"2011","Newham 013C","E01003615","Total",643,186,36,150,200,90,174,45,129
"2011","Newham 013E","E01033578","Total",603,149,30,119,130,82,78,12,66
"2011","Newham 013F","E01033579","Total",618,106,17,89,97,61,57,11,46
"2011","Newham 013G","E01033583","Total",1205,267,64,203,297,139,232,63,169
"2011","Newham 013H","E01033586","Total",597,138,35,103,172,85,135,35,100
"2011","Newham 014A","E01003562","Total",576,136,30,106,232,107,126,56,70
"2011","Newham 014B","E01003564","Total",672,152,48,104,299,162,157,57,100
"2011","Newham 014C","E01003565","Total",496,119,26,93,224,120,118,42,76
"2011","Newham 014D","E01003566","Total",507,155,42,113,209,100,152,47,105
"2011","Newham 015A","E01003625","Total",484,138,49,89,242,132,121,57,64
"2011","Newham 015B","E01003626","Total",420,77,25,52,196,94,89,35,54
"2011","Newham 015C","E01003627","Total",432,108,32,76,198,90,110,42,68
"2011","Newham 015D","E01003628","Total",420,74,20,54,209,96,90,38,52
"2011","Newham 015E","E01003629","Total",481,124,33,91,240,127,115,42,73
"2011","Newham 016A","E01003552","Total",544,157,55,102,209,102,114,38,76
"2011","Newham 016B","E01003596","Total",577,168,42,126,228,118,145,32,113
"2011","Newham 016C","E01003597","Total",475,116,20,96,204,101,115,39,76
"2011","Newham 016D","E01003635","Total",611,133,28,105,197,90,148,36,112
"2011","Newham 017A","E01003568","Total",594,126,40,86,253,116,160,65,95
"2011","Newham 017B","E01003569","Total",509,137,34,103,204,109,133,45,88
"2011","Newham 017C","E01003573","Total",542,132,36,96,255,127,128,55,73
"2011","Newham 017D","E01003574","Total",798,243,54,189,281,128,235,60,175
"2011","Newham 018A","E01003520","Total",583,169,40,129,221,102,164,45,119
"2011","Newham 018B","E01003521","Total",623,120,23,97,249,122,132,33,99
"2011","Newham 018C","E01003522","Total",550,151,45,106,266,124,143,43,100
"2011","Newham 018D","E01003525","Total",519,116,34,82,224,122,131,40,91
"2011","Newham 018E","E01003526","Total",550,167,39,128,237,117,159,50,109
"2011","Newham 019A","E01003488","Total",669,279,83,196,272,132,226,64,162
"2011","Newham 019B","E01003489","Total",520,179,87,92,261,124,133,54,79
"2011","Newham 019C","E01003490","Total",539,144,48,96,255,123,148,62,86
"2011","Newham 019D","E01003524","Total",598,176,46,130,259,133,153,51,102
"2011","Newham 020A","E01003631","Total",727,177,45,132,226,115,146,38,108
"2011","Newham 020B","E01003632","Total",749,193,69,124,282,142,167,49,118
"2011","Newham 020C","E01003633","Total",685,257,78,179,268,128,185,72,113
"2011","Newham 020D","E01003634","Total",602,194,61,133,219,90,151,48,103
"2011","Newham 020E","E01003636","Total",702,217,79,138,263,112,170,60,110
"2011","Newham 021A","E01003598","Total",658,231,83,148,275,140,182,56,126
"2011","Newham 021B","E01003600","Total",690,258,70,188,276,146,193,50,143
"2011","Newham 021C","E01003630","Total",731,202,44,158,256,114,178,40,138
"2011","Newham 021D","E01003637","Total",593,155,35,120,209,100,139,32,107
"2011","Newham 022A","E01003491","Total",637,248,46,202,202,103,205,48,157
"2011","Newham 022B","E01003592","Total",555,153,43,110,244,130,125,42,83
"2011","Newham 022C","E01003599","Total",488,167,59,108,197,97,141,48,93
"2011","Newham 022D","E01003606","Total",675,196,66,130,291,152,149,48,101
"2011","Newham 023A","E01003535","Total",548,213,76,137,250,94,157,48,109
"2011","Newham 023B","E01003536","Total",598,167,62,105,302,155,129,41,88
"2011","Newham 023C","E01003621","Total",442,98,34,64,254,133,104,44,60
"2011","Newham 023D","E01003622","Total",496,158,39,119,224,117,147,39,108
"2011","Newham 023E","E01003623","Total",490,154,66,88,264,101,144,71,73
"2011","Newham 024A","E01003523","Total",669,216,53,163,271,120,185,47,138
"2011","Newham 024B","E01003527","Total",570,150,40,110,253,118,152,52,100
"2011","Newham 024C","E01003537","Total",668,171,50,121,303,156,163,54,109
"2011","Newham 024D","E01003542","Total",668,240,70,170,316,142,219,73,146
"2011","Newham 024E","E01003624","Total",493,154,65,89,236,118,131,56,75
"2011","Newham 025A","E01003492","Total",536,128,34,94,256,119,134,58,76
"2011","Newham 025B","E01003493","Total",732,234,45,189,272,138,186,57,129
"2011","Newham 025C","E01003494","Total",645,157,61,96,321,165,150,60,90
"2011","Newham 025D","E01003495","Total",650,135,34,101,293,154,131,52,79
"2011","Newham 026A","E01003594","Total",540,139,58,81,230,110,124,44,80
"2011","Newham 026B","E01003595","Total",581,235,45,190,182,88,187,35,152
"2011","Newham 026C","E01003602","Total",605,139,37,102,249,111,157,46,111
"2011","Newham 026D","E01003607","Total",560,144,58,86,258,108,129,52,77
"2011","Newham 027A","E01003496","Total",591,160,38,122,179,81,132,35,97
"2011","Newham 027B","E01003498","Total",674,227,64,163,235,112,188,42,146
"2011","Newham 027C","E01003500","Total",732,251,80,171,293,130,186,59,127
"2011","Newham 027D","E01003593","Total",559,188,53,135,217,90,158,46,112
"2011","Newham 028A","E01003601","Total",705,213,75,138,310,132,193,63,130
"2011","Newham 028B","E01003603","Total",624,164,63,101,315,168,128,49,79
"2011","Newham 028C","E01003605","Total",724,239,61,178,283,137,217,59,158
"2011","Newham 028D","E01003608","Total",714,165,57,108,300,147,151,50,101
"2011","Newham 029A","E01003538","Total",652,223,67,156,300,143,171,64,107
"2011","Newham 029B","E01003539","Total",681,174,66,108,344,162,160,69,91
"2011","Newham 029C","E01003540","Total",595,193,66,127,293,134,173,65,108
"2011","Newham 029D","E01003541","Total",570,164,55,109,298,148,127,42,85
"2011","Newham 030A","E01003499","Total",862,372,98,274,335,162,295,76,219
"2011","Newham 030B","E01003501","Total",715,225,68,157,283,129,196,49,147
"2011","Newham 030C","E01003502","Total",669,235,66,169,240,105,182,52,130
"2011","Newham 030D","E01003503","Total",647,262,65,197,232,105,223,49,174
"2011","Newham 031A","E01003507","Total",807,292,63,229,269,136,229,50,179
"2011","Newham 031B","E01003508","Total",555,206,57,149,235,108,135,35,100
"2011","Newham 031C","E01003509","Total",795,301,95,206,301,161,194,49,145
"2011","Newham 031D","E01003604","Total",785,223,95,128,382,205,172,56,116
"2011","Newham 032A","E01003483","Total",492,141,46,95,226,85,149,55,94
"2011","Newham 032B","E01003484","Total",566,84,29,55,252,134,87,40,47
"2011","Newham 032C","E01003516","Total",652,237,73,164,282,124,211,73,138
"2011","Newham 032D","E01003518","Total",588,116,31,85,234,116,109,30,79
"2011","Newham 032E","E01003519","Total",484,108,36,72,200,88,116,36,80
"2011","Newham 033A","E01003480","Total",662,211,44,167,248,120,161,43,118
"2011","Newham 033B","E01003482","Total",1033,183,66,117,370,198,135,47,88
"2011","Newham 033C","E01003486","Total",455,220,65,155,184,53,186,50,136
"2011","Newham 033D","E01003487","Total",424,124,43,81,196,78,129,46,83
"2011","Newham 034A","E01003497","Total",622,230,60,170,241,103,179,41,138
"2011","Newham 034D","E01003506","Total",489,172,46,126,186,72,137,31,106
"2011","Newham 034F","E01033574","Total",579,60,2,58,56,44,21,4,17
"2011","Newham 034G","E01033575","Total",545,68,7,61,41,32,19,1,18
"2011","Newham 034H","E01033576","Total",618,142,21,121,100,71,98,18,80
"2011","Newham 034I","E01033584","Total",564,198,75,123,236,103,155,54,101
"2011","Newham 034J","E01033585","Total",954,337,75,262,287,104,253,65,188
"2011","Newham 035A","E01003479","Total",612,149,45,104,256,149,117,34,83
"2011","Newham 035B","E01003481","Total",500,170,40,130,171,95,145,24,121
"2011","Newham 035C","E01003485","Total",560,142,43,99,254,123,114,36,78
"2011","Newham 035D","E01003513","Total",558,110,44,66,266,134,96,38,58
"2011","Newham 036A","E01003511","Total",452,165,73,92,230,91,111,38,73
"2011","Newham 036B","E01003512","Total",678,237,67,170,263,116,208,51,157
"2011","Newham 036C","E01003514","Total",532,175,57,118,223,105,138,40,98
"2011","Newham 036D","E01003515","Total",755,297,70,227,257,138,222,34,188
"2011","Newham 036E","E01003517","Total",605,180,54,126,268,118,145,54,91
"2011","Newham 037A","E01003609","Total",1058,291,105,186,372,204,185,59,126
"2011","Newham 037C","E01003611","Total",700,247,94,153,297,144,166,48,118
"2011","Newham 037E","E01033577","Total",608,98,30,68,164,82,67,28,39
"2011","Newham 037F","E01033580","Total",659,45,8,37,127,102,59,14,45
"2011","Newham 037G","E01033581","Total",714,213,65,148,251,126,152,31,121
"2011","Newham 037H","E01033582","Total",631,65,15,50,156,115,47,13,34
"2011","Southwark 001A","E01004029","Total",819,126,30,96,165,85,104,28,76
"2011","Southwark 001B","E01004032","Total",714,86,8,78,146,85,72,15,57
"2011","Southwark 001C","E01004053","Total",877,127,18,109,152,96,101,18,83
"2011","Southwark 001D","E01004054","Total",782,94,12,82,134,85,67,12,55
"2011","Southwark 001E","E01004055","Total",513,197,47,150,164,68,165,35,130
"2011","Southwark 002A","E01003927","Total",995,220,35,185,148,69,191,31,160
"2011","Southwark 002B","E01003929","Total",1074,205,34,171,142,69,175,24,151
"2011","Southwark 002C","E01003934","Total",811,272,24,248,97,44,184,24,160
"2011","Southwark 002D","E01003935","Total",451,114,19,95,82,34,121,18,103
"2011","Southwark 002E","E01003939","Total",836,167,31,136,138,68,116,20,96
"2011","Southwark 003A","E01003976","Total",916,248,55,193,218,111,168,38,130
"2011","Southwark 003E","E01004027","Total",993,235,56,179,196,83,170,36,134
"2011","Southwark 003F","E01032637","Total",641,32,1,31,42,31,28,2,26
"2011","Southwark 003G","E01032638","Total",653,44,1,43,50,39,46,3,43
"2011","Southwark 003H","E01032640","Total",672,38,0,38,54,46,32,5,27
"2011","Southwark 003I","E01032646","Total",737,80,14,66,98,54,85,21,64
"2011","Southwark 003J","E01032803","Total",658,60,14,46,81,57,48,7,41
"2011","Southwark 003K","E01032834","Total",666,45,2,43,50,30,41,6,35
"2011","Southwark 004A","E01003975","Total",667,222,86,136,246,126,171,57,114
"2011","Southwark 004B","E01003978","Total",908,220,52,168,186,91,143,33,110
"2011","Southwark 004C","E01004022","Total",1146,299,71,228,254,120,262,53,209
"2011","Southwark 004D","E01004023","Total",703,271,47,224,184,81,201,35,166
"2011","Southwark 004E","E01004028","Total",713,215,41,174,190,86,186,35,151
"2011","Southwark 006A","E01003938","Total",790,201,55,146,212,82,160,39,121
"2011","Southwark 006B","E01003940","Total",620,192,51,141,195,86,145,32,113
"2011","Southwark 006C","E01003941","Total",912,168,29,139,141,79,142,17,125
"2011","Southwark 006D","E01003942","Total",561,195,56,139,183,79,155,34,121
"2011","Southwark 006E","E01003979","Total",809,191,29,162,155,66,155,20,135
"2011","Southwark 006F","E01003981","Total",693,183,28,155,113,56,156,19,137
"2011","Southwark 007A","E01004030","Total",726,193,35,158,119,52,162,23,139
"2011","Southwark 007B","E01004031","Total",880,244,47,197,216,116,160,40,120
"2011","Southwark 007C","E01004033","Total",699,253,53,200,177,76,218,42,176
"2011","Southwark 007D","E01004034","Total",635,210,68,142,217,101,163,36,127
"2011","Southwark 007E","E01004036","Total",806,272,94,178,305,152,182,39,143
"2011","Southwark 008A","E01004056","Total",906,191,40,151,204,100,163,30,133
"2011","Southwark 008B","E01004057","Total",668,136,31,105,168,68,119,31,88
"2011","Southwark 008C","E01004058","Total",855,71,6,65,96,74,63,7,56
"2011","Southwark 008D","E01004059","Total",662,79,8,71,62,44,43,5,38
"2011","Southwark 008E","E01004060","Total",785,215,49,166,210,87,157,37,120
"2011","Southwark 009A","E01003936","Total",552,67,8,59,66,40,51,9,42
"2011","Southwark 009B","E01003937","Total",734,115,20,95,96,47,83,21,62
"2011","Southwark 009C","E01003943","Total",549,165,43,122,186,81,134,32,102
"2011","Southwark 009F","E01032720","Total",681,181,50,131,203,82,122,36,86
"2011","Southwark 010A","E01003977","Total",800,298,59,239,182,93,213,28,185
"2011","Southwark 010B","E01004037","Total",878,213,62,151,259,122,176,44,132
"2011","Southwark 010C","E01004038","Total",920,186,83,103,376,190,159,58,101
"2011","Southwark 010D","E01004042","Total",762,336,60,276,187,76,250,33,217
"2011","Southwark 010E","E01004043","Total",599,196,26,170,123,58,161,23,138
"2011","Southwark 011A","E01003986","Total",549,248,55,193,176,86,200,33,167
"2011","Southwark 011B","E01003987","Total",754,302,63,239,226,88,247,53,194
"2011","Southwark 011C","E01004024","Total",819,307,68,239,224,116,231,48,183
"2011","Southwark 011D","E01004035","Total",687,284,78,206,224,129,193,38,155
"2011","Southwark 012A","E01003960","Total",766,218,51,167,187,83,144,27,117
"2011","Southwark 012B","E01003961","Total",897,368,53,315,235,106,302,48,254
"2011","Southwark 012E","E01003994","Total",622,192,35,157,143,49,173,36,137
"2011","Southwark 012F","E01032722","Total",932,286,56,230,224,89,210,40,170
"2011","Southwark 013A","E01003980","Total",847,310,40,270,166,76,237,32,205
"2011","Southwark 013B","E01004039","Total",633,132,44,88,176,78,106,29,77
"2011","Southwark 013C","E01004040","Total",680,231,73,158,269,110,200,57,143
"2011","Southwark 013D","E01004041","Total",699,221,63,158,245,108,160,38,122
"2011","Southwark 013E","E01004044","Total",556,197,59,138,193,87,150,44,106
"2011","Southwark 014A","E01003992","Total",590,213,75,138,224,98,148,35,113
"2011","Southwark 014B","E01003995","Total",738,259,47,212,154,72,195,35,160
"2011","Southwark 014D","E01003998","Total",632,172,19,153,104,44,158,18,140
"2011","Southwark 014E","E01003999","Total",602,149,42,107,173,83,140,36,104
"2011","Southwark 014F","E01032639","Total",688,149,36,113,121,53,106,27,79
"2011","Southwark 014G","E01032719","Total",623,234,45,189,122,65,151,36,115
"2011","Southwark 015A","E01003964","Total",730,200,55,145,239,119,157,36,121
"2011","Southwark 015B","E01003966","Total",745,248,60,188,243,95,159,45,114
"2011","Southwark 015C","E01003968","Total",525,176,49,127,207,84,135,30,105
"2011","Southwark 015D","E01003971","Total",608,209,80,129,314,135,158,58,100
"2011","Southwark 015E","E01003974","Total",489,165,43,122,177,91,133,34,99
"2011","Southwark 016A","E01003963","Total",662,229,76,153,242,105,186,49,137
"2011","Southwark 016B","E01003967","Total",600,188,67,121,238,133,164,41,123
"2011","Southwark 016C","E01003970","Total",579,199,59,140,216,98,176,44,132
"2011","Southwark 016D","E01003972","Total",714,193,44,149,210,108,134,37,97
"2011","Southwark 016E","E01003973","Total",739,229,58,171,231,103,178,33,145
"2011","Southwark 017A","E01003923","Total",730,171,38,133,188,94,135,26,109
"2011","Southwark 017B","E01003969","Total",764,184,44,140,199,93,161,37,124
"2011","Southwark 017C","E01003991","Total",559,241,40,201,125,54,204,27,177
"2011","Southwark 017D","E01003993","Total",630,193,58,135,257,110,173,53,120
"2011","Southwark 017E","E01003997","Total",472,129,38,91,138,50,116,28,88
"2011","Southwark 018A","E01003983","Total",730,258,91,167,287,124,200,63,137
"2011","Southwark 018B","E01003988","Total",898,299,74,225,270,141,268,60,208
"2011","Southwark 018C","E01003989","Total",720,216,97,119,340,146,139,42,97
"2011","Southwark 018D","E01003990","Total",769,255,88,167,332,142,215,78,137
"2011","Southwark 018E","E01004007","Total",436,147,60,87,195,68,141,44,97
"2011","Southwark 019A","E01003912","Total",571,205,77,128,274,134,165,60,105
"2011","Southwark 019B","E01004011","Total",724,198,91,107,365,172,172,70,102
"2011","Southwark 019C","E01004012","Total",934,234,83,151,360,179,188,74,114
"2011","Southwark 019D","E01004013","Total",606,178,75,103,266,112,152,54,98
"2011","Southwark 019E","E01004014","Total",710,233,75,158,276,121,181,52,129
"2011","Southwark 020A","E01003911","Total",742,191,73,118,299,139,161,59,102
"2011","Southwark 020B","E01003916","Total",830,177,34,143,245,116,129,26,103
"2011","Southwark 020C","E01003917","Total",787,225,28,197,191,109,207,26,181
"2011","Southwark 020D","E01003918","Total",653,246,60,186,211,103,179,41,138
"2011","Southwark 020E","E01003925","Total",527,164,41,123,184,69,143,40,103
"2011","Southwark 021A","E01003919","Total",702,152,34,118,195,99,149,34,115
"2011","Southwark 021B","E01003920","Total",766,240,64,176,284,134,206,43,163
"2011","Southwark 021C","E01003921","Total",673,204,33,171,160,61,154,26,128
"2011","Southwark 021D","E01003922","Total",821,228,62,166,274,123,204,46,158
"2011","Southwark 021E","E01003924","Total",802,245,62,183,277,158,208,42,166
"2011","Southwark 021F","E01003926","Total",540,166,44,122,184,72,144,39,105
"2011","Southwark 022B","E01004008","Total",808,255,79,176,302,121,196,52,144
"2011","Southwark 022D","E01004010","Total",601,180,60,120,234,99,159,43,116
"2011","Southwark 022E","E01004067","Total",831,230,76,154,282,144,201,64,137
"2011","Southwark 022F","E01032805","Total",940,294,81,213,342,159,271,88,183
"2011","Southwark 023A","E01003984","Total",856,274,38,236,208,98,241,37,204
"2011","Southwark 023B","E01004003","Total",755,276,59,217,223,115,222,38,184
"2011","Southwark 023C","E01004004","Total",1069,315,64,251,266,131,279,45,234
"2011","Southwark 023D","E01004005","Total",882,335,85,250,309,168,258,65,193
"2011","Southwark 023E","E01004006","Total",772,227,55,172,222,111,228,51,177
"2011","Southwark 024A","E01003913","Total",800,195,25,170,193,96,179,32,147
"2011","Southwark 024B","E01003914","Total",722,183,41,142,194,88,180,35,145
"2011","Southwark 024C","E01003915","Total",811,211,39,172,225,121,195,36,159
"2011","Southwark 024D","E01004050","Total",652,105,23,82,152,66,85,16,69
"2011","Southwark 024E","E01004052","Total",798,177,15,162,169,100,161,17,144
"2011","Southwark 025A","E01004061","Total",772,156,21,135,182,85,150,26,124
"2011","Southwark 025B","E01004062","Total",830,242,61,181,271,164,196,54,142
"2011","Southwark 025C","E01004063","Total",847,230,30,200,206,114,227,32,195
"2011","Southwark 025D","E01004065","Total",625,122,26,96,188,100,98,19,79
"2011","Southwark 025E","E01004066","Total",844,226,68,158,307,154,192,57,135
"2011","Southwark 026A","E01004000","Total",839,264,51,213,224,112,238,40,198
"2011","Southwark 026B","E01004001","Total",718,293,64,229,231,103,271,51,220
"2011","Southwark 026C","E01004019","Total",912,203,63,140,331,170,199,57,142
"2011","Southwark 026D","E01004064","Total",808,273,79,194,285,149,219,54,165
"2011","Southwark 026E","E01004068","Total",829,320,66,254,259,125,251,58,193
"2011","Southwark 027A","E01004045","Total",601,166,69,97,275,143,129,50,79
"2011","Southwark 027B","E01004047","Total",607,205,65,140,253,105,167,50,117
"2011","Southwark 027C","E01004048","Total",645,130,38,92,214,101,145,48,97
"2011","Southwark 027D","E01004049","Total",507,124,46,78,230,114,109,41,68
"2011","Southwark 027E","E01004051","Total",613,135,20,115,124,63,99,12,87
"2011","Southwark 028A","E01003953","Total",980,175,26,149,185,107,144,21,123
"2011","Southwark 028B","E01003955","Total",822,195,23,172,189,108,158,23,135
"2011","Southwark 028C","E01004015","Total",690,146,20,126,198,108,154,28,126
"2011","Southwark 028D","E01004021","Total",1032,181,26,155,209,121,159,36,123
"2011","Southwark 028E","E01004046","Total",674,124,18,106,198,106,118,22,96
"2011","Southwark 029A","E01004002","Total",639,155,29,126,214,94,157,38,119
"2011","Southwark 029B","E01004016","Total",934,235,66,169,347,196,191,51,140
"2011","Southwark 029C","E01004017","Total",627,126,22,104,202,87,125,30,95
"2011","Southwark 029D","E01004020","Total",730,245,83,162,280,131,163,50,113
"2011","Southwark 030A","E01003952","Total",692,114,17,97,187,104,108,20,88
"2011","Southwark 030B","E01003954","Total",670,149,16,133,189,124,118,16,102
"2011","Southwark 030C","E01003956","Total",720,123,16,107,211,126,142,30,112
"2011","Southwark 030D","E01004071","Total",663,161,27,134,207,88,158,30,128
"2011","Southwark 030E","E01004072","Total",617,88,5,83,248,102,104,24,80
"2011","Southwark 031A","E01004069","Total",497,94,9,85,204,74,91,19,72
"2011","Southwark 031B","E01004070","Total",779,173,20,153,265,117,169,38,131
"2011","Southwark 031C","E01004073","Total",736,136,21,115,282,141,123,33,90
"2011","Southwark 031D","E01004074","Total",631,121,15,106,259,105,121,30,91
"2011","Southwark 031E","E01004075","Total",657,131,10,121,292,120,88,24,64
"2011","Southwark 032A","E01003949","Total",871,180,32,148,226,114,155,29,126
"2011","Southwark 032B","E01003950","Total",798,262,77,185,256,116,237,57,180
"2011","Southwark 032C","E01003957","Total",714,137,25,112,223,112,130,28,102
"2011","Southwark 032D","E01003958","Total",699,146,17,129,214,127,149,27,122
"2011","Southwark 032E","E01004018","Total",780,139,16,123,259,145,125,30,95
"2011","Southwark 033A","E01003945","Total",730,185,21,164,207,98,148,27,121
"2011","Southwark 033B","E01003946","Total",726,228,42,186,228,111,146,32,114
"2011","Southwark 033C","E01003947","Total",612,234,85,149,268,125,167,54,113
"2011","Southwark 033D","E01003948","Total",742,160,28,132,187,109,140,14,126
"2011","Southwark 033E","E01003951","Total",571,151,20,131,174,68,126,25,101
"2011","Southwark 034A","E01003930","Total",458,139,16,123,81,43,109,14,95
"2011","Southwark 034B","E01003932","Total",651,210,39,171,146,66,163,22,141
"2011","Southwark 034C","E01003933","Total",537,129,31,98,124,50,128,36,92
"2011","Southwark 034D","E01032583","Total",644,158,27,131,121,54,134,19,115
"2011","Southwark 034E","E01032584","Total",577,140,23,117,126,46,131,27,104
"2011","Tower Hamlets 001A","E01004222","Total",1048,451,118,333,299,156,346,71,275
"2011","Tower Hamlets 001B","E01004223","Total",938,361,80,281,258,128,288,50,238
"2011","Tower Hamlets 001C","E01004224","Total",806,263,62,201,194,83,206,56,150
"2011","Tower Hamlets 001D","E01004226","Total",676,214,73,141,222,125,158,44,114
"2011","Tower Hamlets 002A","E01004197","Total",964,228,63,165,236,132,204,53,151
"2011","Tower Hamlets 002B","E01004198","Total",606,234,46,188,152,85,196,35,161
"2011","Tower Hamlets 002C","E01004199","Total",574,225,89,136,234,103,175,62,113
"2011","Tower Hamlets 002D","E01004201","Total",619,193,44,149,173,84,161,32,129
"2011","Tower Hamlets 003A","E01004228","Total",769,203,36,167,178,95,177,31,146
"2011","Tower Hamlets 003B","E01004230","Total",803,266,57,209,230,114,209,47,162
"2011","Tower Hamlets 003C","E01004232","Total",603,109,19,90,124,65,96,21,75
"2011","Tower Hamlets 003D","E01004233","Total",751,284,67,217,202,118,215,41,174
"2011","Tower Hamlets 003E","E01004234","Total",903,199,37,162,211,119,163,30,133
"2011","Tower Hamlets 004A","E01004225","Total",1147,140,33,107,136,102,93,17,76
"2011","Tower Hamlets 004C","E01004229","Total",551,154,44,110,162,83,134,34,100
"2011","Tower Hamlets 004D","E01004231","Total",629,235,86,149,240,124,167,48,119
"2011","Tower Hamlets 004E","E01032764","Total",643,125,34,91,105,61,100,33,67
"2011","Tower Hamlets 004F","E01032765","Total",645,177,54,123,152,62,158,47,111
"2011","Tower Hamlets 004G","E01032784","Total",692,149,46,103,128,68,103,29,74
"2011","Tower Hamlets 005A","E01004200","Total",585,107,22,85,86,38,93,22,71
"2011","Tower Hamlets 005B","E01004202","Total",713,137,58,79,149,79,114,34,80
"2011","Tower Hamlets 005C","E01004203","Total",689,163,49,114,151,78,147,35,112
"2011","Tower Hamlets 005D","E01004204","Total",631,253,48,205,163,76,199,41,158
"2011","Tower Hamlets 006A","E01004311","Total",644,242,54,188,157,86,211,47,164
"2011","Tower Hamlets 006B","E01004314","Total",493,115,11,104,93,52,101,14,87
"2011","Tower Hamlets 006C","E01004315","Total",718,215,25,190,112,53,194,29,165
"2011","Tower Hamlets 006D","E01004318","Total",630,201,62,139,182,83,151,32,119
"2011","Tower Hamlets 007A","E01004259","Total",812,193,42,151,143,79,150,37,113
"2011","Tower Hamlets 007B","E01004260","Total",636,206,69,137,220,112,175,53,122
"2011","Tower Hamlets 007C","E01004263","Total",529,203,58,145,173,64,161,37,124
"2011","Tower Hamlets 007D","E01004266","Total",583,172,45,127,168,74,150,38,112
"2011","Tower Hamlets 008A","E01004235","Total",513,171,56,115,214,112,138,48,90
"2011","Tower Hamlets 008B","E01004236","Total",497,179,82,97,236,111,145,59,86
"2011","Tower Hamlets 008C","E01004237","Total",506,165,58,107,140,87,98,22,76
"2011","Tower Hamlets 008D","E01004238","Total",1058,301,119,182,356,209,187,65,122
"2011","Tower Hamlets 008E","E01004239","Total",533,172,62,110,215,101,134,53,81
"2011","Tower Hamlets 009A","E01004312","Total",628,241,53,188,158,86,185,37,148
"2011","Tower Hamlets 009B","E01004313","Total",812,249,97,152,227,112,175,54,121
"2011","Tower Hamlets 009C","E01004316","Total",455,131,41,90,118,65,104,24,80
"2011","Tower Hamlets 009D","E01004317","Total",1193,189,45,144,179,102,163,40,123
"2011","Tower Hamlets 010A","E01004261","Total",550,236,44,192,154,81,137,37,100
"2011","Tower Hamlets 010B","E01004262","Total",495,179,32,147,128,60,135,32,103
"2011","Tower Hamlets 010C","E01004264","Total",457,151,62,89,193,106,144,51,93
"2011","Tower Hamlets 010E","E01032785","Total",616,116,37,79,127,84,73,21,52
"2011","Tower Hamlets 010F","E01032786","Total",674,221,46,175,186,109,158,32,126
"2011","Tower Hamlets 011A","E01004207","Total",515,180,41,139,142,73,159,33,126
"2011","Tower Hamlets 011B","E01004209","Total",466,164,72,92,184,100,144,52,92
"2011","Tower Hamlets 011D","E01004212","Total",720,291,57,234,153,78,142,35,107
"2011","Tower Hamlets 011F","E01032787","Total",793,229,87,142,324,168,205,89,116
"2011","Tower Hamlets 012A","E01004240","Total",574,198,88,110,262,122,158,64,94
"2011","Tower Hamlets 012B","E01004241","Total",570,217,66,151,234,114,154,42,112
"2011","Tower Hamlets 012C","E01004242","Total",898,263,108,155,319,183,166,60,106
"2011","Tower Hamlets 012D","E01004267","Total",707,175,56,119,164,78,125,45,80
"2011","Tower Hamlets 012E","E01004268","Total",688,252,78,174,220,116,190,47,143
"2011","Tower Hamlets 013A","E01004205","Total",688,255,90,165,278,144,196,72,124
"2011","Tower Hamlets 013B","E01004206","Total",554,239,56,183,171,79,185,36,149
"2011","Tower Hamlets 013C","E01004208","Total",788,160,26,134,119,67,107,27,80
"2011","Tower Hamlets 013D","E01004211","Total",720,168,23,145,85,42,111,18,93
"2011","Tower Hamlets 014A","E01004269","Total",726,250,56,194,211,117,189,34,155
"2011","Tower Hamlets 014B","E01004270","Total",745,150,47,103,185,98,121,40,81
"2011","Tower Hamlets 014C","E01004271","Total",548,198,63,135,239,151,127,37,90
"2011","Tower Hamlets 014D","E01004272","Total",639,216,97,119,319,176,202,92,110
"2011","Tower Hamlets 014E","E01004273","Total",594,198,95,103,276,131,177,69,108
"2011","Tower Hamlets 015A","E01004306","Total",687,155,30,125,145,69,118,35,83
"2011","Tower Hamlets 015B","E01004307","Total",1014,149,15,134,100,58,82,12,70
"2011","Tower Hamlets 015C","E01004308","Total",504,143,38,105,137,75,109,26,83
"2011","Tower Hamlets 015D","E01004309","Total",902,274,67,207,233,125,208,80,128
"2011","Tower Hamlets 015E","E01004310","Total",793,205,38,167,146,69,168,38,130
"2011","Tower Hamlets 016A","E01004283","Total",756,243,75,168,257,101,208,74,134
"2011","Tower Hamlets 016B","E01004287","Total",854,334,70,264,260,147,239,59,180
"2011","Tower Hamlets 016C","E01004289","Total",670,251,39,212,179,80,213,54,159
"2011","Tower Hamlets 016D","E01004290","Total",575,183,25,158,87,45,129,14,115
"2011","Tower Hamlets 017A","E01004322","Total",502,175,35,140,133,79,127,25,102
"2011","Tower Hamlets 017B","E01004323","Total",480,123,31,92,141,89,112,27,85
"2011","Tower Hamlets 017C","E01004324","Total",485,149,52,97,184,88,150,51,99
"2011","Tower Hamlets 017D","E01004326","Total",623,194,35,159,140,86,148,32,116
"2011","Tower Hamlets 018A","E01004245","Total",433,162,96,66,259,127,136,75,61
"2011","Tower Hamlets 018B","E01004246","Total",747,187,65,122,225,124,150,41,109
"2011","Tower Hamlets 018C","E01004248","Total",441,194,80,114,210,103,157,56,101
"2011","Tower Hamlets 018D","E01004249","Total",758,287,106,181,288,140,206,58,148
"2011","Tower Hamlets 019A","E01004284","Total",884,225,67,158,282,168,191,63,128
"2011","Tower Hamlets 019B","E01004285","Total",658,231,85,146,318,167,184,70,114
"2011","Tower Hamlets 019C","E01004286","Total",817,266,86,180,297,163,226,73,153
"2011","Tower Hamlets 019D","E01004288","Total",525,183,75,108,231,98,155,60,95
"2011","Tower Hamlets 020A","E01004243","Total",614,225,83,142,246,138,174,60,114
"2011","Tower Hamlets 020B","E01004244","Total",686,299,87,212,243,109,210,45,165
"2011","Tower Hamlets 020C","E01004247","Total",714,289,85,204,261,133,214,69,145
"2011","Tower Hamlets 020D","E01004250","Total",866,332,119,213,348,182,251,70,181
"2011","Tower Hamlets 021A","E01004319","Total",595,181,65,116,210,116,171,62,109
"2011","Tower Hamlets 021C","E01004321","Total",711,215,54,161,175,92,158,51,107
"2011","Tower Hamlets 021D","E01004325","Total",1033,172,45,127,151,83,102,26,76
"2011","Tower Hamlets 021E","E01032766","Total",601,97,37,60,96,58,67,20,47
"2011","Tower Hamlets 021F","E01032767","Total",767,78,8,70,47,29,37,5,32
"2011","Tower Hamlets 022A","E01004298","Total",635,224,65,159,179,102,187,42,145
"2011","Tower Hamlets 022B","E01004300","Total",522,197,48,149,160,72,174,43,131
"2011","Tower Hamlets 022C","E01004304","Total",653,227,65,162,243,131,192,60,132
"2011","Tower Hamlets 022D","E01004305","Total",699,253,81,172,233,118,210,66,144
"2011","Tower Hamlets 023A","E01004251","Total",779,289,77,212,264,150,233,49,184
"2011","Tower Hamlets 023B","E01004254","Total",1046,86,20,66,145,95,63,20,43
"2011","Tower Hamlets 023C","E01004255","Total",647,200,55,145,192,91,156,38,118
"2011","Tower Hamlets 023D","E01004258","Total",713,151,26,125,142,81,121,19,102
"2011","Tower Hamlets 024A","E01004252","Total",1107,283,106,177,339,180,208,72,136
"2011","Tower Hamlets 024B","E01004253","Total",829,324,126,198,341,177,260,66,194
"2011","Tower Hamlets 024C","E01004256","Total",611,228,76,152,239,128,156,51,105
"2011","Tower Hamlets 024D","E01004257","Total",618,218,104,114,296,144,138,64,74
"2011","Tower Hamlets 025B","E01004301","Total",413,131,54,77,156,79,94,38,56
"2011","Tower Hamlets 025C","E01004302","Total",637,170,88,82,284,165,149,78,71
"2011","Tower Hamlets 025D","E01004303","Total",967,291,64,227,278,180,191,51,140
"2011","Tower Hamlets 025E","E01032768","Total",696,63,10,53,88,71,53,10,43
"2011","Tower Hamlets 025F","E01032769","Total",593,75,18,57,105,69,60,15,45
"2011","Tower Hamlets 026A","E01004292","Total",818,78,13,65,119,80,76,20,56
"2011","Tower Hamlets 026B","E01004294","Total",877,160,20,140,120,73,128,23,105
"2011","Tower Hamlets 026C","E01004295","Total",500,161,62,99,208,144,139,44,95
"2011","Tower Hamlets 026D","E01004296","Total",684,180,37,143,169,92,151,38,113
"2011","Tower Hamlets 027A","E01004291","Total",1051,171,26,145,106,69,125,17,108
"2011","Tower Hamlets 027B","E01004293","Total",1133,167,12,155,143,93,143,27,116
"2011","Tower Hamlets 027C","E01004297","Total",909,111,11,100,137,94,102,21,81
"2011","Tower Hamlets 028A","E01004215","Total",1168,306,92,214,294,158,204,54,150
"2011","Tower Hamlets 028B","E01004219","Total",851,230,90,140,287,163,143,50,93
"2011","Tower Hamlets 028D","E01004221","Total",802,130,50,80,177,100,122,41,81
"2011","Tower Hamlets 028E","E01032776","Total",631,96,15,81,71,56,24,7,17
"2011","Tower Hamlets 028F","E01032777","Total",514,81,25,56,122,62,47,16,31
"2011","Tower Hamlets 028G","E01032778","Total",564,99,29,70,99,81,35,4,31
"2011","Tower Hamlets 028H","E01032779","Total",565,90,36,54,114,81,37,12,25
"2011","Tower Hamlets 028I","E01032780","Total",647,46,3,43,85,64,39,7,32
"2011","Tower Hamlets 030A","E01004214","Total",665,266,82,184,258,132,213,54,159
"2011","Tower Hamlets 030B","E01004216","Total",737,162,46,116,171,106,116,26,90
"2011","Tower Hamlets 030C","E01004217","Total",779,232,44,188,194,122,192,32,160
"2011","Tower Hamlets 030D","E01004218","Total",731,154,36,118,192,98,109,24,85
"2011","Tower Hamlets 031A","E01004274","Total",654,162,61,101,260,145,140,55,85
"2011","Tower Hamlets 031B","E01004275","Total",768,149,47,102,216,128,122,32,90
"2011","Tower Hamlets 031C","E01004276","Total",996,88,14,74,131,98,53,7,46
"2011","Tower Hamlets 031D","E01004281","Total",831,96,32,64,165,111,66,16,50
"2011","Tower Hamlets 031F","E01032775","Total",600,52,13,39,86,63,27,3,24
"2011","Tower Hamlets 031G","E01032783","Total",661,129,19,110,108,62,108,16,92
"2011","Tower Hamlets 032A","E01004280","Total",769,178,51,127,233,143,138,51,87
"2011","Tower Hamlets 032B","E01032770","Total",572,127,32,95,101,69,78,14,64
"2011","Tower Hamlets 032C","E01032772","Total",544,141,21,120,88,47,87,22,65
"2011","Tower Hamlets 032D","E01032773","Total",852,167,57,110,154,111,51,20,31
"2011","Tower Hamlets 032E","E01032774","Total",583,156,60,96,174,102,101,34,67
"2011","Tower Hamlets 033A","E01004277","Total",898,80,4,76,121,96,53,6,47
"2011","Tower Hamlets 033B","E01032771","Total",546,107,37,70,97,56,58,22,36
"2011","Tower Hamlets 033C","E01032781","Total",771,70,15,55,112,66,57,14,43
"2011","Tower Hamlets 033D","E01032782","Total",776,169,56,113,154,87,82,33,49
"2011","Wandsworth 001A","E01004560","Total",959,161,25,136,159,82,114,19,95
"2011","Wandsworth 001B","E01004566","Total",821,157,7,150,130,80,120,9,111
"2011","Wandsworth 001C","E01004582","Total",976,182,25,157,203,115,126,25,101
"2011","Wandsworth 001D","E01004583","Total",876,226,25,201,141,68,144,25,119
"2011","Wandsworth 002B","E01004562","Total",754,241,44,197,173,66,186,32,154
"2011","Wandsworth 002C","E01004563","Total",879,244,79,165,229,107,180,45,135
"2011","Wandsworth 002D","E01004564","Total",820,153,26,127,126,59,143,20,123
"2011","Wandsworth 002E","E01004567","Total",982,272,117,155,328,154,209,57,152
"2011","Wandsworth 002F","E01033098","Total",629,140,9,131,55,39,35,3,32
"2011","Wandsworth 002G","E01033100","Total",612,175,25,150,92,43,146,18,128
"2011","Wandsworth 002H","E01033132","Total",619,160,27,133,94,46,69,12,57
"2011","Wandsworth 003A","E01004539","Total",800,290,102,188,321,133,223,70,153
"2011","Wandsworth 003B","E01004540","Total",1002,284,53,231,221,107,223,35,188
"2011","Wandsworth 003C","E01004577","Total",907,197,28,169,165,88,184,22,162
"2011","Wandsworth 003D","E01004584","Total",703,256,80,176,265,107,191,61,130
"2011","Wandsworth 004B","E01004579","Total",744,168,28,140,173,86,132,23,109
"2011","Wandsworth 004C","E01004580","Total",892,164,38,126,177,98,122,22,100
"2011","Wandsworth 004D","E01004581","Total",892,184,22,162,134,67,153,22,131
"2011","Wandsworth 004E","E01033099","Total",456,95,28,67,94,37,61,14,47
"2011","Wandsworth 004F","E01033101","Total",663,78,7,71,57,36,41,6,35
"2011","Wandsworth 004G","E01033133","Total",636,87,21,66,91,46,55,15,40
"2011","Wandsworth 005A","E01004565","Total",815,164,40,124,144,87,129,21,108
"2011","Wandsworth 005B","E01004590","Total",807,258,47,211,179,77,192,27,165
"2011","Wandsworth 005C","E01004591","Total",811,176,24,152,123,60,149,17,132
"2011","Wandsworth 005D","E01004592","Total",795,231,45,186,165,83,196,26,170
"2011","Wandsworth 006A","E01004604","Total",593,85,7,78,235,111,73,19,54
"2011","Wandsworth 006B","E01004605","Total",785,196,24,172,196,96,162,25,137
"2011","Wandsworth 006C","E01004606","Total",754,90,6,84,131,90,77,11,66
"2011","Wandsworth 006D","E01004607","Total",718,119,7,112,193,111,84,12,72
"2011","Wandsworth 006E","E01004608","Total",785,197,15,182,131,72,151,11,140
"2011","Wandsworth 007A","E01004535","Total",731,263,108,155,294,143,202,62,140
"2011","Wandsworth 007B","E01004537","Total",799,265,69,196,220,99,214,47,167
"2011","Wandsworth 007C","E01004538","Total",909,252,69,183,232,114,176,32,144
"2011","Wandsworth 007D","E01004541","Total",762,304,54,250,177,72,253,41,212
"2011","Wandsworth 008A","E01004534","Total",825,126,17,109,150,102,113,22,91
"2011","Wandsworth 008B","E01004536","Total",928,214,57,157,207,92,157,29,128
"2011","Wandsworth 008C","E01004552","Total",913,76,7,69,103,75,89,4,85
"2011","Wandsworth 008D","E01004585","Total",858,146,15,131,144,76,124,20,104
"2011","Wandsworth 008E","E01004588","Total",858,121,17,104,158,111,85,7,78
"2011","Wandsworth 009A","E01004554","Total",653,75,9,66,184,113,65,15,50
"2011","Wandsworth 009B","E01004556","Total",590,55,2,53,248,163,63,17,46
"2011","Wandsworth 009C","E01004586","Total",848,105,14,91,118,71,97,14,83
"2011","Wandsworth 009D","E01004587","Total",735,101,7,94,159,107,98,10,88
"2011","Wandsworth 009E","E01004589","Total",706,74,2,72,143,91,70,9,61
"2011","Wandsworth 010A","E01004509","Total",1122,170,21,149,113,76,127,21,106
"2011","Wandsworth 010B","E01004511","Total",712,85,7,78,148,84,57,10,47
"2011","Wandsworth 010C","E01004602","Total",706,79,6,73,139,81,79,11,68
"2011","Wandsworth 010E","E01004609","Total",996,143,7,136,147,82,103,10,93
"2011","Wandsworth 010F","E01033093","Total",766,73,7,66,127,71,57,10,47
"2011","Wandsworth 010G","E01033135","Total",475,55,6,49,103,58,53,12,41
"2011","Wandsworth 011A","E01004506","Total",955,172,8,164,129,72,118,11,107
"2011","Wandsworth 011B","E01004638","Total",519,97,10,87,182,52,77,16,61
"2011","Wandsworth 011C","E01004639","Total",783,163,11,152,162,85,122,19,103
"2011","Wandsworth 011D","E01004640","Total",797,145,16,129,179,94,106,15,91
"2011","Wandsworth 011E","E01004641","Total",818,270,24,246,196,88,205,30,175
"2011","Wandsworth 012A","E01004508","Total",986,160,17,143,135,78,129,15,114
"2011","Wandsworth 012B","E01004510","Total",917,106,11,95,144,82,97,19,78
"2011","Wandsworth 012C","E01004514","Total",799,122,14,108,142,113,104,14,90
"2011","Wandsworth 012D","E01004515","Total",739,117,24,93,135,60,120,26,94
"2011","Wandsworth 012E","E01004551","Total",884,168,30,138,147,80,152,22,130
"2011","Wandsworth 013A","E01004568","Total",458,184,60,124,169,88,126,21,105
"2011","Wandsworth 013B","E01004574","Total",727,298,123,175,314,162,209,62,147
"2011","Wandsworth 013C","E01004575","Total",691,325,56,269,149,53,250,42,208
"2011","Wandsworth 013D","E01004576","Total",592,199,47,152,205,105,178,47,131
"2011","Wandsworth 014A","E01004500","Total",807,199,14,185,90,51,147,15,132
"2011","Wandsworth 014B","E01004501","Total",712,190,35,155,165,84,137,27,110
"2011","Wandsworth 014C","E01004503","Total",738,148,19,129,134,60,130,22,108
"2011","Wandsworth 014D","E01004505","Total",838,226,15,211,106,60,126,9,117
"2011","Wandsworth 014E","E01004507","Total",962,199,16,183,103,57,123,10,113
"2011","Wandsworth 015A","E01004553","Total",766,116,13,103,140,88,96,16,80
"2011","Wandsworth 015B","E01004557","Total",650,103,9,94,183,107,109,16,93
"2011","Wandsworth 015C","E01004558","Total",675,87,9,78,232,137,94,27,67
"2011","Wandsworth 015D","E01004559","Total",503,74,11,63,209,107,59,14,45
"2011","Wandsworth 015E","E01004619","Total",536,77,9,68,196,82,69,14,55
"2011","Wandsworth 016A","E01004572","Total",706,208,43,165,187,88,146,23,123
"2011","Wandsworth 016B","E01004642","Total",761,261,41,220,213,112,180,36,144
"2011","Wandsworth 016C","E01004643","Total",851,270,50,220,227,110,193,37,156
"2011","Wandsworth 016D","E01004644","Total",870,290,39,251,215,93,200,25,175
"2011","Wandsworth 016E","E01004645","Total",844,311,85,226,270,138,237,49,188
"2011","Wandsworth 017A","E01004477","Total",607,101,6,95,215,107,83,10,73
"2011","Wandsworth 017B","E01004478","Total",538,78,8,70,224,125,70,15,55
"2011","Wandsworth 017C","E01004479","Total",613,110,15,95,199,90,91,16,75
"2011","Wandsworth 017D","E01004550","Total",570,125,47,78,195,109,81,26,55
"2011","Wandsworth 017E","E01004555","Total",587,78,9,69,255,160,74,18,56
"2011","Wandsworth 018A","E01004494","Total",762,153,30,123,170,97,130,20,110
"2011","Wandsworth 018B","E01004513","Total",833,196,38,158,181,95,166,31,135
"2011","Wandsworth 018C","E01004600","Total",893,222,100,122,292,136,152,50,102
"2011","Wandsworth 018D","E01004601","Total",1006,218,40,178,231,126,164,35,129
"2011","Wandsworth 019A","E01004493","Total",803,119,20,99,156,88,123,19,104
"2011","Wandsworth 019B","E01004512","Total",618,110,17,93,178,105,94,14,80
"2011","Wandsworth 019C","E01004620","Total",702,131,14,117,200,127,112,21,91
"2011","Wandsworth 019D","E01004621","Total",659,94,12,82,169,76,74,21,53
"2011","Wandsworth 019E","E01004623","Total",712,120,13,107,217,145,102,19,83
"2011","Wandsworth 019F","E01004627","Total",631,116,19,97,204,116,95,20,75
"2011","Wandsworth 020A","E01004499","Total",713,128,18,110,130,63,102,13,89
"2011","Wandsworth 020B","E01004502","Total",670,87,3,84,182,107,94,14,80
"2011","Wandsworth 020C","E01004504","Total",566,97,6,91,183,87,71,10,61
"2011","Wandsworth 020D","E01004594","Total",590,94,10,84,219,101,75,19,56
"2011","Wandsworth 020E","E01004596","Total",646,107,5,102,205,103,96,14,82
"2011","Wandsworth 020F","E01004629","Total",609,138,19,119,184,73,109,23,86
"2011","Wandsworth 021A","E01004472","Total",742,125,12,113,161,91,99,15,84
"2011","Wandsworth 021B","E01004474","Total",918,120,14,106,113,71,112,16,96
"2011","Wandsworth 021C","E01004476","Total",824,155,15,140,92,46,126,20,106
"2011","Wandsworth 021D","E01004542","Total",618,92,13,79,195,111,76,13,63
"2011","Wandsworth 021E","E01004544","Total",606,89,11,78,192,105,91,14,77
"2011","Wandsworth 022A","E01004628","Total",911,158,37,121,222,108,127,22,105
"2011","Wandsworth 022B","E01004630","Total",679,228,75,153,268,117,162,42,120
"2011","Wandsworth 022C","E01004631","Total",643,154,38,116,178,89,118,22,96
"2011","Wandsworth 022D","E01004633","Total",623,169,59,110,230,100,127,38,89
"2011","Wandsworth 023A","E01004569","Total",737,216,49,167,236,96,168,40,128
"2011","Wandsworth 023B","E01004570","Total",745,299,58,241,203,90,243,49,194
"2011","Wandsworth 023C","E01004571","Total",651,237,49,188,176,76,196,33,163
"2011","Wandsworth 023D","E01004573","Total",631,178,27,151,166,73,139,21,118
"2011","Wandsworth 024A","E01004495","Total",523,107,41,66,175,66,113,39,74
"2011","Wandsworth 024B","E01004496","Total",951,127,8,119,125,83,118,13,105
"2011","Wandsworth 024C","E01004497","Total",541,119,15,104,186,97,122,23,99
"2011","Wandsworth 024D","E01004622","Total",533,123,20,103,102,58,97,18,79
"2011","Wandsworth 024E","E01004624","Total",624,125,21,104,182,77,111,22,89
"2011","Wandsworth 025A","E01004593","Total",852,137,13,124,182,117,107,20,87
"2011","Wandsworth 025B","E01004595","Total",796,122,17,105,190,114,124,24,100
"2011","Wandsworth 025C","E01004597","Total",779,162,27,135,244,147,131,21,110
"2011","Wandsworth 025D","E01004598","Total",818,75,8,67,150,105,79,11,68
"2011","Wandsworth 025E","E01004599","Total",575,86,8,78,225,133,76,15,61
"2011","Wandsworth 026A","E01004473","Total",746,134,15,119,147,93,123,21,102
"2011","Wandsworth 026B","E01004475","Total",622,109,15,94,112,65,83,19,64
"2011","Wandsworth 026C","E01004480","Total",678,79,6,73,118,86,85,13,72
"2011","Wandsworth 026D","E01004483","Total",1011,133,33,100,202,117,101,21,80
"2011","Wandsworth 026E","E01004484","Total",652,120,19,101,114,56,98,15,83
"2011","Wandsworth 026F","E01004486","Total",784,176,19,157,102,57,128,15,113
"2011","Wandsworth 027A","E01004543","Total",717,100,15,85,224,120,92,19,73
"2011","Wandsworth 027B","E01004545","Total",850,145,6,139,74,44,115,10,105
"2011","Wandsworth 027C","E01004546","Total",640,76,6,70,141,82,88,14,74
"2011","Wandsworth 027D","E01004549","Total",672,133,8,125,163,74,138,21,117
"2011","Wandsworth 027E","E01004625","Total",469,104,5,99,193,81,83,17,66
"2011","Wandsworth 027F","E01004626","Total",724,98,11,87,196,109,63,12,51
"2011","Wandsworth 028A","E01004632","Total",593,122,19,103,192,77,108,22,86
"2011","Wandsworth 028B","E01004634","Total",697,170,28,142,137,78,126,25,101
"2011","Wandsworth 028C","E01004635","Total",691,152,28,124,178,95,100,21,79
"2011","Wandsworth 028D","E01004636","Total",650,135,31,104,180,86,92,18,74
"2011","Wandsworth 028E","E01004637","Total",602,160,29,131,154,75,124,28,96
"2011","Wandsworth 029A","E01004481","Total",716,93,19,74,122,74,107,18,89
"2011","Wandsworth 029B","E01004488","Total",625,146,23,123,175,90,100,15,85
"2011","Wandsworth 029C","E01004547","Total",551,126,9,117,137,62,120,20,100
"2011","Wandsworth 029D","E01004548","Total",1054,240,24,216,134,71,168,14,154
"2011","Wandsworth 030A","E01004482","Total",626,131,32,99,155,62,111,23,88
"2011","Wandsworth 030B","E01004485","Total",691,144,18,126,151,76,130,20,110
"2011","Wandsworth 030C","E01004487","Total",715,135,21,114,153,75,132,24,108
"2011","Wandsworth 030D","E01004489","Total",612,110,14,96,164,76,109,20,89
"2011","Wandsworth 031A","E01004490","Total",614,84,3,81,174,119,86,14,72
"2011","Wandsworth 031B","E01004491","Total",971,154,36,118,191,124,136,34,102
"2011","Wandsworth 031C","E01004492","Total",744,131,19,112,177,96,136,27,109
"2011","Wandsworth 031D","E01004498","Total",784,103,11,92,150,118,81,7,74
"2011","Wandsworth 032A","E01004532","Total",644,154,33,121,168,102,121,21,100
"2011","Wandsworth 032B","E01004611","Total",570,124,32,92,161,76,111,30,81
"2011","Wandsworth 032C","E01004612","Total",558,116,28,88,196,95,96,28,68
"2011","Wandsworth 032D","E01004618","Total",527,92,10,82,158,70,106,22,84
"2011","Wandsworth 033A","E01004531","Total",649,169,47,122,230,114,156,33,123
"2011","Wandsworth 033B","E01004533","Total",569,154,52,102,191,90,139,39,100
"2011","Wandsworth 033C","E01004610","Total",632,155,23,132,212,103,128,39,89
"2011","Wandsworth 033D","E01004613","Total",677,254,55,199,194,96,184,33,151
"2011","Wandsworth 034A","E01004614","Total",855,220,52,168,185,107,177,31,146
"2011","Wandsworth 034B","E01004615","Total",757,288,86,202,253,128,231,51,180
"2011","Wandsworth 034C","E01004616","Total",816,174,37,137,183,108,138,35,103
"2011","Wandsworth 034D","E01004617","Total",638,174,33,141,152,74,145,34,111
"2011","Wandsworth 035A","E01004525","Total",659,137,40,97,178,114,105,29,76
"2011","Wandsworth 035B","E01004526","Total",655,153,20,133,144,83,135,29,106
"2011","Wandsworth 035C","E01004527","Total",578,131,28,103,174,88,133,32,101
"2011","Wandsworth 035D","E01004528","Total",655,183,49,134,207,89,169,43,126
"2011","Wandsworth 035E","E01004529","Total",902,175,48,127,244,137,153,39,114
"2011","Wandsworth 035F","E01004530","Total",789,172,27,145,188,108,118,27,91
"2011","Wandsworth 036A","E01004516","Total",510,100,18,82,232,85,119,37,82
"2011","Wandsworth 036B","E01004518","Total",650,131,19,112,249,97,118,33,85
"2011","Wandsworth 036C","E01004519","Total",632,163,37,126,224,102,145,36,109
"2011","Wandsworth 036D","E01004520","Total",459,109,29,80,193,85,107,43,64
"2011","Wandsworth 036E","E01004523","Total",722,245,24,221,179,69,196,29,167
"2011","Wandsworth 037A","E01004517","Total",810,177,41,136,248,125,136,44,92
"2011","Wandsworth 037B","E01004521","Total",768,160,50,110,286,137,146,33,113
"2011","Wandsworth 037C","E01004522","Total",628,154,51,103,236,115,130,34,96
"2011","Wandsworth 037D","E01004524","Total",774,311,61,250,211,115,237,40,197
"2011","Westminster 001A","E01004647","Total",685,236,21,215,154,74,168,22,146
"2011","Westminster 001B","E01004649","Total",716,217,27,190,196,90,121,21,100
"2011","Westminster 001C","E01004724","Total",850,246,30,216,173,79,153,28,125
"2011","Westminster 001D","E01004730","Total",804,259,28,231,178,104,132,12,120
"2011","Westminster 002A","E01004646","Total",616,162,34,128,239,108,120,25,95
"2011","Westminster 002B","E01004648","Total",1122,312,53,259,252,119,208,27,181
"2011","Westminster 002C","E01004650","Total",932,222,26,196,221,104,140,25,115
"2011","Westminster 002D","E01004710","Total",635,260,86,174,226,98,205,62,143
"2011","Westminster 002E","E01004711","Total",759,259,89,170,236,105,189,53,136
"2011","Westminster 003A","E01004651","Total",1137,331,23,308,170,101,166,19,147
"2011","Westminster 003B","E01004725","Total",799,411,66,345,183,74,266,51,215
"2011","Westminster 003C","E01004726","Total",824,237,25,212,182,87,130,18,112
"2011","Westminster 003D","E01004728","Total",808,313,32,281,134,69,215,25,190
"2011","Westminster 003E","E01004729","Total",856,434,36,398,160,73,336,38,298
"2011","Westminster 004A","E01004718","Total",850,273,87,186,244,102,230,60,170
"2011","Westminster 004B","E01004719","Total",786,249,74,175,270,113,231,65,166
"2011","Westminster 004C","E01004720","Total",777,287,83,204,252,118,222,64,158
"2011","Westminster 004D","E01004721","Total",879,362,78,284,262,126,310,52,258
"2011","Westminster 004E","E01004722","Total",849,340,140,200,361,150,291,102,189
"2011","Westminster 005A","E01004674","Total",843,331,82,249,247,114,279,67,212
"2011","Westminster 005B","E01004675","Total",1098,431,111,320,268,115,325,66,259
"2011","Westminster 005C","E01004677","Total",876,253,58,195,184,92,204,37,167
"2011","Westminster 005D","E01004678","Total",889,279,65,214,236,118,228,49,179
"2011","Westminster 005E","E01004679","Total",935,306,92,214,290,133,236,64,172
"2011","Westminster 005F","E01004723","Total",997,334,92,242,243,108,271,58,213
"2011","Westminster 006A","E01004676","Total",794,202,66,136,183,109,153,32,121
"2011","Westminster 006B","E01004706","Total",735,114,23,91,144,94,107,14,93
"2011","Westminster 006C","E01004707","Total",798,133,32,101,224,132,105,24,81
"2011","Westminster 006D","E01004708","Total",788,196,32,164,146,83,165,24,141
"2011","Westminster 006E","E01004756","Total",866,216,55,161,194,106,159,38,121
"2011","Westminster 007A","E01004701","Total",843,212,11,201,152,106,135,12,123
"2011","Westminster 007B","E01004703","Total",1027,242,36,206,263,138,186,29,157
"2011","Westminster 007D","E01004705","Total",700,132,10,122,160,95,78,14,64
"2011","Westminster 007E","E01004709","Total",765,202,54,148,182,67,162,36,126
"2011","Westminster 007F","E01033600","Total",644,139,9,130,100,65,127,12,115
"2011","Westminster 007G","E01033608","Total",735,154,11,143,106,60,117,17,100
"2011","Westminster 008A","E01004659","Total",961,267,20,247,91,52,146,18,128
"2011","Westminster 008B","E01004660","Total",873,245,27,218,151,96,109,16,93
"2011","Westminster 008C","E01004712","Total",842,224,20,204,98,51,113,13,100
"2011","Westminster 008D","E01004727","Total",977,274,24,250,156,81,126,18,108
"2011","Westminster 009A","E01004670","Total",948,517,160,357,386,173,410,131,279
"2011","Westminster 009E","E01004702","Total",994,427,145,282,348,124,361,108,253
"2011","Westminster 009F","E01033598","Total",502,252,70,182,158,55,189,49,140
"2011","Westminster 009G","E01033601","Total",589,240,64,176,190,69,209,46,163
"2011","Westminster 009H","E01033602","Total",645,297,100,197,238,104,227,71,156
"2011","Westminster 009I","E01033603","Total",600,199,42,157,131,56,130,30,100
"2011","Westminster 009J","E01033604","Total",620,222,47,175,133,65,158,26,132
"2011","Westminster 009K","E01033605","Total",815,380,112,268,258,129,293,80,213
"2011","Westminster 010A","E01004754","Total",600,274,85,189,210,85,227,55,172
"2011","Westminster 010B","E01004755","Total",963,279,95,184,268,111,231,75,156
"2011","Westminster 010C","E01004757","Total",600,251,101,150,220,90,202,65,137
"2011","Westminster 010F","E01032512","Total",989,391,163,228,396,194,296,107,189
"2011","Westminster 010G","E01032513","Total",567,254,70,184,165,79,192,22,170
"2011","Westminster 011A","E01004713","Total",939,166,5,161,129,76,91,9,82
"2011","Westminster 011B","E01004714","Total",1177,253,22,231,151,79,110,22,88
"2011","Westminster 011C","E01004716","Total",724,175,7,168,97,49,102,5,97
"2011","Westminster 011D","E01004717","Total",898,188,6,182,79,52,82,7,75
"2011","Westminster 011E","E01004762","Total",1136,354,28,326,147,71,178,19,159
"2011","Westminster 012A","E01004657","Total",827,204,8,196,100,65,103,12,91
"2011","Westminster 012B","E01004658","Total",744,264,31,233,111,66,129,23,106
"2011","Westminster 012C","E01004661","Total",892,294,38,256,129,66,140,31,109
"2011","Westminster 012D","E01004662","Total",1040,287,12,275,123,76,148,14,134
"2011","Westminster 012E","E01004663","Total",851,254,25,229,131,57,155,15,140
"2011","Westminster 013A","E01004715","Total",824,296,20,276,91,36,169,13,156
"2011","Westminster 013B","E01004763","Total",1076,252,6,246,46,22,149,10,139
"2011","Westminster 013D","E01004765","Total",1103,308,34,274,126,58,209,26,183
"2011","Westminster 013E","E01033595","Total",755,212,11,201,53,26,118,7,111
"2011","Westminster 013F","E01033596","Total",745,248,21,227,82,39,183,20,163
"2011","Westminster 014A","E01004653","Total",929,220,20,200,166,71,163,18,145
"2011","Westminster 014B","E01004654","Total",1204,229,24,205,170,94,175,16,159
"2011","Westminster 014D","E01004656","Total",1178,370,35,335,150,76,233,18,215
"2011","Westminster 014E","E01004760","Total",771,230,57,173,161,75,187,45,142
"2011","Westminster 014F","E01033606","Total",614,130,16,114,61,34,91,12,79
"2011","Westminster 014G","E01033607","Total",616,168,12,156,109,54,147,13,134
"2011","Westminster 015A","E01004680","Total",708,209,20,189,138,80,97,6,91
"2011","Westminster 015B","E01004683","Total",767,176,16,160,133,66,98,12,86
"2011","Westminster 015C","E01004684","Total",701,299,49,250,144,83,177,35,142
"2011","Westminster 015E","E01004686","Total",848,380,51,329,137,79,234,33,201
"2011","Westminster 015F","E01033593","Total",645,254,56,198,125,70,91,23,68
"2011","Westminster 015G","E01033594","Total",711,260,36,224,95,41,169,20,149
"2011","Westminster 016A","E01004681","Total",1150,250,33,217,141,88,142,25,117
"2011","Westminster 016B","E01004682","Total",765,192,14,178,71,44,98,7,91
"2011","Westminster 016C","E01004694","Total",949,238,15,223,122,81,88,10,78
"2011","Westminster 016D","E01004697","Total",816,232,21,211,106,67,116,16,100
"2011","Westminster 016E","E01004700","Total",941,209,19,190,143,90,107,13,94
"2011","Westminster 017A","E01004652","Total",958,283,27,256,114,69,163,28,135
"2011","Westminster 017B","E01004693","Total",735,182,8,174,109,67,87,9,78
"2011","Westminster 017C","E01004695","Total",669,169,13,156,67,39,62,3,59
"2011","Westminster 017D","E01004696","Total",760,349,79,270,187,87,260,47,213
"2011","Westminster 017E","E01004698","Total",754,177,14,163,105,45,89,10,79
"2011","Westminster 017F","E01004699","Total",1165,276,34,242,147,95,123,17,106
"2011","Westminster 018A","E01004734","Total",1104,356,20,336,91,37,220,25,195
"2011","Westminster 018B","E01004735","Total",977,327,12,315,70,32,207,13,194
"2011","Westminster 018C","E01004736","Total",729,136,2,134,53,25,69,6,63
"2011","Westminster 018D","E01004761","Total",1085,285,19,266,115,61,126,10,116
"2011","Westminster 019A","E01004687","Total",799,177,12,165,158,61,80,4,76
"2011","Westminster 019B","E01004688","Total",486,137,6,131,64,24,44,2,42
"2011","Westminster 019C","E01004689","Total",510,180,19,161,82,36,44,9,35
"2011","Westminster 019D","E01004690","Total",627,136,23,113,148,58,57,8,49
"2011","Westminster 019E","E01004691","Total",816,234,19,215,111,45,83,11,72
"2011","Westminster 019F","E01004692","Total",644,221,27,194,117,51,84,5,79
"2011","Westminster 020A","E01004731","Total",910,159,16,143,100,58,99,15,84
"2011","Westminster 020B","E01004732","Total",697,300,41,259,134,46,222,34,188
"2011","Westminster 020C","E01004733","Total",926,158,23,135,143,62,120,25,95
"2011","Westminster 020D","E01004744","Total",744,270,25,245,127,76,202,25,177
"2011","Westminster 020E","E01004748","Total",615,152,15,137,93,50,86,8,78
"2011","Westminster 021A","E01004740","Total",776,326,34,292,124,56,242,25,217
"2011","Westminster 021B","E01004743","Total",713,192,47,145,154,69,131,28,103
"2011","Westminster 021C","E01004745","Total",1125,282,35,247,184,86,215,35,180
"2011","Westminster 021D","E01004746","Total",757,288,44,244,151,67,228,25,203
"2011","Westminster 021E","E01004747","Total",1127,293,53,240,189,88,238,41,197
"2011","Westminster 022A","E01004742","Total",779,151,8,143,78,44,105,6,99
"2011","Westminster 022B","E01004749","Total",1185,256,44,212,198,113,145,19,126
"2011","Westminster 022C","E01004751","Total",943,179,14,165,124,59,139,11,128
"2011","Westminster 022D","E01004752","Total",905,267,16,251,79,40,212,20,192
"2011","Westminster 022E","E01004753","Total",1041,244,14,230,111,60,199,16,183
"2011","Westminster 023B","E01004666","Total",553,171,23,148,96,39,130,20,110
"2011","Westminster 023C","E01004667","Total",743,237,30,207,118,53,206,31,175
"2011","Westminster 023D","E01004668","Total",645,214,46,168,172,80,160,32,128
"2011","Westminster 023E","E01004750","Total",951,332,35,297,130,68,238,21,217
"2011","Westminster 023F","E01033597","Total",621,192,24,168,81,46,116,13,103
"2011","Westminster 023G","E01033599","Total",630,228,116,112,267,119,152,62,90
"2011","Westminster 024A","E01004665","Total",611,273,86,187,200,72,223,57,166
"2011","Westminster 024B","E01004669","Total",758,316,68,248,190,86,241,43,198
"2011","Westminster 024C","E01004737","Total",683,233,28,205,126,48,151,26,125
"2011","Westminster 024D","E01004738","Total",722,167,16,151,86,48,97,13,84
"2011","Westminster 024E","E01004739","Total",950,264,6,258,39,21,169,8,161
"2011","Westminster 024F","E01004741","Total",698,187,20,167,112,46,148,13,135
"2011","Barking and Dagenham 001A","E01000027","Total",641,265,85,180,275,116,207,53,154
"2011","Barking and Dagenham 001B","E01000028","Total",612,261,77,184,253,110,196,48,148
"2011","Barking and Dagenham 001C","E01000029","Total",690,311,25,286,177,69,224,37,187
"2011","Barking and Dagenham 001D","E01000030","Total",770,335,132,203,357,185,238,61,177
"2011","Barking and Dagenham 002A","E01000031","Total",598,210,36,174,215,77,163,35,128
"2011","Barking and Dagenham 002B","E01000032","Total",631,201,45,156,219,100,181,40,141
"2011","Barking and Dagenham 002C","E01000110","Total",501,130,20,110,187,69,109,32,77
"2011","Barking and Dagenham 002D","E01000111","Total",732,279,70,209,273,145,186,39,147
"2011","Barking and Dagenham 002E","E01000112","Total",739,221,48,173,258,138,165,34,131
"2011","Barking and Dagenham 002F","E01000113","Total",633,169,49,120,240,127,154,38,116
"2011","Barking and Dagenham 003A","E01000034","Total",517,188,45,143,198,66,158,44,114
"2011","Barking and Dagenham 003B","E01000037","Total",579,148,18,130,191,64,127,32,95
"2011","Barking and Dagenham 003C","E01000038","Total",563,218,25,193,196,64,140,25,115
"2011","Barking and Dagenham 003D","E01000039","Total",659,214,34,180,217,86,162,28,134
"2011","Barking and Dagenham 004A","E01000063","Total",635,241,73,168,266,126,185,36,149
"2011","Barking and Dagenham 004B","E01000100","Total",615,221,63,158,268,127,170,42,128
"2011","Barking and Dagenham 004C","E01000101","Total",567,204,57,147,239,105,185,49,136
"2011","Barking and Dagenham 004D","E01000109","Total",608,187,50,137,248,110,160,38,122
"2011","Barking and Dagenham 004E","E01000114","Total",758,238,64,174,323,146,204,59,145
"2011","Barking and Dagenham 006A","E01000033","Total",533,219,65,154,217,111,158,45,113
"2011","Barking and Dagenham 006B","E01000060","Total",770,316,77,239,290,149,223,48,175
"2011","Barking and Dagenham 006C","E01000061","Total",668,294,150,144,351,176,175,64,111
"2011","Barking and Dagenham 006D","E01000062","Total",761,293,69,224,290,128,230,40,190
"2011","Barking and Dagenham 006E","E01000064","Total",709,265,76,189,279,138,233,61,172
"2011","Barking and Dagenham 007A","E01000065","Total",774,371,62,309,262,114,289,41,248
"2011","Barking and Dagenham 007B","E01000078","Total",649,280,109,171,283,155,188,50,138
"2011","Barking and Dagenham 007C","E01000080","Total",594,248,61,187,243,111,206,48,158
"2011","Barking and Dagenham 007D","E01000081","Total",648,224,68,156,269,128,174,44,130
"2011","Barking and Dagenham 007E","E01000082","Total",672,254,64,190,274,135,210,55,155
"2011","Barking and Dagenham 007F","E01000083","Total",629,222,81,141,278,142,207,59,148
"2011","Barking and Dagenham 007G","E01000102","Total",625,237,61,176,269,134,192,51,141
"2011","Barking and Dagenham 008A","E01000021","Total",593,220,68,152,237,114,155,44,111
"2011","Barking and Dagenham 008B","E01000022","Total",474,159,66,93,222,101,123,38,85
"2011","Barking and Dagenham 008C","E01000023","Total",500,163,33,130,145,84,125,30,95
"2011","Barking and Dagenham 008D","E01000024","Total",456,148,46,102,211,110,114,35,79
"2011","Barking and Dagenham 008E","E01000025","Total",629,219,67,152,268,115,184,55,129
"2011","Barking and Dagenham 008F","E01000077","Total",560,198,61,137,237,99,177,52,125
"2011","Barking and Dagenham 009A","E01000015","Total",836,302,143,159,430,237,208,85,123
"2011","Barking and Dagenham 009B","E01000016","Total",626,235,69,166,251,108,160,43,117
"2011","Barking and Dagenham 009C","E01000017","Total",609,233,60,173,229,116,205,58,147
"2011","Barking and Dagenham 009D","E01000018","Total",612,232,81,151,264,126,177,52,125
"2011","Barking and Dagenham 009E","E01000079","Total",609,262,64,198,239,121,214,58,156
"2011","Barking and Dagenham 010A","E01000035","Total",567,186,50,136,222,98,143,34,109
"2011","Barking and Dagenham 010B","E01000036","Total",469,121,22,99,182,74,111,33,78
"2011","Barking and Dagenham 010C","E01000107","Total",601,215,48,167,240,113,152,34,118
"2011","Barking and Dagenham 010D","E01000108","Total",652,194,55,139,223,105,151,41,110
"2011","Barking and Dagenham 011A","E01000066","Total",683,229,48,181,280,138,192,51,141
"2011","Barking and Dagenham 011B","E01000067","Total",679,215,39,176,271,114,189,44,145
"2011","Barking and Dagenham 011C","E01000069","Total",513,118,15,103,242,81,113,33,80
"2011","Barking and Dagenham 011D","E01000070","Total",598,171,23,148,237,94,141,46,95
"2011","Barking and Dagenham 011E","E01000071","Total",785,249,47,202,308,164,199,41,158
"2011","Barking and Dagenham 012A","E01000057","Total",537,183,73,110,253,143,139,47,92
"2011","Barking and Dagenham 012B","E01000073","Total",627,211,59,152,267,138,179,50,129
"2011","Barking and Dagenham 012C","E01000074","Total",629,236,60,176,259,125,211,53,158
"2011","Barking and Dagenham 012D","E01000075","Total",622,227,50,177,240,99,188,51,137
"2011","Barking and Dagenham 012E","E01000076","Total",710,279,91,188,312,148,207,53,154
"2011","Barking and Dagenham 013A","E01000013","Total",650,233,68,165,259,123,182,47,135
"2011","Barking and Dagenham 013B","E01000014","Total",638,238,73,165,256,121,170,47,123
"2011","Barking and Dagenham 013C","E01000059","Total",578,217,75,142,257,101,176,47,129
"2011","Barking and Dagenham 013D","E01000084","Total",517,173,54,119,212,117,130,38,92
"2011","Barking and Dagenham 013E","E01000085","Total",640,249,72,177,269,128,159,32,127
"2011","Barking and Dagenham 013F","E01000086","Total",508,166,46,120,227,108,130,32,98
"2011","Barking and Dagenham 014A","E01000103","Total",600,194,78,116,273,119,172,56,116
"2011","Barking and Dagenham 014B","E01000104","Total",739,293,89,204,292,138,200,53,147
"2011","Barking and Dagenham 014C","E01000105","Total",915,391,95,296,336,179,270,57,213
"2011","Barking and Dagenham 014D","E01000106","Total",916,395,102,293,317,197,271,52,219
"2011","Barking and Dagenham 015A","E01000007","Total",612,219,36,183,212,134,114,40,74
"2011","Barking and Dagenham 015B","E01000008","Total",521,155,73,82,246,127,106,47,59
"2011","Barking and Dagenham 015C","E01000010","Total",1103,261,89,172,416,256,156,50,106
"2011","Barking and Dagenham 015D","E01000012","Total",698,190,95,95,347,223,105,35,70
"2011","Barking and Dagenham 016A","E01000006","Total",543,119,34,85,228,117,100,34,66
"2011","Barking and Dagenham 016B","E01000009","Total",638,201,35,166,203,122,147,25,122
"2011","Barking and Dagenham 016C","E01000011","Total",457,105,38,67,203,111,88,29,59
"2011","Barking and Dagenham 016D","E01000044","Total",629,195,57,138,264,136,148,47,101
"2011","Barking and Dagenham 016E","E01000068","Total",462,107,11,96,176,69,91,26,65
"2011","Barking and Dagenham 017A","E01000041","Total",607,207,64,143,264,127,137,35,102
"2011","Barking and Dagenham 017B","E01000042","Total",679,299,109,190,285,169,175,45,130
"2011","Barking and Dagenham 017C","E01000045","Total",602,200,76,124,283,132,156,50,106
"2011","Barking and Dagenham 017D","E01000046","Total",654,209,65,144,302,144,183,56,127
"2011","Barking and Dagenham 017E","E01000072","Total",784,335,113,222,340,179,274,70,204
"2011","Barking and Dagenham 018A","E01000054","Total",638,222,65,157,272,124,154,42,112
"2011","Barking and Dagenham 018B","E01000055","Total",560,174,53,121,250,109,157,44,113
"2011","Barking and Dagenham 018C","E01000056","Total",573,183,67,116,271,147,159,47,112
"2011","Barking and Dagenham 018D","E01000058","Total",690,244,77,167,288,147,203,54,149
"2011","Barking and Dagenham 018E","E01000095","Total",549,139,48,91,276,168,132,46,86
"2011","Barking and Dagenham 019A","E01000040","Total",640,236,67,169,243,110,163,39,124
"2011","Barking and Dagenham 019B","E01000043","Total",461,170,37,133,179,73,129,29,100
"2011","Barking and Dagenham 019C","E01000050","Total",615,254,60,194,234,132,194,41,153
"2011","Barking and Dagenham 019D","E01000052","Total",769,254,67,187,295,162,210,50,160
"2011","Barking and Dagenham 019E","E01000092","Total",975,318,94,224,454,242,267,66,201
"2011","Barking and Dagenham 020A","E01000053","Total",645,253,59,194,221,110,209,38,171
"2011","Barking and Dagenham 020B","E01000087","Total",503,170,55,115,206,94,138,33,105
"2011","Barking and Dagenham 020C","E01000088","Total",640,184,55,129,276,145,155,39,116
"2011","Barking and Dagenham 020D","E01000089","Total",612,179,73,106,275,135,145,46,99
"2011","Barking and Dagenham 020E","E01000090","Total",549,156,50,106,257,129,112,30,82
"2011","Barking and Dagenham 021B","E01000048","Total",644,276,124,152,348,195,157,57,100
"2011","Barking and Dagenham 021C","E01000049","Total",643,255,115,140,332,176,151,56,95
"2011","Barking and Dagenham 021D","E01000051","Total",725,315,155,160,349,194,186,70,116
"2011","Barking and Dagenham 021E","E01033587","Total",631,178,81,97,279,182,130,49,81
"2011","Barking and Dagenham 021F","E01033588","Total",618,182,83,99,316,188,120,44,76
"2011","Barking and Dagenham 022A","E01000091","Total",633,254,95,159,277,155,183,55,128
"2011","Barking and Dagenham 022B","E01000093","Total",642,255,76,179,254,146,190,44,146
"2011","Barking and Dagenham 022C","E01000094","Total",517,122,69,53,252,157,77,27,50
"2011","Barking and Dagenham 022D","E01000096","Total",639,250,129,121,350,184,158,61,97
"2011","Barking and Dagenham 023A","E01000019","Total",504,168,57,111,217,93,134,46,88
"2011","Barking and Dagenham 023B","E01000020","Total",650,222,61,161,296,126,190,49,141
"2011","Barking and Dagenham 023C","E01000097","Total",708,318,59,259,257,116,262,49,213
"2011","Barking and Dagenham 023D","E01000098","Total",625,221,77,144,281,134,182,57,125
"2011","Barking and Dagenham 023E","E01000099","Total",666,224,66,158,280,137,180,49,131
"2011","Barking and Dagenham 023F","E01032580","Total",471,151,61,90,220,108,128,50,78
"2011","Barnet 001A","E01000248","Total",666,162,8,154,234,91,143,22,121
"2011","Barnet 001B","E01000249","Total",572,139,14,125,204,61,129,24,105
"2011","Barnet 001C","E01000250","Total",979,260,23,237,280,121,201,33,168
"2011","Barnet 001D","E01000254","Total",622,177,12,165,197,86,124,15,109
"2011","Barnet 001E","E01000292","Total",629,221,15,206,165,64,175,26,149
"2011","Barnet 001F","E01000293","Total",642,168,13,155,200,74,140,18,122
"2011","Barnet 002A","E01000167","Total",522,165,44,121,187,69,154,38,116
"2011","Barnet 002B","E01000246","Total",654,204,18,186,178,70,152,23,129
"2011","Barnet 002C","E01000247","Total",746,168,22,146,233,84,136,26,110
"2011","Barnet 002D","E01000251","Total",947,332,43,289,200,103,246,30,216
"2011","Barnet 002E","E01000252","Total",753,259,29,230,203,88,184,23,161
"2011","Barnet 003A","E01000166","Total",648,199,29,170,211,90,156,28,128
"2011","Barnet 003B","E01000168","Total",576,167,8,159,189,58,143,27,116
"2011","Barnet 003C","E01000169","Total",670,170,17,153,192,84,127,19,108
"2011","Barnet 003D","E01000172","Total",602,193,35,158,223,90,141,28,113
"2011","Barnet 004A","E01000285","Total",610,201,32,169,195,76,152,36,116
"2011","Barnet 004B","E01000287","Total",622,202,50,152,241,79,166,52,114
"2011","Barnet 004C","E01000288","Total",568,160,17,143,219,76,137,32,105
"2011","Barnet 004D","E01000289","Total",631,216,75,141,290,97,190,62,128
"2011","Barnet 004E","E01000291","Total",602,224,66,158,245,84,197,45,152
"2011","Barnet 004F","E01000294","Total",672,226,24,202,194,76,169,21,148
"2011","Barnet 005A","E01000267","Total",567,134,18,116,186,74,111,26,85
"2011","Barnet 005B","E01000268","Total",745,195,69,126,246,123,136,38,98
"2011","Barnet 005C","E01000269","Total",535,136,13,123,177,60,126,30,96
"2011","Barnet 005D","E01000270","Total",626,180,16,164,178,73,127,22,105
"2011","Barnet 006A","E01000170","Total",656,204,39,165,225,79,170,46,124
"2011","Barnet 006B","E01000171","Total",856,223,84,139,294,165,157,41,116
"2011","Barnet 006C","E01000173","Total",617,152,25,127,248,80,124,34,90
"2011","Barnet 006D","E01000174","Total",766,247,40,207,240,106,195,32,163
"2011","Barnet 006E","E01000175","Total",618,174,20,154,207,97,149,26,123
"2011","Barnet 007A","E01000228","Total",475,92,20,72,230,69,98,30,68
"2011","Barnet 007B","E01000253","Total",597,183,12,171,189,45,120,19,101
"2011","Barnet 007C","E01000279","Total",513,136,14,122,177,60,91,17,74
"2011","Barnet 007D","E01000280","Total",497,128,9,119,165,41,92,20,72
"2011","Barnet 007E","E01000286","Total",654,239,49,190,211,83,183,46,137
"2011","Barnet 007F","E01000290","Total",674,273,25,248,195,66,209,37,172
"2011","Barnet 008A","E01000271","Total",582,186,11,175,164,70,131,15,116
"2011","Barnet 008B","E01000272","Total",468,109,3,106,133,37,91,17,74
"2011","Barnet 008C","E01000273","Total",648,216,17,199,169,67,176,26,150
"2011","Barnet 008D","E01000281","Total",480,129,31,98,195,98,124,39,85
"2011","Barnet 008E","E01000282","Total",639,171,11,160,234,97,134,26,108
"2011","Barnet 009A","E01000115","Total",485,118,10,108,193,55,104,30,74
"2011","Barnet 009B","E01000116","Total",623,158,16,142,241,89,149,33,116
"2011","Barnet 009C","E01000119","Total",607,163,18,145,211,71,142,30,112
"2011","Barnet 009D","E01000120","Total",505,133,8,125,197,63,120,35,85
"2011","Barnet 009E","E01000122","Total",522,132,13,119,190,67,117,30,87
"2011","Barnet 010A","E01000117","Total",762,248,29,219,219,86,184,36,148
"2011","Barnet 010B","E01000118","Total",709,180,30,150,272,112,170,53,117
"2011","Barnet 010C","E01000121","Total",501,171,73,98,236,83,173,55,118
"2011","Barnet 010D","E01000123","Total",685,150,22,128,212,96,146,35,111
"2011","Barnet 010E","E01000124","Total",660,195,41,154,219,92,169,42,127
"2011","Barnet 011A","E01000265","Total",791,221,56,165,292,147,186,41,145
"2011","Barnet 011B","E01000266","Total",511,117,12,105,192,52,110,26,84
"2011","Barnet 011C","E01000274","Total",699,197,44,153,266,102,155,47,108
"2011","Barnet 011D","E01000320","Total",628,201,21,180,177,61,153,20,133
"2011","Barnet 011E","E01000322","Total",774,216,41,175,221,101,168,31,137
"2011","Barnet 012A","E01000275","Total",644,150,22,128,175,72,143,33,110
"2011","Barnet 012B","E01000277","Total",777,308,55,253,182,103,184,25,159
"2011","Barnet 012C","E01000283","Total",480,107,6,101,192,69,89,19,70
"2011","Barnet 012D","E01000284","Total",780,234,38,196,204,113,182,25,157
"2011","Barnet 012E","E01000321","Total",700,155,18,137,169,73,139,16,123
"2011","Barnet 013A","E01000195","Total",697,234,61,173,270,121,188,51,137
"2011","Barnet 013B","E01000229","Total",600,168,40,128,246,115,147,35,112
"2011","Barnet 013C","E01000230","Total",650,197,17,180,207,79,175,37,138
"2011","Barnet 013D","E01000231","Total",654,144,36,108,290,111,155,46,109
"2011","Barnet 013E","E01000232","Total",706,221,15,206,233,106,165,32,133
"2011","Barnet 013F","E01000233","Total",635,132,28,104,265,126,128,29,99
"2011","Barnet 014A","E01000186","Total",501,97,9,88,212,74,99,25,74
"2011","Barnet 014B","E01000187","Total",593,202,36,166,230,102,164,42,122
"2011","Barnet 014C","E01000188","Total",516,100,10,90,173,58,114,21,93
"2011","Barnet 014D","E01000189","Total",711,264,102,162,342,163,192,54,138
"2011","Barnet 014E","E01000190","Total",546,152,21,131,184,76,140,26,114
"2011","Barnet 014F","E01000191","Total",530,144,13,131,182,78,153,31,122
"2011","Barnet 015A","E01000158","Total",564,149,38,111,202,91,116,25,91
"2011","Barnet 015B","E01000159","Total",645,194,48,146,250,86,151,42,109
"2011","Barnet 015C","E01000160","Total",923,179,37,142,243,125,121,17,104
"2011","Barnet 015D","E01000161","Total",710,163,28,135,200,83,163,27,136
"2011","Barnet 015E","E01000162","Total",552,137,29,108,199,64,137,31,106
"2011","Barnet 015F","E01000324","Total",655,183,18,165,234,93,158,33,125
"2011","Barnet 016A","E01000256","Total",656,150,22,128,250,91,113,28,85
"2011","Barnet 016B","E01000258","Total",696,182,21,161,220,84,162,25,137
"2011","Barnet 016C","E01000263","Total",499,96,6,90,230,81,105,24,81
"2011","Barnet 016D","E01000264","Total",634,158,28,130,229,89,157,31,126
"2011","Barnet 017A","E01000255","Total",527,144,21,123,185,64,162,37,125
"2011","Barnet 017B","E01000257","Total",724,273,78,195,276,123,227,45,182
"2011","Barnet 017C","E01000261","Total",646,221,4,217,187,71,176,21,155
"2011","Barnet 017D","E01000262","Total",752,198,75,123,312,131,163,56,107
"2011","Barnet 018A","E01000192","Total",683,203,22,181,221,125,162,30,132
"2011","Barnet 018B","E01000193","Total",594,166,22,144,211,77,155,34,121
"2011","Barnet 018C","E01000194","Total",610,165,37,128,203,92,128,29,99
"2011","Barnet 018D","E01000226","Total",630,222,52,170,257,120,212,55,157
"2011","Barnet 018E","E01000227","Total",603,140,19,121,235,99,124,31,93
"2011","Barnet 019A","E01000299","Total",782,210,27,183,200,113,170,23,147
"2011","Barnet 019B","E01000300","Total",667,164,14,150,204,97,153,31,122
"2011","Barnet 019C","E01000302","Total",840,266,29,237,190,100,187,27,160
"2011","Barnet 019D","E01000317","Total",657,172,26,146,198,78,130,26,104
"2011","Barnet 019E","E01000318","Total",610,151,30,121,238,68,153,37,116
"2011","Barnet 019F","E01000323","Total",865,245,32,213,201,101,185,24,161
"2011","Barnet 020A","E01000276","Total",506,123,5,118,226,83,99,16,83
"2011","Barnet 020B","E01000278","Total",498,111,4,107,226,93,105,22,83
"2011","Barnet 020C","E01000301","Total",528,107,14,93,216,101,87,22,65
"2011","Barnet 020D","E01000303","Total",540,102,15,87,221,107,104,25,79
"2011","Barnet 020E","E01000304","Total",621,115,19,96,173,85,93,14,79
"2011","Barnet 021A","E01000130","Total",570,155,64,91,239,97,142,44,98
"2011","Barnet 021B","E01000132","Total",495,152,51,101,246,95,112,37,75
"2011","Barnet 021C","E01000133","Total",565,198,55,143,232,84,180,43,137
"2011","Barnet 021D","E01000234","Total",650,153,29,124,239,123,126,28,98
"2011","Barnet 021E","E01000235","Total",582,161,55,106,267,112,151,48,103
"2011","Barnet 022A","E01000156","Total",751,169,26,143,266,115,146,32,114
"2011","Barnet 022B","E01000157","Total",689,176,47,129,202,111,135,30,105
"2011","Barnet 022C","E01000163","Total",759,240,56,184,232,115,198,37,161
"2011","Barnet 022D","E01000164","Total",648,187,58,129,248,106,158,49,109
"2011","Barnet 022E","E01000165","Total",707,140,40,100,258,117,109,29,80
"2011","Barnet 022F","E01000315","Total",614,210,68,142,282,68,201,75,126
"2011","Barnet 023A","E01000197","Total",707,145,20,125,201,102,120,21,99
"2011","Barnet 023B","E01000295","Total",686,160,14,146,195,86,124,24,100
"2011","Barnet 023C","E01000296","Total",734,155,29,126,188,96,118,27,91
"2011","Barnet 023D","E01000298","Total",733,167,27,140,190,100,146,33,113
"2011","Barnet 024A","E01000125","Total",1015,323,112,211,393,200,274,74,200
"2011","Barnet 024B","E01000127","Total",514,161,57,104,232,95,161,61,100
"2011","Barnet 024C","E01000128","Total",624,175,59,116,291,131,168,45,123
"2011","Barnet 024D","E01000129","Total",624,224,63,161,251,120,195,56,139
"2011","Barnet 024E","E01000131","Total",634,172,31,141,234,119,157,44,113
"2011","Barnet 024F","E01000134","Total",625,191,46,145,243,94,161,40,121
"2011","Barnet 025A","E01000198","Total",685,155,25,130,253,134,122,30,92
"2011","Barnet 025B","E01000199","Total",671,217,11,206,192,75,158,21,137
"2011","Barnet 025C","E01000204","Total",687,177,12,165,194,74,140,13,127
"2011","Barnet 025D","E01000259","Total",980,232,51,181,374,147,200,40,160
"2011","Barnet 025E","E01000260","Total",761,168,47,121,296,145,141,49,92
"2011","Barnet 026A","E01000126","Total",726,206,87,119,345,153,210,80,130
"2011","Barnet 026B","E01000151","Total",617,240,103,137,303,152,146,53,93
"2011","Barnet 026C","E01000152","Total",564,170,102,68,335,138,129,65,64
"2011","Barnet 026D","E01000153","Total",620,246,74,172,233,101,179,38,141
"2011","Barnet 026E","E01000154","Total",501,181,51,130,187,92,177,46,131
"2011","Barnet 027A","E01000176","Total",698,268,42,226,198,74,235,44,191
"2011","Barnet 027B","E01000178","Total",695,192,22,170,234,102,179,35,144
"2011","Barnet 027C","E01000184","Total",503,164,53,111,182,85,134,29,105
"2011","Barnet 027D","E01000297","Total",554,114,17,97,154,76,123,32,91
"2011","Barnet 027E","E01000316","Total",874,193,64,129,328,141,182,54,128
"2011","Barnet 027F","E01000319","Total",529,113,18,95,205,92,110,25,85
"2011","Barnet 028A","E01000196","Total",896,258,27,231,157,90,193,24,169
"2011","Barnet 028B","E01000200","Total",863,302,20,282,168,70,215,22,193
"2011","Barnet 028C","E01000201","Total",517,115,9,106,176,60,117,27,90
"2011","Barnet 028D","E01000202","Total",648,138,15,123,209,87,119,22,97
"2011","Barnet 028E","E01000203","Total",613,187,36,151,224,85,153,37,116
"2011","Barnet 029A","E01000177","Total",690,124,15,109,184,112,120,16,104
"2011","Barnet 029B","E01000179","Total",763,129,22,107,193,125,115,22,93
"2011","Barnet 029C","E01000180","Total",689,245,32,213,176,87,180,33,147
"2011","Barnet 029D","E01000181","Total",669,134,11,123,195,96,100,22,78
"2011","Barnet 029E","E01000182","Total",746,199,9,190,165,62,150,16,134
"2011","Barnet 029F","E01000185","Total",606,229,61,168,188,75,195,45,150
"2011","Barnet 030A","E01000147","Total",544,144,13,131,176,69,138,30,108
"2011","Barnet 030B","E01000148","Total",725,255,55,200,230,115,217,47,170
"2011","Barnet 030D","E01000155","Total",797,175,49,126,258,161,118,28,90
"2011","Barnet 030E","E01033572","Total",571,139,26,113,192,100,109,31,78
"2011","Barnet 030F","E01033573","Total",607,157,30,127,140,71,65,22,43
"2011","Barnet 031A","E01000239","Total",877,232,45,187,227,128,156,31,125
"2011","Barnet 031B","E01000240","Total",582,152,25,127,217,87,114,30,84
"2011","Barnet 031C","E01000241","Total",696,172,20,152,201,91,138,31,107
"2011","Barnet 031D","E01000309","Total",619,142,27,115,207,98,113,19,94
"2011","Barnet 032A","E01000237","Total",740,164,15,149,201,107,122,24,98
"2011","Barnet 032B","E01000242","Total",597,187,22,165,196,92,160,19,141
"2011","Barnet 032C","E01000243","Total",791,253,18,235,179,105,171,15,156
"2011","Barnet 032D","E01000244","Total",582,197,17,180,157,78,106,20,86
"2011","Barnet 032E","E01000245","Total",811,281,48,233,252,122,243,40,203
"2011","Barnet 032F","E01000314","Total",658,149,15,134,189,88,125,21,104
"2011","Barnet 033A","E01000183","Total",584,144,11,133,165,76,124,19,105
"2011","Barnet 033B","E01000206","Total",514,98,17,81,182,59,84,21,63
"2011","Barnet 033C","E01000207","Total",608,171,18,153,196,77,112,18,94
"2011","Barnet 033D","E01000208","Total",619,144,5,139,178,82,98,9,89
"2011","Barnet 033E","E01000210","Total",600,137,19,118,231,112,88,14,74
"2011","Barnet 033F","E01000213","Total",465,102,7,95,200,78,71,7,64
"2011","Barnet 034A","E01000236","Total",674,175,16,159,248,163,155,27,128
"2011","Barnet 034B","E01000238","Total",615,138,24,114,256,139,141,38,103
"2011","Barnet 034C","E01000310","Total",701,171,17,154,187,89,148,33,115
"2011","Barnet 034D","E01000311","Total",470,96,12,84,210,123,91,24,67
"2011","Barnet 035A","E01000205","Total",619,135,17,118,227,113,104,21,83
"2011","Barnet 035B","E01000209","Total",747,277,13,264,178,84,188,27,161
"2011","Barnet 035C","E01000211","Total",861,249,34,215,194,106,170,18,152
"2011","Barnet 035D","E01000212","Total",529,124,9,115,159,68,88,15,73
"2011","Barnet 035E","E01000216","Total",684,174,23,151,240,133,152,28,124
"2011","Barnet 035F","E01000217","Total",521,97,12,85,202,100,96,21,75
"2011","Barnet 036A","E01000150","Total",744,182,29,153,247,112,190,42,148
"2011","Barnet 036B","E01000305","Total",637,184,32,152,194,88,163,34,129
"2011","Barnet 036C","E01000306","Total",558,119,16,103,174,87,121,31,90
"2011","Barnet 036D","E01000308","Total",669,298,74,224,217,92,224,44,180
"2011","Barnet 036E","E01000312","Total",710,193,40,153,249,116,167,34,133
"2011","Barnet 036F","E01000313","Total",672,159,30,129,202,110,134,25,109
"2011","Barnet 037A","E01000145","Total",444,107,24,83,172,92,88,24,64
"2011","Barnet 037B","E01000215","Total",680,212,22,190,225,129,186,23,163
"2011","Barnet 037C","E01000218","Total",573,137,19,118,193,105,112,22,90
"2011","Barnet 037D","E01000219","Total",581,130,22,108,219,135,121,33,88
"2011","Barnet 037E","E01000220","Total",593,159,13,146,188,115,169,24,145
"2011","Barnet 037F","E01000225","Total",529,152,15,137,231,124,141,18,123
"2011","Barnet 038A","E01000135","Total",541,124,13,111,164,60,102,24,78
"2011","Barnet 038B","E01000136","Total",563,141,13,128,180,68,99,21,78
"2011","Barnet 038C","E01000144","Total",607,132,9,123,143,76,108,18,90
"2011","Barnet 038D","E01000146","Total",744,206,29,177,148,75,159,21,138
"2011","Barnet 038E","E01000214","Total",717,131,10,121,177,90,102,13,89
"2011","Barnet 039A","E01000141","Total",864,204,65,139,262,132,173,44,129
"2011","Barnet 039B","E01000221","Total",485,200,64,136,198,91,161,45,116
"2011","Barnet 039C","E01000223","Total",478,152,42,110,180,66,140,33,107
"2011","Barnet 039D","E01000307","Total",530,146,29,117,198,81,139,30,109
"2011","Barnet 040A","E01000138","Total",523,147,31,116,181,77,130,40,90
"2011","Barnet 040B","E01000142","Total",950,208,59,149,313,158,154,58,96
"2011","Barnet 040C","E01000222","Total",506,151,55,96,199,83,143,46,97
"2011","Barnet 040D","E01000224","Total",524,155,40,115,190,82,123,32,91
"2011","Barnet 041A","E01000137","Total",669,244,72,172,255,121,184,55,129
"2011","Barnet 041B","E01000139","Total",560,146,20,126,153,63,101,23,78
"2011","Barnet 041C","E01000140","Total",683,207,32,175,159,83,143,24,119
"2011","Barnet 041D","E01000143","Total",538,184,54,130,191,80,171,50,121
"2011","Bexley 001A","E01000466","Total",602,204,62,142,256,119,125,36,89
"2011","Bexley 001B","E01000467","Total",591,165,58,107,264,144,114,37,77
"2011","Bexley 001C","E01000468","Total",890,178,87,91,501,262,143,61,82
"2011","Bexley 001D","E01000469","Total",645,168,45,123,255,124,123,34,89
"2011","Bexley 002A","E01000416","Total",517,142,41,101,219,88,126,34,92
"2011","Bexley 002B","E01000418","Total",754,210,43,167,277,119,177,43,134
"2011","Bexley 002C","E01000422","Total",681,257,89,168,296,135,156,27,129
"2011","Bexley 002D","E01000464","Total",546,171,42,129,193,73,153,34,119
"2011","Bexley 002E","E01000465","Total",707,269,61,208,215,104,192,37,155
"2011","Bexley 002F","E01000470","Total",590,235,74,161,239,106,150,30,120
"2011","Bexley 003A","E01000333","Total",793,304,47,257,223,105,233,39,194
"2011","Bexley 003B","E01000335","Total",638,198,64,134,286,137,161,64,97
"2011","Bexley 003C","E01000336","Total",793,276,68,208,303,135,215,43,172
"2011","Bexley 003D","E01000337","Total",663,173,45,128,247,99,135,36,99
"2011","Bexley 003E","E01000338","Total",693,158,33,125,266,120,165,47,118
"2011","Bexley 004A","E01000403","Total",990,441,82,359,294,149,300,39,261
"2011","Bexley 004B","E01000404","Total",959,271,118,153,382,232,159,50,109
"2011","Bexley 004C","E01000405","Total",522,126,47,79,222,106,109,35,74
"2011","Bexley 004D","E01000408","Total",570,149,51,98,244,116,123,32,91
"2011","Bexley 005A","E01000332","Total",611,218,19,199,181,62,176,33,143
"2011","Bexley 005B","E01000402","Total",660,230,46,184,207,95,166,30,136
"2011","Bexley 005C","E01000406","Total",594,156,43,113,243,116,133,47,86
"2011","Bexley 005D","E01000407","Total",630,273,21,252,140,48,194,24,170
"2011","Bexley 006A","E01000334","Total",640,197,21,176,210,91,154,32,122
"2011","Bexley 006B","E01000417","Total",713,239,24,215,191,81,201,36,165
"2011","Bexley 006C","E01000419","Total",594,223,8,215,178,58,159,19,140
"2011","Bexley 006D","E01000420","Total",604,183,15,168,191,58,141,26,115
"2011","Bexley 006E","E01000442","Total",626,219,18,201,205,72,187,34,153
"2011","Bexley 007A","E01000437","Total",498,165,16,149,172,58,126,24,102
"2011","Bexley 007B","E01000438","Total",599,167,25,142,221,93,139,25,114
"2011","Bexley 007C","E01000439","Total",496,124,29,95,203,77,126,44,82
"2011","Bexley 007D","E01000440","Total",517,165,11,154,168,47,129,22,107
"2011","Bexley 007E","E01000441","Total",672,238,64,174,261,108,179,44,135
"2011","Bexley 008A","E01000373","Total",688,275,123,152,311,198,137,35,102
"2011","Bexley 008B","E01000429","Total",719,246,78,168,281,158,158,46,112
"2011","Bexley 008C","E01000430","Total",678,180,53,127,295,144,149,41,108
"2011","Bexley 008D","E01000431","Total",681,259,89,170,284,144,169,50,119
"2011","Bexley 008E","E01000432","Total",640,260,61,199,242,93,190,49,141
"2011","Bexley 008F","E01000433","Total",720,294,102,192,303,134,196,54,142
"2011","Bexley 008G","E01000434","Total",596,225,74,151,274,91,196,54,142
"2011","Bexley 009A","E01000356","Total",628,248,11,237,160,57,165,23,142
"2011","Bexley 009B","E01000357","Total",488,116,10,106,202,70,91,24,67
"2011","Bexley 009C","E01000359","Total",488,151,7,144,166,50,101,20,81
"2011","Bexley 009D","E01000421","Total",603,255,8,247,166,43,192,17,175
"2011","Bexley 009E","E01000450","Total",645,210,34,176,262,99,186,45,141
"2011","Bexley 009F","E01000451","Total",621,159,25,134,238,72,116,29,87
"2011","Bexley 009G","E01000452","Total",495,100,17,83,210,70,100,29,71
"2011","Bexley 010A","E01000367","Total",605,220,46,174,209,76,158,34,124
"2011","Bexley 010B","E01000368","Total",632,229,63,166,257,114,184,39,145
"2011","Bexley 010C","E01000372","Total",593,203,52,151,222,85,159,35,124
"2011","Bexley 010D","E01000380","Total",758,296,30,266,166,78,221,16,205
"2011","Bexley 010E","E01000435","Total",597,225,56,169,206,81,173,39,134
"2011","Bexley 011A","E01000353","Total",662,238,8,230,183,60,178,22,156
"2011","Bexley 011B","E01000354","Total",623,214,23,191,201,67,175,35,140
"2011","Bexley 011C","E01000355","Total",613,230,11,219,149,41,158,15,143
"2011","Bexley 011D","E01000358","Total",659,204,11,193,183,58,153,21,132
"2011","Bexley 011E","E01000436","Total",615,186,6,180,204,75,139,23,116
"2011","Bexley 013A","E01000401","Total",637,205,24,181,200,86,169,35,134
"2011","Bexley 013B","E01000453","Total",513,123,11,112,199,73,104,26,78
"2011","Bexley 013C","E01000454","Total",628,208,14,194,196,79,201,41,160
"2011","Bexley 013D","E01000455","Total",605,169,17,152,227,81,125,29,96
"2011","Bexley 013E","E01000456","Total",487,99,11,88,213,77,110,32,78
"2011","Bexley 014A","E01000325","Total",583,167,15,152,206,55,122,32,90
"2011","Bexley 014B","E01000326","Total",544,121,22,99,191,88,96,23,73
"2011","Bexley 014C","E01000369","Total",626,164,19,145,197,71,137,21,116
"2011","Bexley 014D","E01000370","Total",649,227,7,220,186,64,170,21,149
"2011","Bexley 014E","E01000371","Total",634,176,10,166,192,69,138,31,107
"2011","Bexley 015A","E01000360","Total",662,145,26,119,223,91,115,21,94
"2011","Bexley 015B","E01000362","Total",626,242,14,228,167,52,164,28,136
"2011","Bexley 015C","E01000365","Total",700,265,26,239,193,89,198,24,174
"2011","Bexley 015D","E01000366","Total",655,170,11,159,194,79,151,20,131
"2011","Bexley 015E","E01000394","Total",624,217,6,211,174,64,166,18,148
"2011","Bexley 016A","E01000388","Total",621,241,13,228,163,49,160,21,139
"2011","Bexley 016B","E01000392","Total",695,233,61,172,263,110,189,48,141
"2011","Bexley 016C","E01000409","Total",649,172,11,161,211,78,125,22,103
"2011","Bexley 016D","E01000411","Total",551,164,14,150,168,56,136,22,114
"2011","Bexley 016E","E01000414","Total",674,235,28,207,211,88,179,29,150
"2011","Bexley 016F","E01000415","Total",512,143,8,135,175,52,116,22,94
"2011","Bexley 017A","E01000327","Total",604,212,12,200,186,63,146,28,118
"2011","Bexley 017B","E01000328","Total",596,192,13,179,180,70,157,21,136
"2011","Bexley 017C","E01000329","Total",517,180,25,155,169,50,138,30,108
"2011","Bexley 017D","E01000330","Total",772,342,28,314,167,72,264,30,234
"2011","Bexley 017E","E01000331","Total",617,221,26,195,216,79,192,48,144
"2011","Bexley 018A","E01000340","Total",619,202,13,189,182,70,174,27,147
"2011","Bexley 018B","E01000395","Total",499,145,6,139,178,48,123,29,94
"2011","Bexley 018C","E01000396","Total",507,137,8,129,181,46,127,34,93
"2011","Bexley 018D","E01000410","Total",594,156,11,145,205,72,121,25,96
"2011","Bexley 018E","E01000412","Total",632,161,15,146,238,100,140,28,112
"2011","Bexley 018F","E01000413","Total",505,121,9,112,175,57,102,18,84
"2011","Bexley 019A","E01000374","Total",534,202,64,138,249,79,182,60,122
"2011","Bexley 019B","E01000375","Total",565,176,33,143,213,74,139,38,101
"2011","Bexley 019C","E01000376","Total",606,171,19,152,224,85,143,25,118
"2011","Bexley 019D","E01000377","Total",649,207,13,194,154,65,145,17,128
"2011","Bexley 019E","E01000378","Total",968,303,30,273,252,114,250,34,216
"2011","Bexley 019F","E01000379","Total",663,202,37,165,239,95,161,39,122
"2011","Bexley 020A","E01000348","Total",523,149,5,144,193,49,115,21,94
"2011","Bexley 020B","E01000349","Total",650,227,11,216,200,66,159,24,135
"2011","Bexley 020C","E01000361","Total",602,138,17,121,211,87,122,28,94
"2011","Bexley 020D","E01000363","Total",565,173,10,163,162,51,113,17,96
"2011","Bexley 020E","E01000389","Total",714,219,19,200,176,74,172,20,152
"2011","Bexley 020F","E01000390","Total",515,176,11,165,143,48,139,20,119
"2011","Bexley 020G","E01000393","Total",640,167,18,149,205,80,150,26,124
"2011","Bexley 021A","E01000346","Total",625,164,13,151,230,96,142,28,114
"2011","Bexley 021B","E01000347","Total",618,193,17,176,206,65,152,22,130
"2011","Bexley 021C","E01000350","Total",521,132,9,123,203,68,104,28,76
"2011","Bexley 021D","E01000352","Total",676,222,22,200,211,88,148,27,121
"2011","Bexley 021E","E01000391","Total",644,169,22,147,239,80,143,31,112
"2011","Bexley 022A","E01000341","Total",610,203,14,189,179,49,152,26,126
"2011","Bexley 022B","E01000342","Total",644,150,11,139,218,79,127,29,98
"2011","Bexley 022C","E01000343","Total",550,131,9,122,215,82,107,23,84
"2011","Bexley 022D","E01000345","Total",487,117,9,108,187,52,92,24,68
"2011","Bexley 022E","E01000460","Total",498,101,9,92,166,54,80,13,67
"2011","Bexley 023A","E01000364","Total",651,201,20,181,173,62,161,29,132
"2011","Bexley 023B","E01000444","Total",626,197,7,190,183,54,125,21,104
"2011","Bexley 023C","E01000447","Total",713,210,20,190,190,94,144,22,122
"2011","Bexley 023D","E01000448","Total",504,163,8,155,160,43,86,12,74
"2011","Bexley 023E","E01000449","Total",648,268,5,263,151,51,183,15,168
"2011","Bexley 024A","E01000351","Total",616,187,16,171,198,66,148,27,121
"2011","Bexley 024B","E01000443","Total",510,165,8,157,174,67,138,28,110
"2011","Bexley 024C","E01000445","Total",687,267,10,257,188,77,156,22,134
"2011","Bexley 024D","E01000446","Total",602,129,13,116,206,69,132,29,103
"2011","Bexley 024E","E01000461","Total",569,138,3,135,186,57,120,24,96
"2011","Bexley 025A","E01000339","Total",602,209,16,193,187,67,154,27,127
"2011","Bexley 025B","E01000344","Total",646,206,11,195,215,85,156,26,130
"2011","Bexley 025C","E01000423","Total",609,185,6,179,205,60,129,29,100
"2011","Bexley 025D","E01000425","Total",590,165,6,159,202,62,123,17,106
"2011","Bexley 025E","E01000463","Total",452,109,11,98,176,57,93,30,63
"2011","Bexley 026A","E01000424","Total",765,222,15,207,151,48,143,17,126
"2011","Bexley 026B","E01000426","Total",712,188,16,172,218,102,150,23,127
"2011","Bexley 026C","E01000427","Total",922,391,31,360,212,78,267,26,241
"2011","Bexley 026D","E01000457","Total",825,264,23,241,171,92,172,22,150
"2011","Bexley 026E","E01000462","Total",738,279,24,255,166,64,180,21,159
"2011","Bexley 027A","E01000382","Total",587,202,8,194,184,51,148,16,132
"2011","Bexley 027B","E01000384","Total",780,273,32,241,222,103,219,41,178
"2011","Bexley 027C","E01000387","Total",618,219,20,199,184,59,170,37,133
"2011","Bexley 027D","E01000428","Total",882,352,30,322,152,50,214,26,188
"2011","Bexley 027E","E01000458","Total",631,243,8,235,151,45,173,18,155
"2011","Bexley 027F","E01000459","Total",781,330,19,311,179,51,235,23,212
"2011","Bexley 028A","E01000381","Total",660,217,34,183,223,93,195,46,149
"2011","Bexley 028B","E01000383","Total",633,233,17,216,165,54,178,30,148
"2011","Bexley 028C","E01000385","Total",770,273,83,190,293,146,199,58,141
"2011","Bexley 028D","E01000386","Total",659,309,66,243,216,96,223,34,189
"2011","Bexley 029A","E01000398","Total",611,198,32,166,196,82,166,33,133
"2011","Bexley 029B","E01000399","Total",619,231,15,216,171,58,187,26,161
"2011","Bexley 029C","E01000400","Total",590,166,12,154,199,69,161,35,126
"2011","Bexley 029D","E01032566","Total",747,283,46,237,213,88,217,40,177
"2011","Brent 001A","E01000587","Total",458,102,16,86,179,74,108,28,80
"2011","Brent 001B","E01000589","Total",592,131,22,109,225,99,128,38,90
"2011","Brent 001C","E01000590","Total",626,196,26,170,216,78,169,33,136
"2011","Brent 001D","E01000592","Total",525,141,28,113,176,78,131,38,93
"2011","Brent 001E","E01000593","Total",680,156,54,102,288,128,154,43,111
"2011","Brent 001F","E01000594","Total",527,126,19,107,207,85,136,39,97
"2011","Brent 002A","E01000513","Total",471,106,22,84,208,83,125,50,75
"2011","Brent 002B","E01000514","Total",495,83,19,64,204,89,95,31,64
"2011","Brent 002C","E01000516","Total",517,107,18,89,193,92,122,33,89
"2011","Brent 002D","E01000520","Total",586,175,27,148,203,99,156,31,125
"2011","Brent 002E","E01000588","Total",669,169,67,102,312,121,179,70,109
"2011","Brent 003A","E01000515","Total",628,191,42,149,235,118,175,49,126
"2011","Brent 003B","E01000517","Total",491,123,14,109,176,79,133,29,104
"2011","Brent 003E","E01000543","Total",500,121,22,99,185,80,134,39,95
"2011","Brent 003F","E01000591","Total",650,164,25,139,234,103,163,38,125
"2011","Brent 003G","E01033463","Total",848,203,34,169,305,84,233,68,165
"2011","Brent 004A","E01000536","Total",522,136,18,118,161,65,128,28,100
"2011","Brent 004B","E01000538","Total",478,101,8,93,178,65,108,32,76
"2011","Brent 004C","E01000539","Total",548,168,10,158,152,56,154,25,129
"2011","Brent 004D","E01000540","Total",471,121,12,109,147,54,119,22,97
"2011","Brent 004E","E01000541","Total",499,133,6,127,173,65,127,17,110
"2011","Brent 005A","E01000518","Total",557,156,31,125,220,76,161,47,114
"2011","Brent 005B","E01000519","Total",629,181,42,139,262,112,157,45,112
"2011","Brent 005C","E01000623","Total",541,117,21,96,219,93,131,33,98
"2011","Brent 005D","E01000624","Total",594,184,28,156,195,92,152,37,115
"2011","Brent 005E","E01000629","Total",605,136,26,110,211,84,137,37,100
"2011","Brent 006A","E01000480","Total",535,116,13,103,195,64,111,26,85
"2011","Brent 006B","E01000484","Total",423,133,34,99,170,57,140,35,105
"2011","Brent 006C","E01000485","Total",488,148,15,133,165,62,160,37,123
"2011","Brent 006D","E01000486","Total",532,121,21,100,203,81,111,30,81
"2011","Brent 006E","E01000487","Total",674,201,33,168,208,90,180,34,146
"2011","Brent 007A","E01000572","Total",462,108,17,91,185,79,99,27,72
"2011","Brent 007B","E01000573","Total",474,119,20,99,183,71,108,37,71
"2011","Brent 007C","E01000574","Total",428,101,21,80,175,69,105,40,65
"2011","Brent 007D","E01000575","Total",625,130,22,108,221,106,136,43,93
"2011","Brent 007E","E01000577","Total",793,195,88,107,382,200,152,70,82
"2011","Brent 008A","E01000562","Total",480,103,16,87,164,62,107,22,85
"2011","Brent 008B","E01000563","Total",474,118,15,103,157,52,113,29,84
"2011","Brent 008C","E01000566","Total",475,118,18,100,171,57,108,42,66
"2011","Brent 008D","E01000568","Total",787,105,5,100,137,70,83,22,61
"2011","Brent 008E","E01000569","Total",480,87,6,81,180,43,114,37,77
"2011","Brent 009A","E01000479","Total",510,134,17,117,181,68,120,27,93
"2011","Brent 009B","E01000481","Total",610,191,54,137,215,97,152,42,110
"2011","Brent 009C","E01000482","Total",992,310,95,215,412,213,267,87,180
"2011","Brent 009D","E01000483","Total",643,226,72,154,267,128,178,50,128
"2011","Brent 009E","E01000625","Total",557,186,22,164,178,87,157,32,125
"2011","Brent 010B","E01000498","Total",457,115,43,72,215,109,103,41,62
"2011","Brent 010D","E01000622","Total",636,191,40,151,216,125,144,24,120
"2011","Brent 010E","E01000626","Total",590,208,57,151,254,108,189,61,128
"2011","Brent 010F","E01033464","Total",813,245,89,156,351,157,223,76,147
"2011","Brent 011A","E01000497","Total",586,175,37,138,202,78,150,33,117
"2011","Brent 011B","E01000499","Total",500,154,63,91,237,115,125,55,70
"2011","Brent 011C","E01000501","Total",734,275,77,198,293,127,210,57,153
"2011","Brent 011D","E01000502","Total",453,125,37,88,197,99,91,30,61
"2011","Brent 011E","E01000503","Total",721,217,45,172,237,113,190,47,143
"2011","Brent 012A","E01000570","Total",513,129,35,94,206,78,139,45,94
"2011","Brent 012B","E01000571","Total",477,119,31,88,190,72,127,42,85
"2011","Brent 012C","E01000576","Total",534,130,13,117,170,64,121,32,89
"2011","Brent 012D","E01000578","Total",689,240,23,217,184,88,220,34,186
"2011","Brent 013A","E01000564","Total",460,101,27,74,206,95,89,26,63
"2011","Brent 013B","E01000565","Total",497,146,19,127,168,69,149,28,121
"2011","Brent 013C","E01000607","Total",667,162,29,133,278,120,142,39,103
"2011","Brent 013D","E01000608","Total",734,194,44,150,305,146,164,46,118
"2011","Brent 013E","E01000613","Total",639,162,27,135,238,122,142,36,106
"2011","Brent 014A","E01000506","Total",657,209,71,138,227,115,149,41,108
"2011","Brent 014B","E01000509","Total",430,142,40,102,143,58,96,26,70
"2011","Brent 014C","E01000510","Total",533,127,38,89,236,131,119,37,82
"2011","Brent 014D","E01000511","Total",543,155,62,93,237,130,113,42,71
"2011","Brent 014E","E01000627","Total",653,207,58,149,256,122,175,53,122
"2011","Brent 014F","E01000628","Total",633,198,67,131,232,121,138,45,93
"2011","Brent 015A","E01000553","Total",696,163,42,121,237,127,152,46,106
"2011","Brent 015B","E01000554","Total",683,188,57,131,233,113,152,50,102
"2011","Brent 015C","E01000555","Total",512,109,19,90,156,68,123,32,91
"2011","Brent 015D","E01000556","Total",800,195,43,152,193,95,144,36,108
"2011","Brent 015E","E01000557","Total",751,151,28,123,179,103,154,33,121
"2011","Brent 015F","E01000558","Total",665,162,24,138,136,63,134,22,112
"2011","Brent 016A","E01000567","Total",486,141,16,125,175,80,121,26,95
"2011","Brent 016B","E01000606","Total",567,170,30,140,197,81,161,34,127
"2011","Brent 016C","E01000609","Total",640,160,47,113,284,124,137,49,88
"2011","Brent 016D","E01000611","Total",454,133,30,103,159,68,108,29,79
"2011","Brent 017B","E01000615","Total",563,110,24,86,209,105,96,29,67
"2011","Brent 017C","E01000617","Total",528,144,19,125,176,73,143,30,113
"2011","Brent 017D","E01000618","Total",500,171,33,138,173,75,143,32,111
"2011","Brent 017E","E01000619","Total",473,106,22,84,183,71,130,42,88
"2011","Brent 017F","E01033424","Total",638,183,48,135,177,112,124,27,97
"2011","Brent 017G","E01033457","Total",562,96,16,80,203,118,94,26,68
"2011","Brent 018A","E01000504","Total",676,159,33,126,165,81,145,30,115
"2011","Brent 018B","E01000505","Total",525,148,30,118,188,83,134,40,94
"2011","Brent 018C","E01000507","Total",508,138,36,102,173,63,118,30,88
"2011","Brent 018D","E01000512","Total",610,112,28,84,174,81,131,27,104
"2011","Brent 018E","E01000559","Total",650,159,23,136,124,52,137,19,118
"2011","Brent 019A","E01000610","Total",621,137,24,113,242,120,168,49,119
"2011","Brent 019B","E01000612","Total",521,129,18,111,198,80,143,39,104
"2011","Brent 019C","E01000631","Total",522,116,19,97,197,92,116,28,88
"2011","Brent 019D","E01000633","Total",554,121,16,105,207,99,143,38,105
"2011","Brent 019E","E01000634","Total",696,129,38,91,329,160,155,58,97
"2011","Brent 020A","E01000616","Total",586,131,23,108,186,84,130,34,96
"2011","Brent 020B","E01000620","Total",500,123,24,99,177,68,126,28,98
"2011","Brent 020C","E01000621","Total",514,105,24,81,213,84,124,32,92
"2011","Brent 020D","E01000635","Total",774,175,41,134,282,136,178,45,133
"2011","Brent 020E","E01000636","Total",518,106,15,91,170,75,135,32,103
"2011","Brent 021A","E01000596","Total",640,281,99,182,278,117,191,57,134
"2011","Brent 021B","E01000601","Total",477,153,79,74,250,107,145,55,90
"2011","Brent 021C","E01000602","Total",512,172,58,114,217,90,157,51,106
"2011","Brent 021D","E01000603","Total",576,181,81,100,249,135,114,32,82
"2011","Brent 021E","E01000604","Total",548,176,68,108,257,91,184,79,105
"2011","Brent 021F","E01000605","Total",553,214,88,126,258,96,180,64,116
"2011","Brent 022A","E01000488","Total",533,117,30,87,200,96,100,35,65
"2011","Brent 022B","E01000637","Total",636,185,40,145,176,92,145,26,119
"2011","Brent 022C","E01000639","Total",716,139,26,113,152,86,127,25,102
"2011","Brent 022D","E01000642","Total",915,190,31,159,180,93,172,31,141
"2011","Brent 022E","E01000644","Total",728,190,47,143,231,96,166,35,131
"2011","Brent 023A","E01000490","Total",787,153,31,122,151,96,157,28,129
"2011","Brent 023B","E01000494","Total",724,222,19,203,156,80,183,18,165
"2011","Brent 023C","E01000495","Total",850,320,24,296,118,64,270,23,247
"2011","Brent 023D","E01000560","Total",727,163,14,149,138,62,122,17,105
"2011","Brent 023E","E01000561","Total",823,212,37,175,188,88,192,34,158
"2011","Brent 024A","E01000638","Total",715,197,61,136,254,121,169,47,122
"2011","Brent 024B","E01000640","Total",802,213,61,152,268,130,185,49,136
"2011","Brent 024C","E01000641","Total",715,182,66,116,268,122,169,50,119
"2011","Brent 024D","E01000643","Total",840,329,85,244,317,135,282,59,223
"2011","Brent 025A","E01000508","Total",716,278,80,198,266,143,206,56,150
"2011","Brent 025B","E01000521","Total",905,333,95,238,332,159,259,64,195
"2011","Brent 025C","E01000522","Total",710,210,85,125,321,143,176,64,112
"2011","Brent 025D","E01000526","Total",813,273,97,176,343,144,227,61,166
"2011","Brent 025E","E01000527","Total",813,293,106,187,331,184,203,50,153
"2011","Brent 025F","E01000528","Total",600,228,58,170,216,80,190,49,141
"2011","Brent 026A","E01000471","Total",469,100,20,80,212,72,109,34,75
"2011","Brent 026B","E01000474","Total",501,112,28,84,250,97,138,54,84
"2011","Brent 026C","E01000476","Total",455,99,10,89,181,66,114,34,80
"2011","Brent 026D","E01000477","Total",656,147,43,104,283,125,138,54,84
"2011","Brent 026E","E01000630","Total",768,234,54,180,267,128,208,49,159
"2011","Brent 027A","E01000595","Total",582,215,84,131,264,118,182,65,117
"2011","Brent 027D","E01000599","Total",489,146,38,108,189,75,132,35,97
"2011","Brent 027E","E01000600","Total",783,300,86,214,311,160,231,59,172
"2011","Brent 027F","E01033456","Total",743,294,101,193,331,130,239,73,166
"2011","Brent 028A","E01000545","Total",856,181,28,153,148,68,161,32,129
"2011","Brent 028B","E01000546","Total",756,192,30,162,166,82,160,29,131
"2011","Brent 028C","E01000547","Total",768,213,34,179,193,107,161,30,131
"2011","Brent 028D","E01000548","Total",1014,280,32,248,148,83,201,18,183
"2011","Brent 028E","E01000549","Total",883,159,24,135,203,132,149,24,125
"2011","Brent 029A","E01000472","Total",512,106,30,76,166,89,89,20,69
"2011","Brent 029B","E01000473","Total",520,135,26,109,201,71,151,40,111
"2011","Brent 029C","E01000475","Total",596,132,31,101,246,120,120,40,80
"2011","Brent 029D","E01000478","Total",447,92,19,73,190,80,113,42,71
"2011","Brent 029E","E01000632","Total",548,110,15,95,224,86,178,51,127
"2011","Brent 030A","E01000489","Total",593,191,28,163,175,76,170,34,136
"2011","Brent 030B","E01000491","Total",806,230,42,188,230,95,176,24,152
"2011","Brent 030C","E01000492","Total",467,114,11,103,140,58,99,18,81
"2011","Brent 030D","E01000493","Total",578,143,18,125,189,72,114,19,95
"2011","Brent 030E","E01000581","Total",603,119,19,100,201,94,100,22,78
"2011","Brent 031A","E01000523","Total",993,292,92,200,357,194,234,43,191
"2011","Brent 031B","E01000524","Total",1035,360,123,237,379,183,235,57,178
"2011","Brent 031C","E01000525","Total",785,252,73,179,300,143,204,50,154
"2011","Brent 031E","E01000533","Total",952,302,79,223,321,150,246,56,190
"2011","Brent 031F","E01000535","Total",829,178,40,138,277,126,158,48,110
"2011","Brent 031G","E01033455","Total",501,160,44,116,153,79,110,32,78
"2011","Brent 031H","E01033485","Total",789,293,92,201,269,139,231,52,179
"2011","Brent 032A","E01000579","Total",683,149,33,116,186,84,137,27,110
"2011","Brent 032B","E01000580","Total",821,197,25,172,240,113,176,37,139
"2011","Brent 032C","E01000582","Total",720,142,28,114,237,119,128,23,105
"2011","Brent 032D","E01000583","Total",1017,240,30,210,220,109,171,26,145
"2011","Brent 032E","E01000586","Total",1093,245,70,175,245,127,190,40,150
"2011","Brent 033A","E01000530","Total",700,151,31,120,195,81,143,32,111
"2011","Brent 033B","E01000531","Total",908,261,55,206,265,133,212,43,169
"2011","Brent 033C","E01000532","Total",733,162,27,135,155,86,161,34,127
"2011","Brent 033D","E01000534","Total",651,147,36,111,238,98,148,50,98
"2011","Brent 033E","E01000584","Total",619,140,26,114,198,96,135,29,106
"2011","Brent 033F","E01000585","Total",718,133,33,100,212,118,134,28,106
"2011","Brent 034A","E01000544","Total",742,226,65,161,226,120,187,44,143
"2011","Brent 034B","E01000550","Total",906,291,60,231,228,98,225,44,181
"2011","Brent 034C","E01000551","Total",940,376,92,284,329,146,271,66,205
"2011","Brent 034D","E01000552","Total",793,331,82,249,273,100,239,52,187
"2011","Bromley 001A","E01000779","Total",551,168,16,152,128,44,151,20,131
"2011","Bromley 001B","E01000780","Total",628,229,41,188,197,80,175,26,149
"2011","Bromley 001C","E01000781","Total",614,238,72,166,232,91,160,40,120
"2011","Bromley 001D","E01000782","Total",647,281,73,208,216,107,223,54,169
"2011","Bromley 001E","E01000783","Total",626,241,72,169,252,100,194,49,145
"2011","Bromley 001F","E01000785","Total",609,229,52,177,202,87,196,37,159
"2011","Bromley 002A","E01000689","Total",612,208,30,178,165,71,188,39,149
"2011","Bromley 002B","E01000690","Total",534,147,10,137,188,75,122,21,101
"2011","Bromley 002C","E01000691","Total",619,202,23,179,187,66,140,21,119
"2011","Bromley 002D","E01000692","Total",659,170,21,149,204,79,109,21,88
"2011","Bromley 002E","E01000784","Total",582,129,16,113,217,93,114,25,89
"2011","Bromley 004A","E01000799","Total",719,167,27,140,223,101,144,36,108
"2011","Bromley 004B","E01000802","Total",750,181,28,153,225,104,169,34,135
"2011","Bromley 004C","E01000803","Total",730,194,31,163,199,91,153,19,134
"2011","Bromley 004D","E01000804","Total",548,145,14,131,172,66,110,18,92
"2011","Bromley 004E","E01000805","Total",717,185,29,156,189,93,166,26,140
"2011","Bromley 005A","E01000740","Total",871,188,43,145,240,136,162,37,125
"2011","Bromley 005B","E01000741","Total",842,240,51,189,182,89,204,30,174
"2011","Bromley 005C","E01000742","Total",1044,247,71,176,247,144,170,36,134
"2011","Bromley 005D","E01000745","Total",883,233,53,180,216,120,165,25,140
"2011","Bromley 005E","E01000746","Total",949,252,48,204,228,128,183,25,158
"2011","Bromley 006A","E01000709","Total",787,307,14,293,107,61,225,19,206
"2011","Bromley 006B","E01000710","Total",862,220,27,193,145,90,113,15,98
"2011","Bromley 006C","E01000711","Total",1012,269,13,256,110,67,170,7,163
"2011","Bromley 006D","E01000714","Total",1036,262,23,239,168,98,183,17,166
"2011","Bromley 006E","E01000718","Total",971,321,95,226,292,146,211,42,169
"2011","Bromley 007A","E01000645","Total",536,150,5,145,174,54,102,18,84
"2011","Bromley 007B","E01000649","Total",774,214,17,197,248,100,146,32,114
"2011","Bromley 007C","E01000694","Total",635,226,7,219,195,74,138,14,124
"2011","Bromley 007D","E01000695","Total",614,204,16,188,183,62,122,15,107
"2011","Bromley 007E","E01000696","Total",637,219,9,210,175,62,133,22,111
"2011","Bromley 007F","E01000697","Total",765,185,8,177,172,78,134,9,125
"2011","Bromley 008A","E01000674","Total",802,262,20,242,178,88,181,23,158
"2011","Bromley 008B","E01000676","Total",866,274,47,227,217,117,183,18,165
"2011","Bromley 008C","E01000820","Total",643,202,19,183,170,87,153,16,137
"2011","Bromley 008D","E01000822","Total",727,198,26,172,207,108,144,31,113
"2011","Bromley 008E","E01000823","Total",747,152,15,137,210,105,129,19,110
"2011","Bromley 008F","E01000824","Total",514,111,17,94,166,72,92,19,73
"2011","Bromley 008G","E01000825","Total",807,261,30,231,187,114,192,20,172
"2011","Bromley 009A","E01000743","Total",841,325,93,232,252,127,223,41,182
"2011","Bromley 009B","E01000744","Total",682,292,70,222,219,83,210,52,158
"2011","Bromley 009C","E01000796","Total",638,199,82,117,289,105,138,51,87
"2011","Bromley 009D","E01000798","Total",693,305,86,219,214,94,205,50,155
"2011","Bromley 009E","E01000800","Total",780,229,62,167,232,117,172,38,134
"2011","Bromley 009F","E01000806","Total",768,216,68,148,267,121,154,48,106
"2011","Bromley 010A","E01000693","Total",570,223,11,212,134,45,145,17,128
"2011","Bromley 010B","E01000698","Total",439,151,11,140,123,31,109,15,94
"2011","Bromley 010C","E01000736","Total",618,223,46,177,229,91,174,35,139
"2011","Bromley 010D","E01000737","Total",580,247,45,202,175,80,168,34,134
"2011","Bromley 011A","E01000672","Total",650,187,18,169,175,85,130,25,105
"2011","Bromley 011B","E01000673","Total",630,148,17,131,217,101,122,25,97
"2011","Bromley 011C","E01000716","Total",702,219,9,210,147,46,126,14,112
"2011","Bromley 011D","E01000717","Total",889,231,21,210,149,61,177,21,156
"2011","Bromley 011E","E01000828","Total",766,266,18,248,181,86,173,13,160
"2011","Bromley 012A","E01000712","Total",862,215,7,208,147,82,132,5,127
"2011","Bromley 012B","E01000713","Total",885,219,22,197,169,84,129,20,109
"2011","Bromley 012C","E01000715","Total",885,282,10,272,139,66,189,12,177
"2011","Bromley 012D","E01000770","Total",691,288,2,286,123,43,166,15,151
"2011","Bromley 012E","E01000772","Total",734,283,5,278,156,66,189,12,177
"2011","Bromley 013A","E01000700","Total",666,148,32,116,220,111,141,23,118
"2011","Bromley 013B","E01000702","Total",572,105,9,96,160,78,93,22,71
"2011","Bromley 013C","E01000703","Total",694,148,19,129,212,106,119,26,93
"2011","Bromley 013D","E01000706","Total",591,187,20,167,177,96,135,27,108
"2011","Bromley 013E","E01000797","Total",679,154,12,142,185,87,149,24,125
"2011","Bromley 014A","E01000729","Total",824,370,78,292,274,127,272,55,217
"2011","Bromley 014B","E01000730","Total",649,241,80,161,302,124,194,56,138
"2011","Bromley 014C","E01000735","Total",562,213,46,167,217,76,166,39,127
"2011","Bromley 014D","E01000738","Total",632,223,31,192,197,75,172,36,136
"2011","Bromley 014E","E01000739","Total",634,303,79,224,235,91,217,53,164
"2011","Bromley 015A","E01000699","Total",648,170,43,127,207,99,126,28,98
"2011","Bromley 015B","E01000701","Total",599,134,17,117,173,94,108,17,91
"2011","Bromley 015C","E01000704","Total",593,156,18,138,209,79,125,27,98
"2011","Bromley 015D","E01000705","Total",565,143,26,117,178,85,112,25,87
"2011","Bromley 015E","E01000801","Total",650,189,34,155,181,88,149,26,123
"2011","Bromley 016A","E01000646","Total",728,207,20,187,182,69,154,19,135
"2011","Bromley 016B","E01000647","Total",635,123,22,101,241,100,125,26,99
"2011","Bromley 016C","E01000648","Total",646,129,20,109,257,102,100,20,80
"2011","Bromley 016D","E01000653","Total",608,232,9,223,171,53,139,16,123
"2011","Bromley 016E","E01000678","Total",666,149,14,135,244,99,139,29,110
"2011","Bromley 018A","E01000670","Total",864,187,22,165,233,94,140,30,110
"2011","Bromley 018B","E01000675","Total",690,162,10,152,200,89,132,29,103
"2011","Bromley 018C","E01000677","Total",800,143,31,112,256,155,114,20,94
"2011","Bromley 018D","E01000762","Total",743,266,13,253,172,68,163,21,142
"2011","Bromley 018E","E01000829","Total",734,152,12,140,241,107,138,33,105
"2011","Bromley 019A","E01000719","Total",853,281,82,199,308,164,202,61,141
"2011","Bromley 019B","E01000720","Total",668,217,89,128,260,119,170,55,115
"2011","Bromley 019C","E01000721","Total",524,246,77,169,224,106,168,50,118
"2011","Bromley 019D","E01000724","Total",674,275,93,182,295,134,208,64,144
"2011","Bromley 019E","E01000728","Total",657,266,41,225,177,83,163,26,137
"2011","Bromley 020A","E01000651","Total",631,202,5,197,191,81,150,21,129
"2011","Bromley 020B","E01000668","Total",691,166,13,153,237,119,149,31,118
"2011","Bromley 020C","E01000669","Total",740,189,17,172,247,119,151,31,120
"2011","Bromley 020D","E01000671","Total",784,255,15,240,213,94,205,20,185
"2011","Bromley 020E","E01000679","Total",662,143,17,126,248,103,131,28,103
"2011","Bromley 021A","E01000826","Total",563,155,8,147,211,39,107,17,90
"2011","Bromley 021B","E01000827","Total",790,307,14,293,193,74,193,13,180
"2011","Bromley 021C","E01000830","Total",544,158,10,148,196,45,109,16,93
"2011","Bromley 021D","E01000831","Total",789,298,6,292,170,62,206,13,193
"2011","Bromley 021E","E01000833","Total",497,129,9,120,212,43,84,21,63
"2011","Bromley 022A","E01000650","Total",750,258,19,239,246,85,168,30,138
"2011","Bromley 022B","E01000652","Total",659,222,9,213,206,64,156,28,128
"2011","Bromley 022C","E01000807","Total",595,174,21,153,219,88,119,34,85
"2011","Bromley 022D","E01000809","Total",629,212,7,205,180,81,134,16,118
"2011","Bromley 023A","E01000722","Total",704,227,52,175,232,102,153,38,115
"2011","Bromley 023B","E01000725","Total",775,274,65,209,240,116,176,39,137
"2011","Bromley 023C","E01000731","Total",532,190,45,145,197,71,154,34,120
"2011","Bromley 023D","E01000732","Total",587,208,23,185,191,68,162,28,134
"2011","Bromley 023E","E01000733","Total",651,220,36,184,219,83,175,40,135
"2011","Bromley 024A","E01000769","Total",454,114,12,102,166,45,115,24,91
"2011","Bromley 024B","E01000773","Total",605,230,8,222,196,66,148,22,126
"2011","Bromley 024C","E01000775","Total",867,229,19,210,349,99,162,35,127
"2011","Bromley 024D","E01000777","Total",565,142,15,127,232,66,114,35,79
"2011","Bromley 024E","E01000778","Total",618,185,18,167,232,73,145,23,122
"2011","Bromley 025A","E01000808","Total",625,204,14,190,214,92,135,20,115
"2011","Bromley 025B","E01000810","Total",599,202,3,199,177,79,113,15,98
"2011","Bromley 025C","E01000811","Total",571,163,12,151,173,74,111,20,91
"2011","Bromley 025D","E01000813","Total",637,237,7,230,190,76,159,19,140
"2011","Bromley 025E","E01000815","Total",562,171,4,167,191,64,111,19,92
"2011","Bromley 026A","E01000661","Total",671,270,90,180,260,103,225,57,168
"2011","Bromley 026B","E01000662","Total",680,225,29,196,227,80,190,39,151
"2011","Bromley 026C","E01000663","Total",660,238,43,195,221,98,199,38,161
"2011","Bromley 026D","E01000664","Total",612,213,44,169,235,67,180,50,130
"2011","Bromley 027A","E01000763","Total",523,156,10,146,195,58,108,21,87
"2011","Bromley 027B","E01000764","Total",633,217,19,198,219,69,171,37,134
"2011","Bromley 027C","E01000766","Total",645,184,2,182,220,69,107,22,85
"2011","Bromley 027D","E01000767","Total",598,168,9,159,224,65,135,36,99
"2011","Bromley 027E","E01000834","Total",461,95,6,89,210,44,64,17,47
"2011","Bromley 028A","E01000727","Total",687,257,22,235,181,76,186,17,169
"2011","Bromley 028B","E01000734","Total",507,142,27,115,212,88,127,34,93
"2011","Bromley 028C","E01000790","Total",872,239,30,209,260,116,186,32,154
"2011","Bromley 028D","E01000812","Total",663,218,12,206,153,62,171,21,150
"2011","Bromley 028E","E01000814","Total",564,160,2,158,175,41,103,16,87
"2011","Bromley 029A","E01000723","Total",561,218,10,208,114,30,150,21,129
"2011","Bromley 029B","E01000726","Total",590,191,6,185,128,51,141,19,122
"2011","Bromley 029C","E01000787","Total",667,269,21,248,146,58,196,30,166
"2011","Bromley 029D","E01000788","Total",618,202,19,183,186,59,167,33,134
"2011","Bromley 029E","E01000791","Total",621,268,11,257,161,44,171,19,152
"2011","Bromley 030A","E01000832","Total",572,191,6,185,189,54,136,18,118
"2011","Bromley 030B","E01000835","Total",648,179,17,162,234,74,138,22,116
"2011","Bromley 030C","E01000836","Total",500,118,5,113,220,65,87,25,62
"2011","Bromley 030D","E01000837","Total",647,253,16,237,189,60,183,32,151
"2011","Bromley 030E","E01000838","Total",548,185,5,180,183,51,131,17,114
"2011","Bromley 030F","E01000839","Total",550,139,3,136,192,71,95,13,82
"2011","Bromley 030G","E01000840","Total",685,315,4,311,138,40,215,17,198
"2011","Bromley 030H","E01000841","Total",606,190,10,180,194,74,146,25,121
"2011","Bromley 031A","E01000753","Total",750,318,11,307,212,55,184,20,164
"2011","Bromley 031B","E01000754","Total",743,257,19,238,224,87,174,32,142
"2011","Bromley 031C","E01000755","Total",615,227,3,224,193,49,156,26,130
"2011","Bromley 031D","E01000757","Total",601,219,5,214,170,37,131,16,115
"2011","Bromley 031E","E01000758","Total",591,211,7,204,180,45,148,28,120
"2011","Bromley 032A","E01000786","Total",627,281,10,271,121,36,154,15,139
"2011","Bromley 032B","E01000789","Total",657,271,128,143,340,171,190,80,110
"2011","Bromley 032C","E01000792","Total",483,193,24,169,133,51,135,21,114
"2011","Bromley 032D","E01000793","Total",643,256,7,249,168,61,162,16,146
"2011","Bromley 032E","E01000795","Total",542,191,24,167,197,76,148,34,114
"2011","Bromley 033A","E01000665","Total",757,226,23,203,243,87,184,35,149
"2011","Bromley 033B","E01000666","Total",776,288,10,278,193,56,165,20,145
"2011","Bromley 033C","E01000667","Total",622,223,13,210,201,53,128,18,110
"2011","Bromley 033D","E01000756","Total",594,204,14,190,186,47,130,25,105
"2011","Bromley 034A","E01000759","Total",549,143,7,136,218,55,118,28,90
"2011","Bromley 034B","E01000760","Total",550,178,15,163,188,53,105,11,94
"2011","Bromley 034C","E01000761","Total",577,142,4,138,209,61,107,25,82
"2011","Bromley 034D","E01000765","Total",679,183,11,172,211,75,143,31,112
"2011","Bromley 034E","E01000768","Total",613,219,12,207,183,49,155,31,124
"2011","Bromley 035A","E01000681","Total",654,176,8,168,236,81,114,22,92
"2011","Bromley 035B","E01000682","Total",642,234,5,229,199,54,165,30,135
"2011","Bromley 035C","E01000683","Total",705,190,17,173,209,84,127,25,102
"2011","Bromley 035D","E01000684","Total",757,182,11,171,296,119,128,33,95
"2011","Bromley 035E","E01000794","Total",611,225,7,218,160,51,142,29,113
"2011","Bromley 036A","E01000749","Total",639,209,6,203,178,49,171,29,142
"2011","Bromley 036B","E01000750","Total",665,275,45,230,199,55,195,38,157
"2011","Bromley 036C","E01000751","Total",807,241,16,225,290,94,163,29,134
"2011","Bromley 036D","E01000752","Total",778,343,14,329,171,56,211,17,194
"2011","Bromley 037A","E01000680","Total",646,193,9,184,171,65,129,25,104
"2011","Bromley 037B","E01000685","Total",618,174,12,162,224,94,164,41,123
"2011","Bromley 037C","E01000686","Total",648,235,10,225,166,66,145,11,134
"2011","Bromley 037D","E01000687","Total",656,215,16,199,195,66,140,22,118
"2011","Bromley 037E","E01000688","Total",504,146,4,142,168,47,93,12,81
"2011","Bromley 039A","E01000654","Total",486,87,7,80,165,74,101,21,80
"2011","Bromley 039B","E01000655","Total",494,93,13,80,182,66,96,20,76
"2011","Bromley 039C","E01000656","Total",517,101,2,99,163,53,97,22,75
"2011","Bromley 039D","E01000657","Total",674,185,22,163,207,82,151,22,129
"2011","Bromley 039E","E01000659","Total",520,97,9,88,204,67,101,27,74
"2011","Bromley 040A","E01000816","Total",592,171,21,150,187,72,148,37,111
"2011","Bromley 040B","E01000818","Total",568,165,16,149,184,72,131,27,104
"2011","Bromley 040C","E01000819","Total",740,288,53,235,250,108,213,46,167
"2011","Bromley 040D","E01032562","Total",623,252,73,179,243,98,200,41,159
"2011","Bromley 040E","E01032563","Total",568,188,7,181,153,56,127,20,107
"2011","Bromley 041A","E01000707","Total",536,87,6,81,243,134,70,17,53
"2011","Bromley 041B","E01000708","Total",650,183,19,164,204,93,155,25,130
"2011","Bromley 041C","E01000771","Total",620,153,8,145,223,99,115,29,86
"2011","Bromley 041D","E01000774","Total",581,152,8,144,207,79,129,27,102
"2011","Bromley 041E","E01032568","Total",647,208,38,170,207,86,182,33,149
"2011","Bromley 042A","E01000658","Total",550,193,14,179,140,39,134,17,117
"2011","Bromley 042B","E01000747","Total",773,209,29,180,254,120,140,28,112
"2011","Bromley 042C","E01000748","Total",670,229,7,222,153,41,181,25,156
"2011","Bromley 042D","E01032570","Total",669,242,19,223,178,66,181,25,156
"2011","Croydon 001A","E01001137","Total",875,270,36,234,210,113,173,28,145
"2011","Croydon 001B","E01001138","Total",774,173,29,144,220,102,131,23,108
"2011","Croydon 001C","E01001156","Total",721,220,55,165,226,112,172,37,135
"2011","Croydon 001D","E01001162","Total",767,224,70,154,280,134,163,34,129
"2011","Croydon 001E","E01001164","Total",962,210,39,171,238,126,146,23,123
"2011","Croydon 002A","E01001084","Total",665,185,22,163,211,79,147,34,113
"2011","Croydon 002B","E01001157","Total",615,157,21,136,228,96,136,32,104
"2011","Croydon 002C","E01001159","Total",741,219,41,178,250,118,158,40,118
"2011","Croydon 002D","E01001160","Total",627,157,19,138,219,83,142,37,105
"2011","Croydon 002E","E01001163","Total",798,195,30,165,282,117,168,33,135
"2011","Croydon 003A","E01001083","Total",536,159,16,143,190,74,123,34,89
"2011","Croydon 003B","E01001086","Total",603,137,22,115,214,70,156,32,124
"2011","Croydon 003C","E01001087","Total",848,229,43,186,257,123,184,41,143
"2011","Croydon 003D","E01001161","Total",566,179,71,108,260,95,182,68,114
"2011","Croydon 004A","E01001085","Total",612,230,38,192,193,93,182,30,152
"2011","Croydon 004B","E01001088","Total",592,148,42,106,256,102,124,37,87
"2011","Croydon 004C","E01001089","Total",715,251,66,185,280,135,179,39,140
"2011","Croydon 004D","E01001090","Total",922,270,100,170,344,159,206,62,144
"2011","Croydon 004E","E01001091","Total",562,136,20,116,188,76,130,28,102
"2011","Croydon 005A","E01001147","Total",620,213,83,130,288,138,157,57,100
"2011","Croydon 005B","E01001148","Total",673,174,53,121,254,98,139,38,101
"2011","Croydon 005C","E01001151","Total",671,229,55,174,256,112,177,44,133
"2011","Croydon 005D","E01001152","Total",674,182,55,127,268,138,131,38,93
"2011","Croydon 005E","E01001158","Total",700,185,57,128,235,113,132,32,100
"2011","Croydon 006A","E01001146","Total",607,150,39,111,229,91,150,46,104
"2011","Croydon 006B","E01001149","Total",619,140,48,92,259,106,112,37,75
"2011","Croydon 006C","E01001150","Total",620,137,32,105,271,107,124,33,91
"2011","Croydon 006D","E01001153","Total",591,156,39,117,236,96,129,45,84
"2011","Croydon 006E","E01001154","Total",735,201,78,123,339,159,154,52,102
"2011","Croydon 007A","E01001136","Total",927,301,71,230,257,141,208,45,163
"2011","Croydon 007B","E01001139","Total",694,176,43,133,218,97,152,35,117
"2011","Croydon 007C","E01001140","Total",773,184,41,143,212,104,133,24,109
"2011","Croydon 007D","E01001142","Total",620,164,49,115,221,88,111,30,81
"2011","Croydon 007E","E01001144","Total",797,290,90,200,251,129,187,37,150
"2011","Croydon 008A","E01001141","Total",568,162,37,125,201,92,150,36,114
"2011","Croydon 008B","E01001143","Total",848,321,72,249,287,143,236,45,191
"2011","Croydon 008C","E01001145","Total",848,310,98,212,305,152,209,44,165
"2011","Croydon 008D","E01001191","Total",823,235,71,164,257,123,159,31,128
"2011","Croydon 008E","E01001192","Total",727,217,71,146,275,146,183,49,134
"2011","Croydon 009A","E01000994","Total",536,140,37,103,221,96,112,33,79
"2011","Croydon 009B","E01000995","Total",597,169,43,126,221,116,134,30,104
"2011","Croydon 009C","E01000996","Total",443,94,19,75,160,54,96,31,65
"2011","Croydon 009D","E01000997","Total",471,121,29,92,186,70,108,28,80
"2011","Croydon 009E","E01000999","Total",436,100,21,79,163,67,126,35,91
"2011","Croydon 009F","E01001002","Total",498,136,24,112,201,90,118,33,85
"2011","Croydon 010A","E01000998","Total",629,163,45,118,222,111,148,46,102
"2011","Croydon 010B","E01001000","Total",454,115,25,90,165,82,94,23,71
"2011","Croydon 010C","E01001003","Total",608,159,48,111,230,108,136,29,107
"2011","Croydon 010D","E01001111","Total",610,139,43,96,246,103,119,41,78
"2011","Croydon 010E","E01001155","Total",761,329,57,272,217,98,250,41,209
"2011","Croydon 011A","E01001174","Total",523,135,30,105,221,89,120,36,84
"2011","Croydon 011B","E01001175","Total",527,147,38,109,213,100,127,38,89
"2011","Croydon 011C","E01001176","Total",628,150,57,93,299,144,128,45,83
"2011","Croydon 011D","E01001182","Total",462,128,34,94,192,81,123,38,85
"2011","Croydon 011E","E01001183","Total",550,157,49,108,210,100,140,41,99
"2011","Croydon 011F","E01001184","Total",456,118,23,95,174,62,116,30,86
"2011","Croydon 013A","E01001001","Total",493,143,41,102,181,85,111,32,79
"2011","Croydon 013B","E01001109","Total",845,312,93,219,322,151,236,60,176
"2011","Croydon 013C","E01001112","Total",763,238,81,157,280,126,183,49,134
"2011","Croydon 013D","E01001113","Total",795,195,64,131,283,162,180,42,138
"2011","Croydon 013E","E01001114","Total",585,190,76,114,260,122,134,37,97
"2011","Croydon 013F","E01001116","Total",528,144,45,99,222,118,116,31,85
"2011","Croydon 014A","E01000992","Total",723,219,66,153,317,115,206,59,147
"2011","Croydon 014B","E01001185","Total",717,174,43,131,241,122,163,40,123
"2011","Croydon 014C","E01001186","Total",841,304,69,235,271,128,223,42,181
"2011","Croydon 014D","E01001188","Total",728,204,79,125,312,134,165,50,115
"2011","Croydon 014E","E01001193","Total",583,166,92,74,326,87,155,73,82
"2011","Croydon 015A","E01001004","Total",787,207,93,114,372,176,148,51,97
"2011","Croydon 015B","E01001115","Total",657,254,76,178,270,107,208,53,155
"2011","Croydon 015C","E01001117","Total",1113,251,93,158,416,236,189,55,134
"2011","Croydon 015D","E01001178","Total",505,193,88,105,220,124,122,38,84
"2011","Croydon 015E","E01001181","Total",759,238,87,151,339,192,201,52,149
"2011","Croydon 016A","E01001006","Total",616,154,78,76,291,151,123,54,69
"2011","Croydon 016B","E01001007","Total",605,145,38,107,288,109,155,54,101
"2011","Croydon 016C","E01001177","Total",551,164,55,109,269,88,155,55,100
"2011","Croydon 016D","E01001179","Total",538,134,34,100,243,111,122,40,82
"2011","Croydon 016E","E01001180","Total",609,149,59,90,302,151,140,55,85
"2011","Croydon 017A","E01000980","Total",566,120,32,88,214,94,127,39,88
"2011","Croydon 017B","E01000981","Total",647,134,23,111,245,104,128,31,97
"2011","Croydon 017C","E01000982","Total",684,152,43,109,231,110,134,29,105
"2011","Croydon 017D","E01000983","Total",665,135,15,120,230,89,119,20,99
"2011","Croydon 017E","E01001187","Total",809,194,62,132,293,126,166,40,126
"2011","Croydon 018A","E01000989","Total",628,146,20,126,247,82,132,34,98
"2011","Croydon 018B","E01000991","Total",662,217,7,210,175,49,149,24,125
"2011","Croydon 018C","E01001131","Total",685,213,23,190,228,95,169,33,136
"2011","Croydon 018D","E01001132","Total",607,218,7,211,141,36,159,25,134
"2011","Croydon 018E","E01001134","Total",697,180,17,163,192,68,158,28,130
"2011","Croydon 019A","E01001005","Total",536,121,40,81,261,144,92,29,63
"2011","Croydon 019B","E01001008","Total",538,165,64,101,263,101,131,52,79
"2011","Croydon 019C","E01001009","Total",609,139,49,90,308,157,117,43,74
"2011","Croydon 019D","E01001010","Total",539,156,62,94,255,91,179,56,123
"2011","Croydon 019E","E01001011","Total",755,195,66,129,301,145,151,55,96
"2011","Croydon 020A","E01001012","Total",746,229,94,135,267,158,170,52,118
"2011","Croydon 020B","E01001013","Total",899,389,119,270,332,141,305,79,226
"2011","Croydon 020C","E01001048","Total",949,244,72,172,302,189,162,27,135
"2011","Croydon 020D","E01001110","Total",771,205,68,137,286,144,151,43,108
"2011","Croydon 020E","E01001118","Total",795,294,99,195,301,141,225,59,166
"2011","Croydon 021A","E01000985","Total",515,138,11,127,172,44,108,24,84
"2011","Croydon 021B","E01000986","Total",677,197,24,173,205,80,164,30,134
"2011","Croydon 021C","E01000987","Total",513,123,3,120,165,52,118,25,93
"2011","Croydon 021D","E01000993","Total",616,161,28,133,233,84,126,29,97
"2011","Croydon 022A","E01000975","Total",710,154,36,118,187,89,139,28,111
"2011","Croydon 022B","E01000976","Total",824,224,49,175,253,139,179,38,141
"2011","Croydon 022C","E01000977","Total",918,322,35,287,203,114,251,29,222
"2011","Croydon 022D","E01000978","Total",927,238,44,194,193,116,170,18,152
"2011","Croydon 022E","E01000979","Total",790,150,26,124,190,119,140,25,115
"2011","Croydon 022F","E01000984","Total",822,280,62,218,236,114,226,48,178
"2011","Croydon 023A","E01001044","Total",871,259,18,241,230,123,164,33,131
"2011","Croydon 023B","E01001046","Total",850,210,11,199,226,130,133,16,117
"2011","Croydon 023C","E01001049","Total",505,146,12,134,146,47,115,22,93
"2011","Croydon 023D","E01001050","Total",802,335,31,304,204,118,250,26,224
"2011","Croydon 024A","E01001014","Total",1186,327,133,194,428,253,252,58,194
"2011","Croydon 024B","E01001042","Total",836,212,67,145,255,137,167,38,129
"2011","Croydon 024C","E01001165","Total",676,131,23,108,228,91,161,40,121
"2011","Croydon 024D","E01001166","Total",835,280,85,195,278,148,189,41,148
"2011","Croydon 024E","E01001168","Total",740,179,31,148,225,122,145,26,119
"2011","Croydon 025A","E01001127","Total",574,157,9,148,175,61,133,25,108
"2011","Croydon 025B","E01001128","Total",566,196,85,111,299,114,134,49,85
"2011","Croydon 025C","E01001130","Total",598,226,144,82,398,190,128,54,74
"2011","Croydon 025D","E01001135","Total",631,182,10,172,184,65,156,27,129
"2011","Croydon 026A","E01001062","Total",571,172,9,163,159,35,136,25,111
"2011","Croydon 026B","E01001063","Total",587,155,15,140,189,70,136,23,113
"2011","Croydon 026C","E01001064","Total",613,191,11,180,172,56,138,32,106
"2011","Croydon 026D","E01001129","Total",502,132,4,128,173,47,118,29,89
"2011","Croydon 026E","E01001133","Total",726,340,7,333,150,43,248,20,228
"2011","Croydon 027A","E01001035","Total",834,163,23,140,170,96,124,17,107
"2011","Croydon 027B","E01001043","Total",1202,242,90,152,363,224,181,47,134
"2011","Croydon 027C","E01001045","Total",953,229,33,196,178,103,180,15,165
"2011","Croydon 027D","E01001047","Total",869,219,32,187,176,110,191,21,170
"2011","Croydon 027E","E01001170","Total",989,291,47,244,273,135,236,36,200
"2011","Croydon 028A","E01001167","Total",829,195,48,147,323,138,189,55,134
"2011","Croydon 028B","E01001169","Total",651,227,62,165,256,101,200,57,143
"2011","Croydon 028C","E01001171","Total",681,242,78,164,250,126,166,34,132
"2011","Croydon 028D","E01001172","Total",616,235,86,149,288,104,199,69,130
"2011","Croydon 028E","E01001173","Total",1089,261,75,186,378,176,212,52,160
"2011","Croydon 029A","E01001036","Total",628,184,5,179,144,57,136,18,118
"2011","Croydon 029B","E01001037","Total",624,130,45,85,213,116,99,26,73
"2011","Croydon 029C","E01001038","Total",941,171,29,142,175,116,156,25,131
"2011","Croydon 029D","E01001039","Total",583,155,11,144,177,72,107,23,84
"2011","Croydon 029E","E01001040","Total",763,167,37,130,249,141,142,32,110
"2011","Croydon 030A","E01001051","Total",581,249,70,179,254,114,190,45,145
"2011","Croydon 030B","E01001052","Total",470,164,83,81,256,103,127,57,70
"2011","Croydon 030C","E01001054","Total",594,203,70,133,259,109,165,55,110
"2011","Croydon 030D","E01001056","Total",593,226,136,90,379,173,181,89,92
"2011","Croydon 030E","E01001057","Total",637,262,171,91,435,239,164,84,80
"2011","Croydon 031A","E01001033","Total",694,180,28,152,213,123,146,27,119
"2011","Croydon 031B","E01001034","Total",660,126,29,97,186,91,124,28,96
"2011","Croydon 031C","E01001041","Total",752,185,59,126,238,138,124,36,88
"2011","Croydon 031D","E01001095","Total",584,129,34,95,211,123,95,29,66
"2011","Croydon 031E","E01001100","Total",619,140,8,132,186,85,117,18,99
"2011","Croydon 032A","E01001053","Total",527,170,41,129,212,92,138,35,103
"2011","Croydon 032B","E01001055","Total",585,224,47,177,200,77,204,48,156
"2011","Croydon 032C","E01001077","Total",523,141,25,116,172,70,112,26,86
"2011","Croydon 032D","E01001078","Total",513,167,61,106,221,81,147,52,95
"2011","Croydon 032E","E01001082","Total",560,193,71,122,264,89,162,56,106
"2011","Croydon 033A","E01001120","Total",480,128,9,119,174,57,117,30,87
"2011","Croydon 033B","E01001122","Total",507,100,6,94,162,46,105,23,82
"2011","Croydon 033C","E01001123","Total",598,221,12,209,183,54,152,21,131
"2011","Croydon 033D","E01001124","Total",609,207,6,201,161,36,125,18,107
"2011","Croydon 033E","E01001125","Total",602,170,19,151,201,74,132,42,90
"2011","Croydon 034A","E01001058","Total",521,147,20,127,186,76,116,32,84
"2011","Croydon 034B","E01001059","Total",692,178,22,156,178,88,113,15,98
"2011","Croydon 034C","E01001060","Total",657,156,20,136,216,79,139,30,109
"2011","Croydon 034D","E01001061","Total",642,175,37,138,214,100,167,40,127
"2011","Croydon 034E","E01001065","Total",672,212,12,200,117,40,143,18,125
"2011","Croydon 034F","E01001066","Total",493,179,66,113,241,98,149,48,101
"2011","Croydon 034G","E01001119","Total",576,138,6,132,169,51,114,24,90
"2011","Croydon 034H","E01001126","Total",598,184,13,171,170,61,132,18,114
"2011","Croydon 035A","E01001032","Total",520,171,5,166,144,50,109,13,96
"2011","Croydon 035B","E01001101","Total",509,141,8,133,193,54,105,31,74
"2011","Croydon 035C","E01001102","Total",605,248,10,238,156,52,171,14,157
"2011","Croydon 035D","E01001107","Total",662,188,21,167,178,76,110,21,89
"2011","Croydon 035E","E01001108","Total",628,175,12,163,216,68,110,21,89
"2011","Croydon 036A","E01001076","Total",581,215,71,144,267,126,186,63,123
"2011","Croydon 036B","E01001079","Total",639,247,81,166,280,129,199,64,135
"2011","Croydon 036C","E01001080","Total",687,329,90,239,265,126,279,63,216
"2011","Croydon 036D","E01001081","Total",506,189,60,129,203,81,151,38,113
"2011","Croydon 037A","E01001073","Total",618,157,15,142,171,74,140,24,116
"2011","Croydon 037B","E01001092","Total",588,173,19,154,195,66,109,22,87
"2011","Croydon 037C","E01001093","Total",694,185,44,141,250,115,142,34,108
"2011","Croydon 037D","E01001096","Total",530,122,9,113,197,65,100,31,69
"2011","Croydon 037E","E01001097","Total",1059,318,41,277,233,119,236,26,210
"2011","Croydon 037F","E01001098","Total",515,121,11,110,182,60,99,20,79
"2011","Croydon 038A","E01001028","Total",528,135,10,125,189,54,111,26,85
"2011","Croydon 038B","E01001029","Total",541,113,15,98,178,53,113,28,85
"2011","Croydon 038C","E01001030","Total",462,101,12,89,197,63,97,30,67
"2011","Croydon 038D","E01001031","Total",491,118,6,112,191,44,94,25,69
"2011","Croydon 038E","E01001094","Total",521,133,7,126,179,47,85,23,62
"2011","Croydon 039A","E01001103","Total",651,255,15,240,218,75,174,31,143
"2011","Croydon 039B","E01001105","Total",632,200,24,176,246,78,179,31,148
"2011","Croydon 039C","E01001106","Total",540,151,22,129,204,64,139,31,108
"2011","Croydon 039D","E01001121","Total",501,169,6,163,114,36,110,14,96
"2011","Croydon 040A","E01001069","Total",500,122,14,108,183,72,107,24,83
"2011","Croydon 040B","E01001070","Total",659,206,32,174,224,82,152,38,114
"2011","Croydon 040C","E01001075","Total",646,154,25,129,221,112,108,25,83
"2011","Croydon 040D","E01001099","Total",586,144,44,100,224,104,105,38,67
"2011","Croydon 041A","E01001015","Total",515,159,39,120,206,77,138,49,89
"2011","Croydon 041B","E01001016","Total",665,206,20,186,215,72,150,33,117
"2011","Croydon 041C","E01001023","Total",575,180,13,167,161,62,146,21,125
"2011","Croydon 041D","E01001067","Total",578,132,6,126,213,78,109,33,76
"2011","Croydon 041E","E01001074","Total",828,199,38,161,278,121,165,35,130
"2011","Croydon 042A","E01001068","Total",784,203,53,150,288,105,170,41,129
"2011","Croydon 042B","E01001071","Total",735,161,28,133,277,89,151,36,115
"2011","Croydon 042C","E01001072","Total",533,159,8,151,165,52,119,24,95
"2011","Croydon 042D","E01001104","Total",642,154,14,140,234,61,117,26,91
"2011","Croydon 043A","E01001017","Total",642,183,4,179,188,72,121,12,109
"2011","Croydon 043B","E01001024","Total",532,131,18,113,201,67,121,38,83
"2011","Croydon 043C","E01001025","Total",489,140,13,127,174,58,95,18,77
"2011","Croydon 043D","E01001026","Total",641,164,21,143,246,80,157,34,123
"2011","Croydon 043E","E01001027","Total",534,113,15,98,215,66,121,38,83
"2011","Croydon 044A","E01001018","Total",639,199,9,190,192,77,144,23,121
"2011","Croydon 044B","E01001019","Total",593,227,2,225,178,52,159,24,135
"2011","Croydon 044C","E01001020","Total",657,220,15,205,208,83,159,21,138
"2011","Croydon 044D","E01001021","Total",590,280,46,234,185,71,219,37,182
"2011","Croydon 044E","E01001022","Total",611,242,8,234,156,56,149,16,133
"2011","Croydon 045A","E01000990","Total",538,197,53,144,212,75,182,54,128
"2011","Croydon 045B","E01001189","Total",465,110,26,84,188,81,103,27,76
"2011","Croydon 045C","E01001190","Total",616,148,40,108,272,111,142,40,102
"2011","Croydon 045D","E01001194","Total",624,127,39,88,250,93,120,38,82
"2011","Croydon 045E","E01032569","Total",660,220,93,127,330,136,198,76,122
"2011","Ealing 001A","E01001269","Total",646,113,17,96,284,127,141,45,96
"2011","Ealing 001B","E01001271","Total",593,138,24,114,230,107,132,33,99
"2011","Ealing 001C","E01001309","Total",614,127,19,108,248,105,122,42,80
"2011","Ealing 001D","E01001310","Total",663,161,45,116,250,123,112,32,80
"2011","Ealing 001E","E01001311","Total",663,209,54,155,275,129,205,62,143
"2011","Ealing 002A","E01001307","Total",633,128,13,115,213,97,134,29,105
"2011","Ealing 002B","E01001308","Total",679,173,15,158,216,91,146,40,106
"2011","Ealing 002C","E01001312","Total",590,134,25,109,217,99,132,35,97
"2011","Ealing 002D","E01001313","Total",516,108,18,90,191,83,106,25,81
"2011","Ealing 002E","E01001314","Total",506,106,11,95,190,81,115,26,89
"2011","Ealing 003A","E01001315","Total",495,96,24,72,207,93,111,25,86
"2011","Ealing 003B","E01001316","Total",620,223,76,147,246,123,165,50,115
"2011","Ealing 003C","E01001317","Total",686,198,66,132,288,139,184,59,125
"2011","Ealing 003D","E01001318","Total",677,248,70,178,288,151,206,54,152
"2011","Ealing 003E","E01001320","Total",534,172,81,91,260,111,135,47,88
"2011","Ealing 003F","E01001321","Total",758,255,51,204,262,131,190,47,143
"2011","Ealing 004A","E01001270","Total",565,129,30,99,236,93,129,49,80
"2011","Ealing 004B","E01001319","Total",490,129,29,100,201,83,94,36,58
"2011","Ealing 004C","E01001322","Total",627,156,38,118,223,96,129,36,93
"2011","Ealing 004D","E01001323","Total",684,186,43,143,220,112,139,35,104
"2011","Ealing 005A","E01001341","Total",529,100,17,83,216,107,102,35,67
"2011","Ealing 005B","E01001342","Total",638,121,27,94,248,119,134,36,98
"2011","Ealing 005C","E01001343","Total",483,119,21,98,159,67,112,25,87
"2011","Ealing 005D","E01001345","Total",501,124,22,102,217,89,125,50,75
"2011","Ealing 006A","E01001265","Total",627,130,30,100,243,133,133,41,92
"2011","Ealing 006B","E01001266","Total",578,139,16,123,221,92,115,27,88
"2011","Ealing 006C","E01001267","Total",814,289,50,239,252,132,236,41,195
"2011","Ealing 006D","E01001272","Total",542,105,17,88,213,103,99,31,68
"2011","Ealing 006E","E01001349","Total",507,152,22,130,176,68,142,30,112
"2011","Ealing 007A","E01001344","Total",880,237,53,184,295,166,184,41,143
"2011","Ealing 007B","E01001346","Total",634,149,25,124,240,111,140,36,104
"2011","Ealing 007C","E01001347","Total",518,114,15,99,176,75,116,33,83
"2011","Ealing 007D","E01001348","Total",626,150,23,127,212,105,117,34,83
"2011","Ealing 008A","E01001257","Total",659,263,93,170,296,148,200,60,140
"2011","Ealing 008B","E01001324","Total",662,175,66,109,250,138,140,41,99
"2011","Ealing 008C","E01001326","Total",674,267,83,184,272,137,203,47,156
"2011","Ealing 008D","E01001330","Total",636,243,70,173,235,123,185,38,147
"2011","Ealing 008E","E01001332","Total",579,193,78,115,239,101,173,57,116
"2011","Ealing 009A","E01001325","Total",602,194,41,153,250,116,187,39,148
"2011","Ealing 009B","E01001327","Total",600,197,46,151,235,99,177,39,138
"2011","Ealing 009C","E01001328","Total",620,229,72,157,270,125,185,42,143
"2011","Ealing 009D","E01001329","Total",631,189,43,146,262,121,165,35,130
"2011","Ealing 009E","E01001331","Total",618,217,95,122,297,165,148,51,97
"2011","Ealing 010B","E01001258","Total",634,190,31,159,230,97,160,36,124
"2011","Ealing 010C","E01001262","Total",558,168,30,138,212,92,158,43,115
"2011","Ealing 010D","E01001263","Total",647,224,59,165,235,130,205,46,159
"2011","Ealing 010E","E01001264","Total",612,193,47,146,230,105,167,42,125
"2011","Ealing 010F","E01032743","Total",818,200,132,68,425,242,133,77,56
"2011","Ealing 010G","E01032744","Total",486,147,50,97,204,107,109,29,80
"2011","Ealing 011A","E01001276","Total",651,136,25,111,203,106,116,30,86
"2011","Ealing 011B","E01001277","Total",668,153,35,118,195,92,109,24,85
"2011","Ealing 011C","E01001278","Total",801,222,42,180,242,126,174,35,139
"2011","Ealing 011D","E01001280","Total",782,223,39,184,212,119,142,19,123
"2011","Ealing 012A","E01001218","Total",692,239,59,180,257,117,213,48,165
"2011","Ealing 012B","E01001260","Total",660,177,22,155,228,109,194,39,155
"2011","Ealing 012C","E01001261","Total",758,199,39,160,264,115,150,33,117
"2011","Ealing 012D","E01001268","Total",629,189,25,164,225,110,149,38,111
"2011","Ealing 013A","E01001209","Total",647,128,10,118,248,107,99,20,79
"2011","Ealing 013B","E01001211","Total",705,192,22,170,206,91,142,20,122
"2011","Ealing 013C","E01001279","Total",564,153,4,149,188,56,107,15,92
"2011","Ealing 013D","E01001281","Total",625,147,9,138,209,106,108,19,89
"2011","Ealing 014A","E01001217","Total",455,98,23,75,199,70,104,31,73
"2011","Ealing 014B","E01001259","Total",510,137,36,101,188,85,132,35,97
"2011","Ealing 014C","E01001291","Total",495,117,33,84,209,84,137,40,97
"2011","Ealing 014D","E01001292","Total",504,102,14,88,199,76,90,28,62
"2011","Ealing 014E","E01001293","Total",478,101,25,76,205,76,110,43,67
"2011","Ealing 015A","E01001196","Total",762,334,87,247,239,110,247,50,197
"2011","Ealing 015B","E01001238","Total",1236,312,96,216,299,171,218,49,169
"2011","Ealing 015C","E01001239","Total",553,147,48,99,185,68,135,34,101
"2011","Ealing 015D","E01001246","Total",492,124,35,89,180,86,109,33,76
"2011","Ealing 015E","E01001247","Total",674,214,80,134,220,103,154,39,115
"2011","Ealing 016A","E01001210","Total",740,354,69,285,228,83,282,49,233
"2011","Ealing 016B","E01001282","Total",627,258,52,206,224,93,231,46,185
"2011","Ealing 016C","E01001283","Total",712,320,53,267,212,108,263,41,222
"2011","Ealing 016D","E01001285","Total",562,140,34,106,242,102,141,47,94
"2011","Ealing 016E","E01001286","Total",620,181,45,136,262,124,156,31,125
"2011","Ealing 016F","E01001287","Total",483,150,49,101,229,91,132,55,77
"2011","Ealing 017A","E01001294","Total",538,105,28,77,232,92,151,55,96
"2011","Ealing 017B","E01001295","Total",521,82,14,68,232,91,131,49,82
"2011","Ealing 017C","E01001296","Total",404,85,21,64,186,63,120,37,83
"2011","Ealing 017D","E01001297","Total",495,119,19,100,222,98,117,32,85
"2011","Ealing 017E","E01001298","Total",529,143,32,111,196,83,151,37,114
"2011","Ealing 018A","E01001204","Total",585,133,16,117,200,68,110,19,91
"2011","Ealing 018B","E01001205","Total",598,175,54,121,210,100,127,29,98
"2011","Ealing 018C","E01001206","Total",582,222,115,107,299,136,165,55,110
"2011","Ealing 018D","E01001207","Total",668,122,19,103,177,78,91,17,74
"2011","Ealing 018E","E01001208","Total",498,133,11,122,198,77,109,26,83
"2011","Ealing 018F","E01001212","Total",691,206,11,195,167,63,139,22,117
"2011","Ealing 019A","E01001222","Total",1150,221,63,158,248,131,165,34,131
"2011","Ealing 019B","E01001224","Total",570,102,9,93,208,65,89,17,72
"2011","Ealing 019C","E01001226","Total",668,163,13,150,148,64,115,15,100
"2011","Ealing 019D","E01001227","Total",602,135,11,124,193,71,121,24,97
"2011","Ealing 019E","E01001228","Total",792,186,23,163,144,70,149,12,137
"2011","Ealing 020A","E01001221","Total",952,214,16,198,106,60,177,13,164
"2011","Ealing 020B","E01001223","Total",643,165,21,144,140,61,113,12,101
"2011","Ealing 020C","E01001225","Total",807,244,21,223,186,77,181,22,159
"2011","Ealing 020D","E01001235","Total",691,116,16,100,135,75,84,8,76
"2011","Ealing 020E","E01001236","Total",741,208,26,182,155,81,147,11,136
"2011","Ealing 020F","E01001273","Total",597,160,12,148,178,74,122,19,103
"2011","Ealing 020G","E01001274","Total",585,125,26,99,247,99,108,30,78
"2011","Ealing 020H","E01001275","Total",857,202,21,181,135,78,142,18,124
"2011","Ealing 021A","E01001195","Total",598,169,28,141,208,93,108,28,80
"2011","Ealing 021B","E01001197","Total",668,192,38,154,225,86,134,20,114
"2011","Ealing 021C","E01001198","Total",584,142,28,114,162,71,122,27,95
"2011","Ealing 021D","E01001199","Total",694,167,43,124,219,111,133,37,96
"2011","Ealing 022A","E01001284","Total",538,134,14,120,196,64,121,27,94
"2011","Ealing 022B","E01001288","Total",531,106,25,81,230,106,103,31,72
"2011","Ealing 022C","E01001289","Total",476,87,21,66,206,83,88,26,62
"2011","Ealing 022D","E01001290","Total",738,143,23,120,240,109,142,26,116
"2011","Ealing 023A","E01001213","Total",503,128,27,101,198,88,166,48,118
"2011","Ealing 023B","E01001214","Total",477,120,22,98,180,80,130,32,98
"2011","Ealing 023C","E01001215","Total",552,189,41,148,218,95,179,50,129
"2011","Ealing 023D","E01001216","Total",476,128,20,108,185,94,124,38,86
"2011","Ealing 023E","E01001361","Total",460,124,44,80,209,89,130,54,76
"2011","Ealing 024A","E01001240","Total",512,145,34,111,154,64,127,33,94
"2011","Ealing 024B","E01001241","Total",503,138,24,114,150,58,129,30,99
"2011","Ealing 024C","E01001242","Total",524,178,38,140,170,72,157,29,128
"2011","Ealing 024D","E01001243","Total",649,198,58,140,226,107,166,41,125
"2011","Ealing 024E","E01001244","Total",1099,322,88,234,281,148,241,60,181
"2011","Ealing 024F","E01001245","Total",823,159,42,117,228,137,136,31,105
"2011","Ealing 025A","E01001200","Total",586,115,19,96,160,92,87,13,74
"2011","Ealing 025B","E01001201","Total",642,143,19,124,185,69,135,27,108
"2011","Ealing 025C","E01001202","Total",871,280,69,211,275,132,201,44,157
"2011","Ealing 025D","E01001203","Total",861,282,41,241,191,106,212,22,190
"2011","Ealing 025E","E01001351","Total",811,256,38,218,200,100,183,21,162
"2011","Ealing 026A","E01001359","Total",562,144,37,107,260,119,158,68,90
"2011","Ealing 026B","E01001360","Total",505,128,28,100,220,79,158,62,96
"2011","Ealing 026C","E01001362","Total",511,116,19,97,214,97,144,44,100
"2011","Ealing 026D","E01001363","Total",471,120,38,82,234,117,140,48,92
"2011","Ealing 026E","E01001364","Total",516,189,39,150,203,72,198,54,144
"2011","Ealing 026F","E01001365","Total",590,152,37,115,265,127,171,67,104
"2011","Ealing 027A","E01001231","Total",696,163,17,146,187,65,137,32,105
"2011","Ealing 027B","E01001234","Total",640,132,24,108,114,63,101,14,87
"2011","Ealing 027C","E01001350","Total",621,157,20,137,170,62,129,19,110
"2011","Ealing 027D","E01001352","Total",571,114,14,100,158,59,101,20,81
"2011","Ealing 027E","E01001354","Total",677,126,18,108,172,73,125,25,100
"2011","Ealing 028A","E01001249","Total",1025,314,84,230,314,160,242,59,183
"2011","Ealing 028B","E01001250","Total",983,305,57,248,224,106,274,38,236
"2011","Ealing 028C","E01001255","Total",608,132,14,118,207,99,101,17,84
"2011","Ealing 028D","E01001383","Total",662,131,14,117,190,88,123,27,96
"2011","Ealing 028E","E01001388","Total",743,253,49,204,208,103,191,35,156
"2011","Ealing 028F","E01001389","Total",726,188,19,169,163,100,138,18,120
"2011","Ealing 029A","E01001219","Total",674,256,91,165,310,133,202,61,141
"2011","Ealing 029B","E01001220","Total",471,170,73,97,226,90,150,52,98
"2011","Ealing 029C","E01001334","Total",522,195,58,137,223,92,193,65,128
"2011","Ealing 029D","E01001337","Total",452,134,32,102,171,67,128,38,90
"2011","Ealing 029E","E01001338","Total",518,160,40,120,210,97,146,55,91
"2011","Ealing 029F","E01001339","Total",568,173,79,94,284,114,158,69,89
"2011","Ealing 029G","E01001340","Total",506,120,51,69,211,96,98,31,67
"2011","Ealing 030A","E01001251","Total",659,129,27,102,219,122,128,28,100
"2011","Ealing 030B","E01001252","Total",768,171,28,143,252,146,162,31,131
"2011","Ealing 030C","E01001253","Total",670,148,33,115,219,117,128,35,93
"2011","Ealing 030D","E01001254","Total",750,191,20,171,237,133,170,20,150
"2011","Ealing 031A","E01001229","Total",597,182,51,131,202,84,163,39,124
"2011","Ealing 031B","E01001230","Total",629,115,16,99,136,58,109,15,94
"2011","Ealing 031C","E01001232","Total",612,184,35,149,185,89,133,29,104
"2011","Ealing 031D","E01001233","Total",599,174,24,150,137,61,147,24,123
"2011","Ealing 031E","E01001237","Total",652,110,8,102,136,54,91,7,84
"2011","Ealing 031F","E01001386","Total",735,167,12,155,209,95,103,11,92
"2011","Ealing 032A","E01001303","Total",624,108,11,97,200,97,90,21,69
"2011","Ealing 032B","E01001382","Total",564,121,12,109,217,90,101,21,80
"2011","Ealing 032C","E01001384","Total",677,118,13,105,175,105,113,17,96
"2011","Ealing 032D","E01001385","Total",667,136,7,129,208,103,104,17,87
"2011","Ealing 032E","E01001387","Total",713,158,21,137,154,70,124,17,107
"2011","Ealing 033A","E01001353","Total",718,218,40,178,184,102,171,26,145
"2011","Ealing 033B","E01001355","Total",760,234,42,192,170,80,199,24,175
"2011","Ealing 033C","E01001356","Total",841,378,97,281,280,152,275,53,222
"2011","Ealing 033D","E01001357","Total",426,123,45,78,168,68,105,26,79
"2011","Ealing 033E","E01001358","Total",586,229,79,150,254,131,181,53,128
"2011","Ealing 034A","E01001375","Total",706,119,8,111,219,132,111,19,92
"2011","Ealing 034B","E01001377","Total",718,176,16,160,216,75,134,23,111
"2011","Ealing 034C","E01001379","Total",709,137,13,124,225,115,94,14,80
"2011","Ealing 034D","E01001381","Total",738,178,19,159,163,88,148,15,133
"2011","Ealing 035A","E01001248","Total",581,143,26,117,180,73,126,27,99
"2011","Ealing 035B","E01001299","Total",651,152,11,141,215,87,150,19,131
"2011","Ealing 035C","E01001305","Total",634,120,5,115,230,90,122,32,90
"2011","Ealing 035D","E01001306","Total",713,154,9,145,199,102,132,19,113
"2011","Ealing 037A","E01001366","Total",543,135,50,85,249,122,136,48,88
"2011","Ealing 037B","E01001367","Total",527,148,49,99,219,112,143,49,94
"2011","Ealing 037C","E01001368","Total",456,126,48,78,223,93,130,48,82
"2011","Ealing 037D","E01001370","Total",532,132,39,93,228,109,148,51,97
"2011","Ealing 037E","E01001371","Total",594,163,66,97,281,135,156,51,105
"2011","Ealing 037F","E01001372","Total",493,115,40,75,224,101,119,45,74
"2011","Ealing 037G","E01001373","Total",412,103,33,70,182,81,115,46,69
"2011","Ealing 038A","E01001333","Total",563,211,54,157,218,92,163,42,121
"2011","Ealing 038B","E01001335","Total",524,142,15,127,187,74,155,38,117
"2011","Ealing 038C","E01001336","Total",519,167,36,131,182,70,164,48,116
"2011","Ealing 038D","E01001369","Total",525,136,45,91,235,124,140,49,91
"2011","Ealing 039A","E01001300","Total",608,90,8,82,235,113,86,25,61
"2011","Ealing 039B","E01001301","Total",707,171,10,161,152,105,147,20,127
"2011","Ealing 039C","E01001302","Total",614,131,20,111,208,113,107,17,90
"2011","Ealing 039D","E01001304","Total",705,153,17,136,181,103,122,12,110
"2011","Ealing 040A","E01001374","Total",805,164,28,136,207,108,168,30,138
"2011","Ealing 040B","E01001376","Total",743,194,27,167,164,87,151,23,128
"2011","Ealing 040C","E01001380","Total",762,165,11,154,185,107,142,17,125
"2011","Ealing 040D","E01032572","Total",758,135,20,115,160,81,109,22,87
"2011","Enfield 001A","E01001444","Total",638,216,58,158,243,90,142,37,105
"2011","Enfield 001B","E01001446","Total",714,241,71,170,275,119,180,46,134
"2011","Enfield 001C","E01001546","Total",640,196,77,119,277,112,158,55,103
"2011","Enfield 001D","E01001552","Total",659,198,41,157,225,80,170,35,135
"2011","Enfield 002A","E01001442","Total",617,279,133,146,315,157,181,64,117
"2011","Enfield 002B","E01001545","Total",665,267,111,156,319,129,218,69,149
"2011","Enfield 002C","E01001547","Total",659,242,65,177,245,101,178,47,131
"2011","Enfield 002D","E01001548","Total",676,236,91,145,285,131,173,46,127
"2011","Enfield 002E","E01001551","Total",661,281,83,198,245,90,228,57,171
"2011","Enfield 003B","E01001445","Total",980,303,131,172,396,216,181,67,114
"2011","Enfield 003C","E01001447","Total",783,315,90,225,282,127,229,46,183
"2011","Enfield 003D","E01001448","Total",655,221,88,133,271,118,186,60,126
"2011","Enfield 003E","E01001449","Total",575,202,85,117,243,99,135,34,101
"2011","Enfield 003F","E01033148","Total",661,211,112,99,355,156,151,67,84
"2011","Enfield 003G","E01033150","Total",702,194,116,78,337,211,123,59,64
"2011","Enfield 004A","E01001408","Total",731,182,30,152,217,108,127,22,105
"2011","Enfield 004B","E01001411","Total",759,193,47,146,286,139,159,42,117
"2011","Enfield 004C","E01001412","Total",677,210,39,171,230,79,173,39,134
"2011","Enfield 004D","E01001413","Total",612,170,12,158,206,67,146,22,124
"2011","Enfield 004E","E01001414","Total",687,320,71,249,237,105,222,37,185
"2011","Enfield 005A","E01001407","Total",613,181,41,140,244,99,130,36,94
"2011","Enfield 005B","E01001409","Total",806,282,89,193,291,137,182,50,132
"2011","Enfield 005C","E01001410","Total",755,288,100,188,288,133,203,53,150
"2011","Enfield 005D","E01001516","Total",648,214,67,147,268,114,179,54,125
"2011","Enfield 005E","E01001537","Total",709,194,43,151,271,141,130,25,105
"2011","Enfield 006A","E01001439","Total",790,325,155,170,380,193,213,74,139
"2011","Enfield 006B","E01001441","Total",637,237,81,156,238,117,159,41,118
"2011","Enfield 006C","E01001517","Total",696,308,119,189,305,134,228,68,160
"2011","Enfield 006D","E01001549","Total",798,348,150,198,379,211,208,67,141
"2011","Enfield 006E","E01001550","Total",570,179,78,101,293,107,153,66,87
"2011","Enfield 007A","E01001433","Total",584,187,94,93,299,117,148,56,92
"2011","Enfield 007B","E01001434","Total",551,168,49,119,235,104,128,31,97
"2011","Enfield 007C","E01001435","Total",489,151,48,103,209,77,105,26,79
"2011","Enfield 007D","E01001436","Total",653,209,72,137,279,108,168,51,117
"2011","Enfield 007E","E01001438","Total",566,181,78,103,267,103,150,59,91
"2011","Enfield 008A","E01001469","Total",633,176,30,146,214,83,151,42,109
"2011","Enfield 008B","E01001536","Total",742,217,28,189,197,91,150,21,129
"2011","Enfield 008C","E01001540","Total",794,202,47,155,215,106,163,19,144
"2011","Enfield 008D","E01001541","Total",650,150,12,138,219,110,139,27,112
"2011","Enfield 008E","E01001542","Total",678,259,39,220,233,108,190,38,152
"2011","Enfield 009A","E01001538","Total",603,149,15,134,231,63,121,28,93
"2011","Enfield 009B","E01001539","Total",657,182,21,161,240,83,155,36,119
"2011","Enfield 009C","E01001543","Total",596,176,23,153,227,77,123,25,98
"2011","Enfield 009D","E01001544","Total",610,207,10,197,188,57,141,22,119
"2011","Enfield 010A","E01001457","Total",798,242,20,222,158,83,142,15,127
"2011","Enfield 010B","E01001468","Total",524,171,8,163,142,60,101,20,81
"2011","Enfield 010C","E01001471","Total",930,308,18,290,156,81,209,30,179
"2011","Enfield 010D","E01001472","Total",771,239,23,216,189,89,179,27,152
"2011","Enfield 010E","E01001474","Total",840,228,11,217,173,61,171,16,155
"2011","Enfield 011A","E01001415","Total",677,286,22,264,147,56,208,13,195
"2011","Enfield 011B","E01001417","Total",601,186,9,177,198,75,118,21,97
"2011","Enfield 011C","E01001418","Total",703,267,27,240,186,66,216,24,192
"2011","Enfield 011D","E01001422","Total",559,125,10,115,231,60,86,23,63
"2011","Enfield 012A","E01001440","Total",597,239,57,182,231,94,173,41,132
"2011","Enfield 012B","E01001504","Total",513,165,54,111,213,93,137,41,96
"2011","Enfield 012C","E01001505","Total",567,180,60,120,251,99,158,50,108
"2011","Enfield 012D","E01001507","Total",766,275,82,193,271,150,210,48,162
"2011","Enfield 012E","E01001508","Total",718,230,88,142,303,153,167,53,114
"2011","Enfield 012F","E01001513","Total",623,224,88,136,300,117,190,71,119
"2011","Enfield 013A","E01001416","Total",598,159,10,149,212,60,130,27,103
"2011","Enfield 013B","E01001470","Total",641,230,17,213,209,63,159,21,138
"2011","Enfield 013C","E01001473","Total",547,192,36,156,209,73,151,39,112
"2011","Enfield 013D","E01001475","Total",635,208,16,192,204,64,148,23,125
"2011","Enfield 014A","E01001437","Total",990,408,147,261,420,210,272,75,197
"2011","Enfield 014B","E01001506","Total",565,200,86,114,286,130,127,49,78
"2011","Enfield 014C","E01001509","Total",688,236,86,150,279,169,172,53,119
"2011","Enfield 014D","E01001510","Total",610,264,123,141,312,171,154,49,105
"2011","Enfield 015A","E01001405","Total",862,342,21,321,145,75,207,19,188
"2011","Enfield 015B","E01001406","Total",675,196,46,150,226,96,151,35,116
"2011","Enfield 015C","E01001450","Total",924,321,59,262,223,124,231,31,200
"2011","Enfield 015D","E01001512","Total",782,220,52,168,259,142,177,37,140
"2011","Enfield 015E","E01001515","Total",755,281,122,159,340,162,178,54,124
"2011","Enfield 016A","E01001401","Total",501,135,16,119,178,70,117,28,89
"2011","Enfield 016B","E01001478","Total",544,181,50,131,226,78,147,47,100
"2011","Enfield 016C","E01001484","Total",516,180,45,135,197,83,136,36,100
"2011","Enfield 016D","E01001511","Total",648,176,47,129,286,126,150,48,102
"2011","Enfield 016E","E01001514","Total",685,165,49,116,261,125,155,32,123
"2011","Enfield 016F","E01001518","Total",684,158,38,120,245,105,134,34,100
"2011","Enfield 017A","E01001451","Total",661,205,21,184,193,74,147,24,123
"2011","Enfield 017B","E01001452","Total",488,136,15,121,173,52,92,15,77
"2011","Enfield 017C","E01001453","Total",661,230,16,214,197,73,140,19,121
"2011","Enfield 017D","E01001454","Total",660,224,18,206,210,77,149,16,133
"2011","Enfield 018A","E01001476","Total",593,213,62,151,237,99,168,39,129
"2011","Enfield 018B","E01001477","Total",607,214,76,138,278,105,186,64,122
"2011","Enfield 018C","E01001481","Total",556,171,42,129,216,87,144,41,103
"2011","Enfield 018D","E01001502","Total",599,207,64,143,257,103,165,50,115
"2011","Enfield 018E","E01001503","Total",654,227,71,156,279,105,181,64,117
"2011","Enfield 019A","E01001520","Total",673,202,40,162,210,100,150,30,120
"2011","Enfield 019B","E01001522","Total",751,166,52,114,288,111,140,35,105
"2011","Enfield 019C","E01001523","Total",738,256,28,228,207,91,173,22,151
"2011","Enfield 019D","E01001524","Total",546,165,45,120,221,75,137,45,92
"2011","Enfield 019E","E01001526","Total",639,205,16,189,197,68,148,29,119
"2011","Enfield 020A","E01001419","Total",794,267,31,236,193,81,193,34,159
"2011","Enfield 020B","E01001420","Total",569,190,46,144,191,77,155,33,122
"2011","Enfield 020C","E01001421","Total",714,253,51,202,220,80,228,48,180
"2011","Enfield 020D","E01001519","Total",1141,289,69,220,286,154,182,35,147
"2011","Enfield 020E","E01001525","Total",723,200,31,169,213,87,155,23,132
"2011","Enfield 021A","E01001398","Total",491,114,15,99,179,71,92,21,71
"2011","Enfield 021B","E01001399","Total",499,119,11,108,181,48,123,22,101
"2011","Enfield 021C","E01001400","Total",587,211,17,194,160,54,158,16,142
"2011","Enfield 021D","E01001402","Total",691,180,12,168,204,83,138,27,111
"2011","Enfield 021E","E01001403","Total",633,230,23,207,190,67,201,36,165
"2011","Enfield 021F","E01001455","Total",581,154,13,141,163,51,138,17,121
"2011","Enfield 022A","E01001456","Total",481,111,10,101,197,72,87,16,71
"2011","Enfield 022B","E01001564","Total",646,118,12,106,218,94,115,20,95
"2011","Enfield 022C","E01001567","Total",632,185,7,178,188,72,143,25,118
"2011","Enfield 022D","E01001568","Total",538,147,13,134,170,48,119,21,98
"2011","Enfield 022E","E01001569","Total",778,187,15,172,188,93,156,27,129
"2011","Enfield 023A","E01001479","Total",639,208,61,147,245,105,164,36,128
"2011","Enfield 023B","E01001482","Total",690,251,76,175,285,126,178,49,129
"2011","Enfield 023C","E01001487","Total",723,276,93,183,304,159,210,55,155
"2011","Enfield 023D","E01001489","Total",664,216,77,139,272,134,154,46,108
"2011","Enfield 023E","E01001491","Total",722,224,91,133,305,140,164,47,117
"2011","Enfield 024A","E01001459","Total",556,159,48,111,228,86,146,37,109
"2011","Enfield 024B","E01001460","Total",660,235,82,153,279,142,136,44,92
"2011","Enfield 024C","E01001462","Total",531,200,72,128,214,109,125,33,92
"2011","Enfield 024D","E01001480","Total",588,168,37,131,200,85,162,35,127
"2011","Enfield 024E","E01001488","Total",663,216,84,132,300,121,161,49,112
"2011","Enfield 025A","E01001483","Total",609,238,58,180,172,97,149,21,128
"2011","Enfield 025B","E01001485","Total",682,251,76,175,281,129,182,49,133
"2011","Enfield 025C","E01001486","Total",818,348,129,219,367,174,233,75,158
"2011","Enfield 025E","E01001492","Total",680,233,83,150,288,124,190,59,131
"2011","Enfield 025F","E01033146","Total",593,201,97,104,301,131,164,62,102
"2011","Enfield 025G","E01033151","Total",541,235,96,139,261,118,172,52,120
"2011","Enfield 026A","E01001404","Total",525,153,26,127,203,64,131,27,104
"2011","Enfield 026B","E01001493","Total",735,290,44,246,221,108,216,41,175
"2011","Enfield 026C","E01001494","Total",510,144,15,129,191,61,126,23,103
"2011","Enfield 026D","E01001496","Total",602,169,27,142,218,85,143,40,103
"2011","Enfield 026E","E01001570","Total",751,214,40,174,249,102,170,34,136
"2011","Enfield 027A","E01001423","Total",643,247,72,175,265,109,190,54,136
"2011","Enfield 027B","E01001425","Total",737,320,130,190,337,160,188,64,124
"2011","Enfield 027C","E01001428","Total",611,275,93,182,261,104,190,57,133
"2011","Enfield 027D","E01001461","Total",707,298,101,197,264,137,196,53,143
"2011","Enfield 027E","E01001464","Total",422,150,40,110,187,65,143,48,95
"2011","Enfield 028A","E01001521","Total",698,186,16,170,228,90,161,28,133
"2011","Enfield 028B","E01001531","Total",544,119,14,105,188,66,119,29,90
"2011","Enfield 028C","E01001532","Total",687,153,16,137,220,83,116,20,96
"2011","Enfield 028D","E01001533","Total",530,145,9,136,167,49,120,18,102
"2011","Enfield 028E","E01001535","Total",505,132,12,120,172,66,122,24,98
"2011","Enfield 029A","E01001495","Total",731,147,16,131,199,89,137,17,120
"2011","Enfield 029B","E01001498","Total",746,161,24,137,234,102,144,37,107
"2011","Enfield 029C","E01001563","Total",669,160,24,136,200,101,126,31,95
"2011","Enfield 029D","E01001565","Total",709,215,23,192,197,79,159,21,138
"2011","Enfield 029E","E01001566","Total",626,102,10,92,199,82,115,30,85
"2011","Enfield 030A","E01001424","Total",496,189,81,108,213,113,129,44,85
"2011","Enfield 030B","E01001426","Total",628,218,80,138,277,119,159,55,104
"2011","Enfield 030C","E01001427","Total",683,271,108,163,313,138,202,67,135
"2011","Enfield 030D","E01001429","Total",1134,545,117,428,376,192,340,63,277
"2011","Enfield 030E","E01001430","Total",653,277,139,138,340,154,184,68,116
"2011","Enfield 031A","E01001463","Total",513,154,43,111,212,79,149,38,111
"2011","Enfield 031B","E01001465","Total",506,161,45,116,213,66,146,46,100
"2011","Enfield 031C","E01001466","Total",620,187,92,95,304,146,147,59,88
"2011","Enfield 031D","E01001467","Total",634,181,95,86,308,142,127,48,79
"2011","Enfield 031E","E01001497","Total",531,177,44,133,212,79,136,42,94
"2011","Enfield 031F","E01001499","Total",564,179,27,152,181,61,166,44,122
"2011","Enfield 032A","E01001392","Total",665,160,22,138,197,89,133,26,107
"2011","Enfield 032B","E01001528","Total",553,205,69,136,203,88,154,45,109
"2011","Enfield 032C","E01001529","Total",635,221,58,163,193,80,176,34,142
"2011","Enfield 032D","E01001530","Total",467,127,18,109,143,64,116,22,94
"2011","Enfield 032E","E01001534","Total",588,151,19,132,174,74,132,31,101
"2011","Enfield 033A","E01001431","Total",614,221,96,125,264,134,144,57,87
"2011","Enfield 033B","E01001432","Total",700,244,103,141,304,143,189,67,122
"2011","Enfield 033C","E01001555","Total",624,207,61,146,259,114,140,42,98
"2011","Enfield 033D","E01001557","Total",546,166,66,100,255,110,131,45,86
"2011","Enfield 033E","E01001558","Total",558,199,100,99,296,134,127,46,81
"2011","Enfield 033F","E01001559","Total",743,248,102,146,322,131,167,55,112
"2011","Enfield 035A","E01001394","Total",640,194,33,161,183,84,156,28,128
"2011","Enfield 035B","E01001395","Total",620,206,73,133,272,112,194,73,121
"2011","Enfield 035C","E01001397","Total",783,203,53,150,251,114,188,48,140
"2011","Enfield 035D","E01001500","Total",554,144,29,115,208,92,124,28,96
"2011","Enfield 035E","E01001556","Total",543,153,35,118,197,74,138,37,101
"2011","Enfield 035F","E01001560","Total",516,163,59,104,214,76,136,44,92
"2011","Enfield 036A","E01001390","Total",762,132,17,115,209,83,140,27,113
"2011","Enfield 036B","E01001391","Total",687,167,24,143,167,92,149,27,122
"2011","Enfield 036C","E01001393","Total",839,173,28,145,222,117,162,29,133
"2011","Enfield 036D","E01001396","Total",511,163,30,133,147,57,133,28,105
"2011","Enfield 036E","E01001501","Total",818,229,44,185,224,124,190,31,159
"2011","Enfield 036F","E01001527","Total",645,186,14,172,175,79,158,33,125
"2011","Enfield 037A","E01001458","Total",664,269,110,159,277,119,201,53,148
"2011","Enfield 037B","E01001553","Total",530,195,87,108,271,114,143,51,92
"2011","Enfield 037C","E01001554","Total",756,317,114,203,315,152,234,70,164
"2011","Enfield 037D","E01001562","Total",711,256,96,160,278,131,165,57,108
"2011","Enfield 037E","E01032574","Total",695,244,101,143,323,168,164,55,109
"2011","Greenwich 001A","E01001690","Total",845,291,73,218,275,142,218,39,179
"2011","Greenwich 001B","E01001692","Total",522,175,70,105,232,102,114,38,76
"2011","Greenwich 001C","E01001693","Total",610,210,75,135,262,146,142,49,93
"2011","Greenwich 001D","E01001694","Total",598,158,50,108,247,114,132,36,96
"2011","Greenwich 002A","E01001687","Total",511,168,38,130,179,89,135,26,109
"2011","Greenwich 002B","E01001688","Total",937,255,118,137,480,282,150,54,96
"2011","Greenwich 002E","E01033739","Total",571,117,57,60,253,160,84,35,49
"2011","Greenwich 002F","E01033740","Total",550,103,61,42,279,161,72,46,26
"2011","Greenwich 002G","E01033741","Total",559,110,61,49,301,182,80,43,37
"2011","Greenwich 002H","E01033743","Total",663,165,85,80,396,224,130,59,71
"2011","Greenwich 002I","E01033745","Total",591,131,80,51,331,154,93,47,46
"2011","Greenwich 003A","E01001575","Total",599,230,83,147,266,120,185,73,112
"2011","Greenwich 003B","E01001576","Total",658,282,100,182,291,142,182,57,125
"2011","Greenwich 003C","E01001577","Total",737,300,88,212,296,152,232,53,179
"2011","Greenwich 003D","E01001578","Total",809,247,77,170,327,166,182,57,125
"2011","Greenwich 003E","E01001579","Total",637,229,67,162,261,127,176,41,135
"2011","Greenwich 004B","E01001709","Total",494,186,46,140,147,64,156,35,121
"2011","Greenwich 004C","E01001711","Total",612,135,39,96,182,95,113,28,85
"2011","Greenwich 004D","E01001712","Total",935,354,110,244,348,201,248,60,188
"2011","Greenwich 004E","E01033731","Total",559,47,13,34,102,54,50,13,37
"2011","Greenwich 004F","E01033734","Total",579,71,41,30,147,72,67,33,34
"2011","Greenwich 004G","E01033735","Total",555,163,25,138,121,88,103,13,90
"2011","Greenwich 004H","E01033736","Total",608,45,9,36,86,61,46,10,36
"2011","Greenwich 004I","E01033737","Total",602,198,64,134,238,128,147,41,106
"2011","Greenwich 005A","E01001705","Total",760,305,128,177,343,189,197,70,127
"2011","Greenwich 005B","E01001706","Total",479,161,64,97,195,79,145,48,97
"2011","Greenwich 005C","E01001708","Total",640,176,43,133,210,99,170,40,130
"2011","Greenwich 005D","E01001710","Total",685,317,106,211,286,156,216,57,159
"2011","Greenwich 005E","E01001713","Total",636,248,109,139,301,156,161,59,102
"2011","Greenwich 006A","E01001672","Total",630,147,54,93,291,152,128,41,87
"2011","Greenwich 006B","E01001673","Total",685,290,51,239,210,96,247,46,201
"2011","Greenwich 006C","E01001674","Total",671,203,46,157,268,121,167,43,124
"2011","Greenwich 006D","E01001675","Total",629,170,49,121,264,117,145,55,90
"2011","Greenwich 006E","E01001677","Total",668,170,52,118,275,125,127,37,90
"2011","Greenwich 007B","E01001631","Total",793,285,94,191,325,166,216,51,165
"2011","Greenwich 007C","E01001632","Total",635,142,41,101,284,131,132,36,96
"2011","Greenwich 007D","E01001635","Total",618,140,39,101,216,99,125,38,87
"2011","Greenwich 007E","E01001636","Total",593,167,30,137,183,101,170,39,131
"2011","Greenwich 007F","E01033742","Total",581,90,31,59,173,120,63,17,46
"2011","Greenwich 007G","E01033744","Total",646,174,72,102,272,148,135,46,89
"2011","Greenwich 008A","E01001571","Total",615,148,40,108,251,105,153,47,106
"2011","Greenwich 008B","E01001572","Total",628,152,33,119,247,116,150,38,112
"2011","Greenwich 008C","E01001573","Total",513,130,30,100,221,94,117,27,90
"2011","Greenwich 008D","E01001574","Total",768,331,113,218,303,166,254,68,186
"2011","Greenwich 009A","E01001629","Total",852,266,83,183,334,157,239,75,164
"2011","Greenwich 009B","E01001633","Total",652,213,64,149,237,122,200,47,153
"2011","Greenwich 009C","E01001634","Total",667,250,82,168,269,138,210,54,156
"2011","Greenwich 009D","E01001637","Total",706,238,49,189,211,98,179,34,145
"2011","Greenwich 011A","E01001695","Total",654,276,47,229,212,103,226,43,183
"2011","Greenwich 011B","E01001696","Total",506,190,59,131,212,103,165,44,121
"2011","Greenwich 011C","E01001697","Total",770,233,80,153,325,176,160,43,117
"2011","Greenwich 011D","E01001700","Total",703,182,68,114,282,158,142,40,102
"2011","Greenwich 011E","E01001703","Total",753,285,105,180,335,181,181,47,134
"2011","Greenwich 011F","E01001704","Total",615,154,39,115,233,106,143,40,103
"2011","Greenwich 012A","E01001588","Total",659,265,37,228,199,102,242,38,204
"2011","Greenwich 012B","E01001589","Total",616,196,38,158,189,97,151,36,115
"2011","Greenwich 012C","E01001591","Total",839,331,84,247,293,135,258,53,205
"2011","Greenwich 012D","E01001595","Total",693,244,89,155,320,139,181,67,114
"2011","Greenwich 014A","E01001590","Total",701,171,38,133,228,116,145,30,115
"2011","Greenwich 014B","E01001592","Total",740,142,24,118,225,136,125,28,97
"2011","Greenwich 014C","E01001593","Total",728,178,18,160,197,128,155,24,131
"2011","Greenwich 014D","E01001594","Total",763,269,107,162,313,136,202,66,136
"2011","Greenwich 015A","E01001698","Total",682,231,80,151,281,143,181,50,131
"2011","Greenwich 015B","E01001699","Total",602,176,57,119,247,138,134,39,95
"2011","Greenwich 015C","E01001701","Total",598,173,40,133,250,156,145,44,101
"2011","Greenwich 015D","E01001702","Total",475,151,72,79,274,114,129,60,69
"2011","Greenwich 016A","E01001581","Total",838,289,21,268,157,77,221,23,198
"2011","Greenwich 016B","E01001585","Total",628,150,15,135,202,95,124,17,107
"2011","Greenwich 016C","E01001586","Total",683,241,35,206,164,75,177,28,149
"2011","Greenwich 016D","E01001587","Total",921,219,19,200,213,96,175,24,151
"2011","Greenwich 017A","E01001678","Total",628,192,17,175,221,80,164,27,137
"2011","Greenwich 017B","E01001683","Total",565,156,31,125,200,85,167,37,130
"2011","Greenwich 017C","E01001684","Total",561,185,48,137,202,76,166,40,126
"2011","Greenwich 017D","E01001685","Total",610,192,30,162,189,78,162,34,128
"2011","Greenwich 019A","E01001646","Total",1179,316,94,222,399,191,218,88,130
"2011","Greenwich 019B","E01001650","Total",615,202,49,153,215,93,187,38,149
"2011","Greenwich 019C","E01001651","Total",761,310,59,251,227,114,239,39,200
"2011","Greenwich 019D","E01001652","Total",681,219,20,199,160,69,187,22,165
"2011","Greenwich 020A","E01001679","Total",520,101,18,83,190,82,103,32,71
"2011","Greenwich 020B","E01001680","Total",618,163,7,156,192,78,131,22,109
"2011","Greenwich 020C","E01001681","Total",488,134,26,108,161,61,125,27,98
"2011","Greenwich 020D","E01001682","Total",565,166,27,139,164,68,117,28,89
"2011","Greenwich 020E","E01001686","Total",767,255,67,188,251,129,176,26,150
"2011","Greenwich 021A","E01001580","Total",833,152,17,135,150,87,120,16,104
"2011","Greenwich 021B","E01001582","Total",641,226,33,193,187,99,164,28,136
"2011","Greenwich 021C","E01001583","Total",818,189,22,167,145,62,108,10,98
"2011","Greenwich 021D","E01001584","Total",713,169,9,160,152,77,128,14,114
"2011","Greenwich 022A","E01001645","Total",714,250,43,207,236,83,221,45,176
"2011","Greenwich 022B","E01001647","Total",573,191,23,168,179,67,158,31,127
"2011","Greenwich 022C","E01001648","Total",729,195,34,161,207,108,151,36,115
"2011","Greenwich 022D","E01001649","Total",569,176,44,132,209,77,171,47,124
"2011","Greenwich 023A","E01001605","Total",571,149,6,143,198,54,135,30,105
"2011","Greenwich 023B","E01001606","Total",618,127,17,110,235,87,136,38,98
"2011","Greenwich 023C","E01001610","Total",707,227,28,199,212,76,185,34,151
"2011","Greenwich 023D","E01001611","Total",741,273,19,254,198,80,218,30,188
"2011","Greenwich 025A","E01001620","Total",505,159,36,123,219,80,148,44,104
"2011","Greenwich 025B","E01001621","Total",611,204,38,166,194,77,166,35,131
"2011","Greenwich 025C","E01001623","Total",664,171,45,126,229,112,170,47,123
"2011","Greenwich 025D","E01001624","Total",631,208,27,181,208,82,184,42,142
"2011","Greenwich 025E","E01001625","Total",587,216,44,172,206,78,219,50,169
"2011","Greenwich 027A","E01001604","Total",568,135,11,124,189,80,121,34,87
"2011","Greenwich 027B","E01001607","Total",604,196,26,170,191,80,184,34,150
"2011","Greenwich 027C","E01001608","Total",592,193,5,188,167,51,163,20,143
"2011","Greenwich 027D","E01001609","Total",738,304,25,279,178,75,253,28,225
"2011","Greenwich 028A","E01001613","Total",775,292,26,266,158,82,221,24,197
"2011","Greenwich 028B","E01001614","Total",530,182,11,171,145,42,139,16,123
"2011","Greenwich 028C","E01001615","Total",756,240,23,217,157,74,196,28,168
"2011","Greenwich 028D","E01001617","Total",738,282,12,270,158,59,191,27,164
"2011","Greenwich 029A","E01001653","Total",610,217,63,154,249,107,193,59,134
"2011","Greenwich 029B","E01001654","Total",603,235,65,170,234,95,196,59,137
"2011","Greenwich 029C","E01001655","Total",637,253,72,181,222,97,202,47,155
"2011","Greenwich 029D","E01001660","Total",586,209,61,148,230,105,178,57,121
"2011","Greenwich 029E","E01001661","Total",588,219,45,174,203,84,189,44,145
"2011","Greenwich 030C","E01001618","Total",648,250,48,202,215,82,202,46,156
"2011","Greenwich 030D","E01001619","Total",818,208,34,174,233,126,145,33,112
"2011","Greenwich 030E","E01033729","Total",802,367,90,277,271,136,269,56,213
"2011","Greenwich 031A","E01001597","Total",607,202,17,185,175,71,147,21,126
"2011","Greenwich 031B","E01001598","Total",606,178,13,165,170,51,164,20,144
"2011","Greenwich 031C","E01001602","Total",718,285,60,225,244,93,233,62,171
"2011","Greenwich 031D","E01001603","Total",768,367,63,304,230,101,270,40,230
"2011","Greenwich 032A","E01001596","Total",597,189,8,181,195,66,154,23,131
"2011","Greenwich 032B","E01001599","Total",615,194,21,173,207,70,157,36,121
"2011","Greenwich 032C","E01001600","Total",663,205,27,178,190,87,149,26,123
"2011","Greenwich 032D","E01001601","Total",601,185,5,180,178,65,137,16,121
"2011","Greenwich 033A","E01001669","Total",689,227,63,164,289,106,175,49,126
"2011","Greenwich 033B","E01001671","Total",675,187,38,149,234,104,148,31,117
"2011","Greenwich 033C","E01001676","Total",646,207,87,120,308,143,171,63,108
"2011","Greenwich 033D","E01032567","Total",589,187,34,153,229,79,147,39,108
"2011","Greenwich 034A","E01001656","Total",582,214,26,188,149,55,157,32,125
"2011","Greenwich 034B","E01001657","Total",686,182,19,163,205,93,137,22,115
"2011","Greenwich 034C","E01001658","Total",723,266,35,231,187,95,180,24,156
"2011","Greenwich 034D","E01001659","Total",529,183,19,164,175,60,156,28,128
"2011","Greenwich 034E","E01033726","Total",818,269,88,181,365,137,240,80,160
"2011","Greenwich 035A","E01001640","Total",881,279,110,169,310,144,175,63,112
"2011","Greenwich 035B","E01033727","Total",802,237,71,166,272,114,148,47,101
"2011","Greenwich 035C","E01033728","Total",641,94,19,75,99,70,48,7,41
"2011","Greenwich 035D","E01033730","Total",653,141,48,93,126,85,89,14,75
"2011","Greenwich 036A","E01001666","Total",557,133,27,106,150,80,118,21,97
"2011","Greenwich 036B","E01001667","Total",707,309,52,257,185,77,243,33,210
"2011","Greenwich 036C","E01001668","Total",1049,341,78,263,294,148,272,63,209
"2011","Greenwich 036D","E01033732","Total",472,72,43,29,137,78,60,30,30
"2011","Greenwich 036E","E01033733","Total",548,54,10,44,111,88,43,9,34
"2011","Greenwich 037A","E01001662","Total",715,115,15,100,163,92,120,20,100
"2011","Greenwich 037B","E01001664","Total",854,221,22,199,168,90,186,17,169
"2011","Greenwich 037C","E01001665","Total",788,146,26,120,211,112,111,24,87
"2011","Greenwich 037D","E01033738","Total",519,118,10,108,111,70,95,13,82
"2011","Greenwich 038A","E01001638","Total",806,232,69,163,275,135,180,49,131
"2011","Greenwich 038B","E01001641","Total",779,203,22,181,172,98,147,24,123
"2011","Greenwich 038C","E01001642","Total",791,163,18,145,212,114,135,25,110
"2011","Greenwich 038D","E01001644","Total",1022,180,45,135,221,130,146,22,124
"2011","Greenwich 038E","E01033746","Total",715,227,22,205,140,88,173,21,152
"2011","Harrow 001A","E01002112","Total",697,191,20,171,220,89,159,30,129
"2011","Harrow 001B","E01002114","Total",986,437,29,408,194,105,327,24,303
"2011","Harrow 001C","E01002225","Total",623,209,9,200,128,38,156,13,143
"2011","Harrow 001D","E01002226","Total",1003,361,23,338,254,108,272,37,235
"2011","Harrow 002A","E01002113","Total",599,197,20,177,194,65,171,26,145
"2011","Harrow 002B","E01002115","Total",509,139,16,123,176,67,121,24,97
"2011","Harrow 002C","E01002116","Total",680,208,15,193,161,69,176,28,148
"2011","Harrow 002D","E01002117","Total",675,159,39,120,276,95,151,50,101
"2011","Harrow 002E","E01002118","Total",675,207,30,177,205,112,159,30,129
"2011","Harrow 003A","E01002227","Total",611,245,66,179,239,78,235,53,182
"2011","Harrow 003B","E01002228","Total",710,158,36,122,283,117,163,33,130
"2011","Harrow 003C","E01002229","Total",770,298,35,263,186,76,231,28,203
"2011","Harrow 003D","E01002230","Total",637,179,18,161,206,66,156,42,114
"2011","Harrow 004A","E01002144","Total",580,179,8,171,171,54,142,22,120
"2011","Harrow 004B","E01002146","Total",519,133,4,129,195,61,123,34,89
"2011","Harrow 004C","E01002147","Total",502,151,6,145,124,36,123,27,96
"2011","Harrow 004D","E01002149","Total",479,120,7,113,169,57,97,20,77
"2011","Harrow 005A","E01002140","Total",607,183,34,149,230,85,167,45,122
"2011","Harrow 005B","E01002141","Total",680,238,27,211,207,76,208,33,175
"2011","Harrow 005C","E01002142","Total",635,159,22,137,214,90,147,36,111
"2011","Harrow 005D","E01002143","Total",529,126,43,83,236,99,128,46,82
"2011","Harrow 005E","E01002145","Total",631,253,23,230,170,70,179,27,152
"2011","Harrow 006A","E01002139","Total",498,191,62,129,205,74,161,51,110
"2011","Harrow 006B","E01002148","Total",491,131,15,116,204,55,108,35,73
"2011","Harrow 006C","E01002150","Total",839,272,23,249,239,113,213,41,172
"2011","Harrow 006D","E01002151","Total",524,197,49,148,206,86,193,49,144
"2011","Harrow 006E","E01002152","Total",638,192,12,180,201,87,158,27,131
"2011","Harrow 007A","E01002119","Total",568,141,38,103,226,105,132,42,90
"2011","Harrow 007B","E01002120","Total",488,192,38,154,159,77,166,33,133
"2011","Harrow 007C","E01002121","Total",546,134,27,107,212,89,117,40,77
"2011","Harrow 007D","E01002122","Total",582,154,26,128,207,92,128,30,98
"2011","Harrow 007E","E01002123","Total",527,134,29,105,200,94,110,31,79
"2011","Harrow 008A","E01002106","Total",651,137,20,117,232,78,143,40,103
"2011","Harrow 008B","E01002108","Total",559,117,15,102,261,95,113,42,71
"2011","Harrow 008C","E01002109","Total",654,151,13,138,220,78,143,31,112
"2011","Harrow 008D","E01002110","Total",542,117,18,99,252,88,115,41,74
"2011","Harrow 008E","E01002111","Total",681,166,26,140,303,111,149,46,103
"2011","Harrow 009A","E01002185","Total",585,206,62,144,244,82,202,69,133
"2011","Harrow 009B","E01002186","Total",794,283,29,254,193,89,204,22,182
"2011","Harrow 009C","E01002187","Total",761,269,23,246,207,77,214,34,180
"2011","Harrow 009D","E01002190","Total",625,190,3,187,184,52,143,18,125
"2011","Harrow 010A","E01002124","Total",492,117,36,81,248,103,107,38,69
"2011","Harrow 010B","E01002125","Total",512,109,25,84,202,82,102,34,68
"2011","Harrow 010C","E01002198","Total",499,80,21,59,235,88,108,33,75
"2011","Harrow 010D","E01002200","Total",505,123,26,97,207,89,141,49,92
"2011","Harrow 010E","E01002203","Total",524,95,20,75,254,101,127,48,79
"2011","Harrow 011A","E01002232","Total",709,197,30,167,260,121,185,42,143
"2011","Harrow 011B","E01002233","Total",754,232,60,172,302,152,196,52,144
"2011","Harrow 011C","E01002234","Total",548,126,34,92,237,103,134,43,91
"2011","Harrow 011D","E01002235","Total",610,216,44,172,261,109,187,53,134
"2011","Harrow 011E","E01002236","Total",582,116,41,75,230,107,139,50,89
"2011","Harrow 012A","E01002107","Total",575,118,22,96,271,103,97,30,67
"2011","Harrow 012B","E01002197","Total",420,109,9,100,170,55,107,32,75
"2011","Harrow 012C","E01002199","Total",467,103,22,81,195,65,115,35,80
"2011","Harrow 012D","E01002201","Total",508,103,11,92,206,68,134,45,89
"2011","Harrow 012E","E01002202","Total",712,203,67,136,313,164,156,41,115
"2011","Harrow 013A","E01002179","Total",795,224,82,142,312,161,191,60,131
"2011","Harrow 013B","E01002180","Total",783,245,84,161,296,140,206,53,153
"2011","Harrow 013C","E01002183","Total",682,158,30,128,249,100,171,41,130
"2011","Harrow 013D","E01002184","Total",677,174,36,138,266,123,152,34,118
"2011","Harrow 013E","E01002231","Total",679,197,55,142,294,132,165,48,117
"2011","Harrow 015A","E01002154","Total",728,195,32,163,267,101,170,38,132
"2011","Harrow 015B","E01002156","Total",501,113,8,105,180,62,127,30,97
"2011","Harrow 015C","E01002162","Total",687,177,38,139,284,123,158,44,114
"2011","Harrow 015D","E01002163","Total",537,141,21,120,209,58,123,35,88
"2011","Harrow 016A","E01002188","Total",638,193,6,187,189,55,136,20,116
"2011","Harrow 016B","E01002189","Total",714,209,15,194,189,76,160,21,139
"2011","Harrow 016C","E01002192","Total",638,222,13,209,182,84,153,19,134
"2011","Harrow 016D","E01002193","Total",740,208,32,176,267,108,166,29,137
"2011","Harrow 017A","E01002165","Total",528,126,22,104,207,83,121,36,85
"2011","Harrow 017B","E01002166","Total",484,114,21,93,190,75,139,45,94
"2011","Harrow 017C","E01002167","Total",477,116,21,95,204,72,157,52,105
"2011","Harrow 017D","E01002168","Total",511,161,39,122,224,68,172,44,128
"2011","Harrow 017E","E01002169","Total",531,163,36,127,185,57,154,46,108
"2011","Harrow 019A","E01002153","Total",616,176,5,171,226,76,146,27,119
"2011","Harrow 019B","E01002155","Total",641,185,10,175,208,76,139,23,116
"2011","Harrow 019C","E01002157","Total",593,135,12,123,191,65,129,29,100
"2011","Harrow 019D","E01002158","Total",491,112,6,106,187,63,116,31,85
"2011","Harrow 020A","E01002128","Total",784,130,25,105,219,120,142,40,102
"2011","Harrow 020B","E01002130","Total",884,176,62,114,294,170,150,44,106
"2011","Harrow 020C","E01002181","Total",682,127,17,110,231,103,117,21,96
"2011","Harrow 020D","E01002182","Total",689,138,23,115,252,131,135,35,100
"2011","Harrow 021A","E01002159","Total",685,178,24,154,221,83,156,37,119
"2011","Harrow 021B","E01002160","Total",704,116,28,88,268,125,145,51,94
"2011","Harrow 021C","E01002161","Total",728,175,36,139,267,105,179,46,133
"2011","Harrow 021D","E01002164","Total",683,140,29,111,224,111,119,30,89
"2011","Harrow 022A","E01002191","Total",667,147,17,130,312,107,131,42,89
"2011","Harrow 022B","E01002194","Total",657,184,13,171,230,81,134,27,107
"2011","Harrow 022C","E01002195","Total",610,185,17,168,232,88,134,33,101
"2011","Harrow 022D","E01002196","Total",616,141,6,135,233,76,121,21,100
"2011","Harrow 023A","E01002126","Total",1203,306,29,277,329,211,241,37,204
"2011","Harrow 023B","E01002127","Total",628,146,22,124,177,72,125,26,99
"2011","Harrow 023C","E01002129","Total",889,204,33,171,219,124,168,23,145
"2011","Harrow 023D","E01002131","Total",586,193,34,159,217,86,181,42,139
"2011","Harrow 024A","E01002237","Total",648,140,33,107,211,93,140,46,94
"2011","Harrow 024B","E01002238","Total",596,133,29,104,261,114,131,48,83
"2011","Harrow 024C","E01002240","Total",655,187,33,154,217,91,186,41,145
"2011","Harrow 024D","E01002242","Total",613,133,15,118,242,83,135,36,99
"2011","Harrow 025A","E01002208","Total",483,156,5,151,175,58,124,24,100
"2011","Harrow 025B","E01002209","Total",546,126,17,109,198,80,132,30,102
"2011","Harrow 025C","E01002239","Total",635,189,16,173,210,88,146,33,113
"2011","Harrow 025D","E01002241","Total",536,138,31,107,221,79,147,52,95
"2011","Harrow 027A","E01002133","Total",896,344,63,281,284,106,284,47,237
"2011","Harrow 027B","E01002136","Total",638,171,29,142,232,106,133,27,106
"2011","Harrow 027C","E01002138","Total",509,103,26,77,231,95,116,47,69
"2011","Harrow 027D","E01002213","Total",1116,284,83,201,439,215,239,60,179
"2011","Harrow 028A","E01002211","Total",477,117,40,77,232,88,132,50,82
"2011","Harrow 028B","E01002212","Total",647,188,39,149,264,121,157,37,120
"2011","Harrow 028C","E01002216","Total",513,107,24,83,250,101,126,46,80
"2011","Harrow 028D","E01002217","Total",552,181,61,120,251,82,180,57,123
"2011","Harrow 029A","E01002132","Total",828,135,19,116,242,141,125,26,99
"2011","Harrow 029B","E01002134","Total",603,136,19,117,178,92,93,17,76
"2011","Harrow 029C","E01002135","Total",657,186,31,155,218,100,147,39,108
"2011","Harrow 029D","E01002137","Total",468,67,2,65,103,57,54,5,49
"2011","Harrow 030A","E01002218","Total",606,174,22,152,212,99,138,36,102
"2011","Harrow 030B","E01002219","Total",605,171,22,149,249,105,161,44,117
"2011","Harrow 030C","E01002221","Total",511,123,21,102,197,78,126,40,86
"2011","Harrow 030D","E01002222","Total",488,102,21,81,222,73,109,34,75
"2011","Harrow 031A","E01002214","Total",612,167,45,122,289,126,152,44,108
"2011","Harrow 031B","E01002215","Total",595,244,53,191,222,70,211,46,165
"2011","Harrow 031C","E01002220","Total",493,94,24,70,221,71,110,33,77
"2011","Harrow 031D","E01002223","Total",591,115,21,94,276,97,113,39,74
"2011","Harrow 031E","E01002224","Total",497,134,47,87,224,96,134,44,90
"2011","Harrow 032A","E01002204","Total",634,154,23,131,247,112,129,32,97
"2011","Harrow 032B","E01002206","Total",457,116,21,95,191,72,115,31,84
"2011","Harrow 032C","E01002207","Total",524,114,16,98,249,89,125,48,77
"2011","Harrow 032D","E01002210","Total",504,109,15,94,201,87,122,41,81
"2011","Harrow 032E","E01032576","Total",520,113,10,103,224,76,133,45,88
"2011","Harrow 033A","E01002170","Total",408,113,25,88,157,53,108,39,69
"2011","Harrow 033B","E01002171","Total",534,124,19,105,193,82,118,22,96
"2011","Harrow 033C","E01002172","Total",493,101,21,80,209,74,112,34,78
"2011","Harrow 033D","E01002173","Total",529,100,9,91,194,70,118,29,89
"2011","Harrow 033E","E01002174","Total",483,104,12,92,187,60,125,32,93
"2011","Harrow 033F","E01002175","Total",406,76,5,71,127,61,105,21,84
"2011","Harrow 033G","E01002176","Total",535,98,10,88,179,66,125,32,93
"2011","Harrow 033H","E01002177","Total",452,107,19,88,199,70,107,40,67
"2011","Harrow 033I","E01002178","Total",502,108,14,94,227,62,133,49,84
"2011","Havering 001A","E01002276","Total",694,225,42,183,232,77,194,37,157
"2011","Havering 001B","E01002278","Total",631,266,66,200,247,91,195,37,158
"2011","Havering 001C","E01002312","Total",642,308,24,284,150,62,194,15,179
"2011","Havering 001D","E01002313","Total",630,269,54,215,197,84,219,34,185
"2011","Havering 002A","E01002277","Total",608,237,49,188,195,63,184,34,150
"2011","Havering 002B","E01002279","Total",634,223,47,176,234,95,186,27,159
"2011","Havering 002C","E01002281","Total",756,334,78,256,229,108,231,31,200
"2011","Havering 002D","E01002283","Total",594,247,43,204,202,85,204,37,167
"2011","Havering 002E","E01002299","Total",664,198,38,160,238,98,183,37,146
"2011","Havering 003A","E01002301","Total",627,218,18,200,169,62,158,24,134
"2011","Havering 003B","E01002303","Total",823,312,64,248,289,112,215,42,173
"2011","Havering 003C","E01002304","Total",524,195,23,172,146,52,146,27,119
"2011","Havering 003D","E01002306","Total",625,208,73,135,260,111,150,44,106
"2011","Havering 003E","E01002307","Total",636,210,55,155,251,108,175,44,131
"2011","Havering 004A","E01002280","Total",621,276,85,191,250,107,204,49,155
"2011","Havering 004B","E01002282","Total",668,282,74,208,240,109,227,46,181
"2011","Havering 004C","E01002284","Total",765,297,58,239,269,108,225,33,192
"2011","Havering 004D","E01002297","Total",670,256,54,202,186,86,219,38,181
"2011","Havering 004E","E01002314","Total",623,242,64,178,252,101,202,53,149
"2011","Havering 004F","E01002316","Total",740,345,66,279,202,88,265,34,231
"2011","Havering 005A","E01002302","Total",598,177,27,150,201,72,154,30,124
"2011","Havering 005B","E01002305","Total",608,214,27,187,183,71,155,24,131
"2011","Havering 005C","E01002308","Total",670,257,41,216,219,93,213,43,170
"2011","Havering 005D","E01002326","Total",627,227,40,187,196,84,147,26,121
"2011","Havering 005E","E01002331","Total",596,204,22,182,174,56,152,20,132
"2011","Havering 006A","E01002309","Total",651,264,29,235,174,72,199,20,179
"2011","Havering 006B","E01002310","Total",712,289,55,234,204,77,254,37,217
"2011","Havering 006C","E01002311","Total",668,248,48,200,253,108,193,42,151
"2011","Havering 006D","E01002315","Total",633,227,44,183,227,88,191,35,156
"2011","Havering 007A","E01002293","Total",801,234,27,207,196,96,161,31,130
"2011","Havering 007B","E01002294","Total",626,229,8,221,153,47,192,20,172
"2011","Havering 007C","E01002296","Total",691,229,10,219,173,54,210,29,181
"2011","Havering 007D","E01002298","Total",654,216,17,199,177,65,161,20,141
"2011","Havering 007E","E01002300","Total",715,291,19,272,163,67,208,27,181
"2011","Havering 008A","E01002333","Total",516,193,16,177,142,34,146,19,127
"2011","Havering 008B","E01002334","Total",674,243,14,229,173,47,157,27,130
"2011","Havering 008C","E01002336","Total",612,213,14,199,168,60,136,18,118
"2011","Havering 008D","E01002339","Total",602,199,7,192,198,61,140,23,117
"2011","Havering 008E","E01002341","Total",557,222,8,214,133,52,152,21,131
"2011","Havering 009A","E01002327","Total",595,198,14,184,192,66,155,25,130
"2011","Havering 009B","E01002328","Total",642,175,18,157,232,94,155,35,120
"2011","Havering 009C","E01002332","Total",683,238,21,217,191,84,160,22,138
"2011","Havering 009D","E01002335","Total",592,194,32,162,162,65,185,23,162
"2011","Havering 009E","E01002338","Total",523,162,11,151,168,67,121,18,103
"2011","Havering 009F","E01002340","Total",509,131,6,125,192,84,113,30,83
"2011","Havering 010A","E01002268","Total",519,163,8,155,158,54,148,32,116
"2011","Havering 010B","E01002269","Total",678,232,19,213,225,70,186,45,141
"2011","Havering 010C","E01002295","Total",670,193,16,177,181,75,155,22,133
"2011","Havering 010D","E01002377","Total",711,214,19,195,211,83,176,34,142
"2011","Havering 010E","E01002378","Total",604,157,14,143,241,75,140,35,105
"2011","Havering 010F","E01002383","Total",659,194,10,184,188,68,150,21,129
"2011","Havering 011A","E01002244","Total",749,199,42,157,223,110,159,35,124
"2011","Havering 011B","E01002245","Total",630,224,33,191,210,82,174,32,142
"2011","Havering 011C","E01002325","Total",755,324,65,259,230,96,250,45,205
"2011","Havering 011D","E01002329","Total",643,192,24,168,205,72,142,16,126
"2011","Havering 011E","E01002330","Total",737,226,39,187,230,118,183,35,148
"2011","Havering 012A","E01002337","Total",512,182,10,172,132,40,142,14,128
"2011","Havering 012B","E01002354","Total",561,191,4,187,161,66,117,13,104
"2011","Havering 012C","E01002376","Total",520,119,11,108,186,66,92,20,72
"2011","Havering 012D","E01002379","Total",659,227,23,204,167,76,149,14,135
"2011","Havering 012E","E01002380","Total",1036,300,66,234,227,109,196,39,157
"2011","Havering 012F","E01002381","Total",645,209,22,187,184,70,162,16,146
"2011","Havering 013A","E01002243","Total",847,333,82,251,275,136,216,39,177
"2011","Havering 013B","E01002353","Total",832,282,36,246,225,100,201,31,170
"2011","Havering 013C","E01002356","Total",1037,353,76,277,292,159,241,40,201
"2011","Havering 013E","E01032741","Total",663,152,32,120,95,53,109,16,93
"2011","Havering 013F","E01032742","Total",644,232,15,217,126,63,170,16,154
"2011","Havering 014A","E01002272","Total",536,171,9,162,148,57,123,21,102
"2011","Havering 014B","E01002274","Total",692,229,10,219,187,68,153,28,125
"2011","Havering 014C","E01002317","Total",544,145,14,131,180,48,122,23,99
"2011","Havering 014D","E01002318","Total",614,193,9,184,181,63,147,23,124
"2011","Havering 014E","E01002355","Total",574,153,9,144,183,73,131,32,99
"2011","Havering 014F","E01002382","Total",765,213,15,198,208,87,181,28,153
"2011","Havering 015A","E01002270","Total",634,224,4,220,159,41,170,20,150
"2011","Havering 015B","E01002271","Total",515,175,7,168,157,40,120,23,97
"2011","Havering 015C","E01002273","Total",490,154,8,146,131,39,133,18,115
"2011","Havering 015D","E01002275","Total",517,172,3,169,123,27,120,13,107
"2011","Havering 016A","E01002319","Total",652,229,24,205,193,69,177,28,149
"2011","Havering 016B","E01002350","Total",711,236,36,200,179,95,177,22,155
"2011","Havering 016C","E01002351","Total",653,164,23,141,215,97,159,31,128
"2011","Havering 016D","E01002352","Total",722,194,25,169,197,91,160,30,130
"2011","Havering 016E","E01002358","Total",791,168,38,130,240,122,137,35,102
"2011","Havering 017A","E01002246","Total",637,196,22,174,213,67,165,32,133
"2011","Havering 017B","E01002247","Total",729,178,45,133,273,143,154,40,114
"2011","Havering 017C","E01002248","Total",592,222,47,175,195,100,152,23,129
"2011","Havering 017D","E01002249","Total",746,173,31,142,247,119,144,34,110
"2011","Havering 017E","E01002250","Total",642,159,26,133,225,84,141,36,105
"2011","Havering 017F","E01002251","Total",526,170,50,120,211,85,134,37,97
"2011","Havering 018A","E01002252","Total",617,242,13,229,176,45,159,26,133
"2011","Havering 018B","E01002256","Total",620,224,7,217,186,61,141,24,117
"2011","Havering 018C","E01002258","Total",797,364,28,336,202,76,231,25,206
"2011","Havering 018D","E01002259","Total",612,220,9,211,186,55,146,26,120
"2011","Havering 018E","E01002391","Total",608,218,7,211,176,39,149,25,124
"2011","Havering 019A","E01002253","Total",615,235,4,231,168,48,159,21,138
"2011","Havering 019B","E01002254","Total",636,237,5,232,177,46,169,15,154
"2011","Havering 019C","E01002257","Total",651,249,14,235,214,66,151,22,129
"2011","Havering 019D","E01002384","Total",644,223,13,210,166,48,155,22,133
"2011","Havering 020A","E01002359","Total",515,186,4,182,163,41,151,18,133
"2011","Havering 020B","E01002360","Total",742,362,6,356,125,33,264,21,243
"2011","Havering 020C","E01002361","Total",822,295,26,269,192,91,216,16,200
"2011","Havering 020D","E01002363","Total",686,274,35,239,202,70,203,32,171
"2011","Havering 020E","E01002367","Total",658,181,21,160,201,57,130,20,110
"2011","Havering 021A","E01002320","Total",537,121,9,112,200,53,115,25,90
"2011","Havering 021B","E01002321","Total",635,187,8,179,195,65,161,30,131
"2011","Havering 021C","E01002322","Total",731,154,13,141,235,73,144,35,109
"2011","Havering 021D","E01002323","Total",627,176,14,162,233,84,147,31,116
"2011","Havering 021E","E01002324","Total",650,259,26,233,158,42,206,25,181
"2011","Havering 022A","E01002255","Total",630,209,16,193,185,70,158,30,128
"2011","Havering 022B","E01002289","Total",621,199,16,183,208,63,137,28,109
"2011","Havering 022C","E01002292","Total",637,246,28,218,200,73,188,36,152
"2011","Havering 022D","E01002362","Total",616,186,14,172,167,58,151,16,135
"2011","Havering 022E","E01002386","Total",871,261,18,243,221,102,180,25,155
"2011","Havering 023A","E01002287","Total",602,185,15,170,182,55,143,23,120
"2011","Havering 023B","E01002291","Total",775,258,17,241,139,51,175,14,161
"2011","Havering 023C","E01002364","Total",542,193,9,184,141,41,141,17,124
"2011","Havering 023D","E01002365","Total",552,205,13,192,150,49,151,13,138
"2011","Havering 023E","E01002366","Total",568,155,19,136,198,54,121,32,89
"2011","Havering 024A","E01002385","Total",601,163,7,156,186,53,140,25,115
"2011","Havering 024B","E01002387","Total",607,200,4,196,195,53,148,28,120
"2011","Havering 024C","E01002388","Total",608,193,6,187,197,58,131,24,107
"2011","Havering 024D","E01002389","Total",623,259,6,253,144,42,151,14,137
"2011","Havering 024E","E01002390","Total",531,165,3,162,173,47,114,15,99
"2011","Havering 025A","E01002265","Total",638,182,13,169,170,63,134,20,114
"2011","Havering 025B","E01002285","Total",520,201,10,191,121,38,136,10,126
"2011","Havering 025C","E01002286","Total",614,188,15,173,207,51,142,27,115
"2011","Havering 025D","E01002288","Total",554,135,10,125,193,54,122,26,96
"2011","Havering 025E","E01002290","Total",641,260,10,250,153,48,190,18,172
"2011","Havering 026A","E01002260","Total",566,176,27,149,186,57,154,41,113
"2011","Havering 026B","E01002261","Total",645,204,25,179,209,83,172,32,140
"2011","Havering 026C","E01002262","Total",625,226,25,201,196,60,204,34,170
"2011","Havering 026D","E01002263","Total",609,154,15,139,176,62,128,31,97
"2011","Havering 026E","E01002264","Total",710,353,60,293,200,81,236,33,203
"2011","Havering 027A","E01002266","Total",600,256,14,242,140,53,194,30,164
"2011","Havering 027B","E01002267","Total",734,335,40,295,219,68,240,44,196
"2011","Havering 027C","E01002372","Total",603,191,23,168,206,69,153,26,127
"2011","Havering 027D","E01002373","Total",628,214,27,187,201,73,167,34,133
"2011","Havering 027E","E01002374","Total",604,192,26,166,188,59,140,22,118
"2011","Havering 028A","E01002368","Total",696,268,70,198,235,98,193,32,161
"2011","Havering 028B","E01002369","Total",730,241,40,201,241,101,199,46,153
"2011","Havering 028C","E01002370","Total",846,322,52,270,259,99,239,39,200
"2011","Havering 028D","E01002371","Total",643,251,30,221,190,66,174,22,152
"2011","Havering 028E","E01002375","Total",688,271,60,211,241,109,185,34,151
"2011","Havering 029A","E01002343","Total",636,222,13,209,189,63,152,20,132
"2011","Havering 029B","E01002344","Total",638,242,24,218,162,66,158,17,141
"2011","Havering 029C","E01002348","Total",642,259,12,247,158,47,163,20,143
"2011","Havering 029D","E01002349","Total",608,208,12,196,174,44,163,29,134
"2011","Havering 030A","E01002342","Total",632,228,47,181,221,74,167,30,137
"2011","Havering 030B","E01002345","Total",756,243,87,156,283,148,168,29,139
"2011","Havering 030C","E01002346","Total",557,137,36,101,206,87,134,29,105
"2011","Havering 030D","E01002347","Total",526,171,23,148,178,71,134,18,116
"2011","Hillingdon 001A","E01002473","Total",636,188,9,179,168,32,163,23,140
"2011","Hillingdon 001B","E01002475","Total",692,229,20,209,168,83,168,17,151
"2011","Hillingdon 001C","E01002476","Total",611,173,10,163,181,57,109,19,90
"2011","Hillingdon 001D","E01002477","Total",559,165,12,153,137,53,123,15,108
"2011","Hillingdon 001E","E01002482","Total",617,203,9,194,180,66,115,17,98
"2011","Hillingdon 002A","E01002472","Total",771,295,23,272,153,58,179,17,162
"2011","Hillingdon 002B","E01002474","Total",643,197,16,181,176,73,148,23,125
"2011","Hillingdon 002C","E01002478","Total",666,193,15,178,186,69,158,26,132
"2011","Hillingdon 002D","E01002483","Total",714,221,31,190,225,106,170,38,132
"2011","Hillingdon 002E","E01002484","Total",585,158,15,143,180,63,149,31,118
"2011","Hillingdon 002F","E01002485","Total",762,252,33,219,225,105,190,22,168
"2011","Hillingdon 003A","E01002438","Total",480,96,13,83,165,61,94,29,65
"2011","Hillingdon 003B","E01002439","Total",608,196,21,175,195,91,142,25,117
"2011","Hillingdon 003C","E01002440","Total",618,230,35,195,185,69,176,28,148
"2011","Hillingdon 003D","E01002441","Total",667,212,29,183,183,85,162,27,135
"2011","Hillingdon 003E","E01002442","Total",635,179,13,166,178,82,160,33,127
"2011","Hillingdon 004A","E01002433","Total",782,257,32,225,239,106,178,32,146
"2011","Hillingdon 004B","E01002436","Total",658,201,12,189,216,82,172,36,136
"2011","Hillingdon 004C","E01002479","Total",628,174,21,153,239,74,175,44,131
"2011","Hillingdon 004D","E01002480","Total",713,212,11,201,223,82,153,25,128
"2011","Hillingdon 004E","E01002481","Total",659,220,27,193,217,85,175,32,143
"2011","Hillingdon 005A","E01002533","Total",589,149,26,123,213,87,129,37,92
"2011","Hillingdon 005B","E01002534","Total",607,214,12,202,188,79,158,26,132
"2011","Hillingdon 005C","E01002538","Total",746,225,14,211,165,54,195,29,166
"2011","Hillingdon 005D","E01002539","Total",619,224,13,211,171,58,145,20,125
"2011","Hillingdon 006A","E01002418","Total",658,196,20,176,251,83,161,31,130
"2011","Hillingdon 006B","E01002419","Total",611,158,11,147,187,63,123,18,105
"2011","Hillingdon 006C","E01002431","Total",489,146,10,136,186,59,103,19,84
"2011","Hillingdon 006D","E01002432","Total",635,201,5,196,167,59,127,27,100
"2011","Hillingdon 006E","E01002437","Total",608,243,2,241,147,38,165,17,148
"2011","Hillingdon 007A","E01002430","Total",524,149,4,145,169,60,97,19,78
"2011","Hillingdon 007B","E01002434","Total",504,156,8,148,169,54,109,29,80
"2011","Hillingdon 007C","E01002435","Total",535,170,5,165,164,56,112,20,92
"2011","Hillingdon 007D","E01002470","Total",702,221,17,204,189,71,165,20,145
"2011","Hillingdon 007E","E01002535","Total",828,232,10,222,162,62,184,22,162
"2011","Hillingdon 008A","E01002416","Total",593,129,19,110,246,79,119,35,84
"2011","Hillingdon 008B","E01002417","Total",638,202,12,190,180,68,163,31,132
"2011","Hillingdon 008C","E01002420","Total",662,192,26,166,224,85,163,35,128
"2011","Hillingdon 008D","E01002421","Total",636,190,24,166,230,76,158,45,113
"2011","Hillingdon 008E","E01002471","Total",634,144,10,134,219,90,130,22,108
"2011","Hillingdon 009A","E01002465","Total",633,149,27,122,223,101,126,22,104
"2011","Hillingdon 009B","E01002467","Total",639,255,16,239,179,75,182,19,163
"2011","Hillingdon 009C","E01002494","Total",637,139,25,114,237,95,137,40,97
"2011","Hillingdon 009D","E01002536","Total",609,95,12,83,182,96,96,20,76
"2011","Hillingdon 009E","E01002537","Total",579,115,12,103,172,86,93,20,73
"2011","Hillingdon 010A","E01002415","Total",643,149,7,142,238,85,138,32,106
"2011","Hillingdon 010B","E01002466","Total",633,142,8,134,229,94,127,31,96
"2011","Hillingdon 010C","E01002468","Total",633,133,13,120,233,85,125,35,90
"2011","Hillingdon 010D","E01002469","Total",631,135,12,123,219,90,130,34,96
"2011","Hillingdon 010E","E01002495","Total",695,136,29,107,259,115,134,40,94
"2011","Hillingdon 011A","E01002458","Total",543,189,6,183,153,48,130,28,102
"2011","Hillingdon 011B","E01002459","Total",622,209,5,204,191,56,148,15,133
"2011","Hillingdon 011C","E01002460","Total",597,235,7,228,144,65,168,22,146
"2011","Hillingdon 011D","E01002462","Total",506,127,3,124,196,69,108,19,89
"2011","Hillingdon 011E","E01002464","Total",623,170,13,157,229,106,140,35,105
"2011","Hillingdon 013A","E01002461","Total",516,153,9,144,156,48,113,15,98
"2011","Hillingdon 013B","E01002463","Total",528,147,12,135,193,47,132,32,100
"2011","Hillingdon 013C","E01002512","Total",647,180,4,176,182,59,163,34,129
"2011","Hillingdon 013D","E01002513","Total",544,196,7,189,134,38,162,20,142
"2011","Hillingdon 013E","E01002516","Total",490,124,11,113,167,61,113,27,86
"2011","Hillingdon 014A","E01002450","Total",503,112,19,93,214,82,103,32,71
"2011","Hillingdon 014B","E01002451","Total",493,114,17,97,211,83,111,31,80
"2011","Hillingdon 014C","E01002452","Total",500,100,12,88,210,81,109,36,73
"2011","Hillingdon 014D","E01002453","Total",599,128,23,105,237,98,157,33,124
"2011","Hillingdon 014E","E01002454","Total",661,209,53,156,285,129,175,52,123
"2011","Hillingdon 015A","E01002414","Total",527,150,13,137,106,52,100,21,79
"2011","Hillingdon 015C","E01002514","Total",885,260,24,236,201,78,186,27,159
"2011","Hillingdon 015D","E01002515","Total",718,222,25,197,214,102,197,36,161
"2011","Hillingdon 015F","E01033725","Total",945,275,32,243,261,121,228,46,182
"2011","Hillingdon 016B","E01002520","Total",603,153,45,108,222,96,120,36,84
"2011","Hillingdon 016C","E01002521","Total",909,390,42,348,167,104,273,25,248
"2011","Hillingdon 016D","E01002523","Total",549,125,20,105,169,72,119,37,82
"2011","Hillingdon 016F","E01033724","Total",1051,324,52,272,283,120,214,43,171
"2011","Hillingdon 017A","E01002410","Total",638,178,30,148,205,83,156,36,120
"2011","Hillingdon 017B","E01002412","Total",822,217,38,179,259,117,154,43,111
"2011","Hillingdon 017C","E01002456","Total",621,202,39,163,232,106,162,33,129
"2011","Hillingdon 017D","E01002509","Total",502,161,19,142,174,65,106,29,77
"2011","Hillingdon 017E","E01002511","Total",613,213,29,184,203,89,165,28,137
"2011","Hillingdon 018A","E01002422","Total",494,129,28,101,219,77,123,33,90
"2011","Hillingdon 018B","E01002423","Total",568,157,19,138,212,68,128,25,103
"2011","Hillingdon 018C","E01002424","Total",526,131,29,102,248,92,114,37,77
"2011","Hillingdon 018D","E01002425","Total",613,182,47,135,249,107,170,45,125
"2011","Hillingdon 018E","E01002427","Total",514,138,20,118,195,75,129,27,102
"2011","Hillingdon 018F","E01002428","Total",496,127,21,106,197,70,108,31,77
"2011","Hillingdon 019A","E01002408","Total",629,191,40,151,186,84,180,48,132
"2011","Hillingdon 019B","E01002409","Total",672,239,59,180,229,100,204,54,150
"2011","Hillingdon 019C","E01002429","Total",498,149,46,103,221,74,139,49,90
"2011","Hillingdon 019D","E01002455","Total",652,196,30,166,227,108,150,30,120
"2011","Hillingdon 019E","E01002457","Total",517,142,62,80,245,93,125,49,76
"2011","Hillingdon 020A","E01002392","Total",618,239,96,143,300,135,176,51,125
"2011","Hillingdon 020B","E01002393","Total",705,207,85,122,312,152,180,56,124
"2011","Hillingdon 020C","E01002540","Total",621,142,43,99,246,128,124,26,98
"2011","Hillingdon 020D","E01002542","Total",665,198,74,124,309,170,162,58,104
"2011","Hillingdon 020E","E01002543","Total",625,187,67,120,287,138,159,52,107
"2011","Hillingdon 021A","E01002394","Total",508,156,34,122,219,118,138,37,101
"2011","Hillingdon 021B","E01002395","Total",424,83,19,64,193,73,90,32,58
"2011","Hillingdon 021C","E01002397","Total",514,129,49,80,245,105,116,26,90
"2011","Hillingdon 021D","E01002398","Total",493,98,21,77,218,91,130,50,80
"2011","Hillingdon 021E","E01002399","Total",474,101,24,77,205,79,121,49,72
"2011","Hillingdon 021F","E01002426","Total",631,175,51,124,295,140,158,53,105
"2011","Hillingdon 022A","E01002411","Total",632,206,32,174,198,94,171,27,144
"2011","Hillingdon 022B","E01002413","Total",594,202,46,156,206,93,160,25,135
"2011","Hillingdon 022C","E01002518","Total",490,148,16,132,124,43,121,12,109
"2011","Hillingdon 022D","E01002519","Total",719,244,33,211,153,82,187,26,161
"2011","Hillingdon 022E","E01002550","Total",795,196,67,129,275,149,139,40,99
"2011","Hillingdon 022F","E01002554","Total",1073,241,84,157,370,211,190,55,135
"2011","Hillingdon 023A","E01002541","Total",785,158,33,125,284,134,147,32,115
"2011","Hillingdon 023B","E01002544","Total",555,115,24,91,223,114,113,40,73
"2011","Hillingdon 023C","E01002545","Total",483,157,96,61,300,113,128,56,72
"2011","Hillingdon 023D","E01002546","Total",449,66,15,51,217,98,107,35,72
"2011","Hillingdon 023E","E01002547","Total",492,132,64,68,244,122,117,49,68
"2011","Hillingdon 024A","E01002400","Total",599,178,51,127,256,111,138,46,92
"2011","Hillingdon 024B","E01002401","Total",609,192,41,151,247,124,149,40,109
"2011","Hillingdon 024C","E01002402","Total",491,147,40,107,225,86,141,38,103
"2011","Hillingdon 024D","E01002403","Total",543,154,56,98,272,117,151,61,90
"2011","Hillingdon 024E","E01002404","Total",675,202,71,131,315,155,184,62,122
"2011","Hillingdon 025A","E01002548","Total",657,257,62,195,239,119,224,45,179
"2011","Hillingdon 025B","E01002549","Total",672,189,34,155,226,102,180,35,145
"2011","Hillingdon 025C","E01002551","Total",641,199,42,157,248,98,183,54,129
"2011","Hillingdon 025D","E01002552","Total",526,138,41,97,234,83,135,43,92
"2011","Hillingdon 025E","E01002553","Total",603,193,52,141,239,94,167,51,116
"2011","Hillingdon 026A","E01002396","Total",563,190,41,149,249,95,172,51,121
"2011","Hillingdon 026B","E01002501","Total",506,139,34,105,219,88,145,53,92
"2011","Hillingdon 026C","E01002502","Total",491,135,38,97,201,81,156,47,109
"2011","Hillingdon 026D","E01002505","Total",682,210,74,136,260,143,179,56,123
"2011","Hillingdon 026E","E01002508","Total",648,255,75,180,298,134,222,71,151
"2011","Hillingdon 027A","E01002405","Total",634,186,44,142,258,116,173,45,128
"2011","Hillingdon 027B","E01002406","Total",680,197,77,120,317,141,160,50,110
"2011","Hillingdon 027C","E01002503","Total",497,125,45,80,227,90,138,49,89
"2011","Hillingdon 027D","E01002504","Total",726,208,61,147,292,138,163,42,121
"2011","Hillingdon 027E","E01002506","Total",643,209,72,137,280,133,163,51,112
"2011","Hillingdon 027F","E01002507","Total",465,103,36,67,209,84,113,35,78
"2011","Hillingdon 028A","E01002486","Total",699,198,72,126,355,148,156,65,91
"2011","Hillingdon 028B","E01002487","Total",614,182,42,140,237,118,164,44,120
"2011","Hillingdon 028C","E01002526","Total",635,176,56,120,310,107,168,73,95
"2011","Hillingdon 028D","E01002528","Total",563,191,51,140,233,96,178,58,120
"2011","Hillingdon 028E","E01002532","Total",886,238,73,165,373,193,219,80,139
"2011","Hillingdon 029A","E01002445","Total",588,212,103,109,310,146,146,60,86
"2011","Hillingdon 029B","E01002525","Total",647,173,22,151,186,91,140,23,117
"2011","Hillingdon 029C","E01002529","Total",771,165,60,105,312,162,150,49,101
"2011","Hillingdon 029D","E01002530","Total",619,254,77,177,267,111,204,51,153
"2011","Hillingdon 029E","E01002531","Total",644,208,22,186,174,71,173,25,148
"2011","Hillingdon 030A","E01002407","Total",725,183,81,102,338,176,170,62,108
"2011","Hillingdon 030B","E01002488","Total",533,140,33,107,229,93,119,30,89
"2011","Hillingdon 030C","E01002489","Total",537,126,34,92,258,114,128,51,77
"2011","Hillingdon 030D","E01002490","Total",656,145,44,101,291,150,145,42,103
"2011","Hillingdon 030E","E01002492","Total",488,108,43,65,250,110,123,53,70
"2011","Hillingdon 031A","E01002444","Total",625,161,23,138,146,70,130,25,105
"2011","Hillingdon 031B","E01002446","Total",592,172,31,141,208,114,133,35,98
"2011","Hillingdon 031C","E01002447","Total",623,124,44,80,216,88,117,32,85
"2011","Hillingdon 031D","E01002527","Total",622,207,40,167,184,83,142,25,117
"2011","Hillingdon 032A","E01002443","Total",547,109,19,90,220,128,90,23,67
"2011","Hillingdon 032B","E01002448","Total",765,223,35,188,254,123,174,31,143
"2011","Hillingdon 032C","E01002449","Total",710,147,41,106,219,131,128,43,85
"2011","Hillingdon 032D","E01002491","Total",519,157,49,108,244,102,142,57,85
"2011","Hillingdon 032E","E01002493","Total",601,176,86,90,328,157,158,65,93
"2011","Hillingdon 033A","E01002496","Total",767,195,30,165,269,123,145,31,114
"2011","Hillingdon 033B","E01002497","Total",759,222,41,181,253,136,164,36,128
"2011","Hillingdon 033C","E01002498","Total",516,140,17,123,192,74,117,29,88
"2011","Hillingdon 033D","E01002499","Total",678,184,34,150,223,111,153,28,125
"2011","Hillingdon 033E","E01032577","Total",601,156,21,135,239,82,132,37,95
"2011","Hounslow 001A","E01002569","Total",792,151,12,139,170,96,113,15,98
"2011","Hounslow 001B","E01002570","Total",732,127,12,115,157,77,103,20,83
"2011","Hounslow 001C","E01002573","Total",679,151,15,136,210,78,117,19,98
"2011","Hounslow 001D","E01002574","Total",645,121,17,104,172,79,103,18,85
"2011","Hounslow 001E","E01002575","Total",688,137,15,122,202,87,106,24,82
"2011","Hounslow 003A","E01002562","Total",518,170,29,141,146,60,146,34,112
"2011","Hounslow 003B","E01002564","Total",736,215,53,162,250,127,188,44,144
"2011","Hounslow 003C","E01002566","Total",1027,338,84,254,289,150,241,47,194
"2011","Hounslow 003D","E01002568","Total",1181,381,128,253,387,195,288,68,220
"2011","Hounslow 003F","E01033081","Total",649,139,43,96,153,81,95,21,74
"2011","Hounslow 003G","E01033082","Total",659,223,29,194,121,73,162,17,145
"2011","Hounslow 004A","E01002620","Total",676,222,70,152,304,148,182,70,112
"2011","Hounslow 004B","E01002625","Total",492,115,22,93,205,71,142,45,97
"2011","Hounslow 004C","E01002626","Total",490,129,20,109,180,70,134,34,100
"2011","Hounslow 004D","E01002627","Total",609,197,54,143,248,117,168,55,113
"2011","Hounslow 004E","E01002631","Total",509,104,42,62,234,99,112,45,67
"2011","Hounslow 005A","E01002633","Total",623,239,68,171,253,113,182,51,131
"2011","Hounslow 005B","E01002634","Total",546,201,91,110,283,149,169,59,110
"2011","Hounslow 005C","E01002637","Total",563,203,51,152,220,103,156,40,116
"2011","Hounslow 005D","E01002638","Total",582,194,61,133,257,106,150,48,102
"2011","Hounslow 006A","E01002563","Total",635,152,12,140,158,61,145,23,122
"2011","Hounslow 006B","E01002565","Total",1020,244,23,221,226,122,193,25,168
"2011","Hounslow 006C","E01002567","Total",837,182,24,158,191,103,153,18,135
"2011","Hounslow 006D","E01002684","Total",1096,236,40,196,248,126,182,36,146
"2011","Hounslow 006E","E01002686","Total",681,251,56,195,240,102,199,46,153
"2011","Hounslow 007A","E01002571","Total",611,111,7,104,164,64,85,22,63
"2011","Hounslow 007B","E01002572","Total",710,255,59,196,218,97,197,54,143
"2011","Hounslow 007C","E01002577","Total",660,117,17,100,195,72,106,16,90
"2011","Hounslow 007D","E01002578","Total",612,145,14,131,194,58,128,21,107
"2011","Hounslow 007E","E01002689","Total",796,255,28,227,198,105,216,37,179
"2011","Hounslow 007F","E01002690","Total",612,150,22,128,181,67,108,18,90
"2011","Hounslow 008A","E01002576","Total",756,204,39,165,245,86,189,33,156
"2011","Hounslow 008B","E01002579","Total",823,229,14,215,201,92,157,17,140
"2011","Hounslow 008C","E01002580","Total",675,204,30,174,157,89,168,15,153
"2011","Hounslow 008D","E01002581","Total",862,164,23,141,211,121,126,16,110
"2011","Hounslow 008E","E01002582","Total",719,156,12,144,227,121,139,21,118
"2011","Hounslow 009A","E01002675","Total",877,161,40,121,339,178,138,45,93
"2011","Hounslow 009B","E01002678","Total",669,117,19,98,217,102,116,38,78
"2011","Hounslow 009C","E01002679","Total",643,136,24,112,198,102,127,25,102
"2011","Hounslow 009D","E01002680","Total",728,138,18,120,228,116,123,29,94
"2011","Hounslow 010A","E01002619","Total",624,180,25,155,216,89,182,47,135
"2011","Hounslow 010B","E01002622","Total",526,107,28,79,210,85,129,48,81
"2011","Hounslow 010C","E01002632","Total",569,155,34,121,236,104,151,44,107
"2011","Hounslow 010D","E01002635","Total",524,109,24,85,210,91,140,41,99
"2011","Hounslow 010E","E01002636","Total",609,149,40,109,237,89,166,51,115
"2011","Hounslow 011A","E01002618","Total",512,111,20,91,212,83,116,32,84
"2011","Hounslow 011B","E01002621","Total",594,141,34,107,238,104,154,51,103
"2011","Hounslow 011C","E01002623","Total",484,125,38,87,206,95,125,44,81
"2011","Hounslow 011D","E01002628","Total",620,141,30,111,239,96,149,39,110
"2011","Hounslow 011E","E01002629","Total",715,197,45,152,271,126,174,43,131
"2011","Hounslow 012A","E01002630","Total",569,122,27,95,227,115,115,41,74
"2011","Hounslow 012B","E01002639","Total",497,101,15,86,177,83,117,27,90
"2011","Hounslow 012C","E01002640","Total",548,108,17,91,197,97,90,18,72
"2011","Hounslow 012D","E01002674","Total",668,159,16,143,210,114,123,24,99
"2011","Hounslow 012E","E01002676","Total",559,138,14,124,189,63,111,33,78
"2011","Hounslow 013A","E01002583","Total",512,120,32,88,224,95,118,39,79
"2011","Hounslow 013B","E01002584","Total",493,106,29,77,207,113,131,36,95
"2011","Hounslow 013C","E01002585","Total",509,140,39,101,220,84,140,42,98
"2011","Hounslow 013D","E01002586","Total",457,101,21,80,173,68,111,24,87
"2011","Hounslow 013E","E01002589","Total",677,187,54,133,276,146,172,49,123
"2011","Hounslow 014A","E01002668","Total",883,177,29,148,228,118,149,36,113
"2011","Hounslow 014B","E01002669","Total",711,203,68,135,276,121,214,67,147
"2011","Hounslow 014C","E01002681","Total",741,163,58,105,283,124,156,57,99
"2011","Hounslow 014D","E01002682","Total",927,211,45,166,305,155,182,47,135
"2011","Hounslow 014E","E01002683","Total",1037,221,42,179,362,203,170,37,133
"2011","Hounslow 015A","E01002642","Total",735,173,36,137,273,156,149,35,114
"2011","Hounslow 015B","E01002643","Total",910,323,39,284,276,131,260,41,219
"2011","Hounslow 015C","E01002645","Total",766,216,28,188,233,108,196,35,161
"2011","Hounslow 015D","E01002658","Total",501,110,9,101,165,64,95,20,75
"2011","Hounslow 015E","E01002677","Total",652,155,30,125,188,90,146,31,115
"2011","Hounslow 016A","E01002587","Total",605,169,30,139,222,106,179,53,126
"2011","Hounslow 016B","E01002588","Total",677,285,85,200,272,126,203,50,153
"2011","Hounslow 016C","E01002660","Total",522,114,16,98,194,89,124,34,90
"2011","Hounslow 016D","E01002661","Total",518,111,9,102,177,82,126,30,96
"2011","Hounslow 016E","E01002665","Total",524,164,38,126,206,92,181,38,143
"2011","Hounslow 017A","E01002624","Total",480,98,22,76,185,99,137,42,95
"2011","Hounslow 017B","E01002646","Total",712,226,81,145,322,153,190,58,132
"2011","Hounslow 017C","E01002662","Total",627,129,21,108,186,90,117,34,83
"2011","Hounslow 017D","E01002663","Total",751,246,37,209,261,125,241,40,201
"2011","Hounslow 017E","E01002664","Total",596,136,27,109,233,121,137,38,99
"2011","Hounslow 018A","E01002641","Total",637,162,26,136,229,107,160,37,123
"2011","Hounslow 018C","E01002648","Total",900,199,58,141,356,185,189,56,133
"2011","Hounslow 018D","E01002649","Total",692,156,42,114,237,111,129,23,106
"2011","Hounslow 018E","E01002657","Total",650,133,18,115,244,122,144,32,112
"2011","Hounslow 018F","E01033083","Total",643,40,12,28,276,205,33,8,25
"2011","Hounslow 018G","E01033084","Total",648,129,53,76,246,143,100,30,70
"2011","Hounslow 019A","E01002653","Total",542,113,13,100,222,75,138,38,100
"2011","Hounslow 019B","E01002654","Total",646,128,15,113,221,89,116,30,86
"2011","Hounslow 019C","E01002655","Total",622,140,16,124,238,102,134,37,97
"2011","Hounslow 019D","E01002656","Total",479,136,10,126,163,63,125,22,103
"2011","Hounslow 019E","E01002659","Total",504,147,18,129,174,65,135,32,103
"2011","Hounslow 020A","E01002667","Total",651,166,39,127,191,92,136,34,102
"2011","Hounslow 020B","E01002670","Total",708,170,37,133,218,101,144,32,112
"2011","Hounslow 020C","E01002671","Total",636,146,29,117,211,107,153,34,119
"2011","Hounslow 020D","E01002672","Total",683,182,42,140,186,84,151,41,110
"2011","Hounslow 020E","E01002673","Total",621,251,99,152,279,151,182,65,117
"2011","Hounslow 021A","E01002647","Total",753,190,65,125,374,170,175,53,122
"2011","Hounslow 021B","E01002650","Total",792,178,77,101,396,208,168,60,108
"2011","Hounslow 021C","E01002651","Total",550,123,27,96,219,104,128,41,87
"2011","Hounslow 021D","E01002652","Total",516,102,27,75,192,82,119,37,82
"2011","Hounslow 021E","E01002666","Total",407,108,28,80,164,72,112,28,84
"2011","Hounslow 022A","E01002555","Total",681,159,37,122,262,130,144,32,112
"2011","Hounslow 022B","E01002556","Total",639,173,29,144,239,117,152,35,117
"2011","Hounslow 022C","E01002590","Total",726,203,42,161,253,121,211,41,170
"2011","Hounslow 022D","E01002592","Total",789,267,64,203,291,143,220,51,169
"2011","Hounslow 022E","E01002595","Total",712,207,47,160,257,95,173,47,126
"2011","Hounslow 023A","E01002557","Total",743,236,35,201,209,94,198,41,157
"2011","Hounslow 023B","E01002558","Total",773,228,57,171,272,138,199,57,142
"2011","Hounslow 023C","E01002559","Total",857,187,56,131,325,159,165,48,117
"2011","Hounslow 023D","E01002560","Total",615,217,37,180,193,72,194,40,154
"2011","Hounslow 023E","E01002561","Total",551,143,68,75,230,112,132,48,84
"2011","Hounslow 024A","E01002591","Total",626,179,32,147,224,84,172,33,139
"2011","Hounslow 024B","E01002593","Total",725,199,15,184,221,101,189,28,161
"2011","Hounslow 024C","E01002594","Total",642,160,34,126,277,124,135,49,86
"2011","Hounslow 024D","E01002611","Total",636,162,31,131,237,114,143,37,106
"2011","Hounslow 024E","E01002612","Total",699,231,51,180,221,101,171,33,138
"2011","Hounslow 024F","E01002613","Total",609,145,29,116,247,103,132,45,87
"2011","Hounslow 025B","E01002598","Total",649,179,62,117,293,128,149,43,106
"2011","Hounslow 025C","E01002599","Total",569,157,55,102,261,114,135,44,91
"2011","Hounslow 025D","E01002600","Total",520,135,37,98,201,83,143,44,99
"2011","Hounslow 025E","E01002603","Total",666,113,48,65,329,154,121,47,74
"2011","Hounslow 025F","E01033000","Total",663,205,71,134,304,164,167,50,117
"2011","Hounslow 025G","E01033030","Total",773,90,40,50,288,208,66,22,44
"2011","Hounslow 026A","E01002604","Total",588,206,93,113,318,143,143,52,91
"2011","Hounslow 026B","E01002605","Total",753,230,55,175,258,120,194,43,151
"2011","Hounslow 026C","E01002606","Total",671,251,60,191,237,103,223,53,170
"2011","Hounslow 026D","E01002607","Total",676,178,55,123,291,142,152,48,104
"2011","Hounslow 026E","E01002615","Total",606,233,58,175,217,102,201,43,158
"2011","Hounslow 027A","E01002596","Total",772,125,62,63,321,193,110,49,61
"2011","Hounslow 027B","E01002601","Total",637,98,38,60,266,145,93,29,64
"2011","Hounslow 027C","E01002602","Total",564,124,12,112,215,89,127,31,96
"2011","Hounslow 027D","E01002614","Total",758,187,53,134,242,145,144,36,108
"2011","Hounslow 027E","E01002616","Total",535,174,18,156,174,73,129,22,107
"2011","Hounslow 028A","E01002608","Total",676,207,61,146,255,128,176,39,137
"2011","Hounslow 028B","E01002609","Total",655,177,20,157,224,88,162,38,124
"2011","Hounslow 028C","E01002610","Total",632,241,61,180,227,113,149,40,109
"2011","Hounslow 028D","E01002617","Total",642,168,21,147,199,99,137,26,111
"2011","Hounslow 029A","E01002687","Total",832,161,11,150,162,90,136,17,119
"2011","Hounslow 029B","E01002691","Total",591,151,15,136,150,65,112,27,85
"2011","Hounslow 029C","E01002692","Total",911,214,37,177,172,97,134,24,110
"2011","Hounslow 029D","E01002693","Total",841,282,16,266,150,87,204,7,197
"2011","Hounslow 029E","E01032573","Total",860,201,9,192,116,64,139,11,128
"2011","Kingston upon Thames 001A","E01003006","Total",611,174,11,163,200,69,129,21,108
"2011","Kingston upon Thames 001B","E01003007","Total",549,129,11,118,232,84,109,25,84
"2011","Kingston upon Thames 001C","E01003008","Total",514,114,3,111,236,90,82,20,62
"2011","Kingston upon Thames 001D","E01003009","Total",773,205,26,179,282,130,162,31,131
"2011","Kingston upon Thames 001E","E01003010","Total",554,109,9,100,216,52,87,22,65
"2011","Kingston upon Thames 002A","E01002952","Total",486,124,9,115,178,39,84,24,60
"2011","Kingston upon Thames 002B","E01002953","Total",453,110,11,99,157,47,73,13,60
"2011","Kingston upon Thames 002C","E01002955","Total",513,128,10,118,157,55,119,29,90
"2011","Kingston upon Thames 002D","E01002956","Total",437,130,15,115,158,53,91,12,79
"2011","Kingston upon Thames 002E","E01002959","Total",479,148,10,138,195,52,94,18,76
"2011","Kingston upon Thames 003A","E01002935","Total",775,162,20,142,182,86,107,22,85
"2011","Kingston upon Thames 003B","E01002938","Total",782,179,16,163,303,159,126,32,94
"2011","Kingston upon Thames 003C","E01002951","Total",624,168,25,143,178,97,106,16,90
"2011","Kingston upon Thames 003D","E01002954","Total",565,197,24,173,137,81,113,10,103
"2011","Kingston upon Thames 003E","E01002957","Total",608,164,50,114,223,117,108,36,72
"2011","Kingston upon Thames 004A","E01002933","Total",807,252,30,222,291,147,199,40,159
"2011","Kingston upon Thames 004B","E01002934","Total",649,100,13,87,294,147,96,28,68
"2011","Kingston upon Thames 004D","E01002937","Total",645,112,11,101,283,160,94,29,65
"2011","Kingston upon Thames 004E","E01003011","Total",730,200,16,184,223,112,134,16,118
"2011","Kingston upon Thames 004F","E01033568","Total",718,157,37,120,183,104,81,17,64
"2011","Kingston upon Thames 004G","E01033569","Total",696,123,26,97,199,108,81,19,62
"2011","Kingston upon Thames 005A","E01002964","Total",982,341,35,306,203,115,251,27,224
"2011","Kingston upon Thames 005B","E01002969","Total",756,276,67,209,241,121,203,37,166
"2011","Kingston upon Thames 005C","E01002971","Total",705,149,18,131,195,125,128,29,99
"2011","Kingston upon Thames 005D","E01002972","Total",828,236,28,208,167,91,165,20,145
"2011","Kingston upon Thames 005E","E01002974","Total",726,178,31,147,234,95,144,27,117
"2011","Kingston upon Thames 006A","E01002932","Total",678,189,65,124,285,123,167,52,115
"2011","Kingston upon Thames 006B","E01002960","Total",574,151,13,138,218,76,115,25,90
"2011","Kingston upon Thames 006C","E01002962","Total",511,107,22,85,206,76,114,35,79
"2011","Kingston upon Thames 006D","E01002970","Total",570,150,35,115,194,72,119,33,86
"2011","Kingston upon Thames 006E","E01002973","Total",465,109,34,75,186,80,115,35,80
"2011","Kingston upon Thames 007A","E01002929","Total",635,161,13,148,219,70,121,29,92
"2011","Kingston upon Thames 007B","E01002930","Total",683,170,25,145,221,105,126,34,92
"2011","Kingston upon Thames 007C","E01002931","Total",654,137,21,116,268,118,143,30,113
"2011","Kingston upon Thames 007D","E01002963","Total",768,226,24,202,224,117,136,18,118
"2011","Kingston upon Thames 007E","E01002985","Total",603,157,24,133,239,107,122,35,87
"2011","Kingston upon Thames 008A","E01002927","Total",614,194,18,176,190,74,159,33,126
"2011","Kingston upon Thames 008B","E01002928","Total",660,197,20,177,178,82,158,15,143
"2011","Kingston upon Thames 008C","E01002958","Total",659,128,13,115,239,116,100,19,81
"2011","Kingston upon Thames 008D","E01002961","Total",609,135,11,124,252,74,115,34,81
"2011","Kingston upon Thames 008E","E01002986","Total",471,153,15,138,161,47,122,25,97
"2011","Kingston upon Thames 009A","E01002965","Total",1071,304,33,271,184,85,179,26,153
"2011","Kingston upon Thames 009B","E01002967","Total",958,211,11,200,149,95,148,19,129
"2011","Kingston upon Thames 009C","E01002968","Total",1123,331,19,312,199,110,128,15,113
"2011","Kingston upon Thames 009D","E01002990","Total",937,210,15,195,113,77,131,7,124
"2011","Kingston upon Thames 009E","E01002991","Total",710,147,6,141,160,73,91,10,81
"2011","Kingston upon Thames 010A","E01002922","Total",725,211,7,204,184,74,143,16,127
"2011","Kingston upon Thames 010B","E01002926","Total",590,154,12,142,215,105,125,27,98
"2011","Kingston upon Thames 010C","E01002966","Total",744,150,18,132,236,122,133,25,108
"2011","Kingston upon Thames 010D","E01002992","Total",438,96,8,88,108,62,69,9,60
"2011","Kingston upon Thames 011A","E01002921","Total",857,227,20,207,126,75,167,13,154
"2011","Kingston upon Thames 011B","E01002987","Total",844,240,15,225,97,68,171,3,168
"2011","Kingston upon Thames 011C","E01002988","Total",572,99,20,79,133,72,90,18,72
"2011","Kingston upon Thames 011D","E01002989","Total",909,118,8,110,177,113,76,12,64
"2011","Kingston upon Thames 012A","E01002975","Total",483,134,16,118,191,69,104,26,78
"2011","Kingston upon Thames 012B","E01002977","Total",654,229,49,180,237,100,181,43,138
"2011","Kingston upon Thames 012C","E01002980","Total",482,132,15,117,170,40,117,30,87
"2011","Kingston upon Thames 012D","E01002981","Total",518,147,16,131,196,58,127,28,99
"2011","Kingston upon Thames 012E","E01002984","Total",604,235,20,215,160,65,179,20,159
"2011","Kingston upon Thames 013A","E01002923","Total",777,382,42,340,159,66,282,26,256
"2011","Kingston upon Thames 013B","E01002925","Total",796,145,17,128,177,109,113,13,100
"2011","Kingston upon Thames 013C","E01002993","Total",867,216,15,201,115,77,142,13,129
"2011","Kingston upon Thames 013D","E01002995","Total",602,138,5,133,153,65,97,13,84
"2011","Kingston upon Thames 013E","E01002999","Total",743,188,25,163,126,78,109,10,99
"2011","Kingston upon Thames 014A","E01002915","Total",479,119,6,113,131,52,107,22,85
"2011","Kingston upon Thames 014B","E01002916","Total",520,153,11,142,178,60,115,25,90
"2011","Kingston upon Thames 014C","E01002917","Total",497,130,6,124,172,47,110,22,88
"2011","Kingston upon Thames 014D","E01002920","Total",593,179,8,171,222,92,138,26,112
"2011","Kingston upon Thames 014E","E01002924","Total",560,160,3,157,195,76,100,16,84
"2011","Kingston upon Thames 015A","E01002976","Total",641,159,24,135,238,111,124,28,96
"2011","Kingston upon Thames 015B","E01002978","Total",684,191,14,177,197,70,153,32,121
"2011","Kingston upon Thames 015C","E01002979","Total",614,136,13,123,182,65,118,23,95
"2011","Kingston upon Thames 015D","E01002982","Total",517,148,5,143,155,54,124,23,101
"2011","Kingston upon Thames 015E","E01002983","Total",595,161,8,153,208,53,136,34,102
"2011","Kingston upon Thames 016A","E01002994","Total",602,135,6,129,157,73,98,12,86
"2011","Kingston upon Thames 016B","E01002996","Total",589,110,8,102,212,100,99,22,77
"2011","Kingston upon Thames 016C","E01002997","Total",588,110,5,105,175,85,106,15,91
"2011","Kingston upon Thames 016D","E01002998","Total",612,166,42,124,239,119,132,33,99
"2011","Kingston upon Thames 016E","E01003002","Total",783,227,31,196,247,139,173,30,143
"2011","Kingston upon Thames 017A","E01002918","Total",615,129,28,101,285,120,138,44,94
"2011","Kingston upon Thames 017B","E01002919","Total",669,178,31,147,236,108,159,24,135
"2011","Kingston upon Thames 017C","E01003000","Total",587,173,20,153,204,77,147,31,116
"2011","Kingston upon Thames 017D","E01003001","Total",627,137,20,117,260,93,148,44,104
"2011","Kingston upon Thames 017E","E01003003","Total",574,129,20,109,191,77,115,30,85
"2011","Kingston upon Thames 018A","E01002939","Total",605,151,20,131,214,85,143,29,114
"2011","Kingston upon Thames 018B","E01002941","Total",628,231,12,219,170,49,197,34,163
"2011","Kingston upon Thames 018C","E01002942","Total",522,151,10,141,163,62,137,29,108
"2011","Kingston upon Thames 018D","E01003004","Total",591,131,16,115,224,82,132,30,102
"2011","Kingston upon Thames 018E","E01003005","Total",570,121,16,105,210,86,118,30,88
"2011","Kingston upon Thames 019A","E01002944","Total",508,113,26,87,194,84,83,29,54
"2011","Kingston upon Thames 019B","E01002945","Total",655,147,14,133,212,105,130,24,106
"2011","Kingston upon Thames 019C","E01002946","Total",603,144,17,127,190,81,124,24,100
"2011","Kingston upon Thames 019D","E01002947","Total",597,126,9,117,206,72,116,23,93
"2011","Kingston upon Thames 020A","E01002940","Total",604,178,30,148,239,85,167,47,120
"2011","Kingston upon Thames 020B","E01002943","Total",507,138,24,114,187,71,125,35,90
"2011","Kingston upon Thames 020C","E01002948","Total",784,199,34,165,306,122,182,53,129
"2011","Kingston upon Thames 020D","E01002949","Total",677,171,29,142,259,101,163,42,121
"2011","Kingston upon Thames 020E","E01002950","Total",719,236,56,180,240,123,162,31,131
"2011","Merton 001A","E01003472","Total",481,86,7,79,201,124,72,23,49
"2011","Merton 001B","E01003473","Total",505,71,9,62,160,85,73,13,60
"2011","Merton 001C","E01003474","Total",480,80,1,79,191,60,79,15,64
"2011","Merton 001D","E01003475","Total",1162,204,61,143,303,181,171,35,136
"2011","Merton 001E","E01003478","Total",602,102,8,94,227,135,81,17,64
"2011","Merton 002A","E01003460","Total",679,212,17,195,157,56,134,8,126
"2011","Merton 002B","E01003462","Total",599,193,10,183,178,76,122,14,108
"2011","Merton 002C","E01003464","Total",550,183,7,176,156,67,103,11,92
"2011","Merton 002D","E01003465","Total",472,113,10,103,162,47,75,10,65
"2011","Merton 003A","E01003400","Total",659,98,10,88,131,61,86,14,72
"2011","Merton 003B","E01003454","Total",587,112,9,103,141,66,83,11,72
"2011","Merton 003C","E01003456","Total",667,112,9,103,136,67,90,12,78
"2011","Merton 003D","E01003476","Total",482,85,24,61,198,87,69,13,56
"2011","Merton 003E","E01003477","Total",573,80,7,73,188,92,79,15,64
"2011","Merton 004A","E01003401","Total",647,174,2,172,140,83,122,11,111
"2011","Merton 004B","E01003402","Total",705,169,9,160,168,92,92,8,84
"2011","Merton 004C","E01003403","Total",710,174,13,161,141,81,111,12,99
"2011","Merton 004D","E01003404","Total",912,268,16,252,127,78,170,12,158
"2011","Merton 004E","E01003461","Total",712,150,9,141,135,57,87,9,78
"2011","Merton 005A","E01003367","Total",961,125,8,117,195,123,149,21,128
"2011","Merton 005B","E01003369","Total",768,118,17,101,151,96,142,21,121
"2011","Merton 005C","E01003370","Total",869,114,20,94,199,117,119,19,100
"2011","Merton 005D","E01003371","Total",626,109,14,95,135,76,117,14,103
"2011","Merton 005E","E01003455","Total",749,91,17,74,167,98,88,16,72
"2011","Merton 006A","E01003359","Total",816,212,21,191,173,94,179,28,151
"2011","Merton 006B","E01003360","Total",740,115,12,103,172,123,80,11,69
"2011","Merton 006C","E01003457","Total",623,94,8,86,232,154,86,21,65
"2011","Merton 006D","E01003458","Total",693,109,4,105,184,108,77,6,71
"2011","Merton 006E","E01003459","Total",956,200,39,161,240,128,169,23,146
"2011","Merton 007A","E01003394","Total",636,143,20,123,211,98,150,27,123
"2011","Merton 007B","E01003395","Total",503,122,8,114,178,75,127,32,95
"2011","Merton 007C","E01003396","Total",534,101,22,79,169,85,116,22,94
"2011","Merton 007D","E01003397","Total",557,130,27,103,186,81,127,26,101
"2011","Merton 007E","E01003398","Total",583,133,24,109,223,79,137,29,108
"2011","Merton 008A","E01003368","Total",578,121,23,98,172,81,132,30,102
"2011","Merton 008B","E01003372","Total",627,162,41,121,211,97,153,46,107
"2011","Merton 008C","E01003393","Total",646,132,21,111,180,111,86,17,69
"2011","Merton 008D","E01003406","Total",566,113,48,65,263,107,104,43,61
"2011","Merton 008E","E01003407","Total",768,105,21,84,210,111,100,22,78
"2011","Merton 009A","E01003355","Total",765,117,12,105,144,77,98,7,91
"2011","Merton 009B","E01003356","Total",696,131,8,123,215,109,112,22,90
"2011","Merton 009C","E01003358","Total",801,133,12,121,145,89,103,6,97
"2011","Merton 009D","E01003383","Total",692,93,6,87,150,90,67,8,59
"2011","Merton 009E","E01003384","Total",623,94,13,81,168,88,91,18,73
"2011","Merton 010A","E01003442","Total",701,169,12,157,190,83,112,19,93
"2011","Merton 010B","E01003443","Total",633,134,12,122,232,126,96,20,76
"2011","Merton 010C","E01003444","Total",695,157,10,147,199,97,97,12,85
"2011","Merton 010D","E01003445","Total",658,159,10,149,223,92,146,36,110
"2011","Merton 010E","E01003463","Total",459,122,11,111,170,52,77,18,59
"2011","Merton 011A","E01003380","Total",680,124,8,116,188,110,104,14,90
"2011","Merton 011B","E01003382","Total",676,138,9,129,165,102,115,14,101
"2011","Merton 011C","E01003385","Total",626,102,9,93,207,110,81,15,66
"2011","Merton 011D","E01003399","Total",618,110,4,106,121,53,105,11,94
"2011","Merton 011E","E01003423","Total",605,115,13,102,182,92,101,18,83
"2011","Merton 012A","E01003357","Total",750,226,53,173,225,101,179,35,144
"2011","Merton 012B","E01003376","Total",588,173,43,130,200,87,159,39,120
"2011","Merton 012C","E01003377","Total",526,159,56,103,257,109,140,46,94
"2011","Merton 012D","E01003408","Total",873,164,22,142,200,134,129,23,106
"2011","Merton 012E","E01003410","Total",630,121,29,92,210,104,127,41,86
"2011","Merton 013A","E01003386","Total",722,163,49,114,359,167,130,50,80
"2011","Merton 013B","E01003388","Total",590,223,36,187,192,78,191,33,158
"2011","Merton 013C","E01003389","Total",631,157,42,115,252,103,128,37,91
"2011","Merton 013D","E01003392","Total",501,93,18,75,163,66,95,22,73
"2011","Merton 013E","E01003409","Total",562,154,41,113,248,97,151,58,93
"2011","Merton 014A","E01003387","Total",614,195,40,155,233,98,174,43,131
"2011","Merton 014B","E01003391","Total",544,181,64,117,222,116,133,35,98
"2011","Merton 014C","E01003411","Total",719,204,43,161,263,122,155,33,122
"2011","Merton 014D","E01003412","Total",597,140,38,102,245,94,149,45,104
"2011","Merton 014E","E01003435","Total",490,127,17,110,169,65,118,30,88
"2011","Merton 015A","E01003361","Total",621,143,19,124,209,91,144,40,104
"2011","Merton 015B","E01003424","Total",574,174,7,167,203,74,123,16,107
"2011","Merton 015C","E01003425","Total",508,111,8,103,185,75,100,21,79
"2011","Merton 015D","E01003426","Total",609,166,15,151,199,66,133,23,110
"2011","Merton 015E","E01003428","Total",649,177,8,169,157,71,123,17,106
"2011","Merton 016A","E01003366","Total",595,136,15,121,154,63,143,22,121
"2011","Merton 016B","E01003381","Total",720,158,7,151,121,92,105,8,97
"2011","Merton 016C","E01003446","Total",799,147,13,134,147,68,122,14,108
"2011","Merton 016D","E01003447","Total",691,208,31,177,191,109,166,28,138
"2011","Merton 016E","E01003471","Total",604,173,19,154,177,88,108,16,92
"2011","Merton 017A","E01003413","Total",709,167,48,119,274,110,145,46,99
"2011","Merton 017B","E01003414","Total",539,145,20,125,208,73,152,43,109
"2011","Merton 017C","E01003415","Total",548,140,24,116,222,67,128,35,93
"2011","Merton 017D","E01003416","Total",534,142,12,130,185,61,129,30,99
"2011","Merton 017E","E01003434","Total",506,107,15,92,203,76,108,28,80
"2011","Merton 018A","E01003373","Total",536,172,70,102,241,123,146,55,91
"2011","Merton 018B","E01003378","Total",728,166,51,115,308,127,153,48,105
"2011","Merton 018C","E01003379","Total",742,285,47,238,282,149,226,35,191
"2011","Merton 018D","E01003390","Total",623,188,58,130,265,140,164,38,126
"2011","Merton 018E","E01003405","Total",630,194,32,162,227,106,176,35,141
"2011","Merton 019A","E01003429","Total",507,130,21,109,208,80,108,35,73
"2011","Merton 019B","E01003430","Total",545,167,49,118,245,119,117,40,77
"2011","Merton 019C","E01003431","Total",545,152,57,95,243,85,142,50,92
"2011","Merton 019D","E01003432","Total",508,154,66,88,267,103,138,56,82
"2011","Merton 019E","E01003433","Total",578,174,31,143,213,88,145,43,102
"2011","Merton 020A","E01003466","Total",599,168,14,154,200,90,133,22,111
"2011","Merton 020B","E01003467","Total",601,140,5,135,210,97,111,16,95
"2011","Merton 020C","E01003468","Total",630,144,12,132,227,107,111,19,92
"2011","Merton 020D","E01003469","Total",574,124,31,93,243,104,114,39,75
"2011","Merton 020E","E01003470","Total",607,120,15,105,235,97,107,24,83
"2011","Merton 021A","E01003362","Total",499,141,6,135,149,51,107,12,95
"2011","Merton 021B","E01003363","Total",590,156,10,146,216,82,137,29,108
"2011","Merton 021C","E01003364","Total",648,185,7,178,198,80,146,21,125
"2011","Merton 021D","E01003365","Total",497,149,9,140,152,47,117,21,96
"2011","Merton 021E","E01003421","Total",640,162,14,148,189,96,152,25,127
"2011","Merton 022A","E01003374","Total",546,187,39,148,198,96,141,34,107
"2011","Merton 022B","E01003375","Total",654,214,17,197,189,77,165,24,141
"2011","Merton 022C","E01003437","Total",764,260,20,240,212,95,201,33,168
"2011","Merton 022D","E01003440","Total",627,180,27,153,217,107,143,45,98
"2011","Merton 022E","E01003441","Total",617,167,49,118,254,109,147,50,97
"2011","Merton 023A","E01003427","Total",706,174,22,152,207,103,158,30,128
"2011","Merton 023B","E01003436","Total",588,183,33,150,212,106,139,36,103
"2011","Merton 023C","E01003439","Total",548,132,39,93,192,75,135,37,98
"2011","Merton 023D","E01003448","Total",648,195,51,144,252,117,174,46,128
"2011","Merton 023E","E01003453","Total",650,189,36,153,235,109,168,43,125
"2011","Merton 024A","E01003438","Total",650,214,50,164,247,91,169,40,129
"2011","Merton 024B","E01003449","Total",677,225,44,181,233,106,178,53,125
"2011","Merton 024C","E01003450","Total",597,182,40,142,255,105,142,39,103
"2011","Merton 024D","E01003451","Total",598,168,8,160,189,49,147,24,123
"2011","Merton 024E","E01003452","Total",806,302,50,252,260,102,253,46,207
"2011","Merton 025A","E01003417","Total",608,164,11,153,189,68,141,21,120
"2011","Merton 025B","E01003418","Total",531,128,9,119,180,55,115,23,92
"2011","Merton 025C","E01003419","Total",642,141,16,125,233,85,118,33,85
"2011","Merton 025D","E01003420","Total",506,119,14,105,199,85,111,23,88
"2011","Merton 025E","E01003422","Total",513,135,8,127,160,66,124,27,97
"2011","Redbridge 001A","E01003744","Total",592,178,4,174,135,42,120,20,100
"2011","Redbridge 001B","E01003745","Total",483,107,3,104,192,57,75,22,53
"2011","Redbridge 001C","E01003746","Total",661,217,4,213,154,63,137,18,119
"2011","Redbridge 001D","E01003747","Total",490,147,6,141,171,53,106,15,91
"2011","Redbridge 001E","E01003748","Total",572,167,7,160,176,61,117,21,96
"2011","Redbridge 001F","E01003749","Total",681,192,15,177,188,68,147,21,126
"2011","Redbridge 001G","E01003750","Total",798,273,12,261,170,62,213,13,200
"2011","Redbridge 002A","E01003720","Total",821,386,57,329,236,94,327,51,276
"2011","Redbridge 002B","E01003722","Total",690,235,55,180,252,101,219,60,159
"2011","Redbridge 002C","E01003723","Total",704,258,51,207,258,112,235,56,179
"2011","Redbridge 002D","E01003726","Total",649,272,69,203,242,109,206,48,158
"2011","Redbridge 003A","E01003721","Total",604,203,40,163,223,104,160,42,118
"2011","Redbridge 003B","E01003724","Total",511,138,23,115,203,88,121,29,92
"2011","Redbridge 003C","E01003725","Total",650,201,65,136,250,116,165,47,118
"2011","Redbridge 003D","E01003727","Total",655,257,54,203,236,101,216,54,162
"2011","Redbridge 004A","E01003654","Total",603,165,27,138,219,96,148,39,109
"2011","Redbridge 004B","E01003655","Total",642,165,26,139,196,81,132,24,108
"2011","Redbridge 004C","E01003658","Total",699,254,52,202,228,87,197,36,161
"2011","Redbridge 004D","E01003660","Total",663,135,18,117,236,101,114,28,86
"2011","Redbridge 005A","E01003656","Total",643,233,32,201,195,82,210,42,168
"2011","Redbridge 005B","E01003657","Total",870,263,38,225,275,117,196,32,164
"2011","Redbridge 005C","E01003659","Total",638,140,24,116,253,103,113,23,90
"2011","Redbridge 006A","E01003698","Total",519,132,27,105,184,55,118,26,92
"2011","Redbridge 006B","E01003699","Total",594,164,27,137,183,89,138,27,111
"2011","Redbridge 006C","E01003700","Total",849,247,41,206,284,113,251,61,190
"2011","Redbridge 006D","E01003701","Total",626,193,36,157,257,106,159,41,118
"2011","Redbridge 006E","E01003702","Total",744,215,26,189,216,104,167,25,142
"2011","Redbridge 006F","E01003703","Total",968,220,42,178,352,136,209,53,156
"2011","Redbridge 006G","E01003704","Total",666,240,70,170,266,95,208,71,137
"2011","Redbridge 007A","E01003668","Total",755,204,13,191,150,79,166,20,146
"2011","Redbridge 007B","E01003669","Total",606,118,8,110,208,77,115,32,83
"2011","Redbridge 007C","E01003670","Total",577,147,12,135,197,81,117,12,105
"2011","Redbridge 007D","E01003671","Total",552,119,4,115,220,89,106,18,88
"2011","Redbridge 007E","E01003672","Total",690,227,39,188,176,94,206,42,164
"2011","Redbridge 007F","E01003673","Total",789,136,16,120,223,108,114,27,87
"2011","Redbridge 007G","E01003674","Total",1000,191,19,172,232,130,152,18,134
"2011","Redbridge 008A","E01003707","Total",469,132,15,117,173,51,113,24,89
"2011","Redbridge 008B","E01003708","Total",613,250,65,185,219,90,186,40,146
"2011","Redbridge 008C","E01003709","Total",570,178,21,157,214,74,147,37,110
"2011","Redbridge 008D","E01003710","Total",507,155,17,138,171,48,158,33,125
"2011","Redbridge 009A","E01003759","Total",554,153,5,148,190,82,117,23,94
"2011","Redbridge 009B","E01003760","Total",661,148,30,118,273,112,129,40,89
"2011","Redbridge 009C","E01003761","Total",698,269,99,170,325,171,174,49,125
"2011","Redbridge 009D","E01003762","Total",656,128,17,111,241,94,130,30,100
"2011","Redbridge 009E","E01003763","Total",657,158,23,135,254,123,163,38,125
"2011","Redbridge 009F","E01003764","Total",835,161,22,139,241,121,160,38,122
"2011","Redbridge 009G","E01003765","Total",642,111,10,101,209,102,104,23,81
"2011","Redbridge 010A","E01003705","Total",802,231,48,183,324,123,174,41,133
"2011","Redbridge 010B","E01003706","Total",613,230,52,178,239,92,157,37,120
"2011","Redbridge 010C","E01003711","Total",662,221,25,196,224,81,185,39,146
"2011","Redbridge 010D","E01003712","Total",536,235,54,181,198,62,196,46,150
"2011","Redbridge 012A","E01003646","Total",572,180,19,161,212,86,164,35,129
"2011","Redbridge 012B","E01003648","Total",528,178,6,172,140,47,125,30,95
"2011","Redbridge 012C","E01003649","Total",521,130,17,113,226,85,149,42,107
"2011","Redbridge 012D","E01003651","Total",466,127,10,117,187,49,131,33,98
"2011","Redbridge 013A","E01003639","Total",665,226,40,186,242,116,191,37,154
"2011","Redbridge 013B","E01003640","Total",648,165,24,141,265,115,166,53,113
"2011","Redbridge 013C","E01003641","Total",530,114,25,89,233,92,112,34,78
"2011","Redbridge 013D","E01003642","Total",542,143,41,102,248,88,149,55,94
"2011","Redbridge 014A","E01003774","Total",867,207,15,192,191,105,153,21,132
"2011","Redbridge 014B","E01003775","Total",686,178,14,164,212,116,157,33,124
"2011","Redbridge 014C","E01003776","Total",932,415,33,382,164,82,333,24,309
"2011","Redbridge 014D","E01003777","Total",856,182,9,173,156,86,144,15,129
"2011","Redbridge 014E","E01003778","Total",879,216,14,202,188,88,178,16,162
"2011","Redbridge 014F","E01003779","Total",708,234,6,228,178,100,180,21,159
"2011","Redbridge 014G","E01003780","Total",507,130,8,122,184,52,114,17,97
"2011","Redbridge 015A","E01003647","Total",612,153,25,128,214,103,135,36,99
"2011","Redbridge 015B","E01003650","Total",580,220,29,191,199,81,181,40,141
"2011","Redbridge 015C","E01003652","Total",482,114,20,94,223,87,110,41,69
"2011","Redbridge 015D","E01003653","Total",516,124,23,101,215,95,106,35,71
"2011","Redbridge 017A","E01003638","Total",590,238,25,213,200,68,176,32,144
"2011","Redbridge 017B","E01003643","Total",622,193,29,164,256,108,170,43,127
"2011","Redbridge 017C","E01003644","Total",498,142,24,118,213,86,142,41,101
"2011","Redbridge 017D","E01003645","Total",910,148,49,99,412,231,161,58,103
"2011","Redbridge 018A","E01003789","Total",625,156,4,152,141,64,143,18,125
"2011","Redbridge 018B","E01003794","Total",544,151,24,127,217,89,108,25,83
"2011","Redbridge 018C","E01003795","Total",433,101,7,94,163,71,98,16,82
"2011","Redbridge 018D","E01003796","Total",638,161,13,148,198,83,157,33,124
"2011","Redbridge 019A","E01003661","Total",651,163,37,126,279,106,157,49,108
"2011","Redbridge 019B","E01003662","Total",741,198,62,136,274,151,175,49,126
"2011","Redbridge 019C","E01003663","Total",662,276,28,248,229,75,217,52,165
"2011","Redbridge 019D","E01003664","Total",575,148,36,112,244,113,133,37,96
"2011","Redbridge 019E","E01003665","Total",529,121,27,94,254,101,118,38,80
"2011","Redbridge 019F","E01003666","Total",935,253,110,143,417,245,180,60,120
"2011","Redbridge 019H","E01033590","Total",434,112,56,56,198,122,70,30,40
"2011","Redbridge 019I","E01033592","Total",633,122,43,79,292,136,133,50,83
"2011","Redbridge 020A","E01003751","Total",611,164,33,131,273,123,148,44,104
"2011","Redbridge 020B","E01003753","Total",659,164,41,123,299,128,159,54,105
"2011","Redbridge 020C","E01003754","Total",533,173,24,149,208,82,167,32,135
"2011","Redbridge 020D","E01003757","Total",622,155,51,104,311,120,142,54,88
"2011","Redbridge 022A","E01003769","Total",557,177,63,114,247,137,121,35,86
"2011","Redbridge 022B","E01003770","Total",848,185,43,142,364,158,180,57,123
"2011","Redbridge 022C","E01003771","Total",581,161,68,93,296,155,127,50,77
"2011","Redbridge 022D","E01003773","Total",579,166,36,130,247,115,131,37,94
"2011","Redbridge 023A","E01003752","Total",838,166,35,131,301,125,175,51,124
"2011","Redbridge 023B","E01003755","Total",571,118,30,88,317,127,147,63,84
"2011","Redbridge 023C","E01003756","Total",600,152,36,116,306,108,167,69,98
"2011","Redbridge 023D","E01003758","Total",810,222,116,106,480,240,178,82,96
"2011","Redbridge 024A","E01003766","Total",548,135,41,94,257,103,148,59,89
"2011","Redbridge 024B","E01003767","Total",567,133,42,91,243,129,119,40,79
"2011","Redbridge 024C","E01003768","Total",569,182,59,123,231,118,139,41,98
"2011","Redbridge 024D","E01003772","Total",524,153,42,111,228,90,134,35,99
"2011","Redbridge 026A","E01003781","Total",602,153,36,117,229,123,126,30,96
"2011","Redbridge 026B","E01003782","Total",518,116,37,79,248,144,138,61,77
"2011","Redbridge 026C","E01003786","Total",442,108,17,91,196,70,112,40,72
"2011","Redbridge 026D","E01003787","Total",469,122,26,96,209,93,127,52,75
"2011","Redbridge 027A","E01003790","Total",557,164,17,147,190,77,161,33,128
"2011","Redbridge 027B","E01003791","Total",540,119,7,112,169,71,122,29,93
"2011","Redbridge 027C","E01003792","Total",508,102,6,96,197,71,107,32,75
"2011","Redbridge 027D","E01003793","Total",760,273,39,234,192,79,238,39,199
"2011","Redbridge 029A","E01003783","Total",858,315,94,221,333,205,197,57,140
"2011","Redbridge 029B","E01003784","Total",546,125,37,88,249,127,125,47,78
"2011","Redbridge 029C","E01003785","Total",704,192,52,140,298,180,142,46,96
"2011","Redbridge 029D","E01003788","Total",645,171,59,112,267,178,138,37,101
"2011","Redbridge 030A","E01003683","Total",576,169,87,82,295,145,135,59,76
"2011","Redbridge 030B","E01003684","Total",496,127,42,85,257,110,119,47,72
"2011","Redbridge 030C","E01003685","Total",508,142,54,88,238,112,151,63,88
"2011","Redbridge 030D","E01003686","Total",533,143,50,93,284,142,130,51,79
"2011","Redbridge 030F","E01003688","Total",532,165,57,108,231,133,141,59,82
"2011","Redbridge 030G","E01003689","Total",508,204,72,132,215,120,163,43,120
"2011","Redbridge 030H","E01033589","Total",660,116,48,68,282,212,63,26,37
"2011","Redbridge 030I","E01033591","Total",630,203,70,133,281,154,142,45,97
"2011","Redbridge 031A","E01003737","Total",575,201,33,168,226,101,154,42,112
"2011","Redbridge 031B","E01003738","Total",646,173,26,147,269,105,166,56,110
"2011","Redbridge 031C","E01003739","Total",658,142,49,93,323,153,136,61,75
"2011","Redbridge 031D","E01003740","Total",621,156,32,124,260,101,196,65,131
"2011","Redbridge 031E","E01003741","Total",643,242,25,217,217,81,203,39,164
"2011","Redbridge 031F","E01003742","Total",618,132,49,83,328,141,125,52,73
"2011","Redbridge 031G","E01003743","Total",496,136,48,88,249,94,134,56,78
"2011","Redbridge 032A","E01003728","Total",810,209,64,145,339,188,170,48,122
"2011","Redbridge 032B","E01003729","Total",526,216,65,151,227,129,154,51,103
"2011","Redbridge 032C","E01003730","Total",416,118,66,52,233,116,99,53,46
"2011","Redbridge 032D","E01003732","Total",592,239,146,93,332,197,124,57,67
"2011","Redbridge 032E","E01003733","Total",507,152,68,84,245,118,116,43,73
"2011","Redbridge 033A","E01003731","Total",447,157,53,104,205,85,131,41,90
"2011","Redbridge 033B","E01003734","Total",517,146,41,105,248,128,134,48,86
"2011","Redbridge 033C","E01003735","Total",811,391,204,187,432,152,235,73,162
"2011","Redbridge 033D","E01003736","Total",475,117,72,45,278,135,98,46,52
"2011","Redbridge 034A","E01003713","Total",481,122,36,86,219,95,98,36,62
"2011","Redbridge 034B","E01003714","Total",642,162,58,104,311,162,166,54,112
"2011","Redbridge 034C","E01003715","Total",564,152,52,100,259,116,142,48,94
"2011","Redbridge 034D","E01003716","Total",521,144,36,108,214,103,149,44,105
"2011","Redbridge 034E","E01003718","Total",630,146,49,97,284,164,134,55,79
"2011","Redbridge 034F","E01003719","Total",633,178,46,132,254,118,141,37,104
"2011","Redbridge 034G","E01032581","Total",699,208,65,143,249,123,162,56,106
"2011","Redbridge 035A","E01003690","Total",608,188,31,157,185,92,136,32,104
"2011","Redbridge 035B","E01003691","Total",413,97,23,74,189,75,124,46,78
"2011","Redbridge 035C","E01003692","Total",501,130,37,93,210,105,109,35,74
"2011","Redbridge 035D","E01003693","Total",431,90,15,75,179,65,98,29,69
"2011","Redbridge 035E","E01003694","Total",448,135,18,117,167,73,143,35,108
"2011","Redbridge 035F","E01003695","Total",534,138,30,108,199,96,133,44,89
"2011","Redbridge 035G","E01003696","Total",593,157,25,132,212,83,153,46,107
"2011","Redbridge 035H","E01003697","Total",492,114,19,95,206,89,103,24,79
"2011","Redbridge 036A","E01003675","Total",490,124,17,107,212,74,134,41,93
"2011","Redbridge 036B","E01003676","Total",495,116,17,99,232,77,137,52,85
"2011","Redbridge 036C","E01003677","Total",494,144,9,135,180,55,121,33,88
"2011","Redbridge 036D","E01003678","Total",479,99,18,81,219,75,116,39,77
"2011","Redbridge 036E","E01003679","Total",493,107,11,96,202,56,127,41,86
"2011","Redbridge 036F","E01003680","Total",475,86,15,71,233,68,101,41,60
"2011","Redbridge 036G","E01003681","Total",683,249,33,216,253,84,214,46,168
"2011","Redbridge 036H","E01003682","Total",493,89,10,79,234,64,120,46,74
"2011","Richmond upon Thames 001A","E01003797","Total",523,142,10,132,212,72,87,15,72
"2011","Richmond upon Thames 001B","E01003798","Total",691,189,9,180,178,72,150,17,133
"2011","Richmond upon Thames 001C","E01003799","Total",653,131,16,115,221,113,99,14,85
"2011","Richmond upon Thames 001D","E01003800","Total",640,185,37,148,210,70,122,30,92
"2011","Richmond upon Thames 001E","E01003801","Total",534,110,8,102,148,69,75,14,61
"2011","Richmond upon Thames 001F","E01003802","Total",623,132,14,118,152,67,68,8,60
"2011","Richmond upon Thames 001G","E01003803","Total",632,227,39,188,183,64,197,29,168
"2011","Richmond upon Thames 002A","E01003846","Total",628,130,9,121,261,101,107,21,86
"2011","Richmond upon Thames 002B","E01003847","Total",842,234,6,228,141,73,146,13,133
"2011","Richmond upon Thames 002C","E01003849","Total",653,149,11,138,180,89,107,21,86
"2011","Richmond upon Thames 002D","E01003851","Total",691,160,11,149,233,97,72,9,63
"2011","Richmond upon Thames 002E","E01003860","Total",819,147,14,133,169,106,104,9,95
"2011","Richmond upon Thames 002F","E01003864","Total",671,168,11,157,159,70,135,23,112
"2011","Richmond upon Thames 003A","E01003852","Total",652,189,18,171,130,61,127,13,114
"2011","Richmond upon Thames 003B","E01003853","Total",622,188,24,164,185,81,128,25,103
"2011","Richmond upon Thames 003C","E01003854","Total",653,147,8,139,173,98,112,13,99
"2011","Richmond upon Thames 003D","E01003855","Total",831,235,39,196,195,105,167,30,137
"2011","Richmond upon Thames 003E","E01003856","Total",749,117,22,95,192,122,100,10,90
"2011","Richmond upon Thames 003F","E01003857","Total",756,151,19,132,255,146,130,28,102
"2011","Richmond upon Thames 003G","E01003858","Total",678,125,13,112,259,157,91,19,72
"2011","Richmond upon Thames 004A","E01003848","Total",817,160,26,134,234,130,125,34,91
"2011","Richmond upon Thames 004C","E01003861","Total",855,172,21,151,184,108,122,13,109
"2011","Richmond upon Thames 004D","E01003862","Total",627,157,24,133,160,76,137,22,115
"2011","Richmond upon Thames 004E","E01003863","Total",639,217,13,204,170,80,182,24,158
"2011","Richmond upon Thames 004F","E01003865","Total",529,148,18,130,184,79,120,15,105
"2011","Richmond upon Thames 004G","E01033570","Total",709,124,38,86,221,119,90,30,60
"2011","Richmond upon Thames 004H","E01033571","Total",624,176,19,157,201,61,140,26,114
"2011","Richmond upon Thames 005A","E01003804","Total",768,194,20,174,248,121,139,19,120
"2011","Richmond upon Thames 005B","E01003807","Total",817,187,13,174,208,103,130,18,112
"2011","Richmond upon Thames 005C","E01003808","Total",793,172,15,157,259,142,117,21,96
"2011","Richmond upon Thames 005D","E01003809","Total",657,156,12,144,230,96,111,11,100
"2011","Richmond upon Thames 005E","E01003859","Total",631,151,13,138,238,111,113,24,89
"2011","Richmond upon Thames 006A","E01003873","Total",850,190,11,179,175,96,122,8,114
"2011","Richmond upon Thames 006B","E01003874","Total",787,145,6,139,150,93,84,6,78
"2011","Richmond upon Thames 006C","E01003875","Total",681,193,13,180,214,79,127,14,113
"2011","Richmond upon Thames 006D","E01003878","Total",648,211,18,193,164,58,159,19,140
"2011","Richmond upon Thames 007A","E01003866","Total",642,113,9,104,255,145,88,15,73
"2011","Richmond upon Thames 007B","E01003868","Total",639,86,10,76,200,108,77,20,57
"2011","Richmond upon Thames 007C","E01003871","Total",642,106,24,82,265,130,97,31,66
"2011","Richmond upon Thames 007D","E01003872","Total",686,110,7,103,160,70,82,7,75
"2011","Richmond upon Thames 008A","E01003821","Total",784,180,16,164,131,68,100,16,84
"2011","Richmond upon Thames 008B","E01003876","Total",865,210,8,202,113,49,123,6,117
"2011","Richmond upon Thames 008C","E01003877","Total",724,197,8,189,166,89,111,7,104
"2011","Richmond upon Thames 008D","E01003879","Total",613,109,10,99,165,79,67,11,56
"2011","Richmond upon Thames 009A","E01003892","Total",924,204,12,192,233,124,125,15,110
"2011","Richmond upon Thames 009B","E01003893","Total",759,176,8,168,155,83,118,8,110
"2011","Richmond upon Thames 009C","E01003894","Total",760,130,7,123,183,78,92,7,85
"2011","Richmond upon Thames 009D","E01003895","Total",766,174,16,158,211,103,126,16,110
"2011","Richmond upon Thames 010A","E01003905","Total",548,129,11,118,178,72,114,32,82
"2011","Richmond upon Thames 010B","E01003906","Total",649,168,21,147,197,97,141,21,120
"2011","Richmond upon Thames 010C","E01003907","Total",673,207,29,178,225,106,180,35,145
"2011","Richmond upon Thames 010D","E01003908","Total",668,170,9,161,238,98,150,27,123
"2011","Richmond upon Thames 010E","E01003909","Total",606,200,18,182,183,64,140,19,121
"2011","Richmond upon Thames 011A","E01003867","Total",576,126,13,113,193,87,92,11,81
"2011","Richmond upon Thames 011B","E01003869","Total",693,140,11,129,189,78,109,17,92
"2011","Richmond upon Thames 011C","E01003870","Total",721,118,16,102,273,119,115,27,88
"2011","Richmond upon Thames 011D","E01003910","Total",670,218,4,214,191,88,176,21,155
"2011","Richmond upon Thames 012A","E01003805","Total",593,150,10,140,239,109,95,15,80
"2011","Richmond upon Thames 012B","E01003806","Total",523,117,10,107,218,76,80,13,67
"2011","Richmond upon Thames 012C","E01003816","Total",640,206,22,184,255,82,142,24,118
"2011","Richmond upon Thames 012D","E01003817","Total",867,297,18,279,169,78,212,17,195
"2011","Richmond upon Thames 013A","E01003840","Total",560,140,34,106,236,103,126,32,94
"2011","Richmond upon Thames 013B","E01003841","Total",811,301,71,230,298,142,209,48,161
"2011","Richmond upon Thames 013C","E01003842","Total",619,173,38,135,228,89,163,43,120
"2011","Richmond upon Thames 013D","E01003843","Total",753,235,41,194,271,118,195,48,147
"2011","Richmond upon Thames 013E","E01003844","Total",553,165,11,154,173,54,119,18,101
"2011","Richmond upon Thames 013F","E01003845","Total",622,219,16,203,171,59,166,29,137
"2011","Richmond upon Thames 014A","E01003882","Total",793,143,10,133,245,121,121,20,101
"2011","Richmond upon Thames 014B","E01003883","Total",836,140,5,135,217,160,120,14,106
"2011","Richmond upon Thames 014C","E01003896","Total",796,139,10,129,153,74,96,16,80
"2011","Richmond upon Thames 014D","E01003897","Total",848,158,21,137,190,100,113,17,96
"2011","Richmond upon Thames 015A","E01003898","Total",675,106,9,97,192,97,95,11,84
"2011","Richmond upon Thames 015B","E01003899","Total",632,133,9,124,186,91,116,17,99
"2011","Richmond upon Thames 015C","E01003900","Total",614,192,26,166,214,73,159,32,127
"2011","Richmond upon Thames 015D","E01003901","Total",605,114,8,106,247,113,119,28,91
"2011","Richmond upon Thames 015E","E01003902","Total",503,113,12,101,183,77,97,22,75
"2011","Richmond upon Thames 015F","E01003903","Total",580,131,25,106,248,105,136,36,100
"2011","Richmond upon Thames 015G","E01003904","Total",671,159,19,140,217,121,131,28,103
"2011","Richmond upon Thames 016A","E01003880","Total",581,94,6,88,204,73,93,21,72
"2011","Richmond upon Thames 016B","E01003881","Total",492,123,7,116,138,47,75,12,63
"2011","Richmond upon Thames 016C","E01003884","Total",698,176,6,170,178,63,137,17,120
"2011","Richmond upon Thames 016D","E01003885","Total",647,137,20,117,225,88,105,21,84
"2011","Richmond upon Thames 017A","E01003818","Total",661,189,16,173,207,78,125,25,100
"2011","Richmond upon Thames 017B","E01003819","Total",747,262,57,205,217,97,214,45,169
"2011","Richmond upon Thames 017C","E01003820","Total",751,201,34,167,261,119,187,38,149
"2011","Richmond upon Thames 018A","E01003811","Total",640,101,4,97,241,147,90,17,73
"2011","Richmond upon Thames 018B","E01003812","Total",772,143,19,124,260,120,142,26,116
"2011","Richmond upon Thames 018C","E01003890","Total",642,130,9,121,204,84,91,16,75
"2011","Richmond upon Thames 018D","E01003891","Total",826,225,4,221,169,60,132,16,116
"2011","Richmond upon Thames 019A","E01003810","Total",613,100,7,93,238,99,102,19,83
"2011","Richmond upon Thames 019B","E01003813","Total",643,170,4,166,217,72,123,19,104
"2011","Richmond upon Thames 019C","E01003814","Total",760,207,14,193,192,72,166,21,145
"2011","Richmond upon Thames 019D","E01003815","Total",824,204,22,182,254,149,150,16,134
"2011","Richmond upon Thames 020A","E01003828","Total",630,184,15,169,176,64,129,11,118
"2011","Richmond upon Thames 020B","E01003829","Total",686,233,39,194,229,97,189,42,147
"2011","Richmond upon Thames 020C","E01003830","Total",734,211,24,187,236,87,143,26,117
"2011","Richmond upon Thames 020D","E01003831","Total",697,197,28,169,224,99,157,29,128
"2011","Richmond upon Thames 020E","E01003832","Total",681,267,38,229,178,73,222,34,188
"2011","Richmond upon Thames 020F","E01003833","Total",658,189,25,164,163,86,152,19,133
"2011","Richmond upon Thames 021A","E01003886","Total",684,115,8,107,249,104,104,23,81
"2011","Richmond upon Thames 021B","E01003887","Total",789,161,6,155,212,104,127,14,113
"2011","Richmond upon Thames 021C","E01003888","Total",896,287,22,265,212,97,231,24,207
"2011","Richmond upon Thames 021D","E01003889","Total",779,187,5,182,196,92,124,14,110
"2011","Richmond upon Thames 022A","E01003834","Total",829,264,13,251,148,76,152,16,136
"2011","Richmond upon Thames 022B","E01003835","Total",537,96,10,86,239,83,80,18,62
"2011","Richmond upon Thames 022C","E01003836","Total",613,227,14,213,201,73,188,20,168
"2011","Richmond upon Thames 022D","E01003837","Total",802,260,18,242,242,87,160,27,133
"2011","Richmond upon Thames 022E","E01003838","Total",758,158,20,138,250,99,117,20,97
"2011","Richmond upon Thames 022F","E01003839","Total",916,273,57,216,256,149,185,25,160
"2011","Richmond upon Thames 023A","E01003822","Total",516,144,4,140,191,50,107,19,88
"2011","Richmond upon Thames 023B","E01003823","Total",796,199,17,182,153,63,138,17,121
"2011","Richmond upon Thames 023C","E01003824","Total",649,181,14,167,234,102,123,17,106
"2011","Richmond upon Thames 023D","E01003825","Total",653,158,12,146,257,123,132,34,98
"2011","Richmond upon Thames 023E","E01003826","Total",760,269,41,228,237,128,217,42,175
"2011","Richmond upon Thames 023F","E01003827","Total",800,173,20,153,235,127,146,21,125
"2011","Sutton 001A","E01004125","Total",630,208,34,174,247,101,200,50,150
"2011","Sutton 001B","E01004183","Total",663,180,43,137,260,96,180,46,134
"2011","Sutton 001C","E01004184","Total",598,214,75,139,283,139,171,50,121
"2011","Sutton 001D","E01004185","Total",565,167,58,109,250,87,151,59,92
"2011","Sutton 001E","E01004189","Total",750,243,53,190,298,131,221,51,170
"2011","Sutton 002A","E01004123","Total",838,242,66,176,336,138,191,54,137
"2011","Sutton 002B","E01004124","Total",655,178,51,127,291,127,156,50,106
"2011","Sutton 002C","E01004126","Total",564,171,60,111,253,114,158,48,110
"2011","Sutton 002D","E01004128","Total",528,174,47,127,215,73,140,43,97
"2011","Sutton 002E","E01004129","Total",750,304,58,246,251,110,234,39,195
"2011","Sutton 003A","E01004130","Total",644,188,17,171,204,56,166,24,142
"2011","Sutton 003B","E01004131","Total",613,159,21,138,226,68,145,27,118
"2011","Sutton 003C","E01004134","Total",555,138,19,119,180,75,127,27,100
"2011","Sutton 003D","E01004135","Total",517,128,11,117,183,58,124,28,96
"2011","Sutton 003E","E01004136","Total",550,128,9,119,191,59,146,36,110
"2011","Sutton 004A","E01004164","Total",639,170,16,154,175,74,127,18,109
"2011","Sutton 004B","E01004166","Total",658,166,11,155,171,81,142,20,122
"2011","Sutton 004C","E01004169","Total",460,116,33,83,173,92,80,20,60
"2011","Sutton 004D","E01004186","Total",790,129,33,96,257,143,122,37,85
"2011","Sutton 004E","E01004188","Total",724,167,50,117,247,127,116,20,96
"2011","Sutton 005A","E01004127","Total",630,161,33,128,265,98,146,40,106
"2011","Sutton 005B","E01004163","Total",615,156,18,138,207,76,158,38,120
"2011","Sutton 005C","E01004165","Total",705,169,27,142,234,101,159,41,118
"2011","Sutton 005D","E01004167","Total",527,186,27,159,190,72,131,29,102
"2011","Sutton 005E","E01004187","Total",640,193,29,164,238,92,168,34,134
"2011","Sutton 006A","E01004117","Total",508,104,4,100,210,65,98,21,77
"2011","Sutton 006B","E01004121","Total",627,182,10,172,189,87,151,28,123
"2011","Sutton 006C","E01004192","Total",753,142,30,112,282,129,135,38,97
"2011","Sutton 006D","E01004193","Total",923,173,49,124,398,217,140,37,103
"2011","Sutton 006E","E01004195","Total",661,166,17,149,215,87,135,26,109
"2011","Sutton 007A","E01004144","Total",633,166,16,150,199,68,140,32,108
"2011","Sutton 007B","E01004145","Total",786,178,24,154,299,115,174,44,130
"2011","Sutton 007C","E01004146","Total",686,195,31,164,250,116,152,32,120
"2011","Sutton 007D","E01004147","Total",603,180,12,168,198,68,140,23,117
"2011","Sutton 008A","E01004116","Total",640,234,6,228,173,62,190,27,163
"2011","Sutton 008B","E01004122","Total",517,137,5,132,170,54,108,24,84
"2011","Sutton 008C","E01004190","Total",499,127,10,117,174,47,101,19,82
"2011","Sutton 008D","E01004191","Total",657,204,19,185,202,77,134,25,109
"2011","Sutton 008E","E01004194","Total",609,159,15,144,174,83,136,22,114
"2011","Sutton 008F","E01004196","Total",567,165,15,150,179,69,121,26,95
"2011","Sutton 009A","E01004115","Total",664,161,15,146,244,94,138,37,101
"2011","Sutton 009B","E01004118","Total",669,206,21,185,199,63,157,27,130
"2011","Sutton 009C","E01004119","Total",506,113,7,106,189,57,95,27,68
"2011","Sutton 009D","E01004132","Total",514,100,5,95,233,82,98,21,77
"2011","Sutton 009E","E01004133","Total",533,126,11,115,230,70,101,24,77
"2011","Sutton 010A","E01004171","Total",558,150,6,144,203,95,135,31,104
"2011","Sutton 010B","E01004172","Total",748,238,56,182,217,107,165,41,124
"2011","Sutton 010C","E01004173","Total",520,148,15,133,164,53,149,26,123
"2011","Sutton 010D","E01004175","Total",690,192,28,164,231,92,146,28,118
"2011","Sutton 010E","E01004176","Total",583,115,18,97,204,96,95,22,73
"2011","Sutton 011A","E01004076","Total",616,162,26,136,214,83,144,31,113
"2011","Sutton 011B","E01004077","Total",629,182,18,164,207,78,169,31,138
"2011","Sutton 011C","E01004078","Total",686,159,27,132,237,111,157,38,119
"2011","Sutton 011D","E01004079","Total",489,107,4,103,178,46,106,18,88
"2011","Sutton 011E","E01004080","Total",506,126,6,120,162,46,98,18,80
"2011","Sutton 011F","E01004081","Total",615,143,12,131,222,98,130,27,103
"2011","Sutton 011G","E01004082","Total",496,104,7,97,196,61,115,30,85
"2011","Sutton 012A","E01004137","Total",763,169,24,145,194,106,139,24,115
"2011","Sutton 012B","E01004140","Total",746,283,43,240,170,80,235,32,203
"2011","Sutton 012C","E01004141","Total",724,257,44,213,194,92,196,26,170
"2011","Sutton 012D","E01004142","Total",1052,368,61,307,268,131,265,31,234
"2011","Sutton 012E","E01004149","Total",813,303,35,268,200,87,204,29,175
"2011","Sutton 013A","E01004101","Total",531,164,9,155,176,59,106,18,88
"2011","Sutton 013B","E01004103","Total",734,146,20,126,205,89,122,19,103
"2011","Sutton 013C","E01004138","Total",697,146,26,120,218,108,116,22,94
"2011","Sutton 013D","E01004139","Total",595,130,20,110,182,89,110,13,97
"2011","Sutton 013E","E01004168","Total",579,135,6,129,205,63,117,20,97
"2011","Sutton 014A","E01004143","Total",626,157,28,129,216,89,128,31,97
"2011","Sutton 014B","E01004148","Total",643,186,41,145,256,122,157,45,112
"2011","Sutton 014C","E01004159","Total",629,165,16,149,195,73,139,29,110
"2011","Sutton 014D","E01004160","Total",672,129,20,109,226,105,120,34,86
"2011","Sutton 014E","E01004161","Total",594,101,10,91,209,80,98,19,79
"2011","Sutton 015A","E01004097","Total",625,127,12,115,236,96,105,30,75
"2011","Sutton 015B","E01004098","Total",504,126,15,111,161,53,112,19,93
"2011","Sutton 015C","E01004099","Total",711,185,20,165,188,106,148,27,121
"2011","Sutton 015D","E01004100","Total",536,149,10,139,164,62,129,27,102
"2011","Sutton 015E","E01004102","Total",556,145,9,136,161,69,132,21,111
"2011","Sutton 016A","E01004110","Total",790,207,22,185,227,87,159,29,130
"2011","Sutton 016B","E01004111","Total",578,179,20,159,222,76,123,22,101
"2011","Sutton 016C","E01004112","Total",668,197,6,191,208,56,137,22,115
"2011","Sutton 016D","E01004120","Total",547,148,9,139,198,49,117,30,87
"2011","Sutton 016E","E01004157","Total",452,110,5,105,162,55,85,17,68
"2011","Sutton 017A","E01004087","Total",522,144,3,141,159,38,121,16,105
"2011","Sutton 017B","E01004170","Total",751,167,15,152,208,87,147,27,120
"2011","Sutton 017C","E01004174","Total",664,190,15,175,192,79,143,20,123
"2011","Sutton 017D","E01004178","Total",950,267,24,243,247,111,199,35,164
"2011","Sutton 017E","E01004179","Total",599,131,9,122,209,75,114,23,91
"2011","Sutton 018A","E01004152","Total",849,297,35,262,155,76,198,12,186
"2011","Sutton 018B","E01004155","Total",822,192,11,181,183,104,134,19,115
"2011","Sutton 018C","E01004156","Total",892,242,21,221,188,122,161,14,147
"2011","Sutton 018D","E01004158","Total",696,153,10,143,160,66,119,23,96
"2011","Sutton 018E","E01004162","Total",745,200,22,178,179,107,137,19,118
"2011","Sutton 019A","E01004083","Total",612,237,60,177,200,73,197,43,154
"2011","Sutton 019B","E01004086","Total",592,147,21,126,218,89,153,43,110
"2011","Sutton 019C","E01004088","Total",733,295,95,200,305,126,228,67,161
"2011","Sutton 019D","E01004089","Total",549,192,71,121,231,122,149,37,112
"2011","Sutton 019E","E01004182","Total",653,225,63,162,260,113,168,39,129
"2011","Sutton 020A","E01004104","Total",551,159,4,155,185,64,87,17,70
"2011","Sutton 020B","E01004107","Total",619,174,26,148,228,102,155,41,114
"2011","Sutton 020C","E01004177","Total",911,432,49,383,193,102,313,21,292
"2011","Sutton 020D","E01004180","Total",616,187,9,178,195,39,123,26,97
"2011","Sutton 020E","E01004181","Total",756,217,28,189,181,79,190,33,157
"2011","Sutton 021A","E01004090","Total",540,245,54,191,171,86,166,23,143
"2011","Sutton 021B","E01004096","Total",756,204,27,177,167,99,149,24,125
"2011","Sutton 021C","E01004150","Total",936,377,19,358,142,73,257,14,243
"2011","Sutton 021D","E01004151","Total",790,153,22,131,178,93,116,26,90
"2011","Sutton 021E","E01004153","Total",903,258,27,231,201,120,175,28,147
"2011","Sutton 022A","E01004091","Total",474,136,6,130,141,36,104,15,89
"2011","Sutton 022B","E01004092","Total",585,174,7,167,159,44,120,19,101
"2011","Sutton 022C","E01004105","Total",647,136,17,119,267,96,114,33,81
"2011","Sutton 022D","E01004106","Total",522,121,2,119,181,48,95,19,76
"2011","Sutton 022E","E01004154","Total",561,156,2,154,162,53,115,14,101
"2011","Sutton 024A","E01004084","Total",504,146,6,140,164,37,111,23,88
"2011","Sutton 024B","E01004085","Total",582,153,12,141,179,49,120,25,95
"2011","Sutton 024C","E01004108","Total",595,129,18,111,244,83,117,35,82
"2011","Sutton 024D","E01004109","Total",638,187,29,158,223,83,176,40,136
"2011","Sutton 025A","E01004093","Total",598,143,4,139,190,83,103,18,85
"2011","Sutton 025B","E01004094","Total",748,181,14,167,244,114,144,22,122
"2011","Sutton 025C","E01004095","Total",635,151,7,144,164,72,92,14,78
"2011","Sutton 025D","E01004114","Total",595,178,7,171,191,50,131,24,107
"2011","Sutton 025E","E01032623","Total",619,199,3,196,211,46,123,26,97
"2011","Waltham Forest 001A","E01004349","Total",547,203,40,163,191,60,160,32,128
"2011","Waltham Forest 001B","E01004350","Total",915,524,42,482,189,75,363,28,335
"2011","Waltham Forest 001C","E01004351","Total",645,215,23,192,205,65,182,38,144
"2011","Waltham Forest 001D","E01004356","Total",590,195,37,158,224,63,160,37,123
"2011","Waltham Forest 001E","E01004357","Total",574,182,25,157,185,71,159,32,127
"2011","Waltham Forest 002A","E01004352","Total",813,256,13,243,181,64,187,20,167
"2011","Waltham Forest 002B","E01004353","Total",798,290,26,264,198,68,214,27,187
"2011","Waltham Forest 002C","E01004354","Total",749,205,24,181,225,105,162,29,133
"2011","Waltham Forest 002D","E01004358","Total",788,319,37,282,199,79,221,18,203
"2011","Waltham Forest 002E","E01004359","Total",610,175,21,154,222,61,145,31,114
"2011","Waltham Forest 003A","E01004384","Total",695,244,56,188,266,119,204,54,150
"2011","Waltham Forest 003B","E01004385","Total",650,288,47,241,177,63,205,33,172
"2011","Waltham Forest 003C","E01004386","Total",642,191,12,179,189,56,168,28,140
"2011","Waltham Forest 003D","E01004389","Total",706,269,54,215,218,83,214,41,173
"2011","Waltham Forest 003E","E01004390","Total",652,248,57,191,223,104,199,44,155
"2011","Waltham Forest 004A","E01004355","Total",673,232,50,182,223,100,171,41,130
"2011","Waltham Forest 004B","E01004360","Total",492,150,17,133,149,45,111,24,87
"2011","Waltham Forest 004C","E01004413","Total",685,292,53,239,218,87,236,32,204
"2011","Waltham Forest 004D","E01004415","Total",583,198,40,158,215,71,165,36,129
"2011","Waltham Forest 004E","E01004416","Total",632,171,27,144,226,81,164,51,113
"2011","Waltham Forest 005A","E01004361","Total",492,124,7,117,148,57,114,28,86
"2011","Waltham Forest 005B","E01004414","Total",615,218,33,185,217,83,160,36,124
"2011","Waltham Forest 005C","E01004417","Total",650,237,33,204,202,76,187,31,156
"2011","Waltham Forest 005D","E01004451","Total",641,199,27,172,220,64,183,29,154
"2011","Waltham Forest 005E","E01004452","Total",692,247,36,211,207,95,181,27,154
"2011","Waltham Forest 006A","E01004450","Total",605,167,16,151,217,70,129,26,103
"2011","Waltham Forest 006B","E01004453","Total",658,182,48,134,220,102,152,36,116
"2011","Waltham Forest 006C","E01004454","Total",640,218,35,183,228,113,193,36,157
"2011","Waltham Forest 006D","E01004455","Total",544,166,42,124,227,89,134,45,89
"2011","Waltham Forest 006E","E01004456","Total",539,201,68,133,229,80,184,53,131
"2011","Waltham Forest 007A","E01004379","Total",523,120,10,110,196,59,122,26,96
"2011","Waltham Forest 007B","E01004380","Total",607,187,32,155,214,79,159,32,127
"2011","Waltham Forest 007C","E01004381","Total",674,134,22,112,262,99,170,47,123
"2011","Waltham Forest 007D","E01004383","Total",575,163,25,138,224,74,148,36,112
"2011","Waltham Forest 007E","E01004387","Total",525,115,10,105,207,65,119,22,97
"2011","Waltham Forest 007F","E01004388","Total",649,201,24,177,174,56,177,28,149
"2011","Waltham Forest 008A","E01004343","Total",647,150,17,133,240,92,146,29,117
"2011","Waltham Forest 008B","E01004344","Total",667,180,53,127,295,144,160,48,112
"2011","Waltham Forest 008C","E01004382","Total",501,181,68,113,218,98,159,51,108
"2011","Waltham Forest 008D","E01004418","Total",649,189,45,144,235,100,158,31,127
"2011","Waltham Forest 008E","E01004419","Total",637,173,33,140,202,83,138,32,106
"2011","Waltham Forest 009A","E01004398","Total",679,258,81,177,270,112,234,64,170
"2011","Waltham Forest 009B","E01004399","Total",594,225,96,129,281,110,191,69,122
"2011","Waltham Forest 009C","E01004400","Total",641,187,44,143,232,107,137,29,108
"2011","Waltham Forest 009D","E01004402","Total",663,224,69,155,254,116,160,41,119
"2011","Waltham Forest 009E","E01004403","Total",602,179,53,126,265,119,165,53,112
"2011","Waltham Forest 010A","E01004345","Total",624,151,48,103,282,138,147,45,102
"2011","Waltham Forest 010B","E01004348","Total",973,197,67,130,404,228,170,58,112
"2011","Waltham Forest 010C","E01004377","Total",626,159,19,140,251,99,147,30,117
"2011","Waltham Forest 010D","E01004378","Total",677,186,48,138,251,99,172,37,135
"2011","Waltham Forest 011A","E01004342","Total",789,258,40,218,293,146,211,54,157
"2011","Waltham Forest 011B","E01004346","Total",557,134,41,93,271,106,136,50,86
"2011","Waltham Forest 011C","E01004347","Total",809,192,50,142,282,160,154,39,115
"2011","Waltham Forest 011D","E01004460","Total",671,176,53,123,263,117,148,43,105
"2011","Waltham Forest 011E","E01004462","Total",639,143,32,111,222,118,131,36,95
"2011","Waltham Forest 012A","E01004396","Total",647,161,33,128,253,143,136,29,107
"2011","Waltham Forest 012B","E01004457","Total",738,173,47,126,252,135,160,44,116
"2011","Waltham Forest 012C","E01004458","Total",681,174,43,131,225,107,139,36,103
"2011","Waltham Forest 012D","E01004459","Total",535,219,91,128,274,109,172,61,111
"2011","Waltham Forest 012E","E01004463","Total",906,178,51,127,270,172,131,32,99
"2011","Waltham Forest 013A","E01004407","Total",493,174,58,116,237,148,126,36,90
"2011","Waltham Forest 013B","E01004410","Total",852,344,64,280,248,118,258,49,209
"2011","Waltham Forest 013C","E01004464","Total",643,250,66,184,252,121,185,35,150
"2011","Waltham Forest 013D","E01004469","Total",627,242,67,175,246,115,191,54,137
"2011","Waltham Forest 013E","E01004470","Total",602,196,45,151,205,113,156,30,126
"2011","Waltham Forest 013F","E01004471","Total",668,217,55,162,236,131,165,44,121
"2011","Waltham Forest 014A","E01004391","Total",846,201,45,156,223,126,173,45,128
"2011","Waltham Forest 014B","E01004393","Total",1023,282,53,229,216,117,213,34,179
"2011","Waltham Forest 014C","E01004401","Total",803,185,48,137,298,161,161,41,120
"2011","Waltham Forest 014D","E01004404","Total",882,231,70,161,294,167,194,48,146
"2011","Waltham Forest 014E","E01004461","Total",794,155,30,125,266,143,172,42,130
"2011","Waltham Forest 015A","E01004412","Total",740,156,33,123,234,124,149,32,117
"2011","Waltham Forest 015B","E01004465","Total",543,132,21,111,202,102,138,30,108
"2011","Waltham Forest 015C","E01004466","Total",638,122,23,99,205,115,125,22,103
"2011","Waltham Forest 015D","E01004467","Total",881,262,56,206,324,152,218,47,171
"2011","Waltham Forest 015E","E01004468","Total",657,159,17,142,189,92,151,21,130
"2011","Waltham Forest 016A","E01004406","Total",731,149,40,109,235,146,147,37,110
"2011","Waltham Forest 016B","E01004408","Total",676,164,43,121,252,135,166,47,119
"2011","Waltham Forest 016C","E01004409","Total",711,225,31,194,177,89,188,23,165
"2011","Waltham Forest 016D","E01004411","Total",648,134,30,104,184,102,114,25,89
"2011","Waltham Forest 016E","E01004443","Total",586,141,39,102,243,116,143,44,99
"2011","Waltham Forest 016F","E01004447","Total",653,127,31,96,218,110,147,51,96
"2011","Waltham Forest 017A","E01004392","Total",879,212,60,152,292,148,193,54,139
"2011","Waltham Forest 017B","E01004394","Total",744,237,58,179,241,120,211,48,163
"2011","Waltham Forest 017C","E01004397","Total",849,114,31,83,257,138,151,38,113
"2011","Waltham Forest 017D","E01004444","Total",966,287,85,202,380,191,249,65,184
"2011","Waltham Forest 017E","E01004446","Total",677,150,35,115,261,145,134,50,84
"2011","Waltham Forest 018A","E01004395","Total",565,121,27,94,209,110,119,40,79
"2011","Waltham Forest 018B","E01004421","Total",604,153,41,112,264,144,152,53,99
"2011","Waltham Forest 018C","E01004445","Total",624,157,31,126,211,106,149,39,110
"2011","Waltham Forest 018D","E01004448","Total",759,190,82,108,315,173,121,30,91
"2011","Waltham Forest 018E","E01004449","Total",599,241,73,168,254,111,221,66,155
"2011","Waltham Forest 019A","E01004363","Total",506,113,19,94,186,91,123,27,96
"2011","Waltham Forest 019B","E01004364","Total",563,176,57,119,241,98,152,59,93
"2011","Waltham Forest 019C","E01004366","Total",642,191,30,161,197,80,172,40,132
"2011","Waltham Forest 019D","E01004367","Total",537,135,31,104,209,108,124,37,87
"2011","Waltham Forest 019E","E01004368","Total",720,169,19,150,195,107,140,32,108
"2011","Waltham Forest 020A","E01004365","Total",700,150,48,102,247,141,149,45,104
"2011","Waltham Forest 020B","E01004405","Total",566,132,30,102,210,113,114,33,81
"2011","Waltham Forest 020C","E01004420","Total",790,270,48,222,237,113,188,44,144
"2011","Waltham Forest 020D","E01004423","Total",697,256,49,207,243,148,237,49,188
"2011","Waltham Forest 020G","E01033153","Total",936,370,151,219,418,197,277,96,181
"2011","Waltham Forest 021A","E01004362","Total",676,171,21,150,166,85,148,25,123
"2011","Waltham Forest 021B","E01004436","Total",580,135,25,110,171,76,118,33,85
"2011","Waltham Forest 021C","E01004437","Total",762,234,44,190,197,105,175,29,146
"2011","Waltham Forest 021D","E01004439","Total",619,132,32,100,191,94,136,31,105
"2011","Waltham Forest 021E","E01004442","Total",668,112,17,95,187,80,109,21,88
"2011","Waltham Forest 022A","E01004422","Total",589,163,39,124,237,116,150,45,105
"2011","Waltham Forest 022B","E01004424","Total",627,169,60,109,279,130,140,46,94
"2011","Waltham Forest 022C","E01004425","Total",848,213,83,130,339,204,137,38,99
"2011","Waltham Forest 022D","E01004426","Total",590,153,48,105,239,104,137,42,95
"2011","Waltham Forest 022E","E01004427","Total",852,171,68,103,366,212,159,48,111
"2011","Waltham Forest 023A","E01004369","Total",615,117,34,83,241,148,108,39,69
"2011","Waltham Forest 023B","E01004370","Total",636,127,15,112,217,115,123,30,93
"2011","Waltham Forest 023C","E01004372","Total",744,109,18,91,249,176,116,36,80
"2011","Waltham Forest 023D","E01004432","Total",652,162,45,117,262,151,135,36,99
"2011","Waltham Forest 023E","E01004435","Total",749,194,41,153,278,139,159,32,127
"2011","Waltham Forest 024A","E01004333","Total",611,175,60,115,253,128,127,35,92
"2011","Waltham Forest 024B","E01004334","Total",637,303,75,228,232,108,202,37,165
"2011","Waltham Forest 024C","E01004438","Total",772,127,21,106,204,98,139,30,109
"2011","Waltham Forest 024D","E01004440","Total",794,144,23,121,235,137,141,27,114
"2011","Waltham Forest 024E","E01004441","Total",635,128,22,106,175,83,125,29,96
"2011","Waltham Forest 025A","E01004371","Total",615,133,20,113,175,91,134,28,106
"2011","Waltham Forest 025B","E01004373","Total",621,153,27,126,194,114,122,22,100
"2011","Waltham Forest 025C","E01004374","Total",688,148,32,116,211,121,136,34,102
"2011","Waltham Forest 025D","E01004375","Total",647,151,47,104,216,126,141,38,103
"2011","Waltham Forest 025E","E01004376","Total",654,122,27,95,189,111,136,36,100
"2011","Waltham Forest 026A","E01004336","Total",564,130,26,104,142,69,118,35,83
"2011","Waltham Forest 026B","E01004428","Total",653,263,88,175,282,117,205,64,141
"2011","Waltham Forest 026C","E01004429","Total",653,173,53,120,229,110,152,45,107
"2011","Waltham Forest 026D","E01004430","Total",827,168,40,128,213,124,130,28,102
"2011","Waltham Forest 026E","E01004434","Total",737,249,75,174,281,143,194,47,147
"2011","Waltham Forest 027A","E01004335","Total",645,255,130,125,304,142,169,60,109
"2011","Waltham Forest 027B","E01004337","Total",717,217,50,167,270,121,192,47,145
"2011","Waltham Forest 027C","E01004338","Total",580,102,22,80,186,109,103,33,70
"2011","Waltham Forest 027D","E01004339","Total",661,138,48,90,249,148,130,41,89
"2011","Waltham Forest 027E","E01004340","Total",698,244,68,176,237,110,216,60,156
"2011","Waltham Forest 027F","E01004341","Total",665,249,58,191,228,121,198,39,159
"2011","Waltham Forest 028A","E01004327","Total",465,159,25,134,140,77,124,14,110
"2011","Waltham Forest 028B","E01004328","Total",671,141,36,105,214,129,114,28,86
"2011","Waltham Forest 028C","E01004329","Total",671,141,49,92,251,116,144,40,104
"2011","Waltham Forest 028D","E01004330","Total",625,134,34,100,225,113,134,36,98
"2011","Waltham Forest 028E","E01004331","Total",675,177,57,120,242,132,162,47,115
"2011","Waltham Forest 028F","E01004332","Total",633,148,38,110,223,125,121,33,88
"2011","Bracknell Forest 001C","E01016252","Total",658,195,9,186,134,50,127,9,118
"2011","Bracknell Forest 001D","E01016253","Total",521,93,9,84,232,89,89,27,62
"2011","Bracknell Forest 001E","E01032727","Total",1308,437,9,428,354,128,274,23,251
"2011","Bracknell Forest 002A","E01016184","Total",868,149,27,122,296,120,124,30,94
"2011","Bracknell Forest 002B","E01016185","Total",607,115,8,107,159,75,82,9,73
"2011","Bracknell Forest 002C","E01016186","Total",731,173,20,153,238,87,139,19,120
"2011","Bracknell Forest 002D","E01016187","Total",667,155,7,148,216,69,116,23,93
"2011","Bracknell Forest 002E","E01016188","Total",661,67,8,59,272,113,85,25,60
"2011","Bracknell Forest 003A","E01016190","Total",609,193,22,171,203,72,126,28,98
"2011","Bracknell Forest 003B","E01016238","Total",483,163,7,156,123,34,107,9,98
"2011","Bracknell Forest 003C","E01016243","Total",592,84,16,68,244,117,64,17,47
"2011","Bracknell Forest 003D","E01016245","Total",889,113,13,100,401,142,95,32,63
"2011","Bracknell Forest 003E","E01016246","Total",607,65,3,62,275,101,73,22,51
"2011","Bracknell Forest 003F","E01016247","Total",692,71,12,59,254,118,79,21,58
"2011","Bracknell Forest 004A","E01016239","Total",610,178,22,156,184,62,172,24,148
"2011","Bracknell Forest 004B","E01016240","Total",646,189,27,162,211,84,164,24,140
"2011","Bracknell Forest 004C","E01016241","Total",647,191,22,169,223,101,169,34,135
"2011","Bracknell Forest 004D","E01016242","Total",805,244,47,197,244,123,169,26,143
"2011","Bracknell Forest 005A","E01016180","Total",558,166,12,154,162,62,133,20,113
"2011","Bracknell Forest 005B","E01016181","Total",540,158,7,151,137,49,105,12,93
"2011","Bracknell Forest 005C","E01016182","Total",614,158,15,143,207,69,121,22,99
"2011","Bracknell Forest 005D","E01016183","Total",516,129,11,118,197,60,94,21,73
"2011","Bracknell Forest 005E","E01016222","Total",503,68,8,60,181,66,49,15,34
"2011","Bracknell Forest 006B","E01016191","Total",651,209,12,197,218,82,168,32,136
"2011","Bracknell Forest 006C","E01016223","Total",648,159,18,141,177,96,148,25,123
"2011","Bracknell Forest 006D","E01016224","Total",756,229,48,181,258,139,195,39,156
"2011","Bracknell Forest 006E","E01016226","Total",625,213,19,194,157,72,169,21,148
"2011","Bracknell Forest 006F","E01032724","Total",630,213,49,164,171,101,150,25,125
"2011","Bracknell Forest 006G","E01032728","Total",641,184,16,168,157,85,157,19,138
"2011","Bracknell Forest 007A","E01016225","Total",888,210,48,162,317,168,147,43,104
"2011","Bracknell Forest 007B","E01016233","Total",1027,269,46,223,330,151,200,49,151
"2011","Bracknell Forest 007C","E01016248","Total",568,170,25,145,195,75,147,31,116
"2011","Bracknell Forest 007D","E01016249","Total",797,287,40,247,159,91,209,17,192
"2011","Bracknell Forest 007E","E01016250","Total",708,234,22,212,192,73,159,27,132
"2011","Bracknell Forest 008A","E01016200","Total",562,51,11,40,202,102,63,27,36
"2011","Bracknell Forest 008B","E01016201","Total",565,61,15,46,189,87,65,24,41
"2011","Bracknell Forest 008C","E01016202","Total",635,68,5,63,134,72,68,14,54
"2011","Bracknell Forest 008D","E01016203","Total",591,204,25,179,169,77,174,19,155
"2011","Bracknell Forest 008E","E01016204","Total",482,99,17,82,171,79,109,23,86
"2011","Bracknell Forest 009A","E01016209","Total",553,148,21,127,188,72,139,34,105
"2011","Bracknell Forest 009B","E01016210","Total",483,141,41,100,187,91,111,22,89
"2011","Bracknell Forest 009D","E01016213","Total",428,95,13,82,147,53,95,25,70
"2011","Bracknell Forest 009E","E01016214","Total",509,116,2,114,150,54,113,24,89
"2011","Bracknell Forest 009F","E01016215","Total",480,112,28,84,190,104,93,22,71
"2011","Bracknell Forest 009G","E01032725","Total",604,71,37,34,266,173,64,32,32
"2011","Bracknell Forest 009H","E01032726","Total",548,145,37,108,214,97,128,35,93
"2011","Bracknell Forest 010A","E01016205","Total",546,114,13,101,163,80,132,26,106
"2011","Bracknell Forest 010B","E01016217","Total",578,112,16,96,178,80,122,28,94
"2011","Bracknell Forest 010C","E01016218","Total",634,173,15,158,157,69,174,20,154
"2011","Bracknell Forest 010D","E01016231","Total",764,204,29,175,269,118,161,29,132
"2011","Bracknell Forest 010E","E01016232","Total",611,154,18,136,193,78,126,21,105
"2011","Bracknell Forest 011A","E01016212","Total",493,113,36,77,203,101,119,36,83
"2011","Bracknell Forest 011B","E01016216","Total",561,121,11,110,156,73,125,22,103
"2011","Bracknell Forest 011C","E01016219","Total",545,147,14,133,160,56,139,27,112
"2011","Bracknell Forest 011D","E01016220","Total",578,111,26,85,200,110,101,20,81
"2011","Bracknell Forest 011E","E01016221","Total",580,126,8,118,158,63,113,16,97
"2011","Bracknell Forest 012A","E01016206","Total",747,222,12,210,198,66,142,25,117
"2011","Bracknell Forest 012B","E01016208","Total",836,245,6,239,217,61,189,22,167
"2011","Bracknell Forest 012C","E01016229","Total",491,147,6,141,146,45,129,26,103
"2011","Bracknell Forest 012D","E01016230","Total",459,103,2,101,129,53,70,5,65
"2011","Bracknell Forest 013A","E01016207","Total",512,89,12,77,223,92,98,28,70
"2011","Bracknell Forest 013B","E01016234","Total",459,86,8,78,143,58,85,20,65
"2011","Bracknell Forest 013C","E01016235","Total",487,65,4,61,188,65,74,21,53
"2011","Bracknell Forest 013D","E01016236","Total",578,130,35,95,213,88,124,26,98
"2011","Bracknell Forest 013E","E01016237","Total",473,61,12,49,174,73,78,19,59
"2011","Bracknell Forest 014A","E01016192","Total",612,181,12,169,172,80,141,19,122
"2011","Bracknell Forest 014B","E01016194","Total",511,153,2,151,136,37,107,17,90
"2011","Bracknell Forest 014C","E01016195","Total",473,63,12,51,169,77,78,21,57
"2011","Bracknell Forest 014D","E01016227","Total",482,100,6,94,182,57,82,18,64
"2011","Bracknell Forest 014E","E01016228","Total",574,142,9,133,183,69,108,21,87
"2011","Bracknell Forest 015A","E01016193","Total",528,75,7,68,163,68,83,12,71
"2011","Bracknell Forest 015B","E01016196","Total",557,75,15,60,299,142,75,26,49
"2011","Bracknell Forest 015C","E01016197","Total",511,134,22,112,182,63,102,28,74
"2011","Bracknell Forest 015D","E01016198","Total",517,148,6,142,145,46,113,11,102
"2011","Bracknell Forest 015E","E01016199","Total",470,78,7,71,158,61,58,15,43
"2011","Brighton and Hove 001A","E01016924","Total",582,177,9,168,208,69,156,40,116
"2011","Brighton and Hove 001B","E01016926","Total",606,210,60,150,264,92,189,48,141
"2011","Brighton and Hove 001C","E01016927","Total",626,173,26,147,214,68,170,33,137
"2011","Brighton and Hove 001D","E01016929","Total",639,204,27,177,209,80,181,31,150
"2011","Brighton and Hove 001E","E01016931","Total",635,217,14,203,180,68,169,31,138
"2011","Brighton and Hove 002A","E01016898","Total",757,295,32,263,198,81,270,39,231
"2011","Brighton and Hove 002B","E01016899","Total",404,145,13,132,115,45,128,14,114
"2011","Brighton and Hove 002C","E01016914","Total",506,190,71,119,191,73,155,49,106
"2011","Brighton and Hove 002D","E01016915","Total",499,226,78,148,195,62,164,50,114
"2011","Brighton and Hove 003A","E01016923","Total",675,243,17,226,196,74,195,30,165
"2011","Brighton and Hove 003B","E01016928","Total",662,230,16,214,202,72,156,30,126
"2011","Brighton and Hove 003C","E01016998","Total",591,179,3,176,215,87,144,30,114
"2011","Brighton and Hove 003D","E01016999","Total",569,162,4,158,156,45,121,15,106
"2011","Brighton and Hove 003E","E01017000","Total",851,346,17,329,194,72,225,23,202
"2011","Brighton and Hove 004A","E01016925","Total",612,177,32,145,215,66,172,45,127
"2011","Brighton and Hove 004B","E01016930","Total",760,230,13,217,217,75,182,22,160
"2011","Brighton and Hove 004C","E01017001","Total",598,197,8,189,181,49,148,18,130
"2011","Brighton and Hove 004D","E01017003","Total",671,168,17,151,250,75,151,33,118
"2011","Brighton and Hove 005A","E01016916","Total",611,206,15,191,168,58,176,29,147
"2011","Brighton and Hove 005B","E01016917","Total",578,152,21,131,173,65,133,23,110
"2011","Brighton and Hove 005C","E01016918","Total",592,237,44,193,213,73,207,52,155
"2011","Brighton and Hove 005D","E01016919","Total",551,132,33,99,211,72,129,33,96
"2011","Brighton and Hove 005E","E01016920","Total",638,136,19,117,244,101,132,37,95
"2011","Brighton and Hove 006A","E01016882","Total",627,241,41,200,203,87,199,37,162
"2011","Brighton and Hove 006B","E01016883","Total",661,322,16,306,135,44,191,23,168
"2011","Brighton and Hove 006C","E01016884","Total",616,207,20,187,213,81,200,28,172
"2011","Brighton and Hove 006D","E01016885","Total",619,264,67,197,225,96,223,51,172
"2011","Brighton and Hove 006E","E01016886","Total",623,220,18,202,211,71,190,31,159
"2011","Brighton and Hove 007A","E01016980","Total",570,148,17,131,215,73,116,29,87
"2011","Brighton and Hove 007B","E01016982","Total",498,153,10,143,185,66,106,24,82
"2011","Brighton and Hove 007C","E01016983","Total",535,180,14,166,180,50,105,19,86
"2011","Brighton and Hove 007D","E01016984","Total",575,181,11,170,178,45,119,22,97
"2011","Brighton and Hove 007E","E01016985","Total",626,158,15,143,233,79,133,32,101
"2011","Brighton and Hove 008A","E01016900","Total",764,426,106,320,213,101,306,52,254
"2011","Brighton and Hove 008B","E01016902","Total",577,191,42,149,195,81,161,44,117
"2011","Brighton and Hove 008C","E01016904","Total",684,336,116,220,252,113,271,71,200
"2011","Brighton and Hove 008D","E01016905","Total",803,379,44,335,180,81,320,41,279
"2011","Brighton and Hove 008E","E01016909","Total",647,224,53,171,172,66,188,39,149
"2011","Brighton and Hove 009A","E01016906","Total",603,233,73,160,243,80,207,52,155
"2011","Brighton and Hove 009B","E01016907","Total",579,210,34,176,138,44,159,33,126
"2011","Brighton and Hove 009C","E01016908","Total",577,243,79,164,236,106,219,61,158
"2011","Brighton and Hove 009D","E01016910","Total",541,190,62,128,213,70,196,63,133
"2011","Brighton and Hove 009E","E01016911","Total",543,168,41,127,182,55,167,52,115
"2011","Brighton and Hove 010A","E01016901","Total",611,136,23,113,243,82,134,32,102
"2011","Brighton and Hove 010B","E01016903","Total",690,128,21,107,262,80,125,31,94
"2011","Brighton and Hove 010C","E01016934","Total",528,87,7,80,229,78,94,30,64
"2011","Brighton and Hove 010D","E01016939","Total",604,116,6,110,274,98,108,25,83
"2011","Brighton and Hove 010E","E01016940","Total",616,77,10,67,262,91,106,33,73
"2011","Brighton and Hove 011A","E01016981","Total",657,236,16,220,202,65,149,22,127
"2011","Brighton and Hove 011B","E01017002","Total",774,223,18,205,198,88,162,17,145
"2011","Brighton and Hove 011C","E01017004","Total",776,208,19,189,226,85,176,17,159
"2011","Brighton and Hove 011D","E01017005","Total",715,135,10,125,245,106,142,32,110
"2011","Brighton and Hove 011E","E01017006","Total",763,140,17,123,192,76,139,27,112
"2011","Brighton and Hove 012A","E01016921","Total",640,195,45,150,224,88,155,41,114
"2011","Brighton and Hove 012B","E01016922","Total",523,173,30,143,200,73,120,29,91
"2011","Brighton and Hove 012C","E01016973","Total",648,215,41,174,220,87,179,41,138
"2011","Brighton and Hove 012D","E01016977","Total",618,200,22,178,214,66,168,33,135
"2011","Brighton and Hove 012E","E01016978","Total",716,224,38,186,224,87,190,32,158
"2011","Brighton and Hove 013A","E01016879","Total",558,167,35,132,222,79,162,47,115
"2011","Brighton and Hove 013B","E01016880","Total",495,183,66,117,211,72,177,62,115
"2011","Brighton and Hove 013C","E01016881","Total",605,221,36,185,219,78,201,51,150
"2011","Brighton and Hove 013D","E01016887","Total",619,222,16,206,178,65,156,22,134
"2011","Brighton and Hove 013E","E01016888","Total",587,205,15,190,205,57,176,28,148
"2011","Brighton and Hove 013F","E01016976","Total",623,194,21,173,213,65,158,37,121
"2011","Brighton and Hove 014A","E01016932","Total",687,148,15,133,216,75,150,33,117
"2011","Brighton and Hove 014B","E01016933","Total",635,148,19,129,174,58,131,26,105
"2011","Brighton and Hove 014C","E01016935","Total",813,276,21,255,175,83,197,16,181
"2011","Brighton and Hove 014D","E01016936","Total",684,101,13,88,199,90,105,18,87
"2011","Brighton and Hove 014E","E01016937","Total",1019,208,27,181,148,79,199,21,178
"2011","Brighton and Hove 015A","E01016890","Total",777,162,20,142,124,65,131,18,113
"2011","Brighton and Hove 015B","E01016966","Total",753,235,25,210,129,61,185,13,172
"2011","Brighton and Hove 015C","E01016970","Total",696,159,16,143,182,91,150,31,119
"2011","Brighton and Hove 015D","E01016971","Total",756,195,13,182,111,42,161,18,143
"2011","Brighton and Hove 015E","E01016972","Total",804,153,20,133,177,82,153,26,127
"2011","Brighton and Hove 016A","E01016979","Total",625,128,17,111,262,105,151,40,111
"2011","Brighton and Hove 016B","E01016990","Total",749,196,26,170,269,135,187,35,152
"2011","Brighton and Hove 016C","E01016991","Total",794,175,39,136,249,123,161,39,122
"2011","Brighton and Hove 016D","E01016996","Total",703,154,16,138,261,130,135,24,111
"2011","Brighton and Hove 017A","E01017007","Total",652,259,56,203,230,87,210,36,174
"2011","Brighton and Hove 017B","E01017008","Total",694,266,16,250,172,65,180,19,161
"2011","Brighton and Hove 017C","E01017009","Total",631,206,24,182,188,72,179,33,146
"2011","Brighton and Hove 017D","E01017010","Total",695,235,24,211,212,77,197,32,165
"2011","Brighton and Hove 017E","E01017011","Total",531,182,52,130,213,67,166,48,118
"2011","Brighton and Hove 017F","E01017012","Total",721,218,22,196,243,103,200,42,158
"2011","Brighton and Hove 018A","E01016892","Total",628,134,23,111,213,89,148,42,106
"2011","Brighton and Hove 018B","E01016893","Total",773,132,17,115,217,107,132,34,98
"2011","Brighton and Hove 018C","E01016912","Total",785,190,23,167,155,76,158,20,138
"2011","Brighton and Hove 018D","E01016913","Total",612,158,13,145,122,43,109,16,93
"2011","Brighton and Hove 018E","E01016946","Total",620,134,13,121,199,80,125,23,102
"2011","Brighton and Hove 019A","E01016860","Total",795,199,26,173,163,78,162,17,145
"2011","Brighton and Hove 019B","E01016871","Total",1059,356,26,330,136,68,270,19,251
"2011","Brighton and Hove 019C","E01016872","Total",963,172,24,148,179,98,182,31,151
"2011","Brighton and Hove 019D","E01016873","Total",1002,340,14,326,129,81,281,14,267
"2011","Brighton and Hove 019E","E01016878","Total",876,244,20,224,213,90,198,35,163
"2011","Brighton and Hove 020A","E01016870","Total",688,119,19,100,194,78,110,19,91
"2011","Brighton and Hove 020B","E01016874","Total",1032,345,12,333,165,106,245,14,231
"2011","Brighton and Hove 020C","E01016875","Total",600,86,10,76,229,95,92,29,63
"2011","Brighton and Hove 020D","E01016876","Total",816,231,21,210,151,73,177,17,160
"2011","Brighton and Hove 020E","E01016877","Total",919,285,28,257,166,85,199,24,175
"2011","Brighton and Hove 021A","E01016974","Total",706,177,23,154,243,109,144,28,116
"2011","Brighton and Hove 021B","E01016975","Total",592,179,43,136,232,91,183,53,130
"2011","Brighton and Hove 021C","E01016992","Total",659,199,10,189,219,96,162,22,140
"2011","Brighton and Hove 021D","E01016994","Total",730,167,35,132,236,119,160,23,137
"2011","Brighton and Hove 021E","E01016997","Total",631,165,10,155,220,85,158,25,133
"2011","Brighton and Hove 022A","E01016889","Total",761,179,13,166,154,77,164,22,142
"2011","Brighton and Hove 022B","E01016891","Total",805,236,30,206,151,71,200,14,186
"2011","Brighton and Hove 022C","E01016894","Total",709,172,39,133,158,59,152,25,127
"2011","Brighton and Hove 022D","E01016896","Total",700,116,20,96,188,91,118,16,102
"2011","Brighton and Hove 022E","E01016897","Total",761,165,26,139,209,111,148,23,125
"2011","Brighton and Hove 023A","E01016987","Total",761,210,21,189,217,91,185,31,154
"2011","Brighton and Hove 023B","E01016989","Total",744,238,15,223,159,63,182,11,171
"2011","Brighton and Hove 023C","E01016993","Total",754,382,32,350,169,74,303,28,275
"2011","Brighton and Hove 023D","E01016995","Total",648,174,9,165,238,90,130,22,108
"2011","Brighton and Hove 024A","E01016938","Total",911,167,10,157,155,75,149,20,129
"2011","Brighton and Hove 024B","E01016950","Total",1029,248,11,237,118,65,195,16,179
"2011","Brighton and Hove 024C","E01016951","Total",883,246,11,235,88,40,206,14,192
"2011","Brighton and Hove 024D","E01016967","Total",1109,227,14,213,116,47,189,12,177
"2011","Brighton and Hove 024E","E01016968","Total",924,171,12,159,92,55,118,10,108
"2011","Brighton and Hove 025A","E01016864","Total",584,252,44,208,181,57,203,51,152
"2011","Brighton and Hove 025B","E01016865","Total",578,233,105,128,281,102,196,77,119
"2011","Brighton and Hove 025C","E01016866","Total",542,232,84,148,237,83,203,74,129
"2011","Brighton and Hove 025D","E01016867","Total",661,285,74,211,215,75,242,44,198
"2011","Brighton and Hove 025E","E01016868","Total",707,365,99,266,235,93,294,66,228
"2011","Brighton and Hove 025F","E01016895","Total",587,226,74,152,234,80,178,55,123
"2011","Brighton and Hove 026A","E01016849","Total",893,190,11,179,96,54,154,14,140
"2011","Brighton and Hove 026B","E01016852","Total",964,247,17,230,92,46,168,10,158
"2011","Brighton and Hove 026C","E01016853","Total",1113,248,23,225,142,78,207,21,186
"2011","Brighton and Hove 026D","E01016855","Total",1021,197,14,183,115,70,165,12,153
"2011","Brighton and Hove 026E","E01016856","Total",981,307,13,294,100,61,232,10,222
"2011","Brighton and Hove 027A","E01016952","Total",805,177,17,160,72,39,137,4,133
"2011","Brighton and Hove 027B","E01016953","Total",866,191,14,177,102,47,139,8,131
"2011","Brighton and Hove 027C","E01016964","Total",1015,372,33,339,115,61,300,27,273
"2011","Brighton and Hove 027E","E01016969","Total",1037,335,40,295,142,69,231,26,205
"2011","Brighton and Hove 027F","E01033328","Total",717,192,21,171,106,47,157,21,136
"2011","Brighton and Hove 027G","E01033329","Total",798,215,36,179,155,69,127,30,97
"2011","Brighton and Hove 028A","E01016857","Total",811,211,19,192,125,59,169,18,151
"2011","Brighton and Hove 028B","E01016858","Total",878,208,16,192,99,61,154,9,145
"2011","Brighton and Hove 028C","E01016859","Total",891,338,9,329,83,54,229,10,219
"2011","Brighton and Hove 028D","E01016986","Total",841,305,17,288,133,71,229,14,215
"2011","Brighton and Hove 028E","E01016988","Total",737,246,17,229,153,78,177,17,160
"2011","Brighton and Hove 029A","E01016850","Total",912,174,16,158,120,64,160,15,145
"2011","Brighton and Hove 029B","E01016851","Total",992,192,13,179,111,60,158,11,147
"2011","Brighton and Hove 029C","E01016854","Total",1001,252,30,222,115,55,205,24,181
"2011","Brighton and Hove 029D","E01016954","Total",1110,295,9,286,88,45,183,5,178
"2011","Brighton and Hove 029E","E01016955","Total",1037,267,2,265,78,43,185,8,177
"2011","Brighton and Hove 030A","E01016941","Total",1118,413,27,386,89,37,287,19,268
"2011","Brighton and Hove 030B","E01016945","Total",981,253,15,238,57,28,203,14,189
"2011","Brighton and Hove 030C","E01016947","Total",900,421,56,365,168,70,363,35,328
"2011","Brighton and Hove 030D","E01016948","Total",780,188,46,142,220,99,185,41,144
"2011","Brighton and Hove 030E","E01016949","Total",911,422,25,397,128,49,359,26,333
"2011","Brighton and Hove 031A","E01016861","Total",907,199,9,190,95,54,145,11,134
"2011","Brighton and Hove 031B","E01016862","Total",845,259,12,247,96,48,196,7,189
"2011","Brighton and Hove 031C","E01016942","Total",1114,828,21,807,59,28,670,16,654
"2011","Brighton and Hove 031D","E01016943","Total",696,163,29,134,205,92,148,34,114
"2011","Brighton and Hove 031E","E01016944","Total",862,204,16,188,91,39,142,10,132
"2011","Brighton and Hove 032A","E01016863","Total",928,420,51,369,152,70,343,24,319
"2011","Brighton and Hove 032B","E01016869","Total",809,288,44,244,193,85,230,34,196
"2011","Brighton and Hove 032C","E01016957","Total",889,302,20,282,90,45,156,12,144
"2011","Brighton and Hove 032D","E01016963","Total",958,247,25,222,187,97,223,35,188
"2011","Brighton and Hove 033A","E01016956","Total",717,287,17,270,173,56,197,19,178
"2011","Brighton and Hove 033B","E01016958","Total",821,336,14,322,177,60,219,22,197
"2011","Brighton and Hove 033C","E01016959","Total",619,227,7,220,136,34,148,16,132
"2011","Brighton and Hove 033D","E01016960","Total",829,335,19,316,204,55,196,13,183
"2011","Brighton and Hove 033E","E01016961","Total",792,246,19,227,193,84,183,18,165
"2011","Brighton and Hove 033F","E01016962","Total",734,263,8,255,183,60,169,18,151
"2011","Isle of Wight 001A","E01017300","Total",1200,495,29,466,191,80,301,22,279
"2011","Isle of Wight 001B","E01017303","Total",550,146,14,132,139,57,103,29,74
"2011","Isle of Wight 001C","E01017305","Total",652,203,37,166,187,93,145,32,113
"2011","Isle of Wight 001D","E01017306","Total",553,138,25,113,206,68,120,34,86
"2011","Isle of Wight 001E","E01017309","Total",714,197,29,168,248,93,172,37,135
"2011","Isle of Wight 002A","E01017301","Total",488,237,4,233,109,31,134,15,119
"2011","Isle of Wight 002B","E01017302","Total",671,198,12,186,231,86,145,31,114
"2011","Isle of Wight 002C","E01017304","Total",560,157,16,141,199,69,137,30,107
"2011","Isle of Wight 002D","E01017316","Total",819,348,12,336,175,51,240,26,214
"2011","Isle of Wight 002E","E01017329","Total",978,405,12,393,259,69,295,42,253
"2011","Isle of Wight 003A","E01017307","Total",902,378,22,356,175,66,264,28,236
"2011","Isle of Wight 003B","E01017308","Total",739,256,27,229,227,85,215,41,174
"2011","Isle of Wight 003D","E01033229","Total",647,273,15,258,129,52,189,13,176
"2011","Isle of Wight 003E","E01033237","Total",559,244,57,187,189,87,175,34,141
"2011","Isle of Wight 004A","E01017335","Total",765,322,32,290,176,57,223,28,195
"2011","Isle of Wight 004B","E01017336","Total",847,322,48,274,166,72,235,32,203
"2011","Isle of Wight 004C","E01017337","Total",797,296,29,267,159,53,211,35,176
"2011","Isle of Wight 004D","E01017346","Total",740,265,25,240,163,52,205,34,171
"2011","Isle of Wight 005A","E01017286","Total",694,313,14,299,132,35,205,26,179
"2011","Isle of Wight 005B","E01017287","Total",746,294,10,284,178,60,226,29,197
"2011","Isle of Wight 005C","E01017367","Total",861,419,10,409,160,50,263,30,233
"2011","Isle of Wight 005D","E01017368","Total",717,318,17,301,181,64,233,33,200
"2011","Isle of Wight 006A","E01017282","Total",590,199,24,175,181,68,158,28,130
"2011","Isle of Wight 006B","E01017283","Total",667,229,15,214,179,50,196,30,166
"2011","Isle of Wight 006C","E01017338","Total",625,295,16,279,141,41,176,25,151
"2011","Isle of Wight 006D","E01017341","Total",660,290,35,255,208,70,225,47,178
"2011","Isle of Wight 006E","E01017342","Total",726,270,46,224,252,92,199,44,155
"2011","Isle of Wight 007A","E01017339","Total",671,217,40,177,244,78,176,47,129
"2011","Isle of Wight 007B","E01017340","Total",799,311,63,248,276,135,250,48,202
"2011","Isle of Wight 007C","E01017343","Total",575,253,35,218,177,61,206,37,169
"2011","Isle of Wight 007D","E01017344","Total",729,312,12,300,159,58,197,19,178
"2011","Isle of Wight 007E","E01017345","Total",836,302,117,185,350,146,219,79,140
"2011","Isle of Wight 008A","E01017310","Total",520,185,10,175,121,27,146,29,117
"2011","Isle of Wight 008B","E01017311","Total",713,241,25,216,165,64,210,33,177
"2011","Isle of Wight 008C","E01017331","Total",671,321,52,269,177,73,228,38,190
"2011","Isle of Wight 008D","E01017332","Total",535,229,37,192,174,55,212,42,170
"2011","Isle of Wight 008E","E01017334","Total",478,130,10,120,154,58,111,23,88
"2011","Isle of Wight 009A","E01017295","Total",539,175,38,137,187,74,154,39,115
"2011","Isle of Wight 009B","E01017325","Total",612,241,38,203,171,68,196,31,165
"2011","Isle of Wight 009C","E01017326","Total",843,346,50,296,191,69,268,40,228
"2011","Isle of Wight 009D","E01017328","Total",667,248,45,203,204,102,193,32,161
"2011","Isle of Wight 009E","E01017333","Total",659,162,32,130,281,95,155,50,105
"2011","Isle of Wight 010A","E01017284","Total",783,403,19,384,145,34,226,23,203
"2011","Isle of Wight 010B","E01017285","Total",920,508,14,494,135,38,297,20,277
"2011","Isle of Wight 010C","E01017288","Total",590,266,6,260,115,28,171,21,150
"2011","Isle of Wight 010D","E01017351","Total",679,316,15,301,139,35,184,18,166
"2011","Isle of Wight 010E","E01017352","Total",577,336,8,328,78,13,180,8,172
"2011","Isle of Wight 011A","E01017292","Total",665,215,34,181,208,79,168,33,135
"2011","Isle of Wight 011B","E01017293","Total",771,241,25,216,300,106,196,45,151
"2011","Isle of Wight 011C","E01017296","Total",527,186,12,174,131,41,146,17,129
"2011","Isle of Wight 011D","E01017321","Total",494,197,13,184,114,29,160,16,144
"2011","Isle of Wight 011E","E01017322","Total",609,241,56,185,204,61,189,45,144
"2011","Isle of Wight 011F","E01017327","Total",684,231,29,202,220,86,189,34,155
"2011","Isle of Wight 012A","E01017312","Total",767,365,20,345,154,55,276,31,245
"2011","Isle of Wight 012D","E01017315","Total",685,347,33,314,169,48,255,39,216
"2011","Isle of Wight 012E","E01017354","Total",590,284,15,269,105,39,181,21,160
"2011","Isle of Wight 012F","E01017361","Total",637,346,14,332,103,34,190,18,172
"2011","Isle of Wight 012G","E01017362","Total",661,289,30,259,158,49,215,34,181
"2011","Isle of Wight 012H","E01033239","Total",1135,623,24,599,160,42,356,30,326
"2011","Isle of Wight 013A","E01017290","Total",588,193,8,185,110,32,168,17,151
"2011","Isle of Wight 013B","E01017291","Total",563,299,11,288,91,22,196,20,176
"2011","Isle of Wight 013C","E01017294","Total",657,200,7,193,177,49,166,34,132
"2011","Isle of Wight 013D","E01017353","Total",542,209,10,199,113,31,153,24,129
"2011","Isle of Wight 014A","E01017289","Total",910,377,38,339,195,61,263,38,225
"2011","Isle of Wight 014B","E01017347","Total",724,321,35,286,180,64,225,37,188
"2011","Isle of Wight 014C","E01017348","Total",538,172,18,154,168,51,158,32,126
"2011","Isle of Wight 014D","E01017349","Total",936,336,45,291,270,101,236,56,180
"2011","Isle of Wight 014E","E01017350","Total",802,327,59,268,279,107,280,72,208
"2011","Isle of Wight 015A","E01017317","Total",672,275,26,249,180,51,189,34,155
"2011","Isle of Wight 015B","E01017320","Total",557,313,6,307,96,18,206,23,183
"2011","Isle of Wight 015C","E01017323","Total",510,187,2,185,95,26,139,15,124
"2011","Isle of Wight 015D","E01017324","Total",622,225,25,200,157,33,162,27,135
"2011","Isle of Wight 015E","E01017355","Total",663,258,25,233,166,59,198,27,171
"2011","Isle of Wight 015F","E01017358","Total",589,307,15,292,116,29,193,23,170
"2011","Isle of Wight 016A","E01017318","Total",522,248,44,204,176,60,197,38,159
"2011","Isle of Wight 016B","E01017319","Total",670,402,19,383,116,24,254,20,234
"2011","Isle of Wight 016C","E01017356","Total",686,313,40,273,169,60,209,36,173
"2011","Isle of Wight 016D","E01017357","Total",645,315,31,284,162,53,244,48,196
"2011","Isle of Wight 016E","E01017359","Total",685,334,21,313,123,36,182,18,164
"2011","Isle of Wight 016F","E01017360","Total",812,352,29,323,174,75,243,25,218
"2011","Isle of Wight 017A","E01017297","Total",606,219,18,201,172,44,163,33,130
"2011","Isle of Wight 017B","E01017298","Total",681,315,10,305,139,36,208,34,174
"2011","Isle of Wight 017C","E01017299","Total",546,215,18,197,121,36,146,19,127
"2011","Isle of Wight 017D","E01017369","Total",631,235,15,220,153,51,181,23,158
"2011","Isle of Wight 018A","E01017363","Total",813,367,41,326,161,62,266,28,238
"2011","Isle of Wight 018B","E01017364","Total",699,272,11,261,145,38,194,23,171
"2011","Isle of Wight 018C","E01017365","Total",711,411,15,396,78,22,233,16,217
"2011","Isle of Wight 018D","E01017366","Total",623,250,47,203,198,61,207,58,149
"2011","Isle of Wight 018E","E01017370","Total",794,362,28,334,174,46,270,39,231
"2011","Medway 001A","E01016070","Total",731,277,23,254,175,65,221,37,184
"2011","Medway 001B","E01016071","Total",630,176,34,142,220,83,173,38,135
"2011","Medway 001C","E01016072","Total",525,165,24,141,150,48,162,33,129
"2011","Medway 001D","E01016074","Total",838,377,15,362,136,54,273,23,250
"2011","Medway 002A","E01016142","Total",491,99,5,94,151,48,102,16,86
"2011","Medway 002B","E01016144","Total",575,167,15,152,167,47,129,27,102
"2011","Medway 002C","E01016145","Total",485,91,6,85,191,59,79,15,64
"2011","Medway 002D","E01016149","Total",586,200,25,175,195,66,170,37,133
"2011","Medway 003A","E01016073","Total",794,225,15,210,246,75,179,32,147
"2011","Medway 003B","E01016075","Total",576,188,17,171,171,48,162,28,134
"2011","Medway 003C","E01016076","Total",920,240,28,212,323,135,186,38,148
"2011","Medway 003D","E01016077","Total",634,249,26,223,172,64,211,39,172
"2011","Medway 003E","E01016143","Total",949,223,48,175,363,177,172,52,120
"2011","Medway 004A","E01016146","Total",852,332,41,291,255,103,258,44,214
"2011","Medway 004B","E01016147","Total",738,221,9,212,222,93,177,32,145
"2011","Medway 004C","E01016148","Total",731,177,14,163,248,84,136,33,103
"2011","Medway 005A","E01016133","Total",539,182,3,179,142,36,123,19,104
"2011","Medway 005B","E01016134","Total",526,150,27,123,202,59,124,31,93
"2011","Medway 005C","E01016138","Total",592,196,8,188,163,57,153,22,131
"2011","Medway 005D","E01016139","Total",616,158,24,134,239,73,142,44,98
"2011","Medway 006A","E01016135","Total",624,180,32,148,210,71,159,38,121
"2011","Medway 006B","E01016136","Total",624,226,51,175,229,90,171,40,131
"2011","Medway 006C","E01016137","Total",614,151,38,113,219,98,146,39,107
"2011","Medway 006D","E01016140","Total",596,161,29,132,174,77,147,31,116
"2011","Medway 006E","E01016141","Total",723,207,40,167,258,120,181,43,138
"2011","Medway 007A","E01016035","Total",737,250,87,163,281,134,143,43,100
"2011","Medway 007D","E01016112","Total",1162,184,27,157,410,192,152,39,113
"2011","Medway 007E","E01032798","Total",1228,379,61,318,363,184,299,62,237
"2011","Medway 008A","E01016151","Total",623,185,20,165,208,78,157,31,126
"2011","Medway 008B","E01016152","Total",632,297,47,250,180,66,217,29,188
"2011","Medway 008C","E01016153","Total",607,258,61,197,205,94,182,39,143
"2011","Medway 008D","E01016155","Total",619,234,46,188,194,78,189,36,153
"2011","Medway 009A","E01016033","Total",474,214,49,165,155,68,145,35,110
"2011","Medway 009B","E01016036","Total",715,254,44,210,203,98,150,27,123
"2011","Medway 009C","E01016037","Total",665,168,57,111,224,96,141,40,101
"2011","Medway 009D","E01016039","Total",692,208,47,161,238,116,168,40,128
"2011","Medway 010A","E01016030","Total",696,211,71,140,304,144,186,70,116
"2011","Medway 010B","E01016032","Total",466,176,76,100,238,90,148,64,84
"2011","Medway 010C","E01016034","Total",1035,229,34,195,377,174,195,57,138
"2011","Medway 010D","E01016038","Total",586,175,41,134,208,78,148,43,105
"2011","Medway 011A","E01016150","Total",607,201,62,139,248,110,155,58,97
"2011","Medway 011B","E01016154","Total",648,165,26,139,215,80,185,45,140
"2011","Medway 011C","E01016156","Total",659,142,46,96,284,150,131,39,92
"2011","Medway 011D","E01016157","Total",778,222,38,184,279,118,172,35,137
"2011","Medway 011E","E01016158","Total",880,221,30,191,304,139,210,48,162
"2011","Medway 012A","E01016031","Total",859,382,99,283,270,150,245,39,206
"2011","Medway 012B","E01016041","Total",714,214,54,160,233,94,191,45,146
"2011","Medway 012C","E01016045","Total",630,135,38,97,235,91,147,40,107
"2011","Medway 012D","E01016049","Total",876,312,78,234,271,128,234,52,182
"2011","Medway 013A","E01016040","Total",681,215,45,170,245,95,180,50,130
"2011","Medway 013B","E01016042","Total",570,164,56,108,229,92,142,63,79
"2011","Medway 013C","E01016043","Total",561,191,20,171,179,61,179,41,138
"2011","Medway 013D","E01016177","Total",625,199,44,155,237,94,153,45,108
"2011","Medway 013E","E01016178","Total",555,151,28,123,215,90,158,44,114
"2011","Medway 014A","E01016117","Total",867,354,65,289,203,117,257,30,227
"2011","Medway 014B","E01016129","Total",948,258,84,174,265,137,170,43,127
"2011","Medway 014C","E01016130","Total",920,272,22,250,172,69,195,24,171
"2011","Medway 014D","E01016131","Total",783,282,11,271,215,78,194,29,165
"2011","Medway 015A","E01016016","Total",650,236,41,195,199,85,169,38,131
"2011","Medway 015B","E01016017","Total",750,289,31,258,142,81,220,21,199
"2011","Medway 015C","E01016019","Total",657,174,69,105,292,144,152,48,104
"2011","Medway 015D","E01016110","Total",955,324,36,288,140,78,216,18,198
"2011","Medway 015E","E01016111","Total",568,277,33,244,157,83,182,13,169
"2011","Medway 016A","E01016044","Total",673,185,49,136,235,122,158,42,116
"2011","Medway 016B","E01016046","Total",632,178,34,144,206,94,148,32,116
"2011","Medway 016C","E01016047","Total",649,172,39,133,253,110,142,34,108
"2011","Medway 016D","E01016048","Total",683,177,36,141,252,122,169,45,124
"2011","Medway 017A","E01016113","Total",598,183,19,164,193,60,137,28,109
"2011","Medway 017B","E01016114","Total",656,168,34,134,211,85,143,34,109
"2011","Medway 017C","E01016115","Total",765,221,63,158,300,126,169,46,123
"2011","Medway 017D","E01016118","Total",752,204,34,170,224,87,174,38,136
"2011","Medway 018A","E01016160","Total",612,272,41,231,192,70,236,42,194
"2011","Medway 018B","E01016161","Total",743,371,40,331,180,73,289,35,254
"2011","Medway 018C","E01016162","Total",648,184,20,164,217,86,165,37,128
"2011","Medway 018D","E01016163","Total",505,168,28,140,170,62,125,35,90
"2011","Medway 018E","E01016164","Total",646,274,44,230,197,69,238,47,191
"2011","Medway 018F","E01016165","Total",520,187,18,169,153,35,162,31,131
"2011","Medway 019A","E01016159","Total",512,193,72,121,230,98,142,42,100
"2011","Medway 019B","E01016174","Total",514,126,21,105,172,58,121,34,87
"2011","Medway 019C","E01016175","Total",707,205,17,188,222,63,153,32,121
"2011","Medway 019D","E01016179","Total",505,132,11,121,175,46,126,29,97
"2011","Medway 020A","E01016061","Total",694,196,52,144,235,108,119,30,89
"2011","Medway 020B","E01016063","Total",741,332,70,262,214,108,234,46,188
"2011","Medway 020C","E01016064","Total",701,281,73,208,208,99,196,48,148
"2011","Medway 020D","E01016069","Total",764,243,72,171,270,142,174,40,134
"2011","Medway 021A","E01016020","Total",506,166,39,127,172,77,124,21,103
"2011","Medway 021B","E01016021","Total",595,162,33,129,201,84,144,38,106
"2011","Medway 021C","E01016022","Total",507,143,36,107,190,73,113,32,81
"2011","Medway 021D","E01016125","Total",646,143,26,117,234,79,139,41,98
"2011","Medway 022A","E01016018","Total",754,208,72,136,320,159,180,52,128
"2011","Medway 022B","E01016023","Total",603,261,121,140,286,123,180,61,119
"2011","Medway 022C","E01016024","Total",768,253,95,158,327,175,168,44,124
"2011","Medway 022D","E01016062","Total",594,205,63,142,216,91,141,37,104
"2011","Medway 023A","E01016093","Total",665,258,2,256,149,56,178,17,161
"2011","Medway 023B","E01016096","Total",633,270,12,258,137,53,188,17,171
"2011","Medway 023C","E01016166","Total",580,194,16,178,173,74,135,22,113
"2011","Medway 023D","E01016167","Total",576,197,15,182,171,44,156,32,124
"2011","Medway 024A","E01016116","Total",757,263,38,225,244,92,229,41,188
"2011","Medway 024B","E01016127","Total",705,226,26,200,202,78,174,27,147
"2011","Medway 024C","E01016128","Total",545,199,21,178,157,52,149,21,128
"2011","Medway 024D","E01016132","Total",640,164,12,152,216,71,120,32,88
"2011","Medway 025A","E01016094","Total",616,191,10,181,180,71,155,23,132
"2011","Medway 025B","E01016095","Total",523,129,13,116,195,72,100,25,75
"2011","Medway 025C","E01016097","Total",637,213,35,178,182,70,171,34,137
"2011","Medway 025D","E01016098","Total",682,271,43,228,175,82,203,29,174
"2011","Medway 025E","E01016102","Total",620,259,48,211,186,60,191,46,145
"2011","Medway 026A","E01016119","Total",532,164,12,152,186,52,126,30,96
"2011","Medway 026B","E01016120","Total",596,265,34,231,162,65,209,34,175
"2011","Medway 026C","E01016124","Total",673,209,16,193,198,64,171,35,136
"2011","Medway 026D","E01016126","Total",613,167,11,156,231,72,137,33,104
"2011","Medway 027A","E01016025","Total",629,288,36,252,193,71,218,30,188
"2011","Medway 027B","E01016065","Total",635,231,15,216,160,61,176,21,155
"2011","Medway 027C","E01016066","Total",608,202,44,158,192,66,183,41,142
"2011","Medway 027D","E01016067","Total",651,222,34,188,223,72,190,31,159
"2011","Medway 027E","E01016068","Total",667,278,73,205,267,134,209,46,163
"2011","Medway 028A","E01016026","Total",506,98,11,87,188,67,122,39,83
"2011","Medway 028B","E01016027","Total",572,158,8,150,194,75,104,24,80
"2011","Medway 028C","E01016028","Total",598,233,8,225,143,45,171,15,156
"2011","Medway 028D","E01016029","Total",535,147,23,124,170,65,128,25,103
"2011","Medway 029A","E01016087","Total",694,204,9,195,197,84,159,23,136
"2011","Medway 029B","E01016088","Total",597,206,27,179,184,64,180,41,139
"2011","Medway 029C","E01016089","Total",667,249,9,240,178,56,193,23,170
"2011","Medway 029D","E01016090","Total",609,206,5,201,180,47,155,29,126
"2011","Medway 030A","E01016085","Total",646,229,3,226,160,43,160,14,146
"2011","Medway 030B","E01016086","Total",499,177,3,174,143,33,125,12,113
"2011","Medway 030C","E01016091","Total",614,246,12,234,159,46,176,29,147
"2011","Medway 030D","E01016176","Total",575,132,6,126,186,48,119,28,91
"2011","Medway 031A","E01016058","Total",622,145,14,131,169,76,146,29,117
"2011","Medway 031B","E01016059","Total",532,177,33,144,197,75,146,29,117
"2011","Medway 031C","E01016079","Total",488,101,13,88,175,57,110,28,82
"2011","Medway 031D","E01016083","Total",570,250,50,200,187,69,211,44,167
"2011","Medway 031E","E01016084","Total",513,127,43,84,232,96,129,45,84
"2011","Medway 032A","E01016101","Total",565,130,21,109,219,87,98,30,68
"2011","Medway 032B","E01016103","Total",575,125,7,118,189,70,105,22,83
"2011","Medway 032C","E01016104","Total",566,103,14,89,196,96,82,19,63
"2011","Medway 032D","E01016107","Total",602,114,13,101,203,73,88,23,65
"2011","Medway 033A","E01016121","Total",640,250,17,233,167,54,159,20,139
"2011","Medway 033B","E01016122","Total",617,208,9,199,183,56,169,32,137
"2011","Medway 033C","E01016123","Total",635,200,14,186,195,78,157,29,128
"2011","Medway 033D","E01016173","Total",648,241,50,191,201,92,208,45,163
"2011","Medway 034A","E01016078","Total",658,76,25,51,253,141,70,28,42
"2011","Medway 034B","E01016080","Total",620,167,27,140,224,108,130,26,104
"2011","Medway 034C","E01016081","Total",567,64,20,44,262,99,86,37,49
"2011","Medway 034D","E01016082","Total",580,124,22,102,222,89,100,23,77
"2011","Medway 035A","E01016050","Total",666,175,3,172,187,62,136,23,113
"2011","Medway 035B","E01016051","Total",592,133,7,126,219,64,105,26,79
"2011","Medway 035C","E01016052","Total",648,223,8,215,183,49,148,27,121
"2011","Medway 035D","E01016053","Total",637,260,8,252,141,36,176,19,157
"2011","Medway 035E","E01016054","Total",596,150,6,144,162,48,132,15,117
"2011","Medway 036A","E01016092","Total",630,198,12,186,177,60,159,26,133
"2011","Medway 036B","E01016099","Total",621,146,23,123,227,85,117,28,89
"2011","Medway 036C","E01016100","Total",657,216,36,180,187,85,187,37,150
"2011","Medway 036D","E01016105","Total",592,219,13,206,155,55,167,26,141
"2011","Medway 036E","E01016106","Total",591,203,19,184,188,69,152,33,119
"2011","Medway 037A","E01016168","Total",658,266,31,235,185,76,192,38,154
"2011","Medway 037B","E01016169","Total",638,153,9,144,217,60,130,36,94
"2011","Medway 037C","E01016171","Total",638,251,51,200,232,93,183,38,145
"2011","Medway 037D","E01016172","Total",587,183,5,178,170,54,138,16,122
"2011","Medway 038A","E01016055","Total",651,233,26,207,189,74,204,33,171
"2011","Medway 038B","E01016056","Total",630,132,24,108,203,92,125,23,102
"2011","Medway 038C","E01016057","Total",642,131,34,97,254,107,121,38,83
"2011","Medway 038D","E01016060","Total",628,186,8,178,181,57,139,24,115
"2011","Medway 038E","E01016170","Total",634,152,30,122,246,95,122,37,85
"2011","Milton Keynes 001A","E01016796","Total",657,201,7,194,167,79,132,18,114
"2011","Milton Keynes 001B","E01016797","Total",810,288,10,278,201,78,204,18,186
"2011","Milton Keynes 001C","E01016798","Total",731,140,6,134,300,100,113,36,77
"2011","Milton Keynes 001D","E01016799","Total",778,212,12,200,237,98,169,27,142
"2011","Milton Keynes 001E","E01016800","Total",694,190,14,176,206,85,137,22,115
"2011","Milton Keynes 002A","E01016759","Total",582,167,15,152,176,76,136,22,114
"2011","Milton Keynes 002B","E01016760","Total",975,206,38,168,334,180,169,35,134
"2011","Milton Keynes 002C","E01016761","Total",568,154,6,148,156,51,118,15,103
"2011","Milton Keynes 002D","E01016801","Total",565,199,12,187,155,63,132,17,115
"2011","Milton Keynes 002E","E01016802","Total",569,173,5,168,157,51,112,18,94
"2011","Milton Keynes 002F","E01016803","Total",547,150,8,142,154,58,126,22,104
"2011","Milton Keynes 003A","E01016786","Total",625,234,8,226,134,54,172,14,158
"2011","Milton Keynes 003B","E01016787","Total",660,236,24,212,199,78,175,29,146
"2011","Milton Keynes 003C","E01016788","Total",611,130,8,122,208,77,121,20,101
"2011","Milton Keynes 003D","E01016789","Total",502,78,19,59,204,89,91,26,65
"2011","Milton Keynes 003E","E01016790","Total",527,153,6,147,146,41,139,16,123
"2011","Milton Keynes 004A","E01016791","Total",595,179,14,165,170,50,133,23,110
"2011","Milton Keynes 004B","E01016792","Total",525,89,7,82,188,63,97,33,64
"2011","Milton Keynes 004C","E01016793","Total",792,185,16,169,258,106,157,34,123
"2011","Milton Keynes 004D","E01016794","Total",691,178,8,170,168,57,133,18,115
"2011","Milton Keynes 004E","E01016795","Total",686,154,15,139,199,90,113,27,86
"2011","Milton Keynes 005A","E01016762","Total",517,157,21,136,158,64,128,24,104
"2011","Milton Keynes 005B","E01016764","Total",604,150,8,142,143,67,139,20,119
"2011","Milton Keynes 005C","E01016766","Total",536,151,23,128,173,62,128,26,102
"2011","Milton Keynes 005D","E01016767","Total",521,111,7,104,164,51,105,19,86
"2011","Milton Keynes 005E","E01016771","Total",491,143,16,127,172,85,157,35,122
"2011","Milton Keynes 006A","E01016806","Total",697,221,65,156,296,148,212,56,156
"2011","Milton Keynes 006B","E01016807","Total",678,171,32,139,222,100,197,44,153
"2011","Milton Keynes 006C","E01016809","Total",517,128,34,94,200,102,112,28,84
"2011","Milton Keynes 006D","E01016835","Total",677,250,68,182,246,119,179,38,141
"2011","Milton Keynes 007A","E01016763","Total",632,210,9,201,127,44,170,17,153
"2011","Milton Keynes 007B","E01016769","Total",581,137,5,132,175,62,134,18,116
"2011","Milton Keynes 007C","E01016770","Total",675,153,18,135,215,88,141,28,113
"2011","Milton Keynes 007D","E01016773","Total",797,332,5,327,182,54,252,19,233
"2011","Milton Keynes 008A","E01016836","Total",619,136,24,112,223,112,129,30,99
"2011","Milton Keynes 008B","E01016837","Total",698,141,26,115,262,122,138,38,100
"2011","Milton Keynes 008C","E01016838","Total",604,184,26,158,220,109,175,48,127
"2011","Milton Keynes 008D","E01016841","Total",984,227,52,175,280,169,196,36,160
"2011","Milton Keynes 009A","E01016721","Total",619,188,36,152,211,110,171,43,128
"2011","Milton Keynes 009B","E01016765","Total",651,241,22,219,178,76,204,27,177
"2011","Milton Keynes 009C","E01016772","Total",501,153,35,118,195,99,124,24,100
"2011","Milton Keynes 009D","E01016804","Total",719,247,42,205,230,103,210,38,172
"2011","Milton Keynes 010A","E01016812","Total",642,179,9,170,172,77,157,22,135
"2011","Milton Keynes 010B","E01016817","Total",657,199,15,184,160,68,173,21,152
"2011","Milton Keynes 010C","E01016818","Total",840,281,8,273,139,78,239,13,226
"2011","Milton Keynes 010D","E01016840","Total",1052,250,36,214,314,172,201,47,154
"2011","Milton Keynes 011A","E01016719","Total",646,177,22,155,179,82,158,31,127
"2011","Milton Keynes 011B","E01016722","Total",621,129,15,114,209,99,144,31,113
"2011","Milton Keynes 011C","E01016805","Total",606,174,12,162,125,52,127,15,112
"2011","Milton Keynes 011D","E01016808","Total",533,123,16,107,174,74,106,19,87
"2011","Milton Keynes 012A","E01016810","Total",580,251,50,201,177,96,179,30,149
"2011","Milton Keynes 012B","E01016811","Total",490,167,95,72,274,136,101,40,61
"2011","Milton Keynes 012C","E01016819","Total",451,182,44,138,154,70,137,28,109
"2011","Milton Keynes 012D","E01016839","Total",613,186,92,94,297,148,158,62,96
"2011","Milton Keynes 013A","E01016717","Total",632,170,22,148,191,94,160,28,132
"2011","Milton Keynes 013B","E01016720","Total",650,260,44,216,232,112,213,33,180
"2011","Milton Keynes 013C","E01016723","Total",618,121,23,98,225,88,121,31,90
"2011","Milton Keynes 013D","E01016724","Total",643,141,35,106,213,107,142,32,110
"2011","Milton Keynes 014A","E01016718","Total",610,183,60,123,232,116,160,43,117
"2011","Milton Keynes 014B","E01016729","Total",784,248,74,174,293,167,203,48,155
"2011","Milton Keynes 014D","E01016768","Total",869,184,36,148,210,102,167,21,146
"2011","Milton Keynes 014E","E01033499","Total",757,225,20,205,120,79,138,12,126
"2011","Milton Keynes 014F","E01033500","Total",795,59,10,49,76,60,37,3,34
"2011","Milton Keynes 015A","E01016776","Total",539,99,11,88,199,57,107,18,89
"2011","Milton Keynes 015B","E01016813","Total",664,111,16,95,194,101,96,18,78
"2011","Milton Keynes 015C","E01016815","Total",531,117,13,104,183,79,101,21,80
"2011","Milton Keynes 015D","E01016816","Total",601,176,4,172,185,61,128,31,97
"2011","Milton Keynes 016A","E01016731","Total",644,178,23,155,177,79,157,23,134
"2011","Milton Keynes 016B","E01016732","Total",522,125,19,106,155,59,113,25,88
"2011","Milton Keynes 016D","E01016784","Total",665,195,37,158,186,89,140,26,114
"2011","Milton Keynes 016E","E01033501","Total",704,66,31,35,362,173,74,45,29
"2011","Milton Keynes 016F","E01033506","Total",703,74,13,61,355,153,104,41,63
"2011","Milton Keynes 017A","E01016783","Total",744,91,29,62,340,174,95,30,65
"2011","Milton Keynes 017C","E01016820","Total",629,146,33,113,264,105,129,41,88
"2011","Milton Keynes 017D","E01016821","Total",489,62,14,48,240,117,66,27,39
"2011","Milton Keynes 017E","E01016823","Total",788,112,31,81,262,136,106,32,74
"2011","Milton Keynes 017F","E01033503","Total",588,89,12,77,234,107,91,24,67
"2011","Milton Keynes 017G","E01033508","Total",627,44,28,16,298,183,67,34,33
"2011","Milton Keynes 017H","E01033509","Total",602,67,48,19,293,206,60,29,31
"2011","Milton Keynes 017I","E01033511","Total",595,62,32,30,214,122,67,25,42
"2011","Milton Keynes 017J","E01033512","Total",606,66,12,54,273,123,74,26,48
"2011","Milton Keynes 018A","E01016726","Total",581,161,71,90,257,130,135,43,92
"2011","Milton Keynes 018B","E01016733","Total",589,161,64,97,290,163,135,44,91
"2011","Milton Keynes 018C","E01016845","Total",709,288,99,189,303,139,199,56,143
"2011","Milton Keynes 018D","E01016846","Total",626,177,31,146,233,124,164,37,127
"2011","Milton Keynes 018E","E01016848","Total",575,201,36,165,159,80,186,27,159
"2011","Milton Keynes 019B","E01016780","Total",651,86,19,67,268,97,90,32,58
"2011","Milton Keynes 019C","E01016781","Total",553,114,6,108,247,67,115,28,87
"2011","Milton Keynes 019D","E01016814","Total",738,271,5,266,157,67,184,22,162
"2011","Milton Keynes 019E","E01033505","Total",514,40,11,29,228,116,55,26,29
"2011","Milton Keynes 019F","E01033522","Total",548,66,16,50,224,118,82,30,52
"2011","Milton Keynes 019G","E01033523","Total",528,41,19,22,247,130,55,24,31
"2011","Milton Keynes 019H","E01033525","Total",582,78,34,44,320,135,72,31,41
"2011","Milton Keynes 020A","E01016774","Total",675,165,6,159,249,88,147,27,120
"2011","Milton Keynes 020B","E01016775","Total",685,142,21,121,259,108,150,39,111
"2011","Milton Keynes 020C","E01016777","Total",641,135,12,123,233,98,131,18,113
"2011","Milton Keynes 020D","E01016778","Total",683,131,22,109,282,114,147,40,107
"2011","Milton Keynes 021A","E01016725","Total",574,125,51,74,218,122,112,33,79
"2011","Milton Keynes 021B","E01016727","Total",653,158,32,126,229,106,161,41,120
"2011","Milton Keynes 021C","E01016728","Total",707,94,36,58,316,187,105,41,64
"2011","Milton Keynes 021D","E01016847","Total",844,290,63,227,326,157,271,60,211
"2011","Milton Keynes 022A","E01016822","Total",662,150,37,113,256,111,134,37,97
"2011","Milton Keynes 022B","E01016824","Total",658,117,23,94,285,108,110,31,79
"2011","Milton Keynes 022C","E01016825","Total",635,122,30,92,249,114,119,29,90
"2011","Milton Keynes 022D","E01016827","Total",715,101,26,75,284,128,104,33,71
"2011","Milton Keynes 022E","E01016828","Total",732,121,13,108,259,84,111,25,86
"2011","Milton Keynes 023B","E01016842","Total",601,262,97,165,262,145,175,43,132
"2011","Milton Keynes 023C","E01016843","Total",528,197,98,99,246,149,138,50,88
"2011","Milton Keynes 023D","E01016844","Total",636,298,65,233,207,112,233,58,175
"2011","Milton Keynes 023E","E01033497","Total",592,218,25,193,114,72,163,11,152
"2011","Milton Keynes 023F","E01033498","Total",643,202,28,174,162,110,155,22,133
"2011","Milton Keynes 024A","E01016734","Total",517,158,10,148,132,53,134,20,114
"2011","Milton Keynes 024B","E01016735","Total",869,190,11,179,271,102,159,33,126
"2011","Milton Keynes 024C","E01016736","Total",591,211,4,207,138,49,145,11,134
"2011","Milton Keynes 024D","E01016826","Total",531,51,13,38,272,64,75,25,50
"2011","Milton Keynes 025B","E01016752","Total",609,92,36,56,324,123,101,36,65
"2011","Milton Keynes 025C","E01016753","Total",881,131,50,81,397,158,142,50,92
"2011","Milton Keynes 025D","E01016755","Total",719,148,29,119,308,138,118,19,99
"2011","Milton Keynes 025E","E01033514","Total",511,52,9,43,274,152,71,26,45
"2011","Milton Keynes 025F","E01033515","Total",620,70,17,53,367,120,97,44,53
"2011","Milton Keynes 025G","E01033517","Total",548,23,9,14,307,137,51,27,24
"2011","Milton Keynes 026A","E01016754","Total",728,217,18,199,201,92,179,28,151
"2011","Milton Keynes 026B","E01016756","Total",933,241,44,197,369,157,219,52,167
"2011","Milton Keynes 026C","E01016757","Total",593,109,21,88,221,98,114,20,94
"2011","Milton Keynes 026D","E01016758","Total",660,104,25,79,275,106,112,32,80
"2011","Milton Keynes 027A","E01016737","Total",615,152,31,121,233,102,121,30,91
"2011","Milton Keynes 027B","E01016738","Total",763,293,55,238,252,122,224,41,183
"2011","Milton Keynes 027C","E01016739","Total",594,127,18,109,199,91,122,25,97
"2011","Milton Keynes 027D","E01016740","Total",559,183,11,172,153,62,147,25,122
"2011","Milton Keynes 027E","E01016741","Total",712,277,46,231,226,89,210,36,174
"2011","Milton Keynes 028A","E01016748","Total",815,109,23,86,336,132,104,23,81
"2011","Milton Keynes 028C","E01016750","Total",634,129,11,118,221,89,120,22,98
"2011","Milton Keynes 028D","E01016751","Total",629,106,17,89,274,107,116,34,82
"2011","Milton Keynes 028E","E01033519","Total",701,87,24,63,334,158,81,33,48
"2011","Milton Keynes 028F","E01033520","Total",631,70,9,61,322,112,93,30,63
"2011","Milton Keynes 029A","E01016829","Total",664,249,52,197,210,101,196,33,163
"2011","Milton Keynes 029B","E01016831","Total",611,185,22,163,194,75,131,20,111
"2011","Milton Keynes 029C","E01016832","Total",498,144,19,125,169,67,119,27,92
"2011","Milton Keynes 029D","E01016833","Total",506,162,4,158,128,42,120,20,100
"2011","Milton Keynes 029E","E01016834","Total",651,256,47,209,214,93,218,42,176
"2011","Milton Keynes 030A","E01016710","Total",743,319,27,292,187,76,279,45,234
"2011","Milton Keynes 030B","E01016714","Total",750,305,59,246,259,141,210,30,180
"2011","Milton Keynes 030C","E01016716","Total",772,276,35,241,212,99,216,37,179
"2011","Milton Keynes 030D","E01016745","Total",616,166,23,143,187,73,168,40,128
"2011","Milton Keynes 031A","E01016711","Total",955,262,22,240,274,146,203,27,176
"2011","Milton Keynes 031B","E01016713","Total",714,232,22,210,202,74,166,18,148
"2011","Milton Keynes 031C","E01016715","Total",640,225,42,183,221,91,201,45,156
"2011","Milton Keynes 031D","E01016830","Total",515,106,9,97,161,68,107,21,86
"2011","Milton Keynes 032A","E01016742","Total",577,221,93,128,281,139,166,57,109
"2011","Milton Keynes 032B","E01016743","Total",787,241,94,147,347,175,218,71,147
"2011","Milton Keynes 032C","E01016744","Total",545,176,78,98,273,126,144,46,98
"2011","Milton Keynes 032D","E01016746","Total",681,263,45,218,212,120,194,32,162
"2011","Portsmouth 001A","E01017112","Total",664,221,72,149,285,106,214,72,142
"2011","Portsmouth 001B","E01017115","Total",485,162,44,118,203,69,144,47,97
"2011","Portsmouth 001C","E01017117","Total",600,192,61,131,249,101,183,59,124
"2011","Portsmouth 001D","E01017119","Total",648,201,52,149,255,114,203,59,144
"2011","Portsmouth 001E","E01017120","Total",679,289,39,250,188,74,252,29,223
"2011","Portsmouth 002A","E01017051","Total",789,273,86,187,297,167,215,53,162
"2011","Portsmouth 002B","E01017052","Total",572,198,41,157,198,85,162,36,126
"2011","Portsmouth 002C","E01017053","Total",535,237,70,167,208,89,171,45,126
"2011","Portsmouth 002D","E01017118","Total",563,199,77,122,260,105,181,62,119
"2011","Portsmouth 003A","E01017050","Total",690,288,18,270,161,58,203,26,177
"2011","Portsmouth 003B","E01017061","Total",664,238,5,233,179,49,155,21,134
"2011","Portsmouth 003C","E01017063","Total",626,221,7,214,182,55,158,21,137
"2011","Portsmouth 003D","E01017064","Total",707,300,11,289,175,64,203,21,182
"2011","Portsmouth 004A","E01017054","Total",624,232,17,215,164,64,210,27,183
"2011","Portsmouth 004B","E01017113","Total",621,201,35,166,194,78,161,34,127
"2011","Portsmouth 004C","E01017114","Total",702,213,11,202,109,52,118,21,97
"2011","Portsmouth 004D","E01017116","Total",624,223,75,148,287,152,163,55,108
"2011","Portsmouth 006A","E01017055","Total",676,232,16,216,180,75,187,27,160
"2011","Portsmouth 006B","E01017056","Total",497,128,12,116,212,70,113,28,85
"2011","Portsmouth 006C","E01017057","Total",570,125,10,115,205,72,119,23,96
"2011","Portsmouth 006D","E01017058","Total",651,185,50,135,273,110,182,52,130
"2011","Portsmouth 006E","E01017060","Total",633,222,12,210,225,65,166,40,126
"2011","Portsmouth 007A","E01017086","Total",500,131,5,126,171,64,124,18,106
"2011","Portsmouth 007B","E01017089","Total",629,173,57,116,259,124,138,47,91
"2011","Portsmouth 007C","E01017090","Total",607,142,37,105,214,95,136,29,107
"2011","Portsmouth 007D","E01017091","Total",723,308,35,273,210,115,217,28,189
"2011","Portsmouth 007E","E01017092","Total",642,213,12,201,174,66,164,30,134
"2011","Portsmouth 008A","E01017014","Total",634,159,23,136,231,88,146,36,110
"2011","Portsmouth 008B","E01017046","Total",780,174,6,168,171,54,141,29,112
"2011","Portsmouth 008C","E01017047","Total",636,170,20,150,247,88,154,33,121
"2011","Portsmouth 008D","E01017048","Total",593,144,15,129,221,71,117,24,93
"2011","Portsmouth 008E","E01017085","Total",671,232,12,220,139,47,196,20,176
"2011","Portsmouth 009A","E01017084","Total",565,145,12,133,184,65,124,26,98
"2011","Portsmouth 009B","E01017087","Total",596,140,17,123,181,78,131,30,101
"2011","Portsmouth 009C","E01017088","Total",687,206,19,187,214,92,174,35,139
"2011","Portsmouth 009D","E01017105","Total",639,200,24,176,180,83,155,17,138
"2011","Portsmouth 009E","E01017107","Total",662,177,36,141,213,102,159,38,121
"2011","Portsmouth 010A","E01017104","Total",473,148,27,121,150,69,132,25,107
"2011","Portsmouth 010B","E01017106","Total",627,172,32,140,203,92,186,29,157
"2011","Portsmouth 010C","E01017108","Total",709,252,55,197,209,92,213,39,174
"2011","Portsmouth 010D","E01017109","Total",599,196,52,144,217,123,156,34,122
"2011","Portsmouth 011A","E01017041","Total",517,130,15,115,183,76,130,26,104
"2011","Portsmouth 011B","E01017043","Total",524,126,31,95,214,102,111,42,69
"2011","Portsmouth 011C","E01017044","Total",617,128,20,108,212,90,133,22,111
"2011","Portsmouth 011D","E01017049","Total",594,165,9,156,176,55,151,27,124
"2011","Portsmouth 011E","E01017110","Total",605,136,32,104,205,102,121,30,91
"2011","Portsmouth 011F","E01017111","Total",612,156,43,113,230,116,128,37,91
"2011","Portsmouth 012A","E01017013","Total",649,161,35,126,250,112,125,32,93
"2011","Portsmouth 012B","E01017042","Total",528,131,38,93,217,88,116,31,85
"2011","Portsmouth 012C","E01017045","Total",510,110,25,85,214,91,100,36,64
"2011","Portsmouth 012D","E01017075","Total",672,174,60,114,276,131,148,34,114
"2011","Portsmouth 012E","E01017082","Total",728,167,39,128,259,138,171,38,133
"2011","Portsmouth 012F","E01017083","Total",723,170,41,129,273,109,153,41,112
"2011","Portsmouth 013A","E01017036","Total",593,214,82,132,269,130,157,60,97
"2011","Portsmouth 013B","E01017037","Total",649,330,106,224,242,107,232,52,180
"2011","Portsmouth 013C","E01017038","Total",820,509,81,428,218,102,346,44,302
"2011","Portsmouth 013D","E01017102","Total",713,287,46,241,183,82,251,31,220
"2011","Portsmouth 013E","E01017103","Total",502,244,92,152,219,109,164,45,119
"2011","Portsmouth 014A","E01017015","Total",627,215,26,189,198,53,168,31,137
"2011","Portsmouth 014B","E01017016","Total",634,156,16,140,228,100,141,24,117
"2011","Portsmouth 014C","E01017017","Total",602,179,13,166,198,72,150,23,127
"2011","Portsmouth 014D","E01017018","Total",620,201,20,181,216,78,158,28,130
"2011","Portsmouth 014E","E01017019","Total",746,196,36,160,256,114,171,39,132
"2011","Portsmouth 014F","E01017020","Total",953,285,64,221,330,151,250,47,203
"2011","Portsmouth 015A","E01017076","Total",742,174,49,125,221,105,164,32,132
"2011","Portsmouth 015B","E01017077","Total",886,404,61,343,225,126,315,36,279
"2011","Portsmouth 015C","E01017078","Total",638,147,39,108,224,107,135,30,105
"2011","Portsmouth 015D","E01017079","Total",627,186,44,142,190,86,144,31,113
"2011","Portsmouth 015E","E01017080","Total",827,250,46,204,238,139,169,28,141
"2011","Portsmouth 015F","E01017081","Total",666,162,41,121,219,98,153,40,113
"2011","Portsmouth 016A","E01017031","Total",970,482,74,408,253,143,405,58,347
"2011","Portsmouth 016B","E01017032","Total",612,355,45,310,109,50,203,18,185
"2011","Portsmouth 016D","E01017034","Total",582,291,57,234,156,92,195,26,169
"2011","Portsmouth 016E","E01017039","Total",746,363,71,292,234,113,285,51,234
"2011","Portsmouth 016F","E01017040","Total",644,342,96,246,245,107,233,57,176
"2011","Portsmouth 016G","E01033381","Total",724,253,45,208,119,64,108,17,91
"2011","Portsmouth 016H","E01033383","Total",594,272,60,212,159,61,196,34,162
"2011","Portsmouth 017A","E01017021","Total",637,270,12,258,127,41,188,24,164
"2011","Portsmouth 017B","E01017093","Total",495,184,22,162,110,49,152,18,134
"2011","Portsmouth 017C","E01017096","Total",670,215,13,202,177,80,170,22,148
"2011","Portsmouth 017D","E01017099","Total",706,239,25,214,200,80,186,33,153
"2011","Portsmouth 017E","E01017100","Total",521,121,11,110,205,72,103,21,82
"2011","Portsmouth 017F","E01017101","Total",656,184,32,152,222,86,147,31,116
"2011","Portsmouth 018A","E01017035","Total",765,472,85,387,232,139,323,42,281
"2011","Portsmouth 018B","E01017128","Total",653,183,13,170,74,28,112,15,97
"2011","Portsmouth 018C","E01017129","Total",664,228,20,208,101,53,122,19,103
"2011","Portsmouth 018D","E01017130","Total",777,401,91,310,280,135,263,54,209
"2011","Portsmouth 018E","E01017132","Total",925,471,116,355,337,196,283,68,215
"2011","Portsmouth 018F","E01017133","Total",847,451,52,399,139,68,258,25,233
"2011","Portsmouth 019A","E01017023","Total",669,191,24,167,194,78,147,23,124
"2011","Portsmouth 019B","E01017025","Total",818,226,38,188,177,79,173,41,132
"2011","Portsmouth 019C","E01017026","Total",771,259,24,235,188,73,180,29,151
"2011","Portsmouth 019D","E01017029","Total",706,202,19,183,177,76,147,22,125
"2011","Portsmouth 019E","E01017030","Total",705,196,28,168,170,80,144,27,117
"2011","Portsmouth 020A","E01017022","Total",661,225,12,213,87,39,155,7,148
"2011","Portsmouth 020B","E01017024","Total",725,169,11,158,118,60,120,11,109
"2011","Portsmouth 020C","E01017027","Total",626,203,15,188,107,48,129,17,112
"2011","Portsmouth 020D","E01017028","Total",690,189,22,167,134,50,126,27,99
"2011","Portsmouth 020E","E01017124","Total",801,228,26,202,163,77,158,25,133
"2011","Portsmouth 021A","E01017094","Total",611,140,21,119,220,108,125,27,98
"2011","Portsmouth 021B","E01017095","Total",869,213,38,175,238,115,159,30,129
"2011","Portsmouth 021C","E01017097","Total",725,205,38,167,216,95,137,33,104
"2011","Portsmouth 021D","E01017098","Total",646,201,55,146,200,88,148,27,121
"2011","Portsmouth 022A","E01017122","Total",854,244,13,231,114,47,148,16,132
"2011","Portsmouth 022B","E01017125","Total",866,404,18,386,116,43,249,20,229
"2011","Portsmouth 022C","E01017127","Total",999,275,17,258,114,61,183,15,168
"2011","Portsmouth 022D","E01017135","Total",836,300,14,286,117,48,183,9,174
"2011","Portsmouth 023A","E01017067","Total",653,240,30,210,182,76,175,39,136
"2011","Portsmouth 023B","E01017068","Total",908,280,42,238,191,99,185,27,158
"2011","Portsmouth 023C","E01017069","Total",745,184,15,169,250,133,187,60,127
"2011","Portsmouth 023D","E01017070","Total",726,284,8,276,121,30,183,16,167
"2011","Portsmouth 023E","E01017074","Total",793,214,71,143,309,168,143,39,104
"2011","Portsmouth 024A","E01017073","Total",953,373,34,339,136,72,206,21,185
"2011","Portsmouth 024B","E01017123","Total",1129,368,16,352,101,57,233,7,226
"2011","Portsmouth 024C","E01017131","Total",735,284,22,262,145,57,161,17,144
"2011","Portsmouth 024E","E01033380","Total",850,321,38,283,97,60,84,7,77
"2011","Portsmouth 024F","E01033384","Total",803,312,6,306,94,37,178,9,169
"2011","Portsmouth 025A","E01017071","Total",656,136,9,127,166,71,106,18,88
"2011","Portsmouth 025B","E01017072","Total",627,197,10,187,157,54,122,20,102
"2011","Portsmouth 025C","E01017121","Total",763,213,13,200,142,61,154,22,132
"2011","Portsmouth 025D","E01017126","Total",820,228,14,214,143,67,141,10,131
"2011","Portsmouth 026A","E01017059","Total",648,250,4,246,182,66,165,29,136
"2011","Portsmouth 026B","E01017062","Total",619,157,8,149,243,94,128,26,102
"2011","Portsmouth 026C","E01017066","Total",758,218,20,198,243,94,177,33,144
"2011","Portsmouth 026D","E01032604","Total",605,182,10,172,191,54,141,17,124
"2011","Reading 001A","E01016407","Total",653,226,11,215,184,74,158,26,132
"2011","Reading 001B","E01016408","Total",577,131,12,119,192,79,100,30,70
"2011","Reading 001C","E01016410","Total",659,156,13,143,195,78,127,17,110
"2011","Reading 001D","E01016411","Total",641,255,10,245,165,59,152,22,130
"2011","Reading 001E","E01016412","Total",585,121,9,112,220,88,92,17,75
"2011","Reading 002A","E01016386","Total",594,223,7,216,164,46,142,20,122
"2011","Reading 002B","E01016387","Total",585,168,2,166,203,79,129,26,103
"2011","Reading 002C","E01016425","Total",658,147,11,136,275,124,110,26,84
"2011","Reading 002D","E01016426","Total",502,121,3,118,211,71,81,16,65
"2011","Reading 002E","E01016430","Total",507,93,6,87,222,82,79,28,51
"2011","Reading 003A","E01016364","Total",578,144,5,139,183,101,122,17,105
"2011","Reading 003B","E01016409","Total",728,249,9,240,192,70,197,18,179
"2011","Reading 003C","E01016427","Total",642,202,13,189,196,84,146,25,121
"2011","Reading 003D","E01016428","Total",723,189,14,175,257,114,144,35,109
"2011","Reading 003E","E01016429","Total",615,140,6,134,226,98,104,24,80
"2011","Reading 004A","E01016362","Total",819,232,22,210,146,91,175,20,155
"2011","Reading 004B","E01016363","Total",709,163,74,89,332,173,131,55,76
"2011","Reading 004C","E01016365","Total",765,142,21,121,166,88,109,20,89
"2011","Reading 004D","E01016366","Total",667,154,21,133,206,88,121,33,88
"2011","Reading 004E","E01016367","Total",687,179,25,154,199,104,163,28,135
"2011","Reading 005A","E01016380","Total",674,157,13,144,216,87,129,22,107
"2011","Reading 005B","E01016383","Total",649,134,28,106,203,92,115,19,96
"2011","Reading 005C","E01016384","Total",604,149,9,140,188,72,96,21,75
"2011","Reading 005D","E01016431","Total",625,163,12,151,211,86,135,24,111
"2011","Reading 005E","E01016432","Total",634,258,30,228,194,80,176,30,146
"2011","Reading 006A","E01016381","Total",520,145,45,100,209,98,130,47,83
"2011","Reading 006B","E01016382","Total",697,189,48,141,267,138,177,45,132
"2011","Reading 006C","E01016385","Total",602,123,28,95,222,103,132,35,97
"2011","Reading 006D","E01016396","Total",543,205,61,144,203,81,160,42,118
"2011","Reading 006E","E01016397","Total",565,220,54,166,206,94,175,49,126
"2011","Reading 007A","E01016355","Total",790,99,17,82,205,128,111,25,86
"2011","Reading 007B","E01016358","Total",740,164,32,132,203,117,121,20,101
"2011","Reading 007C","E01016359","Total",820,166,57,109,332,177,132,49,83
"2011","Reading 007D","E01016360","Total",772,179,48,131,281,157,131,35,96
"2011","Reading 007E","E01016361","Total",739,170,59,111,269,152,124,29,95
"2011","Reading 008A","E01016356","Total",673,166,49,117,217,119,129,30,99
"2011","Reading 008B","E01016357","Total",736,125,30,95,207,131,111,24,87
"2011","Reading 008C","E01016395","Total",639,244,23,221,151,73,175,25,150
"2011","Reading 008D","E01016398","Total",743,131,49,82,237,141,115,27,88
"2011","Reading 008E","E01016399","Total",562,112,20,92,182,88,113,25,88
"2011","Reading 008F","E01016400","Total",642,164,28,136,184,95,140,26,114
"2011","Reading 009A","E01016394","Total",566,267,53,214,192,82,188,34,154
"2011","Reading 009B","E01016433","Total",601,213,18,195,159,74,175,11,164
"2011","Reading 009C","E01016434","Total",680,186,27,159,230,108,170,36,134
"2011","Reading 009D","E01016435","Total",567,228,24,204,183,69,170,34,136
"2011","Reading 009E","E01016436","Total",608,194,20,174,206,78,160,32,128
"2011","Reading 010B","E01016402","Total",643,151,37,114,188,99,108,29,79
"2011","Reading 010C","E01016404","Total",801,151,36,115,270,162,136,27,109
"2011","Reading 010D","E01016405","Total",650,102,36,66,271,152,98,43,55
"2011","Reading 010E","E01016406","Total",480,74,10,64,135,65,71,16,55
"2011","Reading 010F","E01033417","Total",598,108,8,100,73,48,72,5,67
"2011","Reading 010G","E01033421","Total",868,237,34,203,211,114,190,30,160
"2011","Reading 011B","E01016353","Total",817,192,37,155,209,127,147,38,109
"2011","Reading 011D","E01016378","Total",966,191,29,162,196,123,140,20,120
"2011","Reading 011E","E01016391","Total",850,178,55,123,258,131,133,41,92
"2011","Reading 011F","E01033415","Total",766,139,12,127,111,84,92,10,82
"2011","Reading 011G","E01033418","Total",625,87,20,67,123,88,48,12,36
"2011","Reading 011H","E01033420","Total",645,141,10,131,84,59,83,6,77
"2011","Reading 011I","E01033422","Total",613,139,13,126,93,63,100,7,93
"2011","Reading 011J","E01033423","Total",609,97,13,84,95,67,69,8,61
"2011","Reading 012A","E01016401","Total",590,133,11,122,149,64,118,22,96
"2011","Reading 012B","E01016403","Total",678,125,13,112,239,102,121,35,86
"2011","Reading 012C","E01016416","Total",625,106,10,96,105,65,66,10,56
"2011","Reading 012D","E01016417","Total",568,130,10,120,122,62,89,22,67
"2011","Reading 012E","E01016418","Total",591,136,19,117,122,71,75,13,62
"2011","Reading 013A","E01016388","Total",602,177,19,158,163,66,141,18,123
"2011","Reading 013B","E01016389","Total",702,199,67,132,309,162,156,44,112
"2011","Reading 013C","E01016390","Total",758,176,14,162,134,85,119,19,100
"2011","Reading 013D","E01016392","Total",968,196,23,173,196,133,136,14,122
"2011","Reading 013E","E01016393","Total",652,189,13,176,167,98,129,21,108
"2011","Reading 014A","E01016374","Total",693,105,30,75,166,94,81,18,63
"2011","Reading 014B","E01016375","Total",507,116,23,93,138,84,90,23,67
"2011","Reading 014C","E01016376","Total",665,166,13,153,130,84,106,13,93
"2011","Reading 014D","E01016379","Total",764,146,20,126,154,99,97,21,76
"2011","Reading 014E","E01016413","Total",453,118,10,108,108,63,69,11,58
"2011","Reading 014F","E01016414","Total",643,121,12,109,142,77,90,14,76
"2011","Reading 015A","E01016419","Total",762,217,29,188,183,89,186,29,157
"2011","Reading 015B","E01016420","Total",567,207,51,156,245,126,177,37,140
"2011","Reading 015C","E01016421","Total",521,203,16,187,140,62,157,25,132
"2011","Reading 015D","E01016422","Total",650,313,33,280,149,76,220,25,195
"2011","Reading 015E","E01016423","Total",602,234,38,196,204,79,191,28,163
"2011","Reading 015F","E01016424","Total",480,120,19,101,171,73,100,22,78
"2011","Reading 016A","E01016370","Total",498,185,39,146,146,83,110,17,93
"2011","Reading 016B","E01016371","Total",606,180,21,159,167,76,145,22,123
"2011","Reading 016C","E01016373","Total",535,164,76,88,233,100,121,40,81
"2011","Reading 016D","E01016415","Total",687,301,60,241,221,133,199,32,167
"2011","Reading 017A","E01016368","Total",531,200,62,138,216,84,161,49,112
"2011","Reading 017B","E01016372","Total",478,163,49,114,185,90,130,30,100
"2011","Reading 017C","E01016377","Total",635,189,46,143,210,108,152,34,118
"2011","Reading 017D","E01016438","Total",521,200,56,144,197,87,144,35,109
"2011","Reading 017E","E01016442","Total",1106,231,95,136,401,219,204,72,132
"2011","Reading 017F","E01016443","Total",545,187,69,118,262,116,139,45,94
"2011","Reading 018A","E01016369","Total",639,233,28,205,182,76,176,40,136
"2011","Reading 018B","E01016437","Total",518,121,36,85,206,103,125,30,95
"2011","Reading 018C","E01016439","Total",584,165,43,122,210,92,141,46,95
"2011","Reading 018D","E01016440","Total",555,161,29,132,208,87,144,42,102
"2011","Reading 018E","E01016441","Total",574,224,67,157,223,91,198,51,147
"2011","Slough 001A","E01016450","Total",593,202,70,132,297,145,164,52,112
"2011","Slough 001B","E01016451","Total",607,228,79,149,288,140,176,53,123
"2011","Slough 001C","E01016452","Total",643,223,42,181,243,104,179,35,144
"2011","Slough 001D","E01016453","Total",660,227,35,192,214,99,165,33,132
"2011","Slough 001E","E01016454","Total",611,198,42,156,222,100,176,37,139
"2011","Slough 001F","E01016455","Total",534,133,51,82,227,105,120,39,81
"2011","Slough 002A","E01016483","Total",561,125,36,89,259,134,128,45,83
"2011","Slough 002B","E01016484","Total",547,146,31,115,208,105,143,35,108
"2011","Slough 002C","E01016485","Total",539,119,22,97,253,125,134,48,86
"2011","Slough 002D","E01016486","Total",640,201,43,158,252,131,164,34,130
"2011","Slough 002E","E01016487","Total",470,100,35,65,229,98,129,50,79
"2011","Slough 002F","E01016488","Total",705,170,43,127,283,150,139,34,105
"2011","Slough 003A","E01016493","Total",484,89,15,74,157,57,87,23,64
"2011","Slough 003B","E01016494","Total",825,160,43,117,285,157,138,41,97
"2011","Slough 003C","E01016495","Total",682,133,9,124,187,102,142,27,115
"2011","Slough 003D","E01016496","Total",574,189,48,141,220,109,118,26,92
"2011","Slough 003E","E01016497","Total",484,110,13,97,190,63,106,25,81
"2011","Slough 003F","E01016498","Total",647,144,50,94,259,122,151,41,110
"2011","Slough 003G","E01016499","Total",502,127,47,80,222,98,120,37,83
"2011","Slough 004A","E01016444","Total",473,116,36,80,255,133,143,59,84
"2011","Slough 004B","E01016445","Total",524,128,39,89,280,135,143,59,84
"2011","Slough 004C","E01016446","Total",453,114,33,81,219,101,122,50,72
"2011","Slough 004D","E01016447","Total",506,114,41,73,241,143,111,48,63
"2011","Slough 004E","E01016448","Total",753,209,45,164,292,170,204,57,147
"2011","Slough 004F","E01016449","Total",625,178,60,118,295,138,164,54,110
"2011","Slough 005A","E01016516","Total",456,106,34,72,241,111,122,50,72
"2011","Slough 005B","E01016517","Total",458,98,24,74,194,101,118,36,82
"2011","Slough 005C","E01016518","Total",600,125,34,91,242,116,103,39,64
"2011","Slough 005D","E01016519","Total",1038,299,34,265,301,145,243,35,208
"2011","Slough 005E","E01016520","Total",573,196,60,136,265,108,178,58,120
"2011","Slough 005F","E01016521","Total",634,198,26,172,239,114,173,24,149
"2011","Slough 006A","E01016467","Total",576,132,25,107,214,106,113,27,86
"2011","Slough 006B","E01016468","Total",627,113,24,89,253,112,117,38,79
"2011","Slough 006C","E01016469","Total",674,188,34,154,221,111,156,29,127
"2011","Slough 006D","E01016470","Total",678,126,16,110,217,111,100,22,78
"2011","Slough 006E","E01016471","Total",494,110,20,90,184,70,105,24,81
"2011","Slough 006F","E01016472","Total",592,184,30,154,219,85,165,41,124
"2011","Slough 007A","E01016456","Total",639,173,41,132,251,132,185,57,128
"2011","Slough 007B","E01016457","Total",511,97,29,68,226,119,119,56,63
"2011","Slough 007C","E01016458","Total",557,180,57,123,261,120,151,49,102
"2011","Slough 007D","E01016459","Total",695,147,54,93,316,180,115,48,67
"2011","Slough 007E","E01016460","Total",545,132,33,99,220,119,129,46,83
"2011","Slough 007F","E01016461","Total",933,163,40,123,369,223,165,55,110
"2011","Slough 008A","E01016473","Total",746,98,41,57,372,194,111,55,56
"2011","Slough 008B","E01016474","Total",831,263,51,212,272,148,229,44,185
"2011","Slough 008C","E01016475","Total",622,156,40,116,275,147,165,50,115
"2011","Slough 008D","E01016476","Total",673,95,40,55,309,173,95,37,58
"2011","Slough 008E","E01016477","Total",1023,156,55,101,363,217,136,44,92
"2011","Slough 008F","E01016478","Total",694,127,30,97,263,145,128,44,84
"2011","Slough 009A","E01016462","Total",830,137,49,88,329,190,156,58,98
"2011","Slough 009B","E01016463","Total",613,198,53,145,250,125,180,45,135
"2011","Slough 009C","E01016464","Total",608,173,46,127,234,139,128,50,78
"2011","Slough 009D","E01016465","Total",967,211,66,145,427,243,172,61,111
"2011","Slough 009F","E01032729","Total",603,164,46,118,232,142,141,31,110
"2011","Slough 009G","E01032730","Total",620,141,50,91,254,171,90,29,61
"2011","Slough 010A","E01016506","Total",811,117,40,77,253,155,97,35,62
"2011","Slough 010B","E01016507","Total",614,173,19,154,210,90,171,38,133
"2011","Slough 010C","E01016508","Total",605,158,30,128,253,114,132,37,95
"2011","Slough 010D","E01016509","Total",619,121,10,111,179,70,134,24,110
"2011","Slough 010E","E01016510","Total",457,109,9,100,167,53,116,31,85
"2011","Slough 011A","E01016511","Total",775,208,21,187,239,124,172,30,142
"2011","Slough 011B","E01016512","Total",842,186,29,157,252,160,148,35,113
"2011","Slough 011C","E01016513","Total",592,126,15,111,250,89,140,40,100
"2011","Slough 011D","E01016514","Total",821,161,24,137,215,122,152,26,126
"2011","Slough 011E","E01016515","Total",624,117,11,106,274,107,134,51,83
"2011","Slough 012A","E01016500","Total",606,137,26,111,259,115,143,41,102
"2011","Slough 012B","E01016501","Total",603,200,55,145,249,109,177,42,135
"2011","Slough 012C","E01016502","Total",502,130,28,102,231,95,137,47,90
"2011","Slough 012D","E01016503","Total",601,162,21,141,217,107,173,39,134
"2011","Slough 012E","E01016504","Total",473,111,7,104,159,56,107,24,83
"2011","Slough 012F","E01016505","Total",660,221,44,177,248,107,183,37,146
"2011","Slough 013B","E01016490","Total",843,301,70,231,319,149,244,45,199
"2011","Slough 013C","E01016491","Total",665,199,19,180,208,89,164,27,137
"2011","Slough 013D","E01016492","Total",601,154,33,121,254,105,132,41,91
"2011","Slough 013E","E01032731","Total",507,101,37,64,271,132,87,35,52
"2011","Slough 013F","E01032732","Total",660,187,36,151,242,123,157,28,129
"2011","Slough 014A","E01016479","Total",579,103,48,55,257,139,79,35,44
"2011","Slough 014B","E01016480","Total",519,143,36,107,191,84,128,29,99
"2011","Slough 014C","E01016481","Total",715,165,32,133,186,106,127,19,108
"2011","Slough 014D","E01016482","Total",720,118,21,97,209,103,100,26,74
"2011","Southampton 001A","E01017144","Total",427,159,14,145,100,42,92,14,78
"2011","Southampton 001B","E01017145","Total",651,242,12,230,116,52,155,16,139
"2011","Southampton 001C","E01017146","Total",707,224,21,203,177,73,136,14,122
"2011","Southampton 001D","E01017148","Total",604,291,9,282,93,40,82,10,72
"2011","Southampton 001E","E01017149","Total",460,163,26,137,144,50,117,28,89
"2011","Southampton 002A","E01017180","Total",581,118,12,106,188,75,110,30,80
"2011","Southampton 002B","E01017181","Total",559,189,32,157,174,80,184,31,153
"2011","Southampton 002C","E01017183","Total",664,171,16,155,218,88,131,30,101
"2011","Southampton 002D","E01017185","Total",730,257,48,209,257,123,192,36,156
"2011","Southampton 002E","E01017187","Total",682,197,34,163,198,98,186,32,154
"2011","Southampton 003A","E01017264","Total",483,202,32,170,117,66,128,21,107
"2011","Southampton 003B","E01017265","Total",751,315,52,263,216,92,246,44,202
"2011","Southampton 003C","E01017270","Total",556,258,8,250,108,48,182,12,170
"2011","Southampton 003D","E01017271","Total",466,152,2,150,111,42,103,13,90
"2011","Southampton 004A","E01017182","Total",725,406,13,393,117,50,325,17,308
"2011","Southampton 004B","E01017184","Total",603,198,25,173,176,70,192,29,163
"2011","Southampton 004C","E01017186","Total",695,194,41,153,230,88,200,45,155
"2011","Southampton 004D","E01017188","Total",623,200,50,150,257,98,200,51,149
"2011","Southampton 005A","E01017266","Total",483,160,42,118,163,61,122,40,82
"2011","Southampton 005B","E01017267","Total",442,160,15,145,92,38,111,18,93
"2011","Southampton 005E","E01017272","Total",506,156,52,104,205,92,143,43,100
"2011","Southampton 005F","E01032756","Total",963,411,38,373,169,79,219,30,189
"2011","Southampton 006A","E01017147","Total",637,194,10,184,134,67,143,16,127
"2011","Southampton 006B","E01017150","Total",615,236,12,224,125,51,129,15,114
"2011","Southampton 006C","E01017151","Total",733,290,22,268,170,81,236,37,199
"2011","Southampton 006D","E01017152","Total",661,177,27,150,204,77,166,39,127
"2011","Southampton 007A","E01017238","Total",582,235,46,189,186,77,191,54,137
"2011","Southampton 007B","E01017241","Total",657,320,48,272,190,82,243,32,211
"2011","Southampton 007C","E01017242","Total",730,197,19,178,145,78,169,19,150
"2011","Southampton 007D","E01017243","Total",660,186,13,173,205,77,165,29,136
"2011","Southampton 007E","E01017244","Total",511,179,36,143,178,71,164,37,127
"2011","Southampton 008A","E01017174","Total",553,189,11,178,150,59,149,30,119
"2011","Southampton 008B","E01017175","Total",623,161,9,152,213,80,143,20,123
"2011","Southampton 008C","E01017176","Total",677,203,33,170,207,70,171,31,140
"2011","Southampton 008D","E01017179","Total",618,227,54,173,211,101,192,46,146
"2011","Southampton 009A","E01017226","Total",830,382,15,367,82,39,223,11,212
"2011","Southampton 009D","E01017231","Total",640,243,14,229,100,42,128,11,117
"2011","Southampton 009E","E01017232","Total",495,169,7,162,109,46,108,18,90
"2011","Southampton 009F","E01032753","Total",788,248,16,232,180,82,159,16,143
"2011","Southampton 010A","E01017246","Total",879,213,38,175,238,138,177,32,145
"2011","Southampton 010B","E01017250","Total",728,378,46,332,173,87,279,24,255
"2011","Southampton 010C","E01017251","Total",661,205,48,157,224,104,172,32,140
"2011","Southampton 010D","E01017253","Total",656,188,47,141,241,117,165,46,119
"2011","Southampton 011A","E01017247","Total",622,167,9,158,210,77,152,27,125
"2011","Southampton 011B","E01017248","Total",600,165,5,160,208,78,144,26,118
"2011","Southampton 011C","E01017249","Total",508,134,4,130,179,64,122,25,97
"2011","Southampton 011D","E01017252","Total",663,220,11,209,185,69,158,23,135
"2011","Southampton 011E","E01017254","Total",672,183,31,152,225,96,138,38,100
"2011","Southampton 012A","E01017236","Total",599,246,62,184,206,92,188,36,152
"2011","Southampton 012B","E01017237","Total",590,237,72,165,223,102,205,52,153
"2011","Southampton 012C","E01017239","Total",641,176,43,133,215,106,161,47,114
"2011","Southampton 012D","E01017240","Total",599,273,64,209,171,89,179,29,150
"2011","Southampton 012E","E01017245","Total",611,271,92,179,276,149,189,55,134
"2011","Southampton 013A","E01017227","Total",410,121,10,111,40,26,74,8,66
"2011","Southampton 013B","E01017228","Total",712,221,44,177,172,70,175,33,142
"2011","Southampton 013C","E01017233","Total",723,229,35,194,178,82,189,36,153
"2011","Southampton 013D","E01017234","Total",735,279,31,248,135,74,193,23,170
"2011","Southampton 013E","E01017235","Total",601,194,13,181,89,54,123,12,111
"2011","Southampton 014A","E01017171","Total",872,239,21,218,196,96,220,37,183
"2011","Southampton 014B","E01017172","Total",809,160,25,135,200,97,160,31,129
"2011","Southampton 014C","E01017173","Total",617,179,26,153,193,86,159,37,122
"2011","Southampton 014D","E01017177","Total",749,232,18,214,145,58,186,26,160
"2011","Southampton 014E","E01017178","Total",589,108,13,95,204,76,138,37,101
"2011","Southampton 015A","E01017207","Total",697,291,94,197,271,157,206,46,160
"2011","Southampton 015B","E01017209","Total",584,151,23,128,202,106,115,17,98
"2011","Southampton 015C","E01017211","Total",934,406,16,390,154,84,312,21,291
"2011","Southampton 015D","E01017212","Total",555,159,22,137,177,59,111,25,86
"2011","Southampton 015E","E01017213","Total",713,158,12,146,141,73,130,11,119
"2011","Southampton 016A","E01017200","Total",840,320,9,311,171,68,250,18,232
"2011","Southampton 016B","E01017201","Total",630,287,55,232,198,94,209,43,166
"2011","Southampton 016C","E01017202","Total",747,300,88,212,273,145,188,35,153
"2011","Southampton 016D","E01017203","Total",632,184,26,158,213,101,152,30,122
"2011","Southampton 016E","E01017204","Total",625,187,15,172,197,77,149,28,121
"2011","Southampton 017A","E01017157","Total",571,194,9,185,47,21,99,9,90
"2011","Southampton 017B","E01017158","Total",796,258,21,237,97,59,149,12,137
"2011","Southampton 017C","E01017159","Total",527,154,24,130,81,40,79,21,58
"2011","Southampton 017D","E01017160","Total",669,161,4,157,92,50,104,13,91
"2011","Southampton 018A","E01017198","Total",673,298,17,281,135,56,222,16,206
"2011","Southampton 018B","E01017199","Total",771,320,24,296,181,73,228,30,198
"2011","Southampton 018C","E01017205","Total",515,206,51,155,197,76,166,39,127
"2011","Southampton 018D","E01017206","Total",648,214,22,192,191,72,188,34,154
"2011","Southampton 019A","E01017208","Total",561,205,57,148,228,130,155,35,120
"2011","Southampton 019B","E01017210","Total",603,236,70,166,257,116,195,47,148
"2011","Southampton 019C","E01017214","Total",552,136,27,109,202,88,115,26,89
"2011","Southampton 019D","E01017215","Total",696,165,14,151,228,101,140,27,113
"2011","Southampton 019E","E01017216","Total",579,148,27,121,186,73,151,39,112
"2011","Southampton 020A","E01017189","Total",734,161,8,153,119,59,111,15,96
"2011","Southampton 020B","E01017190","Total",730,137,4,133,79,47,93,11,82
"2011","Southampton 020C","E01017191","Total",791,140,15,125,176,100,138,26,112
"2011","Southampton 020D","E01017196","Total",1012,225,13,212,135,85,122,10,112
"2011","Southampton 020E","E01017197","Total",553,106,14,92,189,82,114,27,87
"2011","Southampton 021A","E01017192","Total",911,237,41,196,247,118,197,34,163
"2011","Southampton 021B","E01017193","Total",848,268,20,248,161,66,223,21,202
"2011","Southampton 021C","E01017194","Total",827,204,29,175,182,97,175,25,150
"2011","Southampton 021D","E01017195","Total",941,229,41,188,212,117,180,21,159
"2011","Southampton 022A","E01017153","Total",466,115,31,84,192,105,116,46,70
"2011","Southampton 022B","E01017154","Total",888,353,108,245,357,198,271,64,207
"2011","Southampton 022C","E01017155","Total",538,155,32,123,196,117,124,36,88
"2011","Southampton 022D","E01017156","Total",492,146,45,101,226,116,141,57,84
"2011","Southampton 022F","E01032738","Total",630,194,17,177,61,40,90,10,80
"2011","Southampton 022G","E01032750","Total",621,289,25,264,95,61,144,12,132
"2011","Southampton 023A","E01017136","Total",622,171,4,167,38,14,95,9,86
"2011","Southampton 023B","E01017137","Total",647,196,4,192,25,12,69,10,59
"2011","Southampton 023C","E01017138","Total",940,289,15,274,86,54,157,11,146
"2011","Southampton 023D","E01017140","Total",831,365,23,342,97,62,260,17,243
"2011","Southampton 024A","E01017217","Total",663,236,18,218,163,63,207,23,184
"2011","Southampton 024B","E01017223","Total",662,166,9,157,208,81,148,26,122
"2011","Southampton 024C","E01017224","Total",550,146,9,137,163,65,120,23,97
"2011","Southampton 024D","E01017225","Total",609,177,38,139,216,95,156,40,116
"2011","Southampton 025A","E01017162","Total",625,254,24,230,148,59,181,22,159
"2011","Southampton 025B","E01017163","Total",651,287,90,197,249,142,187,38,149
"2011","Southampton 025C","E01017164","Total",670,263,26,237,158,71,203,28,175
"2011","Southampton 025D","E01017165","Total",622,261,43,218,171,65,213,38,175
"2011","Southampton 025E","E01017166","Total",668,306,75,231,231,121,229,43,186
"2011","Southampton 026A","E01017256","Total",863,257,17,240,229,99,203,31,172
"2011","Southampton 026B","E01017257","Total",767,228,18,210,180,82,196,20,176
"2011","Southampton 026C","E01017259","Total",601,168,10,158,180,80,144,24,120
"2011","Southampton 026D","E01017260","Total",653,285,13,272,134,55,214,18,196
"2011","Southampton 026E","E01017262","Total",528,139,22,117,189,63,132,32,100
"2011","Southampton 027A","E01017167","Total",673,286,102,184,245,140,198,43,155
"2011","Southampton 027B","E01017168","Total",824,331,65,266,220,107,254,43,211
"2011","Southampton 027C","E01017169","Total",641,262,59,203,225,110,208,54,154
"2011","Southampton 027D","E01017170","Total",670,232,34,198,202,101,188,45,143
"2011","Southampton 028A","E01017218","Total",495,148,42,106,205,73,141,39,102
"2011","Southampton 028B","E01017219","Total",857,332,46,286,203,99,285,38,247
"2011","Southampton 028C","E01017220","Total",800,253,33,220,235,93,237,38,199
"2011","Southampton 028D","E01017221","Total",662,158,29,129,227,98,148,41,107
"2011","Southampton 028E","E01017222","Total",620,123,15,108,217,85,139,35,104
"2011","Southampton 029A","E01017139","Total",904,382,51,331,200,116,269,48,221
"2011","Southampton 029C","E01017142","Total",1021,220,16,204,81,45,99,12,87
"2011","Southampton 029E","E01032745","Total",577,187,40,147,138,84,111,19,92
"2011","Southampton 029F","E01032746","Total",713,146,15,131,59,44,50,4,46
"2011","Southampton 029G","E01032748","Total",635,125,8,117,42,17,90,11,79
"2011","Southampton 029H","E01032751","Total",565,150,21,129,102,66,103,14,89
"2011","Southampton 029I","E01032755","Total",493,215,51,164,181,127,155,30,125
"2011","Southampton 030A","E01017255","Total",686,192,11,181,192,87,154,19,135
"2011","Southampton 030B","E01017258","Total",640,180,24,156,229,94,155,28,127
"2011","Southampton 030C","E01017261","Total",717,192,14,178,204,90,173,35,138
"2011","Southampton 030D","E01017263","Total",598,178,27,151,166,63,170,39,131
"2011","Southampton 031A","E01017273","Total",594,181,13,168,151,67,155,22,133
"2011","Southampton 031B","E01017275","Total",691,185,30,155,184,82,169,33,136
"2011","Southampton 031C","E01017276","Total",742,226,55,171,249,117,208,56,152
"2011","Southampton 031D","E01017278","Total",600,126,18,108,167,90,133,25,108
"2011","Southampton 031E","E01017279","Total",730,201,25,176,199,93,169,35,134
"2011","Southampton 032A","E01017274","Total",613,265,66,199,217,85,218,48,170
"2011","Southampton 032B","E01017277","Total",582,144,35,109,221,98,129,31,98
"2011","Southampton 032C","E01017280","Total",604,271,51,220,187,66,229,41,188
"2011","Southampton 032D","E01017281","Total",818,412,121,291,294,183,257,53,204
"2011","West Berkshire 001A","E01016277","Total",527,151,6,145,169,73,92,17,75
"2011","West Berkshire 001B","E01016286","Total",602,121,21,100,232,67,124,35,89
"2011","West Berkshire 001C","E01016287","Total",573,106,16,90,203,59,81,24,57
"2011","West Berkshire 001D","E01016288","Total",666,162,13,149,211,63,130,22,108
"2011","West Berkshire 002A","E01016303","Total",633,161,9,152,171,74,133,22,111
"2011","West Berkshire 002B","E01016304","Total",672,179,20,159,167,69,139,15,124
"2011","West Berkshire 002C","E01016305","Total",581,162,2,160,119,44,125,14,111
"2011","West Berkshire 002D","E01016306","Total",530,145,18,127,155,66,122,27,95
"2011","West Berkshire 003A","E01016256","Total",666,152,8,144,220,75,106,17,89
"2011","West Berkshire 003B","E01016257","Total",534,136,7,129,170,50,86,16,70
"2011","West Berkshire 003C","E01016313","Total",706,227,20,207,201,100,166,23,143
"2011","West Berkshire 003D","E01016314","Total",521,172,3,169,126,38,101,13,88
"2011","West Berkshire 004A","E01016315","Total",713,203,6,197,171,58,135,25,110
"2011","West Berkshire 004B","E01016316","Total",793,182,11,171,258,101,150,31,119
"2011","West Berkshire 004C","E01016317","Total",510,140,10,130,169,52,95,19,76
"2011","West Berkshire 004D","E01016318","Total",626,161,6,155,192,73,119,21,98
"2011","West Berkshire 005A","E01016258","Total",669,236,4,232,161,49,150,13,137
"2011","West Berkshire 005B","E01016261","Total",550,71,7,64,250,80,91,37,54
"2011","West Berkshire 005C","E01016349","Total",472,149,1,148,146,50,103,16,87
"2011","West Berkshire 005D","E01016350","Total",596,162,8,154,196,64,129,21,108
"2011","West Berkshire 006A","E01016259","Total",584,118,15,103,215,63,118,32,86
"2011","West Berkshire 006B","E01016260","Total",617,164,13,151,216,70,96,28,68
"2011","West Berkshire 006C","E01016262","Total",531,199,10,189,152,40,115,22,93
"2011","West Berkshire 006D","E01016272","Total",590,120,16,104,187,60,98,12,86
"2011","West Berkshire 006E","E01016273","Total",627,234,40,194,214,88,185,32,153
"2011","West Berkshire 007A","E01016263","Total",849,175,17,158,354,136,140,39,101
"2011","West Berkshire 007B","E01016278","Total",411,61,6,55,202,87,60,22,38
"2011","West Berkshire 007C","E01016283","Total",575,142,10,132,190,65,107,21,86
"2011","West Berkshire 007D","E01016284","Total",515,116,11,105,186,52,101,30,71
"2011","West Berkshire 007E","E01016285","Total",622,136,13,123,203,76,121,23,98
"2011","West Berkshire 008A","E01016271","Total",597,194,24,170,163,58,160,24,136
"2011","West Berkshire 008B","E01016274","Total",512,108,16,92,167,58,97,26,71
"2011","West Berkshire 008C","E01016275","Total",647,109,24,85,206,113,78,15,63
"2011","West Berkshire 008D","E01016276","Total",578,92,14,78,226,93,82,23,59
"2011","West Berkshire 009A","E01016327","Total",471,91,11,80,158,67,97,21,76
"2011","West Berkshire 009B","E01016328","Total",717,190,19,171,242,91,150,21,129
"2011","West Berkshire 009C","E01016344","Total",714,237,25,212,179,82,171,15,156
"2011","West Berkshire 009D","E01016345","Total",538,100,8,92,179,78,105,26,79
"2011","West Berkshire 010A","E01016296","Total",766,231,16,215,175,87,177,15,162
"2011","West Berkshire 010B","E01016297","Total",628,204,16,188,180,66,174,31,143
"2011","West Berkshire 010C","E01016298","Total",564,149,7,142,113,64,125,17,108
"2011","West Berkshire 010D","E01016299","Total",642,148,6,142,175,77,114,21,93
"2011","West Berkshire 011A","E01016254","Total",611,187,5,182,135,48,160,17,143
"2011","West Berkshire 011B","E01016255","Total",581,147,4,143,159,52,131,20,111
"2011","West Berkshire 011C","E01016264","Total",430,91,3,88,133,51,88,18,70
"2011","West Berkshire 011D","E01016265","Total",578,159,7,152,182,59,121,25,96
"2011","West Berkshire 011E","E01016266","Total",530,151,9,142,164,51,116,20,96
"2011","West Berkshire 011F","E01016339","Total",1124,208,34,174,412,212,197,41,156
"2011","West Berkshire 012A","E01016310","Total",826,299,19,280,204,87,270,30,240
"2011","West Berkshire 012B","E01016311","Total",819,248,11,237,158,80,198,20,178
"2011","West Berkshire 012C","E01016323","Total",595,212,10,202,135,51,128,9,119
"2011","West Berkshire 012D","E01016324","Total",577,172,14,158,153,55,118,21,97
"2011","West Berkshire 012E","E01016325","Total",649,251,46,205,209,113,175,31,144
"2011","West Berkshire 013A","E01016279","Total",914,218,41,177,269,146,194,33,161
"2011","West Berkshire 013B","E01016280","Total",700,165,41,124,234,119,135,37,98
"2011","West Berkshire 013C","E01016281","Total",556,135,15,120,178,79,113,25,88
"2011","West Berkshire 013D","E01016282","Total",615,104,16,88,204,97,97,28,69
"2011","West Berkshire 014A","E01016329","Total",606,70,7,63,199,83,83,21,62
"2011","West Berkshire 014B","E01016340","Total",631,174,14,160,190,67,172,37,135
"2011","West Berkshire 014C","E01016341","Total",512,95,17,78,187,69,127,31,96
"2011","West Berkshire 014D","E01016342","Total",783,103,14,89,280,119,126,42,84
"2011","West Berkshire 014E","E01016343","Total",578,147,7,140,157,53,125,17,108
"2011","West Berkshire 015A","E01016267","Total",550,139,15,124,190,71,104,17,87
"2011","West Berkshire 015B","E01016268","Total",624,185,21,164,205,79,155,39,116
"2011","West Berkshire 015C","E01016269","Total",565,134,9,125,168,53,114,23,91
"2011","West Berkshire 015D","E01016270","Total",533,70,9,61,245,115,82,35,47
"2011","West Berkshire 016A","E01016330","Total",665,147,12,135,174,69,144,25,119
"2011","West Berkshire 016B","E01016331","Total",593,130,27,103,250,113,116,37,79
"2011","West Berkshire 016C","E01016332","Total",755,336,22,314,179,80,262,27,235
"2011","West Berkshire 016D","E01016334","Total",637,102,21,81,264,109,126,48,78
"2011","West Berkshire 016E","E01016336","Total",479,178,44,134,200,86,120,33,87
"2011","West Berkshire 017A","E01016333","Total",492,65,9,56,209,85,65,14,51
"2011","West Berkshire 017B","E01016335","Total",586,111,12,99,202,93,95,19,76
"2011","West Berkshire 017C","E01016337","Total",887,230,24,206,306,151,193,38,155
"2011","West Berkshire 017D","E01016338","Total",743,132,11,121,273,101,134,25,109
"2011","West Berkshire 018A","E01016300","Total",642,176,8,168,186,97,131,14,117
"2011","West Berkshire 018B","E01016301","Total",771,177,14,163,207,71,137,21,116
"2011","West Berkshire 018C","E01016302","Total",633,145,15,130,210,65,122,28,94
"2011","West Berkshire 018D","E01016326","Total",541,148,8,140,159,62,99,15,84
"2011","West Berkshire 019A","E01016293","Total",1005,218,36,182,396,166,170,48,122
"2011","West Berkshire 019B","E01016346","Total",729,221,19,202,112,63,164,11,153
"2011","West Berkshire 019C","E01016347","Total",880,299,15,284,127,80,224,14,210
"2011","West Berkshire 019D","E01016348","Total",978,195,16,179,235,141,163,27,136
"2011","West Berkshire 020A","E01016294","Total",650,151,9,142,163,73,131,21,110
"2011","West Berkshire 020B","E01016295","Total",616,201,75,126,233,102,173,53,120
"2011","West Berkshire 020C","E01016312","Total",825,189,29,160,263,117,181,46,135
"2011","West Berkshire 020D","E01016319","Total",737,280,6,274,179,76,199,16,183
"2011","West Berkshire 020E","E01016320","Total",637,190,14,176,157,61,147,15,132
"2011","West Berkshire 021A","E01016289","Total",579,224,5,219,149,40,119,12,107
"2011","West Berkshire 021B","E01016290","Total",629,162,11,151,213,82,109,20,89
"2011","West Berkshire 021C","E01016291","Total",688,174,5,169,255,106,136,35,101
"2011","West Berkshire 021D","E01016292","Total",615,177,16,161,202,73,152,32,120
"2011","West Berkshire 021E","E01016321","Total",609,160,13,147,163,70,128,17,111
"2011","West Berkshire 021F","E01016322","Total",491,143,1,142,163,58,111,22,89
"2011","West Berkshire 022A","E01016307","Total",679,235,14,221,198,78,179,28,151
"2011","West Berkshire 022B","E01016308","Total",759,190,13,177,238,99,150,17,133
"2011","West Berkshire 022C","E01016309","Total",888,256,32,224,269,120,199,38,161
"2011","Windsor and Maidenhead 001A","E01016570","Total",640,163,9,154,220,88,116,16,100
"2011","Windsor and Maidenhead 001B","E01016572","Total",559,204,19,185,158,49,121,15,106
"2011","Windsor and Maidenhead 001C","E01016582","Total",501,108,10,98,183,87,106,31,75
"2011","Windsor and Maidenhead 001D","E01016600","Total",448,149,8,141,134,44,83,13,70
"2011","Windsor and Maidenhead 002A","E01016530","Total",647,226,20,206,183,83,182,34,148
"2011","Windsor and Maidenhead 002B","E01016531","Total",607,174,4,170,157,57,109,19,90
"2011","Windsor and Maidenhead 002C","E01016532","Total",840,220,2,218,214,81,152,20,132
"2011","Windsor and Maidenhead 002D","E01016533","Total",770,175,9,166,260,91,128,17,111
"2011","Windsor and Maidenhead 002E","E01016578","Total",589,137,10,127,151,46,112,15,97
"2011","Windsor and Maidenhead 002F","E01016579","Total",693,186,14,172,209,78,140,20,120
"2011","Windsor and Maidenhead 002G","E01016581","Total",572,152,9,143,191,65,113,20,93
"2011","Windsor and Maidenhead 003A","E01016571","Total",562,130,10,120,211,78,106,27,79
"2011","Windsor and Maidenhead 003B","E01016573","Total",523,146,26,120,195,81,131,36,95
"2011","Windsor and Maidenhead 003C","E01016574","Total",604,204,14,190,163,79,165,22,143
"2011","Windsor and Maidenhead 003D","E01016599","Total",600,149,35,114,237,88,146,41,105
"2011","Windsor and Maidenhead 004A","E01016583","Total",680,184,5,179,167,65,118,18,100
"2011","Windsor and Maidenhead 004B","E01016585","Total",781,206,10,196,144,54,133,16,117
"2011","Windsor and Maidenhead 004C","E01016586","Total",542,147,3,144,136,37,95,5,90
"2011","Windsor and Maidenhead 004D","E01016591","Total",629,142,6,136,234,80,99,26,73
"2011","Windsor and Maidenhead 004E","E01016592","Total",798,252,11,241,188,86,173,19,154
"2011","Windsor and Maidenhead 005A","E01016525","Total",635,130,7,123,216,72,101,22,79
"2011","Windsor and Maidenhead 005B","E01016528","Total",631,155,9,146,209,95,112,20,92
"2011","Windsor and Maidenhead 005C","E01016529","Total",654,227,38,189,204,103,188,38,150
"2011","Windsor and Maidenhead 005D","E01016536","Total",848,204,19,185,199,118,162,20,142
"2011","Windsor and Maidenhead 005E","E01016584","Total",669,177,37,140,231,122,141,31,110
"2011","Windsor and Maidenhead 005G","E01032733","Total",617,238,24,214,103,80,149,9,140
"2011","Windsor and Maidenhead 005H","E01032734","Total",650,155,18,137,179,95,110,22,88
"2011","Windsor and Maidenhead 006A","E01016526","Total",713,134,9,125,292,123,93,21,72
"2011","Windsor and Maidenhead 006B","E01016527","Total",656,112,11,101,223,109,98,22,76
"2011","Windsor and Maidenhead 006C","E01016534","Total",587,160,3,157,176,47,129,26,103
"2011","Windsor and Maidenhead 006D","E01016598","Total",513,150,7,143,176,47,89,18,71
"2011","Windsor and Maidenhead 006E","E01016601","Total",616,146,16,130,248,95,105,17,88
"2011","Windsor and Maidenhead 006F","E01016602","Total",636,220,6,214,191,59,129,17,112
"2011","Windsor and Maidenhead 007A","E01016535","Total",491,126,12,114,153,75,99,23,76
"2011","Windsor and Maidenhead 007B","E01016537","Total",470,99,22,77,204,101,104,30,74
"2011","Windsor and Maidenhead 007C","E01016538","Total",625,117,13,104,219,117,89,20,69
"2011","Windsor and Maidenhead 007D","E01016593","Total",665,180,27,153,231,114,159,38,121
"2011","Windsor and Maidenhead 007E","E01016594","Total",582,157,19,138,193,79,119,23,96
"2011","Windsor and Maidenhead 008A","E01016559","Total",562,151,5,146,177,61,101,16,85
"2011","Windsor and Maidenhead 008B","E01016560","Total",646,222,26,196,211,96,190,33,157
"2011","Windsor and Maidenhead 008C","E01016561","Total",674,124,12,112,238,80,126,26,100
"2011","Windsor and Maidenhead 008D","E01016562","Total",513,124,4,120,172,74,76,15,61
"2011","Windsor and Maidenhead 008E","E01016563","Total",507,100,5,95,170,58,91,18,73
"2011","Windsor and Maidenhead 008F","E01016580","Total",643,199,28,171,197,77,176,26,150
"2011","Windsor and Maidenhead 009A","E01016539","Total",641,189,9,180,188,63,119,16,103
"2011","Windsor and Maidenhead 009B","E01016540","Total",652,169,13,156,208,77,119,21,98
"2011","Windsor and Maidenhead 009C","E01016541","Total",512,97,2,95,171,71,76,13,63
"2011","Windsor and Maidenhead 009D","E01016542","Total",491,130,9,121,167,85,127,26,101
"2011","Windsor and Maidenhead 009E","E01016543","Total",670,162,10,152,186,73,130,24,106
"2011","Windsor and Maidenhead 010A","E01016544","Total",800,178,6,172,137,76,120,12,108
"2011","Windsor and Maidenhead 010B","E01016567","Total",817,146,10,136,174,76,120,20,100
"2011","Windsor and Maidenhead 010C","E01016568","Total",499,153,14,139,151,50,130,19,111
"2011","Windsor and Maidenhead 010D","E01016569","Total",493,140,8,132,108,39,109,10,99
"2011","Windsor and Maidenhead 011A","E01016564","Total",644,174,20,154,214,87,150,26,124
"2011","Windsor and Maidenhead 011B","E01016565","Total",624,158,6,152,172,61,117,17,100
"2011","Windsor and Maidenhead 011C","E01016566","Total",764,173,27,146,212,117,124,27,97
"2011","Windsor and Maidenhead 011D","E01016577","Total",698,168,17,151,197,81,152,26,126
"2011","Windsor and Maidenhead 012A","E01016545","Total",1069,319,19,300,201,106,220,10,210
"2011","Windsor and Maidenhead 012B","E01016547","Total",756,107,12,95,206,101,94,12,82
"2011","Windsor and Maidenhead 012C","E01016550","Total",510,125,8,117,176,86,108,17,91
"2011","Windsor and Maidenhead 012D","E01016552","Total",686,163,19,144,211,106,117,21,96
"2011","Windsor and Maidenhead 013A","E01016551","Total",623,215,6,209,165,52,131,21,110
"2011","Windsor and Maidenhead 013B","E01016553","Total",676,278,6,272,142,44,163,16,147
"2011","Windsor and Maidenhead 013C","E01016557","Total",832,262,15,247,220,70,214,25,189
"2011","Windsor and Maidenhead 013D","E01016558","Total",613,96,24,72,325,202,103,34,69
"2011","Windsor and Maidenhead 014A","E01016548","Total",830,177,8,169,233,109,131,21,110
"2011","Windsor and Maidenhead 014B","E01016549","Total",858,287,28,259,245,109,229,34,195
"2011","Windsor and Maidenhead 014C","E01016554","Total",650,208,37,171,232,112,154,34,120
"2011","Windsor and Maidenhead 014D","E01016555","Total",588,168,28,140,199,80,150,28,122
"2011","Windsor and Maidenhead 014E","E01016556","Total",762,273,34,239,220,86,211,36,175
"2011","Windsor and Maidenhead 015A","E01016546","Total",750,140,2,138,197,102,122,16,106
"2011","Windsor and Maidenhead 015B","E01016595","Total",680,160,26,134,239,102,121,31,90
"2011","Windsor and Maidenhead 015C","E01016596","Total",797,215,15,200,222,97,137,25,112
"2011","Windsor and Maidenhead 015D","E01016597","Total",617,145,8,137,233,90,101,23,78
"2011","Windsor and Maidenhead 016A","E01016575","Total",637,195,8,187,156,41,147,21,126
"2011","Windsor and Maidenhead 016B","E01016576","Total",661,162,10,152,212,88,136,18,118
"2011","Windsor and Maidenhead 016C","E01016587","Total",638,194,5,189,188,73,126,13,113
"2011","Windsor and Maidenhead 016D","E01016588","Total",777,259,12,247,196,80,189,24,165
"2011","Windsor and Maidenhead 016E","E01016589","Total",642,188,5,183,174,56,131,17,114
"2011","Windsor and Maidenhead 017A","E01016522","Total",698,155,8,147,265,78,97,21,76
"2011","Windsor and Maidenhead 017B","E01016523","Total",584,143,8,135,173,58,98,21,77
"2011","Windsor and Maidenhead 017C","E01016524","Total",864,205,23,182,257,98,129,17,112
"2011","Windsor and Maidenhead 017D","E01016609","Total",740,191,29,162,269,108,174,37,137
"2011","Windsor and Maidenhead 018A","E01016603","Total",744,245,9,236,208,62,152,21,131
"2011","Windsor and Maidenhead 018B","E01016604","Total",778,257,19,238,238,65,138,26,112
"2011","Windsor and Maidenhead 018C","E01016605","Total",613,149,9,140,195,76,113,19,94
"2011","Windsor and Maidenhead 018D","E01016606","Total",646,156,10,146,219,67,89,15,74
"2011","Windsor and Maidenhead 018E","E01016607","Total",529,146,13,133,189,46,91,18,73
"2011","Windsor and Maidenhead 018F","E01016608","Total",808,255,33,222,260,85,175,19,156
"2011","Wokingham 001A","E01016675","Total",469,160,7,153,108,39,99,9,90
"2011","Wokingham 001B","E01016676","Total",621,198,8,190,178,49,112,19,93
"2011","Wokingham 001C","E01016677","Total",619,204,10,194,174,67,146,21,125
"2011","Wokingham 001D","E01016678","Total",563,186,8,178,143,61,126,18,108
"2011","Wokingham 002A","E01016619","Total",571,124,4,120,220,82,97,25,72
"2011","Wokingham 002B","E01016620","Total",526,95,11,84,216,80,97,24,73
"2011","Wokingham 002C","E01016692","Total",653,228,0,228,159,68,157,11,146
"2011","Wokingham 002D","E01016693","Total",604,96,5,91,166,89,82,15,67
"2011","Wokingham 002E","E01016694","Total",683,228,4,224,159,84,162,15,147
"2011","Wokingham 002F","E01016695","Total",597,163,9,154,210,87,109,23,86
"2011","Wokingham 003A","E01016621","Total",582,160,23,137,199,74,104,27,77
"2011","Wokingham 003B","E01016623","Total",605,200,5,195,179,63,129,19,110
"2011","Wokingham 003C","E01016624","Total",527,158,8,150,180,65,101,21,80
"2011","Wokingham 003D","E01016684","Total",619,164,12,152,203,65,123,28,95
"2011","Wokingham 003E","E01016685","Total",621,197,11,186,185,59,153,22,131
"2011","Wokingham 004A","E01016622","Total",462,125,7,118,156,46,85,25,60
"2011","Wokingham 004B","E01016657","Total",547,98,10,88,244,95,86,32,54
"2011","Wokingham 004C","E01016658","Total",484,54,8,46,222,61,70,25,45
"2011","Wokingham 004D","E01016659","Total",643,137,21,116,208,75,99,14,85
"2011","Wokingham 004E","E01016660","Total",624,108,9,99,240,89,100,28,72
"2011","Wokingham 005A","E01016615","Total",605,248,19,229,173,73,220,28,192
"2011","Wokingham 005B","E01016616","Total",622,265,13,252,153,64,175,24,151
"2011","Wokingham 005C","E01016617","Total",502,187,1,186,131,39,114,15,99
"2011","Wokingham 005D","E01016662","Total",700,227,38,189,252,117,215,46,169
"2011","Wokingham 006A","E01016613","Total",479,103,17,86,218,92,108,39,69
"2011","Wokingham 006B","E01016614","Total",477,135,13,122,156,55,107,24,83
"2011","Wokingham 006C","E01016618","Total",486,155,9,146,136,57,114,16,98
"2011","Wokingham 006D","E01016664","Total",476,150,5,145,188,57,127,23,104
"2011","Wokingham 006E","E01016668","Total",602,175,18,157,214,67,138,29,109
"2011","Wokingham 006F","E01016669","Total",703,212,8,204,226,97,150,37,113
"2011","Wokingham 007A","E01016661","Total",493,96,4,92,178,66,90,23,67
"2011","Wokingham 007B","E01016663","Total",598,153,11,142,193,79,130,29,101
"2011","Wokingham 007C","E01016686","Total",486,86,10,76,144,68,79,15,64
"2011","Wokingham 007D","E01016687","Total",500,144,6,138,148,55,97,17,80
"2011","Wokingham 007E","E01016688","Total",454,87,11,76,144,59,82,13,69
"2011","Wokingham 007F","E01016689","Total",579,201,4,197,160,59,134,19,115
"2011","Wokingham 008B","E01016652","Total",470,79,6,73,198,67,65,20,45
"2011","Wokingham 008C","E01016653","Total",450,109,5,104,164,34,89,21,68
"2011","Wokingham 008D","E01016665","Total",642,134,9,125,225,98,111,21,90
"2011","Wokingham 008E","E01016666","Total",503,93,9,84,184,81,79,25,54
"2011","Wokingham 008G","E01032761","Total",970,287,8,279,322,72,189,36,153
"2011","Wokingham 009A","E01016647","Total",626,67,15,52,305,113,81,30,51
"2011","Wokingham 009B","E01016701","Total",643,133,9,124,240,77,110,34,76
"2011","Wokingham 009C","E01016702","Total",697,154,27,127,249,97,124,30,94
"2011","Wokingham 009D","E01016703","Total",691,121,21,100,282,127,101,33,68
"2011","Wokingham 009E","E01016704","Total",796,216,41,175,291,134,173,44,129
"2011","Wokingham 010A","E01016627","Total",716,145,5,140,228,87,122,17,105
"2011","Wokingham 010B","E01016628","Total",619,197,4,193,191,71,127,18,109
"2011","Wokingham 010C","E01016656","Total",560,132,9,123,166,61,111,22,89
"2011","Wokingham 010D","E01016700","Total",722,129,10,119,251,84,116,21,95
"2011","Wokingham 011A","E01016644","Total",529,65,8,57,236,104,78,32,46
"2011","Wokingham 011B","E01016645","Total",745,95,7,88,184,84,96,15,81
"2011","Wokingham 011C","E01016646","Total",610,77,6,71,241,103,71,23,48
"2011","Wokingham 011D","E01016648","Total",638,96,12,84,207,112,104,23,81
"2011","Wokingham 011E","E01016649","Total",622,101,7,94,179,75,92,25,67
"2011","Wokingham 012A","E01016651","Total",587,145,13,132,173,63,107,22,85
"2011","Wokingham 012B","E01016654","Total",590,142,6,136,173,69,112,14,98
"2011","Wokingham 012C","E01016655","Total",503,57,3,54,172,71,61,20,41
"2011","Wokingham 012D","E01016679","Total",842,161,37,124,322,156,127,35,92
"2011","Wokingham 012E","E01016680","Total",496,142,33,109,191,84,103,24,79
"2011","Wokingham 012G","E01032758","Total",608,113,25,88,258,136,118,36,82
"2011","Wokingham 012H","E01032759","Total",580,128,13,115,174,91,110,19,91
"2011","Wokingham 013A","E01016626","Total",800,261,21,240,196,86,182,21,161
"2011","Wokingham 013B","E01016671","Total",869,430,8,422,123,59,262,14,248
"2011","Wokingham 013C","E01016673","Total",740,264,39,225,229,94,223,47,176
"2011","Wokingham 013D","E01016674","Total",580,180,33,147,175,87,128,21,107
"2011","Wokingham 013E","E01016696","Total",736,197,12,185,157,95,147,15,132
"2011","Wokingham 014A","E01016670","Total",821,123,11,112,314,149,100,23,77
"2011","Wokingham 014B","E01016672","Total",702,193,5,188,217,78,122,15,107
"2011","Wokingham 014E","E01032763","Total",905,284,8,276,278,93,160,16,144
"2011","Wokingham 015A","E01016612","Total",788,160,5,155,322,83,152,37,115
"2011","Wokingham 015B","E01016629","Total",523,179,0,179,149,42,113,12,101
"2011","Wokingham 015C","E01016630","Total",569,82,3,79,219,86,72,20,52
"2011","Wokingham 015D","E01016635","Total",507,78,9,69,220,91,72,19,53
"2011","Wokingham 016A","E01016625","Total",658,185,4,181,201,75,137,21,116
"2011","Wokingham 016B","E01016631","Total",558,142,16,126,185,81,119,23,96
"2011","Wokingham 016C","E01016632","Total",588,104,1,103,197,66,93,22,71
"2011","Wokingham 016D","E01016634","Total",606,167,6,161,183,73,112,13,99
"2011","Wokingham 016E","E01016699","Total",635,179,4,175,174,64,116,17,99
"2011","Wokingham 017A","E01016682","Total",748,139,9,130,241,126,141,23,118
"2011","Wokingham 017B","E01016683","Total",728,142,9,133,243,98,124,13,111
"2011","Wokingham 017C","E01016690","Total",747,176,20,156,233,106,139,25,114
"2011","Wokingham 017D","E01016691","Total",446,114,3,111,147,48,86,14,72
"2011","Wokingham 018A","E01016610","Total",1094,197,18,179,417,183,159,37,122
"2011","Wokingham 018B","E01016611","Total",438,67,7,60,164,82,74,12,62
"2011","Wokingham 018C","E01016641","Total",548,175,4,171,160,51,117,15,102
"2011","Wokingham 018D","E01016642","Total",455,159,22,137,148,67,121,14,107
"2011","Wokingham 019A","E01016633","Total",497,112,8,104,211,73,81,18,63
"2011","Wokingham 019B","E01016636","Total",562,158,2,156,179,61,113,25,88
"2011","Wokingham 019C","E01016637","Total",408,106,6,100,137,31,70,6,64
"2011","Wokingham 019D","E01016638","Total",493,84,1,83,203,87,75,20,55
"2011","Wokingham 019E","E01016639","Total",609,127,6,121,240,81,104,20,84
"2011","Wokingham 019F","E01016640","Total",611,199,10,189,176,42,130,14,116
"2011","Wokingham 019G","E01016643","Total",499,81,2,79,208,72,75,23,52
"2011","Wokingham 020A","E01016705","Total",501,105,10,95,179,72,87,16,71
"2011","Wokingham 020B","E01016706","Total",636,120,4,116,234,73,83,15,68
"2011","Wokingham 020C","E01016707","Total",629,167,3,164,224,72,130,23,107
"2011","Wokingham 020D","E01016708","Total",653,200,3,197,170,44,130,15,115
"2011","Wokingham 020E","E01016709","Total",608,214,0,214,196,63,106,19,87
"2011","Aylesbury Vale 001A","E01017648","Total",683,135,3,132,249,75,111,27,84
"2011","Aylesbury Vale 001B","E01017649","Total",833,272,25,247,253,89,171,25,146
"2011","Aylesbury Vale 001C","E01017650","Total",609,119,11,108,274,93,106,35,71
"2011","Aylesbury Vale 001F","E01032960","Total",954,203,18,185,289,90,183,35,148
"2011","Aylesbury Vale 002A","E01017644","Total",633,128,12,116,204,71,127,24,103
"2011","Aylesbury Vale 002B","E01017645","Total",574,221,23,198,129,47,121,17,104
"2011","Aylesbury Vale 002C","E01017646","Total",790,288,33,255,235,106,231,46,185
"2011","Aylesbury Vale 002D","E01017647","Total",619,176,8,168,210,57,105,12,93
"2011","Aylesbury Vale 003A","E01017671","Total",609,124,5,119,207,63,130,24,106
"2011","Aylesbury Vale 003B","E01017672","Total",578,137,2,135,185,49,122,19,103
"2011","Aylesbury Vale 003C","E01017695","Total",511,167,4,163,124,36,127,8,119
"2011","Aylesbury Vale 003D","E01017696","Total",510,131,5,126,147,35,116,18,98
"2011","Aylesbury Vale 004A","E01017693","Total",438,84,1,83,130,54,74,10,64
"2011","Aylesbury Vale 004B","E01017694","Total",826,153,15,138,356,129,151,42,109
"2011","Aylesbury Vale 004C","E01017713","Total",589,149,10,139,180,60,130,21,109
"2011","Aylesbury Vale 004D","E01017714","Total",521,92,3,89,154,58,98,15,83
"2011","Aylesbury Vale 004E","E01017717","Total",692,190,7,183,203,70,137,26,111
"2011","Aylesbury Vale 004F","E01017718","Total",640,149,6,143,205,76,136,30,106
"2011","Aylesbury Vale 005A","E01017735","Total",545,141,7,134,155,43,108,20,88
"2011","Aylesbury Vale 005B","E01017736","Total",662,219,16,203,192,64,186,30,156
"2011","Aylesbury Vale 005C","E01017737","Total",593,204,5,199,142,43,139,16,123
"2011","Aylesbury Vale 005D","E01017738","Total",685,194,5,189,165,66,165,16,149
"2011","Aylesbury Vale 006A","E01017669","Total",605,165,8,157,174,34,134,22,112
"2011","Aylesbury Vale 006B","E01017670","Total",633,153,10,143,184,58,125,16,109
"2011","Aylesbury Vale 006C","E01017715","Total",460,116,5,111,133,44,92,15,77
"2011","Aylesbury Vale 006D","E01017716","Total",713,211,11,200,235,76,134,14,120
"2011","Aylesbury Vale 007A","E01017641","Total",708,217,5,212,189,61,162,19,143
"2011","Aylesbury Vale 007B","E01017731","Total",550,159,9,150,173,59,137,27,110
"2011","Aylesbury Vale 007C","E01017732","Total",549,132,9,123,172,61,95,19,76
"2011","Aylesbury Vale 007D","E01017733","Total",509,142,9,133,146,50,100,10,90
"2011","Aylesbury Vale 007E","E01017734","Total",553,107,3,104,172,54,80,15,65
"2011","Aylesbury Vale 008A","E01017703","Total",523,155,12,143,169,39,111,18,93
"2011","Aylesbury Vale 008B","E01017704","Total",486,116,7,109,165,50,98,23,75
"2011","Aylesbury Vale 008C","E01017719","Total",501,137,4,133,158,49,121,16,105
"2011","Aylesbury Vale 008D","E01017720","Total",512,97,5,92,174,54,103,22,81
"2011","Aylesbury Vale 008F","E01032958","Total",622,170,10,160,189,77,103,17,86
"2011","Aylesbury Vale 008G","E01032959","Total",628,103,58,45,347,225,87,43,44
"2011","Aylesbury Vale 009A","E01017651","Total",602,118,3,115,208,58,119,23,96
"2011","Aylesbury Vale 009B","E01017652","Total",625,162,6,156,188,63,135,24,111
"2011","Aylesbury Vale 009C","E01017657","Total",584,201,6,195,179,54,115,15,100
"2011","Aylesbury Vale 009D","E01017658","Total",594,139,8,131,180,49,101,27,74
"2011","Aylesbury Vale 009E","E01017701","Total",810,148,17,131,358,141,152,47,105
"2011","Aylesbury Vale 009F","E01017702","Total",608,169,5,164,177,66,137,16,121
"2011","Aylesbury Vale 010A","E01017642","Total",539,154,5,149,158,50,126,21,105
"2011","Aylesbury Vale 010B","E01017643","Total",529,130,7,123,143,52,107,15,92
"2011","Aylesbury Vale 010C","E01017673","Total",486,109,5,104,175,37,94,17,77
"2011","Aylesbury Vale 010D","E01017674","Total",512,82,5,77,187,47,105,24,81
"2011","Aylesbury Vale 011A","E01017659","Total",607,177,30,147,225,97,147,37,110
"2011","Aylesbury Vale 011B","E01017660","Total",740,119,23,96,255,132,125,34,91
"2011","Aylesbury Vale 011C","E01017661","Total",618,160,33,127,223,101,151,30,121
"2011","Aylesbury Vale 011D","E01017664","Total",627,84,5,79,171,73,86,23,63
"2011","Aylesbury Vale 012A","E01017705","Total",483,83,8,75,138,49,95,24,71
"2011","Aylesbury Vale 012B","E01017706","Total",498,104,30,74,208,93,118,40,78
"2011","Aylesbury Vale 012C","E01017707","Total",468,132,46,86,215,75,125,42,83
"2011","Aylesbury Vale 012D","E01017708","Total",595,175,38,137,234,124,156,45,111
"2011","Aylesbury Vale 013A","E01017665","Total",584,184,45,139,231,110,163,37,126
"2011","Aylesbury Vale 013B","E01017666","Total",733,234,25,209,201,119,231,38,193
"2011","Aylesbury Vale 013C","E01017667","Total",506,132,40,92,221,117,136,37,99
"2011","Aylesbury Vale 013D","E01017668","Total",617,162,22,140,203,85,136,27,109
"2011","Aylesbury Vale 014A","E01017697","Total",621,107,11,96,202,97,100,23,77
"2011","Aylesbury Vale 014B","E01017698","Total",534,112,23,89,232,97,124,40,84
"2011","Aylesbury Vale 014C","E01017699","Total",435,85,15,70,142,76,81,22,59
"2011","Aylesbury Vale 014D","E01017700","Total",619,209,3,206,176,59,167,18,149
"2011","Aylesbury Vale 015B","E01017634","Total",634,99,17,82,190,107,108,36,72
"2011","Aylesbury Vale 015C","E01017662","Total",515,147,26,121,177,85,121,36,85
"2011","Aylesbury Vale 015D","E01017663","Total",600,185,36,149,195,105,167,29,138
"2011","Aylesbury Vale 015E","E01032955","Total",722,269,5,264,97,44,196,10,186
"2011","Aylesbury Vale 015F","E01032961","Total",503,112,27,85,130,63,107,29,78
"2011","Aylesbury Vale 016A","E01017653","Total",608,107,10,97,198,78,120,29,91
"2011","Aylesbury Vale 016B","E01017654","Total",542,145,31,114,209,88,138,38,100
"2011","Aylesbury Vale 016C","E01017655","Total",813,102,13,89,264,131,130,19,111
"2011","Aylesbury Vale 016E","E01032956","Total",670,52,9,43,244,163,61,17,44
"2011","Aylesbury Vale 016F","E01032957","Total",598,69,14,55,188,131,71,20,51
"2011","Aylesbury Vale 016G","E01032962","Total",656,73,17,56,243,141,73,22,51
"2011","Aylesbury Vale 017A","E01017635","Total",609,192,3,189,184,70,151,25,126
"2011","Aylesbury Vale 017B","E01017636","Total",637,230,7,223,198,65,140,19,121
"2011","Aylesbury Vale 017C","E01017637","Total",492,107,5,102,168,60,103,21,82
"2011","Aylesbury Vale 017D","E01017638","Total",499,177,2,175,155,55,117,19,98
"2011","Aylesbury Vale 017E","E01017639","Total",611,183,3,180,185,35,133,25,108
"2011","Aylesbury Vale 017F","E01017640","Total",624,237,7,230,200,57,180,34,146
"2011","Aylesbury Vale 018A","E01017709","Total",569,184,26,158,220,96,178,40,138
"2011","Aylesbury Vale 018B","E01017710","Total",517,112,21,91,214,83,135,36,99
"2011","Aylesbury Vale 018C","E01017711","Total",622,203,36,167,225,101,210,49,161
"2011","Aylesbury Vale 018D","E01017712","Total",798,164,52,112,309,160,170,57,113
"2011","Aylesbury Vale 019A","E01017687","Total",886,183,23,160,285,146,136,37,99
"2011","Aylesbury Vale 019B","E01017688","Total",513,81,10,71,166,79,88,26,62
"2011","Aylesbury Vale 019C","E01017689","Total",568,134,7,127,183,65,107,24,83
"2011","Aylesbury Vale 019D","E01017690","Total",483,145,8,137,135,48,125,18,107
"2011","Aylesbury Vale 019E","E01017691","Total",517,81,4,77,175,54,81,19,62
"2011","Aylesbury Vale 019F","E01017692","Total",683,151,13,138,186,82,119,22,97
"2011","Aylesbury Vale 020A","E01017721","Total",773,137,15,122,206,117,132,15,117
"2011","Aylesbury Vale 020B","E01017722","Total",624,81,17,64,203,88,122,31,91
"2011","Aylesbury Vale 020C","E01017723","Total",500,130,41,89,197,87,122,27,95
"2011","Aylesbury Vale 020D","E01017724","Total",498,122,42,80,228,100,126,41,85
"2011","Aylesbury Vale 021A","E01017627","Total",676,160,10,150,202,77,150,23,127
"2011","Aylesbury Vale 021B","E01017628","Total",633,165,8,157,202,76,127,21,106
"2011","Aylesbury Vale 021C","E01017629","Total",649,163,9,154,193,59,121,19,102
"2011","Aylesbury Vale 021D","E01017630","Total",617,198,9,189,179,66,140,19,121
"2011","Aylesbury Vale 021E","E01017631","Total",644,196,4,192,188,59,154,26,128
"2011","Aylesbury Vale 021F","E01017632","Total",618,139,4,135,183,68,139,26,113
"2011","Aylesbury Vale 022A","E01017675","Total",605,169,12,157,179,60,116,22,94
"2011","Aylesbury Vale 022B","E01017676","Total",568,185,5,180,148,44,122,22,100
"2011","Aylesbury Vale 022C","E01017677","Total",602,189,4,185,143,47,140,11,129
"2011","Aylesbury Vale 022D","E01017678","Total",547,137,4,133,118,41,102,13,89
"2011","Aylesbury Vale 022E","E01017679","Total",616,167,18,149,213,77,128,24,104
"2011","Aylesbury Vale 022F","E01017680","Total",449,170,6,164,97,31,127,13,114
"2011","Aylesbury Vale 023A","E01017681","Total",523,163,3,160,138,42,126,12,114
"2011","Aylesbury Vale 023B","E01017682","Total",481,153,6,147,170,52,81,14,67
"2011","Aylesbury Vale 023C","E01017683","Total",671,146,2,144,203,53,137,20,117
"2011","Aylesbury Vale 023D","E01017684","Total",462,148,2,146,117,55,101,13,88
"2011","Aylesbury Vale 024A","E01017726","Total",527,234,5,229,84,29,138,8,130
"2011","Aylesbury Vale 024B","E01017727","Total",661,214,3,211,214,71,144,19,125
"2011","Aylesbury Vale 024C","E01017728","Total",740,95,30,65,400,220,100,39,61
"2011","Aylesbury Vale 024D","E01017729","Total",679,198,8,190,240,89,124,19,105
"2011","Aylesbury Vale 024E","E01017730","Total",734,308,16,292,193,72,248,25,223
"2011","Chiltern 001A","E01017750","Total",883,242,8,234,261,72,179,24,155
"2011","Chiltern 001B","E01017752","Total",887,240,7,233,261,70,187,25,162
"2011","Chiltern 001C","E01017766","Total",904,260,14,246,284,89,182,32,150
"2011","Chiltern 001D","E01017778","Total",516,163,5,158,153,55,116,16,100
"2011","Chiltern 002A","E01017747","Total",533,151,13,138,189,68,124,23,101
"2011","Chiltern 002B","E01017748","Total",727,220,33,187,254,104,201,44,157
"2011","Chiltern 002C","E01017749","Total",659,189,5,184,202,77,134,21,113
"2011","Chiltern 002D","E01017789","Total",508,180,21,159,149,61,121,24,97
"2011","Chiltern 002E","E01017790","Total",495,160,41,119,207,98,127,37,90
"2011","Chiltern 002F","E01017795","Total",829,222,26,196,283,120,183,41,142
"2011","Chiltern 003A","E01017769","Total",627,142,8,134,196,68,123,22,101
"2011","Chiltern 003B","E01017771","Total",623,250,8,242,148,47,144,20,124
"2011","Chiltern 003C","E01017780","Total",490,104,4,100,161,57,87,19,68
"2011","Chiltern 003D","E01017781","Total",455,99,18,81,184,101,100,28,72
"2011","Chiltern 004A","E01017770","Total",642,154,8,146,211,125,134,17,117
"2011","Chiltern 004B","E01017791","Total",621,157,23,134,209,94,153,25,128
"2011","Chiltern 004C","E01017792","Total",923,349,19,330,208,96,230,19,211
"2011","Chiltern 004D","E01017793","Total",610,181,21,160,178,67,152,31,121
"2011","Chiltern 005A","E01017768","Total",960,335,12,323,270,85,230,34,196
"2011","Chiltern 005B","E01017779","Total",425,132,8,124,154,38,73,14,59
"2011","Chiltern 005C","E01017785","Total",666,209,4,205,197,44,143,21,122
"2011","Chiltern 005D","E01017786","Total",603,160,5,155,215,63,128,19,109
"2011","Chiltern 005E","E01017787","Total",615,187,6,181,215,47,120,20,100
"2011","Chiltern 005F","E01017788","Total",763,252,22,230,250,82,199,34,165
"2011","Chiltern 006A","E01017741","Total",665,233,14,219,208,91,184,23,161
"2011","Chiltern 006B","E01017742","Total",701,233,12,221,224,94,177,24,153
"2011","Chiltern 006C","E01017743","Total",638,177,31,146,244,110,156,34,122
"2011","Chiltern 006D","E01017763","Total",750,290,6,284,209,80,177,17,160
"2011","Chiltern 006E","E01017764","Total",609,183,7,176,248,70,97,21,76
"2011","Chiltern 006F","E01017765","Total",619,193,4,189,242,59,109,20,89
"2011","Chiltern 007A","E01017739","Total",493,119,8,111,170,49,90,16,74
"2011","Chiltern 007B","E01017740","Total",532,135,5,130,180,90,106,19,87
"2011","Chiltern 007C","E01017744","Total",569,146,5,141,178,69,111,19,92
"2011","Chiltern 007D","E01017745","Total",813,271,4,267,188,71,193,18,175
"2011","Chiltern 007E","E01017746","Total",593,149,6,143,211,86,112,28,84
"2011","Chiltern 008A","E01017762","Total",527,139,9,130,202,51,74,13,61
"2011","Chiltern 008B","E01017775","Total",677,260,11,249,200,65,176,28,148
"2011","Chiltern 008C","E01017776","Total",661,195,33,162,224,93,135,31,104
"2011","Chiltern 008D","E01017777","Total",644,236,5,231,208,74,145,14,131
"2011","Chiltern 010A","E01017759","Total",776,264,18,246,234,81,130,20,110
"2011","Chiltern 010B","E01017760","Total",658,213,4,209,205,57,133,18,115
"2011","Chiltern 010C","E01017761","Total",862,263,11,252,285,85,187,29,158
"2011","Chiltern 010D","E01017794","Total",889,242,10,232,313,114,164,19,145
"2011","Chiltern 011A","E01017754","Total",551,163,3,160,186,50,110,14,96
"2011","Chiltern 011B","E01017755","Total",662,182,9,173,180,68,131,21,110
"2011","Chiltern 011C","E01017756","Total",584,190,1,189,183,37,128,20,108
"2011","Chiltern 011D","E01017757","Total",479,150,10,140,164,49,109,13,96
"2011","Chiltern 011E","E01017758","Total",426,115,6,109,164,46,96,17,79
"2011","Chiltern 012A","E01017751","Total",787,218,13,205,293,69,121,20,101
"2011","Chiltern 012B","E01017753","Total",516,167,11,156,171,68,125,14,111
"2011","Chiltern 012C","E01017767","Total",879,259,20,239,285,104,207,31,176
"2011","Chiltern 013A","E01017773","Total",609,200,7,193,186,51,130,17,113
"2011","Chiltern 013B","E01017774","Total",505,173,5,168,153,44,101,14,87
"2011","Chiltern 013C","E01017782","Total",544,174,9,165,184,67,94,16,78
"2011","Chiltern 013D","E01017783","Total",601,163,9,154,184,76,107,25,82
"2011","Chiltern 013E","E01017784","Total",645,184,4,180,193,55,114,17,97
"2011","Chiltern 013F","E01032609","Total",518,166,5,161,137,49,117,12,105
"2011","South Bucks 001A","E01017796","Total",776,277,15,262,185,77,171,22,149
"2011","South Bucks 001B","E01017797","Total",533,164,11,153,198,73,90,16,74
"2011","South Bucks 001C","E01017798","Total",714,268,17,251,216,66,132,15,117
"2011","South Bucks 001D","E01017799","Total",791,226,19,207,273,114,149,20,129
"2011","South Bucks 001E","E01017800","Total",684,189,24,165,252,148,168,30,138
"2011","South Bucks 001F","E01017801","Total",580,147,4,143,232,83,110,23,87
"2011","South Bucks 001G","E01017802","Total",655,217,18,199,202,63,166,20,146
"2011","South Bucks 002A","E01017818","Total",715,173,20,153,268,95,129,32,97
"2011","South Bucks 002B","E01017819","Total",552,135,8,127,212,61,87,18,69
"2011","South Bucks 002C","E01017820","Total",703,291,3,288,144,60,164,10,154
"2011","South Bucks 002D","E01017821","Total",561,163,15,148,201,62,87,21,66
"2011","South Bucks 002E","E01017822","Total",629,154,5,149,271,74,129,42,87
"2011","South Bucks 003A","E01017810","Total",902,453,24,429,174,89,288,16,272
"2011","South Bucks 003B","E01017811","Total",498,188,10,178,103,33,124,11,113
"2011","South Bucks 003C","E01017812","Total",651,172,21,151,214,85,145,31,114
"2011","South Bucks 003D","E01017813","Total",755,211,9,202,200,68,154,20,134
"2011","South Bucks 004A","E01017815","Total",679,199,11,188,221,68,120,21,99
"2011","South Bucks 004B","E01017816","Total",723,227,8,219,189,72,163,19,144
"2011","South Bucks 004C","E01017817","Total",724,196,13,183,248,87,156,34,122
"2011","South Bucks 004D","E01017823","Total",572,159,15,144,176,51,125,28,97
"2011","South Bucks 005A","E01017830","Total",779,237,11,226,202,80,183,19,164
"2011","South Bucks 005B","E01017831","Total",648,210,7,203,212,74,149,33,116
"2011","South Bucks 005C","E01017832","Total",601,186,15,171,171,67,124,27,97
"2011","South Bucks 005D","E01017834","Total",552,155,14,141,162,57,119,26,93
"2011","South Bucks 005E","E01017835","Total",774,230,10,220,188,79,182,32,150
"2011","South Bucks 006A","E01017803","Total",486,137,10,127,135,44,91,14,77
"2011","South Bucks 006B","E01017806","Total",648,185,2,183,204,66,129,29,100
"2011","South Bucks 006C","E01017814","Total",595,168,8,160,170,50,125,20,105
"2011","South Bucks 006D","E01017833","Total",791,225,4,221,145,57,131,14,117
"2011","South Bucks 007A","E01017804","Total",683,250,9,241,164,62,176,22,154
"2011","South Bucks 007B","E01017805","Total",774,199,32,167,279,123,177,44,133
"2011","South Bucks 007C","E01017807","Total",608,154,14,140,190,76,127,18,109
"2011","South Bucks 007D","E01017808","Total",642,174,23,151,199,89,148,25,123
"2011","South Bucks 007E","E01017809","Total",587,137,20,117,215,78,149,32,117
"2011","South Bucks 008A","E01017824","Total",685,194,8,186,201,79,151,29,122
"2011","South Bucks 008B","E01017825","Total",651,144,12,132,245,91,129,23,106
"2011","South Bucks 008C","E01017826","Total",623,214,20,194,194,64,186,27,159
"2011","South Bucks 008D","E01017827","Total",664,169,13,156,196,86,138,24,114
"2011","South Bucks 008E","E01017828","Total",659,212,18,194,212,81,164,23,141
"2011","South Bucks 008F","E01017829","Total",667,143,18,125,235,73,131,42,89
"2011","Wycombe 001A","E01017929","Total",785,393,27,366,169,74,294,34,260
"2011","Wycombe 001B","E01017930","Total",731,242,8,234,187,66,167,18,149
"2011","Wycombe 001C","E01017931","Total",600,190,10,180,164,57,137,20,117
"2011","Wycombe 001D","E01017932","Total",680,245,4,241,162,55,161,20,141
"2011","Wycombe 001E","E01017933","Total",704,283,18,265,197,63,211,37,174
"2011","Wycombe 002A","E01017885","Total",672,178,12,166,206,76,120,21,99
"2011","Wycombe 002B","E01017886","Total",614,190,8,182,181,58,108,19,89
"2011","Wycombe 002C","E01017887","Total",468,149,5,144,132,46,103,17,86
"2011","Wycombe 002D","E01017888","Total",630,130,8,122,257,84,106,28,78
"2011","Wycombe 003A","E01017869","Total",511,150,6,144,159,49,95,11,84
"2011","Wycombe 003B","E01017870","Total",478,134,1,133,143,29,83,11,72
"2011","Wycombe 003C","E01017871","Total",609,197,6,191,171,46,119,18,101
"2011","Wycombe 003D","E01017872","Total",673,247,1,246,176,42,156,16,140
"2011","Wycombe 003E","E01017873","Total",517,96,5,91,186,68,82,17,65
"2011","Wycombe 003F","E01017874","Total",459,126,9,117,182,84,90,21,69
"2011","Wycombe 004A","E01017915","Total",530,130,8,122,167,59,124,20,104
"2011","Wycombe 004B","E01017916","Total",480,112,3,109,122,30,114,19,95
"2011","Wycombe 004C","E01017917","Total",578,130,14,116,196,73,97,22,75
"2011","Wycombe 004D","E01017918","Total",702,234,18,216,186,72,181,23,158
"2011","Wycombe 006A","E01017857","Total",598,196,28,168,180,88,161,33,128
"2011","Wycombe 006B","E01017858","Total",601,99,32,67,177,103,89,26,63
"2011","Wycombe 006C","E01017859","Total",503,127,10,117,175,59,96,22,74
"2011","Wycombe 006D","E01017860","Total",493,112,17,95,205,78,105,31,74
"2011","Wycombe 006E","E01017861","Total",607,156,11,145,224,85,108,18,90
"2011","Wycombe 006F","E01017862","Total",706,163,13,150,280,102,137,42,95
"2011","Wycombe 006G","E01017863","Total",641,144,1,143,227,98,124,27,97
"2011","Wycombe 007A","E01017842","Total",1053,234,15,219,332,104,195,35,160
"2011","Wycombe 007B","E01017853","Total",575,103,9,94,165,73,82,12,70
"2011","Wycombe 007C","E01017854","Total",505,117,8,109,166,43,102,22,80
"2011","Wycombe 007D","E01017878","Total",1074,269,16,253,302,105,172,28,144
"2011","Wycombe 008A","E01017920","Total",476,115,12,103,166,68,83,21,62
"2011","Wycombe 008B","E01017921","Total",674,128,20,108,198,93,109,28,81
"2011","Wycombe 008C","E01017922","Total",676,153,17,136,199,87,151,28,123
"2011","Wycombe 008D","E01017923","Total",666,152,17,135,145,59,134,25,109
"2011","Wycombe 008E","E01017924","Total",557,134,8,126,208,57,79,17,62
"2011","Wycombe 009A","E01017937","Total",567,128,4,124,222,69,96,21,75
"2011","Wycombe 009B","E01017938","Total",503,126,5,121,183,49,79,17,62
"2011","Wycombe 009C","E01017940","Total",673,110,8,102,185,81,95,12,83
"2011","Wycombe 009D","E01017942","Total",587,187,12,175,204,65,122,22,100
"2011","Wycombe 010A","E01017850","Total",474,101,44,57,211,84,86,39,47
"2011","Wycombe 010B","E01017851","Total",678,143,16,127,222,90,154,29,125
"2011","Wycombe 010C","E01017852","Total",709,137,28,109,323,142,154,55,99
"2011","Wycombe 010D","E01017919","Total",630,176,22,154,141,74,130,20,110
"2011","Wycombe 011A","E01017925","Total",785,150,43,107,272,133,119,33,86
"2011","Wycombe 011B","E01017926","Total",669,198,62,136,244,153,136,28,108
"2011","Wycombe 011C","E01017927","Total",589,178,13,165,195,76,150,27,123
"2011","Wycombe 011D","E01017928","Total",614,240,9,231,134,54,182,16,166
"2011","Wycombe 012A","E01017911","Total",670,166,28,138,246,135,159,38,121
"2011","Wycombe 012B","E01017912","Total",523,94,11,83,168,76,98,23,75
"2011","Wycombe 012C","E01017913","Total",745,132,26,106,225,113,122,34,88
"2011","Wycombe 012D","E01017914","Total",507,100,10,90,174,73,105,20,85
"2011","Wycombe 013A","E01017903","Total",508,103,33,70,226,122,117,48,69
"2011","Wycombe 013B","E01017904","Total",607,118,42,76,218,125,106,34,72
"2011","Wycombe 013C","E01017905","Total",838,183,36,147,224,124,167,43,124
"2011","Wycombe 013D","E01017906","Total",501,114,57,57,302,152,131,72,59
"2011","Wycombe 013E","E01017907","Total",621,185,45,140,258,141,172,44,128
"2011","Wycombe 014A","E01017899","Total",688,229,40,189,230,108,207,41,166
"2011","Wycombe 014B","E01017900","Total",528,131,47,84,203,79,111,35,76
"2011","Wycombe 014C","E01017901","Total",462,121,34,87,194,84,115,38,77
"2011","Wycombe 014D","E01017902","Total",637,175,63,112,267,107,149,41,108
"2011","Wycombe 015A","E01017836","Total",551,86,15,71,209,103,113,31,82
"2011","Wycombe 015B","E01017837","Total",779,176,38,138,197,102,141,29,112
"2011","Wycombe 015C","E01017838","Total",510,96,9,87,206,96,97,34,63
"2011","Wycombe 015D","E01017839","Total",496,142,2,140,84,36,101,11,90
"2011","Wycombe 015E","E01017840","Total",666,158,13,145,201,74,145,33,112
"2011","Wycombe 015F","E01017841","Total",518,100,6,94,194,48,92,29,63
"2011","Wycombe 016A","E01017908","Total",1167,285,60,225,339,179,225,51,174
"2011","Wycombe 016B","E01017909","Total",938,129,51,78,344,189,119,33,86
"2011","Wycombe 016C","E01017910","Total",1072,267,20,247,243,128,192,31,161
"2011","Wycombe 016D","E01017941","Total",671,161,12,149,152,68,137,19,118
"2011","Wycombe 017A","E01017843","Total",654,229,8,221,152,55,161,17,144
"2011","Wycombe 017B","E01017844","Total",731,287,28,259,195,67,232,25,207
"2011","Wycombe 017C","E01017845","Total",706,236,23,213,178,83,176,19,157
"2011","Wycombe 017D","E01017855","Total",617,179,9,170,178,66,146,21,125
"2011","Wycombe 017E","E01017856","Total",538,146,25,121,189,72,130,28,102
"2011","Wycombe 018A","E01017864","Total",520,169,1,168,162,54,90,18,72
"2011","Wycombe 018B","E01017865","Total",611,205,4,201,183,62,125,20,105
"2011","Wycombe 018C","E01017867","Total",610,209,31,178,221,89,152,33,119
"2011","Wycombe 018D","E01017868","Total",649,224,10,214,176,58,155,18,137
"2011","Wycombe 019A","E01017934","Total",750,196,33,163,245,97,157,37,120
"2011","Wycombe 019B","E01017935","Total",872,190,16,174,248,124,139,22,117
"2011","Wycombe 019C","E01017936","Total",649,187,12,175,187,68,139,26,113
"2011","Wycombe 019D","E01017939","Total",558,103,8,95,181,61,112,27,85
"2011","Wycombe 020A","E01017866","Total",603,184,3,181,156,49,121,15,106
"2011","Wycombe 020B","E01017875","Total",544,91,6,85,244,87,54,18,36
"2011","Wycombe 020C","E01017876","Total",775,184,4,180,284,93,139,30,109
"2011","Wycombe 020D","E01017877","Total",641,194,11,183,218,70,131,26,105
"2011","Wycombe 021A","E01017846","Total",639,261,25,236,146,45,190,31,159
"2011","Wycombe 021B","E01017847","Total",682,212,4,208,183,70,146,11,135
"2011","Wycombe 021C","E01017848","Total",474,158,6,152,127,43,80,13,67
"2011","Wycombe 021D","E01017849","Total",665,173,12,161,148,59,117,13,104
"2011","Wycombe 022A","E01017889","Total",530,125,14,111,163,73,109,17,92
"2011","Wycombe 022B","E01017890","Total",500,136,3,133,164,55,92,22,70
"2011","Wycombe 022C","E01017891","Total",635,228,9,219,181,63,155,20,135
"2011","Wycombe 022D","E01017892","Total",607,226,6,220,200,70,105,14,91
"2011","Wycombe 022E","E01017893","Total",799,311,11,300,158,60,223,16,207
"2011","Wycombe 022F","E01017894","Total",658,214,4,210,188,79,109,12,97
"2011","Wycombe 023A","E01017895","Total",606,210,14,196,159,72,133,19,114
"2011","Wycombe 023B","E01017896","Total",629,211,7,204,167,55,107,9,98
"2011","Wycombe 023C","E01017897","Total",643,123,6,117,196,82,126,26,100
"2011","Wycombe 023D","E01017898","Total",499,94,15,79,167,80,81,21,60
"2011","Wycombe 024A","E01017880","Total",519,124,2,122,187,61,109,23,86
"2011","Wycombe 024B","E01017881","Total",701,231,11,220,220,73,158,26,132
"2011","Wycombe 024C","E01017882","Total",635,187,8,179,208,69,123,16,107
"2011","Wycombe 024D","E01017883","Total",626,152,8,144,227,66,115,21,94
"2011","Wycombe 024E","E01017884","Total",627,204,4,200,191,67,177,20,157
"2011","Wycombe 024F","E01032610","Total",652,179,6,173,196,65,137,28,109
"2011","Eastbourne 001A","E01020924","Total",551,178,22,156,185,49,165,39,126
"2011","Eastbourne 001B","E01020925","Total",605,220,50,170,234,70,209,54,155
"2011","Eastbourne 001C","E01020927","Total",567,167,47,120,224,87,155,48,107
"2011","Eastbourne 001D","E01020928","Total",791,401,26,375,148,62,247,31,216
"2011","Eastbourne 001E","E01020930","Total",495,123,59,64,261,79,133,65,68
"2011","Eastbourne 002A","E01020917","Total",587,208,64,144,230,82,197,56,141
"2011","Eastbourne 002B","E01020918","Total",625,185,47,138,251,101,156,54,102
"2011","Eastbourne 002C","E01020919","Total",584,169,39,130,236,84,153,46,107
"2011","Eastbourne 002D","E01020923","Total",569,199,50,149,210,95,202,44,158
"2011","Eastbourne 002E","E01020949","Total",685,258,26,232,163,64,194,33,161
"2011","Eastbourne 003A","E01020926","Total",613,190,24,166,203,53,156,41,115
"2011","Eastbourne 003B","E01020929","Total",739,336,50,286,212,97,259,44,215
"2011","Eastbourne 003C","E01020955","Total",700,307,40,267,191,76,232,35,197
"2011","Eastbourne 003D","E01020956","Total",822,458,8,450,100,41,271,17,254
"2011","Eastbourne 003E","E01020957","Total",663,314,31,283,190,75,205,40,165
"2011","Eastbourne 004A","E01020920","Total",741,374,39,335,188,71,295,37,258
"2011","Eastbourne 004B","E01020921","Total",604,213,26,187,187,58,179,34,145
"2011","Eastbourne 004C","E01020922","Total",599,215,47,168,212,64,185,50,135
"2011","Eastbourne 004D","E01020945","Total",802,363,13,350,175,40,218,26,192
"2011","Eastbourne 004E","E01020950","Total",738,352,20,332,143,52,220,22,198
"2011","Eastbourne 006A","E01020940","Total",602,258,10,248,169,50,189,27,162
"2011","Eastbourne 006B","E01020941","Total",646,218,41,177,257,81,213,60,153
"2011","Eastbourne 006C","E01020942","Total",626,193,9,184,215,67,131,29,102
"2011","Eastbourne 006D","E01020946","Total",734,305,11,294,153,44,174,18,156
"2011","Eastbourne 006E","E01020947","Total",722,314,20,294,165,56,237,23,214
"2011","Eastbourne 007A","E01020914","Total",814,211,31,180,259,119,187,49,138
"2011","Eastbourne 007B","E01020915","Total",839,377,34,343,209,78,271,42,229
"2011","Eastbourne 007C","E01020952","Total",741,284,38,246,239,101,232,39,193
"2011","Eastbourne 007D","E01020953","Total",572,134,7,127,210,65,142,29,113
"2011","Eastbourne 007E","E01020954","Total",619,156,16,140,263,75,147,39,108
"2011","Eastbourne 008A","E01020948","Total",758,388,6,382,103,51,227,13,214
"2011","Eastbourne 008B","E01020963","Total",639,169,14,155,196,56,137,22,115
"2011","Eastbourne 008C","E01020965","Total",1027,369,15,354,120,58,265,19,246
"2011","Eastbourne 008D","E01020966","Total",856,383,9,374,99,52,268,10,258
"2011","Eastbourne 009A","E01020938","Total",627,201,15,186,226,89,166,33,133
"2011","Eastbourne 009B","E01020939","Total",649,201,19,182,216,75,141,30,111
"2011","Eastbourne 009C","E01020943","Total",751,250,24,226,226,77,174,28,146
"2011","Eastbourne 009D","E01020964","Total",887,397,11,386,156,71,245,18,227
"2011","Eastbourne 009E","E01020967","Total",994,574,11,563,112,37,366,20,346
"2011","Eastbourne 010A","E01020910","Total",829,334,23,311,186,91,249,30,219
"2011","Eastbourne 010B","E01020911","Total",958,314,43,271,190,118,216,29,187
"2011","Eastbourne 010C","E01020912","Total",1034,347,36,311,172,98,262,22,240
"2011","Eastbourne 010D","E01020916","Total",769,223,37,186,217,116,181,29,152
"2011","Eastbourne 011A","E01020935","Total",1075,416,21,395,139,79,262,18,244
"2011","Eastbourne 011B","E01020936","Total",1025,589,4,585,62,30,347,9,338
"2011","Eastbourne 011C","E01020937","Total",747,298,18,280,96,52,171,14,157
"2011","Eastbourne 011D","E01020968","Total",911,401,21,380,136,73,237,9,228
"2011","Eastbourne 012A","E01020931","Total",829,451,11,440,78,26,247,9,238
"2011","Eastbourne 012B","E01020932","Total",843,598,4,594,47,22,315,9,306
"2011","Eastbourne 012C","E01020933","Total",434,203,7,196,81,23,110,8,102
"2011","Eastbourne 012D","E01020934","Total",685,375,5,370,78,35,203,13,190
"2011","Eastbourne 012E","E01020944","Total",610,234,12,222,178,51,141,25,116
"2011","Eastbourne 013A","E01020913","Total",972,399,64,335,276,114,310,55,255
"2011","Eastbourne 013B","E01020951","Total",647,210,17,193,192,72,207,40,167
"2011","Eastbourne 013C","E01020959","Total",609,235,17,218,190,69,188,35,153
"2011","Eastbourne 013D","E01020961","Total",652,333,8,325,111,43,205,16,189
"2011","Eastbourne 013E","E01020962","Total",976,400,25,375,207,78,256,33,223
"2011","Eastbourne 014A","E01020960","Total",1172,399,43,356,300,149,270,56,214
"2011","Eastbourne 014B","E01032831","Total",701,222,14,208,182,68,147,24,123
"2011","Eastbourne 014C","E01032832","Total",672,251,66,185,234,79,182,62,120
"2011","Eastbourne 014D","E01032833","Total",679,166,23,143,144,64,92,17,75
"2011","Hastings 001A","E01020969","Total",656,271,15,256,154,56,198,20,178
"2011","Hastings 001B","E01020970","Total",1003,225,15,210,354,124,215,52,163
"2011","Hastings 001C","E01020971","Total",841,296,48,248,276,107,276,48,228
"2011","Hastings 001D","E01020987","Total",753,140,21,119,283,132,134,41,93
"2011","Hastings 002A","E01020974","Total",605,242,13,229,149,44,195,34,161
"2011","Hastings 002B","E01020986","Total",590,201,13,188,156,54,165,32,133
"2011","Hastings 002C","E01020988","Total",744,308,8,300,157,54,220,34,186
"2011","Hastings 002D","E01021007","Total",667,315,3,312,101,34,195,17,178
"2011","Hastings 002E","E01021008","Total",792,398,14,384,157,55,258,18,240
"2011","Hastings 002F","E01021009","Total",808,314,19,295,223,75,202,30,172
"2011","Hastings 003A","E01020993","Total",593,272,65,207,192,73,247,55,192
"2011","Hastings 003B","E01020994","Total",581,226,60,166,221,98,216,54,162
"2011","Hastings 003C","E01020995","Total",585,242,54,188,188,83,207,55,152
"2011","Hastings 003D","E01020996","Total",637,196,69,127,279,93,175,58,117
"2011","Hastings 003E","E01021019","Total",827,475,38,437,173,63,369,40,329
"2011","Hastings 004A","E01021004","Total",773,311,43,268,197,80,212,41,171
"2011","Hastings 004B","E01021005","Total",661,313,89,224,246,117,239,60,179
"2011","Hastings 004C","E01021006","Total",847,275,43,232,237,105,218,33,185
"2011","Hastings 004D","E01021013","Total",726,189,36,153,273,103,160,43,117
"2011","Hastings 005A","E01020972","Total",661,372,121,251,249,121,256,60,196
"2011","Hastings 005B","E01020973","Total",716,270,44,226,242,93,212,45,167
"2011","Hastings 005C","E01020977","Total",742,257,57,200,220,118,214,43,171
"2011","Hastings 005D","E01021015","Total",682,359,136,223,290,123,248,60,188
"2011","Hastings 006A","E01021010","Total",636,216,19,197,202,55,161,36,125
"2011","Hastings 006B","E01021011","Total",650,176,35,141,224,95,173,34,139
"2011","Hastings 006C","E01021012","Total",774,306,22,284,173,69,262,34,228
"2011","Hastings 006D","E01021020","Total",734,320,60,260,251,80,263,71,192
"2011","Hastings 006E","E01021021","Total",844,281,37,244,236,116,230,50,180
"2011","Hastings 007A","E01021000","Total",645,190,26,164,200,73,159,25,134
"2011","Hastings 007B","E01021001","Total",497,151,21,130,164,60,122,30,92
"2011","Hastings 007C","E01021002","Total",639,213,28,185,175,61,162,36,126
"2011","Hastings 007D","E01021003","Total",941,378,24,354,129,45,264,27,237
"2011","Hastings 007E","E01021014","Total",808,297,88,209,302,139,229,66,163
"2011","Hastings 008A","E01020975","Total",838,324,38,286,194,104,228,35,193
"2011","Hastings 008B","E01020976","Total",876,314,19,295,197,75,233,32,201
"2011","Hastings 008C","E01020990","Total",697,231,41,190,230,85,197,33,164
"2011","Hastings 008D","E01020991","Total",660,212,27,185,139,48,172,28,144
"2011","Hastings 008E","E01020992","Total",902,342,68,274,236,117,266,43,223
"2011","Hastings 009A","E01020978","Total",1113,440,69,371,222,104,311,39,272
"2011","Hastings 009B","E01020979","Total",1171,545,51,494,153,93,395,27,368
"2011","Hastings 009C","E01020980","Total",811,316,51,265,181,81,242,40,202
"2011","Hastings 009D","E01020981","Total",698,211,47,164,198,88,171,39,132
"2011","Hastings 010A","E01020997","Total",642,203,37,166,221,88,185,45,140
"2011","Hastings 010B","E01020998","Total",939,352,34,318,169,71,247,21,226
"2011","Hastings 010C","E01020999","Total",736,292,18,274,165,59,204,30,174
"2011","Hastings 010D","E01021016","Total",754,302,51,251,186,73,222,32,190
"2011","Hastings 010E","E01021017","Total",667,177,24,153,208,67,179,42,137
"2011","Hastings 010F","E01021018","Total",742,183,19,164,272,88,170,52,118
"2011","Hastings 011A","E01020982","Total",1034,438,54,384,170,81,362,46,316
"2011","Hastings 011B","E01020983","Total",1034,584,54,530,131,65,421,27,394
"2011","Hastings 011C","E01020984","Total",1173,471,58,413,180,81,312,29,283
"2011","Hastings 011D","E01020985","Total",1088,415,51,364,163,63,328,41,287
"2011","Hastings 011E","E01020989","Total",926,345,51,294,195,97,281,41,240
"2011","Lewes 001A","E01021022","Total",840,243,22,221,280,95,204,42,162
"2011","Lewes 001B","E01021024","Total",487,141,20,121,162,61,133,33,100
"2011","Lewes 001C","E01021025","Total",681,162,12,150,233,76,141,32,109
"2011","Lewes 001D","E01021052","Total",516,163,5,158,141,43,113,10,103
"2011","Lewes 001E","E01021053","Total",484,168,10,158,138,39,109,14,95
"2011","Lewes 002A","E01021023","Total",758,209,15,194,252,72,170,46,124
"2011","Lewes 002B","E01021026","Total",994,414,15,399,230,79,240,31,209
"2011","Lewes 002C","E01021032","Total",847,270,11,259,232,52,221,38,183
"2011","Lewes 002D","E01021067","Total",453,109,4,105,132,34,115,17,98
"2011","Lewes 002E","E01021068","Total",439,103,8,95,126,35,82,17,65
"2011","Lewes 003A","E01021033","Total",807,266,21,245,211,81,209,21,188
"2011","Lewes 003B","E01021034","Total",559,148,28,120,183,70,134,36,98
"2011","Lewes 003C","E01021035","Total",922,288,15,273,158,58,221,21,200
"2011","Lewes 003D","E01021036","Total",631,208,20,188,187,58,142,19,123
"2011","Lewes 003E","E01021037","Total",625,215,40,175,231,92,206,52,154
"2011","Lewes 003F","E01021038","Total",819,232,17,215,216,73,204,32,172
"2011","Lewes 004A","E01021054","Total",598,160,4,156,158,57,135,20,115
"2011","Lewes 004B","E01021055","Total",766,324,25,299,204,89,231,39,192
"2011","Lewes 004C","E01021056","Total",723,262,7,255,169,58,169,26,143
"2011","Lewes 004D","E01021057","Total",682,232,25,207,190,62,212,32,180
"2011","Lewes 005A","E01021039","Total",654,190,16,174,180,67,158,24,134
"2011","Lewes 005B","E01021040","Total",675,232,17,215,181,69,166,15,151
"2011","Lewes 005C","E01021041","Total",646,267,14,253,204,75,172,31,141
"2011","Lewes 005D","E01021042","Total",499,141,11,130,187,57,108,27,81
"2011","Lewes 005E","E01021043","Total",620,178,46,132,279,105,132,41,91
"2011","Lewes 006A","E01021027","Total",655,239,15,224,178,65,180,36,144
"2011","Lewes 006B","E01021028","Total",615,145,17,128,228,90,130,26,104
"2011","Lewes 006C","E01021029","Total",610,187,13,174,191,65,164,34,130
"2011","Lewes 006D","E01021030","Total",570,232,10,222,138,44,171,16,155
"2011","Lewes 006E","E01021031","Total",711,274,17,257,137,59,223,26,197
"2011","Lewes 007A","E01021061","Total",593,167,32,135,219,69,158,36,122
"2011","Lewes 007B","E01021063","Total",698,224,17,207,210,68,189,38,151
"2011","Lewes 007C","E01021064","Total",821,364,13,351,138,53,268,22,246
"2011","Lewes 007D","E01021065","Total",657,308,24,284,124,68,220,18,202
"2011","Lewes 007E","E01021066","Total",652,267,27,240,173,63,190,33,157
"2011","Lewes 008A","E01021045","Total",849,409,30,379,173,64,285,28,257
"2011","Lewes 008B","E01021046","Total",595,183,18,165,187,67,157,26,131
"2011","Lewes 008C","E01021047","Total",610,207,18,189,171,52,171,27,144
"2011","Lewes 008D","E01021048","Total",730,229,32,197,190,98,168,21,147
"2011","Lewes 009A","E01021044","Total",716,201,52,149,293,131,197,57,140
"2011","Lewes 009B","E01021049","Total",686,244,44,200,189,91,208,36,172
"2011","Lewes 009C","E01021050","Total",542,169,27,142,192,74,129,31,98
"2011","Lewes 009D","E01021051","Total",524,185,26,159,163,60,166,32,134
"2011","Lewes 010A","E01021058","Total",795,302,33,269,222,90,249,43,206
"2011","Lewes 010B","E01021059","Total",711,317,25,292,138,60,251,41,210
"2011","Lewes 010C","E01021060","Total",712,300,23,277,171,66,247,31,216
"2011","Lewes 010D","E01021062","Total",610,236,33,203,197,66,209,47,162
"2011","Lewes 011A","E01021069","Total",669,277,10,267,151,50,175,19,156
"2011","Lewes 011B","E01021075","Total",748,297,22,275,215,81,203,27,176
"2011","Lewes 011C","E01021077","Total",656,311,10,301,137,42,197,18,179
"2011","Lewes 011D","E01021081","Total",747,361,9,352,113,39,221,19,202
"2011","Lewes 011E","E01021082","Total",788,360,4,356,108,37,225,16,209
"2011","Lewes 011F","E01021083","Total",572,260,14,246,129,39,127,17,110
"2011","Lewes 012A","E01021072","Total",725,420,6,414,101,26,209,10,199
"2011","Lewes 012B","E01021073","Total",634,288,12,276,153,46,180,17,163
"2011","Lewes 012C","E01021074","Total",772,371,30,341,174,66,252,40,212
"2011","Lewes 012D","E01021076","Total",790,318,37,281,250,93,247,50,197
"2011","Lewes 012E","E01021078","Total",552,251,8,243,122,34,143,19,124
"2011","Lewes 013A","E01021070","Total",795,331,11,320,154,68,247,23,224
"2011","Lewes 013B","E01021071","Total",982,414,31,383,157,70,305,32,273
"2011","Lewes 013C","E01021079","Total",759,359,18,341,139,59,259,28,231
"2011","Lewes 013D","E01021080","Total",605,246,12,234,152,40,192,25,167
"2011","Rother 001A","E01021132","Total",495,167,10,157,146,50,127,17,110
"2011","Rother 001B","E01021133","Total",707,205,19,186,201,74,165,28,137
"2011","Rother 001C","E01021134","Total",599,163,15,148,193,84,138,34,104
"2011","Rother 001D","E01021139","Total",561,226,23,203,175,76,163,29,134
"2011","Rother 001E","E01021140","Total",693,180,8,172,209,70,132,25,107
"2011","Rother 001F","E01021141","Total",584,164,14,150,203,64,124,29,95
"2011","Rother 002A","E01021103","Total",673,268,23,245,141,45,189,28,161
"2011","Rother 002B","E01021114","Total",692,277,15,262,150,43,186,23,163
"2011","Rother 002C","E01021115","Total",728,288,5,283,130,31,172,15,157
"2011","Rother 002D","E01021116","Total",670,248,17,231,158,55,201,23,178
"2011","Rother 003A","E01021098","Total",722,242,13,229,177,58,192,34,158
"2011","Rother 003B","E01021099","Total",679,189,4,185,158,39,150,23,127
"2011","Rother 003C","E01021100","Total",658,177,18,159,218,69,133,32,101
"2011","Rother 003D","E01021104","Total",588,197,13,184,141,45,151,25,126
"2011","Rother 003E","E01021105","Total",548,221,13,208,130,31,164,26,138
"2011","Rother 004A","E01021101","Total",833,404,30,374,155,50,251,28,223
"2011","Rother 004B","E01021102","Total",761,287,27,260,165,49,230,32,198
"2011","Rother 004C","E01021117","Total",783,323,22,301,133,52,222,31,191
"2011","Rother 004D","E01021118","Total",753,301,7,294,142,45,233,20,213
"2011","Rother 004E","E01021119","Total",512,255,35,220,128,65,199,28,171
"2011","Rother 005A","E01021087","Total",695,245,8,237,155,45,167,25,142
"2011","Rother 005B","E01021088","Total",673,283,9,274,110,31,189,18,171
"2011","Rother 005C","E01021089","Total",646,254,20,234,182,44,204,37,167
"2011","Rother 005D","E01021109","Total",697,284,17,267,144,37,196,29,167
"2011","Rother 005E","E01021110","Total",1104,555,17,538,144,44,317,29,288
"2011","Rother 006A","E01021084","Total",929,427,35,392,226,100,306,45,261
"2011","Rother 006B","E01021085","Total",698,213,10,203,222,62,178,35,143
"2011","Rother 006C","E01021086","Total",714,276,21,255,214,57,199,32,167
"2011","Rother 006D","E01021096","Total",492,146,11,135,138,44,120,22,98
"2011","Rother 006E","E01021097","Total",529,176,14,162,158,42,121,22,99
"2011","Rother 007A","E01021111","Total",520,285,12,273,82,31,191,19,172
"2011","Rother 007B","E01021113","Total",603,209,26,183,191,68,167,24,143
"2011","Rother 007C","E01021131","Total",633,216,60,156,275,105,201,63,138
"2011","Rother 007D","E01021135","Total",735,302,86,216,282,122,246,71,175
"2011","Rother 007E","E01021136","Total",575,323,74,249,182,89,229,39,190
"2011","Rother 007F","E01021137","Total",613,264,47,217,193,72,209,34,175
"2011","Rother 008A","E01021112","Total",642,298,18,280,145,42,177,20,157
"2011","Rother 008B","E01021120","Total",749,507,5,502,78,25,321,20,301
"2011","Rother 008C","E01021126","Total",649,299,23,276,137,51,205,20,185
"2011","Rother 008D","E01021127","Total",686,308,31,277,182,65,243,43,200
"2011","Rother 008E","E01021128","Total",846,399,20,379,187,69,258,36,222
"2011","Rother 009A","E01021093","Total",687,367,5,362,108,24,205,21,184
"2011","Rother 009B","E01021095","Total",631,379,9,370,81,17,203,15,188
"2011","Rother 009C","E01021123","Total",714,388,10,378,125,41,232,23,209
"2011","Rother 009D","E01021124","Total",828,460,3,457,111,41,300,15,285
"2011","Rother 009E","E01021125","Total",555,282,6,276,90,24,169,19,150
"2011","Rother 009F","E01021129","Total",806,405,20,385,156,43,215,32,183
"2011","Rother 009G","E01021138","Total",476,228,12,216,91,27,152,16,136
"2011","Rother 010A","E01021094","Total",842,544,3,541,84,23,313,12,301
"2011","Rother 010B","E01021106","Total",893,583,7,576,93,31,314,20,294
"2011","Rother 010C","E01021107","Total",744,440,9,431,114,32,241,22,219
"2011","Rother 010D","E01021108","Total",638,248,19,229,180,62,172,26,146
"2011","Rother 010E","E01021130","Total",684,323,17,306,132,52,222,27,195
"2011","Rother 011A","E01021090","Total",802,271,40,231,223,100,247,44,203
"2011","Rother 011B","E01021091","Total",1086,501,25,476,165,84,341,25,316
"2011","Rother 011C","E01021092","Total",1146,650,38,612,163,86,457,34,423
"2011","Rother 011D","E01021121","Total",818,363,15,348,132,51,236,14,222
"2011","Rother 011E","E01021122","Total",860,456,22,434,91,34,318,21,297
"2011","Wealden 001A","E01021167","Total",945,297,31,266,288,76,220,36,184
"2011","Wealden 001B","E01021168","Total",675,178,13,165,214,49,140,27,113
"2011","Wealden 001C","E01021169","Total",495,114,6,108,161,35,88,20,68
"2011","Wealden 001D","E01021186","Total",508,144,5,139,141,48,109,11,98
"2011","Wealden 002A","E01021171","Total",812,223,19,204,277,91,171,39,132
"2011","Wealden 002B","E01021172","Total",732,211,16,195,241,90,171,37,134
"2011","Wealden 002C","E01021173","Total",548,120,7,113,175,50,114,23,91
"2011","Wealden 002D","E01021218","Total",478,138,5,133,128,44,102,19,83
"2011","Wealden 003A","E01021156","Total",758,248,10,238,228,91,191,30,161
"2011","Wealden 003B","E01021157","Total",742,271,14,257,202,58,152,22,130
"2011","Wealden 003C","E01021158","Total",842,230,20,210,290,111,174,39,135
"2011","Wealden 004A","E01021159","Total",942,364,6,358,200,49,198,31,167
"2011","Wealden 004B","E01021160","Total",739,314,11,303,140,49,214,12,202
"2011","Wealden 004C","E01021161","Total",667,194,8,186,187,68,145,20,125
"2011","Wealden 004D","E01021162","Total",640,206,2,204,165,49,123,13,110
"2011","Wealden 005A","E01021202","Total",521,201,6,195,99,35,106,7,99
"2011","Wealden 005B","E01021203","Total",618,200,5,195,161,59,147,18,129
"2011","Wealden 005C","E01021229","Total",695,184,11,173,205,67,113,12,101
"2011","Wealden 005D","E01021230","Total",688,207,15,192,226,65,147,33,114
"2011","Wealden 005E","E01021231","Total",773,270,16,254,214,71,211,30,181
"2011","Wealden 006A","E01021151","Total",679,155,15,140,235,80,147,28,119
"2011","Wealden 006B","E01021152","Total",501,174,25,149,175,63,140,39,101
"2011","Wealden 006C","E01021153","Total",861,217,14,203,260,93,198,33,165
"2011","Wealden 006D","E01021154","Total",606,183,21,162,202,82,160,36,124
"2011","Wealden 006E","E01021155","Total",479,93,14,79,159,64,94,23,71
"2011","Wealden 007A","E01021163","Total",837,266,8,258,209,64,172,22,150
"2011","Wealden 007B","E01021164","Total",770,195,13,182,222,77,154,25,129
"2011","Wealden 007C","E01021187","Total",582,174,12,162,151,49,118,15,103
"2011","Wealden 008A","E01021144","Total",689,188,10,178,216,84,135,19,116
"2011","Wealden 008B","E01021145","Total",817,279,9,270,196,85,211,28,183
"2011","Wealden 008C","E01021170","Total",1103,308,16,292,298,99,211,36,175
"2011","Wealden 008D","E01021217","Total",544,193,5,188,147,46,137,19,118
"2011","Wealden 009A","E01021219","Total",545,161,5,156,147,58,108,15,93
"2011","Wealden 009B","E01021220","Total",793,353,18,335,164,76,237,22,215
"2011","Wealden 009C","E01021223","Total",494,146,3,143,133,38,119,22,97
"2011","Wealden 009D","E01021224","Total",641,241,34,207,194,73,221,35,186
"2011","Wealden 009E","E01021225","Total",673,192,11,181,199,77,167,26,141
"2011","Wealden 009F","E01021226","Total",522,101,17,84,201,82,114,30,84
"2011","Wealden 010A","E01021150","Total",441,129,1,128,127,46,99,11,88
"2011","Wealden 010B","E01021191","Total",841,339,12,327,156,55,225,21,204
"2011","Wealden 010C","E01021192","Total",659,193,9,184,206,64,152,28,124
"2011","Wealden 010D","E01021193","Total",756,291,38,253,222,68,223,50,173
"2011","Wealden 010E","E01021194","Total",633,161,19,142,252,88,127,29,98
"2011","Wealden 011A","E01021149","Total",529,160,10,150,135,45,123,19,104
"2011","Wealden 011B","E01021189","Total",523,117,6,111,165,40,122,24,98
"2011","Wealden 011C","E01021190","Total",640,200,10,190,158,55,157,22,135
"2011","Wealden 011D","E01021200","Total",510,186,17,169,128,40,154,21,133
"2011","Wealden 011E","E01021201","Total",604,183,9,174,171,60,148,16,132
"2011","Wealden 012A","E01021221","Total",540,148,13,135,167,61,117,21,96
"2011","Wealden 012B","E01021222","Total",685,189,14,175,189,79,175,28,147
"2011","Wealden 012C","E01021227","Total",607,113,20,93,235,74,101,30,71
"2011","Wealden 012D","E01021228","Total",577,138,10,128,229,52,99,27,72
"2011","Wealden 013A","E01021146","Total",701,223,16,207,217,69,152,35,117
"2011","Wealden 013B","E01021147","Total",642,159,9,150,180,55,129,18,111
"2011","Wealden 013C","E01021148","Total",600,148,11,137,184,68,139,17,122
"2011","Wealden 013D","E01021165","Total",455,121,6,115,136,56,96,22,74
"2011","Wealden 014A","E01021188","Total",477,141,6,135,124,30,109,17,92
"2011","Wealden 014B","E01021198","Total",644,226,17,209,197,75,193,39,154
"2011","Wealden 014C","E01021199","Total",581,196,7,189,129,38,130,22,108
"2011","Wealden 014D","E01021204","Total",499,166,17,149,149,36,133,22,111
"2011","Wealden 014E","E01021205","Total",494,150,9,141,118,40,115,17,98
"2011","Wealden 015A","E01021174","Total",659,208,13,195,208,71,148,23,125
"2011","Wealden 015B","E01021175","Total",628,236,9,227,156,59,171,22,149
"2011","Wealden 015C","E01021176","Total",652,297,6,291,135,55,218,22,196
"2011","Wealden 015D","E01021177","Total",581,263,12,251,93,41,196,18,178
"2011","Wealden 016A","E01021180","Total",537,185,12,173,133,49,145,23,122
"2011","Wealden 016B","E01021181","Total",529,188,13,175,171,61,126,28,98
"2011","Wealden 016C","E01021182","Total",677,297,13,284,152,55,215,33,182
"2011","Wealden 016D","E01021183","Total",541,214,58,156,225,89,176,50,126
"2011","Wealden 017A","E01021178","Total",546,240,47,193,200,87,173,39,134
"2011","Wealden 017B","E01021179","Total",637,267,54,213,191,88,241,37,204
"2011","Wealden 017C","E01021184","Total",648,283,9,274,157,60,199,21,178
"2011","Wealden 017D","E01021185","Total",642,257,44,213,206,83,202,43,159
"2011","Wealden 018A","E01021142","Total",609,372,4,368,51,16,190,7,183
"2011","Wealden 018B","E01021143","Total",560,240,10,230,111,33,128,11,117
"2011","Wealden 018C","E01021166","Total",1050,467,13,454,189,59,256,28,228
"2011","Wealden 018D","E01021195","Total",780,265,13,252,183,57,203,33,170
"2011","Wealden 018E","E01021196","Total",805,277,18,259,229,87,214,38,176
"2011","Wealden 018F","E01021197","Total",723,163,9,154,228,89,156,18,138
"2011","Wealden 019A","E01021212","Total",918,411,14,397,172,58,268,24,244
"2011","Wealden 019B","E01021213","Total",805,284,30,254,214,94,231,31,200
"2011","Wealden 019C","E01021214","Total",774,377,15,362,150,63,251,23,228
"2011","Wealden 019D","E01021215","Total",642,335,11,324,103,36,224,17,207
"2011","Wealden 019E","E01021216","Total",510,206,11,195,105,41,155,20,135
"2011","Wealden 020A","E01021206","Total",667,279,9,270,143,36,232,26,206
"2011","Wealden 020B","E01021207","Total",660,299,16,283,115,38,218,28,190
"2011","Wealden 020C","E01021208","Total",743,190,17,173,284,97,158,35,123
"2011","Wealden 020D","E01021209","Total",668,275,6,269,180,49,184,35,149
"2011","Wealden 020E","E01021210","Total",581,125,8,117,255,81,125,39,86
"2011","Wealden 020F","E01021211","Total",806,446,6,440,89,34,288,18,270
"2011","Wealden 021A","E01021232","Total",816,394,6,388,145,54,267,24,243
"2011","Wealden 021B","E01021233","Total",640,277,4,273,159,48,196,16,180
"2011","Wealden 021C","E01021234","Total",675,309,7,302,146,36,186,24,162
"2011","Wealden 021D","E01021235","Total",647,298,4,294,105,27,190,16,174
"2011","Wealden 021E","E01021236","Total",728,344,11,333,131,42,248,23,225
"2011","Basingstoke and Deane 001A","E01022553","Total",606,174,15,159,168,59,137,21,116
"2011","Basingstoke and Deane 001B","E01022554","Total",678,196,10,186,205,75,152,32,120
"2011","Basingstoke and Deane 001C","E01022555","Total",629,195,13,182,171,64,143,21,122
"2011","Basingstoke and Deane 001D","E01022556","Total",666,216,39,177,224,89,178,41,137
"2011","Basingstoke and Deane 001E","E01022560","Total",481,92,8,84,147,58,90,15,75
"2011","Basingstoke and Deane 002A","E01022493","Total",521,130,8,122,164,60,114,24,90
"2011","Basingstoke and Deane 002B","E01022536","Total",551,184,5,179,138,39,127,16,111
"2011","Basingstoke and Deane 002C","E01022537","Total",550,174,2,172,137,40,138,14,124
"2011","Basingstoke and Deane 002D","E01022557","Total",627,160,14,146,188,88,141,24,117
"2011","Basingstoke and Deane 002E","E01022558","Total",588,114,8,106,163,75,111,25,86
"2011","Basingstoke and Deane 002F","E01022559","Total",524,139,4,135,155,45,109,28,81
"2011","Basingstoke and Deane 003A","E01022488","Total",451,99,11,88,170,67,94,25,69
"2011","Basingstoke and Deane 003B","E01022489","Total",548,152,8,144,177,58,109,22,87
"2011","Basingstoke and Deane 003C","E01022499","Total",557,120,8,112,209,86,90,22,68
"2011","Basingstoke and Deane 003D","E01022500","Total",535,119,10,109,159,57,118,24,94
"2011","Basingstoke and Deane 003E","E01022513","Total",616,142,14,128,209,67,106,21,85
"2011","Basingstoke and Deane 004A","E01022472","Total",500,152,8,144,126,56,117,20,97
"2011","Basingstoke and Deane 004B","E01022473","Total",504,136,7,129,157,60,107,17,90
"2011","Basingstoke and Deane 004C","E01022520","Total",759,235,19,216,187,63,203,27,176
"2011","Basingstoke and Deane 004D","E01022521","Total",741,200,8,192,196,77,146,27,119
"2011","Basingstoke and Deane 004E","E01022522","Total",623,125,9,116,180,52,116,24,92
"2011","Basingstoke and Deane 005A","E01022490","Total",742,193,14,179,255,100,150,38,112
"2011","Basingstoke and Deane 005B","E01022491","Total",746,149,42,107,304,150,122,47,75
"2011","Basingstoke and Deane 005C","E01022492","Total",661,161,5,156,176,66,101,14,87
"2011","Basingstoke and Deane 005D","E01022546","Total",557,131,3,128,173,61,102,15,87
"2011","Basingstoke and Deane 005E","E01022547","Total",724,226,8,218,201,64,177,24,153
"2011","Basingstoke and Deane 006A","E01022495","Total",652,81,11,70,199,99,70,21,49
"2011","Basingstoke and Deane 006B","E01022496","Total",937,83,12,71,411,188,95,38,57
"2011","Basingstoke and Deane 006C","E01022497","Total",610,104,8,96,183,76,102,24,78
"2011","Basingstoke and Deane 006D","E01022498","Total",650,104,9,95,211,101,91,21,70
"2011","Basingstoke and Deane 007B","E01022539","Total",488,122,22,100,179,76,127,30,97
"2011","Basingstoke and Deane 007C","E01022540","Total",749,167,51,116,296,151,182,60,122
"2011","Basingstoke and Deane 007E","E01022542","Total",456,121,38,83,182,82,124,39,85
"2011","Basingstoke and Deane 007F","E01022543","Total",653,144,21,123,207,99,133,24,109
"2011","Basingstoke and Deane 007H","E01032843","Total",695,90,25,65,257,165,87,32,55
"2011","Basingstoke and Deane 007I","E01032844","Total",685,216,21,195,186,81,197,26,171
"2011","Basingstoke and Deane 007J","E01032851","Total",825,246,57,189,307,139,228,55,173
"2011","Basingstoke and Deane 008A","E01022470","Total",791,138,4,134,245,91,152,29,123
"2011","Basingstoke and Deane 008B","E01022471","Total",619,102,7,95,207,79,91,20,71
"2011","Basingstoke and Deane 008C","E01022494","Total",1024,176,29,147,346,147,174,51,123
"2011","Basingstoke and Deane 008D","E01022523","Total",804,235,64,171,278,126,210,52,158
"2011","Basingstoke and Deane 009A","E01022524","Total",745,215,46,169,284,119,183,38,145
"2011","Basingstoke and Deane 009B","E01022525","Total",651,195,13,182,166,70,143,26,117
"2011","Basingstoke and Deane 009C","E01022526","Total",657,161,33,128,225,74,133,34,99
"2011","Basingstoke and Deane 009D","E01022527","Total",749,280,36,244,204,87,192,37,155
"2011","Basingstoke and Deane 010B","E01022566","Total",473,114,11,103,167,56,115,27,88
"2011","Basingstoke and Deane 010C","E01022567","Total",511,163,27,136,192,67,157,40,117
"2011","Basingstoke and Deane 010D","E01022568","Total",614,207,25,182,184,60,171,29,142
"2011","Basingstoke and Deane 010E","E01022570","Total",637,185,8,177,184,57,124,19,105
"2011","Basingstoke and Deane 010F","E01032840","Total",708,80,32,48,280,202,86,36,50
"2011","Basingstoke and Deane 010G","E01032841","Total",702,87,14,73,254,142,98,34,64
"2011","Basingstoke and Deane 011B","E01022502","Total",690,185,15,170,185,81,144,23,121
"2011","Basingstoke and Deane 011C","E01022506","Total",592,148,10,138,139,52,137,18,119
"2011","Basingstoke and Deane 011D","E01022507","Total",680,174,10,164,183,60,172,22,150
"2011","Basingstoke and Deane 011E","E01032842","Total",679,54,4,50,129,87,43,10,33
"2011","Basingstoke and Deane 011F","E01032847","Total",651,196,21,175,144,49,158,22,136
"2011","Basingstoke and Deane 012A","E01022481","Total",753,207,18,189,214,90,167,20,147
"2011","Basingstoke and Deane 012B","E01022482","Total",712,273,36,237,193,86,187,23,164
"2011","Basingstoke and Deane 012D","E01022503","Total",617,112,6,106,152,67,113,22,91
"2011","Basingstoke and Deane 012E","E01032845","Total",720,130,12,118,215,108,133,25,108
"2011","Basingstoke and Deane 012F","E01032846","Total",742,63,9,54,191,128,75,13,62
"2011","Basingstoke and Deane 013A","E01022484","Total",504,170,45,125,201,91,127,36,91
"2011","Basingstoke and Deane 013B","E01022485","Total",465,142,29,113,162,69,122,39,83
"2011","Basingstoke and Deane 013C","E01022486","Total",801,156,40,116,333,160,154,58,96
"2011","Basingstoke and Deane 013D","E01022487","Total",484,146,39,107,186,88,127,43,84
"2011","Basingstoke and Deane 013E","E01022569","Total",507,153,14,139,133,46,133,26,107
"2011","Basingstoke and Deane 014A","E01022548","Total",631,259,27,232,153,48,194,27,167
"2011","Basingstoke and Deane 014B","E01022549","Total",791,317,41,276,203,90,245,40,205
"2011","Basingstoke and Deane 014C","E01022550","Total",793,320,44,276,207,87,249,41,208
"2011","Basingstoke and Deane 014D","E01022551","Total",650,214,18,196,176,73,191,29,162
"2011","Basingstoke and Deane 014E","E01022552","Total",607,179,28,151,211,83,156,33,123
"2011","Basingstoke and Deane 015A","E01022528","Total",497,147,6,141,148,48,117,22,95
"2011","Basingstoke and Deane 015B","E01022529","Total",660,245,6,239,133,53,199,17,182
"2011","Basingstoke and Deane 015C","E01022530","Total",523,196,6,190,121,36,116,17,99
"2011","Basingstoke and Deane 015D","E01022531","Total",597,169,2,167,160,46,135,20,115
"2011","Basingstoke and Deane 016A","E01022475","Total",719,110,17,93,221,93,113,26,87
"2011","Basingstoke and Deane 016B","E01022476","Total",696,116,14,102,275,116,121,34,87
"2011","Basingstoke and Deane 016C","E01022480","Total",494,113,20,93,191,78,128,31,97
"2011","Basingstoke and Deane 016D","E01022504","Total",643,223,11,212,166,56,138,22,116
"2011","Basingstoke and Deane 016E","E01022505","Total",627,166,7,159,192,70,131,19,112
"2011","Basingstoke and Deane 017A","E01022467","Total",668,213,5,208,182,66,140,14,126
"2011","Basingstoke and Deane 017B","E01022468","Total",749,240,12,228,193,66,159,21,138
"2011","Basingstoke and Deane 017C","E01022469","Total",662,239,14,225,196,70,181,19,162
"2011","Basingstoke and Deane 017D","E01022561","Total",608,128,4,124,167,62,105,15,90
"2011","Basingstoke and Deane 017E","E01022562","Total",545,152,7,145,147,49,100,18,82
"2011","Basingstoke and Deane 018A","E01022515","Total",656,355,5,350,60,21,213,8,205
"2011","Basingstoke and Deane 018B","E01022516","Total",610,245,5,240,154,42,139,21,118
"2011","Basingstoke and Deane 018C","E01022517","Total",489,125,2,123,125,36,92,13,79
"2011","Basingstoke and Deane 018D","E01022518","Total",744,142,7,135,293,95,124,37,87
"2011","Basingstoke and Deane 018E","E01022519","Total",497,155,4,151,137,38,126,21,105
"2011","Basingstoke and Deane 019A","E01022474","Total",614,176,40,136,245,105,131,30,101
"2011","Basingstoke and Deane 019B","E01022477","Total",633,134,23,111,191,79,127,30,97
"2011","Basingstoke and Deane 019C","E01022478","Total",621,165,41,124,207,90,180,36,144
"2011","Basingstoke and Deane 019D","E01022479","Total",599,213,32,181,193,62,180,32,148
"2011","Basingstoke and Deane 019E","E01022509","Total",574,89,13,76,220,103,71,23,48
"2011","Basingstoke and Deane 020A","E01022514","Total",631,166,6,160,174,65,138,23,115
"2011","Basingstoke and Deane 020B","E01022563","Total",731,188,11,177,212,87,131,22,109
"2011","Basingstoke and Deane 020C","E01022564","Total",783,244,13,231,231,98,179,33,146
"2011","Basingstoke and Deane 020D","E01022565","Total",727,213,16,197,209,85,163,25,138
"2011","Basingstoke and Deane 021B","E01022510","Total",577,45,11,34,293,107,80,39,41
"2011","Basingstoke and Deane 021C","E01022511","Total",446,57,5,52,203,65,47,14,33
"2011","Basingstoke and Deane 021D","E01022512","Total",468,51,8,43,246,80,68,28,40
"2011","Basingstoke and Deane 021E","E01032848","Total",573,53,21,32,304,157,71,34,37
"2011","Basingstoke and Deane 021F","E01032849","Total",564,54,15,39,287,154,79,34,45
"2011","Basingstoke and Deane 021G","E01032850","Total",607,66,10,56,223,108,76,29,47
"2011","Basingstoke and Deane 022A","E01022532","Total",537,140,6,134,164,45,105,16,89
"2011","Basingstoke and Deane 022B","E01022533","Total",694,169,13,156,244,100,125,30,95
"2011","Basingstoke and Deane 022C","E01022534","Total",724,250,13,237,188,92,164,19,145
"2011","Basingstoke and Deane 022D","E01022535","Total",689,248,6,242,149,60,181,23,158
"2011","East Hampshire 001A","E01022581","Total",573,125,9,116,202,73,92,20,72
"2011","East Hampshire 001B","E01022582","Total",558,144,10,134,168,50,99,14,85
"2011","East Hampshire 001C","E01022604","Total",485,140,11,129,144,41,109,19,90
"2011","East Hampshire 001D","E01022605","Total",607,146,6,140,180,66,111,21,90
"2011","East Hampshire 002A","E01022574","Total",621,210,12,198,172,79,171,22,149
"2011","East Hampshire 002B","E01022575","Total",573,188,60,128,230,107,172,46,126
"2011","East Hampshire 002C","E01022576","Total",803,336,34,302,168,72,266,31,235
"2011","East Hampshire 002D","E01022579","Total",506,201,27,174,137,54,145,23,122
"2011","East Hampshire 003A","E01022571","Total",475,103,4,99,157,52,97,22,75
"2011","East Hampshire 003B","E01022572","Total",507,107,5,102,153,49,95,26,69
"2011","East Hampshire 003C","E01022573","Total",1066,267,7,260,285,87,212,28,184
"2011","East Hampshire 003D","E01022577","Total",736,294,12,282,157,64,199,17,182
"2011","East Hampshire 003E","E01022578","Total",1174,335,17,318,371,134,273,47,226
"2011","East Hampshire 003F","E01022580","Total",484,118,6,112,140,50,110,19,91
"2011","East Hampshire 004A","E01022603","Total",534,118,18,100,196,77,128,30,98
"2011","East Hampshire 004B","E01022634","Total",498,151,11,140,123,61,150,11,139
"2011","East Hampshire 004C","E01022639","Total",567,68,21,47,310,167,85,30,55
"2011","East Hampshire 004D","E01022640","Total",571,87,25,62,228,101,96,34,62
"2011","East Hampshire 006A","E01022615","Total",1101,243,32,211,360,156,207,51,156
"2011","East Hampshire 006B","E01022633","Total",608,127,7,120,147,56,126,15,111
"2011","East Hampshire 006C","E01022635","Total",514,114,39,75,226,78,115,37,78
"2011","East Hampshire 006D","E01022636","Total",499,82,20,62,185,71,96,41,55
"2011","East Hampshire 006E","E01022641","Total",519,103,13,90,156,58,112,27,85
"2011","East Hampshire 007A","E01022591","Total",961,245,10,235,279,82,179,39,140
"2011","East Hampshire 007B","E01022593","Total",482,149,5,144,138,41,103,14,89
"2011","East Hampshire 007C","E01022594","Total",587,176,14,162,176,65,128,24,104
"2011","East Hampshire 007D","E01022595","Total",728,161,7,154,257,74,127,33,94
"2011","East Hampshire 007E","E01022596","Total",537,161,2,159,133,44,105,17,88
"2011","East Hampshire 007F","E01022627","Total",880,221,13,208,264,54,177,23,154
"2011","East Hampshire 008A","E01022630","Total",939,266,17,249,259,86,192,36,156
"2011","East Hampshire 008D","E01022642","Total",420,109,4,105,135,44,100,13,87
"2011","East Hampshire 008E","E01032663","Total",966,242,27,215,291,109,207,40,167
"2011","East Hampshire 009A","E01022583","Total",699,232,14,218,220,63,154,24,130
"2011","East Hampshire 009B","E01022584","Total",785,306,22,284,224,73,228,30,198
"2011","East Hampshire 009C","E01022585","Total",653,205,6,199,192,53,114,17,97
"2011","East Hampshire 009D","E01022586","Total",634,149,5,144,200,61,122,23,99
"2011","East Hampshire 009E","E01022587","Total",761,209,14,195,222,74,161,23,138
"2011","East Hampshire 010A","E01022616","Total",735,233,21,212,221,97,185,18,167
"2011","East Hampshire 010B","E01022617","Total",657,190,6,184,178,67,155,22,133
"2011","East Hampshire 010C","E01022618","Total",671,225,4,221,178,46,145,19,126
"2011","East Hampshire 010D","E01022631","Total",514,120,5,115,170,58,91,16,75
"2011","East Hampshire 010E","E01022632","Total",453,126,6,120,126,43,92,18,74
"2011","East Hampshire 011A","E01022592","Total",929,262,20,242,282,85,200,28,172
"2011","East Hampshire 011B","E01022597","Total",993,257,23,234,303,109,182,37,145
"2011","East Hampshire 011C","E01022619","Total",517,129,6,123,156,61,82,16,66
"2011","East Hampshire 011D","E01022624","Total",1000,365,7,358,248,66,200,27,173
"2011","East Hampshire 011E","E01022625","Total",1090,339,10,329,356,129,233,36,197
"2011","East Hampshire 012A","E01022620","Total",489,122,10,112,138,63,104,19,85
"2011","East Hampshire 012B","E01022621","Total",607,222,26,196,202,85,165,23,142
"2011","East Hampshire 012C","E01022622","Total",568,208,8,200,161,58,130,17,113
"2011","East Hampshire 012D","E01022623","Total",940,286,34,252,317,121,195,28,167
"2011","East Hampshire 012F","E01032664","Total",656,292,5,287,85,34,182,8,174
"2011","East Hampshire 012G","E01032665","Total",658,213,13,200,156,64,159,14,145
"2011","East Hampshire 013A","E01022588","Total",647,208,9,199,190,51,143,31,112
"2011","East Hampshire 013B","E01022589","Total",741,198,16,182,216,74,175,31,144
"2011","East Hampshire 013C","E01022590","Total",595,197,15,182,176,49,109,19,90
"2011","East Hampshire 013D","E01022607","Total",515,176,11,165,134,46,115,18,97
"2011","East Hampshire 013E","E01022608","Total",522,130,1,129,176,51,104,15,89
"2011","East Hampshire 014A","E01022606","Total",943,216,8,208,286,86,185,28,157
"2011","East Hampshire 014B","E01022611","Total",634,208,10,198,203,66,160,22,138
"2011","East Hampshire 014C","E01022613","Total",518,124,9,115,188,50,122,27,95
"2011","East Hampshire 014D","E01022614","Total",474,179,17,162,119,49,136,21,115
"2011","East Hampshire 016A","E01022610","Total",536,162,2,160,142,46,136,18,118
"2011","East Hampshire 016B","E01022628","Total",520,151,7,144,134,48,105,19,86
"2011","East Hampshire 016C","E01022629","Total",618,291,6,285,115,29,151,13,138
"2011","East Hampshire 016D","E01032615","Total",466,206,2,204,88,31,120,16,104
"2011","East Hampshire 016E","E01032616","Total",632,175,3,172,187,56,122,16,106
"2011","East Hampshire 017A","E01022599","Total",597,217,7,210,131,48,146,14,132
"2011","East Hampshire 017B","E01022600","Total",640,218,8,210,146,46,147,15,132
"2011","East Hampshire 017C","E01022601","Total",597,205,8,197,157,50,144,25,119
"2011","East Hampshire 017D","E01022602","Total",520,157,1,156,113,32,99,11,88
"2011","East Hampshire 017E","E01032625","Total",455,207,10,197,109,35,118,11,107
"2011","Eastleigh 001A","E01022705","Total",652,275,3,272,178,45,179,29,150
"2011","Eastleigh 001B","E01022706","Total",647,249,2,247,186,40,152,24,128
"2011","Eastleigh 001C","E01022707","Total",761,200,6,194,279,95,132,23,109
"2011","Eastleigh 001D","E01022708","Total",736,232,8,224,232,88,138,23,115
"2011","Eastleigh 001E","E01022709","Total",691,256,7,249,210,66,162,30,132
"2011","Eastleigh 002A","E01022659","Total",630,141,20,121,234,82,129,32,97
"2011","Eastleigh 002B","E01022660","Total",663,250,8,242,156,64,197,13,184
"2011","Eastleigh 002C","E01022675","Total",566,135,5,130,135,46,116,13,103
"2011","Eastleigh 002D","E01022676","Total",608,160,5,155,151,58,125,14,111
"2011","Eastleigh 002E","E01022704","Total",745,241,7,234,232,77,169,25,144
"2011","Eastleigh 003A","E01022661","Total",799,328,7,321,152,56,193,22,171
"2011","Eastleigh 003B","E01022662","Total",543,146,2,144,147,45,122,16,106
"2011","Eastleigh 003C","E01022663","Total",635,136,5,131,201,80,113,27,86
"2011","Eastleigh 003D","E01022664","Total",646,200,3,197,189,60,127,16,111
"2011","Eastleigh 003E","E01022665","Total",748,253,17,236,165,70,178,11,167
"2011","Eastleigh 004A","E01022648","Total",612,227,10,217,115,42,164,19,145
"2011","Eastleigh 004B","E01022667","Total",614,130,9,121,189,83,139,22,117
"2011","Eastleigh 004C","E01022672","Total",623,176,12,164,182,74,176,25,151
"2011","Eastleigh 004D","E01022673","Total",864,196,39,157,267,127,202,42,160
"2011","Eastleigh 004E","E01022674","Total",716,182,15,167,169,76,182,18,164
"2011","Eastleigh 005A","E01022643","Total",667,167,11,156,193,81,143,24,119
"2011","Eastleigh 005B","E01022644","Total",511,123,13,110,184,66,117,22,95
"2011","Eastleigh 005C","E01022646","Total",650,168,13,155,218,71,137,24,113
"2011","Eastleigh 005D","E01022647","Total",618,168,13,155,178,75,157,24,133
"2011","Eastleigh 005E","E01022649","Total",656,256,50,206,253,115,199,44,155
"2011","Eastleigh 005F","E01022650","Total",461,132,12,120,135,57,110,23,87
"2011","Eastleigh 006A","E01022668","Total",1010,186,50,136,366,175,208,58,150
"2011","Eastleigh 006B","E01022677","Total",849,289,57,232,294,148,221,45,176
"2011","Eastleigh 006C","E01022678","Total",718,195,34,161,267,106,195,60,135
"2011","Eastleigh 006D","E01022680","Total",779,367,47,320,198,90,308,38,270
"2011","Eastleigh 006E","E01022681","Total",640,228,31,197,189,61,202,34,168
"2011","Eastleigh 007A","E01022666","Total",930,196,26,170,237,127,194,22,172
"2011","Eastleigh 007B","E01022669","Total",740,164,21,143,240,119,161,40,121
"2011","Eastleigh 007C","E01022670","Total",671,164,42,122,242,119,156,37,119
"2011","Eastleigh 007D","E01022671","Total",719,196,21,175,186,82,196,31,165
"2011","Eastleigh 007E","E01022679","Total",736,157,37,120,262,140,159,41,118
"2011","Eastleigh 008A","E01022645","Total",494,179,2,177,108,24,129,17,112
"2011","Eastleigh 008B","E01022682","Total",508,130,3,127,156,43,121,18,103
"2011","Eastleigh 008C","E01022683","Total",544,124,7,117,194,65,124,31,93
"2011","Eastleigh 008D","E01022684","Total",592,173,10,163,193,54,148,31,117
"2011","Eastleigh 008E","E01022685","Total",553,210,7,203,128,36,135,11,124
"2011","Eastleigh 008F","E01022686","Total",615,130,11,119,242,75,114,32,82
"2011","Eastleigh 008G","E01022687","Total",671,122,12,110,264,72,101,27,74
"2011","Eastleigh 009A","E01022713","Total",695,206,12,194,189,83,170,26,144
"2011","Eastleigh 009B","E01022714","Total",720,288,7,281,163,55,187,19,168
"2011","Eastleigh 009C","E01022715","Total",747,205,19,186,181,70,161,16,145
"2011","Eastleigh 009D","E01022716","Total",765,176,28,148,193,94,155,29,126
"2011","Eastleigh 009E","E01022717","Total",523,106,8,98,146,51,91,19,72
"2011","Eastleigh 009F","E01022718","Total",605,168,10,158,163,55,136,23,113
"2011","Eastleigh 009G","E01022719","Total",693,253,2,251,149,53,192,16,176
"2011","Eastleigh 010A","E01022653","Total",616,217,6,211,151,60,168,19,149
"2011","Eastleigh 010B","E01022691","Total",627,82,9,73,251,87,81,25,56
"2011","Eastleigh 010C","E01022692","Total",1110,102,53,49,531,287,118,50,68
"2011","Eastleigh 010D","E01022693","Total",544,72,4,68,258,87,67,18,49
"2011","Eastleigh 010E","E01022694","Total",672,85,15,70,315,117,82,33,49
"2011","Eastleigh 011A","E01022652","Total",746,265,24,241,213,69,214,28,186
"2011","Eastleigh 011B","E01022695","Total",594,208,10,198,170,63,167,18,149
"2011","Eastleigh 011C","E01022700","Total",677,225,12,213,212,95,183,26,157
"2011","Eastleigh 011D","E01022701","Total",416,167,7,160,108,46,131,19,112
"2011","Eastleigh 011E","E01022703","Total",665,201,17,184,171,53,147,24,123
"2011","Eastleigh 012A","E01022651","Total",794,162,20,142,245,105,149,37,112
"2011","Eastleigh 012B","E01022696","Total",644,255,6,249,177,49,170,28,142
"2011","Eastleigh 012C","E01022697","Total",610,186,12,174,184,57,126,16,110
"2011","Eastleigh 012D","E01022698","Total",652,234,5,229,178,54,166,21,145
"2011","Eastleigh 012E","E01022699","Total",620,182,9,173,189,82,112,17,95
"2011","Eastleigh 012F","E01022702","Total",496,76,4,72,189,56,66,14,52
"2011","Eastleigh 013A","E01022654","Total",572,109,16,93,173,75,103,20,83
"2011","Eastleigh 013B","E01022655","Total",558,191,72,119,292,117,177,64,113
"2011","Eastleigh 013C","E01022656","Total",604,199,19,180,177,77,156,31,125
"2011","Eastleigh 013D","E01022657","Total",745,188,16,172,184,69,148,27,121
"2011","Eastleigh 013E","E01022658","Total",721,234,8,226,177,69,144,25,119
"2011","Eastleigh 014A","E01022710","Total",964,365,10,355,177,84,263,31,232
"2011","Eastleigh 014B","E01022711","Total",749,310,35,275,215,68,261,52,209
"2011","Eastleigh 014C","E01022712","Total",685,135,12,123,215,89,135,24,111
"2011","Eastleigh 015A","E01022688","Total",1037,274,21,253,248,96,184,31,153
"2011","Eastleigh 015B","E01022689","Total",659,200,8,192,170,55,132,15,117
"2011","Eastleigh 015C","E01022690","Total",821,270,28,242,274,130,229,46,183
"2011","Fareham 001A","E01022758","Total",600,133,21,112,232,97,117,26,91
"2011","Fareham 001B","E01022771","Total",601,63,6,57,285,111,81,27,54
"2011","Fareham 001C","E01022772","Total",793,100,18,82,365,142,108,40,68
"2011","Fareham 001D","E01022773","Total",651,174,4,170,196,66,119,18,101
"2011","Fareham 001E","E01022774","Total",739,178,13,165,251,90,133,30,103
"2011","Fareham 002A","E01022749","Total",536,166,8,158,156,53,136,20,116
"2011","Fareham 002B","E01022753","Total",493,128,7,121,161,51,112,18,94
"2011","Fareham 002C","E01022754","Total",760,184,18,166,246,99,154,32,122
"2011","Fareham 002D","E01022780","Total",614,101,13,88,242,113,90,26,64
"2011","Fareham 002E","E01022787","Total",541,154,10,144,164,53,139,27,112
"2011","Fareham 002F","E01022788","Total",528,122,9,113,190,69,111,30,81
"2011","Fareham 003A","E01022730","Total",631,233,15,218,154,47,157,24,133
"2011","Fareham 003B","E01022731","Total",515,84,8,76,177,65,92,21,71
"2011","Fareham 003C","E01022732","Total",666,241,56,185,244,84,211,58,153
"2011","Fareham 003D","E01022733","Total",735,277,17,260,183,66,198,27,171
"2011","Fareham 003E","E01022734","Total",515,153,25,128,177,56,135,28,107
"2011","Fareham 004A","E01022720","Total",525,143,4,139,164,38,95,17,78
"2011","Fareham 004B","E01022725","Total",496,193,1,192,121,26,125,17,108
"2011","Fareham 004C","E01022726","Total",607,258,7,251,134,46,171,24,147
"2011","Fareham 004D","E01022727","Total",655,266,9,257,182,57,192,28,164
"2011","Fareham 004E","E01022729","Total",455,91,8,83,146,57,85,20,65
"2011","Fareham 004F","E01022743","Total",806,284,15,269,161,53,181,18,163
"2011","Fareham 005A","E01022750","Total",631,218,6,212,169,43,173,21,152
"2011","Fareham 005B","E01022751","Total",652,258,4,254,161,47,180,18,162
"2011","Fareham 005C","E01022752","Total",542,154,2,152,172,38,112,19,93
"2011","Fareham 005D","E01022757","Total",695,86,12,74,232,93,93,21,72
"2011","Fareham 005E","E01022790","Total",712,183,4,179,226,62,134,28,106
"2011","Fareham 006A","E01022755","Total",610,221,14,207,175,53,158,30,128
"2011","Fareham 006B","E01022756","Total",524,118,5,113,167,49,100,15,85
"2011","Fareham 006C","E01022791","Total",838,309,7,302,223,62,201,30,171
"2011","Fareham 006D","E01022792","Total",626,183,18,165,191,61,137,27,110
"2011","Fareham 006E","E01022793","Total",681,191,6,185,225,59,120,18,102
"2011","Fareham 007A","E01022781","Total",564,182,21,161,184,74,155,29,126
"2011","Fareham 007B","E01022782","Total",646,221,9,212,140,49,135,19,116
"2011","Fareham 007C","E01022785","Total",614,163,4,159,188,57,121,16,105
"2011","Fareham 007D","E01022786","Total",653,172,15,157,194,73,131,26,105
"2011","Fareham 007E","E01022789","Total",634,142,7,135,173,83,103,22,81
"2011","Fareham 008A","E01022721","Total",634,193,14,179,159,55,128,25,103
"2011","Fareham 008B","E01022722","Total",703,257,16,241,200,77,206,41,165
"2011","Fareham 008C","E01022723","Total",723,250,29,221,161,64,202,28,174
"2011","Fareham 008D","E01022724","Total",577,134,17,117,213,82,124,36,88
"2011","Fareham 008E","E01022737","Total",652,198,21,177,173,63,160,33,127
"2011","Fareham 008F","E01022766","Total",529,189,5,184,132,28,131,19,112
"2011","Fareham 008G","E01022769","Total",552,119,8,111,147,50,98,19,79
"2011","Fareham 009A","E01022740","Total",727,261,3,258,132,41,179,18,161
"2011","Fareham 009B","E01022741","Total",466,127,2,125,150,64,97,21,76
"2011","Fareham 009C","E01022742","Total",872,417,2,415,120,32,261,11,250
"2011","Fareham 009D","E01022783","Total",641,241,5,236,143,50,150,15,135
"2011","Fareham 009E","E01022784","Total",500,110,3,107,169,48,93,20,73
"2011","Fareham 010A","E01022759","Total",660,229,6,223,176,50,161,21,140
"2011","Fareham 010B","E01022763","Total",686,274,3,271,137,41,184,18,166
"2011","Fareham 010C","E01022765","Total",760,294,3,291,175,61,218,14,204
"2011","Fareham 010D","E01022768","Total",599,176,8,168,138,47,132,18,114
"2011","Fareham 010E","E01022770","Total",693,228,9,219,180,48,164,18,146
"2011","Fareham 011A","E01022728","Total",841,291,29,262,225,111,231,40,191
"2011","Fareham 011B","E01022735","Total",619,156,16,140,183,79,151,23,128
"2011","Fareham 011C","E01022736","Total",662,212,11,201,166,56,192,27,165
"2011","Fareham 011D","E01022738","Total",483,191,33,158,132,58,160,30,130
"2011","Fareham 011E","E01022739","Total",673,271,63,208,271,124,206,56,150
"2011","Fareham 012A","E01022760","Total",644,225,14,211,183,60,189,27,162
"2011","Fareham 012B","E01022761","Total",657,239,20,219,160,56,211,26,185
"2011","Fareham 012C","E01022762","Total",639,197,13,184,192,64,164,32,132
"2011","Fareham 012D","E01022764","Total",761,366,11,355,141,43,268,23,245
"2011","Fareham 012E","E01022767","Total",511,165,9,156,145,42,140,23,117
"2011","Fareham 013B","E01022776","Total",627,181,3,178,177,35,134,21,113
"2011","Fareham 013C","E01022777","Total",769,416,10,406,163,44,286,28,258
"2011","Fareham 013D","E01022778","Total",598,212,8,204,159,43,161,28,133
"2011","Fareham 013F","E01032877","Total",919,414,19,395,198,52,269,35,234
"2011","Fareham 014A","E01022744","Total",567,225,4,221,136,35,138,19,119
"2011","Fareham 014B","E01022745","Total",633,266,6,260,144,36,177,16,161
"2011","Fareham 014C","E01022746","Total",703,303,0,303,192,81,166,18,148
"2011","Fareham 014D","E01022747","Total",586,224,4,220,134,38,163,25,138
"2011","Fareham 014E","E01022748","Total",629,199,6,193,167,43,156,30,126
"2011","Gosport 001A","E01022800","Total",645,203,29,174,202,81,199,36,163
"2011","Gosport 001B","E01022801","Total",644,246,38,208,186,81,207,33,174
"2011","Gosport 001C","E01022802","Total",607,178,15,163,163,57,144,20,124
"2011","Gosport 001D","E01022803","Total",626,196,41,155,228,73,216,61,155
"2011","Gosport 001E","E01022836","Total",639,291,13,278,129,27,204,23,181
"2011","Gosport 002A","E01022804","Total",680,237,27,210,173,63,206,43,163
"2011","Gosport 002B","E01022805","Total",646,251,23,228,183,76,179,33,146
"2011","Gosport 002C","E01022834","Total",614,257,21,236,117,44,214,31,183
"2011","Gosport 002D","E01022835","Total",627,208,44,164,182,76,161,49,112
"2011","Gosport 002E","E01022840","Total",664,232,39,193,209,81,202,40,162
"2011","Gosport 003A","E01022813","Total",546,130,10,120,184,71,105,19,86
"2011","Gosport 003B","E01022814","Total",762,237,13,224,207,87,216,25,191
"2011","Gosport 003C","E01022815","Total",619,154,5,149,193,49,154,32,122
"2011","Gosport 003D","E01022823","Total",644,179,18,161,179,69,139,25,114
"2011","Gosport 003E","E01022825","Total",591,137,13,124,188,69,120,26,94
"2011","Gosport 004A","E01022819","Total",671,164,63,101,274,134,136,42,94
"2011","Gosport 004B","E01022820","Total",610,135,94,41,360,194,120,66,54
"2011","Gosport 004E","E01022841","Total",608,181,25,156,230,115,188,39,149
"2011","Gosport 004F","E01022842","Total",607,134,36,98,302,192,118,49,69
"2011","Gosport 004G","E01032882","Total",755,206,111,95,380,165,173,76,97
"2011","Gosport 005A","E01022807","Total",760,255,38,217,201,94,211,35,176
"2011","Gosport 005B","E01022816","Total",615,154,18,136,208,73,144,31,113
"2011","Gosport 005C","E01022817","Total",709,191,38,153,243,104,177,40,137
"2011","Gosport 005D","E01022818","Total",606,208,35,173,209,66,197,41,156
"2011","Gosport 005E","E01022824","Total",1210,241,66,175,390,211,190,48,142
"2011","Gosport 006A","E01022826","Total",675,184,8,176,174,48,138,23,115
"2011","Gosport 006C","E01022828","Total",764,451,9,442,73,31,281,13,268
"2011","Gosport 006D","E01022829","Total",805,312,7,305,206,93,221,31,190
"2011","Gosport 006E","E01022830","Total",639,272,10,262,128,48,156,8,148
"2011","Gosport 006F","E01032880","Total",506,79,7,72,247,96,69,23,46
"2011","Gosport 006G","E01032881","Total",595,90,24,66,319,163,85,27,58
"2011","Gosport 006H","E01032883","Total",632,280,30,250,173,62,222,43,179
"2011","Gosport 007A","E01022806","Total",602,155,19,136,189,69,132,22,110
"2011","Gosport 007D","E01022832","Total",697,160,33,127,244,105,146,33,113
"2011","Gosport 007E","E01022839","Total",639,240,16,224,151,39,218,28,190
"2011","Gosport 007F","E01032884","Total",976,328,18,310,248,122,246,30,216
"2011","Gosport 008A","E01022810","Total",731,268,20,248,174,80,230,26,204
"2011","Gosport 008B","E01022811","Total",1093,251,69,182,334,172,202,58,144
"2011","Gosport 008C","E01022833","Total",867,317,83,234,285,134,252,61,191
"2011","Gosport 008D","E01022843","Total",703,324,71,253,224,83,262,57,205
"2011","Gosport 008F","E01032878","Total",607,188,39,149,126,69,134,22,112
"2011","Gosport 008G","E01032879","Total",766,376,28,348,85,33,261,14,247
"2011","Gosport 009A","E01022794","Total",626,247,7,240,163,51,148,27,121
"2011","Gosport 009B","E01022795","Total",740,263,5,258,151,57,173,14,159
"2011","Gosport 009C","E01022796","Total",496,234,3,231,112,30,148,20,128
"2011","Gosport 009D","E01022837","Total",676,272,7,265,178,50,163,13,150
"2011","Gosport 009E","E01022838","Total",520,195,3,192,156,45,122,17,105
"2011","Gosport 010A","E01022797","Total",451,167,11,156,115,23,114,22,92
"2011","Gosport 010B","E01022798","Total",497,186,7,179,102,34,120,15,105
"2011","Gosport 010C","E01022799","Total",582,183,5,178,144,50,135,18,117
"2011","Gosport 010D","E01022812","Total",529,122,17,105,153,65,127,30,97
"2011","Gosport 010E","E01022831","Total",636,194,12,182,195,66,148,25,123
"2011","Gosport 010F","E01022845","Total",675,219,30,189,197,85,165,30,135
"2011","Hart 001A","E01022890","Total",612,217,24,193,188,55,177,31,146
"2011","Hart 001B","E01022891","Total",650,135,10,125,239,95,119,22,97
"2011","Hart 001C","E01022892","Total",782,253,6,247,185,61,199,19,180
"2011","Hart 001D","E01022893","Total",627,165,9,156,216,54,112,20,92
"2011","Hart 001E","E01022894","Total",622,189,19,170,182,64,148,14,134
"2011","Hart 002A","E01022859","Total",622,126,3,123,218,80,118,26,92
"2011","Hart 002B","E01022895","Total",738,180,9,171,236,95,134,26,108
"2011","Hart 002C","E01022896","Total",594,138,8,130,196,62,103,24,79
"2011","Hart 002D","E01022897","Total",627,88,10,78,224,77,98,27,71
"2011","Hart 002E","E01022898","Total",581,118,2,116,177,70,106,16,90
"2011","Hart 003A","E01022846","Total",456,119,6,113,101,36,90,11,79
"2011","Hart 003B","E01022847","Total",746,185,9,176,198,80,154,30,124
"2011","Hart 003C","E01022848","Total",631,218,11,207,169,62,144,18,126
"2011","Hart 003D","E01022874","Total",491,120,12,108,156,61,112,21,91
"2011","Hart 003E","E01022875","Total",485,93,23,70,210,79,105,38,67
"2011","Hart 003F","E01022876","Total",499,117,6,111,173,55,90,21,69
"2011","Hart 003G","E01022877","Total",543,145,6,139,178,68,97,19,78
"2011","Hart 004A","E01022858","Total",410,106,4,102,121,37,70,12,58
"2011","Hart 004B","E01022878","Total",705,232,5,227,196,60,119,15,104
"2011","Hart 004C","E01022879","Total",806,318,21,297,207,87,217,18,199
"2011","Hart 004D","E01022880","Total",628,164,16,148,160,60,157,25,132
"2011","Hart 005A","E01022860","Total",889,390,5,385,177,61,236,18,218
"2011","Hart 005B","E01022862","Total",945,275,9,266,214,103,207,16,191
"2011","Hart 005D","E01022867","Total",645,81,12,69,216,101,86,34,52
"2011","Hart 005E","E01032852","Total",619,51,19,32,321,157,81,35,46
"2011","Hart 005F","E01032853","Total",616,54,8,46,323,158,68,33,35
"2011","Hart 005G","E01032854","Total",604,46,12,34,306,183,48,24,24
"2011","Hart 005H","E01032857","Total",410,44,5,39,135,63,51,16,35
"2011","Hart 006A","E01022881","Total",915,207,25,182,354,146,177,34,143
"2011","Hart 006B","E01022882","Total",565,108,4,104,202,65,103,18,85
"2011","Hart 006C","E01022883","Total",524,99,15,84,207,53,86,28,58
"2011","Hart 006D","E01022884","Total",666,209,6,203,195,61,148,19,129
"2011","Hart 006E","E01022885","Total",544,79,10,69,222,61,75,20,55
"2011","Hart 007A","E01022861","Total",643,167,3,164,217,69,116,19,97
"2011","Hart 007B","E01022863","Total",631,235,4,231,185,54,148,23,125
"2011","Hart 007C","E01022865","Total",628,182,2,180,186,52,126,18,108
"2011","Hart 007D","E01022868","Total",674,205,4,201,193,64,131,20,111
"2011","Hart 007E","E01022870","Total",584,203,7,196,172,61,149,30,119
"2011","Hart 008A","E01022864","Total",636,270,15,255,164,69,179,20,159
"2011","Hart 008B","E01022871","Total",562,111,15,96,209,84,92,27,65
"2011","Hart 008C","E01022872","Total",714,202,5,197,223,82,145,27,118
"2011","Hart 008D","E01022873","Total",638,185,8,177,199,52,131,28,103
"2011","Hart 008E","E01022887","Total",550,128,2,126,140,42,99,15,84
"2011","Hart 009A","E01022849","Total",646,176,13,163,226,76,146,30,116
"2011","Hart 009B","E01022850","Total",631,150,5,145,185,79,130,18,112
"2011","Hart 009C","E01022851","Total",662,179,11,168,212,86,128,13,115
"2011","Hart 009D","E01022853","Total",693,205,4,201,257,90,147,31,116
"2011","Hart 009E","E01022869","Total",607,171,4,167,175,70,163,26,137
"2011","Hart 010A","E01022852","Total",754,96,6,90,274,95,89,24,65
"2011","Hart 010B","E01022854","Total",648,133,9,124,273,89,101,25,76
"2011","Hart 010C","E01022855","Total",504,162,12,150,152,64,119,16,103
"2011","Hart 010D","E01022856","Total",591,171,7,164,171,49,118,20,98
"2011","Hart 010E","E01022857","Total",444,41,13,28,257,121,51,25,26
"2011","Hart 011B","E01022888","Total",739,242,5,237,189,67,149,23,126
"2011","Hart 011C","E01022889","Total",638,212,12,200,183,75,162,24,138
"2011","Hart 011D","E01032855","Total",440,91,5,86,138,38,93,22,71
"2011","Hart 011E","E01032856","Total",456,23,7,16,281,161,41,26,15
"2011","Havant 003A","E01022930","Total",753,322,7,315,141,34,222,17,205
"2011","Havant 003B","E01022931","Total",641,205,4,201,193,59,147,31,116
"2011","Havant 003C","E01022935","Total",650,298,10,288,157,46,201,24,177
"2011","Havant 003D","E01022975","Total",688,306,6,300,123,25,179,15,164
"2011","Havant 003E","E01022976","Total",689,302,22,280,157,43,216,31,185
"2011","Havant 004A","E01022922","Total",675,107,14,93,216,97,82,14,68
"2011","Havant 004B","E01022971","Total",722,245,7,238,146,42,171,20,151
"2011","Havant 004C","E01022972","Total",646,216,7,209,171,57,123,11,112
"2011","Havant 004D","E01022974","Total",597,185,7,178,161,54,103,14,89
"2011","Havant 005A","E01022959","Total",556,214,47,167,220,72,182,49,133
"2011","Havant 005B","E01022962","Total",608,189,18,171,174,57,147,20,127
"2011","Havant 005C","E01022965","Total",601,230,46,184,225,72,182,39,143
"2011","Havant 005D","E01022973","Total",867,383,33,350,227,99,263,31,232
"2011","Havant 006A","E01022901","Total",643,214,64,150,234,114,164,40,124
"2011","Havant 006B","E01022902","Total",575,191,63,128,240,104,149,41,108
"2011","Havant 006C","E01022966","Total",516,180,59,121,219,91,143,36,107
"2011","Havant 006D","E01022967","Total",513,235,71,164,198,90,197,56,141
"2011","Havant 007A","E01022960","Total",508,88,34,54,198,89,108,37,71
"2011","Havant 007B","E01022961","Total",492,88,24,64,211,76,113,35,78
"2011","Havant 007C","E01022963","Total",621,219,14,205,144,41,168,26,142
"2011","Havant 007D","E01022964","Total",653,272,43,229,173,81,218,31,187
"2011","Havant 008A","E01022903","Total",776,301,77,224,273,147,231,56,175
"2011","Havant 008B","E01022906","Total",570,208,62,146,254,90,156,57,99
"2011","Havant 008C","E01022968","Total",525,195,69,126,241,90,156,59,97
"2011","Havant 008D","E01022969","Total",607,183,67,116,273,119,151,49,102
"2011","Havant 009A","E01022913","Total",549,204,36,168,164,76,180,36,144
"2011","Havant 009B","E01022914","Total",543,229,46,183,161,62,176,34,142
"2011","Havant 009C","E01022915","Total",621,249,69,180,214,99,193,46,147
"2011","Havant 009D","E01022916","Total",639,189,40,149,242,105,174,51,123
"2011","Havant 009E","E01022917","Total",528,258,51,207,160,62,191,37,154
"2011","Havant 010A","E01022900","Total",747,289,66,223,244,106,230,46,184
"2011","Havant 010B","E01022904","Total",766,279,48,231,247,113,254,57,197
"2011","Havant 010C","E01022905","Total",823,383,105,278,282,139,296,63,233
"2011","Havant 010D","E01022908","Total",593,194,39,155,190,83,154,34,120
"2011","Havant 010E","E01022970","Total",692,249,102,147,301,133,206,68,138
"2011","Havant 011A","E01022947","Total",633,164,6,158,204,53,115,19,96
"2011","Havant 011B","E01022948","Total",687,221,12,209,201,69,162,21,141
"2011","Havant 011C","E01022949","Total",757,346,40,306,184,79,277,39,238
"2011","Havant 011D","E01022950","Total",584,205,3,202,164,42,112,13,99
"2011","Havant 011E","E01022951","Total",562,187,8,179,162,43,139,24,115
"2011","Havant 011F","E01022952","Total",629,211,11,200,140,50,157,17,140
"2011","Havant 013A","E01022924","Total",719,274,13,261,153,55,182,18,164
"2011","Havant 013B","E01022925","Total",594,227,15,212,157,62,171,29,142
"2011","Havant 013C","E01022926","Total",625,255,5,250,177,59,156,26,130
"2011","Havant 013D","E01022927","Total",719,333,10,323,160,50,222,21,201
"2011","Havant 013E","E01022928","Total",815,397,5,392,149,42,224,10,214
"2011","Havant 013F","E01022929","Total",857,388,12,376,126,47,231,16,215
"2011","Havant 014A","E01022953","Total",1030,424,38,386,218,104,313,32,281
"2011","Havant 014B","E01022954","Total",693,273,6,267,136,38,155,9,146
"2011","Havant 014C","E01022955","Total",615,266,2,264,128,37,165,23,142
"2011","Havant 014D","E01022956","Total",496,130,24,106,177,70,106,25,81
"2011","Havant 014E","E01022957","Total",522,196,19,177,166,48,145,28,117
"2011","Havant 014F","E01022958","Total",613,206,5,201,146,43,138,16,122
"2011","Havant 015A","E01022937","Total",585,217,21,196,162,40,169,24,145
"2011","Havant 015B","E01022943","Total",650,335,2,333,100,21,166,13,153
"2011","Havant 015C","E01022944","Total",536,168,5,163,114,22,116,14,102
"2011","Havant 015D","E01022946","Total",775,320,14,306,174,55,209,25,184
"2011","Havant 016A","E01022940","Total",729,295,20,275,164,46,208,36,172
"2011","Havant 016B","E01022942","Total",830,453,54,399,145,52,284,25,259
"2011","Havant 016C","E01022945","Total",1049,486,30,456,216,77,300,36,264
"2011","Havant 017A","E01022936","Total",776,314,27,287,129,55,233,24,209
"2011","Havant 017B","E01022938","Total",638,308,15,293,118,33,180,14,166
"2011","Havant 017C","E01022939","Total",697,312,17,295,139,50,206,30,176
"2011","Havant 017D","E01022941","Total",694,277,13,264,128,35,174,20,154
"2011","Havant 018A","E01022899","Total",503,159,35,124,190,67,144,38,106
"2011","Havant 018B","E01022907","Total",632,234,7,227,147,52,199,26,173
"2011","Havant 018C","E01022909","Total",628,202,13,189,163,49,145,27,118
"2011","Havant 018D","E01022910","Total",654,212,32,180,157,68,184,27,157
"2011","Havant 018E","E01022911","Total",638,230,8,222,143,49,177,20,157
"2011","Havant 018F","E01032605","Total",547,200,11,189,141,52,123,16,107
"2011","Havant 019A","E01022919","Total",644,218,23,195,206,70,156,36,120
"2011","Havant 019B","E01022933","Total",711,296,82,214,263,119,205,51,154
"2011","Havant 019C","E01022934","Total",798,299,80,219,311,136,227,66,161
"2011","Havant 019D","E01032618","Total",618,205,23,182,188,58,146,28,118
"2011","Havant 020A","E01022918","Total",667,282,17,265,160,51,193,24,169
"2011","Havant 020B","E01022920","Total",657,226,14,212,163,65,167,23,144
"2011","Havant 020C","E01022921","Total",651,204,7,197,183,58,151,25,126
"2011","Havant 020D","E01032617","Total",661,275,11,264,163,45,177,21,156
"2011","New Forest 001A","E01023011","Total",614,171,12,159,163,51,139,26,113
"2011","New Forest 001B","E01023012","Total",593,178,6,172,141,29,145,15,130
"2011","New Forest 001C","E01023021","Total",625,220,5,215,161,50,127,19,108
"2011","New Forest 001D","E01023022","Total",888,347,22,325,202,73,247,26,221
"2011","New Forest 001E","E01023023","Total",754,305,11,294,194,68,223,34,189
"2011","New Forest 001F","E01023024","Total",629,209,6,203,173,63,140,15,125
"2011","New Forest 001G","E01023025","Total",588,203,4,199,124,30,153,21,132
"2011","New Forest 002A","E01023076","Total",637,267,5,262,117,35,169,22,147
"2011","New Forest 002B","E01023082","Total",617,134,18,116,200,76,117,30,87
"2011","New Forest 002C","E01023083","Total",660,238,28,210,199,82,203,33,170
"2011","New Forest 002D","E01023088","Total",636,215,32,183,196,67,214,49,165
"2011","New Forest 003A","E01023073","Total",518,70,12,58,196,47,75,27,48
"2011","New Forest 003B","E01023080","Total",526,149,20,129,184,73,128,34,94
"2011","New Forest 003C","E01023081","Total",749,169,28,141,304,127,161,53,108
"2011","New Forest 003D","E01023089","Total",716,196,13,183,169,69,152,21,131
"2011","New Forest 003E","E01023090","Total",823,162,25,137,275,119,151,51,100
"2011","New Forest 004A","E01023074","Total",649,270,4,266,144,61,199,20,179
"2011","New Forest 004B","E01023077","Total",712,245,41,204,201,98,184,41,143
"2011","New Forest 004C","E01023078","Total",633,276,6,270,114,40,174,12,162
"2011","New Forest 004D","E01023079","Total",693,198,23,175,228,85,160,38,122
"2011","New Forest 004E","E01023085","Total",635,204,31,173,225,85,189,41,148
"2011","New Forest 005A","E01023072","Total",547,99,13,86,174,76,88,19,69
"2011","New Forest 005B","E01023075","Total",486,143,18,125,153,58,100,24,76
"2011","New Forest 005C","E01023084","Total",627,200,10,190,187,65,154,22,132
"2011","New Forest 005D","E01023086","Total",640,237,18,219,185,58,192,31,161
"2011","New Forest 005E","E01023087","Total",624,72,9,63,215,92,84,22,62
"2011","New Forest 006A","E01022977","Total",609,208,2,206,149,44,137,16,121
"2011","New Forest 006B","E01022978","Total",633,208,11,197,152,60,145,18,127
"2011","New Forest 006C","E01022979","Total",498,174,5,169,96,27,129,13,116
"2011","New Forest 006D","E01022980","Total",549,175,6,169,127,35,118,8,110
"2011","New Forest 007A","E01022992","Total",484,153,2,151,104,29,117,18,99
"2011","New Forest 007B","E01022993","Total",564,172,7,165,123,33,126,12,114
"2011","New Forest 007C","E01023045","Total",716,267,8,259,153,58,182,18,164
"2011","New Forest 007D","E01023046","Total",658,246,10,236,128,49,177,15,162
"2011","New Forest 008A","E01023007","Total",507,177,6,171,107,36,146,17,129
"2011","New Forest 008B","E01023010","Total",655,143,33,110,245,120,157,53,104
"2011","New Forest 008C","E01023047","Total",546,99,11,88,183,65,97,21,76
"2011","New Forest 008D","E01023048","Total",525,148,19,129,170,52,120,30,90
"2011","New Forest 008E","E01023049","Total",682,98,13,85,230,111,112,23,89
"2011","New Forest 008F","E01023050","Total",693,127,29,98,283,143,148,54,94
"2011","New Forest 009A","E01023008","Total",859,474,14,460,102,41,260,12,248
"2011","New Forest 009B","E01023009","Total",648,133,4,129,189,70,114,22,92
"2011","New Forest 009C","E01023038","Total",634,250,12,238,139,47,164,16,148
"2011","New Forest 009D","E01023039","Total",666,296,18,278,148,42,204,28,176
"2011","New Forest 009E","E01023040","Total",673,311,10,301,134,51,169,14,155
"2011","New Forest 010A","E01023026","Total",476,152,6,146,111,19,111,10,101
"2011","New Forest 010B","E01023062","Total",564,149,7,142,191,56,123,28,95
"2011","New Forest 010C","E01023064","Total",536,134,13,121,192,61,95,25,70
"2011","New Forest 010D","E01023066","Total",695,276,10,266,175,52,199,27,172
"2011","New Forest 010E","E01023067","Total",616,215,4,211,177,62,146,24,122
"2011","New Forest 011A","E01023003","Total",779,360,15,345,160,50,235,25,210
"2011","New Forest 011B","E01023004","Total",709,213,17,196,221,78,171,38,133
"2011","New Forest 011C","E01023005","Total",627,220,4,216,142,45,143,21,122
"2011","New Forest 011D","E01023006","Total",501,160,53,107,219,76,151,57,94
"2011","New Forest 011E","E01023028","Total",859,279,31,248,285,126,222,40,182
"2011","New Forest 011F","E01023037","Total",931,419,38,381,201,78,287,31,256
"2011","New Forest 012A","E01023065","Total",680,281,11,270,185,63,218,34,184
"2011","New Forest 012B","E01023068","Total",525,177,24,153,172,61,176,38,138
"2011","New Forest 012C","E01023069","Total",669,214,10,204,180,50,160,21,139
"2011","New Forest 012D","E01023070","Total",925,414,22,392,185,62,295,29,266
"2011","New Forest 012E","E01023071","Total",646,164,8,156,158,66,124,12,112
"2011","New Forest 013A","E01023029","Total",621,241,87,154,283,106,201,59,142
"2011","New Forest 013B","E01023030","Total",507,101,11,90,182,65,118,26,92
"2011","New Forest 013C","E01023032","Total",549,198,11,187,133,45,137,22,115
"2011","New Forest 013D","E01023033","Total",524,197,25,172,163,73,153,21,132
"2011","New Forest 014A","E01023013","Total",650,249,16,233,146,60,170,18,152
"2011","New Forest 014B","E01023014","Total",720,285,23,262,172,56,197,22,175
"2011","New Forest 014C","E01023015","Total",599,198,11,187,158,58,159,25,134
"2011","New Forest 014D","E01023016","Total",614,240,0,240,111,31,154,15,139
"2011","New Forest 014E","E01023027","Total",592,207,23,184,166,65,169,31,138
"2011","New Forest 014F","E01023031","Total",548,191,17,174,129,44,134,24,110
"2011","New Forest 015A","E01022989","Total",719,274,11,263,198,57,194,22,172
"2011","New Forest 015B","E01022991","Total",891,330,6,324,171,51,227,19,208
"2011","New Forest 015C","E01022998","Total",680,290,15,275,157,46,146,20,126
"2011","New Forest 015D","E01023000","Total",791,343,15,328,180,62,224,23,201
"2011","New Forest 016A","E01022994","Total",670,255,8,247,159,55,157,18,139
"2011","New Forest 016B","E01022995","Total",589,203,7,196,158,45,144,21,123
"2011","New Forest 016C","E01022996","Total",515,192,10,182,115,46,145,21,124
"2011","New Forest 016D","E01022997","Total",585,225,14,211,138,42,137,20,117
"2011","New Forest 016E","E01023063","Total",466,133,8,125,156,49,112,15,97
"2011","New Forest 017A","E01022990","Total",651,247,20,227,150,47,158,21,137
"2011","New Forest 017B","E01022999","Total",906,293,11,282,200,62,189,22,167
"2011","New Forest 017C","E01023041","Total",743,342,6,336,125,47,151,11,140
"2011","New Forest 017D","E01023042","Total",893,464,9,455,92,49,261,5,256
"2011","New Forest 017E","E01023043","Total",835,351,19,332,190,67,224,22,202
"2011","New Forest 018A","E01022984","Total",654,312,6,306,111,27,190,20,170
"2011","New Forest 018B","E01022985","Total",528,170,11,159,141,49,116,17,99
"2011","New Forest 018C","E01023020","Total",624,280,9,271,131,43,178,28,150
"2011","New Forest 018D","E01023034","Total",785,333,10,323,178,68,228,29,199
"2011","New Forest 018E","E01023035","Total",732,260,9,251,196,65,178,25,153
"2011","New Forest 018F","E01023036","Total",936,485,9,476,158,40,255,21,234
"2011","New Forest 019A","E01023001","Total",861,261,17,244,209,96,161,24,137
"2011","New Forest 019B","E01023002","Total",777,289,36,253,235,85,222,32,190
"2011","New Forest 019C","E01023058","Total",645,290,51,239,213,80,211,58,153
"2011","New Forest 019D","E01023060","Total",590,219,10,209,141,44,145,18,127
"2011","New Forest 019E","E01023061","Total",667,241,20,221,174,66,205,34,171
"2011","New Forest 020A","E01023017","Total",810,336,37,299,256,88,228,48,180
"2011","New Forest 020B","E01023018","Total",679,360,36,324,154,65,241,34,207
"2011","New Forest 020C","E01023019","Total",668,229,35,194,205,89,205,34,171
"2011","New Forest 020D","E01023055","Total",511,203,38,165,187,59,188,47,141
"2011","New Forest 021A","E01022986","Total",642,293,10,283,122,37,190,19,171
"2011","New Forest 021B","E01022988","Total",676,246,28,218,165,65,211,36,175
"2011","New Forest 021C","E01023054","Total",849,449,13,436,140,60,284,18,266
"2011","New Forest 021D","E01023056","Total",811,506,28,478,138,76,290,20,270
"2011","New Forest 021E","E01023057","Total",903,477,18,459,127,50,329,26,303
"2011","New Forest 022A","E01022981","Total",909,510,6,504,124,29,266,10,256
"2011","New Forest 022B","E01022982","Total",935,519,8,511,99,29,293,16,277
"2011","New Forest 022C","E01022983","Total",808,435,9,426,114,31,222,16,206
"2011","New Forest 022D","E01022987","Total",909,512,5,507,110,36,243,13,230
"2011","New Forest 023A","E01023044","Total",535,318,1,317,66,18,159,6,153
"2011","New Forest 023B","E01023051","Total",658,266,6,260,150,42,177,17,160
"2011","New Forest 023C","E01023052","Total",890,535,6,529,85,27,281,8,273
"2011","New Forest 023D","E01023053","Total",859,497,4,493,101,25,226,9,217
"2011","New Forest 023E","E01023059","Total",774,376,9,367,148,42,237,20,217
"2011","Rushmoor 001A","E01023099","Total",609,193,46,147,233,99,135,35,100
"2011","Rushmoor 001B","E01023104","Total",601,160,23,137,238,92,154,39,115
"2011","Rushmoor 001C","E01023106","Total",567,156,31,125,212,74,125,30,95
"2011","Rushmoor 001D","E01023121","Total",770,227,34,193,278,107,178,52,126
"2011","Rushmoor 002A","E01023105","Total",602,209,40,169,221,70,190,45,145
"2011","Rushmoor 002B","E01023119","Total",466,142,54,88,214,78,131,42,89
"2011","Rushmoor 002C","E01023120","Total",608,150,39,111,255,104,129,43,86
"2011","Rushmoor 002D","E01023122","Total",500,102,36,66,222,82,121,53,68
"2011","Rushmoor 002E","E01023146","Total",472,108,30,78,203,69,118,39,79
"2011","Rushmoor 003A","E01023100","Total",484,75,12,63,200,92,71,22,49
"2011","Rushmoor 003B","E01023101","Total",487,110,5,105,144,53,95,22,73
"2011","Rushmoor 003C","E01023102","Total",541,123,8,115,162,69,96,17,79
"2011","Rushmoor 003D","E01023134","Total",703,95,7,88,232,76,129,33,96
"2011","Rushmoor 003E","E01023147","Total",565,151,18,133,191,53,133,25,108
"2011","Rushmoor 004A","E01023096","Total",910,225,22,203,259,127,150,21,129
"2011","Rushmoor 004B","E01023097","Total",570,152,2,150,162,49,111,22,89
"2011","Rushmoor 004C","E01023103","Total",631,130,8,122,212,86,88,19,69
"2011","Rushmoor 004D","E01023111","Total",756,212,6,206,200,71,172,23,149
"2011","Rushmoor 004E","E01023112","Total",467,67,3,64,190,67,81,22,59
"2011","Rushmoor 005A","E01023092","Total",569,66,6,60,225,88,75,21,54
"2011","Rushmoor 005B","E01023093","Total",524,92,3,89,190,72,93,22,71
"2011","Rushmoor 005C","E01023132","Total",614,166,9,157,199,76,152,23,129
"2011","Rushmoor 005D","E01023133","Total",525,74,14,60,195,89,55,14,41
"2011","Rushmoor 005E","E01023135","Total",945,210,40,170,353,166,168,35,133
"2011","Rushmoor 006A","E01023091","Total",670,217,70,147,270,134,172,37,135
"2011","Rushmoor 006B","E01023094","Total",558,135,12,123,146,62,113,19,94
"2011","Rushmoor 006C","E01023095","Total",743,189,22,167,229,107,193,38,155
"2011","Rushmoor 006D","E01023098","Total",669,159,16,143,188,70,127,26,101
"2011","Rushmoor 006E","E01023148","Total",602,160,8,152,149,55,152,25,127
"2011","Rushmoor 006F","E01023149","Total",543,195,7,188,133,39,130,14,116
"2011","Rushmoor 007A","E01023113","Total",668,178,21,157,185,81,131,22,109
"2011","Rushmoor 007B","E01023114","Total",547,83,10,73,216,92,95,26,69
"2011","Rushmoor 007C","E01023136","Total",657,83,17,66,261,120,94,34,60
"2011","Rushmoor 007D","E01023137","Total",520,104,12,92,177,84,96,21,75
"2011","Rushmoor 007E","E01023138","Total",654,183,13,170,146,62,152,20,132
"2011","Rushmoor 007F","E01023139","Total",531,164,17,147,162,76,121,24,97
"2011","Rushmoor 007G","E01023140","Total",603,114,23,91,285,190,112,44,68
"2011","Rushmoor 008A","E01023141","Total",630,49,14,35,389,263,79,44,35
"2011","Rushmoor 008B","E01023142","Total",853,161,28,133,280,189,150,29,121
"2011","Rushmoor 008C","E01023143","Total",699,103,19,84,374,215,124,52,72
"2011","Rushmoor 008D","E01023144","Total",674,145,31,114,242,105,143,38,105
"2011","Rushmoor 009A","E01023118","Total",675,138,20,118,233,107,167,37,130
"2011","Rushmoor 009B","E01023124","Total",486,82,11,71,165,64,88,18,70
"2011","Rushmoor 009C","E01023125","Total",920,149,31,118,340,172,169,48,121
"2011","Rushmoor 009F","E01032858","Total",864,220,70,150,334,146,194,53,141
"2011","Rushmoor 010A","E01023128","Total",607,206,16,190,169,68,187,17,170
"2011","Rushmoor 010B","E01023129","Total",531,107,15,92,151,55,120,26,94
"2011","Rushmoor 010C","E01023130","Total",549,156,7,149,150,44,121,16,105
"2011","Rushmoor 010D","E01023131","Total",585,224,12,212,144,41,166,24,142
"2011","Rushmoor 010E","E01023145","Total",938,219,26,193,235,119,211,33,178
"2011","Rushmoor 011A","E01023109","Total",592,127,12,115,186,79,117,23,94
"2011","Rushmoor 011B","E01023115","Total",464,84,4,80,175,55,79,23,56
"2011","Rushmoor 011C","E01023116","Total",665,110,20,90,235,86,123,34,89
"2011","Rushmoor 011D","E01023117","Total",674,130,9,121,226,75,135,23,112
"2011","Rushmoor 012A","E01023107","Total",611,242,28,214,177,74,215,41,174
"2011","Rushmoor 012B","E01023108","Total",592,237,22,215,158,65,212,32,180
"2011","Rushmoor 012C","E01023110","Total",705,185,29,156,247,87,177,42,135
"2011","Rushmoor 012D","E01023123","Total",579,111,14,97,190,80,136,36,100
"2011","Test Valley 001A","E01023165","Total",867,227,13,214,249,84,163,24,139
"2011","Test Valley 001B","E01023169","Total",839,278,4,274,197,67,221,24,197
"2011","Test Valley 001C","E01023181","Total",513,57,11,46,228,77,81,34,47
"2011","Test Valley 001D","E01023182","Total",642,102,13,89,231,101,116,27,89
"2011","Test Valley 002A","E01023153","Total",742,189,47,142,231,115,163,33,130
"2011","Test Valley 002B","E01023154","Total",636,190,62,128,270,117,160,50,110
"2011","Test Valley 002C","E01023156","Total",470,130,67,63,255,131,112,47,65
"2011","Test Valley 002D","E01023157","Total",534,164,52,112,221,106,141,45,96
"2011","Test Valley 002E","E01023205","Total",455,100,44,56,229,89,92,35,57
"2011","Test Valley 003A","E01023155","Total",1086,285,56,229,384,182,271,59,212
"2011","Test Valley 003B","E01023201","Total",625,197,33,164,201,83,156,34,122
"2011","Test Valley 003C","E01023202","Total",971,390,29,361,166,83,331,28,303
"2011","Test Valley 003D","E01023215","Total",669,215,12,203,184,68,158,21,137
"2011","Test Valley 003E","E01023219","Total",617,205,17,188,157,52,171,23,148
"2011","Test Valley 004A","E01023179","Total",706,156,25,131,266,86,165,47,118
"2011","Test Valley 004B","E01023183","Total",583,185,24,161,190,74,143,28,115
"2011","Test Valley 004C","E01023190","Total",561,198,5,193,114,42,152,9,143
"2011","Test Valley 004D","E01023203","Total",668,190,12,178,160,58,178,33,145
"2011","Test Valley 004E","E01023204","Total",741,209,31,178,220,105,189,30,159
"2011","Test Valley 005B","E01023180","Total",701,233,11,222,190,63,165,22,143
"2011","Test Valley 005C","E01023186","Total",721,192,16,176,229,84,156,25,131
"2011","Test Valley 005D","E01023189","Total",609,128,5,123,216,105,114,27,87
"2011","Test Valley 005E","E01023196","Total",692,192,10,182,199,70,180,28,152
"2011","Test Valley 005F","E01032870","Total",732,134,7,127,269,102,125,28,97
"2011","Test Valley 005G","E01032871","Total",637,206,14,192,185,64,152,28,124
"2011","Test Valley 006A","E01023187","Total",632,155,6,149,168,70,124,21,103
"2011","Test Valley 006B","E01023188","Total",515,100,2,98,190,64,86,31,55
"2011","Test Valley 006C","E01023216","Total",847,252,19,233,213,90,210,25,185
"2011","Test Valley 006D","E01023217","Total",670,185,6,179,181,69,131,17,114
"2011","Test Valley 006E","E01023218","Total",627,175,9,166,179,62,112,17,95
"2011","Test Valley 007A","E01023159","Total",931,267,11,256,226,76,219,21,198
"2011","Test Valley 007B","E01023195","Total",722,114,5,109,297,149,125,35,90
"2011","Test Valley 007C","E01023197","Total",584,120,9,111,214,90,109,26,83
"2011","Test Valley 007D","E01023198","Total",619,181,5,176,145,50,141,21,120
"2011","Test Valley 008A","E01023160","Total",600,211,6,205,147,42,128,13,115
"2011","Test Valley 008B","E01023168","Total",644,222,8,214,124,35,135,12,123
"2011","Test Valley 008C","E01023178","Total",917,237,8,229,259,112,208,30,178
"2011","Test Valley 009A","E01023166","Total",646,208,11,197,161,47,163,23,140
"2011","Test Valley 009B","E01023167","Total",697,264,9,255,157,53,174,22,152
"2011","Test Valley 009C","E01023177","Total",883,248,17,231,252,93,185,28,157
"2011","Test Valley 009D","E01023184","Total",516,114,10,104,166,40,95,16,79
"2011","Test Valley 009E","E01023185","Total",513,166,6,160,147,54,132,18,114
"2011","Test Valley 010A","E01023174","Total",721,171,13,158,226,76,143,29,114
"2011","Test Valley 010B","E01023175","Total",701,245,14,231,189,57,146,23,123
"2011","Test Valley 010C","E01023176","Total",719,266,7,259,150,65,204,23,181
"2011","Test Valley 010D","E01023207","Total",645,221,7,214,169,58,142,19,123
"2011","Test Valley 010E","E01023208","Total",484,130,13,117,145,44,125,23,102
"2011","Test Valley 010F","E01023209","Total",544,128,5,123,172,59,94,14,80
"2011","Test Valley 011A","E01023150","Total",727,279,23,256,167,61,206,27,179
"2011","Test Valley 011B","E01023151","Total",782,439,42,397,152,82,320,35,285
"2011","Test Valley 011C","E01023152","Total",858,433,13,420,129,39,273,21,252
"2011","Test Valley 011D","E01023206","Total",497,190,10,180,132,35,133,26,107
"2011","Test Valley 012A","E01023158","Total",916,315,6,309,256,66,221,28,193
"2011","Test Valley 012B","E01023191","Total",778,174,8,166,219,84,152,25,127
"2011","Test Valley 012C","E01023192","Total",822,329,39,290,252,120,238,44,194
"2011","Test Valley 012D","E01023193","Total",660,251,11,240,166,55,185,31,154
"2011","Test Valley 012E","E01023194","Total",642,255,7,248,149,42,153,18,135
"2011","Test Valley 012F","E01023200","Total",598,141,9,132,178,60,112,26,86
"2011","Test Valley 013A","E01023162","Total",669,195,5,190,182,48,149,27,122
"2011","Test Valley 013B","E01023163","Total",663,197,8,189,168,37,127,23,104
"2011","Test Valley 013C","E01023164","Total",654,220,14,206,163,46,174,24,150
"2011","Test Valley 013D","E01023199","Total",634,172,13,159,174,59,158,26,132
"2011","Test Valley 014A","E01023210","Total",532,72,2,70,245,77,67,17,50
"2011","Test Valley 014B","E01023211","Total",679,61,11,50,365,139,80,31,49
"2011","Test Valley 014C","E01023212","Total",592,137,3,134,194,63,112,16,96
"2011","Test Valley 014D","E01023213","Total",498,98,12,86,205,69,73,19,54
"2011","Test Valley 014E","E01023214","Total",530,98,3,95,183,69,82,17,65
"2011","Test Valley 015A","E01023170","Total",703,189,21,168,237,91,158,29,129
"2011","Test Valley 015B","E01023171","Total",595,152,5,147,146,49,124,17,107
"2011","Test Valley 015C","E01023172","Total",615,187,2,185,155,45,143,16,127
"2011","Test Valley 015D","E01023173","Total",588,154,4,150,159,33,105,20,85
"2011","Winchester 001A","E01023286","Total",591,170,9,161,185,74,157,24,133
"2011","Winchester 001B","E01023287","Total",1068,236,8,228,372,133,205,42,163
"2011","Winchester 001C","E01023288","Total",577,134,8,126,162,76,102,13,89
"2011","Winchester 002A","E01023236","Total",804,234,7,227,207,80,166,25,141
"2011","Winchester 002B","E01023237","Total",563,183,29,154,163,77,165,35,130
"2011","Winchester 002C","E01023238","Total",587,150,10,140,187,73,109,18,91
"2011","Winchester 002D","E01023239","Total",654,163,4,159,202,76,123,27,96
"2011","Winchester 003A","E01023240","Total",879,325,13,312,271,105,185,34,151
"2011","Winchester 003B","E01023241","Total",518,212,4,208,128,23,132,18,114
"2011","Winchester 003C","E01023248","Total",685,271,5,266,195,65,162,25,137
"2011","Winchester 003D","E01023253","Total",709,295,20,275,176,78,181,22,159
"2011","Winchester 003E","E01023274","Total",626,210,6,204,178,54,153,20,133
"2011","Winchester 004A","E01023225","Total",830,212,11,201,275,79,180,35,145
"2011","Winchester 004B","E01023278","Total",727,273,8,265,191,69,187,24,163
"2011","Winchester 004C","E01023279","Total",613,184,6,178,180,53,123,16,107
"2011","Winchester 004D","E01023280","Total",588,158,3,155,188,59,130,20,110
"2011","Winchester 004E","E01023281","Total",833,367,13,354,182,70,222,19,203
"2011","Winchester 005A","E01023247","Total",631,238,2,236,163,58,163,19,144
"2011","Winchester 005B","E01023249","Total",524,210,6,204,140,42,166,28,138
"2011","Winchester 005C","E01023250","Total",681,251,32,219,211,97,221,41,180
"2011","Winchester 005D","E01023268","Total",485,96,3,93,182,79,88,20,68
"2011","Winchester 005E","E01023269","Total",651,142,8,134,208,78,99,25,74
"2011","Winchester 005F","E01023270","Total",456,94,6,88,170,81,80,16,64
"2011","Winchester 006A","E01023251","Total",635,319,9,310,94,48,232,13,219
"2011","Winchester 006B","E01023255","Total",700,195,23,172,179,88,188,28,160
"2011","Winchester 006C","E01023256","Total",620,218,30,188,173,80,177,24,153
"2011","Winchester 006D","E01023257","Total",688,203,24,179,174,87,184,28,156
"2011","Winchester 006E","E01023258","Total",524,152,24,128,154,70,130,25,105
"2011","Winchester 007A","E01023252","Total",961,328,16,312,126,62,264,16,248
"2011","Winchester 007B","E01023254","Total",831,228,13,215,232,114,167,18,149
"2011","Winchester 007C","E01023263","Total",596,198,7,191,115,47,136,12,124
"2011","Winchester 007D","E01023264","Total",680,224,2,222,122,53,149,13,136
"2011","Winchester 007E","E01023265","Total",816,270,6,264,190,83,189,21,168
"2011","Winchester 007F","E01023267","Total",534,100,6,94,148,85,74,12,62
"2011","Winchester 008A","E01023260","Total",493,168,36,132,155,72,147,30,117
"2011","Winchester 008B","E01023261","Total",616,226,25,201,146,47,193,25,168
"2011","Winchester 008C","E01023262","Total",499,123,27,96,142,61,110,20,90
"2011","Winchester 008D","E01023266","Total",569,187,18,169,165,69,121,22,99
"2011","Winchester 009A","E01023229","Total",776,235,7,228,259,80,148,26,122
"2011","Winchester 009B","E01023242","Total",491,98,4,94,145,52,80,14,66
"2011","Winchester 009C","E01023243","Total",617,103,6,97,149,76,100,23,77
"2011","Winchester 009D","E01023244","Total",655,281,9,272,159,43,173,22,151
"2011","Winchester 009E","E01023259","Total",553,186,14,172,185,55,134,25,109
"2011","Winchester 010A","E01023226","Total",638,192,4,188,203,85,146,26,120
"2011","Winchester 010B","E01023227","Total",796,221,14,207,231,89,187,26,161
"2011","Winchester 010C","E01023228","Total",869,305,6,299,240,90,209,25,184
"2011","Winchester 010D","E01023230","Total",807,208,4,204,248,82,129,26,103
"2011","Winchester 010E","E01023246","Total",575,130,7,123,169,52,118,15,103
"2011","Winchester 011A","E01023235","Total",841,271,10,261,226,69,169,27,142
"2011","Winchester 011B","E01023275","Total",580,194,9,185,183,45,142,19,123
"2011","Winchester 011C","E01023276","Total",585,165,7,158,207,54,97,19,78
"2011","Winchester 011D","E01023277","Total",494,123,2,121,132,30,103,12,91
"2011","Winchester 011E","E01023282","Total",814,250,13,237,203,62,165,20,145
"2011","Winchester 012A","E01023220","Total",838,201,19,182,265,104,162,35,127
"2011","Winchester 012B","E01023221","Total",819,330,12,318,174,59,245,24,221
"2011","Winchester 012C","E01023222","Total",631,186,4,182,155,47,129,14,115
"2011","Winchester 012D","E01023223","Total",599,195,19,176,197,64,144,35,109
"2011","Winchester 012E","E01023272","Total",520,137,11,126,159,47,96,15,81
"2011","Winchester 012F","E01023273","Total",579,156,6,150,175,51,106,19,87
"2011","Winchester 013A","E01023245","Total",917,240,6,234,257,77,208,43,165
"2011","Winchester 013B","E01023271","Total",454,137,7,130,131,42,118,20,98
"2011","Winchester 013D","E01023284","Total",1170,252,31,221,330,152,202,44,158
"2011","Winchester 013E","E01023285","Total",696,295,16,279,162,62,225,23,202
"2011","Winchester 013F","E01032859","Total",645,77,13,64,302,118,67,26,41
"2011","Winchester 013G","E01032860","Total",635,58,15,43,217,118,64,23,41
"2011","Winchester 014A","E01023224","Total",502,126,10,116,175,68,86,20,66
"2011","Winchester 014B","E01023231","Total",695,197,4,193,204,77,128,24,104
"2011","Winchester 014C","E01023232","Total",737,207,9,198,211,81,177,31,146
"2011","Winchester 014D","E01023233","Total",630,211,5,206,194,59,149,22,127
"2011","Winchester 014E","E01023234","Total",665,221,10,211,199,79,168,24,144
"2011","Ashford 001B","E01023987","Total",453,159,5,154,111,49,113,19,94
"2011","Ashford 001C","E01023988","Total",558,154,7,147,158,55,111,19,92
"2011","Ashford 001D","E01024040","Total",548,246,15,231,131,64,160,22,138
"2011","Ashford 001E","E01024041","Total",507,205,10,195,132,56,121,15,106
"2011","Ashford 001F","E01032810","Total",596,135,34,101,255,109,118,32,86
"2011","Ashford 001G","E01032812","Total",669,152,9,143,256,100,126,30,96
"2011","Ashford 002A","E01023985","Total",508,217,4,213,95,32,170,17,153
"2011","Ashford 002B","E01023986","Total",563,214,13,201,128,50,160,19,141
"2011","Ashford 002C","E01023989","Total",454,133,4,129,141,41,97,22,75
"2011","Ashford 002D","E01023990","Total",504,179,24,155,143,51,131,28,103
"2011","Ashford 002E","E01024033","Total",679,177,18,159,199,75,152,26,126
"2011","Ashford 002F","E01024035","Total",453,147,6,141,120,42,103,17,86
"2011","Ashford 003A","E01023983","Total",606,241,8,233,135,47,163,13,150
"2011","Ashford 003B","E01023999","Total",904,301,13,288,236,84,202,32,170
"2011","Ashford 003D","E01032811","Total",596,100,36,64,287,116,107,43,64
"2011","Ashford 003E","E01032822","Total",563,197,8,189,184,64,160,31,129
"2011","Ashford 004A","E01023980","Total",516,200,23,177,126,47,147,21,126
"2011","Ashford 004B","E01023981","Total",507,171,21,150,154,56,150,27,123
"2011","Ashford 004C","E01023984","Total",493,183,55,128,186,92,131,36,95
"2011","Ashford 004E","E01023992","Total",624,208,32,176,195,71,175,37,138
"2011","Ashford 004F","E01023993","Total",528,84,11,73,226,76,94,23,71
"2011","Ashford 004G","E01024021","Total",614,185,17,168,155,58,132,19,113
"2011","Ashford 004H","E01024022","Total",610,247,24,223,167,53,150,21,129
"2011","Ashford 004I","E01032820","Total",625,99,26,73,247,122,79,25,54
"2011","Ashford 004J","E01032821","Total",619,116,13,103,277,100,109,39,70
"2011","Ashford 005A","E01023973","Total",712,299,69,230,238,123,240,42,198
"2011","Ashford 005B","E01024002","Total",566,140,32,108,215,101,116,31,85
"2011","Ashford 005C","E01024023","Total",994,263,39,224,382,164,216,43,173
"2011","Ashford 005D","E01024027","Total",713,217,32,185,187,92,170,27,143
"2011","Ashford 005E","E01024029","Total",937,308,39,269,315,136,265,58,207
"2011","Ashford 006A","E01023972","Total",508,174,28,146,179,56,176,36,140
"2011","Ashford 006B","E01023995","Total",479,133,2,131,138,43,100,19,81
"2011","Ashford 006C","E01023996","Total",481,84,9,75,205,75,74,25,49
"2011","Ashford 006D","E01024003","Total",757,292,16,276,164,50,228,22,206
"2011","Ashford 006E","E01024004","Total",705,200,10,190,195,60,131,27,104
"2011","Ashford 006F","E01024005","Total",645,176,19,157,196,81,159,31,128
"2011","Ashford 007A","E01023974","Total",520,204,42,162,179,74,157,33,124
"2011","Ashford 007B","E01023975","Total",614,219,49,170,224,88,193,44,149
"2011","Ashford 007C","E01023977","Total",530,152,19,133,141,61,130,27,103
"2011","Ashford 007D","E01024016","Total",655,135,20,115,169,86,105,15,90
"2011","Ashford 007E","E01024017","Total",779,228,26,202,234,100,172,36,136
"2011","Ashford 007F","E01024028","Total",697,246,83,163,281,139,174,39,135
"2011","Ashford 008A","E01023976","Total",672,297,34,263,204,78,248,35,213
"2011","Ashford 008B","E01024019","Total",484,149,57,92,226,98,126,44,82
"2011","Ashford 008C","E01024020","Total",634,210,121,89,370,196,160,73,87
"2011","Ashford 008E","E01032816","Total",672,81,16,65,268,112,105,29,76
"2011","Ashford 008F","E01032823","Total",607,139,44,95,246,120,135,43,92
"2011","Ashford 009A","E01024001","Total",650,245,43,202,199,83,207,40,167
"2011","Ashford 009B","E01024006","Total",445,66,8,58,225,65,83,35,48
"2011","Ashford 009D","E01024008","Total",720,99,25,74,351,138,116,46,70
"2011","Ashford 009F","E01032815","Total",420,123,35,88,167,83,111,29,82
"2011","Ashford 009G","E01032817","Total",449,75,35,40,203,98,76,23,53
"2011","Ashford 009H","E01032818","Total",553,75,28,47,292,138,70,34,36
"2011","Ashford 009I","E01032819","Total",648,86,32,54,325,145,81,37,44
"2011","Ashford 009J","E01032824","Total",588,127,19,108,213,100,138,37,101
"2011","Ashford 010A","E01024013","Total",709,243,16,227,197,54,183,36,147
"2011","Ashford 010B","E01024014","Total",650,176,14,162,180,67,157,30,127
"2011","Ashford 010C","E01024015","Total",651,195,4,191,167,49,149,20,129
"2011","Ashford 010D","E01024034","Total",942,256,20,236,294,117,219,58,161
"2011","Ashford 011A","E01023978","Total",510,183,7,176,131,29,125,21,104
"2011","Ashford 011B","E01023979","Total",534,164,17,147,179,72,121,26,95
"2011","Ashford 011C","E01024032","Total",623,179,16,163,188,54,140,23,117
"2011","Ashford 011D","E01024036","Total",526,151,5,146,146,47,117,21,96
"2011","Ashford 012B","E01024031","Total",629,214,9,205,146,37,160,20,140
"2011","Ashford 012C","E01024038","Total",818,360,15,345,192,57,221,20,201
"2011","Ashford 012D","E01024039","Total",577,177,8,169,173,49,149,30,119
"2011","Ashford 012E","E01032813","Total",730,89,20,69,314,180,96,40,56
"2011","Ashford 012F","E01032814","Total",740,195,18,177,256,114,163,35,128
"2011","Ashford 013A","E01024009","Total",482,174,4,170,95,24,94,16,78
"2011","Ashford 013B","E01024010","Total",577,209,14,195,130,36,157,9,148
"2011","Ashford 013C","E01024011","Total",497,166,11,155,147,44,122,22,100
"2011","Ashford 013D","E01024012","Total",453,151,13,138,129,31,116,17,99
"2011","Ashford 013E","E01024024","Total",1105,553,17,536,211,69,346,29,317
"2011","Ashford 013F","E01024025","Total",572,298,19,279,130,46,194,25,169
"2011","Ashford 014A","E01023997","Total",609,214,17,197,166,51,156,25,131
"2011","Ashford 014B","E01023998","Total",474,168,9,159,118,37,135,15,120
"2011","Ashford 014C","E01024026","Total",503,173,9,164,143,49,122,21,101
"2011","Ashford 014D","E01024037","Total",745,241,12,229,207,83,186,31,155
"2011","Canterbury 001A","E01024078","Total",920,400,62,338,214,107,315,50,265
"2011","Canterbury 001B","E01024080","Total",608,214,32,182,161,79,177,24,153
"2011","Canterbury 001C","E01024081","Total",789,398,31,367,151,65,307,32,275
"2011","Canterbury 001D","E01024082","Total",598,217,30,187,188,75,175,29,146
"2011","Canterbury 001E","E01024095","Total",607,190,15,175,178,57,165,30,135
"2011","Canterbury 002A","E01024094","Total",989,369,14,355,273,97,250,35,215
"2011","Canterbury 002B","E01024096","Total",756,352,20,332,175,57,232,26,206
"2011","Canterbury 002C","E01024097","Total",748,403,15,388,123,46,254,14,240
"2011","Canterbury 002D","E01024098","Total",659,291,11,280,147,36,185,15,170
"2011","Canterbury 003A","E01024064","Total",913,256,16,240,325,101,215,53,162
"2011","Canterbury 003B","E01024066","Total",647,264,59,205,225,76,216,44,172
"2011","Canterbury 003C","E01024079","Total",627,246,11,235,167,52,190,25,165
"2011","Canterbury 003D","E01024083","Total",654,346,42,304,167,58,242,32,210
"2011","Canterbury 003E","E01024118","Total",762,334,29,305,211,79,245,48,197
"2011","Canterbury 004A","E01024059","Total",752,411,33,378,164,59,295,37,258
"2011","Canterbury 004B","E01024065","Total",789,273,24,249,261,85,240,58,182
"2011","Canterbury 004C","E01024117","Total",633,290,14,276,124,42,221,19,202
"2011","Canterbury 004D","E01024119","Total",618,234,53,181,256,96,180,46,134
"2011","Canterbury 004E","E01024120","Total",766,375,20,355,136,44,260,33,227
"2011","Canterbury 005A","E01024056","Total",788,344,13,331,195,50,198,28,170
"2011","Canterbury 005B","E01024057","Total",802,372,10,362,151,45,247,20,227
"2011","Canterbury 005C","E01024058","Total",666,209,16,193,195,72,164,29,135
"2011","Canterbury 005D","E01024114","Total",786,326,5,321,182,64,231,28,203
"2011","Canterbury 005E","E01024115","Total",646,316,10,306,129,31,204,21,183
"2011","Canterbury 006A","E01024073","Total",808,260,30,230,248,107,195,32,163
"2011","Canterbury 006B","E01024074","Total",542,137,11,126,179,70,135,30,105
"2011","Canterbury 006C","E01024075","Total",685,266,21,245,169,68,185,24,161
"2011","Canterbury 006D","E01024076","Total",752,204,19,185,257,102,170,33,137
"2011","Canterbury 006E","E01024077","Total",565,142,24,118,215,76,124,40,84
"2011","Canterbury 007A","E01024055","Total",691,301,13,288,150,51,207,24,183
"2011","Canterbury 007B","E01024061","Total",658,344,76,268,199,76,272,55,217
"2011","Canterbury 007C","E01024063","Total",622,194,9,185,191,66,153,25,128
"2011","Canterbury 007D","E01024071","Total",706,228,32,196,244,96,198,41,157
"2011","Canterbury 007E","E01024116","Total",640,265,11,254,161,59,187,22,165
"2011","Canterbury 008A","E01024060","Total",663,224,14,210,183,70,176,28,148
"2011","Canterbury 008B","E01024069","Total",602,150,20,130,206,84,114,18,96
"2011","Canterbury 008C","E01024070","Total",694,224,11,213,162,61,182,28,154
"2011","Canterbury 008D","E01024072","Total",656,179,15,164,174,77,144,21,123
"2011","Canterbury 008E","E01024106","Total",688,284,16,268,172,54,191,27,164
"2011","Canterbury 009A","E01024062","Total",620,191,17,174,190,63,148,27,121
"2011","Canterbury 009B","E01024105","Total",696,300,11,289,134,45,209,15,194
"2011","Canterbury 009C","E01024107","Total",589,191,13,178,184,67,149,28,121
"2011","Canterbury 009D","E01024108","Total",532,247,43,204,143,55,178,39,139
"2011","Canterbury 009E","E01024109","Total",956,394,17,377,243,99,273,39,234
"2011","Canterbury 010A","E01024084","Total",469,166,26,140,143,47,128,29,99
"2011","Canterbury 010B","E01024085","Total",645,190,8,182,177,59,139,14,125
"2011","Canterbury 010C","E01024086","Total",795,207,53,154,303,125,171,52,119
"2011","Canterbury 010D","E01024087","Total",471,141,8,133,128,50,98,18,80
"2011","Canterbury 011A","E01024091","Total",495,167,51,116,194,91,137,47,90
"2011","Canterbury 011B","E01024110","Total",557,230,7,223,122,41,160,16,144
"2011","Canterbury 011C","E01024111","Total",613,230,47,183,213,87,183,48,135
"2011","Canterbury 011D","E01024112","Total",662,224,7,217,160,49,190,22,168
"2011","Canterbury 011E","E01024113","Total",538,199,16,183,128,46,142,19,123
"2011","Canterbury 012C","E01024067","Total",456,144,4,140,111,32,104,15,89
"2011","Canterbury 012D","E01024068","Total",590,214,12,202,148,48,139,19,120
"2011","Canterbury 012E","E01024123","Total",631,213,6,207,143,49,152,19,133
"2011","Canterbury 012F","E01032809","Total",958,374,22,352,234,74,258,38,220
"2011","Canterbury 013A","E01024099","Total",545,223,44,179,135,54,145,40,105
"2011","Canterbury 013B","E01024100","Total",511,202,28,174,115,42,123,15,108
"2011","Canterbury 013C","E01024101","Total",617,212,23,189,151,58,117,23,94
"2011","Canterbury 013D","E01024102","Total",657,241,14,227,136,55,146,15,131
"2011","Canterbury 013E","E01024103","Total",629,262,37,225,157,62,190,35,155
"2011","Canterbury 014A","E01024047","Total",495,114,44,70,284,153,88,39,49
"2011","Canterbury 014B","E01024049","Total",551,265,63,202,178,80,200,49,151
"2011","Canterbury 014C","E01024090","Total",751,304,61,243,163,82,191,31,160
"2011","Canterbury 014D","E01024092","Total",627,284,27,257,97,38,235,24,211
"2011","Canterbury 014E","E01024093","Total",734,355,45,310,133,67,252,26,226
"2011","Canterbury 016A","E01024044","Total",857,263,23,240,159,71,154,20,134
"2011","Canterbury 016B","E01024045","Total",661,253,16,237,150,60,161,14,147
"2011","Canterbury 016C","E01024046","Total",781,264,8,256,180,51,183,20,163
"2011","Canterbury 016D","E01024048","Total",535,202,35,167,122,51,134,23,111
"2011","Canterbury 016E","E01024131","Total",661,199,12,187,154,52,127,15,112
"2011","Canterbury 017A","E01024052","Total",910,225,41,184,338,140,206,56,150
"2011","Canterbury 017B","E01024053","Total",743,194,14,180,234,83,145,25,120
"2011","Canterbury 017C","E01024054","Total",732,196,15,181,216,65,163,31,132
"2011","Canterbury 017D","E01024127","Total",661,218,16,202,148,59,170,19,151
"2011","Canterbury 018A","E01024042","Total",535,165,20,145,163,54,138,24,114
"2011","Canterbury 018B","E01024043","Total",565,201,7,194,142,34,125,20,105
"2011","Canterbury 018C","E01024088","Total",621,211,14,197,191,56,165,31,134
"2011","Canterbury 018D","E01024089","Total",482,159,4,155,148,39,110,19,91
"2011","Canterbury 019A","E01024128","Total",631,206,66,140,225,111,148,42,106
"2011","Canterbury 019B","E01024129","Total",641,166,13,153,110,42,114,16,98
"2011","Canterbury 019C","E01024130","Total",1084,343,36,307,254,114,252,40,212
"2011","Canterbury 020A","E01024104","Total",956,322,20,302,134,61,170,19,151
"2011","Canterbury 020B","E01024121","Total",666,227,7,220,102,34,132,11,121
"2011","Canterbury 020C","E01024122","Total",619,283,22,261,123,53,231,21,210
"2011","Canterbury 020D","E01024124","Total",543,203,4,199,68,38,125,5,120
"2011","Canterbury 020E","E01024126","Total",532,217,56,161,194,74,155,46,109
"2011","Canterbury 020F","E01032807","Total",755,278,11,267,85,39,147,15,132
"2011","Canterbury 020G","E01032808","Total",715,267,46,221,140,68,132,24,108
"2011","Dartford 001A","E01024148","Total",849,451,80,371,235,105,300,46,254
"2011","Dartford 001B","E01024149","Total",1220,342,104,238,500,258,257,73,184
"2011","Dartford 001C","E01024154","Total",512,200,51,149,170,86,132,37,95
"2011","Dartford 001D","E01024155","Total",575,241,74,167,233,111,167,42,125
"2011","Dartford 002A","E01024140","Total",1175,120,34,86,430,242,145,58,87
"2011","Dartford 002B","E01024141","Total",633,156,19,137,197,80,120,18,102
"2011","Dartford 002C","E01024143","Total",999,110,24,86,304,164,100,25,75
"2011","Dartford 002D","E01024179","Total",1214,277,92,185,442,248,182,63,119
"2011","Dartford 003A","E01024180","Total",673,119,26,93,196,87,110,28,82
"2011","Dartford 003B","E01024181","Total",499,85,11,74,199,83,99,27,72
"2011","Dartford 003C","E01024182","Total",773,198,24,174,186,88,174,17,157
"2011","Dartford 003D","E01024183","Total",521,145,10,135,186,69,120,29,91
"2011","Dartford 003E","E01024184","Total",771,164,33,131,298,136,132,40,92
"2011","Dartford 003F","E01024185","Total",856,210,37,173,292,131,166,34,132
"2011","Dartford 004A","E01024142","Total",1249,216,55,161,375,192,173,46,127
"2011","Dartford 004B","E01024176","Total",787,301,50,251,222,108,224,24,200
"2011","Dartford 004C","E01024177","Total",599,262,77,185,219,89,172,45,127
"2011","Dartford 004D","E01024178","Total",623,179,48,131,245,91,162,43,119
"2011","Dartford 005A","E01024156","Total",784,201,22,179,195,87,155,30,125
"2011","Dartford 005B","E01024161","Total",800,143,32,111,285,118,160,44,116
"2011","Dartford 005C","E01024162","Total",818,145,27,118,178,105,128,14,114
"2011","Dartford 005D","E01024163","Total",728,184,21,163,250,104,161,24,137
"2011","Dartford 005E","E01024164","Total",801,148,22,126,273,147,141,34,107
"2011","Dartford 006A","E01024169","Total",629,224,25,199,206,93,199,45,154
"2011","Dartford 006B","E01024170","Total",668,252,52,200,240,100,190,47,143
"2011","Dartford 006C","E01024171","Total",620,149,19,130,197,92,143,41,102
"2011","Dartford 006D","E01024172","Total",980,190,35,155,223,122,165,31,134
"2011","Dartford 007A","E01024144","Total",544,137,6,131,200,64,120,28,92
"2011","Dartford 007B","E01024145","Total",594,139,11,128,221,73,138,33,105
"2011","Dartford 007C","E01024146","Total",538,152,3,149,186,53,103,26,77
"2011","Dartford 007D","E01024147","Total",653,187,6,181,219,80,137,27,110
"2011","Dartford 007E","E01024186","Total",514,126,11,115,181,69,104,12,92
"2011","Dartford 008A","E01024133","Total",460,66,6,60,199,78,57,20,37
"2011","Dartford 008B","E01024136","Total",679,146,14,132,196,80,136,24,112
"2011","Dartford 008C","E01024137","Total",552,137,14,123,213,72,133,32,101
"2011","Dartford 008D","E01024138","Total",657,182,36,146,257,111,144,33,111
"2011","Dartford 008E","E01024139","Total",690,215,4,211,187,58,177,28,149
"2011","Dartford 009A","E01024165","Total",675,279,58,221,227,103,227,51,176
"2011","Dartford 009B","E01024166","Total",620,169,48,121,260,96,146,39,107
"2011","Dartford 009C","E01024167","Total",773,254,36,218,250,103,197,44,153
"2011","Dartford 009D","E01024168","Total",488,183,25,158,164,45,161,32,129
"2011","Dartford 010A","E01024150","Total",643,302,10,292,143,34,155,17,138
"2011","Dartford 010B","E01024151","Total",625,289,7,282,138,40,177,22,155
"2011","Dartford 010C","E01024152","Total",931,176,48,128,427,167,171,58,113
"2011","Dartford 010D","E01024153","Total",543,200,6,194,158,42,121,23,98
"2011","Dartford 011A","E01024173","Total",698,206,18,188,226,81,196,40,156
"2011","Dartford 011B","E01024187","Total",442,133,4,129,117,33,101,15,86
"2011","Dartford 011C","E01024188","Total",508,174,5,169,160,56,119,15,104
"2011","Dartford 011D","E01024189","Total",685,253,16,237,172,61,210,28,182
"2011","Dartford 012A","E01024132","Total",489,139,25,114,179,70,102,27,75
"2011","Dartford 012B","E01024134","Total",650,186,27,159,212,75,163,33,130
"2011","Dartford 012C","E01024135","Total",541,173,30,143,168,60,147,34,113
"2011","Dartford 012D","E01024174","Total",498,166,6,160,136,40,154,22,132
"2011","Dartford 012E","E01024175","Total",514,124,11,113,161,56,98,15,83
"2011","Dartford 013A","E01024157","Total",674,206,9,197,187,58,164,22,142
"2011","Dartford 013B","E01024158","Total",650,247,9,238,150,41,174,20,154
"2011","Dartford 013C","E01024159","Total",647,228,6,222,156,38,160,21,139
"2011","Dartford 013D","E01024160","Total",550,202,9,193,162,44,124,22,102
"2011","Dover 001A","E01024206","Total",717,212,15,197,199,60,168,26,142
"2011","Dover 001B","E01024207","Total",719,205,14,191,224,77,138,23,115
"2011","Dover 001C","E01024208","Total",666,203,15,188,191,65,173,28,145
"2011","Dover 001D","E01024209","Total",749,253,12,241,191,68,191,24,167
"2011","Dover 002A","E01024202","Total",800,331,27,304,213,72,228,41,187
"2011","Dover 002B","E01024242","Total",730,269,14,255,179,67,174,30,144
"2011","Dover 002C","E01024243","Total",761,346,26,320,189,63,284,35,249
"2011","Dover 002D","E01024244","Total",960,399,14,385,136,59,235,15,220
"2011","Dover 002E","E01024245","Total",748,263,15,248,205,60,218,42,176
"2011","Dover 003A","E01024219","Total",562,252,17,235,134,40,178,26,152
"2011","Dover 003B","E01024220","Total",754,356,13,343,142,45,263,24,239
"2011","Dover 003C","E01024221","Total",635,210,20,190,177,63,148,23,125
"2011","Dover 003D","E01024227","Total",675,235,33,202,189,73,182,32,150
"2011","Dover 003E","E01024229","Total",727,316,21,295,144,57,242,25,217
"2011","Dover 004A","E01024228","Total",801,340,23,317,134,52,245,23,222
"2011","Dover 004B","E01024230","Total",761,348,15,333,116,48,225,13,212
"2011","Dover 004C","E01024231","Total",743,297,12,285,155,70,230,29,201
"2011","Dover 004D","E01024252","Total",1141,378,21,357,255,107,274,33,241
"2011","Dover 005A","E01024201","Total",613,179,12,167,175,62,151,36,115
"2011","Dover 005B","E01024217","Total",754,305,34,271,193,75,216,30,186
"2011","Dover 005C","E01024223","Total",625,227,32,195,205,76,188,39,149
"2011","Dover 005D","E01024225","Total",680,204,15,189,223,94,182,40,142
"2011","Dover 005E","E01024226","Total",626,250,27,223,186,58,178,29,149
"2011","Dover 006A","E01024190","Total",594,222,36,186,167,54,187,30,157
"2011","Dover 006B","E01024191","Total",687,206,29,177,244,87,199,47,152
"2011","Dover 006C","E01024192","Total",681,298,53,245,236,103,266,61,205
"2011","Dover 006D","E01024204","Total",657,254,34,220,187,76,198,43,155
"2011","Dover 007A","E01024218","Total",528,191,44,147,178,72,159,35,124
"2011","Dover 007B","E01024222","Total",670,257,45,212,221,92,228,49,179
"2011","Dover 007C","E01024224","Total",647,236,12,224,174,51,194,30,164
"2011","Dover 007D","E01024250","Total",777,388,22,366,170,54,261,25,236
"2011","Dover 007E","E01024251","Total",732,372,13,359,138,41,251,24,227
"2011","Dover 008A","E01024200","Total",715,233,13,220,180,59,182,26,156
"2011","Dover 008B","E01024203","Total",649,206,10,196,148,57,171,23,148
"2011","Dover 008C","E01024205","Total",643,185,30,155,212,74,174,35,139
"2011","Dover 008D","E01024255","Total",671,278,11,267,131,36,213,25,188
"2011","Dover 009A","E01024232","Total",913,390,14,376,185,62,255,21,234
"2011","Dover 009B","E01024236","Total",742,309,7,302,138,44,218,21,197
"2011","Dover 009C","E01024237","Total",758,369,9,360,114,43,211,19,192
"2011","Dover 009D","E01024253","Total",787,353,11,342,140,41,206,14,192
"2011","Dover 010C","E01024233","Total",646,192,2,190,184,63,153,15,138
"2011","Dover 010D","E01024235","Total",699,264,9,255,145,52,182,24,158
"2011","Dover 010E","E01024254","Total",805,249,58,191,331,143,175,54,121
"2011","Dover 010F","E01024256","Total",608,217,8,209,157,51,136,11,125
"2011","Dover 010G","E01033210","Total",961,312,19,293,249,84,235,36,199
"2011","Dover 011A","E01024193","Total",723,314,70,244,230,106,254,46,208
"2011","Dover 011B","E01024194","Total",638,163,42,121,213,86,143,31,112
"2011","Dover 011C","E01024195","Total",528,161,31,130,189,63,150,38,112
"2011","Dover 011D","E01024196","Total",628,253,68,185,204,93,221,47,174
"2011","Dover 011E","E01024197","Total",686,228,27,201,207,91,181,31,150
"2011","Dover 011F","E01024240","Total",651,289,116,173,296,141,212,74,138
"2011","Dover 011G","E01024241","Total",810,239,95,144,360,183,196,66,130
"2011","Dover 011H","E01024248","Total",850,316,76,240,291,139,255,55,200
"2011","Dover 012B","E01024238","Total",566,112,35,77,272,127,110,34,76
"2011","Dover 012C","E01024239","Total",873,375,25,350,181,99,299,37,262
"2011","Dover 012D","E01024247","Total",909,367,45,322,199,87,298,45,253
"2011","Dover 012E","E01033209","Total",574,229,6,223,68,19,154,15,139
"2011","Dover 012F","E01033211","Total",668,364,14,350,57,27,251,15,236
"2011","Dover 013A","E01024214","Total",726,256,45,211,215,108,210,42,168
"2011","Dover 013B","E01024215","Total",674,220,44,176,194,83,154,32,122
"2011","Dover 013C","E01024216","Total",604,148,18,130,218,80,143,32,111
"2011","Dover 013D","E01024246","Total",894,285,80,205,306,151,228,60,168
"2011","Dover 013E","E01024249","Total",915,409,45,364,213,88,345,45,300
"2011","Dover 014A","E01024198","Total",1076,436,4,432,184,47,325,22,303
"2011","Dover 014B","E01024212","Total",663,187,12,175,168,69,151,21,130
"2011","Dover 014C","E01024213","Total",572,151,5,146,167,54,135,22,113
"2011","Dover 014D","E01024234","Total",565,191,6,185,136,40,129,14,115
"2011","Gravesham 001A","E01024276","Total",916,157,39,118,382,187,153,50,103
"2011","Gravesham 001B","E01024277","Total",769,270,78,192,281,146,226,53,173
"2011","Gravesham 001C","E01024278","Total",863,373,127,246,323,197,247,53,194
"2011","Gravesham 001D","E01024279","Total",619,196,53,143,236,116,142,39,103
"2011","Gravesham 002A","E01024257","Total",890,321,49,272,249,114,255,41,214
"2011","Gravesham 002C","E01024290","Total",584,168,35,133,193,83,145,29,116
"2011","Gravesham 002D","E01024291","Total",793,307,42,265,225,113,230,40,190
"2011","Gravesham 002E","E01024295","Total",934,403,47,356,225,136,264,34,230
"2011","Gravesham 002F","E01032799","Total",660,196,22,174,156,92,150,20,130
"2011","Gravesham 002G","E01032800","Total",689,198,21,177,95,50,139,11,128
"2011","Gravesham 003A","E01024258","Total",625,160,28,132,197,84,138,38,100
"2011","Gravesham 003B","E01024261","Total",946,371,12,359,230,79,230,20,210
"2011","Gravesham 003C","E01024293","Total",599,162,35,127,254,112,135,40,95
"2011","Gravesham 003D","E01024294","Total",811,238,86,152,376,178,209,78,131
"2011","Gravesham 003E","E01024296","Total",1165,259,64,195,392,195,242,74,168
"2011","Gravesham 004A","E01024262","Total",715,235,36,199,229,89,195,37,158
"2011","Gravesham 004B","E01024263","Total",593,214,38,176,202,78,203,44,159
"2011","Gravesham 004C","E01024282","Total",580,113,28,85,238,113,128,47,81
"2011","Gravesham 004D","E01024283","Total",491,134,23,111,197,84,113,28,85
"2011","Gravesham 004E","E01024284","Total",595,142,32,110,227,96,143,40,103
"2011","Gravesham 005A","E01024259","Total",560,152,9,143,181,54,122,27,95
"2011","Gravesham 005B","E01024260","Total",808,265,23,242,215,85,212,32,180
"2011","Gravesham 005C","E01024292","Total",557,144,15,129,194,65,123,33,90
"2011","Gravesham 005D","E01024313","Total",631,190,13,177,210,74,169,24,145
"2011","Gravesham 005E","E01024317","Total",641,203,9,194,220,84,164,24,140
"2011","Gravesham 005F","E01024318","Total",622,158,12,146,223,90,159,32,127
"2011","Gravesham 006A","E01024280","Total",682,228,58,170,259,95,188,49,139
"2011","Gravesham 006B","E01024281","Total",528,163,22,141,203,64,143,36,107
"2011","Gravesham 006C","E01024285","Total",525,160,23,137,168,63,137,35,102
"2011","Gravesham 006D","E01024287","Total",645,314,30,284,163,61,235,35,200
"2011","Gravesham 006E","E01024288","Total",499,210,11,199,125,42,125,16,109
"2011","Gravesham 007A","E01024308","Total",612,282,38,244,192,84,224,44,180
"2011","Gravesham 007B","E01024310","Total",627,264,29,235,184,74,199,30,169
"2011","Gravesham 007C","E01024311","Total",457,167,53,114,221,92,120,44,76
"2011","Gravesham 007D","E01024314","Total",485,141,14,127,175,64,111,28,83
"2011","Gravesham 007E","E01024315","Total",596,224,25,199,187,64,192,36,156
"2011","Gravesham 008A","E01024297","Total",564,143,7,136,193,70,104,17,87
"2011","Gravesham 008B","E01024298","Total",537,182,7,175,168,49,132,25,107
"2011","Gravesham 008C","E01024299","Total",553,164,10,154,177,54,126,16,110
"2011","Gravesham 008D","E01024309","Total",478,142,48,94,200,83,103,36,67
"2011","Gravesham 008E","E01024312","Total",474,155,22,133,168,66,121,35,86
"2011","Gravesham 009A","E01024264","Total",612,253,37,216,193,65,201,42,159
"2011","Gravesham 009B","E01024286","Total",620,171,19,152,207,78,151,33,118
"2011","Gravesham 009C","E01024316","Total",683,179,19,160,256,97,137,35,102
"2011","Gravesham 009D","E01024319","Total",554,166,36,130,245,95,132,45,87
"2011","Gravesham 010A","E01024265","Total",499,168,7,161,143,38,117,20,97
"2011","Gravesham 010B","E01024266","Total",482,195,18,177,135,37,150,25,125
"2011","Gravesham 010C","E01024267","Total",623,214,11,203,173,61,150,23,127
"2011","Gravesham 010D","E01024300","Total",580,193,15,178,159,57,144,25,119
"2011","Gravesham 010E","E01024301","Total",518,195,5,190,117,32,121,12,109
"2011","Gravesham 011A","E01024303","Total",668,185,30,155,228,103,151,35,116
"2011","Gravesham 011B","E01024304","Total",610,186,25,161,209,73,176,38,138
"2011","Gravesham 011C","E01024305","Total",547,215,75,140,254,106,155,55,100
"2011","Gravesham 011D","E01024306","Total",436,188,48,140,173,72,133,38,95
"2011","Gravesham 011E","E01024307","Total",643,283,21,262,165,59,191,26,165
"2011","Gravesham 012A","E01024268","Total",631,238,5,233,172,50,177,25,152
"2011","Gravesham 012B","E01024269","Total",758,285,11,274,191,50,210,28,182
"2011","Gravesham 012C","E01024270","Total",586,184,7,177,168,52,105,12,93
"2011","Gravesham 012D","E01024271","Total",579,200,13,187,172,63,162,32,130
"2011","Gravesham 012E","E01024272","Total",592,202,2,200,180,51,148,23,125
"2011","Gravesham 013A","E01024273","Total",552,140,8,132,192,58,114,27,87
"2011","Gravesham 013B","E01024274","Total",616,185,10,175,154,50,152,22,130
"2011","Gravesham 013C","E01024275","Total",526,94,3,91,208,70,104,26,78
"2011","Gravesham 013D","E01024302","Total",598,223,13,210,155,51,132,16,116
"2011","Maidstone 001A","E01024333","Total",521,70,18,52,210,84,87,33,54
"2011","Maidstone 001B","E01024334","Total",412,64,9,55,155,71,75,16,59
"2011","Maidstone 001C","E01024335","Total",605,152,7,145,174,51,124,21,103
"2011","Maidstone 001D","E01024338","Total",513,69,8,61,170,60,67,14,53
"2011","Maidstone 001E","E01024347","Total",655,189,6,183,193,62,136,13,123
"2011","Maidstone 002A","E01024353","Total",720,194,7,187,189,66,150,19,131
"2011","Maidstone 002B","E01024354","Total",602,159,18,141,186,76,129,18,111
"2011","Maidstone 002C","E01024355","Total",823,197,32,165,258,124,165,30,135
"2011","Maidstone 002D","E01024385","Total",623,187,21,166,210,83,145,28,117
"2011","Maidstone 002E","E01024386","Total",697,183,6,177,205,75,165,35,130
"2011","Maidstone 003A","E01024320","Total",492,153,3,150,146,36,110,15,95
"2011","Maidstone 003B","E01024321","Total",736,340,10,330,195,68,189,18,171
"2011","Maidstone 003C","E01024322","Total",494,198,6,192,123,41,143,16,127
"2011","Maidstone 003D","E01024323","Total",593,222,4,218,150,44,140,14,126
"2011","Maidstone 003E","E01024324","Total",637,239,5,234,184,76,155,27,128
"2011","Maidstone 003F","E01024341","Total",698,270,5,265,160,40,171,20,151
"2011","Maidstone 004A","E01024352","Total",868,270,51,219,233,115,245,47,198
"2011","Maidstone 004C","E01024382","Total",641,97,30,67,177,93,107,23,84
"2011","Maidstone 004D","E01024383","Total",868,125,25,100,318,175,121,42,79
"2011","Maidstone 004E","E01024384","Total",783,229,38,191,226,83,212,51,161
"2011","Maidstone 004F","E01033090","Total",632,239,39,200,136,75,167,22,145
"2011","Maidstone 004G","E01033092","Total",631,200,24,176,133,73,154,18,136
"2011","Maidstone 005A","E01024330","Total",641,205,5,200,194,77,121,19,102
"2011","Maidstone 005B","E01024336","Total",624,155,9,146,227,67,122,31,91
"2011","Maidstone 005C","E01024337","Total",606,151,6,145,210,61,127,25,102
"2011","Maidstone 005D","E01024348","Total",518,87,6,81,185,63,89,18,71
"2011","Maidstone 005E","E01024351","Total",666,258,9,249,159,53,176,19,157
"2011","Maidstone 006A","E01024339","Total",850,223,21,202,209,96,184,29,155
"2011","Maidstone 006B","E01024340","Total",1034,247,31,216,249,103,200,36,164
"2011","Maidstone 006C","E01024356","Total",625,116,15,101,202,85,117,27,90
"2011","Maidstone 006E","E01024373","Total",790,221,28,193,221,99,196,37,159
"2011","Maidstone 006F","E01033087","Total",699,130,33,97,139,87,102,15,87
"2011","Maidstone 006G","E01033091","Total",715,161,19,142,206,97,139,33,106
"2011","Maidstone 007A","E01024326","Total",784,346,3,343,194,67,239,29,210
"2011","Maidstone 007B","E01024327","Total",672,194,16,178,202,79,141,22,119
"2011","Maidstone 007C","E01024328","Total",673,268,15,253,191,67,153,24,129
"2011","Maidstone 007D","E01024329","Total",604,218,6,212,186,53,140,19,121
"2011","Maidstone 007E","E01024349","Total",603,84,8,76,193,92,67,13,54
"2011","Maidstone 008A","E01024357","Total",670,127,30,97,261,113,123,35,88
"2011","Maidstone 008B","E01024358","Total",748,285,46,239,241,96,221,40,181
"2011","Maidstone 008C","E01024367","Total",543,144,27,117,196,74,129,35,94
"2011","Maidstone 008E","E01024369","Total",615,167,14,153,214,79,143,34,109
"2011","Maidstone 008F","E01033088","Total",549,57,13,44,232,126,67,23,44
"2011","Maidstone 008G","E01033089","Total",575,151,52,99,248,105,118,41,77
"2011","Maidstone 009A","E01024360","Total",636,140,21,119,215,72,113,29,84
"2011","Maidstone 009B","E01024372","Total",801,192,43,149,256,113,163,37,126
"2011","Maidstone 009C","E01024374","Total",580,177,92,85,307,135,153,73,80
"2011","Maidstone 009D","E01024401","Total",640,154,28,126,226,97,111,24,87
"2011","Maidstone 009E","E01024403","Total",777,195,17,178,224,112,190,37,153
"2011","Maidstone 010A","E01024371","Total",648,193,27,166,195,79,187,43,144
"2011","Maidstone 010B","E01024392","Total",608,203,49,154,211,61,168,51,117
"2011","Maidstone 010C","E01024393","Total",607,209,26,183,199,74,170,34,136
"2011","Maidstone 010D","E01024395","Total",528,156,38,118,216,74,147,35,112
"2011","Maidstone 010E","E01024396","Total",630,222,34,188,230,92,190,48,142
"2011","Maidstone 011A","E01024361","Total",725,262,25,237,182,63,209,28,181
"2011","Maidstone 011B","E01024362","Total",699,190,7,183,203,80,139,22,117
"2011","Maidstone 011C","E01024363","Total",824,253,23,230,256,101,177,35,142
"2011","Maidstone 011D","E01024387","Total",982,283,25,258,260,86,230,41,189
"2011","Maidstone 012A","E01024331","Total",580,199,11,188,163,49,137,20,117
"2011","Maidstone 012B","E01024394","Total",521,162,7,155,163,50,103,20,83
"2011","Maidstone 012C","E01024402","Total",601,212,5,207,156,48,149,23,126
"2011","Maidstone 012D","E01024404","Total",615,187,9,178,203,69,146,28,118
"2011","Maidstone 012E","E01024405","Total",924,336,18,318,227,90,249,33,216
"2011","Maidstone 013A","E01024389","Total",920,425,203,222,466,276,264,91,173
"2011","Maidstone 013B","E01024390","Total",573,234,80,154,248,124,181,59,122
"2011","Maidstone 013C","E01024391","Total",494,181,64,117,220,78,135,43,92
"2011","Maidstone 013D","E01024397","Total",654,304,51,253,184,80,233,36,197
"2011","Maidstone 013E","E01024398","Total",711,297,87,210,260,114,237,56,181
"2011","Maidstone 013F","E01024399","Total",620,298,32,266,152,59,238,29,209
"2011","Maidstone 013G","E01024400","Total",558,241,24,217,160,65,160,28,132
"2011","Maidstone 014A","E01024325","Total",1002,437,8,429,231,76,278,26,252
"2011","Maidstone 014B","E01024346","Total",560,208,7,201,140,49,150,16,134
"2011","Maidstone 014C","E01024377","Total",717,246,12,234,164,65,217,24,193
"2011","Maidstone 014D","E01024378","Total",582,201,13,188,161,50,175,23,152
"2011","Maidstone 015A","E01024332","Total",496,134,4,130,127,45,111,17,94
"2011","Maidstone 015B","E01024350","Total",566,120,8,112,211,71,102,21,81
"2011","Maidstone 015C","E01024375","Total",977,289,25,264,271,88,222,43,179
"2011","Maidstone 015D","E01024388","Total",1146,254,58,196,465,231,222,53,169
"2011","Maidstone 015E","E01024410","Total",635,207,8,199,138,41,151,20,131
"2011","Maidstone 016A","E01024342","Total",749,284,26,258,181,84,195,32,163
"2011","Maidstone 016B","E01024343","Total",522,142,8,134,180,47,114,25,89
"2011","Maidstone 016C","E01024344","Total",616,247,7,240,128,39,166,17,149
"2011","Maidstone 016D","E01024376","Total",921,288,16,272,249,82,213,31,182
"2011","Maidstone 017A","E01024364","Total",699,250,19,231,191,67,184,28,156
"2011","Maidstone 017B","E01024365","Total",760,246,8,238,199,81,186,25,161
"2011","Maidstone 017C","E01024366","Total",652,160,21,139,194,65,133,29,104
"2011","Maidstone 017D","E01024411","Total",468,112,17,95,160,57,128,35,93
"2011","Maidstone 018A","E01024345","Total",605,164,7,157,186,49,138,21,117
"2011","Maidstone 018B","E01024379","Total",658,155,11,144,229,57,152,34,118
"2011","Maidstone 018C","E01024380","Total",689,183,15,168,207,76,153,37,116
"2011","Maidstone 018D","E01024381","Total",612,217,36,181,190,72,170,33,137
"2011","Maidstone 019A","E01024406","Total",547,117,16,101,213,77,106,26,80
"2011","Maidstone 019B","E01024407","Total",567,123,15,108,199,79,120,32,88
"2011","Maidstone 019C","E01024408","Total",580,152,9,143,183,60,125,22,103
"2011","Maidstone 019D","E01024409","Total",617,219,10,209,162,65,146,23,123
"2011","Sevenoaks 001A","E01024445","Total",498,124,4,120,159,57,91,15,76
"2011","Sevenoaks 001B","E01024446","Total",586,152,8,144,177,44,150,22,128
"2011","Sevenoaks 001C","E01024447","Total",578,235,14,221,139,46,156,17,139
"2011","Sevenoaks 001D","E01024472","Total",526,147,21,126,181,50,131,36,95
"2011","Sevenoaks 001E","E01024479","Total",616,202,14,188,159,63,156,22,134
"2011","Sevenoaks 002A","E01024476","Total",593,197,56,141,256,96,177,50,127
"2011","Sevenoaks 002B","E01024477","Total",614,228,31,197,183,74,171,27,144
"2011","Sevenoaks 002C","E01024478","Total",579,193,21,172,163,76,144,21,123
"2011","Sevenoaks 002D","E01024480","Total",809,386,39,347,205,96,322,30,292
"2011","Sevenoaks 002E","E01024481","Total",660,246,34,212,193,77,193,37,156
"2011","Sevenoaks 002F","E01024482","Total",661,225,37,188,176,75,185,33,152
"2011","Sevenoaks 003A","E01024421","Total",801,292,14,278,208,69,221,29,192
"2011","Sevenoaks 003B","E01024473","Total",637,164,15,149,200,78,160,29,131
"2011","Sevenoaks 003C","E01024474","Total",472,128,11,117,151,47,97,26,71
"2011","Sevenoaks 003D","E01024475","Total",623,204,24,180,190,71,131,28,103
"2011","Sevenoaks 004A","E01024441","Total",630,253,8,245,142,32,151,21,130
"2011","Sevenoaks 004B","E01024442","Total",596,198,15,183,158,47,131,26,105
"2011","Sevenoaks 004C","E01024443","Total",654,323,6,317,122,24,177,14,163
"2011","Sevenoaks 004D","E01024444","Total",525,157,19,138,157,57,135,25,110
"2011","Sevenoaks 005A","E01024431","Total",799,262,7,255,199,78,200,24,176
"2011","Sevenoaks 005B","E01024432","Total",611,186,15,171,172,60,142,23,119
"2011","Sevenoaks 005C","E01024433","Total",552,147,6,141,141,52,128,18,110
"2011","Sevenoaks 005D","E01024434","Total",934,294,20,274,223,100,218,31,187
"2011","Sevenoaks 007A","E01024435","Total",579,149,15,134,174,48,123,28,95
"2011","Sevenoaks 007B","E01024436","Total",700,324,4,320,111,27,212,16,196
"2011","Sevenoaks 007C","E01024437","Total",603,211,12,199,164,51,180,32,148
"2011","Sevenoaks 007D","E01024438","Total",623,213,6,207,154,42,152,19,133
"2011","Sevenoaks 008A","E01024422","Total",769,164,20,144,260,121,141,41,100
"2011","Sevenoaks 008B","E01024423","Total",758,190,22,168,232,114,138,25,113
"2011","Sevenoaks 008C","E01024439","Total",628,187,12,175,189,60,146,23,123
"2011","Sevenoaks 008D","E01024440","Total",769,211,13,198,226,90,166,36,130
"2011","Sevenoaks 008E","E01024452","Total",590,197,10,187,159,67,127,18,109
"2011","Sevenoaks 009A","E01024448","Total",504,140,5,135,152,52,124,19,105
"2011","Sevenoaks 009B","E01024449","Total",563,200,14,186,162,53,138,20,118
"2011","Sevenoaks 009C","E01024450","Total",621,202,21,181,209,85,139,18,121
"2011","Sevenoaks 009D","E01024453","Total",644,239,8,231,203,81,137,29,108
"2011","Sevenoaks 009E","E01024454","Total",618,179,11,168,214,96,141,21,120
"2011","Sevenoaks 010A","E01024457","Total",519,187,19,168,146,76,143,30,113
"2011","Sevenoaks 010B","E01024460","Total",669,213,26,187,237,99,185,37,148
"2011","Sevenoaks 010C","E01024461","Total",1049,288,10,278,316,138,217,33,184
"2011","Sevenoaks 010D","E01024465","Total",617,144,9,135,161,66,129,15,114
"2011","Sevenoaks 010E","E01024466","Total",526,138,18,120,180,78,102,18,84
"2011","Sevenoaks 010F","E01024468","Total",629,155,12,143,212,100,110,15,95
"2011","Sevenoaks 011A","E01024416","Total",621,174,8,166,215,90,127,22,105
"2011","Sevenoaks 011B","E01024418","Total",514,172,11,161,195,71,84,15,69
"2011","Sevenoaks 011C","E01024424","Total",486,138,8,130,219,78,92,20,72
"2011","Sevenoaks 011D","E01024463","Total",519,117,8,109,227,73,88,16,72
"2011","Sevenoaks 011E","E01024464","Total",577,154,11,143,232,85,83,20,63
"2011","Sevenoaks 011F","E01024467","Total",645,177,6,171,257,128,118,17,101
"2011","Sevenoaks 012A","E01024458","Total",526,150,11,139,187,40,79,23,56
"2011","Sevenoaks 012B","E01024459","Total",637,173,11,162,212,60,125,24,101
"2011","Sevenoaks 012C","E01024462","Total",659,219,12,207,232,78,140,23,117
"2011","Sevenoaks 012D","E01024469","Total",709,144,8,136,172,78,102,17,85
"2011","Sevenoaks 012E","E01024470","Total",642,223,6,217,209,99,141,19,122
"2011","Sevenoaks 012F","E01024471","Total",741,320,3,317,148,63,211,13,198
"2011","Sevenoaks 013A","E01024417","Total",650,180,13,167,189,71,142,25,117
"2011","Sevenoaks 013B","E01024419","Total",731,185,11,174,206,73,110,14,96
"2011","Sevenoaks 013C","E01024483","Total",682,173,7,166,158,57,122,15,107
"2011","Sevenoaks 013D","E01024484","Total",500,131,7,124,139,52,88,8,80
"2011","Sevenoaks 013E","E01024485","Total",702,207,35,172,248,100,152,30,122
"2011","Sevenoaks 014A","E01024425","Total",724,263,16,247,198,87,212,28,184
"2011","Sevenoaks 014B","E01024426","Total",770,205,11,194,183,65,143,20,123
"2011","Sevenoaks 014C","E01024427","Total",508,147,19,128,150,59,135,26,109
"2011","Sevenoaks 014D","E01024428","Total",532,159,19,140,181,78,132,22,110
"2011","Sevenoaks 014E","E01024429","Total",651,213,44,169,210,100,156,33,123
"2011","Sevenoaks 014F","E01024430","Total",600,169,14,155,158,71,146,20,126
"2011","Sevenoaks 015A","E01024420","Total",831,236,17,219,243,92,169,24,145
"2011","Sevenoaks 015B","E01024451","Total",873,241,18,223,285,99,182,22,160
"2011","Sevenoaks 015C","E01024455","Total",472,112,6,106,150,53,87,17,70
"2011","Sevenoaks 015D","E01024456","Total",518,167,9,158,155,53,126,22,104
"2011","Sevenoaks 016A","E01024413","Total",719,205,28,177,214,92,186,31,155
"2011","Sevenoaks 016B","E01024414","Total",606,103,23,80,227,97,118,36,82
"2011","Sevenoaks 016C","E01024415","Total",507,117,5,112,158,47,94,22,72
"2011","Sevenoaks 016D","E01032619","Total",636,145,12,133,202,68,146,36,110
"2011","Shepway 001A","E01024490","Total",883,315,12,303,206,54,249,38,211
"2011","Shepway 001B","E01024544","Total",574,213,9,204,130,28,156,24,132
"2011","Shepway 001C","E01024545","Total",625,214,10,204,149,40,159,24,135
"2011","Shepway 001D","E01024547","Total",613,259,11,248,145,49,189,25,164
"2011","Shepway 002A","E01024492","Total",639,215,23,192,197,62,195,42,153
"2011","Shepway 002B","E01024541","Total",899,272,72,200,379,155,236,78,158
"2011","Shepway 002C","E01024542","Total",802,236,29,207,279,109,171,39,132
"2011","Shepway 002E","E01033213","Total",643,114,45,69,321,161,98,43,55
"2011","Shepway 002F","E01033214","Total",619,124,10,114,266,91,133,37,96
"2011","Shepway 003A","E01024496","Total",660,270,77,193,235,110,207,48,159
"2011","Shepway 003B","E01024497","Total",653,221,40,181,218,95,192,34,158
"2011","Shepway 003C","E01024498","Total",638,286,72,214,253,98,232,65,167
"2011","Shepway 003D","E01024503","Total",760,302,25,277,203,74,223,29,194
"2011","Shepway 003E","E01024518","Total",677,222,18,204,208,58,172,44,128
"2011","Shepway 004A","E01024499","Total",654,225,68,157,247,119,175,45,130
"2011","Shepway 004B","E01024500","Total",532,230,58,172,184,73,166,42,124
"2011","Shepway 004C","E01024501","Total",635,205,63,142,255,141,165,51,114
"2011","Shepway 004D","E01024502","Total",605,191,42,149,191,85,170,46,124
"2011","Shepway 004E","E01024505","Total",828,307,56,251,251,121,252,47,205
"2011","Shepway 005A","E01024491","Total",551,135,33,102,247,81,129,39,90
"2011","Shepway 005B","E01024493","Total",575,216,28,188,191,58,196,39,157
"2011","Shepway 005C","E01024494","Total",649,237,24,213,215,65,190,37,153
"2011","Shepway 005D","E01024495","Total",677,170,44,126,310,157,140,44,96
"2011","Shepway 005E","E01024520","Total",626,242,25,217,185,79,188,33,155
"2011","Shepway 005F","E01024528","Total",530,181,28,153,156,63,151,28,123
"2011","Shepway 006A","E01024511","Total",538,170,14,156,167,53,129,26,103
"2011","Shepway 006B","E01024512","Total",698,215,24,191,238,88,185,35,150
"2011","Shepway 006C","E01024513","Total",651,211,28,183,233,84,174,37,137
"2011","Shepway 006D","E01024514","Total",511,139,16,123,188,68,112,23,89
"2011","Shepway 006E","E01024515","Total",639,253,13,240,144,54,185,20,165
"2011","Shepway 006F","E01024516","Total",552,204,24,180,171,50,150,37,113
"2011","Shepway 006G","E01024519","Total",622,178,7,171,121,41,120,11,109
"2011","Shepway 006H","E01024521","Total",857,313,13,300,150,53,221,25,196
"2011","Shepway 008A","E01024523","Total",677,327,12,315,150,51,144,14,130
"2011","Shepway 008B","E01024526","Total",663,261,7,254,128,40,159,23,136
"2011","Shepway 008C","E01024527","Total",695,358,8,350,115,44,220,20,200
"2011","Shepway 008D","E01024550","Total",858,287,15,272,218,71,226,29,197
"2011","Shepway 009A","E01024489","Total",795,376,8,368,117,29,260,27,233
"2011","Shepway 009B","E01024530","Total",587,215,11,204,170,49,171,33,138
"2011","Shepway 009C","E01024536","Total",809,246,9,237,231,57,179,34,145
"2011","Shepway 009D","E01024546","Total",662,231,8,223,172,70,183,23,160
"2011","Shepway 010A","E01024522","Total",688,304,14,290,131,56,206,20,186
"2011","Shepway 010B","E01024524","Total",780,422,30,392,133,71,330,25,305
"2011","Shepway 010C","E01024525","Total",860,433,30,403,134,48,272,22,250
"2011","Shepway 010D","E01024529","Total",680,325,21,304,129,48,244,34,210
"2011","Shepway 010E","E01024531","Total",640,302,33,269,157,66,206,33,173
"2011","Shepway 011A","E01024486","Total",874,436,23,413,176,52,296,35,261
"2011","Shepway 011B","E01024487","Total",559,245,15,230,107,29,203,31,172
"2011","Shepway 011C","E01024488","Total",664,388,12,376,85,18,258,22,236
"2011","Shepway 011D","E01024548","Total",500,151,20,131,145,61,139,24,115
"2011","Shepway 011E","E01024549","Total",450,117,8,109,117,42,108,15,93
"2011","Shepway 012A","E01024537","Total",750,313,17,296,154,47,206,21,185
"2011","Shepway 012B","E01024538","Total",705,314,6,308,130,31,197,22,175
"2011","Shepway 012C","E01024539","Total",889,394,46,348,241,96,280,38,242
"2011","Shepway 012D","E01024540","Total",640,262,6,256,153,43,178,24,154
"2011","Shepway 013A","E01024532","Total",639,287,18,269,143,41,199,32,167
"2011","Shepway 013B","E01024533","Total",558,256,15,241,109,35,179,24,155
"2011","Shepway 013C","E01024534","Total",609,226,49,177,223,83,188,44,144
"2011","Shepway 013D","E01024535","Total",1008,357,42,315,255,116,265,55,210
"2011","Shepway 014A","E01024504","Total",1078,449,74,375,259,143,300,44,256
"2011","Shepway 014B","E01024507","Total",1060,498,71,427,225,115,381,52,329
"2011","Shepway 014C","E01033212","Total",913,379,46,333,123,55,252,24,228
"2011","Shepway 014D","E01033215","Total",791,434,19,415,61,37,265,7,258
"2011","Shepway 015A","E01024508","Total",1110,428,52,376,197,103,322,36,286
"2011","Shepway 015B","E01024509","Total",957,484,26,458,118,58,305,12,293
"2011","Shepway 015C","E01024510","Total",874,342,19,323,121,49,252,19,233
"2011","Shepway 015D","E01024517","Total",742,231,30,201,167,54,187,31,156
"2011","Swale 001A","E01024609","Total",530,226,52,174,160,79,158,34,124
"2011","Swale 001B","E01024610","Total",660,267,100,167,260,128,181,52,129
"2011","Swale 001C","E01024611","Total",617,247,108,139,266,153,174,54,120
"2011","Swale 001D","E01024612","Total",634,246,69,177,226,98,189,49,140
"2011","Swale 002A","E01024613","Total",615,263,53,210,188,93,225,50,175
"2011","Swale 002B","E01024614","Total",639,321,92,229,238,117,234,65,169
"2011","Swale 002C","E01024615","Total",613,324,89,235,215,81,253,51,202
"2011","Swale 002D","E01024616","Total",700,321,55,266,230,94,261,52,209
"2011","Swale 003A","E01024585","Total",607,284,40,244,194,65,211,37,174
"2011","Swale 003B","E01024587","Total",638,285,21,264,133,46,204,26,178
"2011","Swale 003C","E01024588","Total",585,203,7,196,141,42,148,24,124
"2011","Swale 003D","E01024589","Total",662,252,12,240,133,47,190,28,162
"2011","Swale 004A","E01024595","Total",635,248,22,226,180,63,183,41,142
"2011","Swale 004B","E01024598","Total",610,165,24,141,200,78,153,27,126
"2011","Swale 004D","E01024619","Total",602,204,20,184,170,63,154,22,132
"2011","Swale 004E","E01024621","Total",478,232,62,170,189,58,205,57,148
"2011","Swale 004F","E01032653","Total",662,193,26,167,189,88,170,28,142
"2011","Swale 004G","E01032654","Total",709,87,28,59,295,150,123,37,86
"2011","Swale 005A","E01024594","Total",593,248,17,231,147,45,179,28,151
"2011","Swale 005B","E01024596","Total",689,256,51,205,216,104,193,38,155
"2011","Swale 005C","E01024597","Total",612,266,61,205,195,79,209,43,166
"2011","Swale 005D","E01024620","Total",544,208,12,196,109,30,162,12,150
"2011","Swale 006A","E01024580","Total",797,430,58,372,159,63,308,34,274
"2011","Swale 006B","E01024581","Total",539,195,36,159,169,66,174,37,137
"2011","Swale 006C","E01024586","Total",662,241,30,211,190,50,207,34,173
"2011","Swale 006D","E01024618","Total",731,258,44,214,219,74,237,49,188
"2011","Swale 007B","E01024576","Total",673,133,25,108,235,93,116,21,95
"2011","Swale 007C","E01024577","Total",521,145,31,114,197,81,99,23,76
"2011","Swale 007D","E01024578","Total",659,135,30,105,257,100,113,27,86
"2011","Swale 007E","E01024579","Total",1056,240,95,145,524,249,209,74,135
"2011","Swale 007F","E01024583","Total",640,166,50,116,248,89,146,40,106
"2011","Swale 007G","E01032655","Total",586,65,16,49,273,141,75,23,52
"2011","Swale 007H","E01032656","Total",571,136,17,119,232,101,124,35,89
"2011","Swale 008A","E01024570","Total",679,240,29,211,211,76,186,49,137
"2011","Swale 008B","E01024571","Total",658,192,14,178,152,58,150,24,126
"2011","Swale 008C","E01024572","Total",447,113,8,105,139,41,102,23,79
"2011","Swale 008D","E01024573","Total",538,182,12,170,162,46,170,35,135
"2011","Swale 008E","E01024575","Total",473,136,11,125,144,44,99,15,84
"2011","Swale 009A","E01024554","Total",988,275,27,248,277,93,223,36,187
"2011","Swale 009B","E01024561","Total",543,120,29,91,189,87,105,26,79
"2011","Swale 009C","E01024567","Total",1133,320,86,234,445,213,220,65,155
"2011","Swale 009D","E01024568","Total",1035,221,20,201,420,159,199,57,142
"2011","Swale 009E","E01024582","Total",629,185,13,172,171,58,175,30,145
"2011","Swale 010A","E01024559","Total",650,258,30,228,167,83,202,27,175
"2011","Swale 010B","E01024584","Total",707,311,69,242,244,92,234,50,184
"2011","Swale 010C","E01024590","Total",685,356,76,280,201,95,257,50,207
"2011","Swale 010D","E01024599","Total",835,278,76,202,305,151,212,50,162
"2011","Swale 010E","E01024608","Total",815,338,36,302,202,92,248,32,216
"2011","Swale 011A","E01024591","Total",768,220,38,182,256,132,203,44,159
"2011","Swale 011B","E01024592","Total",512,137,13,124,164,68,91,19,72
"2011","Swale 011C","E01024593","Total",504,116,39,77,212,89,107,46,61
"2011","Swale 011D","E01024600","Total",618,252,37,215,168,52,218,37,181
"2011","Swale 011E","E01024601","Total",718,278,24,254,166,52,235,22,213
"2011","Swale 012A","E01024560","Total",503,148,27,121,185,85,123,30,93
"2011","Swale 012B","E01024562","Total",571,168,28,140,216,88,136,32,104
"2011","Swale 012C","E01024569","Total",707,222,9,213,197,68,172,30,142
"2011","Swale 012D","E01024630","Total",755,355,15,340,164,52,224,23,201
"2011","Swale 012E","E01024632","Total",648,267,4,263,155,32,164,17,147
"2011","Swale 013A","E01024606","Total",523,176,11,165,163,49,117,24,93
"2011","Swale 013C","E01024628","Total",605,185,15,170,180,50,129,23,106
"2011","Swale 013D","E01024629","Total",452,135,7,128,137,39,92,15,77
"2011","Swale 013E","E01024631","Total",648,236,7,229,176,37,150,18,132
"2011","Swale 013F","E01032735","Total",595,154,15,139,231,78,101,33,68
"2011","Swale 013G","E01032737","Total",583,149,20,129,203,89,107,20,87
"2011","Swale 014A","E01024564","Total",441,173,7,166,111,39,114,21,93
"2011","Swale 014B","E01024603","Total",510,120,7,113,165,54,105,20,85
"2011","Swale 014C","E01024604","Total",478,131,50,81,205,90,100,35,65
"2011","Swale 014D","E01024605","Total",583,206,12,194,142,50,141,19,122
"2011","Swale 014E","E01024626","Total",620,174,7,167,198,87,144,31,113
"2011","Swale 014F","E01024627","Total",817,345,76,269,262,119,248,58,190
"2011","Swale 015A","E01024551","Total",987,273,46,227,327,169,240,58,182
"2011","Swale 015B","E01024552","Total",760,262,43,219,247,111,232,51,181
"2011","Swale 015C","E01024553","Total",1002,368,12,356,190,93,279,22,257
"2011","Swale 015D","E01024563","Total",655,298,62,236,200,77,206,42,164
"2011","Swale 015E","E01024602","Total",699,245,15,230,172,72,190,22,168
"2011","Swale 015F","E01024625","Total",793,261,13,248,217,85,193,35,158
"2011","Swale 016A","E01024565","Total",520,148,12,136,152,44,122,18,104
"2011","Swale 016B","E01024566","Total",603,207,23,184,171,43,152,24,128
"2011","Swale 016C","E01024622","Total",712,223,31,192,190,68,164,21,143
"2011","Swale 016D","E01024623","Total",785,281,28,253,216,72,224,38,186
"2011","Swale 016E","E01024624","Total",738,264,43,221,229,74,211,52,159
"2011","Swale 017A","E01024555","Total",519,177,14,163,152,50,124,21,103
"2011","Swale 017B","E01024556","Total",494,162,6,156,136,47,127,24,103
"2011","Swale 017C","E01024557","Total",611,192,18,174,198,74,144,33,111
"2011","Swale 017D","E01024558","Total",664,190,14,176,188,50,149,20,129
"2011","Thanet 001A","E01024657","Total",1009,470,129,341,318,179,247,52,195
"2011","Thanet 001B","E01024658","Total",949,468,80,388,254,140,309,53,256
"2011","Thanet 001C","E01024659","Total",641,278,34,244,182,70,218,33,185
"2011","Thanet 001D","E01024660","Total",756,341,64,277,232,123,254,45,209
"2011","Thanet 001E","E01024678","Total",1038,549,98,451,222,135,361,47,314
"2011","Thanet 002A","E01024653","Total",722,328,13,315,161,53,228,24,204
"2011","Thanet 002B","E01024654","Total",737,402,9,393,136,37,280,26,254
"2011","Thanet 002C","E01024655","Total",628,294,6,288,138,41,178,30,148
"2011","Thanet 002D","E01024656","Total",779,380,12,368,154,57,253,27,226
"2011","Thanet 002E","E01024675","Total",873,346,15,331,223,67,210,33,177
"2011","Thanet 003A","E01024676","Total",822,391,68,323,205,92,271,45,226
"2011","Thanet 003B","E01024677","Total",677,226,82,144,282,139,199,57,142
"2011","Thanet 003C","E01024695","Total",488,129,34,95,215,96,115,33,82
"2011","Thanet 003D","E01024697","Total",504,213,71,142,219,89,167,53,114
"2011","Thanet 003E","E01024710","Total",588,244,36,208,136,62,171,21,150
"2011","Thanet 004A","E01024661","Total",643,248,75,173,229,119,200,55,145
"2011","Thanet 004B","E01024664","Total",604,222,50,172,230,98,191,48,143
"2011","Thanet 004C","E01024665","Total",594,181,25,156,223,97,183,35,148
"2011","Thanet 004D","E01024694","Total",786,259,26,233,223,90,232,40,192
"2011","Thanet 004E","E01024696","Total",595,219,25,194,171,74,188,44,144
"2011","Thanet 005A","E01024672","Total",598,266,55,211,200,49,219,52,167
"2011","Thanet 005B","E01024673","Total",804,337,30,307,225,93,278,40,238
"2011","Thanet 005C","E01024674","Total",607,168,15,153,195,66,155,34,121
"2011","Thanet 005D","E01024711","Total",542,195,6,189,159,45,160,26,134
"2011","Thanet 005E","E01024712","Total",625,219,10,209,175,55,162,22,140
"2011","Thanet 006A","E01024633","Total",659,312,53,259,213,82,263,46,217
"2011","Thanet 006B","E01024634","Total",546,198,47,151,215,78,169,43,126
"2011","Thanet 006C","E01024662","Total",649,296,57,239,211,86,209,39,170
"2011","Thanet 006D","E01024663","Total",617,281,114,167,283,125,197,71,126
"2011","Thanet 006E","E01024666","Total",734,391,98,293,236,113,270,61,209
"2011","Thanet 007A","E01024641","Total",730,387,34,353,156,58,275,36,239
"2011","Thanet 007B","E01024713","Total",708,289,39,250,227,101,242,48,194
"2011","Thanet 007C","E01024714","Total",735,381,24,357,110,40,262,26,236
"2011","Thanet 007D","E01024715","Total",967,424,28,396,158,66,292,26,266
"2011","Thanet 007E","E01024716","Total",845,292,31,261,279,87,262,52,210
"2011","Thanet 008A","E01024636","Total",1088,599,9,590,128,39,357,16,341
"2011","Thanet 008B","E01024637","Total",748,393,11,382,131,38,247,25,222
"2011","Thanet 008C","E01024638","Total",780,431,18,413,130,45,287,21,266
"2011","Thanet 008D","E01024639","Total",826,410,18,392,150,48,276,21,255
"2011","Thanet 008E","E01024640","Total",772,433,12,421,135,58,277,23,254
"2011","Thanet 009A","E01024635","Total",695,264,27,237,197,70,201,38,163
"2011","Thanet 009B","E01024642","Total",730,387,10,377,118,38,215,20,195
"2011","Thanet 009C","E01024644","Total",597,268,6,262,121,34,181,15,166
"2011","Thanet 009D","E01024692","Total",810,365,29,336,205,68,252,24,228
"2011","Thanet 009E","E01024693","Total",597,235,13,222,162,47,182,25,157
"2011","Thanet 010A","E01024643","Total",616,232,21,211,137,39,159,17,142
"2011","Thanet 010B","E01024705","Total",612,241,16,225,106,36,166,16,150
"2011","Thanet 010C","E01024706","Total",644,258,17,241,177,55,170,24,146
"2011","Thanet 010D","E01024707","Total",587,201,16,185,167,63,152,27,125
"2011","Thanet 010E","E01024708","Total",674,333,9,324,122,30,199,16,183
"2011","Thanet 011A","E01024686","Total",717,327,27,300,173,63,252,36,216
"2011","Thanet 011B","E01024688","Total",734,341,25,316,147,57,251,27,224
"2011","Thanet 011C","E01024689","Total",536,224,7,217,132,43,162,19,143
"2011","Thanet 011D","E01024690","Total",643,317,24,293,149,44,229,35,194
"2011","Thanet 011E","E01024691","Total",478,161,21,140,152,53,130,19,111
"2011","Thanet 012A","E01024669","Total",717,204,41,163,261,109,178,37,141
"2011","Thanet 012B","E01024698","Total",633,226,35,191,180,79,151,26,125
"2011","Thanet 012C","E01024699","Total",762,332,88,244,297,126,252,59,193
"2011","Thanet 012D","E01024700","Total",735,237,41,196,267,107,191,43,148
"2011","Thanet 012E","E01024709","Total",603,275,10,265,119,38,200,11,189
"2011","Thanet 013A","E01024682","Total",717,312,97,215,263,129,248,79,169
"2011","Thanet 013B","E01024683","Total",691,373,96,277,245,99,274,58,216
"2011","Thanet 013C","E01024684","Total",642,236,53,183,224,100,211,52,159
"2011","Thanet 013D","E01024685","Total",764,322,72,250,250,103,266,59,207
"2011","Thanet 013E","E01024687","Total",626,285,63,222,206,59,241,49,192
"2011","Thanet 014A","E01024701","Total",853,241,11,230,217,84,225,37,188
"2011","Thanet 014B","E01024702","Total",623,296,16,280,147,56,203,26,177
"2011","Thanet 014C","E01024703","Total",753,268,15,253,197,64,194,24,170
"2011","Thanet 014D","E01024704","Total",719,249,24,225,208,70,181,21,160
"2011","Thanet 015A","E01024645","Total",612,206,39,167,222,92,193,42,151
"2011","Thanet 015B","E01024647","Total",649,172,37,135,216,83,152,40,112
"2011","Thanet 015C","E01024668","Total",485,167,49,118,205,89,121,41,80
"2011","Thanet 015D","E01024670","Total",687,277,59,218,230,111,220,54,166
"2011","Thanet 015E","E01024681","Total",697,203,58,145,272,125,164,46,118
"2011","Thanet 016A","E01024646","Total",943,415,56,359,218,96,262,40,222
"2011","Thanet 016B","E01024648","Total",715,292,29,263,186,82,225,29,196
"2011","Thanet 016C","E01024649","Total",913,371,56,315,197,110,283,45,238
"2011","Thanet 016D","E01024667","Total",972,512,82,430,206,121,369,42,327
"2011","Thanet 016E","E01024671","Total",912,432,48,384,171,81,293,25,268
"2011","Thanet 017A","E01024650","Total",626,237,8,229,152,47,179,25,154
"2011","Thanet 017B","E01024651","Total",685,304,15,289,141,50,198,26,172
"2011","Thanet 017C","E01024652","Total",772,279,10,269,192,63,206,20,186
"2011","Thanet 017D","E01024679","Total",621,340,3,337,88,28,215,13,202
"2011","Thanet 017E","E01024680","Total",703,267,16,251,201,73,210,35,175
"2011","Tonbridge and Malling 001A","E01024719","Total",780,174,20,154,264,100,164,42,122
"2011","Tonbridge and Malling 001B","E01024720","Total",542,170,7,163,159,55,138,25,113
"2011","Tonbridge and Malling 001C","E01024721","Total",507,129,4,125,161,39,117,25,92
"2011","Tonbridge and Malling 001D","E01024722","Total",556,123,7,116,194,69,106,16,90
"2011","Tonbridge and Malling 001E","E01024727","Total",1106,235,19,216,365,140,221,45,176
"2011","Tonbridge and Malling 001F","E01024728","Total",676,191,23,168,198,70,169,26,143
"2011","Tonbridge and Malling 002C","E01024771","Total",764,196,57,139,289,135,165,36,129
"2011","Tonbridge and Malling 002D","E01024772","Total",650,143,22,121,213,82,116,29,87
"2011","Tonbridge and Malling 002E","E01024773","Total",736,223,7,216,173,61,157,21,136
"2011","Tonbridge and Malling 002F","E01024774","Total",1127,276,42,234,336,157,237,39,198
"2011","Tonbridge and Malling 002G","E01032830","Total",1011,330,70,260,345,121,293,61,232
"2011","Tonbridge and Malling 003A","E01024741","Total",557,193,63,130,227,95,165,47,118
"2011","Tonbridge and Malling 003B","E01024761","Total",884,238,23,215,294,114,192,43,149
"2011","Tonbridge and Malling 003C","E01024762","Total",826,168,17,151,262,127,161,34,127
"2011","Tonbridge and Malling 003D","E01024763","Total",529,157,17,140,181,54,114,28,86
"2011","Tonbridge and Malling 003E","E01024764","Total",517,164,13,151,146,52,137,23,114
"2011","Tonbridge and Malling 003F","E01024765","Total",523,141,6,135,165,48,102,29,73
"2011","Tonbridge and Malling 003G","E01024782","Total",481,94,8,86,185,57,80,23,57
"2011","Tonbridge and Malling 003H","E01024785","Total",615,168,13,155,201,80,137,21,116
"2011","Tonbridge and Malling 005A","E01024717","Total",689,352,28,324,176,60,270,35,235
"2011","Tonbridge and Malling 005B","E01024718","Total",522,162,4,158,137,43,108,12,96
"2011","Tonbridge and Malling 005C","E01024735","Total",608,185,12,173,193,67,160,32,128
"2011","Tonbridge and Malling 005D","E01024736","Total",704,234,36,198,222,81,217,48,169
"2011","Tonbridge and Malling 005E","E01024737","Total",937,242,59,183,354,167,194,56,138
"2011","Tonbridge and Malling 006A","E01024723","Total",625,185,11,174,209,77,133,23,110
"2011","Tonbridge and Malling 006B","E01024724","Total",769,243,28,215,267,88,154,25,129
"2011","Tonbridge and Malling 006C","E01024725","Total",656,205,11,194,214,74,159,27,132
"2011","Tonbridge and Malling 006D","E01024726","Total",738,259,20,239,203,76,200,25,175
"2011","Tonbridge and Malling 006E","E01024755","Total",763,199,13,186,290,81,127,32,95
"2011","Tonbridge and Malling 006F","E01024786","Total",782,296,35,261,248,97,251,43,208
"2011","Tonbridge and Malling 007A","E01024746","Total",427,108,14,94,129,32,91,19,72
"2011","Tonbridge and Malling 007C","E01024760","Total",538,117,17,100,277,97,76,27,49
"2011","Tonbridge and Malling 007D","E01024781","Total",810,211,8,203,269,78,166,27,139
"2011","Tonbridge and Malling 007E","E01032825","Total",564,88,26,62,308,155,94,44,50
"2011","Tonbridge and Malling 007F","E01032826","Total",572,65,12,53,283,126,69,29,40
"2011","Tonbridge and Malling 007G","E01032827","Total",571,67,22,45,355,170,60,34,26
"2011","Tonbridge and Malling 007H","E01032828","Total",438,74,9,65,208,82,66,29,37
"2011","Tonbridge and Malling 008A","E01024743","Total",753,249,20,229,215,72,198,37,161
"2011","Tonbridge and Malling 008B","E01024744","Total",793,221,13,208,245,84,158,28,130
"2011","Tonbridge and Malling 008C","E01024745","Total",723,227,12,215,210,58,158,31,127
"2011","Tonbridge and Malling 008D","E01024747","Total",646,238,37,201,187,64,200,36,164
"2011","Tonbridge and Malling 009A","E01024730","Total",548,240,9,231,145,43,150,24,126
"2011","Tonbridge and Malling 009B","E01024731","Total",472,196,6,190,136,45,112,17,95
"2011","Tonbridge and Malling 009C","E01024775","Total",641,259,60,199,212,91,199,46,153
"2011","Tonbridge and Malling 009D","E01024776","Total",509,179,17,162,170,45,142,33,109
"2011","Tonbridge and Malling 009E","E01024777","Total",507,213,20,193,137,48,162,26,136
"2011","Tonbridge and Malling 010A","E01024734","Total",666,232,10,222,187,56,170,16,154
"2011","Tonbridge and Malling 010B","E01024752","Total",639,200,5,195,222,82,159,31,128
"2011","Tonbridge and Malling 010C","E01024753","Total",621,201,11,190,211,64,129,23,106
"2011","Tonbridge and Malling 010D","E01024754","Total",624,143,11,132,228,74,127,28,99
"2011","Tonbridge and Malling 011A","E01024729","Total",712,260,33,227,243,83,199,36,163
"2011","Tonbridge and Malling 011B","E01024748","Total",534,172,4,168,176,34,125,26,99
"2011","Tonbridge and Malling 011C","E01024749","Total",622,227,30,197,222,85,189,37,152
"2011","Tonbridge and Malling 011D","E01024750","Total",630,256,7,249,166,54,182,27,155
"2011","Tonbridge and Malling 011E","E01024751","Total",647,299,6,293,159,47,190,21,169
"2011","Tonbridge and Malling 012A","E01024732","Total",662,126,15,111,183,65,120,22,98
"2011","Tonbridge and Malling 012B","E01024733","Total",704,186,11,175,237,80,124,22,102
"2011","Tonbridge and Malling 012C","E01024756","Total",639,163,30,133,255,100,176,41,135
"2011","Tonbridge and Malling 012D","E01024766","Total",915,238,19,219,242,106,197,23,174
"2011","Tonbridge and Malling 012E","E01024767","Total",546,148,37,111,246,105,126,40,86
"2011","Tonbridge and Malling 012F","E01024768","Total",744,234,14,220,189,74,167,12,155
"2011","Tonbridge and Malling 013A","E01024757","Total",684,183,7,176,204,81,161,25,136
"2011","Tonbridge and Malling 013B","E01024758","Total",625,143,11,132,207,75,131,31,100
"2011","Tonbridge and Malling 013C","E01024778","Total",650,118,13,105,230,99,97,23,74
"2011","Tonbridge and Malling 013D","E01024779","Total",775,201,12,189,204,84,177,23,154
"2011","Tonbridge and Malling 013E","E01024780","Total",598,122,25,97,263,95,108,39,69
"2011","Tonbridge and Malling 014A","E01024740","Total",752,208,18,190,223,86,169,33,136
"2011","Tonbridge and Malling 014B","E01024742","Total",705,245,47,198,252,114,205,50,155
"2011","Tonbridge and Malling 014C","E01024783","Total",726,264,17,247,155,52,214,24,190
"2011","Tonbridge and Malling 014D","E01024784","Total",583,193,7,186,156,65,136,16,120
"2011","Tonbridge and Malling 014E","E01032620","Total",904,285,15,270,234,58,196,21,175
"2011","Tonbridge and Malling 014F","E01032829","Total",541,162,15,147,156,54,119,23,96
"2011","Tunbridge Wells 001A","E01024798","Total",918,218,20,198,312,109,215,40,175
"2011","Tunbridge Wells 001B","E01024811","Total",481,170,9,161,149,34,110,25,85
"2011","Tunbridge Wells 001C","E01024812","Total",501,157,14,143,172,50,123,23,100
"2011","Tunbridge Wells 001D","E01024813","Total",789,235,16,219,187,90,219,35,184
"2011","Tunbridge Wells 001E","E01024814","Total",512,151,4,147,159,58,130,20,110
"2011","Tunbridge Wells 001F","E01024815","Total",501,143,28,115,173,65,122,27,95
"2011","Tunbridge Wells 001G","E01024816","Total",496,120,15,105,214,71,109,29,80
"2011","Tunbridge Wells 002A","E01024837","Total",651,142,21,121,317,103,121,40,81
"2011","Tunbridge Wells 002B","E01024844","Total",660,140,20,120,223,91,146,30,116
"2011","Tunbridge Wells 002C","E01024846","Total",641,165,15,150,210,88,162,23,139
"2011","Tunbridge Wells 002D","E01024849","Total",670,190,17,173,222,79,167,29,138
"2011","Tunbridge Wells 002E","E01024850","Total",475,148,11,137,171,42,85,19,66
"2011","Tunbridge Wells 003A","E01024836","Total",710,181,42,139,234,103,159,35,124
"2011","Tunbridge Wells 003B","E01024839","Total",743,175,19,156,198,69,149,33,116
"2011","Tunbridge Wells 003C","E01024845","Total",529,193,22,171,186,66,139,30,109
"2011","Tunbridge Wells 003D","E01024847","Total",700,194,38,156,221,107,165,32,133
"2011","Tunbridge Wells 003E","E01024848","Total",636,313,18,295,142,54,223,17,206
"2011","Tunbridge Wells 004A","E01024793","Total",677,203,10,193,184,58,139,19,120
"2011","Tunbridge Wells 004B","E01024825","Total",522,143,7,136,162,39,101,19,82
"2011","Tunbridge Wells 004C","E01024826","Total",626,211,5,206,170,53,175,19,156
"2011","Tunbridge Wells 004D","E01024827","Total",614,180,12,168,220,88,154,24,130
"2011","Tunbridge Wells 004E","E01024828","Total",638,192,19,173,204,77,169,31,138
"2011","Tunbridge Wells 005A","E01024840","Total",696,226,83,143,290,130,189,59,130
"2011","Tunbridge Wells 005B","E01024841","Total",856,315,63,252,276,161,272,45,227
"2011","Tunbridge Wells 005C","E01024842","Total",706,248,23,225,188,80,221,30,191
"2011","Tunbridge Wells 005D","E01024843","Total",581,152,42,110,224,107,132,37,95
"2011","Tunbridge Wells 006A","E01024829","Total",654,165,8,157,216,96,143,24,119
"2011","Tunbridge Wells 006B","E01024851","Total",666,183,11,172,221,90,132,21,111
"2011","Tunbridge Wells 006C","E01024852","Total",505,181,5,176,173,45,103,22,81
"2011","Tunbridge Wells 006D","E01024853","Total",538,171,6,165,159,46,134,18,116
"2011","Tunbridge Wells 006E","E01024854","Total",594,165,13,152,239,73,122,25,97
"2011","Tunbridge Wells 007A","E01024799","Total",937,272,7,265,199,86,179,20,159
"2011","Tunbridge Wells 007B","E01024800","Total",657,186,4,182,216,67,123,19,104
"2011","Tunbridge Wells 007C","E01024835","Total",830,140,15,125,309,156,120,27,93
"2011","Tunbridge Wells 007D","E01024838","Total",673,109,6,103,245,99,99,23,76
"2011","Tunbridge Wells 008A","E01024801","Total",1405,265,32,233,218,127,203,19,184
"2011","Tunbridge Wells 008B","E01024802","Total",1082,183,7,176,198,91,155,15,140
"2011","Tunbridge Wells 008C","E01024823","Total",896,242,12,230,176,85,148,20,128
"2011","Tunbridge Wells 008D","E01024833","Total",1247,369,45,324,261,146,276,34,242
"2011","Tunbridge Wells 009A","E01024821","Total",970,375,10,365,209,101,246,16,230
"2011","Tunbridge Wells 009B","E01024822","Total",844,334,18,316,195,68,233,31,202
"2011","Tunbridge Wells 009C","E01024824","Total",617,172,5,167,208,83,111,15,96
"2011","Tunbridge Wells 009D","E01024832","Total",674,121,12,109,221,102,112,29,83
"2011","Tunbridge Wells 009E","E01024834","Total",923,133,29,104,316,170,142,34,108
"2011","Tunbridge Wells 010A","E01024795","Total",591,209,64,145,215,113,174,48,126
"2011","Tunbridge Wells 010B","E01024796","Total",629,192,25,167,161,62,169,25,144
"2011","Tunbridge Wells 010C","E01024830","Total",804,301,33,268,207,94,236,25,211
"2011","Tunbridge Wells 010D","E01024831","Total",618,166,37,129,202,79,150,30,120
"2011","Tunbridge Wells 011A","E01024792","Total",697,164,2,162,236,81,127,21,106
"2011","Tunbridge Wells 011B","E01024794","Total",662,191,31,160,232,103,138,25,113
"2011","Tunbridge Wells 011C","E01024804","Total",546,122,13,109,200,61,96,22,74
"2011","Tunbridge Wells 011D","E01024805","Total",667,173,12,161,226,99,141,25,116
"2011","Tunbridge Wells 011E","E01024806","Total",641,193,11,182,205,72,159,23,136
"2011","Tunbridge Wells 012A","E01024797","Total",743,250,11,239,155,61,165,26,139
"2011","Tunbridge Wells 012B","E01024817","Total",755,223,12,211,222,67,136,26,110
"2011","Tunbridge Wells 012C","E01024818","Total",716,220,15,205,203,64,136,18,118
"2011","Tunbridge Wells 012D","E01024819","Total",859,176,9,167,151,74,136,16,120
"2011","Tunbridge Wells 012E","E01024820","Total",661,179,7,172,248,120,126,28,98
"2011","Tunbridge Wells 013A","E01024787","Total",459,100,12,88,170,52,102,32,70
"2011","Tunbridge Wells 013B","E01024788","Total",606,195,31,164,223,70,179,46,133
"2011","Tunbridge Wells 013C","E01024790","Total",500,200,21,179,113,40,161,19,142
"2011","Tunbridge Wells 013D","E01024791","Total",549,220,17,203,158,31,126,25,101
"2011","Tunbridge Wells 013E","E01024803","Total",847,261,21,240,261,66,174,31,143
"2011","Tunbridge Wells 014A","E01024789","Total",803,242,14,228,225,70,191,21,170
"2011","Tunbridge Wells 014B","E01024807","Total",675,252,26,226,199,80,188,31,157
"2011","Tunbridge Wells 014C","E01024808","Total",709,229,13,216,190,77,163,15,148
"2011","Tunbridge Wells 014D","E01024809","Total",583,167,11,156,181,46,130,27,103
"2011","Tunbridge Wells 014E","E01024810","Total",613,138,17,121,229,73,123,37,86
"2011","Cherwell 001A","E01028479","Total",552,150,6,144,117,44,123,11,112
"2011","Cherwell 001B","E01028480","Total",609,173,9,164,158,59,126,17,109
"2011","Cherwell 001C","E01028508","Total",442,114,5,109,125,28,92,14,78
"2011","Cherwell 001D","E01028509","Total",645,174,2,172,146,48,119,13,106
"2011","Cherwell 002A","E01028441","Total",997,224,53,171,370,213,214,51,163
"2011","Cherwell 002C","E01028443","Total",586,92,12,80,215,92,84,14,70
"2011","Cherwell 002D","E01028444","Total",586,150,14,136,190,67,122,20,102
"2011","Cherwell 002E","E01032943","Total",623,82,27,55,264,137,77,36,41
"2011","Cherwell 002F","E01032944","Total",612,116,17,99,178,90,116,18,98
"2011","Cherwell 003A","E01028445","Total",510,113,32,81,231,109,120,37,83
"2011","Cherwell 003B","E01028446","Total",619,203,19,184,186,85,167,27,140
"2011","Cherwell 003C","E01028447","Total",541,154,21,133,148,75,130,16,114
"2011","Cherwell 003D","E01028448","Total",631,236,32,204,220,108,211,39,172
"2011","Cherwell 004A","E01028435","Total",922,399,39,360,141,89,273,16,257
"2011","Cherwell 004C","E01028437","Total",568,112,11,101,198,96,116,28,88
"2011","Cherwell 004D","E01028438","Total",773,166,25,141,220,117,162,28,134
"2011","Cherwell 004E","E01028439","Total",569,79,13,66,214,88,82,27,55
"2011","Cherwell 004F","E01028440","Total",734,183,41,142,212,138,159,27,132
"2011","Cherwell 004G","E01032941","Total",629,278,35,243,171,90,220,30,190
"2011","Cherwell 004H","E01032942","Total",657,113,44,69,193,131,106,29,77
"2011","Cherwell 005A","E01028449","Total",529,205,39,166,186,84,167,27,140
"2011","Cherwell 005B","E01028450","Total",533,173,66,107,244,118,153,54,99
"2011","Cherwell 005C","E01028451","Total",478,120,25,95,178,63,123,25,98
"2011","Cherwell 005D","E01028452","Total",493,154,50,104,216,96,131,44,87
"2011","Cherwell 005E","E01028453","Total",498,149,44,105,206,96,120,31,89
"2011","Cherwell 005F","E01028454","Total",608,267,60,207,226,94,200,39,161
"2011","Cherwell 006A","E01028430","Total",659,162,12,150,166,86,136,14,122
"2011","Cherwell 006B","E01028431","Total",650,232,10,222,154,50,181,26,155
"2011","Cherwell 006C","E01028432","Total",637,218,11,207,181,54,166,25,141
"2011","Cherwell 006D","E01028433","Total",751,314,9,305,160,55,223,21,202
"2011","Cherwell 006E","E01028434","Total",513,158,4,154,150,53,117,20,97
"2011","Cherwell 007A","E01028426","Total",562,134,12,122,198,52,120,28,92
"2011","Cherwell 007B","E01028427","Total",668,121,21,100,202,123,120,24,96
"2011","Cherwell 007C","E01028428","Total",518,124,4,120,169,59,116,20,96
"2011","Cherwell 007D","E01028429","Total",471,187,1,186,108,39,140,10,130
"2011","Cherwell 008A","E01028422","Total",621,174,17,157,206,77,134,26,108
"2011","Cherwell 008B","E01028423","Total",612,208,11,197,148,50,137,17,120
"2011","Cherwell 008C","E01028475","Total",872,277,8,269,236,73,213,38,175
"2011","Cherwell 008D","E01028476","Total",870,216,11,205,292,107,140,28,112
"2011","Cherwell 009A","E01028474","Total",657,183,14,169,207,69,165,32,133
"2011","Cherwell 009B","E01028485","Total",531,146,7,139,181,54,119,25,94
"2011","Cherwell 009C","E01028486","Total",540,141,3,138,138,45,121,17,104
"2011","Cherwell 009D","E01028503","Total",496,175,5,170,111,36,115,8,107
"2011","Cherwell 009E","E01028504","Total",590,156,3,153,171,58,110,17,93
"2011","Cherwell 010A","E01028481","Total",617,225,9,216,172,54,166,22,144
"2011","Cherwell 010B","E01028482","Total",490,134,2,132,150,52,88,12,76
"2011","Cherwell 010C","E01028505","Total",713,173,26,147,235,106,159,26,133
"2011","Cherwell 010D","E01028506","Total",721,169,15,154,213,99,148,29,119
"2011","Cherwell 010E","E01028507","Total",582,152,2,150,164,52,114,19,95
"2011","Cherwell 011A","E01028425","Total",687,63,18,45,360,226,90,35,55
"2011","Cherwell 011B","E01028477","Total",581,114,9,105,203,86,105,29,76
"2011","Cherwell 011C","E01028478","Total",483,49,13,36,249,110,68,23,45
"2011","Cherwell 011D","E01028483","Total",501,100,4,96,161,59,99,17,82
"2011","Cherwell 011E","E01028484","Total",455,101,6,95,128,37,90,15,75
"2011","Cherwell 011F","E01028499","Total",618,152,3,149,161,55,150,25,125
"2011","Cherwell 012A","E01028459","Total",652,59,13,46,213,112,73,23,50
"2011","Cherwell 012B","E01028460","Total",726,72,22,50,404,183,102,46,56
"2011","Cherwell 012C","E01028461","Total",678,57,15,42,294,125,95,38,57
"2011","Cherwell 012D","E01028462","Total",627,134,13,121,225,92,133,31,102
"2011","Cherwell 013A","E01028455","Total",529,75,14,61,200,73,86,26,60
"2011","Cherwell 013B","E01028456","Total",601,205,23,182,161,75,177,23,154
"2011","Cherwell 013C","E01028457","Total",503,84,6,78,184,73,101,27,74
"2011","Cherwell 013D","E01028458","Total",613,115,24,91,231,113,134,39,95
"2011","Cherwell 013E","E01028467","Total",704,193,11,182,179,90,144,28,116
"2011","Cherwell 014A","E01028466","Total",690,228,38,190,230,107,190,34,156
"2011","Cherwell 014B","E01028469","Total",596,203,5,198,152,51,147,16,131
"2011","Cherwell 014C","E01028470","Total",676,194,17,177,201,77,169,34,135
"2011","Cherwell 014D","E01028471","Total",481,134,36,98,209,83,124,34,90
"2011","Cherwell 014E","E01028472","Total",481,88,6,82,168,69,93,15,78
"2011","Cherwell 014F","E01028473","Total",607,85,3,82,210,90,93,30,63
"2011","Cherwell 015A","E01028463","Total",1029,107,37,70,402,232,106,39,67
"2011","Cherwell 015B","E01028464","Total",576,69,7,62,206,95,79,31,48
"2011","Cherwell 015C","E01028465","Total",531,59,7,52,246,101,68,17,51
"2011","Cherwell 015D","E01028468","Total",986,434,13,421,155,83,334,19,315
"2011","Cherwell 016A","E01028424","Total",639,155,5,150,165,63,133,22,111
"2011","Cherwell 016B","E01028497","Total",589,172,4,168,150,48,125,10,115
"2011","Cherwell 016C","E01028498","Total",638,163,15,148,221,88,140,27,113
"2011","Cherwell 016D","E01028500","Total",505,127,11,116,144,61,122,18,104
"2011","Cherwell 016E","E01028501","Total",467,110,1,109,131,40,94,15,79
"2011","Cherwell 016F","E01028502","Total",497,113,2,111,156,59,106,19,87
"2011","Cherwell 017A","E01028487","Total",532,101,14,87,160,79,104,24,80
"2011","Cherwell 017B","E01028489","Total",617,256,4,252,114,38,159,15,144
"2011","Cherwell 017C","E01028490","Total",496,188,16,172,128,51,130,18,112
"2011","Cherwell 017D","E01028491","Total",665,233,7,226,150,65,198,28,170
"2011","Cherwell 017E","E01028494","Total",458,136,23,113,152,66,135,31,104
"2011","Cherwell 018A","E01028492","Total",600,204,9,195,158,59,155,15,140
"2011","Cherwell 018B","E01028493","Total",531,176,18,158,153,58,133,19,114
"2011","Cherwell 018C","E01028495","Total",517,121,8,113,169,63,107,17,90
"2011","Cherwell 018D","E01028496","Total",501,126,17,109,196,72,119,34,85
"2011","Cherwell 019A","E01028488","Total",625,105,15,90,174,87,102,31,71
"2011","Cherwell 019B","E01028510","Total",636,186,3,183,178,58,145,23,122
"2011","Cherwell 019C","E01028511","Total",716,288,12,276,147,64,169,18,151
"2011","Cherwell 019D","E01028512","Total",603,137,4,133,175,56,135,23,112
"2011","Oxford 001A","E01028594","Total",661,204,13,191,170,44,129,14,115
"2011","Oxford 001B","E01028595","Total",622,178,13,165,193,81,149,31,118
"2011","Oxford 001C","E01028596","Total",673,189,13,176,168,71,151,21,130
"2011","Oxford 001D","E01028597","Total",637,216,27,189,166,64,173,22,151
"2011","Oxford 002C","E01028591","Total",548,150,10,140,141,38,103,17,86
"2011","Oxford 002D","E01028592","Total",504,107,3,104,118,45,101,11,90
"2011","Oxford 002F","E01032554","Total",991,339,11,328,197,67,221,18,203
"2011","Oxford 002G","E01032555","Total",792,225,68,157,295,132,188,46,142
"2011","Oxford 003A","E01028565","Total",511,91,6,85,148,52,65,14,51
"2011","Oxford 003B","E01028583","Total",443,176,14,162,76,23,100,8,92
"2011","Oxford 003C","E01028584","Total",1101,256,33,223,355,147,153,31,122
"2011","Oxford 003D","E01028585","Total",403,90,4,86,84,26,58,6,52
"2011","Oxford 004A","E01028560","Total",672,231,12,219,154,69,183,21,162
"2011","Oxford 004B","E01028561","Total",645,232,14,218,170,62,149,18,131
"2011","Oxford 004C","E01028562","Total",612,166,31,135,213,102,132,29,103
"2011","Oxford 004D","E01028563","Total",587,131,6,125,175,70,107,18,89
"2011","Oxford 005A","E01028513","Total",929,322,103,219,331,183,239,52,187
"2011","Oxford 005B","E01028514","Total",551,198,65,133,222,100,170,53,117
"2011","Oxford 005C","E01028516","Total",703,227,62,165,233,114,195,53,142
"2011","Oxford 005D","E01028538","Total",630,216,31,185,179,80,171,23,148
"2011","Oxford 006A","E01028534","Total",459,166,2,164,116,44,108,11,97
"2011","Oxford 006B","E01028535","Total",661,172,11,161,146,77,117,13,104
"2011","Oxford 006C","E01028536","Total",627,202,15,187,132,68,143,18,125
"2011","Oxford 006D","E01028537","Total",809,218,9,209,129,60,129,9,120
"2011","Oxford 006E","E01028539","Total",666,150,31,119,234,112,132,34,98
"2011","Oxford 006F","E01028540","Total",550,156,10,146,154,58,124,23,101
"2011","Oxford 007A","E01028515","Total",667,141,29,112,227,122,115,25,90
"2011","Oxford 007B","E01028571","Total",676,178,9,169,181,87,148,22,126
"2011","Oxford 007C","E01028572","Total",669,148,18,130,204,96,131,21,110
"2011","Oxford 007D","E01028573","Total",674,175,8,167,214,113,135,27,108
"2011","Oxford 007E","E01028574","Total",620,271,27,244,143,74,189,20,169
"2011","Oxford 008A","E01028521","Total",668,188,6,182,70,22,73,8,65
"2011","Oxford 008B","E01028522","Total",746,313,18,295,79,45,190,9,181
"2011","Oxford 008E","E01033282","Total",1291,388,31,357,222,90,228,17,211
"2011","Oxford 009A","E01028548","Total",760,193,8,185,161,88,164,28,136
"2011","Oxford 009B","E01028549","Total",778,187,6,181,135,73,143,10,133
"2011","Oxford 009C","E01028550","Total",695,225,17,208,94,40,142,10,132
"2011","Oxford 009D","E01028551","Total",623,202,21,181,96,49,84,11,73
"2011","Oxford 010A","E01028523","Total",638,164,31,133,136,72,114,19,95
"2011","Oxford 010B","E01028524","Total",632,272,63,209,199,110,185,29,156
"2011","Oxford 010C","E01028525","Total",706,272,68,204,229,126,213,34,179
"2011","Oxford 010D","E01028526","Total",551,170,13,157,95,39,74,15,59
"2011","Oxford 011A","E01028579","Total",529,128,12,116,83,41,92,17,75
"2011","Oxford 011B","E01028580","Total",573,166,16,150,66,32,112,13,99
"2011","Oxford 011C","E01028581","Total",484,116,7,109,105,31,80,10,70
"2011","Oxford 011D","E01028582","Total",588,245,14,231,64,28,161,13,148
"2011","Oxford 011E","E01028586","Total",684,191,9,182,97,55,97,13,84
"2011","Oxford 011F","E01028587","Total",755,225,29,196,121,70,132,25,107
"2011","Oxford 011G","E01028588","Total",467,119,7,112,55,28,64,8,56
"2011","Oxford 012A","E01028541","Total",616,141,10,131,153,77,114,11,103
"2011","Oxford 012B","E01028542","Total",755,161,32,129,186,97,126,24,102
"2011","Oxford 012C","E01028543","Total",621,225,16,209,131,62,176,16,160
"2011","Oxford 012D","E01028544","Total",600,205,12,193,99,48,111,13,98
"2011","Oxford 013A","E01028531","Total",867,145,23,122,187,107,140,28,112
"2011","Oxford 013B","E01028532","Total",1004,262,35,227,217,109,189,32,157
"2011","Oxford 013C","E01028533","Total",820,208,70,138,257,144,155,50,105
"2011","Oxford 013D","E01028556","Total",696,155,47,108,221,121,106,21,85
"2011","Oxford 013E","E01028557","Total",699,207,48,159,250,134,178,44,134
"2011","Oxford 013F","E01028558","Total",588,141,21,120,192,88,143,28,115
"2011","Oxford 013G","E01028559","Total",643,151,21,130,162,80,156,32,124
"2011","Oxford 014A","E01028545","Total",612,114,12,102,168,74,81,17,64
"2011","Oxford 014B","E01028546","Total",745,258,44,214,214,98,239,43,196
"2011","Oxford 014C","E01028547","Total",830,141,14,127,198,117,115,24,91
"2011","Oxford 015A","E01028527","Total",685,180,25,155,190,96,157,25,132
"2011","Oxford 015B","E01028528","Total",537,128,19,109,170,88,104,26,78
"2011","Oxford 015C","E01028529","Total",632,227,55,172,204,110,182,37,145
"2011","Oxford 015D","E01028530","Total",633,183,36,147,205,98,165,31,134
"2011","Oxford 015E","E01028575","Total",675,205,14,191,146,66,160,24,136
"2011","Oxford 015F","E01028578","Total",638,188,9,179,155,77,162,20,142
"2011","Oxford 016A","E01028552","Total",731,287,74,213,245,132,195,44,151
"2011","Oxford 016B","E01028553","Total",752,174,44,130,198,97,127,21,106
"2011","Oxford 016C","E01028554","Total",546,158,25,133,141,71,133,25,108
"2011","Oxford 016D","E01028555","Total",665,165,22,143,188,91,141,24,117
"2011","Oxford 016E","E01028576","Total",489,171,71,100,226,116,128,39,89
"2011","Oxford 016F","E01028577","Total",753,281,83,198,261,129,210,46,164
"2011","Oxford 017A","E01028517","Total",509,135,49,86,205,94,121,38,83
"2011","Oxford 017B","E01028518","Total",676,272,73,199,247,106,205,41,164
"2011","Oxford 017C","E01028519","Total",544,181,48,133,198,76,165,42,123
"2011","Oxford 017D","E01028567","Total",661,232,66,166,264,113,206,60,146
"2011","Oxford 018A","E01028520","Total",632,248,88,160,272,137,197,53,144
"2011","Oxford 018B","E01028568","Total",623,288,94,194,273,136,182,38,144
"2011","Oxford 018C","E01028569","Total",664,201,95,106,322,143,161,60,101
"2011","Oxford 018D","E01028570","Total",773,122,58,64,344,220,100,27,73
"2011","South Oxfordshire 001A","E01028666","Total",685,153,9,144,189,77,129,18,111
"2011","South Oxfordshire 001B","E01028667","Total",525,66,8,58,218,75,63,11,52
"2011","South Oxfordshire 001C","E01028668","Total",552,133,2,131,171,56,128,24,104
"2011","South Oxfordshire 001D","E01028669","Total",539,138,7,131,170,65,96,18,78
"2011","South Oxfordshire 002A","E01028638","Total",563,135,9,126,151,38,129,20,109
"2011","South Oxfordshire 002B","E01028639","Total",500,115,9,106,149,45,107,21,86
"2011","South Oxfordshire 002C","E01028640","Total",583,169,15,154,166,68,136,26,110
"2011","South Oxfordshire 002D","E01028683","Total",568,186,6,180,139,36,132,22,110
"2011","South Oxfordshire 003A","E01028670","Total",554,160,6,154,185,65,124,14,110
"2011","South Oxfordshire 003B","E01028671","Total",669,266,12,254,156,72,187,27,160
"2011","South Oxfordshire 003C","E01028672","Total",695,232,12,220,197,79,147,23,124
"2011","South Oxfordshire 003D","E01028673","Total",504,107,12,95,173,74,90,19,71
"2011","South Oxfordshire 004A","E01028646","Total",466,120,10,110,132,54,91,16,75
"2011","South Oxfordshire 004B","E01028647","Total",617,133,10,123,190,78,120,23,97
"2011","South Oxfordshire 004C","E01028681","Total",522,156,6,150,143,50,120,9,111
"2011","South Oxfordshire 004D","E01028682","Total",503,179,5,174,128,45,143,20,123
"2011","South Oxfordshire 004E","E01028684","Total",637,171,3,168,151,62,139,18,121
"2011","South Oxfordshire 005A","E01028598","Total",951,218,11,207,271,90,199,29,170
"2011","South Oxfordshire 005B","E01028613","Total",523,90,3,87,206,72,84,18,66
"2011","South Oxfordshire 005C","E01028614","Total",601,163,13,150,186,66,142,20,122
"2011","South Oxfordshire 005D","E01028615","Total",677,255,8,247,142,41,169,16,153
"2011","South Oxfordshire 005E","E01028616","Total",533,100,6,94,173,52,98,18,80
"2011","South Oxfordshire 006A","E01028604","Total",552,131,31,100,217,114,138,37,101
"2011","South Oxfordshire 006B","E01028605","Total",637,207,27,180,195,76,181,32,149
"2011","South Oxfordshire 006C","E01028607","Total",496,111,10,101,139,48,109,20,89
"2011","South Oxfordshire 006D","E01028641","Total",503,156,3,153,125,39,112,22,90
"2011","South Oxfordshire 006E","E01028657","Total",548,136,8,128,113,48,134,21,113
"2011","South Oxfordshire 006F","E01028658","Total",490,127,9,118,151,47,106,16,90
"2011","South Oxfordshire 007A","E01028600","Total",629,201,7,194,182,53,137,18,119
"2011","South Oxfordshire 007B","E01028603","Total",458,98,7,91,147,50,97,15,82
"2011","South Oxfordshire 007C","E01028606","Total",756,270,12,258,190,56,181,23,158
"2011","South Oxfordshire 007D","E01028609","Total",490,106,4,102,180,59,103,19,84
"2011","South Oxfordshire 007E","E01028610","Total",601,155,7,148,161,51,146,34,112
"2011","South Oxfordshire 008A","E01028678","Total",631,168,7,161,197,73,111,19,92
"2011","South Oxfordshire 008B","E01028679","Total",853,216,19,197,249,93,183,21,162
"2011","South Oxfordshire 008C","E01028680","Total",768,257,6,251,207,98,192,22,170
"2011","South Oxfordshire 009A","E01028625","Total",772,61,8,53,326,174,93,39,54
"2011","South Oxfordshire 009B","E01028626","Total",618,44,7,37,260,107,84,31,53
"2011","South Oxfordshire 009C","E01028627","Total",611,84,25,59,246,102,80,21,59
"2011","South Oxfordshire 009D","E01028628","Total",540,52,11,41,239,94,75,23,52
"2011","South Oxfordshire 009E","E01028629","Total",632,76,16,60,212,93,84,30,54
"2011","South Oxfordshire 010A","E01028621","Total",508,124,46,78,235,115,113,42,71
"2011","South Oxfordshire 010B","E01028622","Total",529,188,12,176,138,48,129,16,113
"2011","South Oxfordshire 010C","E01028623","Total",656,176,19,157,195,78,164,30,134
"2011","South Oxfordshire 010D","E01028624","Total",572,190,10,180,139,47,159,20,139
"2011","South Oxfordshire 011A","E01028599","Total",598,186,3,183,140,49,135,16,119
"2011","South Oxfordshire 011B","E01028601","Total",469,95,3,92,173,74,83,15,68
"2011","South Oxfordshire 011C","E01028602","Total",519,36,1,35,301,177,55,24,31
"2011","South Oxfordshire 011D","E01028620","Total",973,231,11,220,300,109,201,35,166
"2011","South Oxfordshire 012A","E01028608","Total",465,132,5,127,156,51,93,12,81
"2011","South Oxfordshire 012B","E01028617","Total",789,217,8,209,230,97,162,26,136
"2011","South Oxfordshire 012C","E01028674","Total",542,168,6,162,154,66,121,21,100
"2011","South Oxfordshire 012D","E01028675","Total",505,148,12,136,166,68,129,27,102
"2011","South Oxfordshire 012E","E01028676","Total",826,208,21,187,256,118,172,25,147
"2011","South Oxfordshire 012F","E01028677","Total",774,298,15,283,138,77,201,16,185
"2011","South Oxfordshire 013A","E01028630","Total",703,86,18,68,216,100,107,29,78
"2011","South Oxfordshire 013B","E01028631","Total",458,130,8,122,131,61,142,23,119
"2011","South Oxfordshire 013C","E01028632","Total",534,139,30,109,190,73,154,36,118
"2011","South Oxfordshire 013D","E01028633","Total",689,151,37,114,196,96,142,26,116
"2011","South Oxfordshire 014A","E01028634","Total",509,151,3,148,165,66,120,22,98
"2011","South Oxfordshire 014B","E01028635","Total",616,185,24,161,179,72,161,27,134
"2011","South Oxfordshire 014C","E01028636","Total",566,253,28,225,165,61,220,38,182
"2011","South Oxfordshire 014D","E01028637","Total",620,160,3,157,183,72,135,22,113
"2011","South Oxfordshire 015A","E01028618","Total",702,164,7,157,211,87,124,21,103
"2011","South Oxfordshire 015B","E01028619","Total",740,234,19,215,228,103,182,33,149
"2011","South Oxfordshire 015C","E01028644","Total",701,257,9,248,167,60,156,9,147
"2011","South Oxfordshire 015D","E01028648","Total",472,138,5,133,138,51,111,15,96
"2011","South Oxfordshire 015E","E01028649","Total",595,149,12,137,192,68,113,21,92
"2011","South Oxfordshire 016A","E01028650","Total",820,274,19,255,244,96,161,28,133
"2011","South Oxfordshire 016B","E01028651","Total",754,320,17,303,143,62,211,10,201
"2011","South Oxfordshire 016C","E01028652","Total",1042,406,11,395,187,90,218,15,203
"2011","South Oxfordshire 017A","E01028653","Total",633,152,7,145,202,89,97,14,83
"2011","South Oxfordshire 017B","E01028654","Total",615,171,10,161,239,83,146,28,118
"2011","South Oxfordshire 017C","E01028655","Total",860,245,16,229,202,102,156,17,139
"2011","South Oxfordshire 017D","E01028656","Total",533,211,7,204,145,58,121,13,108
"2011","South Oxfordshire 018A","E01028611","Total",445,105,4,101,135,41,75,12,63
"2011","South Oxfordshire 018B","E01028642","Total",492,147,6,141,169,59,97,15,82
"2011","South Oxfordshire 018C","E01028643","Total",560,175,9,166,171,57,127,19,108
"2011","South Oxfordshire 018D","E01028645","Total",627,265,5,260,128,40,135,15,120
"2011","South Oxfordshire 018E","E01028685","Total",485,142,7,135,140,48,116,19,97
"2011","South Oxfordshire 018F","E01028686","Total",473,119,6,113,142,39,94,11,83
"2011","South Oxfordshire 019A","E01028612","Total",511,127,6,121,149,49,75,12,63
"2011","South Oxfordshire 019B","E01028660","Total",687,187,15,172,218,76,144,24,120
"2011","South Oxfordshire 019C","E01028661","Total",577,176,5,171,168,44,116,17,99
"2011","South Oxfordshire 019D","E01028662","Total",503,147,6,141,166,50,93,20,73
"2011","South Oxfordshire 020A","E01028659","Total",624,163,5,158,192,64,112,11,101
"2011","South Oxfordshire 020B","E01028663","Total",611,190,18,172,202,75,140,29,111
"2011","South Oxfordshire 020C","E01028664","Total",543,228,5,223,138,45,133,9,124
"2011","South Oxfordshire 020D","E01028665","Total",527,181,6,175,158,59,125,15,110
"2011","Vale of White Horse 001A","E01028708","Total",747,215,10,205,177,56,193,31,162
"2011","Vale of White Horse 001B","E01028709","Total",658,168,7,161,161,47,122,17,105
"2011","Vale of White Horse 001C","E01028710","Total",667,192,6,186,198,59,132,19,113
"2011","Vale of White Horse 001D","E01028711","Total",667,196,11,185,206,71,138,23,115
"2011","Vale of White Horse 002A","E01028733","Total",547,196,6,190,136,49,141,17,124
"2011","Vale of White Horse 002B","E01028734","Total",655,198,4,194,152,45,140,15,125
"2011","Vale of White Horse 002C","E01028735","Total",641,221,16,205,197,67,154,16,138
"2011","Vale of White Horse 002D","E01028740","Total",657,190,8,182,175,69,152,25,127
"2011","Vale of White Horse 002E","E01028741","Total",502,120,8,112,158,54,89,19,70
"2011","Vale of White Horse 002F","E01028742","Total",726,254,16,238,153,56,203,26,177
"2011","Vale of White Horse 003A","E01028738","Total",474,60,13,47,273,165,77,36,41
"2011","Vale of White Horse 003B","E01028739","Total",699,225,10,215,195,85,173,20,153
"2011","Vale of White Horse 003C","E01028743","Total",478,168,2,166,88,34,113,8,105
"2011","Vale of White Horse 003D","E01028744","Total",524,166,7,159,122,34,129,15,114
"2011","Vale of White Horse 003E","E01028750","Total",589,201,11,190,196,91,165,18,147
"2011","Vale of White Horse 003F","E01028751","Total",585,138,8,130,164,46,123,24,99
"2011","Vale of White Horse 003G","E01028752","Total",656,181,11,170,205,65,135,21,114
"2011","Vale of White Horse 004A","E01028693","Total",603,145,6,139,219,79,126,24,102
"2011","Vale of White Horse 004B","E01028694","Total",607,69,6,63,213,82,78,21,57
"2011","Vale of White Horse 004C","E01028701","Total",638,172,18,154,218,86,140,27,113
"2011","Vale of White Horse 004D","E01028705","Total",490,106,4,102,146,46,77,13,64
"2011","Vale of White Horse 004E","E01028706","Total",599,116,2,114,185,68,95,17,78
"2011","Vale of White Horse 004F","E01028707","Total",607,94,8,86,203,87,87,21,66
"2011","Vale of White Horse 005A","E01028688","Total",507,85,7,78,153,76,92,17,75
"2011","Vale of White Horse 005B","E01028689","Total",637,113,19,94,208,91,90,28,62
"2011","Vale of White Horse 005C","E01028695","Total",656,192,13,179,199,81,142,14,128
"2011","Vale of White Horse 005D","E01028699","Total",650,217,6,211,202,77,145,14,131
"2011","Vale of White Horse 006B","E01028696","Total",519,175,2,173,161,49,111,17,94
"2011","Vale of White Horse 006C","E01028697","Total",674,205,34,171,205,81,165,31,134
"2011","Vale of White Horse 006D","E01028698","Total",669,121,8,113,189,101,88,12,76
"2011","Vale of White Horse 006E","E01028700","Total",699,241,40,201,243,107,206,39,167
"2011","Vale of White Horse 006F","E01028703","Total",816,224,25,199,204,91,190,31,159
"2011","Vale of White Horse 006G","E01033305","Total",664,136,27,109,152,95,91,16,75
"2011","Vale of White Horse 006H","E01033306","Total",804,255,16,239,153,83,194,20,174
"2011","Vale of White Horse 007A","E01028726","Total",929,315,9,306,235,73,204,31,173
"2011","Vale of White Horse 007B","E01028736","Total",935,223,8,215,306,95,183,34,149
"2011","Vale of White Horse 007C","E01028737","Total",948,256,11,245,273,77,193,29,164
"2011","Vale of White Horse 008A","E01028690","Total",712,212,22,190,172,78,166,21,145
"2011","Vale of White Horse 008B","E01028691","Total",611,221,11,210,149,55,199,29,170
"2011","Vale of White Horse 008C","E01028692","Total",507,164,52,112,221,86,147,49,98
"2011","Vale of White Horse 008D","E01028702","Total",518,144,4,140,122,44,109,12,97
"2011","Vale of White Horse 008E","E01028704","Total",853,292,25,267,224,96,224,28,196
"2011","Vale of White Horse 009A","E01028716","Total",749,150,36,114,296,143,119,35,84
"2011","Vale of White Horse 009B","E01028717","Total",820,292,21,271,183,82,228,18,210
"2011","Vale of White Horse 009C","E01028718","Total",609,151,31,120,209,92,160,38,122
"2011","Vale of White Horse 009D","E01028719","Total",654,199,7,192,170,59,154,30,124
"2011","Vale of White Horse 009E","E01028749","Total",990,266,17,249,308,121,207,36,171
"2011","Vale of White Horse 010A","E01028714","Total",958,299,16,283,280,96,228,33,195
"2011","Vale of White Horse 010B","E01028731","Total",542,192,10,182,157,54,164,23,141
"2011","Vale of White Horse 010C","E01028732","Total",502,104,15,89,153,59,94,29,65
"2011","Vale of White Horse 010D","E01028753","Total",585,176,10,166,170,66,173,31,142
"2011","Vale of White Horse 010E","E01028754","Total",569,152,12,140,154,40,117,20,97
"2011","Vale of White Horse 011A","E01028721","Total",517,75,9,66,200,70,75,18,57
"2011","Vale of White Horse 011B","E01028722","Total",690,221,9,212,174,78,145,22,123
"2011","Vale of White Horse 011C","E01028723","Total",590,239,12,227,153,52,155,17,138
"2011","Vale of White Horse 011D","E01028724","Total",505,118,8,110,160,64,92,22,70
"2011","Vale of White Horse 011E","E01028725","Total",616,127,19,108,216,98,115,21,94
"2011","Vale of White Horse 014A","E01028755","Total",686,238,9,229,208,75,183,27,156
"2011","Vale of White Horse 014B","E01028756","Total",1167,348,47,301,277,164,225,31,194
"2011","Vale of White Horse 014C","E01028758","Total",609,230,5,225,177,54,167,21,146
"2011","Vale of White Horse 014D","E01028759","Total",623,178,16,162,174,58,148,28,120
"2011","Vale of White Horse 014E","E01028760","Total",479,98,4,94,170,64,110,29,81
"2011","Vale of White Horse 014F","E01028761","Total",510,105,9,96,183,70,88,25,63
"2011","Vale of White Horse 015A","E01028712","Total",880,299,8,291,218,65,193,21,172
"2011","Vale of White Horse 015B","E01028727","Total",661,202,8,194,200,70,143,19,124
"2011","Vale of White Horse 015C","E01028728","Total",479,152,12,140,140,67,123,22,101
"2011","Vale of White Horse 015D","E01028729","Total",437,88,5,83,137,62,83,13,70
"2011","Vale of White Horse 015E","E01028730","Total",648,143,9,134,196,63,119,27,92
"2011","Vale of White Horse 015F","E01028757","Total",643,229,28,201,187,66,162,27,135
"2011","Vale of White Horse 016E","E01028713","Total",972,256,21,235,262,101,191,25,166
"2011","Vale of White Horse 016F","E01028715","Total",554,122,9,113,180,69,113,27,86
"2011","Vale of White Horse 016G","E01028720","Total",910,263,17,246,238,85,198,41,157
"2011","Vale of White Horse 016A","E01028745","Total",546,177,8,169,144,55,90,11,79
"2011","Vale of White Horse 016B","E01028746","Total",510,162,8,154,142,50,112,16,96
"2011","Vale of White Horse 016C","E01028747","Total",450,72,9,63,212,122,76,24,52
"2011","Vale of White Horse 016D","E01028748","Total",423,103,12,91,174,111,75,11,64
"2011","West Oxfordshire 001A","E01028780","Total",909,263,12,251,230,105,180,20,160
"2011","West Oxfordshire 001B","E01028781","Total",516,176,22,154,167,61,166,34,132
"2011","West Oxfordshire 001C","E01028782","Total",643,182,6,176,188,66,128,19,109
"2011","West Oxfordshire 001D","E01028783","Total",747,260,10,250,161,77,184,12,172
"2011","West Oxfordshire 002A","E01028795","Total",658,159,7,152,165,51,145,19,126
"2011","West Oxfordshire 002B","E01028796","Total",518,138,8,130,146,53,118,12,106
"2011","West Oxfordshire 002C","E01028797","Total",453,103,0,103,131,50,95,18,77
"2011","West Oxfordshire 002D","E01028806","Total",816,217,6,211,234,89,183,23,160
"2011","West Oxfordshire 003A","E01028763","Total",831,250,5,245,215,78,197,25,172
"2011","West Oxfordshire 003B","E01028776","Total",809,230,7,223,202,78,166,20,146
"2011","West Oxfordshire 003C","E01028798","Total",871,277,11,266,243,76,181,20,161
"2011","West Oxfordshire 004B","E01028804","Total",544,176,7,169,169,51,114,21,93
"2011","West Oxfordshire 004D","E01028823","Total",634,193,10,183,127,57,147,5,142
"2011","West Oxfordshire 004E","E01028824","Total",664,213,12,201,194,73,172,23,149
"2011","West Oxfordshire 004F","E01028825","Total",497,144,6,138,139,59,94,9,85
"2011","West Oxfordshire 004G","E01032954","Total",1130,313,24,289,325,113,244,34,210
"2011","West Oxfordshire 005A","E01028777","Total",530,158,7,151,120,39,124,25,99
"2011","West Oxfordshire 005B","E01028778","Total",658,225,9,216,162,58,180,19,161
"2011","West Oxfordshire 005C","E01028779","Total",452,113,5,108,110,36,121,20,101
"2011","West Oxfordshire 005D","E01028799","Total",779,256,9,247,211,70,204,34,170
"2011","West Oxfordshire 006A","E01028788","Total",700,207,10,197,168,73,157,22,135
"2011","West Oxfordshire 006B","E01028789","Total",605,179,0,179,169,49,117,19,98
"2011","West Oxfordshire 006C","E01028790","Total",465,140,2,138,143,48,104,17,87
"2011","West Oxfordshire 006D","E01028791","Total",587,173,2,171,164,56,114,11,103
"2011","West Oxfordshire 007A","E01028784","Total",853,225,10,215,240,89,174,26,148
"2011","West Oxfordshire 007B","E01028792","Total",459,130,2,128,102,32,91,9,82
"2011","West Oxfordshire 007C","E01028793","Total",620,152,17,135,202,67,135,33,102
"2011","West Oxfordshire 007D","E01028794","Total",578,157,6,151,157,53,159,20,139
"2011","West Oxfordshire 008A","E01028810","Total",587,92,3,89,180,62,95,18,77
"2011","West Oxfordshire 008B","E01028811","Total",592,181,19,162,181,77,166,26,140
"2011","West Oxfordshire 008D","E01028813","Total",489,133,21,112,176,63,139,33,106
"2011","West Oxfordshire 008E","E01028814","Total",606,172,8,164,159,54,118,15,103
"2011","West Oxfordshire 008F","E01028815","Total",497,144,3,141,136,41,115,17,98
"2011","West Oxfordshire 008G","E01032947","Total",693,76,29,47,323,190,93,41,52
"2011","West Oxfordshire 008H","E01032948","Total",706,138,13,125,269,135,108,22,86
"2011","West Oxfordshire 008I","E01032952","Total",620,161,10,151,158,56,108,19,89
"2011","West Oxfordshire 009A","E01028809","Total",522,192,36,156,183,82,140,35,105
"2011","West Oxfordshire 009B","E01028820","Total",525,75,5,70,193,86,71,21,50
"2011","West Oxfordshire 009C","E01028821","Total",626,108,10,98,217,92,104,25,79
"2011","West Oxfordshire 009D","E01028822","Total",578,79,1,78,191,71,87,19,68
"2011","West Oxfordshire 010A","E01028807","Total",1005,267,26,241,213,112,213,31,182
"2011","West Oxfordshire 010B","E01028808","Total",725,210,15,195,206,67,150,29,121
"2011","West Oxfordshire 010C","E01028816","Total",491,109,10,99,170,57,94,21,73
"2011","West Oxfordshire 010D","E01028817","Total",591,146,13,133,184,65,120,20,100
"2011","West Oxfordshire 010E","E01028818","Total",836,343,20,323,178,77,223,15,208
"2011","West Oxfordshire 010F","E01028819","Total",732,341,30,311,183,80,263,32,231
"2011","West Oxfordshire 011A","E01028785","Total",658,176,8,168,181,65,150,24,126
"2011","West Oxfordshire 011B","E01028786","Total",518,168,4,164,127,33,140,13,127
"2011","West Oxfordshire 011C","E01028787","Total",542,180,18,162,149,59,147,29,118
"2011","West Oxfordshire 011D","E01028800","Total",518,117,9,108,174,69,115,19,96
"2011","West Oxfordshire 012A","E01028762","Total",749,176,11,165,207,83,153,23,130
"2011","West Oxfordshire 012B","E01028766","Total",834,208,8,200,214,87,174,26,148
"2011","West Oxfordshire 012C","E01028767","Total",863,365,15,350,146,66,221,24,197
"2011","West Oxfordshire 013D","E01028772","Total",748,146,9,137,183,93,118,17,101
"2011","West Oxfordshire 013E","E01032949","Total",577,47,12,35,226,91,62,26,36
"2011","West Oxfordshire 013F","E01032950","Total",679,55,13,42,287,160,64,25,39
"2011","West Oxfordshire 013G","E01032951","Total",710,92,16,76,342,161,115,42,73
"2011","West Oxfordshire 013H","E01032953","Total",850,123,11,112,359,206,147,38,109
"2011","West Oxfordshire 014A","E01028771","Total",653,236,20,216,149,53,196,25,171
"2011","West Oxfordshire 014B","E01028773","Total",578,163,10,153,139,45,126,10,116
"2011","West Oxfordshire 014C","E01028774","Total",531,100,12,88,245,88,122,39,83
"2011","West Oxfordshire 014D","E01028775","Total",559,124,7,117,145,35,119,22,97
"2011","West Oxfordshire 015A","E01028764","Total",760,246,10,236,182,67,190,25,165
"2011","West Oxfordshire 015B","E01028765","Total",822,280,20,260,231,85,219,30,189
"2011","West Oxfordshire 015C","E01028801","Total",545,139,7,132,170,54,114,21,93
"2011","West Oxfordshire 015D","E01028802","Total",600,172,5,167,172,46,122,14,108
"2011","Elmbridge 001A","E01030330","Total",655,178,14,164,193,88,135,20,115
"2011","Elmbridge 001B","E01030331","Total",679,165,14,151,189,69,132,25,107
"2011","Elmbridge 001C","E01030332","Total",593,195,21,174,191,63,158,30,128
"2011","Elmbridge 001D","E01030333","Total",582,169,8,161,180,67,128,22,106
"2011","Elmbridge 002A","E01030326","Total",785,200,8,192,164,64,132,9,123
"2011","Elmbridge 002B","E01030327","Total",642,159,2,157,202,78,113,24,89
"2011","Elmbridge 002C","E01030328","Total",630,145,5,140,243,103,100,18,82
"2011","Elmbridge 002D","E01030329","Total",628,173,9,164,179,70,117,19,98
"2011","Elmbridge 003A","E01030334","Total",543,141,13,128,176,65,118,28,90
"2011","Elmbridge 003B","E01030335","Total",755,202,18,184,251,95,144,29,115
"2011","Elmbridge 003C","E01030336","Total",795,215,43,172,275,138,186,34,152
"2011","Elmbridge 003D","E01030337","Total",731,248,11,237,187,87,214,25,189
"2011","Elmbridge 004A","E01030361","Total",811,185,16,169,274,129,163,38,125
"2011","Elmbridge 004B","E01030362","Total",481,141,28,113,163,60,112,24,88
"2011","Elmbridge 004C","E01030363","Total",785,206,37,169,248,139,168,26,142
"2011","Elmbridge 004D","E01030364","Total",710,148,31,117,209,104,150,25,125
"2011","Elmbridge 005A","E01030350","Total",686,183,17,166,224,107,109,21,88
"2011","Elmbridge 005B","E01030351","Total",634,135,8,127,217,119,121,22,99
"2011","Elmbridge 005C","E01030352","Total",581,156,9,147,222,85,105,17,88
"2011","Elmbridge 005D","E01030353","Total",550,100,6,94,229,90,84,15,69
"2011","Elmbridge 006A","E01030322","Total",751,162,18,144,263,153,127,25,102
"2011","Elmbridge 006B","E01030323","Total",524,147,8,139,189,88,98,16,82
"2011","Elmbridge 006C","E01030324","Total",639,148,10,138,232,97,112,16,96
"2011","Elmbridge 006D","E01030325","Total",590,183,10,173,211,75,143,20,123
"2011","Elmbridge 007A","E01030357","Total",729,240,11,229,175,86,159,22,137
"2011","Elmbridge 007B","E01030358","Total",618,170,9,161,180,75,120,19,101
"2011","Elmbridge 007C","E01030359","Total",1054,263,37,226,263,128,209,28,181
"2011","Elmbridge 007D","E01030360","Total",662,174,24,150,207,73,120,13,107
"2011","Elmbridge 008A","E01030354","Total",541,137,45,92,236,104,129,38,91
"2011","Elmbridge 008B","E01030355","Total",515,114,12,102,200,88,98,22,76
"2011","Elmbridge 008C","E01030356","Total",507,124,13,111,204,93,102,26,76
"2011","Elmbridge 008D","E01030365","Total",603,133,12,121,213,87,95,22,73
"2011","Elmbridge 008E","E01030368","Total",607,174,13,161,219,98,103,23,80
"2011","Elmbridge 009A","E01030319","Total",608,154,19,135,275,96,95,21,74
"2011","Elmbridge 009B","E01030320","Total",678,184,13,171,260,100,159,20,139
"2011","Elmbridge 009C","E01030321","Total",573,158,8,150,224,65,115,22,93
"2011","Elmbridge 009D","E01030369","Total",775,172,11,161,352,120,114,19,95
"2011","Elmbridge 009E","E01030370","Total",592,121,12,109,263,109,104,20,84
"2011","Elmbridge 010A","E01030313","Total",644,179,17,162,219,105,152,23,129
"2011","Elmbridge 010B","E01030314","Total",645,192,3,189,206,93,115,8,107
"2011","Elmbridge 010C","E01030366","Total",815,192,10,182,212,90,127,17,110
"2011","Elmbridge 010D","E01030367","Total",618,184,7,177,190,77,128,21,107
"2011","Elmbridge 011A","E01030338","Total",619,168,8,160,264,126,92,17,75
"2011","Elmbridge 011B","E01030339","Total",683,214,13,201,158,86,131,18,113
"2011","Elmbridge 011C","E01030340","Total",620,192,13,179,191,70,116,11,105
"2011","Elmbridge 011D","E01030341","Total",740,219,6,213,225,85,138,14,124
"2011","Elmbridge 012A","E01030371","Total",711,208,18,190,173,73,159,25,134
"2011","Elmbridge 012B","E01030372","Total",546,161,4,157,197,77,122,9,113
"2011","Elmbridge 012C","E01030373","Total",657,151,12,139,225,108,120,20,100
"2011","Elmbridge 012D","E01030374","Total",771,214,10,204,166,71,150,17,133
"2011","Elmbridge 012E","E01030375","Total",781,178,11,167,225,115,122,18,104
"2011","Elmbridge 012F","E01030376","Total",536,129,9,120,179,68,63,8,55
"2011","Elmbridge 013A","E01030307","Total",646,150,8,142,227,76,94,15,79
"2011","Elmbridge 013B","E01030308","Total",645,196,8,188,204,62,116,16,100
"2011","Elmbridge 013C","E01030309","Total",619,211,14,197,191,52,120,20,100
"2011","Elmbridge 013D","E01030310","Total",728,161,43,118,292,124,145,37,108
"2011","Elmbridge 014A","E01030311","Total",662,243,30,213,198,84,178,25,153
"2011","Elmbridge 014B","E01030312","Total",518,112,19,93,179,73,119,34,85
"2011","Elmbridge 014C","E01030315","Total",636,150,17,133,237,91,116,23,93
"2011","Elmbridge 014D","E01030316","Total",635,178,11,167,216,84,112,23,89
"2011","Elmbridge 014E","E01030317","Total",749,242,13,229,193,96,163,22,141
"2011","Elmbridge 014F","E01030318","Total",644,354,6,348,150,39,219,18,201
"2011","Elmbridge 015A","E01030296","Total",649,176,7,169,249,86,110,20,90
"2011","Elmbridge 015B","E01030297","Total",823,234,14,220,304,97,180,33,147
"2011","Elmbridge 015C","E01030298","Total",679,263,17,246,203,82,187,23,164
"2011","Elmbridge 015D","E01030299","Total",637,150,9,141,233,91,125,29,96
"2011","Elmbridge 016A","E01030346","Total",519,98,14,84,205,73,59,16,43
"2011","Elmbridge 016B","E01030347","Total",681,126,21,105,245,102,96,26,70
"2011","Elmbridge 016C","E01030348","Total",664,156,4,152,222,83,90,20,70
"2011","Elmbridge 016D","E01030349","Total",703,197,6,191,202,90,106,12,94
"2011","Elmbridge 017A","E01030300","Total",756,269,22,247,209,102,198,28,170
"2011","Elmbridge 017B","E01030301","Total",601,205,14,191,224,71,115,20,95
"2011","Elmbridge 017C","E01030302","Total",711,235,8,227,167,73,147,19,128
"2011","Elmbridge 017D","E01030304","Total",696,206,38,168,219,96,168,35,133
"2011","Elmbridge 017E","E01030305","Total",520,128,13,115,245,80,65,11,54
"2011","Elmbridge 017F","E01030306","Total",481,125,15,110,237,60,80,16,64
"2011","Elmbridge 018A","E01030303","Total",690,212,15,197,252,96,110,17,93
"2011","Elmbridge 018B","E01030342","Total",613,188,11,177,222,45,109,11,98
"2011","Elmbridge 018C","E01030343","Total",637,151,9,142,257,95,113,23,90
"2011","Elmbridge 018D","E01030344","Total",526,132,15,117,228,55,69,14,55
"2011","Elmbridge 018E","E01030345","Total",646,181,21,160,241,100,128,20,108
"2011","Epsom and Ewell 001A","E01030386","Total",533,141,12,129,167,44,107,24,83
"2011","Epsom and Ewell 001B","E01030387","Total",643,135,12,123,254,94,118,26,92
"2011","Epsom and Ewell 001C","E01030388","Total",520,164,12,152,143,54,105,16,89
"2011","Epsom and Ewell 001D","E01030389","Total",670,223,16,207,175,61,150,17,133
"2011","Epsom and Ewell 001E","E01030393","Total",821,305,7,298,179,60,215,26,189
"2011","Epsom and Ewell 002A","E01030394","Total",636,162,6,156,245,81,120,19,101
"2011","Epsom and Ewell 002B","E01030399","Total",911,247,24,223,272,114,208,34,174
"2011","Epsom and Ewell 002C","E01030400","Total",599,166,60,106,280,121,132,40,92
"2011","Epsom and Ewell 002D","E01030414","Total",524,141,21,120,189,72,134,28,106
"2011","Epsom and Ewell 003A","E01030377","Total",901,264,8,256,299,107,211,39,172
"2011","Epsom and Ewell 003B","E01030378","Total",611,154,8,146,188,59,119,24,95
"2011","Epsom and Ewell 003C","E01030406","Total",613,164,10,154,196,65,115,18,97
"2011","Epsom and Ewell 003D","E01030407","Total",537,174,5,169,159,53,115,17,98
"2011","Epsom and Ewell 003E","E01030408","Total",641,164,8,156,229,68,128,30,98
"2011","Epsom and Ewell 004A","E01030395","Total",763,319,4,315,167,61,217,21,196
"2011","Epsom and Ewell 004B","E01030413","Total",743,135,17,118,324,154,122,39,83
"2011","Epsom and Ewell 004C","E01030415","Total",607,124,12,112,242,104,130,29,101
"2011","Epsom and Ewell 004D","E01030416","Total",525,157,6,151,152,52,107,18,89
"2011","Epsom and Ewell 005A","E01030383","Total",903,175,47,128,323,145,182,43,139
"2011","Epsom and Ewell 005B","E01030384","Total",980,133,34,99,436,222,168,57,111
"2011","Epsom and Ewell 005C","E01030401","Total",1015,257,11,246,316,139,197,41,156
"2011","Epsom and Ewell 005D","E01030402","Total",481,97,19,78,211,82,66,18,48
"2011","Epsom and Ewell 007A","E01030385","Total",684,243,27,216,207,75,222,36,186
"2011","Epsom and Ewell 007B","E01030391","Total",829,251,14,237,224,84,186,25,161
"2011","Epsom and Ewell 007C","E01030403","Total",591,165,9,156,210,76,130,25,105
"2011","Epsom and Ewell 007D","E01030404","Total",626,187,6,181,193,73,133,28,105
"2011","Epsom and Ewell 007E","E01030409","Total",524,131,14,117,176,67,116,24,92
"2011","Epsom and Ewell 007F","E01030410","Total",592,120,15,105,195,96,99,18,81
"2011","Epsom and Ewell 008A","E01030381","Total",646,230,8,222,163,56,151,21,130
"2011","Epsom and Ewell 008B","E01030411","Total",1077,383,24,359,188,93,299,21,278
"2011","Epsom and Ewell 008C","E01030412","Total",961,302,24,278,188,110,199,21,178
"2011","Epsom and Ewell 008D","E01030419","Total",708,244,10,234,205,89,161,18,143
"2011","Epsom and Ewell 009A","E01030379","Total",502,130,8,122,178,64,98,21,77
"2011","Epsom and Ewell 009B","E01030380","Total",509,153,5,148,176,60,103,23,80
"2011","Epsom and Ewell 009C","E01030405","Total",650,153,12,141,223,92,137,35,102
"2011","Epsom and Ewell 009D","E01030417","Total",523,166,5,161,182,64,105,13,92
"2011","Epsom and Ewell 009E","E01030418","Total",566,128,6,122,199,56,112,27,85
"2011","Epsom and Ewell 009F","E01030420","Total",489,168,17,151,165,64,137,18,119
"2011","Epsom and Ewell 010A","E01030382","Total",591,157,7,150,158,56,116,19,97
"2011","Epsom and Ewell 010B","E01030390","Total",811,244,21,223,235,115,179,18,161
"2011","Epsom and Ewell 010C","E01030392","Total",799,267,14,253,208,73,195,31,164
"2011","Epsom and Ewell 010D","E01030396","Total",646,190,4,186,225,54,130,21,109
"2011","Epsom and Ewell 010E","E01030398","Total",626,180,1,179,226,59,136,28,108
"2011","Epsom and Ewell 010F","E01032624","Total",657,192,7,185,231,45,133,29,104
"2011","Guildford 001A","E01030440","Total",617,178,9,169,204,61,112,18,94
"2011","Guildford 001B","E01030458","Total",524,121,5,116,136,57,100,12,88
"2011","Guildford 001C","E01030459","Total",485,131,8,123,134,50,118,19,99
"2011","Guildford 001D","E01030475","Total",505,138,5,133,156,49,100,11,89
"2011","Guildford 001E","E01030476","Total",456,107,2,105,162,52,80,12,68
"2011","Guildford 001F","E01030477","Total",704,224,18,206,208,89,178,25,153
"2011","Guildford 002A","E01030465","Total",584,158,13,145,160,53,132,18,114
"2011","Guildford 002B","E01030466","Total",726,297,7,290,139,55,181,19,162
"2011","Guildford 002C","E01030473","Total",655,143,8,135,240,104,113,23,90
"2011","Guildford 002D","E01030474","Total",446,24,18,6,298,184,54,42,12
"2011","Guildford 003A","E01030441","Total",514,161,10,151,146,41,104,12,92
"2011","Guildford 003B","E01030442","Total",557,193,9,184,195,35,85,12,73
"2011","Guildford 003C","E01030443","Total",534,182,7,175,181,54,95,18,77
"2011","Guildford 003D","E01030444","Total",597,183,6,177,210,71,107,14,93
"2011","Guildford 003E","E01030445","Total",606,239,11,228,169,58,144,17,127
"2011","Guildford 003F","E01030446","Total",508,150,10,140,164,50,75,11,64
"2011","Guildford 003G","E01030447","Total",546,163,11,152,178,43,110,20,90
"2011","Guildford 004A","E01030426","Total",614,116,21,95,214,110,101,28,73
"2011","Guildford 004B","E01030427","Total",610,143,9,134,183,75,130,19,111
"2011","Guildford 004C","E01030428","Total",510,148,7,141,139,45,110,14,96
"2011","Guildford 004D","E01030429","Total",718,148,25,123,191,98,111,22,89
"2011","Guildford 004E","E01030430","Total",627,173,11,162,141,62,137,11,126
"2011","Guildford 005A","E01030499","Total",645,220,7,213,165,53,143,11,132
"2011","Guildford 005B","E01030500","Total",605,166,10,156,172,70,120,20,100
"2011","Guildford 005C","E01030501","Total",642,116,16,100,221,90,100,27,73
"2011","Guildford 005D","E01030502","Total",500,165,9,156,121,48,133,17,116
"2011","Guildford 005E","E01030503","Total",572,153,40,113,207,113,141,39,102
"2011","Guildford 005F","E01030504","Total",492,191,2,189,113,47,117,11,106
"2011","Guildford 006A","E01030485","Total",741,161,20,141,194,102,131,22,109
"2011","Guildford 006B","E01030487","Total",638,141,11,130,172,77,115,14,101
"2011","Guildford 006C","E01030488","Total",780,193,26,167,282,130,154,26,128
"2011","Guildford 006D","E01030489","Total",947,159,31,128,366,187,142,43,99
"2011","Guildford 007A","E01030481","Total",632,167,26,141,196,78,156,29,127
"2011","Guildford 007B","E01030482","Total",513,124,24,100,178,76,123,33,90
"2011","Guildford 007C","E01030483","Total",587,219,39,180,166,69,187,29,158
"2011","Guildford 007D","E01030484","Total",668,155,15,140,180,71,156,24,132
"2011","Guildford 008A","E01030434","Total",738,122,18,104,232,118,94,16,78
"2011","Guildford 008B","E01030435","Total",647,194,12,182,259,96,153,33,120
"2011","Guildford 008C","E01030462","Total",746,255,17,238,202,63,164,28,136
"2011","Guildford 008D","E01030463","Total",628,135,10,125,201,73,82,15,67
"2011","Guildford 008E","E01030464","Total",645,188,26,162,244,79,192,39,153
"2011","Guildford 009A","E01030486","Total",611,132,13,119,211,90,95,22,73
"2011","Guildford 009B","E01030493","Total",510,149,20,129,155,65,133,23,110
"2011","Guildford 009C","E01030495","Total",643,176,11,165,143,67,137,23,114
"2011","Guildford 009D","E01030498","Total",510,113,6,107,162,67,88,11,77
"2011","Guildford 010A","E01030424","Total",661,214,16,198,200,89,178,27,151
"2011","Guildford 010B","E01030431","Total",627,216,9,207,152,50,145,19,126
"2011","Guildford 010C","E01030432","Total",630,182,35,147,188,82,130,27,103
"2011","Guildford 010D","E01030433","Total",694,175,30,145,196,82,170,34,136
"2011","Guildford 011A","E01030436","Total",982,249,14,235,289,106,201,32,169
"2011","Guildford 011B","E01030437","Total",694,182,7,175,230,70,123,28,95
"2011","Guildford 011C","E01030439","Total",639,185,8,177,232,75,114,19,95
"2011","Guildford 011D","E01030460","Total",633,194,5,189,192,71,131,19,112
"2011","Guildford 011E","E01030461","Total",651,196,14,182,224,79,127,15,112
"2011","Guildford 012A","E01030470","Total",514,119,3,116,113,48,80,7,73
"2011","Guildford 012B","E01030494","Total",651,227,18,209,152,62,181,22,159
"2011","Guildford 012C","E01030496","Total",597,189,36,153,176,77,180,44,136
"2011","Guildford 012D","E01030497","Total",606,185,59,126,242,117,154,49,105
"2011","Guildford 013A","E01030438","Total",730,216,17,199,169,60,142,18,124
"2011","Guildford 013B","E01030450","Total",993,157,15,142,236,134,161,23,138
"2011","Guildford 013C","E01030451","Total",864,174,15,159,169,96,143,16,127
"2011","Guildford 013D","E01030453","Total",774,150,3,147,136,68,103,12,91
"2011","Guildford 013E","E01030455","Total",836,226,10,216,102,47,158,11,147
"2011","Guildford 013F","E01030457","Total",780,164,24,140,150,79,128,16,112
"2011","Guildford 014A","E01030421","Total",617,172,11,161,168,54,118,22,96
"2011","Guildford 014B","E01030422","Total",650,149,12,137,183,73,138,15,123
"2011","Guildford 014C","E01030423","Total",712,203,7,196,182,69,160,20,140
"2011","Guildford 014D","E01030425","Total",657,143,8,135,180,79,123,17,106
"2011","Guildford 015A","E01030452","Total",834,172,8,164,137,74,106,12,94
"2011","Guildford 015B","E01030467","Total",633,187,7,180,207,76,133,23,110
"2011","Guildford 015C","E01030468","Total",497,187,10,177,79,43,122,9,113
"2011","Guildford 015D","E01030469","Total",508,139,16,123,161,58,113,26,87
"2011","Guildford 016A","E01030448","Total",614,153,3,150,161,75,94,12,82
"2011","Guildford 016B","E01030449","Total",674,260,14,246,94,49,143,14,129
"2011","Guildford 016C","E01030454","Total",729,178,18,160,231,86,150,23,127
"2011","Guildford 016D","E01030456","Total",542,160,5,155,175,52,96,22,74
"2011","Guildford 017A","E01030471","Total",482,141,4,137,142,37,85,17,68
"2011","Guildford 017B","E01030472","Total",508,138,8,130,169,55,98,14,84
"2011","Guildford 017C","E01030478","Total",686,189,12,177,206,82,147,22,125
"2011","Guildford 017D","E01030479","Total",759,206,23,183,248,93,180,31,149
"2011","Guildford 017E","E01030480","Total",785,268,8,260,228,95,160,20,140
"2011","Guildford 018A","E01030490","Total",662,187,8,179,192,56,116,13,103
"2011","Guildford 018B","E01030491","Total",789,244,17,227,223,85,182,26,156
"2011","Guildford 018C","E01030492","Total",796,210,13,197,238,76,141,27,114
"2011","Mole Valley 001A","E01030506","Total",486,136,5,131,186,53,92,20,72
"2011","Mole Valley 001B","E01030508","Total",513,197,5,192,138,31,109,18,91
"2011","Mole Valley 001C","E01030509","Total",519,200,5,195,123,51,110,9,101
"2011","Mole Valley 001D","E01030513","Total",520,151,12,139,203,63,114,22,92
"2011","Mole Valley 001E","E01030514","Total",639,254,9,245,183,65,174,30,144
"2011","Mole Valley 002A","E01030505","Total",630,181,9,172,179,75,164,24,140
"2011","Mole Valley 002B","E01030507","Total",501,140,4,136,165,63,106,18,88
"2011","Mole Valley 002C","E01030511","Total",545,156,2,154,187,62,90,17,73
"2011","Mole Valley 002D","E01030512","Total",664,253,8,245,177,74,175,22,153
"2011","Mole Valley 003A","E01030548","Total",709,120,29,91,243,118,107,25,82
"2011","Mole Valley 003B","E01030549","Total",826,135,15,120,219,109,130,28,102
"2011","Mole Valley 003C","E01030550","Total",958,328,21,307,162,76,250,22,228
"2011","Mole Valley 003D","E01030551","Total",684,192,37,155,221,91,177,37,140
"2011","Mole Valley 004A","E01030510","Total",622,201,5,196,204,61,133,25,108
"2011","Mole Valley 004B","E01030552","Total",680,221,8,213,125,73,170,12,158
"2011","Mole Valley 004C","E01030553","Total",786,286,4,282,181,58,188,17,171
"2011","Mole Valley 004D","E01030554","Total",447,155,8,147,135,34,90,15,75
"2011","Mole Valley 005A","E01030539","Total",694,190,17,173,223,75,145,22,123
"2011","Mole Valley 005B","E01030540","Total",814,339,9,330,206,48,158,15,143
"2011","Mole Valley 005C","E01030541","Total",515,167,8,159,166,45,114,20,94
"2011","Mole Valley 005D","E01030542","Total",485,118,2,116,176,67,103,18,85
"2011","Mole Valley 005E","E01030543","Total",604,154,7,147,211,67,96,14,82
"2011","Mole Valley 006A","E01030516","Total",644,303,17,286,140,46,205,23,182
"2011","Mole Valley 006B","E01030517","Total",634,208,4,204,172,42,128,21,107
"2011","Mole Valley 006C","E01030518","Total",544,242,1,241,149,31,125,19,106
"2011","Mole Valley 006D","E01030519","Total",622,211,15,196,216,70,145,35,110
"2011","Mole Valley 007A","E01030520","Total",655,264,14,250,169,72,178,16,162
"2011","Mole Valley 007B","E01030521","Total",684,237,8,229,198,57,158,14,144
"2011","Mole Valley 007C","E01030522","Total",524,196,6,190,145,46,125,25,100
"2011","Mole Valley 007D","E01030523","Total",533,216,5,211,129,50,133,17,116
"2011","Mole Valley 008A","E01030524","Total",1013,412,5,407,147,50,271,17,254
"2011","Mole Valley 008B","E01030525","Total",643,202,3,199,182,50,131,16,115
"2011","Mole Valley 008C","E01030526","Total",548,176,6,170,179,71,130,24,106
"2011","Mole Valley 008D","E01030527","Total",662,180,6,174,172,50,156,19,137
"2011","Mole Valley 009A","E01030532","Total",639,124,9,115,210,94,95,17,78
"2011","Mole Valley 009B","E01030533","Total",517,125,5,120,194,57,92,16,76
"2011","Mole Valley 009C","E01030534","Total",686,271,8,263,115,49,201,14,187
"2011","Mole Valley 009D","E01030556","Total",804,239,5,234,197,60,136,11,125
"2011","Mole Valley 010A","E01030535","Total",802,227,7,220,226,91,167,25,142
"2011","Mole Valley 010B","E01030536","Total",786,245,15,230,199,74,172,21,151
"2011","Mole Valley 010C","E01030537","Total",745,273,8,265,182,58,178,19,159
"2011","Mole Valley 010D","E01030538","Total",692,163,9,154,189,75,136,17,119
"2011","Mole Valley 011A","E01030544","Total",643,183,7,176,173,58,128,21,107
"2011","Mole Valley 011B","E01030545","Total",695,145,12,133,199,88,125,26,99
"2011","Mole Valley 011C","E01030546","Total",679,187,22,165,217,80,165,24,141
"2011","Mole Valley 011D","E01030547","Total",686,245,48,197,230,99,176,35,141
"2011","Mole Valley 012A","E01030529","Total",684,178,21,157,206,72,131,16,115
"2011","Mole Valley 012B","E01030555","Total",680,170,15,155,210,64,137,26,111
"2011","Mole Valley 012C","E01030557","Total",757,176,7,169,239,79,133,19,114
"2011","Mole Valley 012D","E01030558","Total",918,258,13,245,280,115,195,38,157
"2011","Mole Valley 013A","E01030515","Total",863,315,18,297,206,67,225,23,202
"2011","Mole Valley 013B","E01030528","Total",597,169,7,162,165,45,119,12,107
"2011","Mole Valley 013C","E01030530","Total",497,153,5,148,156,45,107,18,89
"2011","Mole Valley 013D","E01030531","Total",911,204,10,194,248,86,187,34,153
"2011","Reigate and Banstead 001A","E01030603","Total",549,130,6,124,179,55,71,15,56
"2011","Reigate and Banstead 001B","E01030604","Total",636,189,11,178,180,68,117,18,99
"2011","Reigate and Banstead 001C","E01030605","Total",528,116,11,105,221,84,93,25,68
"2011","Reigate and Banstead 001D","E01030607","Total",668,177,8,169,213,66,135,26,109
"2011","Reigate and Banstead 002A","E01030559","Total",503,192,4,188,128,36,111,15,96
"2011","Reigate and Banstead 002B","E01030560","Total",764,317,15,302,148,67,181,15,166
"2011","Reigate and Banstead 002C","E01030561","Total",591,251,9,242,122,47,147,10,137
"2011","Reigate and Banstead 002D","E01030562","Total",567,153,13,140,170,68,118,22,96
"2011","Reigate and Banstead 002E","E01030563","Total",408,88,5,83,170,53,86,14,72
"2011","Reigate and Banstead 002F","E01030564","Total",516,139,10,129,192,67,100,17,83
"2011","Reigate and Banstead 003A","E01030606","Total",507,166,7,159,162,42,103,17,86
"2011","Reigate and Banstead 003B","E01030641","Total",625,179,11,168,192,56,141,38,103
"2011","Reigate and Banstead 003C","E01030642","Total",650,218,13,205,201,78,155,21,134
"2011","Reigate and Banstead 003D","E01030644","Total",505,161,0,161,135,35,113,27,86
"2011","Reigate and Banstead 004A","E01030565","Total",567,178,7,171,154,56,137,25,112
"2011","Reigate and Banstead 004B","E01030566","Total",550,105,6,99,231,89,106,34,72
"2011","Reigate and Banstead 004C","E01030567","Total",615,174,8,166,162,48,95,19,76
"2011","Reigate and Banstead 004D","E01030568","Total",568,135,10,125,202,57,93,20,73
"2011","Reigate and Banstead 004E","E01030569","Total",1025,176,31,145,424,188,152,50,102
"2011","Reigate and Banstead 005A","E01030608","Total",587,207,34,173,209,87,161,34,127
"2011","Reigate and Banstead 005B","E01030609","Total",589,150,35,115,261,130,124,40,84
"2011","Reigate and Banstead 005C","E01030640","Total",722,226,31,195,191,92,181,35,146
"2011","Reigate and Banstead 005D","E01030643","Total",621,220,19,201,171,84,163,23,140
"2011","Reigate and Banstead 006A","E01030635","Total",643,162,5,157,195,79,114,14,100
"2011","Reigate and Banstead 006B","E01030636","Total",449,126,13,113,154,38,98,22,76
"2011","Reigate and Banstead 006C","E01030637","Total",458,102,3,99,150,51,79,16,63
"2011","Reigate and Banstead 006D","E01030638","Total",602,178,10,168,186,49,133,32,101
"2011","Reigate and Banstead 006E","E01030639","Total",646,268,5,263,133,36,169,14,155
"2011","Reigate and Banstead 007A","E01030589","Total",646,177,11,166,188,47,107,16,91
"2011","Reigate and Banstead 007B","E01030590","Total",740,182,10,172,227,78,126,22,104
"2011","Reigate and Banstead 007C","E01030591","Total",538,163,10,153,151,45,108,21,87
"2011","Reigate and Banstead 007D","E01030592","Total",843,288,8,280,184,74,195,30,165
"2011","Reigate and Banstead 008A","E01030599","Total",670,243,42,201,210,90,220,41,179
"2011","Reigate and Banstead 008B","E01030600","Total",603,160,18,142,209,93,155,34,121
"2011","Reigate and Banstead 008C","E01030601","Total",591,163,22,141,236,103,172,38,134
"2011","Reigate and Banstead 008D","E01030602","Total",710,173,19,154,225,112,153,19,134
"2011","Reigate and Banstead 009A","E01030598","Total",651,203,11,192,178,74,149,24,125
"2011","Reigate and Banstead 009B","E01030623","Total",904,265,6,259,256,124,151,17,134
"2011","Reigate and Banstead 009C","E01030624","Total",523,138,4,134,170,69,83,16,67
"2011","Reigate and Banstead 009D","E01030625","Total",470,124,2,122,172,53,76,20,56
"2011","Reigate and Banstead 009E","E01030626","Total",442,136,2,134,107,26,79,9,70
"2011","Reigate and Banstead 009F","E01030627","Total",846,238,4,234,154,73,168,14,154
"2011","Reigate and Banstead 010A","E01030615","Total",650,193,59,134,229,114,155,40,115
"2011","Reigate and Banstead 010B","E01030616","Total",685,243,7,236,185,64,155,21,134
"2011","Reigate and Banstead 010C","E01030617","Total",697,196,11,185,182,75,146,17,129
"2011","Reigate and Banstead 010D","E01030618","Total",765,181,21,160,259,115,185,40,145
"2011","Reigate and Banstead 010E","E01030619","Total",624,245,43,202,199,79,174,36,138
"2011","Reigate and Banstead 010F","E01030622","Total",776,140,16,124,242,124,129,23,106
"2011","Reigate and Banstead 011A","E01030610","Total",543,145,22,123,183,86,129,27,102
"2011","Reigate and Banstead 011B","E01030611","Total",1097,165,28,137,364,208,134,28,106
"2011","Reigate and Banstead 011C","E01030612","Total",1182,150,25,125,286,173,145,29,116
"2011","Reigate and Banstead 011D","E01030613","Total",856,107,16,91,245,147,108,18,90
"2011","Reigate and Banstead 011E","E01030614","Total",606,125,9,116,218,92,114,27,87
"2011","Reigate and Banstead 012A","E01030593","Total",594,117,13,104,183,77,101,16,85
"2011","Reigate and Banstead 012B","E01030596","Total",518,114,7,107,226,82,81,19,62
"2011","Reigate and Banstead 012C","E01030597","Total",616,125,9,116,255,137,95,14,81
"2011","Reigate and Banstead 012D","E01030620","Total",792,217,4,213,211,100,163,16,147
"2011","Reigate and Banstead 012E","E01030621","Total",644,203,22,181,218,102,151,23,128
"2011","Reigate and Banstead 013A","E01030594","Total",704,222,26,196,261,89,189,44,145
"2011","Reigate and Banstead 013B","E01030595","Total",603,151,14,137,231,90,124,26,98
"2011","Reigate and Banstead 013C","E01030630","Total",629,201,23,178,233,83,145,24,121
"2011","Reigate and Banstead 013D","E01030631","Total",649,197,28,169,211,89,154,26,128
"2011","Reigate and Banstead 014A","E01030570","Total",643,176,16,160,185,82,144,17,127
"2011","Reigate and Banstead 014B","E01030571","Total",600,133,13,120,206,69,121,23,98
"2011","Reigate and Banstead 014C","E01030572","Total",872,158,27,131,301,135,163,31,132
"2011","Reigate and Banstead 014D","E01030573","Total",719,188,9,179,247,113,185,31,154
"2011","Reigate and Banstead 014E","E01030574","Total",719,117,10,107,240,106,123,29,94
"2011","Reigate and Banstead 015A","E01030628","Total",561,155,8,147,151,47,103,12,91
"2011","Reigate and Banstead 015B","E01030629","Total",514,149,11,138,133,56,100,12,88
"2011","Reigate and Banstead 015C","E01030632","Total",532,126,4,122,175,65,119,35,84
"2011","Reigate and Banstead 015D","E01030633","Total",564,192,23,169,161,68,160,22,138
"2011","Reigate and Banstead 015E","E01030634","Total",576,189,32,157,212,77,156,30,126
"2011","Reigate and Banstead 016A","E01030584","Total",636,147,13,134,208,67,112,22,90
"2011","Reigate and Banstead 016B","E01030585","Total",627,141,9,132,185,83,131,23,108
"2011","Reigate and Banstead 016C","E01030586","Total",654,147,17,130,233,91,154,45,109
"2011","Reigate and Banstead 016D","E01030587","Total",603,175,10,165,186,77,176,22,154
"2011","Reigate and Banstead 016E","E01030588","Total",614,217,37,180,191,79,184,30,154
"2011","Reigate and Banstead 017A","E01030580","Total",764,117,21,96,293,169,109,29,80
"2011","Reigate and Banstead 017B","E01030581","Total",493,132,5,127,139,50,98,20,78
"2011","Reigate and Banstead 017C","E01030582","Total",523,77,15,62,194,90,78,31,47
"2011","Reigate and Banstead 017D","E01030583","Total",556,142,4,138,166,41,143,30,113
"2011","Reigate and Banstead 018A","E01030575","Total",975,238,23,215,238,140,190,25,165
"2011","Reigate and Banstead 018B","E01030576","Total",664,126,12,114,203,99,120,29,91
"2011","Reigate and Banstead 018C","E01030577","Total",734,183,17,166,194,88,138,25,113
"2011","Reigate and Banstead 018D","E01030578","Total",611,223,25,198,148,47,202,33,169
"2011","Reigate and Banstead 018E","E01030579","Total",603,239,12,227,106,52,168,13,155
"2011","Runnymede 001A","E01030667","Total",751,281,15,266,126,57,187,16,171
"2011","Runnymede 001B","E01030668","Total",869,294,11,283,172,86,152,15,137
"2011","Runnymede 001C","E01030669","Total",599,169,7,162,163,84,110,13,97
"2011","Runnymede 001D","E01030670","Total",490,122,9,113,142,50,96,13,83
"2011","Runnymede 002A","E01030671","Total",424,139,12,127,120,53,69,8,61
"2011","Runnymede 002B","E01030672","Total",789,230,23,207,242,111,123,20,103
"2011","Runnymede 002C","E01030673","Total",426,125,4,121,106,49,75,11,64
"2011","Runnymede 002D","E01030674","Total",651,296,17,279,136,46,192,19,173
"2011","Runnymede 002E","E01030675","Total",547,174,16,158,128,54,108,13,95
"2011","Runnymede 002F","E01030676","Total",496,202,17,185,100,42,156,20,136
"2011","Runnymede 003A","E01030663","Total",642,210,27,183,217,90,164,29,135
"2011","Runnymede 003B","E01030664","Total",706,236,32,204,196,76,187,22,165
"2011","Runnymede 003C","E01030665","Total",624,122,18,104,208,99,116,21,95
"2011","Runnymede 003D","E01030666","Total",741,164,16,148,194,85,123,20,103
"2011","Runnymede 003E","E01030687","Total",483,113,4,109,121,32,99,13,86
"2011","Runnymede 003F","E01030688","Total",604,155,13,142,175,58,126,22,104
"2011","Runnymede 004A","E01030656","Total",588,143,22,121,194,93,137,27,110
"2011","Runnymede 004B","E01030658","Total",738,273,7,266,92,39,174,15,159
"2011","Runnymede 004C","E01030685","Total",511,108,5,103,164,55,83,18,65
"2011","Runnymede 004D","E01030686","Total",589,167,4,163,147,56,123,17,106
"2011","Runnymede 005A","E01030689","Total",575,154,10,144,154,58,88,13,75
"2011","Runnymede 005B","E01030690","Total",662,173,14,159,191,70,102,17,85
"2011","Runnymede 005C","E01030691","Total",600,204,15,189,217,57,111,21,90
"2011","Runnymede 005D","E01030692","Total",486,151,15,136,149,47,88,9,79
"2011","Runnymede 006A","E01030652","Total",708,187,19,168,213,123,168,31,137
"2011","Runnymede 006B","E01030653","Total",633,170,15,155,164,72,155,25,130
"2011","Runnymede 006C","E01030654","Total",622,122,16,106,188,100,109,15,94
"2011","Runnymede 006D","E01030657","Total",648,199,28,171,184,87,185,30,155
"2011","Runnymede 006E","E01030659","Total",737,235,9,226,175,77,172,22,150
"2011","Runnymede 007A","E01030647","Total",763,279,8,271,164,70,199,19,180
"2011","Runnymede 007B","E01030648","Total",628,151,22,129,213,107,129,21,108
"2011","Runnymede 007C","E01030649","Total",807,247,32,215,202,112,160,19,141
"2011","Runnymede 007D","E01030650","Total",519,151,39,112,186,84,138,34,104
"2011","Runnymede 007E","E01030651","Total",562,132,12,120,173,84,116,24,92
"2011","Runnymede 007F","E01030655","Total",688,174,11,163,167,75,129,12,117
"2011","Runnymede 007G","E01030662","Total",607,191,15,176,211,83,134,25,109
"2011","Runnymede 008A","E01030677","Total",677,145,6,139,184,87,112,8,104
"2011","Runnymede 008B","E01030678","Total",583,145,13,132,165,80,125,20,105
"2011","Runnymede 008C","E01030679","Total",480,125,5,120,135,56,80,11,69
"2011","Runnymede 008D","E01030680","Total",634,194,5,189,195,64,124,21,103
"2011","Runnymede 009A","E01030645","Total",911,364,36,328,241,100,280,37,243
"2011","Runnymede 009B","E01030646","Total",928,224,12,212,241,116,177,22,155
"2011","Runnymede 009C","E01030660","Total",799,165,18,147,292,110,158,35,123
"2011","Runnymede 009D","E01030661","Total",669,224,4,220,171,54,150,16,134
"2011","Runnymede 009E","E01030684","Total",651,157,13,144,169,75,129,23,106
"2011","Runnymede 010A","E01030681","Total",650,189,13,176,183,75,144,22,122
"2011","Runnymede 010B","E01030682","Total",515,120,5,115,185,71,97,20,77
"2011","Runnymede 010C","E01030683","Total",551,117,10,107,162,72,111,26,85
"2011","Runnymede 010D","E01030693","Total",507,173,8,165,133,40,116,18,98
"2011","Runnymede 010E","E01030694","Total",530,159,23,136,183,55,129,31,98
"2011","Runnymede 010F","E01030695","Total",496,181,3,178,135,30,115,14,101
"2011","Runnymede 010G","E01030696","Total",620,226,14,212,184,63,156,19,137
"2011","Spelthorne 001A","E01030743","Total",651,196,17,179,153,56,172,26,146
"2011","Spelthorne 001B","E01030744","Total",844,241,37,204,177,83,195,34,161
"2011","Spelthorne 001C","E01030745","Total",577,152,41,111,231,86,135,37,98
"2011","Spelthorne 001D","E01030747","Total",550,97,16,81,174,79,102,26,76
"2011","Spelthorne 002A","E01030709","Total",562,125,36,89,223,97,122,37,85
"2011","Spelthorne 002B","E01030710","Total",648,168,34,134,235,109,164,28,136
"2011","Spelthorne 002C","E01030711","Total",638,164,36,128,233,111,145,49,96
"2011","Spelthorne 002D","E01030746","Total",628,232,45,187,208,83,198,42,156
"2011","Spelthorne 003A","E01030707","Total",674,162,19,143,194,108,130,19,111
"2011","Spelthorne 003B","E01030708","Total",618,138,16,122,224,87,131,33,98
"2011","Spelthorne 003C","E01030712","Total",545,124,5,119,133,53,122,17,105
"2011","Spelthorne 003D","E01030713","Total",489,117,6,111,162,55,96,25,71
"2011","Spelthorne 003E","E01030714","Total",476,106,11,95,170,66,90,23,67
"2011","Spelthorne 003F","E01030715","Total",600,157,11,146,180,63,116,20,96
"2011","Spelthorne 003G","E01030716","Total",593,185,4,181,169,57,134,14,120
"2011","Spelthorne 004A","E01030734","Total",551,97,7,90,196,77,97,29,68
"2011","Spelthorne 004B","E01030735","Total",670,151,12,139,182,84,109,14,95
"2011","Spelthorne 004C","E01030736","Total",937,191,14,177,191,136,139,16,123
"2011","Spelthorne 004D","E01030737","Total",681,196,15,181,157,85,149,24,125
"2011","Spelthorne 004E","E01030738","Total",689,178,19,159,202,87,155,31,124
"2011","Spelthorne 005A","E01030701","Total",625,200,13,187,213,83,154,30,124
"2011","Spelthorne 005B","E01030702","Total",489,172,26,146,164,81,137,23,114
"2011","Spelthorne 005C","E01030703","Total",627,201,16,185,184,64,146,27,119
"2011","Spelthorne 005D","E01030704","Total",647,250,8,242,144,53,168,22,146
"2011","Spelthorne 005E","E01030705","Total",643,171,11,160,182,74,136,21,115
"2011","Spelthorne 005F","E01030706","Total",553,135,9,126,171,69,124,20,104
"2011","Spelthorne 006A","E01030697","Total",639,188,8,180,191,64,113,12,101
"2011","Spelthorne 006B","E01030698","Total",655,195,16,179,224,85,154,25,129
"2011","Spelthorne 006C","E01030699","Total",627,240,27,213,180,63,183,39,144
"2011","Spelthorne 006D","E01030700","Total",778,210,19,191,217,110,163,21,142
"2011","Spelthorne 006E","E01030725","Total",787,137,27,110,248,143,110,32,78
"2011","Spelthorne 007A","E01030729","Total",623,187,28,159,193,69,157,34,123
"2011","Spelthorne 007B","E01030739","Total",690,251,34,217,237,104,205,41,164
"2011","Spelthorne 007C","E01030740","Total",745,285,15,270,209,85,256,34,222
"2011","Spelthorne 007D","E01030741","Total",654,149,27,122,233,104,141,33,108
"2011","Spelthorne 008A","E01030748","Total",669,175,25,150,221,99,143,32,111
"2011","Spelthorne 008B","E01030749","Total",608,179,30,149,233,104,169,31,138
"2011","Spelthorne 008C","E01030750","Total",618,138,24,114,215,93,141,35,106
"2011","Spelthorne 008D","E01030751","Total",653,178,25,153,195,79,132,33,99
"2011","Spelthorne 008E","E01030752","Total",615,162,30,132,212,98,142,29,113
"2011","Spelthorne 009A","E01030726","Total",638,174,8,166,206,56,140,22,118
"2011","Spelthorne 009B","E01030727","Total",862,247,17,230,197,89,163,22,141
"2011","Spelthorne 009C","E01030728","Total",723,242,2,240,162,53,157,18,139
"2011","Spelthorne 009D","E01030742","Total",810,277,13,264,221,95,195,23,172
"2011","Spelthorne 010A","E01030753","Total",746,240,6,234,184,63,155,17,138
"2011","Spelthorne 010B","E01030754","Total",625,224,6,218,162,57,145,14,131
"2011","Spelthorne 010C","E01030755","Total",794,230,40,190,271,139,167,31,136
"2011","Spelthorne 010D","E01030756","Total",666,176,7,169,189,81,132,20,112
"2011","Spelthorne 011A","E01030717","Total",730,251,25,226,187,81,168,32,136
"2011","Spelthorne 011B","E01030718","Total",506,140,9,131,186,60,106,28,78
"2011","Spelthorne 011C","E01030719","Total",619,206,19,187,192,62,176,29,147
"2011","Spelthorne 011D","E01030720","Total",641,217,11,206,179,54,169,18,151
"2011","Spelthorne 012A","E01030721","Total",619,190,23,167,183,63,140,32,108
"2011","Spelthorne 012B","E01030722","Total",656,170,10,160,189,69,130,16,114
"2011","Spelthorne 012C","E01030723","Total",617,174,9,165,177,51,149,29,120
"2011","Spelthorne 012D","E01030724","Total",647,215,24,191,198,69,179,38,141
"2011","Spelthorne 013A","E01030730","Total",783,307,3,304,170,61,212,27,185
"2011","Spelthorne 013B","E01030731","Total",767,227,10,217,248,82,154,24,130
"2011","Spelthorne 013C","E01030732","Total",689,238,9,229,132,53,163,19,144
"2011","Spelthorne 013D","E01030733","Total",808,293,13,280,146,48,196,21,175
"2011","Surrey Heath 001A","E01030763","Total",509,130,4,126,115,35,104,13,91
"2011","Surrey Heath 001B","E01030764","Total",506,145,7,138,140,52,111,19,92
"2011","Surrey Heath 001C","E01030765","Total",601,210,14,196,170,86,161,17,144
"2011","Surrey Heath 001D","E01030809","Total",643,205,9,196,167,56,137,20,117
"2011","Surrey Heath 001E","E01030810","Total",542,134,4,130,194,66,79,17,62
"2011","Surrey Heath 001F","E01030811","Total",597,145,4,141,204,71,107,20,87
"2011","Surrey Heath 002A","E01030757","Total",675,96,10,86,208,93,86,17,69
"2011","Surrey Heath 002B","E01030758","Total",439,98,4,94,147,66,92,20,72
"2011","Surrey Heath 002C","E01030759","Total",725,284,25,259,183,80,238,35,203
"2011","Surrey Heath 002D","E01030760","Total",493,114,4,110,151,53,79,15,64
"2011","Surrey Heath 003A","E01030778","Total",741,191,5,186,229,75,133,23,110
"2011","Surrey Heath 003B","E01030779","Total",745,246,2,244,201,65,154,12,142
"2011","Surrey Heath 003C","E01030780","Total",652,138,1,137,203,54,102,16,86
"2011","Surrey Heath 003D","E01030781","Total",640,151,9,142,215,94,138,26,112
"2011","Surrey Heath 004A","E01030786","Total",754,261,51,210,257,129,206,41,165
"2011","Surrey Heath 004B","E01030787","Total",528,149,17,132,190,67,151,36,115
"2011","Surrey Heath 004C","E01030788","Total",487,150,46,104,215,85,127,42,85
"2011","Surrey Heath 004D","E01030801","Total",638,118,14,104,228,111,115,22,93
"2011","Surrey Heath 004E","E01030802","Total",672,180,7,173,183,68,110,19,91
"2011","Surrey Heath 005A","E01030796","Total",522,157,5,152,178,57,83,17,66
"2011","Surrey Heath 005B","E01030797","Total",519,95,4,91,206,72,85,20,65
"2011","Surrey Heath 005C","E01030798","Total",547,169,9,160,191,66,103,17,86
"2011","Surrey Heath 005D","E01030799","Total",501,122,4,118,177,47,87,19,68
"2011","Surrey Heath 005E","E01030800","Total",699,222,20,202,190,77,124,19,105
"2011","Surrey Heath 006A","E01030761","Total",575,157,6,151,202,54,133,34,99
"2011","Surrey Heath 006B","E01030762","Total",735,120,5,115,244,83,114,24,90
"2011","Surrey Heath 006C","E01030806","Total",544,114,5,109,243,64,87,23,64
"2011","Surrey Heath 006D","E01030807","Total",510,131,8,123,188,54,94,21,73
"2011","Surrey Heath 006E","E01030808","Total",634,137,5,132,216,75,98,21,77
"2011","Surrey Heath 007A","E01030774","Total",531,78,7,71,210,72,67,21,46
"2011","Surrey Heath 007B","E01030775","Total",556,158,6,152,174,49,107,20,87
"2011","Surrey Heath 007C","E01030776","Total",616,150,8,142,219,83,103,23,80
"2011","Surrey Heath 007D","E01030777","Total",641,130,13,117,237,103,111,23,88
"2011","Surrey Heath 008A","E01030793","Total",608,172,43,129,220,107,151,35,116
"2011","Surrey Heath 008B","E01030794","Total",613,129,13,116,189,93,104,21,83
"2011","Surrey Heath 008C","E01030795","Total",960,300,12,288,198,93,208,23,185
"2011","Surrey Heath 008D","E01030803","Total",656,151,21,130,198,84,123,23,100
"2011","Surrey Heath 008E","E01030804","Total",668,190,12,178,199,72,129,19,110
"2011","Surrey Heath 008F","E01030805","Total",606,202,34,168,219,72,181,38,143
"2011","Surrey Heath 009A","E01030789","Total",562,155,5,150,161,47,105,13,92
"2011","Surrey Heath 009B","E01030790","Total",663,176,9,167,230,80,160,36,124
"2011","Surrey Heath 009C","E01030791","Total",643,182,4,178,181,60,133,19,114
"2011","Surrey Heath 009D","E01030792","Total",492,128,8,120,157,41,77,17,60
"2011","Surrey Heath 010A","E01030766","Total",662,195,11,184,171,68,162,23,139
"2011","Surrey Heath 010B","E01030767","Total",609,167,28,139,238,103,157,42,115
"2011","Surrey Heath 010C","E01030768","Total",513,156,13,143,172,59,121,20,101
"2011","Surrey Heath 010D","E01030769","Total",570,128,4,124,195,46,112,22,90
"2011","Surrey Heath 011A","E01030770","Total",616,148,4,144,182,64,119,21,98
"2011","Surrey Heath 011B","E01030771","Total",485,88,3,85,158,45,85,17,68
"2011","Surrey Heath 011C","E01030772","Total",623,192,11,181,190,67,158,19,139
"2011","Surrey Heath 011D","E01030773","Total",542,113,3,110,190,67,96,19,77
"2011","Surrey Heath 012A","E01030782","Total",659,226,9,217,172,65,169,25,144
"2011","Surrey Heath 012B","E01030783","Total",636,146,5,141,188,86,136,19,117
"2011","Surrey Heath 012C","E01030784","Total",803,80,15,65,354,163,96,33,63
"2011","Surrey Heath 012D","E01030785","Total",640,216,8,208,153,57,152,17,135
"2011","Tandridge 002A","E01030855","Total",753,249,4,245,167,44,162,23,139
"2011","Tandridge 002B","E01030856","Total",613,194,7,187,177,65,157,21,136
"2011","Tandridge 002C","E01030859","Total",848,156,12,144,225,102,135,29,106
"2011","Tandridge 002D","E01030860","Total",935,195,30,165,288,147,156,34,122
"2011","Tandridge 003A","E01030844","Total",679,143,19,124,260,115,147,32,115
"2011","Tandridge 003B","E01030845","Total",497,114,11,103,190,82,105,24,81
"2011","Tandridge 003C","E01030846","Total",550,168,12,156,176,60,114,19,95
"2011","Tandridge 003D","E01030857","Total",876,187,25,162,337,130,187,35,152
"2011","Tandridge 003E","E01030858","Total",871,200,26,174,303,117,182,49,133
"2011","Tandridge 004A","E01030828","Total",494,134,7,127,148,44,76,15,61
"2011","Tandridge 004B","E01030829","Total",672,228,19,209,152,68,141,18,123
"2011","Tandridge 004C","E01030830","Total",513,128,8,120,183,89,92,20,72
"2011","Tandridge 004D","E01030850","Total",1031,333,30,303,274,153,253,35,218
"2011","Tandridge 004E","E01030851","Total",811,180,26,154,290,120,155,41,114
"2011","Tandridge 004F","E01030861","Total",744,216,12,204,213,72,143,21,122
"2011","Tandridge 005A","E01030820","Total",644,197,3,194,185,50,146,23,123
"2011","Tandridge 005B","E01030847","Total",698,305,13,292,155,35,208,19,189
"2011","Tandridge 005C","E01030848","Total",851,221,17,204,307,110,196,36,160
"2011","Tandridge 006A","E01030831","Total",875,262,9,253,253,75,154,23,131
"2011","Tandridge 006B","E01030832","Total",555,184,9,175,158,45,113,19,94
"2011","Tandridge 006C","E01030836","Total",728,301,11,290,215,71,191,15,176
"2011","Tandridge 006D","E01030837","Total",549,149,11,138,215,73,125,28,97
"2011","Tandridge 006E","E01030838","Total",507,128,9,119,153,51,98,16,82
"2011","Tandridge 006F","E01030839","Total",546,188,6,182,180,55,115,14,101
"2011","Tandridge 007A","E01030840","Total",572,170,20,150,205,80,144,27,117
"2011","Tandridge 007B","E01030841","Total",489,159,5,154,156,53,101,12,89
"2011","Tandridge 007C","E01030842","Total",687,189,26,163,255,101,154,31,123
"2011","Tandridge 007D","E01030843","Total",610,161,21,140,193,72,123,25,98
"2011","Tandridge 008A","E01030812","Total",633,169,17,152,200,68,151,28,123
"2011","Tandridge 008B","E01030813","Total",652,166,12,154,181,79,123,25,98
"2011","Tandridge 008C","E01030814","Total",473,143,10,133,163,49,105,19,86
"2011","Tandridge 008D","E01030815","Total",603,169,10,159,181,82,120,24,96
"2011","Tandridge 009A","E01030824","Total",612,193,27,166,195,85,172,30,142
"2011","Tandridge 009B","E01030825","Total",594,203,5,198,160,61,159,17,142
"2011","Tandridge 009C","E01030826","Total",567,159,11,148,218,74,138,38,100
"2011","Tandridge 009D","E01030827","Total",613,139,10,129,185,68,124,22,102
"2011","Tandridge 010A","E01030821","Total",772,211,13,198,207,70,172,28,144
"2011","Tandridge 010B","E01030822","Total",678,165,10,155,211,61,137,33,104
"2011","Tandridge 010C","E01030833","Total",602,240,7,233,132,67,181,14,167
"2011","Tandridge 010D","E01030834","Total",566,146,18,128,166,73,134,29,105
"2011","Tandridge 010E","E01030835","Total",581,146,7,139,195,84,110,18,92
"2011","Tandridge 011A","E01030816","Total",609,152,16,136,180,68,128,17,111
"2011","Tandridge 011B","E01030817","Total",582,166,5,161,160,47,105,20,85
"2011","Tandridge 011C","E01030818","Total",522,175,14,161,146,49,147,16,131
"2011","Tandridge 011D","E01030819","Total",609,175,4,171,137,49,138,11,127
"2011","Tandridge 011E","E01030823","Total",829,261,12,249,237,72,175,29,146
"2011","Tandridge 012A","E01030852","Total",801,262,29,233,234,88,226,35,191
"2011","Tandridge 012B","E01030853","Total",703,247,14,233,200,75,194,28,166
"2011","Tandridge 012C","E01030854","Total",804,285,15,270,231,75,197,35,162
"2011","Tandridge 012D","E01032571","Total",739,206,12,194,204,64,152,22,130
"2011","Waverley 001A","E01030890","Total",647,187,20,167,209,87,135,30,105
"2011","Waverley 001B","E01030902","Total",534,147,7,140,156,62,97,13,84
"2011","Waverley 001C","E01030903","Total",670,160,11,149,204,71,147,27,120
"2011","Waverley 001D","E01030904","Total",639,251,7,244,138,42,202,20,182
"2011","Waverley 002A","E01030891","Total",637,160,4,156,199,66,109,17,92
"2011","Waverley 002B","E01030892","Total",522,113,7,106,176,77,91,18,73
"2011","Waverley 002C","E01030899","Total",672,179,4,175,192,63,122,19,103
"2011","Waverley 002D","E01030900","Total",501,165,9,156,133,46,120,16,104
"2011","Waverley 002E","E01030901","Total",512,128,55,73,210,91,131,40,91
"2011","Waverley 003A","E01030884","Total",707,216,24,192,161,80,128,15,113
"2011","Waverley 003B","E01030885","Total",682,338,3,335,60,24,236,8,228
"2011","Waverley 003C","E01030886","Total",490,130,12,118,155,56,96,17,79
"2011","Waverley 003D","E01030893","Total",777,182,9,173,229,114,147,26,121
"2011","Waverley 003E","E01030895","Total",640,175,16,159,158,87,152,27,125
"2011","Waverley 004A","E01030881","Total",544,215,13,202,187,53,115,19,96
"2011","Waverley 004B","E01030883","Total",522,171,11,160,179,54,97,14,83
"2011","Waverley 004C","E01030888","Total",627,181,6,175,204,87,118,19,99
"2011","Waverley 004D","E01030894","Total",597,183,5,178,186,43,100,17,83
"2011","Waverley 005A","E01030911","Total",618,196,15,181,182,92,154,34,120
"2011","Waverley 005B","E01030912","Total",547,174,9,165,146,36,161,22,139
"2011","Waverley 005C","E01030913","Total",506,143,30,113,187,79,143,27,116
"2011","Waverley 005D","E01030920","Total",636,141,19,122,171,91,120,25,95
"2011","Waverley 005E","E01030921","Total",834,309,16,293,195,79,250,34,216
"2011","Waverley 006A","E01030882","Total",519,152,3,149,186,78,97,19,78
"2011","Waverley 006B","E01030887","Total",529,166,5,161,186,76,100,13,87
"2011","Waverley 006C","E01030889","Total",634,213,14,199,179,96,160,19,141
"2011","Waverley 006D","E01030896","Total",514,136,21,115,154,60,134,22,112
"2011","Waverley 006E","E01030897","Total",522,135,9,126,191,75,108,22,86
"2011","Waverley 007A","E01030916","Total",799,173,10,163,191,114,140,13,127
"2011","Waverley 007B","E01030917","Total",518,76,4,72,117,62,61,11,50
"2011","Waverley 007C","E01030918","Total",536,167,7,160,113,59,107,10,97
"2011","Waverley 007D","E01030919","Total",521,141,2,139,152,71,74,12,62
"2011","Waverley 007E","E01030922","Total",621,144,7,137,168,86,116,20,96
"2011","Waverley 008A","E01030863","Total",748,234,10,224,235,83,159,14,145
"2011","Waverley 008B","E01030865","Total",622,220,12,208,152,60,166,19,147
"2011","Waverley 008C","E01030866","Total",629,179,5,174,194,79,114,12,102
"2011","Waverley 008D","E01030940","Total",731,246,8,238,218,82,145,22,123
"2011","Waverley 009A","E01030898","Total",626,189,7,182,226,66,127,22,105
"2011","Waverley 009B","E01030905","Total",606,145,19,126,186,75,129,23,106
"2011","Waverley 009C","E01030906","Total",709,203,11,192,244,82,127,27,100
"2011","Waverley 009D","E01030907","Total",471,173,4,169,143,56,94,17,77
"2011","Waverley 010A","E01030914","Total",531,163,27,136,172,96,139,26,113
"2011","Waverley 010B","E01030915","Total",654,166,14,152,232,99,123,29,94
"2011","Waverley 010C","E01030923","Total",558,150,7,143,189,83,85,18,67
"2011","Waverley 010D","E01030924","Total",504,119,7,112,168,71,65,12,53
"2011","Waverley 010E","E01030925","Total",571,124,8,116,232,86,88,30,58
"2011","Waverley 011A","E01030877","Total",517,213,11,202,123,50,155,14,141
"2011","Waverley 011B","E01030878","Total",635,207,3,204,182,59,138,22,116
"2011","Waverley 011C","E01030937","Total",653,166,8,158,220,93,124,21,103
"2011","Waverley 011D","E01030938","Total",621,254,8,246,142,58,185,19,166
"2011","Waverley 011E","E01030939","Total",468,125,7,118,163,50,90,16,74
"2011","Waverley 012A","E01030864","Total",545,143,10,133,176,49,109,20,89
"2011","Waverley 012B","E01030879","Total",459,119,4,115,127,43,95,15,80
"2011","Waverley 012C","E01030941","Total",488,120,9,111,166,56,73,15,58
"2011","Waverley 012D","E01030942","Total",557,140,5,135,187,52,94,24,70
"2011","Waverley 012E","E01030943","Total",514,128,17,111,189,67,120,19,101
"2011","Waverley 013A","E01030870","Total",645,226,8,218,183,57,115,17,98
"2011","Waverley 013B","E01030871","Total",658,156,11,145,222,84,138,18,120
"2011","Waverley 013C","E01030872","Total",812,296,14,282,213,90,273,42,231
"2011","Waverley 013D","E01030873","Total",608,200,8,192,172,55,139,16,123
"2011","Waverley 013E","E01030874","Total",511,167,4,163,128,32,103,11,92
"2011","Waverley 013F","E01030875","Total",601,165,8,157,138,63,115,10,105
"2011","Waverley 013G","E01030876","Total",537,218,5,213,111,25,115,7,108
"2011","Waverley 015A","E01030862","Total",861,404,13,391,167,50,292,29,263
"2011","Waverley 015B","E01030867","Total",596,167,10,157,152,44,126,14,112
"2011","Waverley 015C","E01030868","Total",487,138,8,130,177,78,79,16,63
"2011","Waverley 015D","E01030869","Total",477,125,6,119,148,68,114,26,88
"2011","Waverley 015E","E01030880","Total",814,261,12,249,211,78,181,24,157
"2011","Waverley 016A","E01030930","Total",642,215,8,207,202,77,116,16,100
"2011","Waverley 016B","E01030931","Total",761,271,13,258,196,97,178,19,159
"2011","Waverley 016C","E01030932","Total",591,162,16,146,211,70,145,31,114
"2011","Waverley 016D","E01030933","Total",772,291,15,276,201,78,180,21,159
"2011","Waverley 017A","E01030926","Total",604,183,5,178,190,86,115,15,100
"2011","Waverley 017B","E01030927","Total",528,121,11,110,156,58,111,16,95
"2011","Waverley 017C","E01030928","Total",819,247,21,226,207,98,148,12,136
"2011","Waverley 017D","E01030929","Total",494,106,5,101,170,57,72,18,54
"2011","Waverley 018A","E01030908","Total",590,160,5,155,196,52,94,13,81
"2011","Waverley 018B","E01030909","Total",499,142,6,136,139,32,96,12,84
"2011","Waverley 018C","E01030910","Total",494,158,3,155,143,36,107,16,91
"2011","Waverley 018D","E01030934","Total",568,181,10,171,159,59,113,15,98
"2011","Waverley 018E","E01030935","Total",505,112,4,108,174,56,106,21,85
"2011","Waverley 018F","E01032626","Total",615,185,8,177,131,49,112,11,101
"2011","Woking 001A","E01030946","Total",607,212,35,177,184,87,172,24,148
"2011","Woking 001B","E01030947","Total",532,115,7,108,218,80,96,32,64
"2011","Woking 001C","E01030948","Total",620,135,8,127,201,75,117,19,98
"2011","Woking 001D","E01030949","Total",705,152,15,137,230,116,120,21,99
"2011","Woking 001E","E01030950","Total",710,231,21,210,190,87,181,24,157
"2011","Woking 002A","E01030996","Total",577,185,4,181,199,61,128,28,100
"2011","Woking 002B","E01030998","Total",718,273,8,265,232,72,157,24,133
"2011","Woking 002C","E01031002","Total",678,203,3,200,211,69,126,16,110
"2011","Woking 002D","E01031003","Total",648,173,5,168,253,103,106,21,85
"2011","Woking 002E","E01031004","Total",994,287,23,264,261,138,210,19,191
"2011","Woking 003A","E01030963","Total",530,174,11,163,177,54,99,13,86
"2011","Woking 003B","E01030964","Total",741,186,10,176,193,74,131,17,114
"2011","Woking 003C","E01030965","Total",556,145,8,137,177,56,87,18,69
"2011","Woking 003D","E01030966","Total",507,101,5,96,230,88,117,32,85
"2011","Woking 003E","E01030967","Total",631,183,5,178,203,87,115,14,101
"2011","Woking 003F","E01030968","Total",533,146,16,130,162,64,112,12,100
"2011","Woking 004A","E01030980","Total",556,101,25,76,191,114,128,47,81
"2011","Woking 004B","E01030981","Total",464,119,19,100,199,100,148,50,98
"2011","Woking 004C","E01030982","Total",596,114,27,87,230,125,138,46,92
"2011","Woking 004D","E01030983","Total",681,161,30,131,204,118,146,24,122
"2011","Woking 004E","E01030984","Total",694,198,47,151,286,131,189,50,139
"2011","Woking 004F","E01030985","Total",627,229,45,184,221,103,221,43,178
"2011","Woking 005A","E01030951","Total",611,141,13,128,154,75,120,15,105
"2011","Woking 005B","E01030952","Total",602,207,61,146,279,158,169,56,113
"2011","Woking 005C","E01030953","Total",650,176,2,174,164,62,125,19,106
"2011","Woking 005D","E01030956","Total",509,79,17,62,169,71,83,25,58
"2011","Woking 005E","E01030957","Total",493,79,26,53,213,113,92,28,64
"2011","Woking 005F","E01030958","Total",609,115,15,100,190,88,93,21,72
"2011","Woking 005G","E01030959","Total",471,140,3,137,118,55,113,13,100
"2011","Woking 006A","E01030988","Total",821,157,8,149,202,112,117,24,93
"2011","Woking 006B","E01030989","Total",604,148,16,132,215,97,115,15,100
"2011","Woking 006C","E01030990","Total",581,197,6,191,185,59,119,17,102
"2011","Woking 006D","E01030997","Total",690,257,8,249,158,56,149,13,136
"2011","Woking 007A","E01030974","Total",629,137,12,125,194,82,144,26,118
"2011","Woking 007B","E01030975","Total",554,131,3,128,190,82,124,22,102
"2011","Woking 007C","E01030976","Total",631,145,8,137,204,94,121,23,98
"2011","Woking 007D","E01030977","Total",693,203,15,188,222,93,145,16,129
"2011","Woking 007E","E01030979","Total",832,117,43,74,370,181,103,39,64
"2011","Woking 008A","E01030954","Total",979,179,10,169,247,150,163,20,143
"2011","Woking 008B","E01030969","Total",539,118,0,118,201,87,87,17,70
"2011","Woking 008C","E01030970","Total",628,173,3,170,194,90,146,25,121
"2011","Woking 008D","E01030991","Total",1031,329,10,319,186,114,230,15,215
"2011","Woking 008E","E01030993","Total",1216,246,30,216,272,177,173,16,157
"2011","Woking 009A","E01030960","Total",742,138,16,122,228,93,147,33,114
"2011","Woking 009B","E01030961","Total",717,213,9,204,250,91,171,32,139
"2011","Woking 009C","E01030962","Total",768,231,32,199,202,81,231,33,198
"2011","Woking 009D","E01031000","Total",655,171,4,167,178,88,140,18,122
"2011","Woking 010A","E01030955","Total",578,136,7,129,157,70,101,13,88
"2011","Woking 010B","E01030992","Total",698,149,5,144,195,83,108,19,89
"2011","Woking 010C","E01030999","Total",495,148,7,141,179,50,81,13,68
"2011","Woking 010D","E01031001","Total",738,205,7,198,175,62,157,14,143
"2011","Woking 011A","E01030971","Total",737,230,34,196,268,94,211,52,159
"2011","Woking 011B","E01030972","Total",688,194,22,172,212,90,157,22,135
"2011","Woking 011C","E01030973","Total",694,212,34,178,218,100,152,28,124
"2011","Woking 011D","E01030994","Total",687,154,20,134,267,154,122,30,92
"2011","Woking 011E","E01030995","Total",549,118,19,99,200,92,127,28,99
"2011","Woking 012A","E01030944","Total",497,100,8,92,206,79,68,18,50
"2011","Woking 012B","E01030945","Total",463,119,8,111,161,60,98,20,78
"2011","Woking 012C","E01030978","Total",510,99,8,91,221,83,90,20,70
"2011","Woking 012D","E01030986","Total",449,157,4,153,120,47,104,12,92
"2011","Woking 012E","E01030987","Total",524,149,6,143,181,64,103,20,83
"2011","Adur 001A","E01031349","Total",552,203,13,190,144,48,156,19,137
"2011","Adur 001B","E01031350","Total",496,154,25,129,157,60,145,25,120
"2011","Adur 001C","E01031351","Total",647,229,10,219,176,69,179,23,156
"2011","Adur 001D","E01031352","Total",635,241,16,225,166,54,200,30,170
"2011","Adur 001E","E01031370","Total",568,171,16,155,191,77,158,31,127
"2011","Adur 001F","E01031374","Total",646,216,15,201,177,64,179,30,149
"2011","Adur 002A","E01031338","Total",497,148,5,143,133,52,115,11,104
"2011","Adur 002B","E01031339","Total",519,142,8,134,144,57,98,16,82
"2011","Adur 002C","E01031340","Total",628,235,6,229,144,43,154,19,135
"2011","Adur 002D","E01031365","Total",639,230,8,222,185,82,170,27,143
"2011","Adur 002E","E01031367","Total",546,175,3,172,130,42,146,14,132
"2011","Adur 003A","E01031345","Total",648,200,8,192,145,55,180,24,156
"2011","Adur 003B","E01031353","Total",469,152,3,149,113,48,103,17,86
"2011","Adur 003C","E01031354","Total",543,185,14,171,126,48,123,21,102
"2011","Adur 003D","E01031355","Total",692,233,24,209,209,81,196,33,163
"2011","Adur 003E","E01031359","Total",523,120,13,107,183,68,153,45,108
"2011","Adur 004A","E01031347","Total",656,258,57,201,237,90,188,48,140
"2011","Adur 004B","E01031348","Total",675,223,54,169,264,120,212,53,159
"2011","Adur 004C","E01031366","Total",495,136,12,124,177,62,134,35,99
"2011","Adur 004D","E01031371","Total",610,282,39,243,157,73,225,24,201
"2011","Adur 004E","E01031372","Total",539,236,39,197,163,64,193,32,161
"2011","Adur 004F","E01031373","Total",628,191,18,173,189,79,160,33,127
"2011","Adur 004G","E01031375","Total",701,272,14,258,160,56,207,13,194
"2011","Adur 005A","E01031356","Total",1035,282,23,259,274,128,247,32,215
"2011","Adur 005B","E01031357","Total",1035,294,27,267,288,133,213,37,176
"2011","Adur 005C","E01031364","Total",797,296,35,261,153,86,225,20,205
"2011","Adur 005D","E01031368","Total",552,203,13,190,141,57,145,16,129
"2011","Adur 005E","E01031369","Total",640,309,18,291,134,54,209,19,190
"2011","Adur 006A","E01031344","Total",608,227,20,207,143,51,183,32,151
"2011","Adur 006B","E01031346","Total",640,234,11,223,131,62,174,21,153
"2011","Adur 006C","E01031361","Total",631,239,31,208,193,74,226,40,186
"2011","Adur 006D","E01031362","Total",507,124,18,106,162,50,114,25,89
"2011","Adur 006E","E01031363","Total",746,346,20,326,150,59,223,28,195
"2011","Adur 007A","E01031358","Total",647,277,34,243,194,64,243,38,205
"2011","Adur 007B","E01031360","Total",649,226,29,197,186,62,180,30,150
"2011","Adur 007C","E01031376","Total",630,284,10,274,92,33,174,15,159
"2011","Adur 007D","E01031378","Total",663,260,18,242,127,50,194,18,176
"2011","Adur 008A","E01031341","Total",629,284,41,243,169,60,197,26,171
"2011","Adur 008B","E01031342","Total",829,410,28,382,140,84,253,16,237
"2011","Adur 008C","E01031343","Total",611,234,10,224,147,60,183,31,152
"2011","Adur 008D","E01031377","Total",807,313,30,283,146,89,248,20,228
"2011","Adur 008E","E01031379","Total",749,333,12,321,143,55,213,21,192
"2011","Arun 001A","E01031390","Total",591,237,16,221,148,42,166,30,136
"2011","Arun 001B","E01031391","Total",730,247,11,236,160,69,155,20,135
"2011","Arun 001C","E01031392","Total",730,283,9,274,107,35,180,11,169
"2011","Arun 001D","E01031465","Total",578,194,5,189,168,53,155,22,133
"2011","Arun 002A","E01031386","Total",592,196,24,172,176,60,161,30,131
"2011","Arun 002B","E01031387","Total",696,281,12,269,170,61,193,26,167
"2011","Arun 002C","E01031425","Total",610,254,9,245,136,48,148,18,130
"2011","Arun 002D","E01031426","Total",534,192,9,183,109,34,146,17,129
"2011","Arun 003A","E01031393","Total",751,275,9,266,168,46,197,19,178
"2011","Arun 003B","E01031394","Total",680,179,20,159,214,80,192,50,142
"2011","Arun 003C","E01031395","Total",637,192,6,186,183,57,171,30,141
"2011","Arun 003D","E01031396","Total",791,235,14,221,231,79,187,37,150
"2011","Arun 003E","E01031397","Total",679,200,7,193,177,50,157,30,127
"2011","Arun 003F","E01031466","Total",590,215,9,206,155,45,154,19,135
"2011","Arun 004A","E01031427","Total",615,278,44,234,184,65,231,40,191
"2011","Arun 004B","E01031429","Total",558,197,70,127,230,107,174,52,122
"2011","Arun 004C","E01031430","Total",602,197,25,172,182,91,175,32,143
"2011","Arun 004D","E01031467","Total",743,251,23,228,209,86,206,38,168
"2011","Arun 004E","E01031468","Total",940,216,36,180,317,156,204,41,163
"2011","Arun 005A","E01031388","Total",1067,314,24,290,367,124,249,59,190
"2011","Arun 005B","E01031389","Total",912,389,9,380,241,64,224,48,176
"2011","Arun 005C","E01031414","Total",636,256,10,246,171,62,196,25,171
"2011","Arun 005D","E01031415","Total",776,453,15,438,121,31,301,23,278
"2011","Arun 005E","E01031459","Total",810,339,41,298,219,85,271,40,231
"2011","Arun 006A","E01031470","Total",629,224,33,191,196,80,149,33,116
"2011","Arun 006B","E01031471","Total",520,129,5,124,153,56,113,17,96
"2011","Arun 006C","E01031472","Total",658,254,16,238,162,56,169,27,142
"2011","Arun 006D","E01031473","Total",493,180,18,162,149,59,151,32,119
"2011","Arun 007A","E01031407","Total",611,148,22,126,250,79,112,33,79
"2011","Arun 007B","E01031408","Total",823,232,35,197,280,126,168,30,138
"2011","Arun 007C","E01031410","Total",600,206,13,193,145,62,172,23,149
"2011","Arun 007D","E01031462","Total",636,240,17,223,197,76,175,37,138
"2011","Arun 007E","E01031463","Total",650,261,13,248,188,69,154,20,134
"2011","Arun 007F","E01031464","Total",813,453,19,434,150,63,294,25,269
"2011","Arun 008A","E01031412","Total",638,300,3,297,118,32,155,12,143
"2011","Arun 008B","E01031422","Total",764,486,4,482,85,27,251,12,239
"2011","Arun 008C","E01031423","Total",776,381,6,375,130,40,249,16,233
"2011","Arun 008D","E01031424","Total",686,397,5,392,77,27,228,18,210
"2011","Arun 009A","E01031398","Total",604,207,9,198,169,47,166,34,132
"2011","Arun 009B","E01031399","Total",753,358,11,347,145,42,225,13,212
"2011","Arun 009C","E01031409","Total",510,160,24,136,188,76,141,38,103
"2011","Arun 009D","E01031455","Total",644,308,22,286,144,38,212,28,184
"2011","Arun 009E","E01031461","Total",848,421,6,415,140,46,257,19,238
"2011","Arun 009F","E01031469","Total",759,317,31,286,182,78,231,34,197
"2011","Arun 010A","E01031411","Total",674,409,4,405,79,27,201,12,189
"2011","Arun 010B","E01031413","Total",640,316,12,304,100,36,184,15,169
"2011","Arun 010C","E01031457","Total",868,511,7,504,101,35,270,10,260
"2011","Arun 010D","E01031458","Total",909,556,6,550,95,22,291,16,275
"2011","Arun 010E","E01031460","Total",958,596,10,586,88,37,303,16,287
"2011","Arun 011A","E01031400","Total",839,312,17,295,137,65,229,19,210
"2011","Arun 011B","E01031428","Total",654,186,24,162,181,81,161,27,134
"2011","Arun 011C","E01031454","Total",999,353,49,304,250,117,268,42,226
"2011","Arun 011D","E01031456","Total",970,440,38,402,167,87,296,28,268
"2011","Arun 012A","E01031401","Total",666,231,21,210,170,65,155,16,139
"2011","Arun 012B","E01031402","Total",713,238,8,230,165,62,175,22,153
"2011","Arun 012C","E01031403","Total",634,226,13,213,164,66,192,27,165
"2011","Arun 012D","E01031405","Total",626,216,13,203,150,77,188,21,167
"2011","Arun 012E","E01031406","Total",500,128,16,112,197,62,121,31,90
"2011","Arun 013A","E01031417","Total",693,248,16,232,227,92,172,36,136
"2011","Arun 013B","E01031438","Total",739,267,12,255,213,82,192,29,163
"2011","Arun 013C","E01031439","Total",938,497,11,486,164,39,288,24,264
"2011","Arun 013D","E01031440","Total",770,417,9,408,108,37,241,14,227
"2011","Arun 014A","E01031404","Total",490,186,39,147,191,80,186,51,135
"2011","Arun 014B","E01031433","Total",610,262,26,236,157,57,187,26,161
"2011","Arun 014C","E01031434","Total",711,219,27,192,169,73,186,25,161
"2011","Arun 014D","E01031441","Total",746,319,31,288,195,87,244,30,214
"2011","Arun 014E","E01031442","Total",607,165,26,139,197,91,131,30,101
"2011","Arun 015A","E01031416","Total",643,272,1,271,155,38,160,20,140
"2011","Arun 015B","E01031418","Total",766,346,11,335,160,41,234,27,207
"2011","Arun 015C","E01031419","Total",784,364,19,345,158,54,217,18,199
"2011","Arun 015D","E01031420","Total",736,347,8,339,142,43,201,15,186
"2011","Arun 015E","E01031421","Total",730,311,13,298,199,61,169,27,142
"2011","Arun 016A","E01031443","Total",507,142,30,112,192,60,158,48,110
"2011","Arun 016B","E01031444","Total",654,193,25,168,205,93,149,32,117
"2011","Arun 016C","E01031450","Total",518,171,38,133,191,71,143,48,95
"2011","Arun 016D","E01031451","Total",621,245,32,213,191,80,195,44,151
"2011","Arun 016E","E01031452","Total",528,175,20,155,167,60,140,25,115
"2011","Arun 017A","E01031431","Total",488,259,6,253,45,25,174,7,167
"2011","Arun 017B","E01031432","Total",937,368,33,335,159,90,268,18,250
"2011","Arun 017C","E01031435","Total",724,252,12,240,136,63,171,19,152
"2011","Arun 017D","E01031436","Total",998,432,35,397,177,111,324,20,304
"2011","Arun 017E","E01031437","Total",991,343,37,306,159,100,244,22,222
"2011","Arun 017F","E01031453","Total",712,325,19,306,130,54,244,24,220
"2011","Arun 018A","E01031380","Total",749,395,7,388,113,41,182,14,168
"2011","Arun 018B","E01031381","Total",768,405,12,393,122,53,231,15,216
"2011","Arun 018C","E01031382","Total",795,415,4,411,130,58,243,15,228
"2011","Arun 018D","E01031383","Total",745,413,2,411,103,32,201,11,190
"2011","Arun 018E","E01031384","Total",774,391,14,377,158,57,210,17,193
"2011","Arun 019A","E01031385","Total",763,373,26,347,159,69,238,24,214
"2011","Arun 019B","E01031445","Total",766,451,5,446,106,34,247,8,239
"2011","Arun 019C","E01031446","Total",623,282,8,274,128,53,189,18,171
"2011","Arun 019D","E01031447","Total",733,374,13,361,122,49,238,23,215
"2011","Arun 019E","E01031448","Total",766,353,9,344,118,46,229,26,203
"2011","Arun 019F","E01031449","Total",670,233,29,204,213,80,207,39,168
"2011","Chichester 001A","E01031502","Total",592,135,5,130,228,94,96,20,76
"2011","Chichester 001B","E01031503","Total",567,135,12,123,206,66,104,17,87
"2011","Chichester 001C","E01031504","Total",935,329,29,300,252,110,213,32,181
"2011","Chichester 001D","E01031519","Total",542,149,18,131,169,77,115,25,90
"2011","Chichester 002A","E01031517","Total",734,223,7,216,218,78,128,27,101
"2011","Chichester 002B","E01031518","Total",619,196,8,188,184,54,135,24,111
"2011","Chichester 002C","E01031544","Total",519,135,7,128,162,66,112,21,91
"2011","Chichester 002D","E01031545","Total",515,179,5,174,116,35,121,14,107
"2011","Chichester 003A","E01031508","Total",874,287,15,272,208,68,192,27,165
"2011","Chichester 003B","E01031520","Total",548,186,13,173,137,39,136,22,114
"2011","Chichester 003C","E01031521","Total",453,115,2,113,124,45,84,11,73
"2011","Chichester 003D","E01031536","Total",517,177,6,171,124,38,94,8,86
"2011","Chichester 004A","E01031497","Total",565,191,7,184,155,60,113,17,96
"2011","Chichester 004C","E01031511","Total",749,335,10,325,124,44,214,11,203
"2011","Chichester 004D","E01031512","Total",882,350,31,319,207,80,265,29,236
"2011","Chichester 004F","E01032717","Total",1228,497,25,472,251,97,303,21,282
"2011","Chichester 005A","E01031478","Total",464,144,6,138,105,31,90,12,78
"2011","Chichester 005B","E01031479","Total",442,140,3,137,97,26,89,9,80
"2011","Chichester 005C","E01031498","Total",482,168,4,164,134,31,89,8,81
"2011","Chichester 005D","E01031514","Total",758,281,11,270,156,62,183,13,170
"2011","Chichester 005E","E01031515","Total",702,225,27,198,199,81,173,20,153
"2011","Chichester 005F","E01031516","Total",654,214,12,202,147,45,135,13,122
"2011","Chichester 006A","E01031477","Total",1002,362,16,346,231,78,252,26,226
"2011","Chichester 006B","E01031485","Total",675,339,3,336,137,34,165,16,149
"2011","Chichester 006C","E01031487","Total",675,322,13,309,136,48,182,24,158
"2011","Chichester 006D","E01031509","Total",1004,301,25,276,261,102,229,28,201
"2011","Chichester 007A","E01031506","Total",529,169,8,161,141,39,106,11,95
"2011","Chichester 007B","E01031507","Total",588,169,9,160,153,44,116,18,98
"2011","Chichester 007C","E01031531","Total",524,170,3,167,144,39,126,9,117
"2011","Chichester 007D","E01031533","Total",508,204,12,192,132,47,175,18,157
"2011","Chichester 007E","E01031543","Total",1000,323,22,301,280,108,222,26,196
"2011","Chichester 008A","E01031482","Total",683,208,33,175,167,78,186,29,157
"2011","Chichester 008B","E01031483","Total",1006,322,41,281,293,132,268,52,216
"2011","Chichester 008C","E01031486","Total",841,375,7,368,78,38,213,12,201
"2011","Chichester 008D","E01031488","Total",771,231,28,203,221,109,146,38,108
"2011","Chichester 008E","E01031494","Total",730,337,40,297,189,89,243,32,211
"2011","Chichester 008F","E01031495","Total",760,310,11,299,134,48,213,19,194
"2011","Chichester 009A","E01031475","Total",505,153,5,148,140,36,119,19,100
"2011","Chichester 009B","E01031476","Total",692,292,8,284,135,45,148,11,137
"2011","Chichester 009C","E01031532","Total",456,89,3,86,217,118,57,15,42
"2011","Chichester 009D","E01031534","Total",867,356,20,336,168,72,210,16,194
"2011","Chichester 009E","E01031535","Total",677,248,11,237,163,65,166,25,141
"2011","Chichester 010A","E01031480","Total",605,151,27,124,150,70,109,17,92
"2011","Chichester 010B","E01031481","Total",740,262,21,241,153,67,195,16,179
"2011","Chichester 010C","E01031484","Total",905,354,16,338,152,68,247,21,226
"2011","Chichester 010D","E01031490","Total",956,486,5,481,95,38,320,15,305
"2011","Chichester 010E","E01031491","Total",924,341,11,330,170,79,194,12,182
"2011","Chichester 011A","E01031474","Total",636,221,10,211,170,54,141,14,127
"2011","Chichester 011B","E01031493","Total",786,377,27,350,160,61,211,18,193
"2011","Chichester 011C","E01031496","Total",933,299,16,283,241,80,206,24,182
"2011","Chichester 011D","E01031505","Total",988,322,11,311,252,72,227,35,192
"2011","Chichester 012A","E01031489","Total",645,190,7,183,171,50,139,24,115
"2011","Chichester 012B","E01031492","Total",614,255,24,231,173,59,191,32,159
"2011","Chichester 012C","E01031513","Total",907,277,13,264,243,87,193,32,161
"2011","Chichester 012D","E01031530","Total",535,187,16,171,151,47,128,19,109
"2011","Chichester 012E","E01031538","Total",615,186,33,153,203,72,135,34,101
"2011","Chichester 012F","E01031539","Total",491,118,16,102,143,69,83,19,64
"2011","Chichester 013A","E01031499","Total",797,281,28,253,212,93,192,32,160
"2011","Chichester 013B","E01031500","Total",766,306,18,288,177,61,220,27,193
"2011","Chichester 013C","E01031501","Total",692,344,14,330,127,41,231,18,213
"2011","Chichester 013D","E01031529","Total",479,146,10,136,114,42,104,15,89
"2011","Chichester 013E","E01031540","Total",664,349,11,338,100,35,193,15,178
"2011","Chichester 013F","E01031541","Total",688,372,10,362,92,29,241,11,230
"2011","Chichester 013G","E01031542","Total",785,326,12,314,173,53,185,26,159
"2011","Chichester 014A","E01031522","Total",925,422,37,385,218,95,302,37,265
"2011","Chichester 014B","E01031523","Total",697,315,15,300,162,48,172,22,150
"2011","Chichester 014C","E01031524","Total",712,401,5,396,91,38,265,18,247
"2011","Chichester 014D","E01031525","Total",627,263,12,251,123,35,192,17,175
"2011","Chichester 014E","E01031526","Total",543,228,12,216,121,40,141,21,120
"2011","Chichester 014F","E01031527","Total",678,339,15,324,130,33,214,19,195
"2011","Chichester 014G","E01031528","Total",681,292,12,280,141,54,203,22,181
"2011","Crawley 001A","E01031573","Total",642,217,31,186,211,103,182,36,146
"2011","Crawley 001B","E01031574","Total",649,162,28,134,254,119,170,51,119
"2011","Crawley 001C","E01031575","Total",647,152,28,124,196,93,143,28,115
"2011","Crawley 001D","E01031576","Total",564,196,41,155,218,101,162,45,117
"2011","Crawley 001E","E01031577","Total",440,114,18,96,158,85,121,30,91
"2011","Crawley 002A","E01031586","Total",726,167,34,133,273,152,127,30,97
"2011","Crawley 002B","E01031587","Total",650,148,10,138,191,71,129,18,111
"2011","Crawley 002C","E01031588","Total",606,187,13,174,181,68,137,12,125
"2011","Crawley 002D","E01031590","Total",649,134,10,124,194,80,106,20,86
"2011","Crawley 002E","E01031593","Total",597,128,6,122,155,61,94,15,79
"2011","Crawley 003A","E01031570","Total",510,137,16,121,177,70,127,32,95
"2011","Crawley 003B","E01031571","Total",674,233,35,198,216,94,191,38,153
"2011","Crawley 003C","E01031572","Total",637,252,29,223,174,77,214,37,177
"2011","Crawley 003D","E01031609","Total",684,265,34,231,200,85,224,39,185
"2011","Crawley 003E","E01031610","Total",796,291,35,256,234,122,204,31,173
"2011","Crawley 004A","E01031583","Total",931,234,33,201,236,123,205,36,169
"2011","Crawley 004B","E01031584","Total",655,213,30,183,200,90,187,47,140
"2011","Crawley 004C","E01031585","Total",673,227,18,209,166,66,174,17,157
"2011","Crawley 004D","E01031601","Total",487,160,14,146,148,56,131,30,101
"2011","Crawley 004F","E01032835","Total",758,123,38,85,201,149,84,22,62
"2011","Crawley 004G","E01032836","Total",637,207,21,186,182,73,169,24,145
"2011","Crawley 005A","E01031589","Total",707,216,14,202,203,74,159,19,140
"2011","Crawley 005B","E01031591","Total",766,200,28,172,239,87,158,30,128
"2011","Crawley 005C","E01031594","Total",577,191,36,155,211,101,138,34,104
"2011","Crawley 005D","E01031600","Total",624,216,15,201,160,74,172,17,155
"2011","Crawley 005E","E01031603","Total",595,164,20,144,183,76,132,28,104
"2011","Crawley 006A","E01031564","Total",614,202,18,184,180,76,132,25,107
"2011","Crawley 006B","E01031565","Total",846,285,41,244,289,123,248,64,184
"2011","Crawley 006C","E01031566","Total",668,243,25,218,186,72,177,33,144
"2011","Crawley 006D","E01031567","Total",518,154,18,136,150,56,123,19,104
"2011","Crawley 006E","E01031568","Total",635,127,36,91,189,112,104,23,81
"2011","Crawley 007A","E01031596","Total",788,280,57,223,261,127,224,38,186
"2011","Crawley 007B","E01031597","Total",587,191,11,180,148,50,123,19,104
"2011","Crawley 007C","E01031598","Total",765,275,35,240,187,103,186,25,161
"2011","Crawley 007D","E01031599","Total",772,213,23,190,224,113,174,32,142
"2011","Crawley 007E","E01031608","Total",738,185,34,151,206,116,148,24,124
"2011","Crawley 008A","E01031578","Total",743,90,10,80,288,140,106,27,79
"2011","Crawley 008B","E01031580","Total",860,95,32,63,429,177,88,40,48
"2011","Crawley 008C","E01031581","Total",619,47,4,43,315,115,66,33,33
"2011","Crawley 008D","E01031592","Total",786,140,3,137,251,99,117,25,92
"2011","Crawley 009A","E01031560","Total",624,230,22,208,151,54,172,28,144
"2011","Crawley 009B","E01031561","Total",597,208,16,192,141,51,173,20,153
"2011","Crawley 009C","E01031562","Total",604,260,31,229,147,71,211,25,186
"2011","Crawley 009D","E01031563","Total",484,152,11,141,135,35,129,21,108
"2011","Crawley 009E","E01031579","Total",701,130,18,112,246,100,139,33,106
"2011","Crawley 009F","E01031582","Total",799,82,18,64,295,142,113,31,82
"2011","Crawley 010A","E01031547","Total",518,116,33,83,191,78,127,34,93
"2011","Crawley 010B","E01031548","Total",698,198,48,150,238,116,192,42,150
"2011","Crawley 010C","E01031549","Total",523,105,42,63,234,106,121,44,77
"2011","Crawley 010D","E01031550","Total",522,97,36,61,219,85,131,41,90
"2011","Crawley 010E","E01031569","Total",639,180,38,142,213,98,156,27,129
"2011","Crawley 011A","E01031595","Total",642,200,39,161,230,104,162,42,120
"2011","Crawley 011B","E01031604","Total",674,243,20,223,187,77,195,23,172
"2011","Crawley 011C","E01031605","Total",599,203,35,168,215,96,174,37,137
"2011","Crawley 011D","E01031606","Total",611,212,22,190,199,83,161,28,133
"2011","Crawley 011E","E01031607","Total",570,186,20,166,188,89,179,34,145
"2011","Crawley 012A","E01031546","Total",477,69,34,35,221,98,96,44,52
"2011","Crawley 012B","E01031551","Total",496,84,31,53,241,99,99,36,63
"2011","Crawley 012C","E01031553","Total",504,109,45,64,261,108,93,38,55
"2011","Crawley 012D","E01031554","Total",700,129,35,94,232,126,136,40,96
"2011","Crawley 012E","E01031555","Total",485,106,32,74,218,93,116,43,73
"2011","Crawley 013A","E01031552","Total",753,219,61,158,251,134,169,30,139
"2011","Crawley 013B","E01031556","Total",663,133,54,79,288,104,143,56,87
"2011","Crawley 013C","E01031557","Total",862,136,22,114,204,130,117,22,95
"2011","Crawley 013D","E01031558","Total",648,282,67,215,229,112,237,60,177
"2011","Crawley 013E","E01031559","Total",514,109,42,67,238,117,108,45,63
"2011","Horsham 001A","E01031670","Total",702,189,12,177,169,81,170,20,150
"2011","Horsham 001B","E01031671","Total",798,262,17,245,189,72,223,30,193
"2011","Horsham 001C","E01031673","Total",645,176,23,153,211,85,146,37,109
"2011","Horsham 001D","E01031676","Total",1053,218,11,207,315,99,193,32,161
"2011","Horsham 002A","E01031644","Total",559,120,8,112,199,62,95,16,79
"2011","Horsham 002B","E01031645","Total",550,100,9,91,229,72,73,25,48
"2011","Horsham 002C","E01031646","Total",603,95,11,84,237,66,84,22,62
"2011","Horsham 002D","E01031647","Total",508,152,13,139,149,57,133,19,114
"2011","Horsham 002E","E01031649","Total",455,90,3,87,154,56,73,13,60
"2011","Horsham 002F","E01031650","Total",490,107,7,100,192,59,71,19,52
"2011","Horsham 002G","E01031666","Total",646,204,4,200,193,73,133,15,118
"2011","Horsham 002H","E01031668","Total",654,241,8,233,176,61,164,20,144
"2011","Horsham 003A","E01031620","Total",680,180,30,150,222,87,146,30,116
"2011","Horsham 003B","E01031648","Total",783,253,16,237,178,76,185,24,161
"2011","Horsham 003C","E01031651","Total",646,149,21,128,242,102,116,24,92
"2011","Horsham 003D","E01031658","Total",874,276,18,258,228,83,206,24,182
"2011","Horsham 003E","E01031689","Total",663,184,11,173,203,85,122,18,104
"2011","Horsham 004A","E01031654","Total",650,226,6,220,191,49,149,22,127
"2011","Horsham 004B","E01031655","Total",619,125,16,109,223,100,105,21,84
"2011","Horsham 004C","E01031667","Total",652,218,8,210,195,70,161,18,143
"2011","Horsham 004D","E01031669","Total",685,203,27,176,197,71,150,30,120
"2011","Horsham 004E","E01031672","Total",822,206,9,197,181,86,147,16,131
"2011","Horsham 005A","E01031657","Total",789,236,18,218,229,76,166,24,142
"2011","Horsham 005B","E01031659","Total",555,127,7,120,182,60,115,19,96
"2011","Horsham 005C","E01031674","Total",545,159,2,157,129,38,121,15,106
"2011","Horsham 005D","E01031675","Total",541,147,8,139,165,52,91,12,79
"2011","Horsham 006A","E01031636","Total",1091,439,20,419,206,104,299,25,274
"2011","Horsham 006B","E01031652","Total",631,192,37,155,259,102,195,55,140
"2011","Horsham 006C","E01031653","Total",779,206,7,199,175,79,151,17,134
"2011","Horsham 006D","E01031656","Total",817,264,19,245,219,103,235,38,197
"2011","Horsham 006E","E01031688","Total",603,234,13,221,162,60,188,19,169
"2011","Horsham 006F","E01031691","Total",776,278,6,272,188,83,161,18,143
"2011","Horsham 007A","E01031619","Total",643,122,14,108,200,72,112,26,86
"2011","Horsham 007B","E01031637","Total",812,263,28,235,229,94,222,38,184
"2011","Horsham 007C","E01031638","Total",796,187,13,174,212,92,150,29,121
"2011","Horsham 007D","E01031690","Total",641,249,4,245,165,52,170,26,144
"2011","Horsham 008A","E01031639","Total",798,229,12,217,202,71,162,17,145
"2011","Horsham 008B","E01031640","Total",713,253,5,248,211,42,147,28,119
"2011","Horsham 008C","E01031660","Total",515,158,8,150,135,38,111,9,102
"2011","Horsham 008D","E01031661","Total",630,183,3,180,155,36,137,22,115
"2011","Horsham 008E","E01031679","Total",498,107,7,100,166,62,91,17,74
"2011","Horsham 009A","E01031677","Total",604,184,15,169,186,82,165,26,139
"2011","Horsham 009B","E01031678","Total",571,103,5,98,242,65,103,24,79
"2011","Horsham 009C","E01031680","Total",493,98,4,94,212,49,96,30,66
"2011","Horsham 009D","E01031681","Total",581,119,10,109,231,79,121,45,76
"2011","Horsham 009E","E01031682","Total",470,55,7,48,195,64,68,22,46
"2011","Horsham 009F","E01031683","Total",623,127,11,116,209,89,119,24,95
"2011","Horsham 010A","E01031611","Total",669,170,11,159,168,48,136,26,110
"2011","Horsham 010B","E01031612","Total",874,216,16,200,279,133,161,33,128
"2011","Horsham 010C","E01031613","Total",842,211,13,198,278,115,158,38,120
"2011","Horsham 010D","E01031614","Total",839,255,38,217,293,105,222,43,179
"2011","Horsham 010E","E01031615","Total",721,304,4,300,150,53,185,15,170
"2011","Horsham 011A","E01031632","Total",615,135,10,125,157,45,120,21,99
"2011","Horsham 011B","E01031633","Total",524,145,10,135,151,52,110,22,88
"2011","Horsham 011C","E01031634","Total",493,124,13,111,165,58,93,17,76
"2011","Horsham 011D","E01031635","Total",552,122,8,114,200,67,109,25,84
"2011","Horsham 012A","E01031621","Total",793,419,3,416,89,15,177,11,166
"2011","Horsham 012B","E01031623","Total",752,308,6,302,148,43,165,11,154
"2011","Horsham 012C","E01031627","Total",838,341,8,333,211,55,202,26,176
"2011","Horsham 012D","E01031664","Total",666,229,11,218,171,59,132,22,110
"2011","Horsham 013A","E01031626","Total",669,240,14,226,159,64,156,22,134
"2011","Horsham 013B","E01031630","Total",825,382,8,374,157,62,243,19,224
"2011","Horsham 013C","E01031631","Total",791,401,30,371,166,74,253,31,222
"2011","Horsham 013D","E01031662","Total",719,228,13,215,154,60,153,17,136
"2011","Horsham 013E","E01031663","Total",777,239,28,211,221,93,211,38,173
"2011","Horsham 013F","E01031665","Total",543,193,8,185,118,46,133,15,118
"2011","Horsham 014A","E01031618","Total",542,138,6,132,146,38,118,18,100
"2011","Horsham 014B","E01031641","Total",749,318,9,309,146,53,207,22,185
"2011","Horsham 014C","E01031642","Total",772,256,17,239,220,68,183,28,155
"2011","Horsham 014D","E01031643","Total",725,307,27,280,211,81,211,38,173
"2011","Horsham 014E","E01031687","Total",676,239,18,221,207,81,191,35,156
"2011","Horsham 015A","E01031622","Total",637,147,4,143,209,62,93,22,71
"2011","Horsham 015B","E01031624","Total",599,144,12,132,200,66,120,27,93
"2011","Horsham 015C","E01031625","Total",547,124,5,119,186,55,122,29,93
"2011","Horsham 015D","E01031628","Total",507,156,15,141,146,56,115,16,99
"2011","Horsham 015E","E01031629","Total",631,243,8,235,131,37,146,17,129
"2011","Horsham 016A","E01031616","Total",685,191,16,175,208,74,176,30,146
"2011","Horsham 016B","E01031617","Total",993,346,20,326,271,81,228,40,188
"2011","Horsham 016C","E01031684","Total",631,220,10,210,163,55,121,16,105
"2011","Horsham 016D","E01031685","Total",842,374,13,361,169,56,236,17,219
"2011","Horsham 016E","E01031686","Total",633,283,2,281,147,34,187,27,160
"2011","Mid Sussex 001A","E01031731","Total",860,306,42,264,270,118,250,31,219
"2011","Mid Sussex 001B","E01031732","Total",699,161,20,141,254,101,148,27,121
"2011","Mid Sussex 001C","E01031733","Total",755,184,18,166,226,99,128,20,108
"2011","Mid Sussex 001D","E01031734","Total",620,141,3,138,217,61,97,14,83
"2011","Mid Sussex 001E","E01031741","Total",819,250,11,239,167,77,193,22,171
"2011","Mid Sussex 001F","E01031742","Total",971,354,4,350,151,60,275,14,261
"2011","Mid Sussex 001G","E01031743","Total",769,198,16,182,185,89,144,22,122
"2011","Mid Sussex 002A","E01031718","Total",685,154,11,143,211,68,146,34,112
"2011","Mid Sussex 002B","E01031719","Total",722,188,10,178,224,54,141,28,113
"2011","Mid Sussex 002C","E01031720","Total",548,170,9,161,174,52,119,26,93
"2011","Mid Sussex 002D","E01031722","Total",474,105,12,93,135,57,107,21,86
"2011","Mid Sussex 003A","E01031695","Total",565,148,7,141,174,60,104,21,83
"2011","Mid Sussex 003B","E01031696","Total",563,153,8,145,160,56,135,23,112
"2011","Mid Sussex 003C","E01031729","Total",706,204,10,194,198,60,127,20,107
"2011","Mid Sussex 003D","E01031730","Total",781,99,13,86,271,118,102,25,77
"2011","Mid Sussex 003E","E01031735","Total",695,163,4,159,202,65,137,26,111
"2011","Mid Sussex 004A","E01031736","Total",620,192,4,188,171,55,131,24,107
"2011","Mid Sussex 004B","E01031737","Total",580,126,10,116,214,84,108,30,78
"2011","Mid Sussex 004C","E01031738","Total",512,196,1,195,141,39,121,20,101
"2011","Mid Sussex 004D","E01031739","Total",724,195,1,194,204,69,139,17,122
"2011","Mid Sussex 004E","E01031740","Total",545,158,2,156,151,52,99,15,84
"2011","Mid Sussex 005A","E01031721","Total",698,306,6,300,153,57,210,14,196
"2011","Mid Sussex 005B","E01031723","Total",551,169,6,163,142,35,108,12,96
"2011","Mid Sussex 005C","E01031724","Total",506,73,6,67,196,65,72,16,56
"2011","Mid Sussex 005D","E01031725","Total",588,164,5,159,174,61,121,20,101
"2011","Mid Sussex 006A","E01031694","Total",689,180,10,170,215,71,160,33,127
"2011","Mid Sussex 006B","E01031764","Total",596,188,8,180,169,58,146,25,121
"2011","Mid Sussex 006C","E01031765","Total",611,163,12,151,207,65,147,28,119
"2011","Mid Sussex 006D","E01031766","Total",833,207,10,197,243,76,170,28,142
"2011","Mid Sussex 007A","E01031692","Total",897,208,28,180,308,143,188,43,145
"2011","Mid Sussex 007B","E01031693","Total",755,225,14,211,218,91,178,20,158
"2011","Mid Sussex 007C","E01031697","Total",488,111,4,107,148,56,98,13,85
"2011","Mid Sussex 007D","E01031727","Total",644,178,14,164,209,61,121,29,92
"2011","Mid Sussex 008A","E01031758","Total",507,84,3,81,180,57,92,24,68
"2011","Mid Sussex 008B","E01031760","Total",683,157,11,146,229,94,117,25,92
"2011","Mid Sussex 008C","E01031772","Total",724,268,18,250,184,70,215,29,186
"2011","Mid Sussex 008D","E01031773","Total",815,299,9,290,231,96,190,24,166
"2011","Mid Sussex 008E","E01031774","Total",661,242,8,234,203,78,143,27,116
"2011","Mid Sussex 008F","E01031775","Total",775,334,4,330,185,84,187,12,175
"2011","Mid Sussex 009A","E01031751","Total",1156,212,23,189,327,145,192,46,146
"2011","Mid Sussex 009B","E01031759","Total",710,191,6,185,187,72,133,16,117
"2011","Mid Sussex 009C","E01031761","Total",1103,331,9,322,149,82,252,15,237
"2011","Mid Sussex 009E","E01032837","Total",552,177,6,171,167,88,141,24,117
"2011","Mid Sussex 009F","E01032838","Total",562,54,13,41,205,123,55,18,37
"2011","Mid Sussex 009G","E01032839","Total",573,171,2,169,96,36,121,8,113
"2011","Mid Sussex 010A","E01031752","Total",558,189,42,147,206,95,180,41,139
"2011","Mid Sussex 010B","E01031753","Total",590,167,11,156,167,62,138,29,109
"2011","Mid Sussex 010C","E01031754","Total",646,163,7,156,213,87,153,26,127
"2011","Mid Sussex 010D","E01031755","Total",533,130,9,121,173,78,103,14,89
"2011","Mid Sussex 010E","E01031757","Total",701,195,25,170,193,80,167,25,142
"2011","Mid Sussex 011A","E01031726","Total",596,152,12,140,212,82,124,26,98
"2011","Mid Sussex 011B","E01031728","Total",840,280,12,268,235,77,198,31,167
"2011","Mid Sussex 011C","E01031749","Total",603,162,3,159,205,77,121,14,107
"2011","Mid Sussex 011D","E01031750","Total",637,186,19,167,195,89,163,26,137
"2011","Mid Sussex 011E","E01031756","Total",778,211,16,195,218,88,168,30,138
"2011","Mid Sussex 011F","E01031763","Total",695,230,7,223,204,77,135,19,116
"2011","Mid Sussex 012A","E01031699","Total",685,106,16,90,253,109,97,27,70
"2011","Mid Sussex 012B","E01031700","Total",607,86,5,81,294,87,101,32,69
"2011","Mid Sussex 012C","E01031701","Total",752,163,16,147,261,95,154,36,118
"2011","Mid Sussex 012D","E01031714","Total",564,156,6,150,194,79,152,31,121
"2011","Mid Sussex 013A","E01031704","Total",717,193,19,174,229,109,128,20,108
"2011","Mid Sussex 013B","E01031706","Total",669,204,5,199,201,65,183,22,161
"2011","Mid Sussex 013C","E01031711","Total",683,166,11,155,228,82,152,33,119
"2011","Mid Sussex 013D","E01031712","Total",639,175,23,152,202,92,159,26,133
"2011","Mid Sussex 013E","E01031713","Total",556,171,4,167,152,44,150,27,123
"2011","Mid Sussex 014A","E01031705","Total",658,164,19,145,201,95,169,34,135
"2011","Mid Sussex 014B","E01031707","Total",647,228,4,224,157,51,173,27,146
"2011","Mid Sussex 014C","E01031708","Total",751,193,10,183,185,88,174,19,155
"2011","Mid Sussex 014D","E01031709","Total",779,292,11,281,181,67,239,18,221
"2011","Mid Sussex 014E","E01031716","Total",476,124,29,95,197,85,106,27,79
"2011","Mid Sussex 014F","E01031717","Total",566,117,12,105,199,89,110,22,88
"2011","Mid Sussex 015A","E01031702","Total",527,147,4,143,159,47,96,21,75
"2011","Mid Sussex 015B","E01031703","Total",646,248,7,241,155,35,153,22,131
"2011","Mid Sussex 015C","E01031710","Total",592,202,3,199,155,50,156,21,135
"2011","Mid Sussex 015D","E01031715","Total",612,95,6,89,258,102,101,28,73
"2011","Mid Sussex 016A","E01031698","Total",624,135,5,130,198,66,114,30,84
"2011","Mid Sussex 016B","E01031767","Total",537,155,3,152,171,61,131,28,103
"2011","Mid Sussex 016C","E01031769","Total",707,155,11,144,271,112,142,31,111
"2011","Mid Sussex 016D","E01031770","Total",719,182,8,174,205,81,145,20,125
"2011","Mid Sussex 016E","E01031771","Total",605,153,25,128,246,93,128,34,94
"2011","Mid Sussex 017A","E01031744","Total",587,198,5,193,173,52,154,37,117
"2011","Mid Sussex 017B","E01031745","Total",788,308,9,299,201,89,198,19,179
"2011","Mid Sussex 017C","E01031746","Total",727,245,16,229,212,82,194,27,167
"2011","Mid Sussex 017D","E01031747","Total",670,297,4,293,139,44,187,17,170
"2011","Mid Sussex 017E","E01031748","Total",569,217,5,212,158,50,140,17,123
"2011","Mid Sussex 017F","E01031768","Total",683,279,3,276,164,60,170,18,152
"2011","Worthing 001A","E01031793","Total",604,247,7,240,121,37,161,17,144
"2011","Worthing 001B","E01031820","Total",796,422,6,416,138,34,212,20,192
"2011","Worthing 001C","E01031821","Total",771,333,9,324,184,58,226,20,206
"2011","Worthing 001D","E01031828","Total",538,193,8,185,123,39,123,11,112
"2011","Worthing 001E","E01031829","Total",621,225,9,216,142,46,158,19,139
"2011","Worthing 002A","E01031822","Total",657,232,7,225,184,53,157,22,135
"2011","Worthing 002B","E01031825","Total",784,349,4,345,119,47,253,19,234
"2011","Worthing 002C","E01031826","Total",613,203,17,186,162,54,163,26,137
"2011","Worthing 002D","E01031827","Total",650,226,25,201,178,72,185,33,152
"2011","Worthing 002E","E01031839","Total",762,243,18,225,237,85,209,37,172
"2011","Worthing 003A","E01031792","Total",621,255,25,230,152,72,180,19,161
"2011","Worthing 003B","E01031794","Total",660,351,8,343,109,51,232,11,221
"2011","Worthing 003C","E01031795","Total",647,196,40,156,217,110,177,50,127
"2011","Worthing 003D","E01031818","Total",758,194,49,145,295,111,181,59,122
"2011","Worthing 003E","E01031830","Total",654,249,49,200,219,89,192,47,145
"2011","Worthing 004A","E01031778","Total",677,220,15,205,171,68,159,19,140
"2011","Worthing 004B","E01031797","Total",512,146,4,142,161,48,102,12,90
"2011","Worthing 004C","E01031800","Total",629,184,2,182,236,80,150,23,127
"2011","Worthing 004D","E01031823","Total",533,149,4,145,188,49,117,30,87
"2011","Worthing 004E","E01031824","Total",511,154,6,148,181,49,99,22,77
"2011","Worthing 005A","E01031776","Total",690,161,19,142,235,112,133,23,110
"2011","Worthing 005B","E01031777","Total",725,209,20,189,238,101,184,38,146
"2011","Worthing 005C","E01031780","Total",553,125,14,111,228,80,126,32,94
"2011","Worthing 005D","E01031781","Total",632,167,25,142,241,101,147,31,116
"2011","Worthing 005E","E01031798","Total",695,195,15,180,179,66,172,32,140
"2011","Worthing 006A","E01031783","Total",614,247,33,214,200,72,247,51,196
"2011","Worthing 006B","E01031785","Total",647,223,22,201,180,77,179,31,148
"2011","Worthing 006C","E01031786","Total",626,199,34,165,195,88,182,44,138
"2011","Worthing 006D","E01031817","Total",640,125,33,92,236,84,135,38,97
"2011","Worthing 006E","E01031819","Total",474,151,52,99,215,75,157,65,92
"2011","Worthing 007A","E01031782","Total",776,370,15,355,148,41,259,29,230
"2011","Worthing 007B","E01031784","Total",780,283,27,256,228,91,196,31,165
"2011","Worthing 007C","E01031836","Total",772,273,23,250,227,102,218,36,182
"2011","Worthing 007D","E01031838","Total",659,178,14,164,195,73,159,29,130
"2011","Worthing 007E","E01031840","Total",771,258,16,242,191,80,186,19,167
"2011","Worthing 008A","E01031791","Total",1002,353,68,285,288,166,254,47,207
"2011","Worthing 008B","E01031796","Total",667,179,36,143,243,111,141,25,116
"2011","Worthing 008C","E01031799","Total",666,215,27,188,224,83,204,44,160
"2011","Worthing 008D","E01031801","Total",823,252,41,211,264,138,204,34,170
"2011","Worthing 008E","E01031837","Total",811,185,24,161,281,128,183,40,143
"2011","Worthing 009A","E01031779","Total",536,211,55,156,214,95,168,50,118
"2011","Worthing 009B","E01031831","Total",667,174,16,158,202,90,154,37,117
"2011","Worthing 009C","E01031832","Total",866,386,11,375,140,65,295,24,271
"2011","Worthing 009D","E01031833","Total",664,188,35,153,226,100,165,35,130
"2011","Worthing 009E","E01031834","Total",658,203,24,179,209,75,203,38,165
"2011","Worthing 010A","E01031790","Total",963,400,31,369,155,77,281,24,257
"2011","Worthing 010B","E01031807","Total",853,421,14,407,132,61,272,13,259
"2011","Worthing 010C","E01031809","Total",887,333,12,321,118,57,225,17,208
"2011","Worthing 010D","E01031810","Total",787,219,23,196,204,87,167,18,149
"2011","Worthing 010E","E01031811","Total",674,231,5,226,97,48,173,10,163
"2011","Worthing 011A","E01031787","Total",1086,372,26,346,175,103,285,23,262
"2011","Worthing 011B","E01031788","Total",1011,324,48,276,291,152,255,42,213
"2011","Worthing 011C","E01031789","Total",1025,337,27,310,182,95,237,37,200
"2011","Worthing 011D","E01031808","Total",856,301,25,276,110,73,221,13,208
"2011","Worthing 011E","E01031835","Total",967,276,18,258,147,73,216,22,194
"2011","Worthing 012A","E01031812","Total",813,364,5,359,113,43,221,15,206
"2011","Worthing 012B","E01031813","Total",799,278,28,250,228,100,176,25,151
"2011","Worthing 012C","E01031814","Total",729,296,6,290,147,45,187,27,160
"2011","Worthing 012D","E01031815","Total",790,368,5,363,118,41,207,18,189
"2011","Worthing 012E","E01031816","Total",652,165,15,150,235,106,150,30,120
"2011","Worthing 013A","E01031802","Total",836,487,4,483,102,34,274,15,259
"2011","Worthing 013B","E01031803","Total",648,285,5,280,154,33,182,24,158
"2011","Worthing 013C","E01031804","Total",732,347,5,342,155,47,232,17,215
"2011","Worthing 013D","E01031805","Total",802,427,7,420,132,48,248,17,231
"2011","Worthing 013E","E01031806","Total",722,252,26,226,221,88,223,41,182
"2011","Bath and North East Somerset 001A","E01014399","Total",660,201,21,180,191,88,171,31,140
"2011","Bath and North East Somerset 001B","E01014400","Total",865,313,12,301,199,84,228,25,203
"2011","Bath and North East Somerset 001C","E01014401","Total",651,240,41,199,217,69,209,45,164
"2011","Bath and North East Somerset 002A","E01014402","Total",731,249,29,220,207,84,210,33,177
"2011","Bath and North East Somerset 002B","E01014403","Total",833,424,7,417,151,55,317,18,299
"2011","Bath and North East Somerset 002C","E01014404","Total",743,316,48,268,257,114,213,34,179
"2011","Bath and North East Somerset 003A","E01014395","Total",519,227,4,223,115,31,138,17,121
"2011","Bath and North East Somerset 003B","E01014396","Total",656,262,13,249,179,58,176,27,149
"2011","Bath and North East Somerset 003C","E01014397","Total",510,199,8,191,165,33,133,17,116
"2011","Bath and North East Somerset 003D","E01014398","Total",639,244,9,235,156,44,185,12,173
"2011","Bath and North East Somerset 004A","E01014409","Total",747,291,23,268,197,78,230,24,206
"2011","Bath and North East Somerset 004B","E01014410","Total",733,201,17,184,247,104,145,25,120
"2011","Bath and North East Somerset 004C","E01014411","Total",932,258,15,243,250,90,185,32,153
"2011","Bath and North East Somerset 005A","E01014477","Total",636,264,6,258,145,57,169,19,150
"2011","Bath and North East Somerset 005B","E01014478","Total",469,155,32,123,181,77,140,33,107
"2011","Bath and North East Somerset 005C","E01014479","Total",650,283,7,276,128,57,166,15,151
"2011","Bath and North East Somerset 005D","E01014480","Total",551,191,22,169,157,67,147,23,124
"2011","Bath and North East Somerset 006A","E01014465","Total",669,148,17,131,199,92,133,25,108
"2011","Bath and North East Somerset 006B","E01014466","Total",576,169,34,135,177,69,120,30,90
"2011","Bath and North East Somerset 006C","E01014467","Total",827,211,10,201,143,67,150,16,134
"2011","Bath and North East Somerset 006D","E01014468","Total",756,204,14,190,124,52,106,15,91
"2011","Bath and North East Somerset 007A","E01014370","Total",1044,511,12,499,62,27,376,13,363
"2011","Bath and North East Somerset 007B","E01014371","Total",1084,398,11,387,85,42,222,8,214
"2011","Bath and North East Somerset 007C","E01014372","Total",1164,338,20,318,100,45,206,12,194
"2011","Bath and North East Somerset 007D","E01014412","Total",679,173,13,160,167,60,109,17,92
"2011","Bath and North East Somerset 007E","E01014413","Total",653,252,13,239,146,37,128,11,117
"2011","Bath and North East Somerset 007F","E01014414","Total",848,291,22,269,106,50,210,11,199
"2011","Bath and North East Somerset 008A","E01014427","Total",582,171,14,157,148,65,121,16,105
"2011","Bath and North East Somerset 008B","E01014428","Total",558,191,3,188,143,55,145,17,128
"2011","Bath and North East Somerset 008C","E01014429","Total",634,166,14,152,234,89,136,18,118
"2011","Bath and North East Somerset 008D","E01014430","Total",709,318,11,307,183,66,218,20,198
"2011","Bath and North East Somerset 009A","E01014405","Total",836,229,7,222,198,94,187,23,164
"2011","Bath and North East Somerset 009C","E01014407","Total",643,250,45,205,90,40,166,16,150
"2011","Bath and North East Somerset 009E","E01033080","Total",1187,376,18,358,123,55,238,15,223
"2011","Bath and North East Somerset 010A","E01014373","Total",656,182,20,162,223,67,147,24,123
"2011","Bath and North East Somerset 010B","E01014374","Total",642,272,15,257,146,61,172,18,154
"2011","Bath and North East Somerset 010C","E01014375","Total",515,142,4,138,131,37,113,14,99
"2011","Bath and North East Somerset 010D","E01014376","Total",633,220,2,218,156,41,141,23,118
"2011","Bath and North East Somerset 010E","E01014377","Total",656,293,9,284,136,48,171,18,153
"2011","Bath and North East Somerset 010G","E01033078","Total",706,198,5,193,204,61,156,25,131
"2011","Bath and North East Somerset 010H","E01033079","Total",471,131,14,117,136,39,106,20,86
"2011","Bath and North East Somerset 011A","E01014461","Total",461,145,31,114,151,63,110,29,81
"2011","Bath and North East Somerset 011B","E01014462","Total",617,238,75,163,243,110,181,50,131
"2011","Bath and North East Somerset 011C","E01014463","Total",589,244,43,201,166,55,223,43,180
"2011","Bath and North East Somerset 011D","E01014464","Total",606,259,60,199,180,90,183,39,144
"2011","Bath and North East Somerset 012A","E01014380","Total",517,238,6,232,110,34,133,13,120
"2011","Bath and North East Somerset 012B","E01014381","Total",660,293,10,283,117,34,151,15,136
"2011","Bath and North East Somerset 012C","E01014481","Total",562,149,7,142,87,39,77,12,65
"2011","Bath and North East Somerset 012D","E01014482","Total",510,176,5,171,133,44,98,9,89
"2011","Bath and North East Somerset 012E","E01014483","Total",640,213,14,199,132,56,130,15,115
"2011","Bath and North East Somerset 012F","E01014484","Total",611,194,3,191,83,32,104,11,93
"2011","Bath and North East Somerset 013A","E01014473","Total",577,154,4,150,116,51,137,17,120
"2011","Bath and North East Somerset 013B","E01014474","Total",492,152,15,137,96,45,121,15,106
"2011","Bath and North East Somerset 013C","E01014475","Total",623,191,7,184,97,41,144,12,132
"2011","Bath and North East Somerset 013D","E01014476","Total",524,155,8,147,104,43,93,11,82
"2011","Bath and North East Somerset 014A","E01014435","Total",525,172,6,166,85,42,85,7,78
"2011","Bath and North East Somerset 014B","E01014436","Total",616,216,11,205,119,50,135,13,122
"2011","Bath and North East Somerset 014C","E01014437","Total",637,233,24,209,173,60,200,33,167
"2011","Bath and North East Somerset 014D","E01014438","Total",499,155,24,131,167,53,139,42,97
"2011","Bath and North East Somerset 015A","E01014455","Total",567,222,24,198,155,65,186,31,155
"2011","Bath and North East Somerset 015B","E01014456","Total",625,207,17,190,176,52,170,38,132
"2011","Bath and North East Somerset 015C","E01014457","Total",613,200,8,192,112,31,132,6,126
"2011","Bath and North East Somerset 015D","E01014458","Total",522,195,60,135,220,99,176,60,116
"2011","Bath and North East Somerset 016A","E01014391","Total",611,188,11,177,147,36,144,23,121
"2011","Bath and North East Somerset 016B","E01014392","Total",426,139,5,134,94,28,99,20,79
"2011","Bath and North East Somerset 016C","E01014452","Total",658,287,2,285,142,37,184,11,173
"2011","Bath and North East Somerset 016D","E01014453","Total",503,195,5,190,138,39,137,24,113
"2011","Bath and North East Somerset 016E","E01014454","Total",519,154,3,151,161,43,85,13,72
"2011","Bath and North East Somerset 016F","E01014459","Total",612,232,21,211,166,75,182,21,161
"2011","Bath and North East Somerset 016G","E01014460","Total",501,179,5,174,117,46,107,12,95
"2011","Bath and North East Somerset 017A","E01014415","Total",771,187,11,176,246,96,139,29,110
"2011","Bath and North East Somerset 017B","E01014416","Total",726,259,11,248,190,54,187,33,154
"2011","Bath and North East Somerset 017C","E01014417","Total",743,249,8,241,184,58,175,29,146
"2011","Bath and North East Somerset 018A","E01014387","Total",505,190,8,182,145,54,149,23,126
"2011","Bath and North East Somerset 018B","E01014388","Total",546,203,5,198,133,39,120,12,108
"2011","Bath and North East Somerset 018C","E01014389","Total",620,274,13,261,150,41,188,13,175
"2011","Bath and North East Somerset 018D","E01014390","Total",665,263,71,192,246,113,184,48,136
"2011","Bath and North East Somerset 019A","E01014431","Total",511,158,18,140,146,58,140,23,117
"2011","Bath and North East Somerset 019B","E01014432","Total",543,207,33,174,131,63,166,24,142
"2011","Bath and North East Somerset 019C","E01014433","Total",553,143,41,102,225,101,126,35,91
"2011","Bath and North East Somerset 019D","E01014434","Total",757,206,17,189,192,86,161,24,137
"2011","Bath and North East Somerset 020A","E01014385","Total",508,134,14,120,177,56,111,28,83
"2011","Bath and North East Somerset 020B","E01014386","Total",454,118,3,115,142,56,88,11,77
"2011","Bath and North East Somerset 020C","E01014419","Total",483,140,8,132,171,52,118,28,90
"2011","Bath and North East Somerset 020D","E01014446","Total",448,134,8,126,126,29,102,18,84
"2011","Bath and North East Somerset 020E","E01014447","Total",499,146,10,136,136,40,128,18,110
"2011","Bath and North East Somerset 021A","E01014382","Total",944,300,10,290,265,86,221,26,195
"2011","Bath and North East Somerset 021B","E01014383","Total",424,136,5,131,116,33,96,17,79
"2011","Bath and North East Somerset 021C","E01014384","Total",546,173,13,160,179,58,120,26,94
"2011","Bath and North East Somerset 021D","E01014418","Total",565,159,15,144,157,49,131,19,112
"2011","Bath and North East Somerset 022A","E01014379","Total",841,250,19,231,246,77,214,44,170
"2011","Bath and North East Somerset 022B","E01014442","Total",705,174,13,161,245,94,160,32,128
"2011","Bath and North East Somerset 022C","E01014443","Total",658,172,13,159,190,57,151,24,127
"2011","Bath and North East Somerset 022D","E01014444","Total",588,101,6,95,226,96,103,25,78
"2011","Bath and North East Somerset 022E","E01014445","Total",681,249,38,211,224,109,230,43,187
"2011","Bath and North East Somerset 023A","E01014393","Total",511,130,3,127,154,64,114,18,96
"2011","Bath and North East Somerset 023B","E01014394","Total",675,206,14,192,198,66,169,26,143
"2011","Bath and North East Somerset 023C","E01014439","Total",713,276,22,254,200,86,236,34,202
"2011","Bath and North East Somerset 023D","E01014440","Total",761,188,22,166,247,117,167,31,136
"2011","Bath and North East Somerset 023E","E01014441","Total",711,242,14,228,166,69,174,24,150
"2011","Bath and North East Somerset 024A","E01014448","Total",679,268,39,229,198,81,186,38,148
"2011","Bath and North East Somerset 024B","E01014449","Total",568,104,29,75,235,97,100,32,68
"2011","Bath and North East Somerset 024C","E01014450","Total",533,194,42,152,190,79,149,32,117
"2011","Bath and North East Somerset 024D","E01014451","Total",520,139,16,123,151,66,112,22,90
"2011","Bath and North East Somerset 025A","E01014420","Total",691,176,22,154,211,102,153,33,120
"2011","Bath and North East Somerset 025B","E01014421","Total",528,139,12,127,194,68,111,26,85
"2011","Bath and North East Somerset 025C","E01014422","Total",622,207,11,196,167,59,133,18,115
"2011","Bath and North East Somerset 025D","E01014423","Total",614,197,21,176,172,81,141,21,120
"2011","Bath and North East Somerset 026A","E01014469","Total",490,171,13,158,156,63,138,26,112
"2011","Bath and North East Somerset 026B","E01014470","Total",618,120,19,101,234,86,114,30,84
"2011","Bath and North East Somerset 026C","E01014471","Total",645,155,19,136,199,87,144,35,109
"2011","Bath and North East Somerset 026D","E01014472","Total",546,138,14,124,187,51,111,23,88
"2011","Bath and North East Somerset 027A","E01014424","Total",664,210,8,202,197,55,141,20,121
"2011","Bath and North East Somerset 027B","E01014425","Total",829,309,20,289,230,84,228,32,196
"2011","Bath and North East Somerset 027C","E01014426","Total",637,277,21,256,153,48,225,36,189
"2011","Bournemouth 001A","E01015301","Total",671,266,16,250,144,66,199,22,177
"2011","Bournemouth 001B","E01015303","Total",661,289,30,259,156,54,199,34,165
"2011","Bournemouth 001C","E01015305","Total",624,261,46,215,206,71,208,40,168
"2011","Bournemouth 001D","E01015306","Total",732,320,62,258,217,79,247,41,206
"2011","Bournemouth 002A","E01015302","Total",842,357,38,319,193,87,260,40,220
"2011","Bournemouth 002B","E01015304","Total",782,359,50,309,227,97,302,46,256
"2011","Bournemouth 002C","E01015308","Total",718,208,40,168,238,115,211,48,163
"2011","Bournemouth 002D","E01015311","Total",685,371,4,367,54,14,214,14,200
"2011","Bournemouth 003A","E01015332","Total",701,298,14,284,156,59,181,21,160
"2011","Bournemouth 003B","E01015333","Total",677,245,9,236,171,64,166,13,153
"2011","Bournemouth 003C","E01015334","Total",678,281,17,264,168,54,241,31,210
"2011","Bournemouth 003D","E01015335","Total",703,234,16,218,192,68,185,23,162
"2011","Bournemouth 003E","E01015337","Total",727,224,20,204,218,86,196,33,163
"2011","Bournemouth 004A","E01015343","Total",639,231,21,210,202,75,205,42,163
"2011","Bournemouth 004B","E01015349","Total",656,215,27,188,205,90,166,26,140
"2011","Bournemouth 004C","E01015351","Total",606,129,18,111,205,79,118,31,87
"2011","Bournemouth 004D","E01015352","Total",643,147,21,126,243,112,125,35,90
"2011","Bournemouth 004E","E01015353","Total",494,169,17,152,148,66,144,26,118
"2011","Bournemouth 004F","E01015354","Total",712,175,21,154,255,111,184,48,136
"2011","Bournemouth 005A","E01015307","Total",598,265,47,218,193,77,231,55,176
"2011","Bournemouth 005B","E01015309","Total",585,223,63,160,224,88,212,55,157
"2011","Bournemouth 005C","E01015312","Total",519,204,39,165,180,68,168,32,136
"2011","Bournemouth 005D","E01015313","Total",518,205,48,157,199,53,192,53,139
"2011","Bournemouth 005E","E01015359","Total",756,317,29,288,153,63,284,40,244
"2011","Bournemouth 006A","E01015320","Total",671,182,13,169,210,81,162,30,132
"2011","Bournemouth 006B","E01015323","Total",593,155,14,141,211,80,129,31,98
"2011","Bournemouth 006C","E01015324","Total",659,176,25,151,200,84,146,29,117
"2011","Bournemouth 006D","E01015325","Total",648,152,10,142,241,101,134,31,103
"2011","Bournemouth 006E","E01015350","Total",617,216,4,212,159,68,172,18,154
"2011","Bournemouth 007A","E01015310","Total",606,210,42,168,208,76,204,50,154
"2011","Bournemouth 007B","E01015336","Total",674,219,19,200,173,79,172,34,138
"2011","Bournemouth 007C","E01015355","Total",707,233,20,213,202,94,186,30,156
"2011","Bournemouth 007D","E01015357","Total",697,289,24,265,186,72,243,36,207
"2011","Bournemouth 007E","E01015358","Total",733,252,20,232,214,89,212,29,183
"2011","Bournemouth 008A","E01015338","Total",828,431,52,379,242,91,385,65,320
"2011","Bournemouth 008B","E01015339","Total",674,242,38,204,197,84,207,41,166
"2011","Bournemouth 008C","E01015340","Total",723,321,12,309,138,53,250,25,225
"2011","Bournemouth 008D","E01015341","Total",541,206,65,141,222,84,185,59,126
"2011","Bournemouth 009A","E01015321","Total",747,275,32,243,214,87,257,50,207
"2011","Bournemouth 009B","E01015356","Total",684,231,24,207,198,60,147,39,108
"2011","Bournemouth 009C","E01015374","Total",875,282,50,232,199,97,204,33,171
"2011","Bournemouth 009D","E01015375","Total",703,245,19,226,143,67,158,22,136
"2011","Bournemouth 009E","E01015377","Total",608,147,25,122,170,87,133,26,107
"2011","Bournemouth 010A","E01015322","Total",670,195,17,178,200,88,164,24,140
"2011","Bournemouth 010B","E01015330","Total",771,236,13,223,207,75,187,18,169
"2011","Bournemouth 010C","E01015342","Total",615,176,14,162,181,66,133,24,109
"2011","Bournemouth 010D","E01015373","Total",673,150,18,132,205,97,138,35,103
"2011","Bournemouth 010E","E01015378","Total",612,112,13,99,202,89,125,32,93
"2011","Bournemouth 011A","E01015314","Total",615,204,7,197,181,67,143,23,120
"2011","Bournemouth 011B","E01015315","Total",733,219,6,213,209,65,169,28,141
"2011","Bournemouth 011C","E01015318","Total",715,195,15,180,208,89,179,33,146
"2011","Bournemouth 011D","E01015319","Total",626,134,9,125,172,64,99,20,79
"2011","Bournemouth 012A","E01015344","Total",719,249,9,240,149,49,162,18,144
"2011","Bournemouth 012B","E01015346","Total",678,225,21,204,160,57,173,27,146
"2011","Bournemouth 012C","E01015348","Total",767,288,15,273,139,50,166,20,146
"2011","Bournemouth 012D","E01015360","Total",601,154,17,137,166,61,105,23,82
"2011","Bournemouth 013A","E01015326","Total",815,209,26,183,194,94,144,25,119
"2011","Bournemouth 013B","E01015331","Total",1015,243,45,198,246,147,181,22,159
"2011","Bournemouth 013C","E01015345","Total",728,154,10,144,176,88,122,16,106
"2011","Bournemouth 013D","E01015376","Total",613,133,18,115,172,80,104,22,82
"2011","Bournemouth 014A","E01015316","Total",674,228,14,214,171,69,152,25,127
"2011","Bournemouth 014B","E01015317","Total",683,234,22,212,197,71,220,40,180
"2011","Bournemouth 014C","E01015361","Total",545,140,25,115,200,82,119,26,93
"2011","Bournemouth 014D","E01015362","Total",464,143,41,102,210,55,147,50,97
"2011","Bournemouth 014E","E01015363","Total",669,141,10,131,249,116,155,41,114
"2011","Bournemouth 015A","E01015292","Total",737,220,33,187,222,102,190,34,156
"2011","Bournemouth 015B","E01015293","Total",644,195,39,156,213,92,179,37,142
"2011","Bournemouth 015C","E01015294","Total",831,224,58,166,282,127,189,52,137
"2011","Bournemouth 015D","E01015327","Total",783,207,51,156,242,121,177,33,144
"2011","Bournemouth 015E","E01015329","Total",689,135,18,117,166,67,123,26,97
"2011","Bournemouth 016A","E01015272","Total",833,365,14,351,142,54,230,15,215
"2011","Bournemouth 016B","E01015273","Total",938,312,52,260,250,114,205,33,172
"2011","Bournemouth 016C","E01015275","Total",739,217,19,198,179,76,169,31,138
"2011","Bournemouth 016D","E01015276","Total",658,157,34,123,240,104,162,56,106
"2011","Bournemouth 016E","E01015277","Total",847,252,37,215,227,120,206,28,178
"2011","Bournemouth 017A","E01015283","Total",992,285,16,269,92,57,166,9,157
"2011","Bournemouth 017C","E01015286","Total",1086,481,22,459,131,76,321,15,306
"2011","Bournemouth 017D","E01015287","Total",1183,658,12,646,76,50,220,9,211
"2011","Bournemouth 017E","E01015328","Total",958,350,24,326,141,72,259,22,237
"2011","Bournemouth 017F","E01033242","Total",590,211,5,206,68,38,160,11,149
"2011","Bournemouth 017G","E01033285","Total",624,192,15,177,72,49,147,14,133
"2011","Bournemouth 018A","E01015274","Total",873,310,33,277,195,73,214,30,184
"2011","Bournemouth 018B","E01015297","Total",698,309,6,303,109,50,218,10,208
"2011","Bournemouth 018C","E01015364","Total",684,259,19,240,171,67,163,21,142
"2011","Bournemouth 018D","E01015365","Total",792,230,22,208,179,74,172,30,142
"2011","Bournemouth 018E","E01015366","Total",888,378,8,370,115,49,259,14,245
"2011","Bournemouth 019B","E01015279","Total",991,351,39,312,171,99,274,27,247
"2011","Bournemouth 019C","E01015280","Total",998,331,46,285,197,125,258,37,221
"2011","Bournemouth 019D","E01015281","Total",884,365,64,301,200,74,290,51,239
"2011","Bournemouth 019E","E01015282","Total",1174,452,37,415,172,83,394,26,368
"2011","Bournemouth 019F","E01033241","Total",679,222,15,207,72,46,160,12,148
"2011","Bournemouth 019G","E01033283","Total",715,254,3,251,58,39,152,3,149
"2011","Bournemouth 020A","E01015295","Total",650,290,6,284,123,37,177,25,152
"2011","Bournemouth 020B","E01015296","Total",985,460,21,439,126,59,280,21,259
"2011","Bournemouth 020C","E01015298","Total",794,479,7,472,99,36,259,19,240
"2011","Bournemouth 020D","E01015299","Total",732,259,11,248,202,65,186,27,159
"2011","Bournemouth 020E","E01015300","Total",679,249,11,238,167,68,183,30,153
"2011","Bournemouth 021A","E01015285","Total",1091,380,27,353,129,84,195,15,180
"2011","Bournemouth 021B","E01015288","Total",911,314,60,254,213,125,215,33,182
"2011","Bournemouth 021C","E01015289","Total",1018,357,18,339,115,70,250,14,236
"2011","Bournemouth 021D","E01015290","Total",887,316,23,293,116,67,203,22,181
"2011","Bournemouth 021E","E01015291","Total",1101,514,17,497,92,55,273,13,260
"2011","Bournemouth 023A","E01015371","Total",867,266,14,252,99,51,208,16,192
"2011","Bournemouth 023B","E01015372","Total",1111,543,7,536,80,49,362,9,353
"2011","Bournemouth 023C","E01033286","Total",611,187,7,180,71,36,119,7,112
"2011","Bournemouth 023D","E01033288","Total",615,214,2,212,58,35,144,8,136
"2011","Bournemouth 024A","E01015367","Total",1110,317,22,295,103,60,197,11,186
"2011","Bournemouth 024B","E01015368","Total",1019,494,6,488,74,45,259,9,250
"2011","Bournemouth 024C","E01015369","Total",958,435,13,422,94,55,277,12,265
"2011","Bournemouth 024D","E01015370","Total",811,203,10,193,102,49,124,5,119
"2011","Bristol 001A","E01014601","Total",687,277,41,236,179,86,202,31,171
"2011","Bristol 001B","E01014602","Total",825,326,76,250,295,144,251,54,197
"2011","Bristol 001C","E01014603","Total",960,289,54,235,268,126,221,44,177
"2011","Bristol 001E","E01014605","Total",810,414,90,324,239,139,319,37,282
"2011","Bristol 001G","E01032516","Total",830,259,45,214,212,104,179,28,151
"2011","Bristol 001H","E01032517","Total",694,276,47,229,207,83,232,39,193
"2011","Bristol 002A","E01014688","Total",644,257,78,179,254,119,216,60,156
"2011","Bristol 002B","E01014689","Total",637,304,88,216,244,115,235,63,172
"2011","Bristol 002C","E01014690","Total",792,274,59,215,292,127,241,49,192
"2011","Bristol 002D","E01014691","Total",853,390,53,337,223,105,334,36,298
"2011","Bristol 002E","E01014692","Total",606,195,69,126,240,108,163,49,114
"2011","Bristol 002F","E01014693","Total",651,183,9,174,132,57,136,23,113
"2011","Bristol 002G","E01014694","Total",667,240,38,202,208,82,209,41,168
"2011","Bristol 003A","E01014497","Total",670,271,64,207,215,121,219,48,171
"2011","Bristol 003B","E01014498","Total",658,239,75,164,275,153,178,42,136
"2011","Bristol 003C","E01014638","Total",788,398,75,323,221,95,319,49,270
"2011","Bristol 003D","E01014639","Total",625,256,111,145,292,170,192,45,147
"2011","Bristol 003E","E01014640","Total",590,220,53,167,200,94,193,43,150
"2011","Bristol 004A","E01014631","Total",520,204,11,193,120,48,162,15,147
"2011","Bristol 004B","E01014632","Total",618,203,30,173,168,81,160,24,136
"2011","Bristol 004C","E01014633","Total",663,217,43,174,215,94,161,39,122
"2011","Bristol 004D","E01014636","Total",635,278,79,199,236,111,174,40,134
"2011","Bristol 005A","E01014630","Total",885,262,56,206,234,108,229,37,192
"2011","Bristol 005B","E01014634","Total",694,144,17,127,139,84,117,23,94
"2011","Bristol 005C","E01014659","Total",880,300,98,202,288,149,223,58,165
"2011","Bristol 005D","E01014661","Total",600,176,52,124,226,86,180,39,141
"2011","Bristol 006A","E01014616","Total",684,280,5,275,157,70,213,20,193
"2011","Bristol 006B","E01014719","Total",628,182,11,171,159,73,156,24,132
"2011","Bristol 006C","E01014720","Total",777,314,19,295,186,94,220,20,200
"2011","Bristol 006D","E01014721","Total",647,220,6,214,164,90,157,14,143
"2011","Bristol 007A","E01014641","Total",625,236,20,216,150,48,168,22,146
"2011","Bristol 007B","E01014642","Total",608,219,27,192,183,79,174,30,144
"2011","Bristol 007C","E01014643","Total",547,202,36,166,173,60,173,31,142
"2011","Bristol 007D","E01014644","Total",613,204,37,167,198,74,170,44,126
"2011","Bristol 008A","E01014492","Total",741,325,44,281,157,74,260,31,229
"2011","Bristol 008B","E01014493","Total",609,182,43,139,190,76,195,43,152
"2011","Bristol 008C","E01014494","Total",623,189,14,175,161,61,147,18,129
"2011","Bristol 008D","E01014495","Total",733,272,23,249,174,71,209,28,181
"2011","Bristol 008E","E01014496","Total",680,172,27,145,215,106,164,35,129
"2011","Bristol 008F","E01014499","Total",609,176,38,138,208,76,177,40,137
"2011","Bristol 009A","E01014715","Total",616,169,7,162,231,108,121,20,101
"2011","Bristol 009B","E01014716","Total",614,225,3,222,194,78,139,18,121
"2011","Bristol 009C","E01014717","Total",637,309,6,303,169,61,216,17,199
"2011","Bristol 009D","E01014718","Total",637,211,10,201,149,62,138,16,122
"2011","Bristol 010A","E01014510","Total",740,134,20,114,234,130,136,29,107
"2011","Bristol 010B","E01014635","Total",769,190,27,163,184,96,157,25,132
"2011","Bristol 010C","E01014637","Total",530,96,7,89,119,57,87,10,77
"2011","Bristol 010D","E01014662","Total",631,169,29,140,175,89,140,24,116
"2011","Bristol 011A","E01014615","Total",609,216,5,211,201,86,148,24,124
"2011","Bristol 011B","E01014617","Total",522,137,5,132,183,68,116,17,99
"2011","Bristol 011C","E01014618","Total",624,235,8,227,197,82,140,22,118
"2011","Bristol 011D","E01014620","Total",634,247,7,240,177,80,157,21,136
"2011","Bristol 012A","E01014571","Total",663,221,33,188,183,85,184,35,149
"2011","Bristol 012B","E01014577","Total",640,186,21,165,173,71,162,35,127
"2011","Bristol 012C","E01014586","Total",719,312,27,285,142,56,238,24,214
"2011","Bristol 012D","E01014587","Total",608,254,26,228,144,68,232,34,198
"2011","Bristol 013A","E01014588","Total",747,310,28,282,147,71,237,27,210
"2011","Bristol 013B","E01014589","Total",630,315,88,227,221,98,225,47,178
"2011","Bristol 013C","E01014590","Total",728,288,30,258,158,83,211,29,182
"2011","Bristol 013D","E01014591","Total",800,298,14,284,178,79,216,19,197
"2011","Bristol 013E","E01014592","Total",694,215,22,193,185,87,175,29,146
"2011","Bristol 014A","E01014660","Total",667,294,45,249,193,76,244,42,202
"2011","Bristol 014B","E01014663","Total",616,260,57,203,182,76,211,37,174
"2011","Bristol 014C","E01014664","Total",664,255,37,218,175,82,232,46,186
"2011","Bristol 014D","E01014665","Total",779,234,55,179,273,153,197,43,154
"2011","Bristol 015A","E01014709","Total",596,234,5,229,78,23,115,9,106
"2011","Bristol 015B","E01014710","Total",529,179,5,174,98,43,92,7,85
"2011","Bristol 015C","E01014711","Total",527,207,8,199,141,52,120,12,108
"2011","Bristol 015D","E01014712","Total",500,171,19,152,185,69,133,21,112
"2011","Bristol 015E","E01014713","Total",565,190,8,182,133,56,118,16,102
"2011","Bristol 015F","E01014714","Total",524,158,8,150,174,69,95,9,86
"2011","Bristol 016A","E01014507","Total",673,123,11,112,177,107,98,14,84
"2011","Bristol 016B","E01014508","Total",510,87,10,77,164,77,92,16,76
"2011","Bristol 016C","E01014509","Total",855,105,12,93,207,128,115,22,93
"2011","Bristol 016D","E01014511","Total",517,80,3,77,203,97,74,16,58
"2011","Bristol 016E","E01014512","Total",587,142,6,136,186,75,133,27,106
"2011","Bristol 016F","E01014513","Total",619,133,1,132,219,82,124,23,101
"2011","Bristol 016G","E01014514","Total",817,146,15,131,195,116,143,21,122
"2011","Bristol 017A","E01014619","Total",602,137,3,134,183,69,105,12,93
"2011","Bristol 017B","E01014621","Total",581,150,16,134,202,82,126,16,110
"2011","Bristol 017C","E01014666","Total",660,157,10,147,270,84,129,26,103
"2011","Bristol 017D","E01014667","Total",625,115,12,103,222,78,100,20,80
"2011","Bristol 017E","E01014672","Total",962,259,11,248,151,61,159,16,143
"2011","Bristol 018A","E01014624","Total",667,229,64,165,259,132,177,56,121
"2011","Bristol 018D","E01014629","Total",544,186,64,122,228,99,152,46,106
"2011","Bristol 018E","E01032518","Total",737,302,69,233,273,122,272,67,205
"2011","Bristol 018F","E01032519","Total",500,161,15,146,151,71,135,24,111
"2011","Bristol 019A","E01014572","Total",796,204,41,163,228,130,177,32,145
"2011","Bristol 019B","E01014573","Total",803,209,20,189,179,90,159,27,132
"2011","Bristol 019C","E01014575","Total",656,227,44,183,210,92,176,41,135
"2011","Bristol 019D","E01014576","Total",833,244,43,201,261,130,211,35,176
"2011","Bristol 020A","E01014487","Total",819,155,14,141,165,59,137,31,106
"2011","Bristol 020B","E01014491","Total",764,127,14,113,214,89,135,35,100
"2011","Bristol 020C","E01014668","Total",620,115,6,109,211,73,95,28,67
"2011","Bristol 020D","E01014669","Total",621,91,12,79,152,44,80,15,65
"2011","Bristol 020E","E01014670","Total",596,75,4,71,158,53,73,19,54
"2011","Bristol 020F","E01014671","Total",663,142,9,133,131,54,117,14,103
"2011","Bristol 021A","E01014622","Total",625,186,32,154,179,102,164,30,134
"2011","Bristol 021B","E01014623","Total",642,184,34,150,207,88,177,43,134
"2011","Bristol 021C","E01014626","Total",913,342,65,277,260,144,254,40,214
"2011","Bristol 021D","E01014627","Total",903,225,39,186,262,131,177,30,147
"2011","Bristol 022A","E01014557","Total",589,141,5,136,124,48,97,10,87
"2011","Bristol 022B","E01014558","Total",775,203,9,194,53,26,107,9,98
"2011","Bristol 022C","E01014559","Total",816,176,4,172,134,58,124,20,104
"2011","Bristol 022D","E01014560","Total",778,171,11,160,96,45,106,12,94
"2011","Bristol 022E","E01014562","Total",655,134,6,128,93,43,83,9,74
"2011","Bristol 023A","E01014485","Total",828,216,37,179,223,117,198,23,175
"2011","Bristol 023B","E01014486","Total",1084,383,96,287,289,126,285,69,216
"2011","Bristol 023C","E01014488","Total",797,162,33,129,203,87,172,30,142
"2011","Bristol 023D","E01014489","Total",1140,297,53,244,205,85,267,44,223
"2011","Bristol 023F","E01033347","Total",608,180,42,138,89,57,105,18,87
"2011","Bristol 023G","E01033348","Total",537,176,52,124,123,63,117,23,94
"2011","Bristol 023H","E01033366","Total",575,229,111,118,254,126,159,55,104
"2011","Bristol 025A","E01014539","Total",784,213,7,206,114,42,121,12,109
"2011","Bristol 025C","E01014561","Total",774,158,6,152,126,48,115,12,103
"2011","Bristol 025D","E01014563","Total",802,152,16,136,96,50,109,15,94
"2011","Bristol 025E","E01033342","Total",887,416,9,407,64,44,112,10,102
"2011","Bristol 025F","E01033367","Total",666,227,37,190,101,63,181,14,167
"2011","Bristol 026A","E01014551","Total",813,162,6,156,72,40,88,4,84
"2011","Bristol 026B","E01014552","Total",775,152,9,143,94,33,92,9,83
"2011","Bristol 026C","E01014553","Total",759,143,3,140,93,48,83,8,75
"2011","Bristol 026D","E01014554","Total",832,157,4,153,90,49,85,9,76
"2011","Bristol 026E","E01014556","Total",859,203,11,192,112,54,142,12,130
"2011","Bristol 027A","E01014673","Total",817,225,32,193,223,114,206,31,175
"2011","Bristol 027B","E01014674","Total",647,176,31,145,193,76,175,33,142
"2011","Bristol 027C","E01014675","Total",662,205,22,183,188,72,187,27,160
"2011","Bristol 027D","E01014676","Total",669,236,18,218,200,75,222,33,189
"2011","Bristol 028A","E01014682","Total",647,193,27,166,200,100,152,25,127
"2011","Bristol 028B","E01014683","Total",840,327,34,293,186,95,278,29,249
"2011","Bristol 028C","E01014685","Total",623,221,64,157,226,88,190,57,133
"2011","Bristol 028D","E01014686","Total",704,247,55,192,218,115,184,29,155
"2011","Bristol 028E","E01014687","Total",704,248,29,219,197,104,210,33,177
"2011","Bristol 029A","E01014565","Total",778,291,56,235,205,115,200,25,175
"2011","Bristol 029B","E01014566","Total",819,216,35,181,206,116,173,30,143
"2011","Bristol 029C","E01014567","Total",894,212,53,159,243,135,178,27,151
"2011","Bristol 029D","E01014681","Total",1061,337,66,271,282,185,266,41,225
"2011","Bristol 029E","E01014684","Total",840,215,39,176,195,112,190,37,153
"2011","Bristol 030A","E01014544","Total",577,150,7,143,104,39,82,8,74
"2011","Bristol 030B","E01014545","Total",809,207,5,202,92,38,131,9,122
"2011","Bristol 030C","E01014546","Total",736,186,10,176,52,21,100,6,94
"2011","Bristol 030D","E01014547","Total",857,186,6,180,94,46,117,6,111
"2011","Bristol 032A","E01014538","Total",676,232,6,226,54,32,74,3,71
"2011","Bristol 032B","E01014540","Total",1164,363,41,322,128,68,187,21,166
"2011","Bristol 032C","E01014542","Total",865,253,9,244,56,37,110,7,103
"2011","Bristol 032E","E01033344","Total",646,211,16,195,62,28,91,7,84
"2011","Bristol 032F","E01033345","Total",661,179,3,176,32,19,50,3,47
"2011","Bristol 032G","E01033350","Total",635,144,4,140,41,20,97,5,92
"2011","Bristol 033A","E01014677","Total",662,122,10,112,134,65,112,17,95
"2011","Bristol 033B","E01014678","Total",674,205,22,183,179,88,167,22,145
"2011","Bristol 033C","E01014679","Total",662,173,16,157,189,68,164,28,136
"2011","Bristol 033D","E01014680","Total",515,138,10,128,170,63,114,20,94
"2011","Bristol 034A","E01014548","Total",832,192,17,175,136,61,153,24,129
"2011","Bristol 034B","E01014549","Total",550,176,8,168,83,29,123,9,114
"2011","Bristol 034C","E01014550","Total",895,186,12,174,129,54,120,10,110
"2011","Bristol 034D","E01014555","Total",711,197,5,192,49,21,137,8,129
"2011","Bristol 035A","E01014528","Total",686,123,13,110,183,89,122,31,91
"2011","Bristol 035B","E01014529","Total",596,160,50,110,195,80,155,44,111
"2011","Bristol 035C","E01014530","Total",684,142,16,126,142,73,135,26,109
"2011","Bristol 035D","E01014531","Total",754,144,16,128,185,88,143,22,121
"2011","Bristol 035E","E01014532","Total",631,156,22,134,190,88,137,21,116
"2011","Bristol 035F","E01014537","Total",756,232,31,201,228,102,209,40,169
"2011","Bristol 036A","E01014695","Total",852,354,28,326,161,71,258,19,239
"2011","Bristol 036B","E01014696","Total",695,117,16,101,206,122,122,22,100
"2011","Bristol 036C","E01014698","Total",857,171,19,152,198,109,169,26,143
"2011","Bristol 036D","E01014699","Total",706,203,36,167,151,90,159,16,143
"2011","Bristol 036E","E01014700","Total",652,163,6,157,157,59,135,12,123
"2011","Bristol 036F","E01014701","Total",712,117,7,110,161,95,126,20,106
"2011","Bristol 037A","E01014730","Total",883,222,24,198,148,69,212,17,195
"2011","Bristol 037B","E01014731","Total",775,152,25,127,145,85,147,20,127
"2011","Bristol 037C","E01014732","Total",799,178,33,145,211,123,156,29,127
"2011","Bristol 037D","E01014735","Total",755,159,14,145,175,102,149,23,126
"2011","Bristol 038A","E01014523","Total",548,192,12,180,152,59,171,31,140
"2011","Bristol 038B","E01014524","Total",591,196,23,173,181,82,161,22,139
"2011","Bristol 038C","E01014525","Total",651,146,21,125,213,107,133,30,103
"2011","Bristol 038D","E01014526","Total",672,268,64,204,214,100,182,36,146
"2011","Bristol 038E","E01014527","Total",660,257,20,237,141,78,232,22,210
"2011","Bristol 039A","E01014500","Total",686,193,26,167,178,91,156,21,135
"2011","Bristol 039B","E01014502","Total",750,248,38,210,194,85,228,42,186
"2011","Bristol 039E","E01033359","Total",704,178,17,161,86,47,155,17,138
"2011","Bristol 039F","E01033361","Total",717,296,15,281,59,33,251,12,239
"2011","Bristol 039G","E01033362","Total",685,192,15,177,62,41,148,8,140
"2011","Bristol 039H","E01033364","Total",780,190,15,175,131,76,171,19,152
"2011","Bristol 040A","E01014729","Total",585,208,69,139,200,93,155,35,120
"2011","Bristol 040B","E01014733","Total",741,141,34,107,204,109,128,27,101
"2011","Bristol 040C","E01014734","Total",678,135,21,114,192,111,119,18,101
"2011","Bristol 040D","E01014736","Total",827,248,36,212,228,100,208,40,168
"2011","Bristol 041A","E01014501","Total",756,326,25,301,181,78,244,33,211
"2011","Bristol 041B","E01014504","Total",656,161,18,143,154,84,136,15,121
"2011","Bristol 041C","E01014505","Total",824,165,9,156,158,83,141,16,125
"2011","Bristol 041D","E01014506","Total",599,165,6,159,205,74,149,27,122
"2011","Bristol 042A","E01014645","Total",688,272,22,250,176,57,239,34,205
"2011","Bristol 042B","E01014646","Total",633,219,19,200,191,80,187,28,159
"2011","Bristol 042C","E01014648","Total",675,162,14,148,203,96,137,25,112
"2011","Bristol 042D","E01014649","Total",670,175,14,161,218,99,151,28,123
"2011","Bristol 042E","E01014651","Total",676,163,15,148,200,101,138,23,115
"2011","Bristol 043A","E01014533","Total",619,130,5,125,164,82,124,23,101
"2011","Bristol 043B","E01014534","Total",650,103,21,82,214,109,108,24,84
"2011","Bristol 043C","E01014535","Total",757,226,28,198,244,91,200,52,148
"2011","Bristol 043D","E01014536","Total",672,282,32,250,163,66,228,30,198
"2011","Bristol 044A","E01014578","Total",645,214,58,156,238,104,182,45,137
"2011","Bristol 044B","E01014583","Total",529,228,74,154,213,83,170,45,125
"2011","Bristol 044C","E01014585","Total",711,346,146,200,338,148,222,75,147
"2011","Bristol 044D","E01014647","Total",613,219,59,160,242,116,182,52,130
"2011","Bristol 044E","E01014650","Total",620,214,27,187,201,77,189,39,150
"2011","Bristol 045A","E01014579","Total",546,186,47,139,214,106,161,52,109
"2011","Bristol 045B","E01014580","Total",666,323,81,242,197,90,263,46,217
"2011","Bristol 045C","E01014581","Total",641,320,98,222,236,105,224,52,172
"2011","Bristol 045D","E01014582","Total",520,201,66,135,203,90,171,55,116
"2011","Bristol 045E","E01014584","Total",468,156,60,96,232,75,143,56,87
"2011","Bristol 046A","E01014518","Total",720,213,35,178,202,90,187,32,155
"2011","Bristol 046B","E01014519","Total",552,207,23,184,159,65,155,22,133
"2011","Bristol 046C","E01014520","Total",652,249,9,240,135,53,163,25,138
"2011","Bristol 046D","E01014521","Total",510,175,22,153,160,70,140,32,108
"2011","Bristol 047A","E01014607","Total",541,158,20,138,159,71,141,29,112
"2011","Bristol 047B","E01014608","Total",719,277,66,211,253,113,228,44,184
"2011","Bristol 047C","E01014609","Total",704,237,51,186,245,115,188,38,150
"2011","Bristol 047D","E01014610","Total",715,344,50,294,174,87,275,35,240
"2011","Bristol 047E","E01014613","Total",659,223,24,199,163,70,152,19,133
"2011","Bristol 047F","E01014614","Total",498,165,4,161,136,48,114,20,94
"2011","Bristol 048A","E01014594","Total",640,319,108,211,258,133,226,54,172
"2011","Bristol 048B","E01014598","Total",616,216,14,202,145,64,158,19,139
"2011","Bristol 048C","E01014599","Total",533,160,17,143,168,77,111,17,94
"2011","Bristol 048D","E01014600","Total",585,255,42,213,167,69,199,29,170
"2011","Bristol 049A","E01014702","Total",599,195,16,179,174,59,152,26,126
"2011","Bristol 049B","E01014703","Total",676,279,39,240,182,76,243,43,200
"2011","Bristol 049C","E01014704","Total",742,240,62,178,252,112,197,46,151
"2011","Bristol 049D","E01014705","Total",616,282,13,269,128,40,214,17,197
"2011","Bristol 049E","E01014706","Total",624,315,37,278,139,78,244,30,214
"2011","Bristol 049F","E01014707","Total",626,227,17,210,172,47,157,17,140
"2011","Bristol 049G","E01014708","Total",708,227,24,203,209,80,180,30,150
"2011","Bristol 050A","E01014515","Total",618,257,55,202,186,81,215,46,169
"2011","Bristol 050B","E01014516","Total",636,325,90,235,224,112,223,45,178
"2011","Bristol 050C","E01014517","Total",495,184,48,136,177,79,171,37,134
"2011","Bristol 050D","E01014522","Total",732,328,83,245,259,113,231,49,182
"2011","Bristol 051A","E01014593","Total",572,275,135,140,267,135,178,59,119
"2011","Bristol 051B","E01014595","Total",642,275,45,230,181,78,236,36,200
"2011","Bristol 051C","E01014596","Total",603,283,65,218,206,91,211,52,159
"2011","Bristol 051D","E01014597","Total",618,309,42,267,163,68,220,27,193
"2011","Bristol 052A","E01014611","Total",560,229,9,220,111,36,169,20,149
"2011","Bristol 052B","E01014612","Total",625,248,29,219,169,69,187,29,158
"2011","Bristol 052C","E01014722","Total",622,183,12,171,150,67,143,17,126
"2011","Bristol 052D","E01014723","Total",533,155,11,144,152,60,125,26,99
"2011","Bristol 052E","E01014725","Total",607,200,8,192,139,49,146,17,129
"2011","Bristol 053B","E01014726","Total",675,346,124,222,255,119,257,77,180
"2011","Bristol 053C","E01014727","Total",631,313,111,202,254,123,224,55,169
"2011","Bristol 053E","E01032514","Total",899,503,172,331,356,208,329,77,252
"2011","Bristol 053F","E01032515","Total",629,287,51,236,167,81,209,38,171
"2011","Bristol 054A","E01033352","Total",678,122,32,90,95,59,92,12,80
"2011","Bristol 054B","E01033353","Total",713,277,20,257,54,30,156,3,153
"2011","Bristol 054C","E01033355","Total",606,105,8,97,36,22,69,6,63
"2011","Bristol 054D","E01033358","Total",689,314,97,217,227,149,195,43,152
"2011","Bristol 054E","E01033370","Total",694,292,38,254,101,57,223,18,205
"2011","Bristol 055A","E01014564","Total",736,236,75,161,261,145,201,50,151
"2011","Bristol 055B","E01014653","Total",1058,507,196,311,433,255,328,108,220
"2011","Bristol 055C","E01014655","Total",1063,457,100,357,306,171,367,74,293
"2011","Bristol 056A","E01014654","Total",879,361,113,248,340,180,289,79,210
"2011","Bristol 056B","E01014658","Total",842,408,190,218,406,244,278,90,188
"2011","Bristol 056C","E01033356","Total",693,332,91,241,200,130,230,39,191
"2011","Bristol 056D","E01033369","Total",601,282,99,183,223,119,202,42,160
"2011","Bristol 057A","E01014568","Total",1007,344,111,233,348,202,264,72,192
"2011","Bristol 057B","E01014569","Total",846,269,74,195,271,121,216,49,167
"2011","Bristol 057C","E01014570","Total",779,193,52,141,263,148,170,40,130
"2011","Bristol 057D","E01014574","Total",989,357,92,265,297,170,271,51,220
"2011","Cornwall 010A","E01018753","Total",686,242,15,227,170,49,169,24,145
"2011","Cornwall 010B","E01018754","Total",684,281,31,250,180,60,213,33,180
"2011","Cornwall 010C","E01018755","Total",654,238,11,227,156,35,175,24,151
"2011","Cornwall 010D","E01018756","Total",745,310,10,300,153,47,231,33,198
"2011","Cornwall 012A","E01018777","Total",865,280,10,270,188,64,218,21,197
"2011","Cornwall 012B","E01018782","Total",630,222,16,206,170,43,184,26,158
"2011","Cornwall 012C","E01018783","Total",674,232,16,216,163,54,189,29,160
"2011","Cornwall 012D","E01018784","Total",650,218,11,207,154,46,180,35,145
"2011","Cornwall 013A","E01018750","Total",953,338,31,307,291,77,250,45,205
"2011","Cornwall 013B","E01018751","Total",697,281,33,248,166,70,248,51,197
"2011","Cornwall 013C","E01018752","Total",858,293,31,262,253,105,225,46,179
"2011","Cornwall 013D","E01018779","Total",971,357,24,333,233,86,277,29,248
"2011","Cornwall 016A","E01018758","Total",1030,367,34,333,282,101,316,57,259
"2011","Cornwall 016B","E01018768","Total",781,196,34,162,300,114,177,59,118
"2011","Cornwall 016C","E01018769","Total",832,333,36,297,233,92,254,39,215
"2011","Cornwall 016D","E01018778","Total",736,267,18,249,175,60,203,34,169
"2011","Cornwall 017A","E01018767","Total",647,291,55,236,201,69,256,54,202
"2011","Cornwall 017B","E01018770","Total",552,250,43,207,164,56,191,37,154
"2011","Cornwall 017C","E01018771","Total",704,273,27,246,123,49,202,21,181
"2011","Cornwall 017D","E01018772","Total",705,301,10,291,158,51,200,28,172
"2011","Cornwall 022A","E01018764","Total",616,215,8,207,147,47,135,16,119
"2011","Cornwall 022B","E01018787","Total",604,119,8,111,211,83,114,34,80
"2011","Cornwall 022C","E01018795","Total",510,170,3,167,125,35,107,16,91
"2011","Cornwall 022D","E01018796","Total",498,113,10,103,170,55,95,19,76
"2011","Cornwall 023A","E01018757","Total",939,396,15,381,196,52,231,32,199
"2011","Cornwall 023B","E01018763","Total",447,105,15,90,134,40,110,26,84
"2011","Cornwall 023C","E01018765","Total",671,285,10,275,115,36,184,17,167
"2011","Cornwall 023D","E01018785","Total",822,269,14,255,217,64,219,36,183
"2011","Cornwall 025A","E01018786","Total",550,175,13,162,145,55,146,28,118
"2011","Cornwall 025B","E01018788","Total",723,397,19,378,123,37,304,15,289
"2011","Cornwall 025C","E01018790","Total",487,184,24,160,137,52,166,40,126
"2011","Cornwall 025D","E01018794","Total",612,206,14,192,163,49,166,24,142
"2011","Cornwall 026A","E01018789","Total",604,203,14,189,170,56,157,23,134
"2011","Cornwall 026B","E01018791","Total",531,230,8,222,126,35,166,23,143
"2011","Cornwall 026C","E01018792","Total",1183,358,32,326,358,148,259,51,208
"2011","Cornwall 026D","E01018793","Total",772,252,29,223,194,79,222,44,178
"2011","Cornwall 028A","E01018759","Total",629,215,10,205,143,49,182,28,154
"2011","Cornwall 028B","E01018760","Total",514,159,12,147,129,44,124,19,105
"2011","Cornwall 028C","E01018761","Total",695,348,14,334,120,36,244,22,222
"2011","Cornwall 028D","E01018766","Total",858,384,21,363,158,50,260,34,226
"2011","Cornwall 028E","E01018774","Total",673,310,29,281,145,60,243,31,212
"2011","Cornwall 029A","E01018797","Total",501,204,26,178,139,58,162,29,133
"2011","Cornwall 029B","E01018798","Total",665,253,14,239,150,43,185,17,168
"2011","Cornwall 029C","E01018799","Total",561,265,29,236,145,53,202,26,176
"2011","Cornwall 029D","E01018800","Total",656,165,18,147,239,91,149,27,122
"2011","Cornwall 034A","E01018780","Total",1002,398,36,362,279,102,311,50,261
"2011","Cornwall 034B","E01018781","Total",853,368,11,357,169,43,225,27,198
"2011","Cornwall 034E","E01033294","Total",1017,331,28,303,260,88,267,38,229
"2011","Cornwall 037A","E01018762","Total",549,221,9,212,107,30,172,22,150
"2011","Cornwall 037B","E01018773","Total",727,332,12,320,139,42,259,33,226
"2011","Cornwall 037C","E01018775","Total",636,288,14,274,130,40,175,23,152
"2011","Cornwall 037D","E01018776","Total",597,245,10,235,94,29,178,13,165
"2011","Cornwall 032A","E01018815","Total",836,204,30,174,264,113,194,31,163
"2011","Cornwall 032B","E01018831","Total",536,148,9,139,152,55,146,21,125
"2011","Cornwall 032C","E01018832","Total",553,200,9,191,136,41,150,28,122
"2011","Cornwall 032D","E01018847","Total",631,157,17,140,192,59,149,30,119
"2011","Cornwall 033A","E01018833","Total",591,195,11,184,172,54,165,29,136
"2011","Cornwall 033B","E01018842","Total",621,219,14,205,143,52,187,26,161
"2011","Cornwall 033C","E01018843","Total",534,170,8,162,126,39,132,15,117
"2011","Cornwall 033D","E01018844","Total",616,248,12,236,120,45,203,27,176
"2011","Cornwall 040A","E01018825","Total",667,178,12,166,195,86,169,26,143
"2011","Cornwall 040B","E01018826","Total",987,395,11,384,242,77,286,30,256
"2011","Cornwall 040C","E01018851","Total",672,290,13,277,145,45,222,27,195
"2011","Cornwall 040D","E01018852","Total",1078,383,18,365,294,109,266,34,232
"2011","Cornwall 042A","E01018823","Total",748,321,13,308,150,55,212,24,188
"2011","Cornwall 042B","E01018824","Total",1031,375,39,336,355,155,267,40,227
"2011","Cornwall 042C","E01018853","Total",1010,288,52,236,358,121,230,57,173
"2011","Cornwall 042D","E01018854","Total",598,235,43,192,178,55,187,33,154
"2011","Cornwall 043A","E01018819","Total",652,172,21,151,182,79,141,26,115
"2011","Cornwall 043B","E01018822","Total",516,173,4,169,131,43,153,17,136
"2011","Cornwall 043C","E01018855","Total",936,265,44,221,316,134,201,48,153
"2011","Cornwall 043D","E01018856","Total",638,264,15,249,132,44,220,27,193
"2011","Cornwall 043E","E01018857","Total",540,228,29,199,140,58,189,32,157
"2011","Cornwall 043F","E01018858","Total",632,309,16,293,145,54,185,21,164
"2011","Cornwall 044A","E01018807","Total",626,247,7,240,119,33,157,16,141
"2011","Cornwall 044B","E01018808","Total",656,220,14,206,180,72,166,29,137
"2011","Cornwall 044C","E01018809","Total",1141,485,22,463,180,77,391,34,357
"2011","Cornwall 044D","E01018810","Total",579,174,10,164,150,58,129,11,118
"2011","Cornwall 047A","E01018816","Total",736,359,6,353,153,36,184,23,161
"2011","Cornwall 047B","E01018817","Total",886,353,17,336,217,58,249,36,213
"2011","Cornwall 047C","E01018818","Total",721,361,13,348,145,44,236,18,218
"2011","Cornwall 047D","E01018820","Total",759,244,17,227,212,76,197,34,163
"2011","Cornwall 047E","E01018821","Total",492,130,11,119,144,50,101,22,79
"2011","Cornwall 048A","E01018845","Total",665,223,10,213,195,55,190,30,160
"2011","Cornwall 048B","E01018846","Total",606,197,9,188,129,35,172,17,155
"2011","Cornwall 048C","E01018848","Total",698,243,9,234,192,66,190,33,157
"2011","Cornwall 048D","E01018849","Total",941,455,13,442,134,48,279,21,258
"2011","Cornwall 048E","E01018850","Total",586,209,8,201,122,30,141,20,121
"2011","Cornwall 056A","E01018827","Total",656,293,6,287,123,40,164,19,145
"2011","Cornwall 056B","E01018828","Total",696,312,10,302,138,42,205,21,184
"2011","Cornwall 056C","E01018829","Total",539,153,16,137,150,48,134,25,109
"2011","Cornwall 056D","E01018830","Total",673,313,4,309,125,34,183,21,162
"2011","Cornwall 060A","E01018834","Total",718,232,28,204,231,85,186,40,146
"2011","Cornwall 060B","E01018835","Total",756,246,31,215,205,76,178,45,133
"2011","Cornwall 060C","E01018836","Total",758,313,51,262,186,78,243,37,206
"2011","Cornwall 060D","E01018837","Total",914,297,18,279,189,82,212,32,180
"2011","Cornwall 062A","E01018838","Total",625,271,30,241,151,55,203,32,171
"2011","Cornwall 062B","E01018839","Total",586,235,16,219,90,37,139,14,125
"2011","Cornwall 062C","E01018840","Total",689,255,19,236,111,33,189,19,170
"2011","Cornwall 062D","E01018841","Total",582,263,53,210,182,65,210,50,160
"2011","Cornwall 062E","E01018860","Total",826,400,47,353,238,76,294,54,240
"2011","Cornwall 063A","E01018803","Total",966,515,4,511,91,37,247,17,230
"2011","Cornwall 063B","E01018804","Total",742,235,16,219,124,57,172,17,155
"2011","Cornwall 063C","E01018805","Total",685,323,10,313,118,34,182,8,174
"2011","Cornwall 063D","E01018806","Total",641,235,12,223,133,38,154,16,138
"2011","Cornwall 064A","E01018811","Total",622,207,9,198,191,61,159,32,127
"2011","Cornwall 064B","E01018812","Total",594,221,31,190,185,67,173,37,136
"2011","Cornwall 064C","E01018813","Total",599,189,9,180,185,74,135,25,110
"2011","Cornwall 064D","E01018814","Total",597,189,15,174,188,55,153,30,123
"2011","Cornwall 064E","E01018859","Total",755,330,7,323,137,39,228,20,208
"2011","Cornwall 045A","E01018889","Total",548,159,5,154,151,53,164,21,143
"2011","Cornwall 045B","E01018890","Total",630,269,11,258,129,41,223,24,199
"2011","Cornwall 045C","E01018891","Total",589,210,28,182,154,67,124,20,104
"2011","Cornwall 045D","E01018892","Total",584,192,9,183,152,59,170,29,141
"2011","Cornwall 045E","E01018893","Total",618,303,25,278,132,55,232,25,207
"2011","Cornwall 046A","E01018908","Total",692,257,26,231,179,57,213,39,174
"2011","Cornwall 046B","E01018909","Total",695,207,27,180,229,99,175,25,150
"2011","Cornwall 046C","E01018910","Total",776,379,91,288,272,119,306,68,238
"2011","Cornwall 046D","E01018911","Total",835,366,28,338,181,84,308,34,274
"2011","Cornwall 049A","E01018912","Total",630,222,8,214,152,56,152,15,137
"2011","Cornwall 049B","E01018913","Total",777,195,22,173,241,108,197,35,162
"2011","Cornwall 049C","E01018914","Total",814,282,22,260,205,102,227,41,186
"2011","Cornwall 049D","E01018915","Total",872,309,30,279,240,103,234,40,194
"2011","Cornwall 050A","E01018916","Total",545,194,15,179,170,55,172,39,133
"2011","Cornwall 050B","E01018917","Total",597,234,12,222,160,57,158,18,140
"2011","Cornwall 050C","E01018918","Total",764,292,20,272,208,94,282,45,237
"2011","Cornwall 050D","E01018919","Total",611,237,12,225,125,57,178,17,161
"2011","Cornwall 051A","E01018894","Total",742,193,15,178,220,88,190,34,156
"2011","Cornwall 051B","E01018895","Total",678,222,25,197,194,83,169,33,136
"2011","Cornwall 051C","E01018896","Total",649,273,22,251,181,63,217,30,187
"2011","Cornwall 051D","E01018897","Total",641,229,28,201,158,65,191,27,164
"2011","Cornwall 051E","E01018898","Total",552,268,58,210,187,74,234,44,190
"2011","Cornwall 052A","E01018865","Total",819,267,47,220,252,103,243,54,189
"2011","Cornwall 052B","E01018866","Total",716,275,24,251,173,65,228,31,197
"2011","Cornwall 052C","E01018867","Total",795,282,55,227,261,110,223,48,175
"2011","Cornwall 052D","E01018868","Total",760,284,48,236,244,106,204,47,157
"2011","Cornwall 053A","E01018874","Total",587,275,11,264,126,41,218,34,184
"2011","Cornwall 053B","E01018875","Total",630,368,51,317,169,68,266,39,227
"2011","Cornwall 053C","E01018876","Total",575,199,28,171,167,58,166,33,133
"2011","Cornwall 053D","E01018877","Total",629,313,14,299,121,40,213,25,188
"2011","Cornwall 053E","E01018878","Total",702,327,35,292,165,62,242,27,215
"2011","Cornwall 055A","E01018869","Total",661,259,36,223,186,71,209,31,178
"2011","Cornwall 055B","E01018870","Total",492,214,67,147,211,87,173,53,120
"2011","Cornwall 055C","E01018871","Total",702,243,13,230,185,59,198,31,167
"2011","Cornwall 055D","E01018872","Total",532,200,23,177,145,56,158,32,126
"2011","Cornwall 055E","E01018873","Total",505,176,39,137,169,67,145,40,105
"2011","Cornwall 059A","E01018863","Total",660,212,22,190,219,80,180,46,134
"2011","Cornwall 059B","E01018864","Total",664,222,10,212,182,54,176,31,145
"2011","Cornwall 059C","E01018921","Total",872,287,26,261,225,76,266,47,219
"2011","Cornwall 059D","E01018922","Total",921,243,12,231,260,88,262,60,202
"2011","Cornwall 066A","E01018879","Total",799,357,6,351,136,47,219,27,192
"2011","Cornwall 066B","E01018880","Total",919,358,21,337,219,78,257,38,219
"2011","Cornwall 066C","E01018899","Total",618,241,11,230,135,46,183,26,157
"2011","Cornwall 066D","E01018900","Total",639,227,8,219,150,49,173,22,151
"2011","Cornwall 066E","E01018901","Total",699,286,10,276,175,68,203,26,177
"2011","Cornwall 071A","E01018882","Total",616,190,13,177,207,58,158,36,122
"2011","Cornwall 071B","E01018883","Total",651,187,10,177,197,59,164,25,139
"2011","Cornwall 071C","E01018884","Total",684,211,20,191,226,80,185,37,148
"2011","Cornwall 071D","E01018885","Total",680,256,24,232,164,72,189,28,161
"2011","Cornwall 071E","E01018886","Total",738,173,17,156,327,169,151,37,114
"2011","Cornwall 071F","E01018887","Total",643,173,37,136,242,104,141,42,99
"2011","Cornwall 071G","E01018888","Total",904,400,42,358,237,110,305,36,269
"2011","Cornwall 072A","E01018861","Total",613,219,9,210,146,46,168,29,139
"2011","Cornwall 072B","E01018862","Total",619,251,8,243,115,45,177,19,158
"2011","Cornwall 072C","E01018905","Total",570,209,8,201,130,38,163,22,141
"2011","Cornwall 072D","E01018906","Total",566,239,8,231,126,37,166,19,147
"2011","Cornwall 072E","E01018907","Total",589,271,17,254,130,52,200,15,185
"2011","Cornwall 073A","E01018881","Total",815,341,15,326,186,52,245,29,216
"2011","Cornwall 073B","E01018902","Total",512,182,12,170,140,48,138,22,116
"2011","Cornwall 073C","E01018903","Total",446,173,15,158,107,51,127,24,103
"2011","Cornwall 073D","E01018904","Total",942,410,27,383,200,74,309,41,268
"2011","Cornwall 073E","E01018920","Total",885,380,25,355,189,66,242,29,213
"2011","Cornwall 001A","E01018936","Total",713,286,17,269,152,52,199,31,168
"2011","Cornwall 001B","E01018937","Total",772,278,62,216,289,116,222,63,159
"2011","Cornwall 001C","E01018938","Total",812,442,25,417,157,63,312,37,275
"2011","Cornwall 001D","E01018959","Total",684,352,11,341,116,39,233,19,214
"2011","Cornwall 001E","E01018960","Total",796,287,26,261,236,95,208,35,173
"2011","Cornwall 001F","E01018961","Total",707,335,19,316,140,48,203,20,183
"2011","Cornwall 002A","E01018943","Total",897,297,10,287,213,78,238,25,213
"2011","Cornwall 002B","E01018951","Total",949,372,22,350,222,72,272,40,232
"2011","Cornwall 002C","E01018974","Total",1007,342,21,321,243,104,258,39,219
"2011","Cornwall 003A","E01018940","Total",691,263,13,250,155,58,211,26,185
"2011","Cornwall 003B","E01018941","Total",684,261,22,239,186,84,208,26,182
"2011","Cornwall 003C","E01018942","Total",692,286,19,267,135,52,200,20,180
"2011","Cornwall 003D","E01018969","Total",1011,387,20,367,197,53,305,31,274
"2011","Cornwall 004B","E01018953","Total",496,172,9,163,121,45,134,24,110
"2011","Cornwall 004C","E01018968","Total",1002,335,16,319,237,91,276,40,236
"2011","Cornwall 004D","E01033291","Total",660,223,10,213,158,57,180,29,151
"2011","Cornwall 004E","E01033292","Total",576,217,47,170,203,98,166,34,132
"2011","Cornwall 005A","E01018946","Total",678,276,17,259,139,49,201,26,175
"2011","Cornwall 005B","E01018947","Total",1179,315,44,271,388,173,257,60,197
"2011","Cornwall 005C","E01018948","Total",710,240,36,204,191,74,179,31,148
"2011","Cornwall 005D","E01018949","Total",523,181,53,128,224,88,169,56,113
"2011","Cornwall 005E","E01018950","Total",836,288,20,268,163,70,218,25,193
"2011","Cornwall 006A","E01018925","Total",916,330,10,320,204,66,249,32,217
"2011","Cornwall 006B","E01018952","Total",501,196,15,181,116,39,156,25,131
"2011","Cornwall 006C","E01018965","Total",995,361,11,350,224,73,285,28,257
"2011","Cornwall 006D","E01018966","Total",467,151,7,144,101,25,115,13,102
"2011","Cornwall 006E","E01018967","Total",535,183,8,175,134,43,149,31,118
"2011","Cornwall 007A","E01018924","Total",467,146,7,139,122,36,105,16,89
"2011","Cornwall 007B","E01018962","Total",930,354,14,340,212,71,258,41,217
"2011","Cornwall 007E","E01033289","Total",999,434,8,426,178,72,286,25,261
"2011","Cornwall 008A","E01018954","Total",476,124,23,101,190,76,111,33,78
"2011","Cornwall 008B","E01018955","Total",684,276,19,257,165,56,175,26,149
"2011","Cornwall 008C","E01018956","Total",474,201,7,194,94,39,148,20,128
"2011","Cornwall 008D","E01018957","Total",542,191,18,173,148,56,140,26,114
"2011","Cornwall 008E","E01018958","Total",634,297,18,279,114,38,209,23,186
"2011","Cornwall 009A","E01018970","Total",634,218,15,203,184,48,167,19,148
"2011","Cornwall 009B","E01018971","Total",851,372,15,357,212,66,238,30,208
"2011","Cornwall 009C","E01018972","Total",832,346,17,329,174,74,265,23,242
"2011","Cornwall 009D","E01018973","Total",638,233,16,217,160,51,181,27,154
"2011","Cornwall 011A","E01018923","Total",531,211,11,200,132,48,131,28,103
"2011","Cornwall 011B","E01018926","Total",1027,367,20,347,227,67,285,43,242
"2011","Cornwall 011C","E01018944","Total",455,161,10,151,120,41,122,21,101
"2011","Cornwall 011D","E01018945","Total",540,181,10,171,116,45,150,29,121
"2011","Cornwall 014A","E01018932","Total",703,247,43,204,203,73,198,37,161
"2011","Cornwall 014B","E01018933","Total",657,230,29,201,151,63,175,29,146
"2011","Cornwall 014C","E01018934","Total",811,279,13,266,224,77,227,42,185
"2011","Cornwall 014D","E01018935","Total",927,288,38,250,320,163,208,49,159
"2011","Cornwall 015A","E01018927","Total",648,238,20,218,189,73,219,45,174
"2011","Cornwall 015B","E01018928","Total",790,321,50,271,219,99,256,44,212
"2011","Cornwall 015C","E01018929","Total",539,214,17,197,135,67,154,25,129
"2011","Cornwall 015D","E01018930","Total",669,265,79,186,256,110,217,50,167
"2011","Cornwall 015E","E01018931","Total",502,190,13,177,132,48,150,20,130
"2011","Cornwall 054A","E01019008","Total",642,293,31,262,161,54,241,41,200
"2011","Cornwall 054B","E01019009","Total",606,202,37,165,225,69,182,45,137
"2011","Cornwall 054C","E01019010","Total",569,194,8,186,156,52,154,26,128
"2011","Cornwall 054D","E01019011","Total",628,266,12,254,119,35,177,18,159
"2011","Cornwall 054E","E01019012","Total",1000,450,17,433,125,31,284,13,271
"2011","Cornwall 057A","E01018978","Total",632,234,27,207,171,65,184,29,155
"2011","Cornwall 057B","E01018981","Total",907,379,12,367,202,70,278,29,249
"2011","Cornwall 057C","E01018982","Total",919,333,49,284,294,132,260,49,211
"2011","Cornwall 057D","E01018983","Total",682,282,12,270,143,48,201,26,175
"2011","Cornwall 057E","E01018984","Total",891,410,67,343,275,89,321,72,249
"2011","Cornwall 058A","E01018985","Total",995,394,21,373,226,68,250,34,216
"2011","Cornwall 058B","E01018986","Total",746,382,11,371,126,51,230,22,208
"2011","Cornwall 058C","E01018987","Total",915,306,13,293,209,67,246,36,210
"2011","Cornwall 061A","E01018975","Total",827,334,23,311,232,74,248,40,208
"2011","Cornwall 061B","E01018979","Total",542,173,17,156,151,54,166,28,138
"2011","Cornwall 061C","E01018980","Total",577,206,14,192,141,61,150,25,125
"2011","Cornwall 061D","E01018990","Total",859,413,23,390,164,57,283,35,248
"2011","Cornwall 061E","E01019007","Total",909,304,18,286,246,78,254,42,212
"2011","Cornwall 065A","E01018988","Total",669,247,10,237,157,47,193,29,164
"2011","Cornwall 065B","E01018989","Total",717,244,31,213,195,55,203,38,165
"2011","Cornwall 065C","E01018991","Total",680,262,25,237,171,67,228,33,195
"2011","Cornwall 065D","E01019006","Total",687,228,10,218,150,45,206,24,182
"2011","Cornwall 067A","E01018976","Total",976,422,21,401,209,74,309,38,271
"2011","Cornwall 067B","E01018977","Total",608,256,47,209,203,69,198,40,158
"2011","Cornwall 067C","E01018994","Total",776,366,20,346,151,43,270,29,241
"2011","Cornwall 067D","E01018996","Total",752,361,34,327,179,70,264,43,221
"2011","Cornwall 067E","E01018997","Total",573,278,81,197,245,79,230,63,167
"2011","Cornwall 068A","E01018995","Total",1048,524,56,468,208,72,423,59,364
"2011","Cornwall 068B","E01018998","Total",687,218,35,183,197,100,170,33,137
"2011","Cornwall 068C","E01018999","Total",797,372,29,343,154,65,311,31,280
"2011","Cornwall 068D","E01019001","Total",940,431,24,407,155,46,301,19,282
"2011","Cornwall 069A","E01018992","Total",727,245,12,233,148,47,199,26,173
"2011","Cornwall 069B","E01018993","Total",794,318,33,285,192,51,252,36,216
"2011","Cornwall 069C","E01019005","Total",908,319,15,304,208,85,266,42,224
"2011","Cornwall 070A","E01019000","Total",682,372,20,352,110,39,245,23,222
"2011","Cornwall 070B","E01019002","Total",705,329,10,319,118,28,227,18,209
"2011","Cornwall 070C","E01019003","Total",777,302,16,286,162,50,211,27,184
"2011","Cornwall 070D","E01019004","Total",756,352,65,287,204,74,257,44,213
"2011","Cornwall 018A","E01019048","Total",806,321,15,306,151,51,203,22,181
"2011","Cornwall 018B","E01019049","Total",752,239,24,215,223,89,212,43,169
"2011","Cornwall 018C","E01019050","Total",583,188,9,179,144,57,142,21,121
"2011","Cornwall 018D","E01019051","Total",712,312,31,281,209,69,247,39,208
"2011","Cornwall 019A","E01019060","Total",629,206,13,193,153,60,163,26,137
"2011","Cornwall 019B","E01019061","Total",718,228,20,208,232,95,174,46,128
"2011","Cornwall 019C","E01019062","Total",788,287,43,244,263,125,246,55,191
"2011","Cornwall 019D","E01019063","Total",799,215,26,189,256,105,191,45,146
"2011","Cornwall 019E","E01019064","Total",775,224,30,194,243,108,191,42,149
"2011","Cornwall 019F","E01019065","Total",523,173,24,149,158,64,143,27,116
"2011","Cornwall 020A","E01019028","Total",938,348,33,315,225,98,291,40,251
"2011","Cornwall 020B","E01019029","Total",687,260,21,239,135,59,221,26,195
"2011","Cornwall 020C","E01019030","Total",742,234,19,215,205,73,163,35,128
"2011","Cornwall 020D","E01019031","Total",724,253,22,231,155,70,195,35,160
"2011","Cornwall 021A","E01019018","Total",656,250,9,241,183,65,175,26,149
"2011","Cornwall 021B","E01019019","Total",638,283,14,269,128,40,212,21,191
"2011","Cornwall 021C","E01019020","Total",688,246,35,211,153,45,219,38,181
"2011","Cornwall 021D","E01019021","Total",651,247,19,228,169,69,175,20,155
"2011","Cornwall 021E","E01019022","Total",769,330,50,280,208,81,233,33,200
"2011","Cornwall 021F","E01019023","Total",630,130,31,99,253,107,129,34,95
"2011","Cornwall 024A","E01019052","Total",723,224,29,195,217,84,206,38,168
"2011","Cornwall 024B","E01019053","Total",842,275,26,249,220,105,238,37,201
"2011","Cornwall 024C","E01019054","Total",742,246,28,218,212,72,208,47,161
"2011","Cornwall 024D","E01019055","Total",577,230,52,178,197,81,190,44,146
"2011","Cornwall 027A","E01019035","Total",720,309,7,302,140,47,207,16,191
"2011","Cornwall 027B","E01019036","Total",720,229,11,218,154,51,209,31,178
"2011","Cornwall 027C","E01019037","Total",603,228,28,200,182,57,168,44,124
"2011","Cornwall 027D","E01019074","Total",721,214,38,176,239,107,193,58,135
"2011","Cornwall 027E","E01019075","Total",691,219,29,190,205,76,185,37,148
"2011","Cornwall 027F","E01019076","Total",737,248,53,195,277,141,210,57,153
"2011","Cornwall 030A","E01019069","Total",531,151,27,124,174,80,133,31,102
"2011","Cornwall 030B","E01019070","Total",863,345,51,294,249,107,253,54,199
"2011","Cornwall 030C","E01019071","Total",601,182,16,166,195,61,132,31,101
"2011","Cornwall 030D","E01019072","Total",610,228,34,194,205,79,203,54,149
"2011","Cornwall 030E","E01019073","Total",575,194,8,186,159,58,154,26,128
"2011","Cornwall 031A","E01019056","Total",610,268,76,192,247,106,212,50,162
"2011","Cornwall 031B","E01019057","Total",799,247,29,218,238,92,223,42,181
"2011","Cornwall 031C","E01019058","Total",749,235,19,216,231,84,208,43,165
"2011","Cornwall 031D","E01019059","Total",683,285,28,257,175,52,229,29,200
"2011","Cornwall 035A","E01019024","Total",604,203,18,185,166,52,205,39,166
"2011","Cornwall 035B","E01019025","Total",612,266,7,259,124,23,180,21,159
"2011","Cornwall 035C","E01019026","Total",644,271,6,265,143,39,201,14,187
"2011","Cornwall 035D","E01019027","Total",717,327,18,309,136,43,199,15,184
"2011","Cornwall 036A","E01019013","Total",932,374,39,335,284,93,282,62,220
"2011","Cornwall 036B","E01019014","Total",571,197,19,178,146,44,157,30,127
"2011","Cornwall 036C","E01019015","Total",591,164,8,156,157,55,126,20,106
"2011","Cornwall 036D","E01019016","Total",697,142,32,110,292,116,141,43,98
"2011","Cornwall 036E","E01019017","Total",1075,491,13,478,215,74,294,31,263
"2011","Cornwall 038A","E01019032","Total",611,230,18,212,160,61,156,19,137
"2011","Cornwall 038B","E01019034","Total",622,231,36,195,195,86,184,38,146
"2011","Cornwall 038C","E01019045","Total",871,246,21,225,267,111,200,38,162
"2011","Cornwall 038D","E01019047","Total",483,211,17,194,113,34,173,23,150
"2011","Cornwall 039A","E01019033","Total",694,368,40,328,162,89,280,36,244
"2011","Cornwall 039B","E01019041","Total",763,323,57,266,222,98,273,47,226
"2011","Cornwall 039C","E01019042","Total",749,270,33,237,206,74,228,46,182
"2011","Cornwall 039D","E01019043","Total",678,291,17,274,149,54,210,35,175
"2011","Cornwall 039E","E01019044","Total",721,356,8,348,130,43,232,20,212
"2011","Cornwall 039F","E01019046","Total",590,251,28,223,167,66,217,34,183
"2011","Cornwall 041A","E01019038","Total",549,259,4,255,87,28,180,15,165
"2011","Cornwall 041B","E01019039","Total",598,249,9,240,131,37,163,27,136
"2011","Cornwall 041C","E01019040","Total",546,212,14,198,113,38,152,21,131
"2011","Cornwall 041D","E01019066","Total",501,159,6,153,120,36,115,13,102
"2011","Cornwall 041E","E01019067","Total",493,210,8,202,104,30,135,15,120
"2011","Cornwall 041F","E01019068","Total",720,337,7,330,149,44,218,29,189
"2011","Isles of Scilly 001A","E01019077","Total",989,249,2,247,196,76,208,19,189
"2011","North Somerset 001B","E01014790","Total",624,219,6,213,159,51,169,22,147
"2011","North Somerset 001C","E01014795","Total",605,205,26,179,184,79,181,35,146
"2011","North Somerset 001D","E01014797","Total",740,256,18,238,198,69,201,35,166
"2011","North Somerset 001E","E01032675","Total",637,104,12,92,182,93,73,12,61
"2011","North Somerset 001F","E01032676","Total",726,182,8,174,117,50,109,12,97
"2011","North Somerset 001G","E01032681","Total",628,304,10,294,133,61,195,11,184
"2011","North Somerset 002A","E01014789","Total",615,231,3,228,105,30,126,8,118
"2011","North Somerset 002B","E01014793","Total",666,214,5,209,185,63,141,15,126
"2011","North Somerset 002C","E01014794","Total",745,329,3,326,145,44,191,10,181
"2011","North Somerset 002D","E01014798","Total",587,180,7,173,193,51,126,23,103
"2011","North Somerset 003B","E01014792","Total",891,397,11,386,169,62,284,30,254
"2011","North Somerset 003C","E01014796","Total",732,281,8,273,173,68,200,22,178
"2011","North Somerset 003D","E01032677","Total",573,118,25,93,241,140,106,32,74
"2011","North Somerset 003E","E01032678","Total",553,48,6,42,288,138,54,16,38
"2011","North Somerset 003F","E01032682","Total",425,92,20,72,187,66,78,25,53
"2011","North Somerset 004A","E01014766","Total",564,184,7,177,131,37,115,14,101
"2011","North Somerset 004B","E01014767","Total",572,228,1,227,117,35,138,12,126
"2011","North Somerset 004C","E01014786","Total",721,271,28,243,189,77,194,23,171
"2011","North Somerset 004D","E01014787","Total",814,238,14,224,235,92,192,41,151
"2011","North Somerset 005A","E01014752","Total",646,173,10,163,171,63,144,24,120
"2011","North Somerset 005B","E01014754","Total",636,240,4,236,82,31,159,6,153
"2011","North Somerset 005C","E01014758","Total",512,210,3,207,125,30,110,15,95
"2011","North Somerset 005D","E01014759","Total",596,258,1,257,123,30,152,10,142
"2011","North Somerset 006B","E01014849","Total",682,270,7,263,156,65,170,17,153
"2011","North Somerset 006C","E01014850","Total",822,246,17,229,269,106,152,24,128
"2011","North Somerset 006D","E01014851","Total",1080,321,26,295,368,224,218,43,175
"2011","North Somerset 006E","E01014852","Total",613,162,15,147,213,69,133,29,104
"2011","North Somerset 006F","E01032674","Total",948,179,18,161,404,236,161,40,121
"2011","North Somerset 006G","E01032680","Total",797,286,7,279,163,33,199,25,174
"2011","North Somerset 007A","E01014750","Total",742,252,16,236,180,83,195,21,174
"2011","North Somerset 007B","E01014751","Total",716,269,29,240,185,67,226,34,192
"2011","North Somerset 007C","E01014753","Total",810,289,30,259,231,87,224,36,188
"2011","North Somerset 007D","E01014755","Total",627,268,2,266,82,24,193,15,178
"2011","North Somerset 007E","E01014760","Total",626,221,8,213,155,45,166,19,147
"2011","North Somerset 008A","E01014780","Total",715,275,15,260,182,50,216,23,193
"2011","North Somerset 008B","E01014781","Total",789,363,12,351,174,59,265,24,241
"2011","North Somerset 008C","E01014782","Total",605,237,8,229,137,50,144,23,121
"2011","North Somerset 008D","E01014783","Total",729,241,14,227,170,53,200,19,181
"2011","North Somerset 008E","E01014784","Total",702,285,9,276,180,62,212,27,185
"2011","North Somerset 008F","E01014785","Total",587,235,4,231,119,29,157,12,145
"2011","North Somerset 009A","E01014775","Total",496,128,6,122,159,50,92,15,77
"2011","North Somerset 009B","E01014776","Total",498,123,6,117,177,48,100,22,78
"2011","North Somerset 009C","E01014777","Total",628,183,9,174,222,79,139,26,113
"2011","North Somerset 009D","E01014778","Total",536,202,3,199,117,22,118,17,101
"2011","North Somerset 009E","E01014779","Total",493,178,4,174,124,28,125,14,111
"2011","North Somerset 010A","E01014756","Total",768,221,11,210,185,65,188,26,162
"2011","North Somerset 010B","E01014757","Total",620,155,12,143,192,80,124,19,105
"2011","North Somerset 010C","E01014761","Total",729,208,11,197,195,64,161,22,139
"2011","North Somerset 010D","E01014762","Total",612,179,8,171,177,68,145,22,123
"2011","North Somerset 010E","E01014763","Total",719,158,26,132,274,110,151,38,113
"2011","North Somerset 011A","E01014737","Total",603,229,8,221,180,48,151,25,126
"2011","North Somerset 011B","E01014738","Total",566,164,17,147,218,65,138,39,99
"2011","North Somerset 011C","E01014739","Total",589,203,8,195,166,38,160,26,134
"2011","North Somerset 011D","E01014740","Total",530,136,6,130,191,46,112,19,93
"2011","North Somerset 012A","E01014855","Total",581,176,1,175,143,49,125,19,106
"2011","North Somerset 012B","E01014856","Total",590,181,18,163,204,71,152,34,118
"2011","North Somerset 012C","E01014857","Total",616,218,14,204,200,63,176,33,143
"2011","North Somerset 012D","E01014858","Total",714,155,18,137,211,84,129,25,104
"2011","North Somerset 012E","E01014859","Total",636,213,14,199,192,68,152,32,120
"2011","North Somerset 012F","E01014860","Total",624,217,11,206,178,59,198,30,168
"2011","North Somerset 013A","E01014847","Total",681,184,10,174,195,61,140,22,118
"2011","North Somerset 013B","E01014848","Total",522,156,8,148,146,41,119,23,96
"2011","North Somerset 013C","E01014853","Total",739,298,16,282,204,81,173,27,146
"2011","North Somerset 013D","E01014854","Total",549,166,1,165,136,45,123,17,106
"2011","North Somerset 014A","E01014764","Total",687,291,28,263,182,59,203,30,173
"2011","North Somerset 014B","E01014765","Total",735,262,16,246,207,82,185,26,159
"2011","North Somerset 014C","E01014773","Total",640,117,14,103,250,88,123,31,92
"2011","North Somerset 014D","E01014774","Total",694,260,16,244,148,38,209,24,185
"2011","North Somerset 015A","E01014821","Total",500,117,22,95,195,81,112,33,79
"2011","North Somerset 015B","E01014822","Total",542,100,10,90,220,85,114,40,74
"2011","North Somerset 015C","E01014823","Total",504,128,6,122,167,67,117,26,91
"2011","North Somerset 015D","E01014824","Total",644,212,10,202,162,57,186,21,165
"2011","North Somerset 015E","E01014825","Total",487,146,8,138,144,38,118,22,96
"2011","North Somerset 015F","E01014826","Total",630,136,37,99,259,107,131,34,97
"2011","North Somerset 015G","E01014827","Total",598,209,42,167,201,80,189,44,145
"2011","North Somerset 016A","E01014817","Total",695,292,19,273,158,53,213,26,187
"2011","North Somerset 016B","E01014820","Total",719,413,23,390,119,46,287,25,262
"2011","North Somerset 016C","E01014835","Total",650,315,39,276,181,61,224,35,189
"2011","North Somerset 016D","E01014836","Total",644,289,24,265,176,71,225,37,188
"2011","North Somerset 016E","E01014838","Total",594,226,21,205,178,66,187,33,154
"2011","North Somerset 016F","E01014840","Total",615,268,41,227,171,65,182,39,143
"2011","North Somerset 017A","E01014812","Total",675,300,19,281,139,54,189,25,164
"2011","North Somerset 017B","E01014813","Total",734,283,29,254,222,87,208,37,171
"2011","North Somerset 017C","E01014815","Total",587,216,22,194,176,62,192,34,158
"2011","North Somerset 017D","E01014816","Total",648,257,2,255,139,57,206,19,187
"2011","North Somerset 017E","E01014818","Total",750,309,11,298,159,48,193,17,176
"2011","North Somerset 017F","E01014819","Total",732,331,13,318,136,48,215,26,189
"2011","North Somerset 018A","E01014841","Total",978,366,19,347,87,41,271,21,250
"2011","North Somerset 018B","E01014842","Total",822,366,31,335,110,63,240,12,228
"2011","North Somerset 018C","E01014843","Total",670,241,13,228,97,43,201,18,183
"2011","North Somerset 018D","E01014844","Total",769,372,17,355,91,35,280,19,261
"2011","North Somerset 018E","E01014845","Total",577,247,3,244,110,49,171,15,156
"2011","North Somerset 018F","E01014846","Total",637,254,15,239,144,43,180,23,157
"2011","North Somerset 020A","E01014799","Total",801,309,34,275,174,63,267,47,220
"2011","North Somerset 020B","E01014800","Total",799,335,57,278,194,86,265,41,224
"2011","North Somerset 020C","E01014801","Total",793,453,26,427,94,38,289,17,272
"2011","North Somerset 020D","E01014802","Total",758,333,20,313,118,62,268,23,245
"2011","North Somerset 020E","E01014809","Total",772,276,53,223,222,91,217,37,180
"2011","North Somerset 020F","E01014811","Total",742,310,17,293,179,69,257,31,226
"2011","North Somerset 021A","E01014829","Total",793,325,84,241,263,114,258,60,198
"2011","North Somerset 021B","E01014830","Total",657,216,45,171,213,86,182,40,142
"2011","North Somerset 021C","E01014831","Total",582,287,85,202,219,93,226,65,161
"2011","North Somerset 021D","E01014832","Total",630,348,85,263,196,91,271,57,214
"2011","North Somerset 021E","E01014833","Total",645,331,78,253,229,81,263,73,190
"2011","North Somerset 022A","E01014804","Total",624,299,8,291,118,38,180,13,167
"2011","North Somerset 022B","E01014806","Total",780,393,27,366,129,58,292,23,269
"2011","North Somerset 022C","E01014807","Total",818,298,29,269,177,75,228,32,196
"2011","North Somerset 022D","E01014808","Total",588,198,21,177,176,61,150,24,126
"2011","North Somerset 023A","E01014744","Total",606,230,4,226,123,31,171,23,148
"2011","North Somerset 023B","E01014746","Total",597,222,31,191,176,60,172,39,133
"2011","North Somerset 023C","E01014769","Total",943,270,32,238,332,149,230,44,186
"2011","North Somerset 023D","E01014770","Total",632,292,6,286,97,28,203,15,188
"2011","North Somerset 023E","E01014771","Total",637,272,6,266,130,38,192,25,167
"2011","North Somerset 023F","E01014772","Total",614,254,7,247,112,37,162,12,150
"2011","North Somerset 024A","E01014741","Total",646,274,6,268,144,43,201,26,175
"2011","North Somerset 024B","E01014742","Total",613,255,4,251,135,40,170,23,147
"2011","North Somerset 024C","E01014745","Total",657,280,7,273,132,38,198,20,178
"2011","North Somerset 024D","E01014747","Total",587,187,3,184,149,54,141,12,129
"2011","North Somerset 024E","E01014748","Total",441,151,7,144,116,38,129,23,106
"2011","North Somerset 024F","E01014749","Total",507,133,10,123,167,53,100,16,84
"2011","North Somerset 025A","E01014803","Total",644,273,9,264,151,48,186,26,160
"2011","North Somerset 025B","E01014805","Total",688,361,5,356,92,26,206,10,196
"2011","North Somerset 025C","E01014828","Total",579,246,72,174,226,104,187,50,137
"2011","North Somerset 025D","E01014834","Total",621,279,50,229,192,78,220,37,183
"2011","North Somerset 026A","E01014839","Total",631,163,35,128,240,102,157,46,111
"2011","North Somerset 026B","E01032666","Total",482,142,15,127,145,60,117,25,92
"2011","North Somerset 026C","E01032667","Total",429,87,18,69,175,90,93,29,64
"2011","North Somerset 026D","E01032668","Total",602,102,39,63,265,141,98,38,60
"2011","North Somerset 026E","E01032672","Total",586,111,12,99,196,122,98,22,76
"2011","North Somerset 026F","E01032673","Total",622,256,22,234,147,72,204,19,185
"2011","North Somerset 027A","E01014810","Total",693,234,25,209,183,82,192,35,157
"2011","North Somerset 027B","E01032669","Total",561,60,29,31,265,170,71,36,35
"2011","North Somerset 027C","E01032670","Total",586,75,47,28,310,157,92,55,37
"2011","North Somerset 027D","E01032671","Total",496,61,23,38,281,139,76,36,40
"2011","North Somerset 027E","E01032679","Total",551,94,25,69,220,108,82,26,56
"2011","Plymouth 001A","E01015025","Total",655,284,2,282,123,54,160,16,144
"2011","Plymouth 001B","E01015097","Total",830,450,3,447,91,23,281,13,268
"2011","Plymouth 001C","E01015160","Total",624,240,12,228,158,56,173,24,149
"2011","Plymouth 001D","E01015164","Total",734,172,22,150,307,153,175,46,129
"2011","Plymouth 002A","E01015027","Total",647,204,25,179,200,73,180,39,141
"2011","Plymouth 002B","E01015159","Total",767,364,34,330,182,61,286,44,242
"2011","Plymouth 002C","E01015161","Total",640,256,38,218,193,68,206,47,159
"2011","Plymouth 002D","E01015162","Total",633,247,35,212,184,70,229,31,198
"2011","Plymouth 002E","E01015166","Total",821,322,67,255,264,116,239,52,187
"2011","Plymouth 003A","E01015023","Total",686,273,37,236,198,76,237,46,191
"2011","Plymouth 003B","E01015026","Total",769,322,69,253,224,130,232,39,193
"2011","Plymouth 003C","E01015028","Total",642,279,60,219,222,105,242,45,197
"2011","Plymouth 003D","E01015163","Total",593,229,26,203,171,68,176,32,144
"2011","Plymouth 003E","E01015165","Total",643,142,20,122,269,126,141,37,104
"2011","Plymouth 004A","E01015024","Total",648,177,32,145,175,69,138,32,106
"2011","Plymouth 004B","E01015082","Total",693,294,61,233,223,95,256,50,206
"2011","Plymouth 004C","E01015083","Total",687,315,36,279,171,62,274,44,230
"2011","Plymouth 004D","E01015084","Total",620,244,31,213,168,58,202,42,160
"2011","Plymouth 005A","E01015090","Total",567,151,11,140,137,48,133,24,109
"2011","Plymouth 005B","E01015091","Total",629,197,20,177,169,53,181,41,140
"2011","Plymouth 005C","E01015092","Total",483,140,23,117,126,53,135,26,109
"2011","Plymouth 005D","E01015093","Total",634,235,27,208,152,55,236,32,204
"2011","Plymouth 005E","E01015094","Total",596,203,25,178,187,74,221,44,177
"2011","Plymouth 006A","E01015085","Total",716,296,31,265,178,62,247,42,205
"2011","Plymouth 006B","E01015087","Total",560,201,57,144,241,85,205,65,140
"2011","Plymouth 006C","E01015088","Total",620,276,99,177,274,127,211,68,143
"2011","Plymouth 006D","E01015147","Total",503,183,14,169,128,46,146,20,126
"2011","Plymouth 006E","E01015148","Total",661,228,33,195,204,101,200,35,165
"2011","Plymouth 007A","E01015030","Total",757,384,58,326,197,97,279,40,239
"2011","Plymouth 007B","E01015070","Total",1078,305,40,265,352,160,250,47,203
"2011","Plymouth 007C","E01015081","Total",626,248,49,199,215,81,203,51,152
"2011","Plymouth 007D","E01015086","Total",621,290,39,251,156,66,228,34,194
"2011","Plymouth 007E","E01015089","Total",741,272,20,252,198,90,234,33,201
"2011","Plymouth 008A","E01015029","Total",716,195,47,148,317,147,179,54,125
"2011","Plymouth 008B","E01015064","Total",713,319,7,312,152,58,227,18,209
"2011","Plymouth 008C","E01015065","Total",635,280,9,271,185,81,197,25,172
"2011","Plymouth 008D","E01015071","Total",696,289,21,268,189,81,233,29,204
"2011","Plymouth 009A","E01015076","Total",628,196,26,170,172,72,174,34,140
"2011","Plymouth 009B","E01015142","Total",602,189,19,170,146,49,163,24,139
"2011","Plymouth 009C","E01015143","Total",612,229,26,203,153,54,178,22,156
"2011","Plymouth 009D","E01015144","Total",613,231,62,169,220,99,202,56,146
"2011","Plymouth 009E","E01015146","Total",676,234,98,136,297,120,206,72,134
"2011","Plymouth 009F","E01015149","Total",623,303,63,240,197,69,239,46,193
"2011","Plymouth 009G","E01015150","Total",638,288,20,268,129,52,232,32,200
"2011","Plymouth 010A","E01015063","Total",634,221,38,183,188,94,201,55,146
"2011","Plymouth 010B","E01015068","Total",628,186,10,176,227,84,163,44,119
"2011","Plymouth 010C","E01015069","Total",674,253,40,213,216,82,222,42,180
"2011","Plymouth 010D","E01015095","Total",645,253,14,239,144,62,211,24,187
"2011","Plymouth 010E","E01015096","Total",612,249,32,217,186,58,201,34,167
"2011","Plymouth 011A","E01015074","Total",667,297,37,260,188,83,247,41,206
"2011","Plymouth 011B","E01015077","Total",748,308,41,267,208,85,257,48,209
"2011","Plymouth 011C","E01015079","Total",628,247,18,229,171,66,203,22,181
"2011","Plymouth 011D","E01015102","Total",763,202,20,182,206,102,159,22,137
"2011","Plymouth 011E","E01015104","Total",592,158,10,148,208,73,163,37,126
"2011","Plymouth 012A","E01015035","Total",634,186,15,171,193,73,141,30,111
"2011","Plymouth 012B","E01015037","Total",601,240,23,217,163,62,182,26,156
"2011","Plymouth 012C","E01015058","Total",559,200,64,136,240,91,172,49,123
"2011","Plymouth 012D","E01015066","Total",605,171,13,158,187,70,126,21,105
"2011","Plymouth 012E","E01015067","Total",613,246,2,244,148,39,146,21,125
"2011","Plymouth 013A","E01015072","Total",607,217,56,161,212,87,208,67,141
"2011","Plymouth 013B","E01015073","Total",642,248,39,209,165,68,246,46,200
"2011","Plymouth 013C","E01015078","Total",484,215,42,173,168,59,186,52,134
"2011","Plymouth 013D","E01015080","Total",471,204,97,107,244,96,151,63,88
"2011","Plymouth 013E","E01015106","Total",531,179,20,159,139,49,156,25,131
"2011","Plymouth 014A","E01015039","Total",461,138,27,111,144,64,124,23,101
"2011","Plymouth 014B","E01015040","Total",589,219,68,151,209,85,193,60,133
"2011","Plymouth 014C","E01015041","Total",642,167,40,127,201,108,149,30,119
"2011","Plymouth 014D","E01015075","Total",648,268,56,212,195,77,220,42,178
"2011","Plymouth 014E","E01015145","Total",668,272,174,98,430,248,176,85,91
"2011","Plymouth 015A","E01015120","Total",608,200,12,188,190,60,157,31,126
"2011","Plymouth 015B","E01015121","Total",645,278,6,272,176,47,188,31,157
"2011","Plymouth 015C","E01015123","Total",721,319,15,304,161,63,209,25,184
"2011","Plymouth 015D","E01015124","Total",692,281,7,274,180,67,207,28,179
"2011","Plymouth 015E","E01015125","Total",620,201,13,188,194,62,153,29,124
"2011","Plymouth 016A","E01015033","Total",626,217,7,210,179,60,155,25,130
"2011","Plymouth 016B","E01015034","Total",516,142,7,135,157,49,124,25,99
"2011","Plymouth 016C","E01015036","Total",655,252,8,244,182,67,193,32,161
"2011","Plymouth 016D","E01015038","Total",712,210,14,196,207,65,156,31,125
"2011","Plymouth 016E","E01015101","Total",616,228,10,218,188,71,170,27,143
"2011","Plymouth 017A","E01015098","Total",647,189,14,175,202,86,154,32,122
"2011","Plymouth 017B","E01015099","Total",634,147,10,137,185,86,147,27,120
"2011","Plymouth 017C","E01015100","Total",612,158,12,146,172,65,133,23,110
"2011","Plymouth 017D","E01015103","Total",624,145,13,132,194,66,128,26,102
"2011","Plymouth 017E","E01015105","Total",621,139,6,133,193,74,135,26,109
"2011","Plymouth 018A","E01015107","Total",593,118,15,103,235,92,125,32,93
"2011","Plymouth 018B","E01015110","Total",609,130,4,126,184,66,123,22,101
"2011","Plymouth 018C","E01015111","Total",703,126,18,108,246,116,118,31,87
"2011","Plymouth 018D","E01015119","Total",639,109,12,97,262,96,120,43,77
"2011","Plymouth 019A","E01015112","Total",559,141,11,130,190,80,128,31,97
"2011","Plymouth 019B","E01015113","Total",627,219,7,212,179,69,168,30,138
"2011","Plymouth 019C","E01015114","Total",622,202,11,191,168,60,154,25,129
"2011","Plymouth 019D","E01015118","Total",676,220,10,210,220,85,186,34,152
"2011","Plymouth 019E","E01015122","Total",642,242,10,232,206,64,188,24,164
"2011","Plymouth 020A","E01015042","Total",650,183,36,147,198,98,158,32,126
"2011","Plymouth 020B","E01015044","Total",734,254,23,231,137,62,215,27,188
"2011","Plymouth 020C","E01015167","Total",683,165,33,132,203,97,190,46,144
"2011","Plymouth 020D","E01015168","Total",814,239,46,193,208,108,204,35,169
"2011","Plymouth 020E","E01015171","Total",809,243,31,212,164,75,184,27,157
"2011","Plymouth 021A","E01015055","Total",603,232,44,188,183,65,224,54,170
"2011","Plymouth 021B","E01015056","Total",746,270,24,246,149,74,208,25,183
"2011","Plymouth 021C","E01015057","Total",657,268,56,212,212,94,216,46,170
"2011","Plymouth 021D","E01015059","Total",639,151,38,113,210,71,155,50,105
"2011","Plymouth 021E","E01015060","Total",644,206,35,171,206,89,197,52,145
"2011","Plymouth 021F","E01015176","Total",588,212,22,190,155,57,200,35,165
"2011","Plymouth 022A","E01015108","Total",762,203,18,185,303,142,171,41,130
"2011","Plymouth 022B","E01015109","Total",641,151,19,132,182,59,130,37,93
"2011","Plymouth 022C","E01015115","Total",697,383,15,368,132,37,329,26,303
"2011","Plymouth 022D","E01015116","Total",603,189,14,175,181,71,160,32,128
"2011","Plymouth 022E","E01015117","Total",592,160,17,143,179,57,141,25,116
"2011","Plymouth 023A","E01015031","Total",673,162,14,148,110,55,107,13,94
"2011","Plymouth 023B","E01015032","Total",804,265,16,249,98,51,181,21,160
"2011","Plymouth 023C","E01015049","Total",594,168,7,161,83,34,113,13,100
"2011","Plymouth 023D","E01015050","Total",665,204,5,199,55,29,114,7,107
"2011","Plymouth 023E","E01015051","Total",521,181,9,172,58,15,93,11,82
"2011","Plymouth 024A","E01015169","Total",860,321,12,309,147,54,212,25,187
"2011","Plymouth 024B","E01015170","Total",748,296,44,252,200,89,250,44,206
"2011","Plymouth 024C","E01015173","Total",760,220,25,195,182,73,177,26,151
"2011","Plymouth 024D","E01015174","Total",681,188,10,178,188,70,150,28,122
"2011","Plymouth 025A","E01015061","Total",614,184,36,148,164,83,134,30,104
"2011","Plymouth 025B","E01015062","Total",711,201,20,181,100,46,142,19,123
"2011","Plymouth 025C","E01015175","Total",660,177,14,163,160,64,146,24,122
"2011","Plymouth 025D","E01015177","Total",727,192,22,170,176,84,181,37,144
"2011","Plymouth 025E","E01015178","Total",810,217,19,198,139,66,170,23,147
"2011","Plymouth 026A","E01015043","Total",675,260,77,183,243,119,193,41,152
"2011","Plymouth 026B","E01015045","Total",748,282,76,206,208,116,212,37,175
"2011","Plymouth 026C","E01015046","Total",931,485,96,389,278,140,392,62,330
"2011","Plymouth 026D","E01015047","Total",633,235,74,161,241,120,185,43,142
"2011","Plymouth 026E","E01015048","Total",592,253,51,202,168,100,203,40,163
"2011","Plymouth 027A","E01015053","Total",581,243,23,220,74,37,131,10,121
"2011","Plymouth 027B","E01015054","Total",528,215,13,202,49,19,140,10,130
"2011","Plymouth 027C","E01015152","Total",947,527,97,430,224,123,373,50,323
"2011","Plymouth 027E","E01015156","Total",758,327,23,304,67,24,246,12,234
"2011","Plymouth 027F","E01032657","Total",754,279,18,261,55,35,146,16,130
"2011","Plymouth 027G","E01032658","Total",808,395,29,366,80,33,272,25,247
"2011","Plymouth 028A","E01015052","Total",806,293,27,266,113,49,225,27,198
"2011","Plymouth 028B","E01015179","Total",659,187,13,174,116,59,135,20,115
"2011","Plymouth 028C","E01015180","Total",871,350,56,294,206,106,273,39,234
"2011","Plymouth 028D","E01015181","Total",985,315,47,268,191,89,252,39,213
"2011","Plymouth 028E","E01015182","Total",837,289,44,245,226,90,268,62,206
"2011","Plymouth 029A","E01015151","Total",914,411,45,366,155,82,262,37,225
"2011","Plymouth 029B","E01015153","Total",903,442,61,381,204,99,332,39,293
"2011","Plymouth 029C","E01015155","Total",934,517,85,432,221,112,381,46,335
"2011","Plymouth 029D","E01015157","Total",1193,401,42,359,159,84,314,32,282
"2011","Plymouth 029E","E01015158","Total",1334,539,30,509,103,61,353,19,334
"2011","Plymouth 029F","E01015172","Total",822,218,25,193,183,88,167,31,136
"2011","Plymouth 030A","E01015126","Total",637,341,10,331,132,45,180,25,155
"2011","Plymouth 030B","E01015127","Total",616,205,8,197,159,43,157,23,134
"2011","Plymouth 030C","E01015131","Total",643,290,6,284,134,40,173,24,149
"2011","Plymouth 030D","E01015132","Total",668,298,11,287,169,60,238,24,214
"2011","Plymouth 030E","E01015133","Total",649,266,7,259,146,38,186,28,158
"2011","Plymouth 031A","E01015135","Total",630,222,13,209,181,56,178,25,153
"2011","Plymouth 031B","E01015136","Total",628,239,13,226,183,69,179,32,147
"2011","Plymouth 031C","E01015137","Total",655,193,10,183,200,66,168,25,143
"2011","Plymouth 031D","E01015138","Total",699,275,6,269,152,50,197,23,174
"2011","Plymouth 031E","E01015139","Total",613,235,24,211,169,56,172,27,145
"2011","Plymouth 031F","E01015141","Total",746,293,9,284,199,77,201,30,171
"2011","Plymouth 032A","E01015128","Total",758,320,8,312,156,56,213,19,194
"2011","Plymouth 032B","E01015129","Total",674,178,22,156,232,97,168,42,126
"2011","Plymouth 032C","E01015130","Total",616,121,8,113,276,120,143,53,90
"2011","Plymouth 032D","E01015134","Total",678,284,9,275,195,68,233,31,202
"2011","Plymouth 032E","E01015140","Total",653,301,5,296,177,91,183,36,147
"2011","Poole 001A","E01015431","Total",441,117,3,114,121,29,86,15,71
"2011","Poole 001B","E01015432","Total",745,291,14,277,177,56,212,28,184
"2011","Poole 001C","E01015433","Total",603,204,2,202,138,31,144,15,129
"2011","Poole 001D","E01015434","Total",651,275,4,271,166,39,169,22,147
"2011","Poole 002A","E01015379","Total",480,146,37,109,188,79,147,31,116
"2011","Poole 002B","E01015435","Total",659,126,33,93,217,105,129,35,94
"2011","Poole 002C","E01015436","Total",532,178,7,171,151,47,139,24,115
"2011","Poole 002D","E01015437","Total",505,155,9,146,130,35,108,21,87
"2011","Poole 003A","E01015395","Total",625,308,4,304,128,39,194,15,179
"2011","Poole 003B","E01015396","Total",643,265,5,260,150,38,171,22,149
"2011","Poole 003C","E01015397","Total",528,114,6,108,222,62,91,26,65
"2011","Poole 003D","E01015398","Total",508,134,6,128,176,41,88,18,70
"2011","Poole 003E","E01015399","Total",628,289,4,285,151,27,155,15,140
"2011","Poole 003F","E01015400","Total",621,259,6,253,173,54,155,22,133
"2011","Poole 003G","E01015401","Total",644,291,4,287,165,35,190,19,171
"2011","Poole 004A","E01015412","Total",486,108,1,107,146,51,80,16,64
"2011","Poole 004B","E01015413","Total",635,191,15,176,194,79,179,34,145
"2011","Poole 004C","E01015414","Total",625,186,24,162,183,80,148,26,122
"2011","Poole 004D","E01015415","Total",541,163,35,128,170,72,165,31,134
"2011","Poole 004E","E01015416","Total",522,142,8,134,176,66,121,31,90
"2011","Poole 005A","E01015407","Total",622,218,16,202,159,46,183,26,157
"2011","Poole 005B","E01015408","Total",503,149,11,138,171,72,125,27,98
"2011","Poole 005C","E01015409","Total",589,147,40,107,245,106,143,41,102
"2011","Poole 005D","E01015410","Total",655,121,14,107,208,89,119,26,93
"2011","Poole 005E","E01015411","Total",529,128,8,120,191,69,131,40,91
"2011","Poole 006A","E01015417","Total",621,228,20,208,167,68,182,33,149
"2011","Poole 006B","E01015418","Total",694,205,9,196,183,83,187,25,162
"2011","Poole 006C","E01015419","Total",782,256,7,249,202,100,194,30,164
"2011","Poole 006D","E01015420","Total",646,237,31,206,207,71,207,44,163
"2011","Poole 006E","E01015421","Total",629,280,21,259,126,44,190,25,165
"2011","Poole 006F","E01015422","Total",614,90,13,77,208,91,98,30,68
"2011","Poole 007A","E01015380","Total",753,316,18,298,139,52,212,29,183
"2011","Poole 007B","E01015381","Total",652,252,34,218,192,82,229,37,192
"2011","Poole 007C","E01015382","Total",768,185,62,123,270,121,180,48,132
"2011","Poole 007D","E01015383","Total",685,282,9,273,92,29,200,11,189
"2011","Poole 007E","E01015384","Total",493,137,60,77,252,102,151,62,89
"2011","Poole 007F","E01015385","Total",788,335,31,304,189,79,285,36,249
"2011","Poole 008A","E01015438","Total",622,166,9,157,174,76,148,25,123
"2011","Poole 008B","E01015439","Total",755,265,40,225,212,83,218,39,179
"2011","Poole 008C","E01015441","Total",836,305,37,268,220,103,245,39,206
"2011","Poole 008D","E01015442","Total",799,314,36,278,267,101,268,47,221
"2011","Poole 008E","E01015443","Total",759,292,52,240,214,109,240,45,195
"2011","Poole 008F","E01015444","Total",687,194,24,170,223,95,170,30,140
"2011","Poole 009A","E01015386","Total",843,322,33,289,173,75,243,28,215
"2011","Poole 009B","E01015387","Total",666,237,19,218,156,65,172,29,143
"2011","Poole 009C","E01015388","Total",487,152,11,141,151,49,115,20,95
"2011","Poole 009D","E01015389","Total",675,172,9,163,138,60,129,14,115
"2011","Poole 010A","E01015390","Total",753,225,37,188,211,114,184,35,149
"2011","Poole 010B","E01015391","Total",619,162,7,155,153,61,144,23,121
"2011","Poole 010C","E01015392","Total",647,208,14,194,165,82,185,23,162
"2011","Poole 010D","E01015393","Total",520,131,18,113,162,68,140,30,110
"2011","Poole 010E","E01015394","Total",634,143,15,128,215,93,128,31,97
"2011","Poole 011A","E01015440","Total",842,269,31,238,237,111,203,36,167
"2011","Poole 011B","E01015447","Total",647,215,9,206,170,53,177,25,152
"2011","Poole 011C","E01015449","Total",707,259,33,226,222,85,212,40,172
"2011","Poole 011D","E01015456","Total",780,289,30,259,191,82,237,32,205
"2011","Poole 011E","E01015457","Total",805,332,15,317,141,61,200,18,182
"2011","Poole 012A","E01015445","Total",779,248,11,237,232,76,187,19,168
"2011","Poole 012B","E01015446","Total",646,233,15,218,193,60,197,27,170
"2011","Poole 012C","E01015448","Total",627,199,19,180,187,67,144,30,114
"2011","Poole 012D","E01015450","Total",669,214,22,192,217,67,182,44,138
"2011","Poole 012E","E01015451","Total",633,251,5,246,153,43,172,25,147
"2011","Poole 013A","E01015458","Total",651,281,5,276,159,59,131,19,112
"2011","Poole 013B","E01015460","Total",720,180,23,157,244,117,163,38,125
"2011","Poole 013C","E01015461","Total",642,155,16,139,211,83,129,20,109
"2011","Poole 013D","E01015462","Total",682,150,13,137,208,93,132,24,108
"2011","Poole 013E","E01015463","Total",733,236,6,230,173,76,164,19,145
"2011","Poole 013F","E01015464","Total",649,190,10,180,202,63,113,19,94
"2011","Poole 014A","E01015427","Total",647,142,29,113,256,135,148,41,107
"2011","Poole 014B","E01015428","Total",965,357,25,332,238,91,258,38,220
"2011","Poole 014C","E01015429","Total",675,244,41,203,229,86,206,45,161
"2011","Poole 014D","E01015430","Total",574,219,67,152,232,94,176,49,127
"2011","Poole 015A","E01015465","Total",770,260,27,233,206,96,197,27,170
"2011","Poole 015B","E01015466","Total",734,266,12,254,167,67,210,23,187
"2011","Poole 015D","E01015468","Total",933,423,22,401,194,97,291,22,269
"2011","Poole 015F","E01032659","Total",619,248,22,226,107,62,201,18,183
"2011","Poole 015G","E01032660","Total",657,159,27,132,170,102,130,32,98
"2011","Poole 015H","E01032661","Total",679,228,10,218,109,57,147,13,134
"2011","Poole 015I","E01032662","Total",633,306,27,279,97,57,250,24,226
"2011","Poole 016A","E01015423","Total",975,351,40,311,222,102,283,26,257
"2011","Poole 016B","E01015424","Total",610,199,27,172,160,54,152,20,132
"2011","Poole 016C","E01015425","Total",551,204,20,184,142,50,154,26,128
"2011","Poole 016D","E01015426","Total",550,203,29,174,148,50,180,32,148
"2011","Poole 017A","E01015452","Total",826,374,10,364,194,63,239,22,217
"2011","Poole 017B","E01015453","Total",980,292,21,271,189,97,209,22,187
"2011","Poole 017C","E01015454","Total",874,285,22,263,203,90,225,32,193
"2011","Poole 017D","E01015455","Total",906,392,14,378,203,75,226,17,209
"2011","Poole 017E","E01015459","Total",800,364,13,351,174,73,189,18,171
"2011","Poole 018A","E01015402","Total",795,368,14,354,122,53,213,11,202
"2011","Poole 018B","E01015403","Total",1095,708,8,700,48,28,353,5,348
"2011","Poole 018C","E01015404","Total",855,467,19,448,116,42,231,12,219
"2011","Poole 018D","E01015405","Total",766,300,8,292,133,55,136,19,117
"2011","Poole 018E","E01015406","Total",902,394,26,368,129,58,173,16,157
"2011","South Gloucestershire 001A","E01014985","Total",641,203,5,198,159,37,113,18,95
"2011","South Gloucestershire 001B","E01014986","Total",663,290,26,264,183,53,201,22,179
"2011","South Gloucestershire 001C","E01014987","Total",514,168,7,161,151,52,107,19,88
"2011","South Gloucestershire 001D","E01014988","Total",543,182,1,181,167,47,107,20,87
"2011","South Gloucestershire 001E","E01014989","Total",441,126,4,122,111,30,89,18,71
"2011","South Gloucestershire 002A","E01014990","Total",640,260,4,256,147,41,181,18,163
"2011","South Gloucestershire 002B","E01014991","Total",983,408,37,371,286,115,344,56,288
"2011","South Gloucestershire 002C","E01014992","Total",582,159,13,146,189,57,131,29,102
"2011","South Gloucestershire 002D","E01014993","Total",551,132,4,128,182,49,113,28,85
"2011","South Gloucestershire 003A","E01014884","Total",589,128,16,112,217,66,130,31,99
"2011","South Gloucestershire 003B","E01014885","Total",717,169,10,159,256,68,142,25,117
"2011","South Gloucestershire 003C","E01014929","Total",786,231,23,208,240,78,179,35,144
"2011","South Gloucestershire 003D","E01014930","Total",709,165,19,146,301,66,154,46,108
"2011","South Gloucestershire 004A","E01014863","Total",660,294,8,286,147,42,201,29,172
"2011","South Gloucestershire 004B","E01014864","Total",632,222,4,218,120,33,160,19,141
"2011","South Gloucestershire 004C","E01014962","Total",666,175,4,171,176,44,134,28,106
"2011","South Gloucestershire 004D","E01014963","Total",768,239,5,234,232,73,174,24,150
"2011","South Gloucestershire 005A","E01014861","Total",747,219,19,200,216,90,177,32,145
"2011","South Gloucestershire 005B","E01014862","Total",1065,283,37,246,385,169,216,59,157
"2011","South Gloucestershire 005C","E01014953","Total",807,187,12,175,284,98,152,29,123
"2011","South Gloucestershire 005D","E01014954","Total",700,211,28,183,182,79,160,25,135
"2011","South Gloucestershire 006A","E01015014","Total",537,103,4,99,201,56,91,21,70
"2011","South Gloucestershire 006B","E01015015","Total",575,65,11,54,193,67,103,33,70
"2011","South Gloucestershire 006C","E01015016","Total",455,139,4,135,149,38,87,8,79
"2011","South Gloucestershire 006D","E01015017","Total",585,198,12,186,154,49,163,19,144
"2011","South Gloucestershire 006E","E01015018","Total",571,162,15,147,191,50,142,38,104
"2011","South Gloucestershire 007A","E01015019","Total",758,203,45,158,260,100,187,47,140
"2011","South Gloucestershire 007B","E01015020","Total",650,213,51,162,217,98,170,39,131
"2011","South Gloucestershire 007C","E01015021","Total",636,162,4,158,204,65,128,30,98
"2011","South Gloucestershire 007D","E01015022","Total",675,134,15,119,204,83,124,25,99
"2011","South Gloucestershire 008A","E01014886","Total",836,344,20,324,187,61,268,33,235
"2011","South Gloucestershire 008B","E01014887","Total",614,182,6,176,140,40,126,18,108
"2011","South Gloucestershire 008C","E01014888","Total",618,250,2,248,139,38,160,16,144
"2011","South Gloucestershire 008D","E01014889","Total",613,152,6,146,197,75,151,33,118
"2011","South Gloucestershire 009A","E01014872","Total",723,52,15,37,220,115,90,28,62
"2011","South Gloucestershire 009B","E01014874","Total",601,62,10,52,238,93,80,19,61
"2011","South Gloucestershire 009C","E01014876","Total",746,75,27,48,291,157,93,28,65
"2011","South Gloucestershire 009D","E01014877","Total",601,64,9,55,265,108,85,36,49
"2011","South Gloucestershire 009E","E01014879","Total",757,181,6,175,217,80,164,30,134
"2011","South Gloucestershire 009F","E01014881","Total",717,44,13,31,343,136,90,45,45
"2011","South Gloucestershire 010A","E01015009","Total",616,252,9,243,153,49,193,23,170
"2011","South Gloucestershire 010B","E01015010","Total",527,137,16,121,173,77,122,24,98
"2011","South Gloucestershire 010C","E01015011","Total",659,224,28,196,165,58,201,37,164
"2011","South Gloucestershire 010D","E01015012","Total",526,213,5,208,115,41,156,23,133
"2011","South Gloucestershire 010E","E01015013","Total",514,95,16,79,209,76,113,30,83
"2011","South Gloucestershire 011A","E01014946","Total",639,201,30,171,201,85,167,38,129
"2011","South Gloucestershire 011B","E01014947","Total",632,293,6,287,117,29,176,25,151
"2011","South Gloucestershire 011C","E01014948","Total",804,313,55,258,230,121,264,47,217
"2011","South Gloucestershire 011D","E01014949","Total",544,99,23,76,193,85,113,28,85
"2011","South Gloucestershire 011E","E01014950","Total",601,160,15,145,181,84,130,25,105
"2011","South Gloucestershire 011F","E01014951","Total",586,156,28,128,187,89,171,35,136
"2011","South Gloucestershire 011G","E01014952","Total",708,233,13,220,170,55,185,30,155
"2011","South Gloucestershire 012A","E01014873","Total",558,74,7,67,217,71,83,31,52
"2011","South Gloucestershire 012B","E01014875","Total",794,89,27,62,273,154,95,30,65
"2011","South Gloucestershire 012C","E01014878","Total",853,95,18,77,345,145,95,35,60
"2011","South Gloucestershire 012D","E01014880","Total",715,71,21,50,327,143,97,40,57
"2011","South Gloucestershire 012E","E01014882","Total",834,133,54,79,351,172,138,61,77
"2011","South Gloucestershire 012F","E01014883","Total",535,99,8,91,184,86,88,19,69
"2011","South Gloucestershire 013A","E01014911","Total",548,209,6,203,145,46,122,13,109
"2011","South Gloucestershire 013B","E01014912","Total",735,213,6,207,229,79,148,28,120
"2011","South Gloucestershire 013C","E01014913","Total",655,216,9,207,206,59,125,18,107
"2011","South Gloucestershire 013D","E01014914","Total",639,220,29,191,234,71,178,40,138
"2011","South Gloucestershire 014A","E01014892","Total",679,165,31,134,243,117,168,32,136
"2011","South Gloucestershire 014B","E01014893","Total",620,160,16,144,199,85,143,33,110
"2011","South Gloucestershire 014C","E01014894","Total",490,93,13,80,182,70,97,25,72
"2011","South Gloucestershire 014D","E01014895","Total",526,83,13,70,212,73,82,25,57
"2011","South Gloucestershire 014E","E01014896","Total",478,73,13,60,212,89,105,35,70
"2011","South Gloucestershire 015A","E01014979","Total",667,157,10,147,191,75,148,27,121
"2011","South Gloucestershire 015B","E01014980","Total",641,143,8,135,207,59,147,33,114
"2011","South Gloucestershire 015C","E01014982","Total",632,158,12,146,198,95,147,29,118
"2011","South Gloucestershire 015D","E01014983","Total",648,202,31,171,208,78,169,30,139
"2011","South Gloucestershire 015E","E01014984","Total",608,205,16,189,174,69,166,27,139
"2011","South Gloucestershire 016A","E01014998","Total",643,260,12,248,177,51,190,25,165
"2011","South Gloucestershire 016B","E01014999","Total",629,241,4,237,193,57,161,23,138
"2011","South Gloucestershire 016C","E01015000","Total",654,250,23,227,183,51,160,22,138
"2011","South Gloucestershire 016D","E01015001","Total",628,212,11,201,218,69,147,25,122
"2011","South Gloucestershire 017A","E01014978","Total",589,111,15,96,230,96,108,27,81
"2011","South Gloucestershire 017B","E01014981","Total",1168,204,47,157,418,204,204,52,152
"2011","South Gloucestershire 017C","E01014996","Total",699,282,8,274,151,62,163,20,143
"2011","South Gloucestershire 017E","E01033331","Total",588,62,19,43,137,79,56,9,47
"2011","South Gloucestershire 017F","E01033333","Total",552,151,15,136,148,64,109,20,89
"2011","South Gloucestershire 018A","E01014904","Total",648,237,33,204,166,79,174,33,141
"2011","South Gloucestershire 018B","E01014905","Total",663,176,7,169,175,80,149,23,126
"2011","South Gloucestershire 018C","E01014906","Total",742,325,40,285,197,73,259,41,218
"2011","South Gloucestershire 018D","E01014907","Total",685,243,11,232,140,60,192,21,171
"2011","South Gloucestershire 018E","E01014908","Total",559,184,6,178,139,47,119,18,101
"2011","South Gloucestershire 018F","E01014909","Total",595,158,18,140,151,70,137,28,109
"2011","South Gloucestershire 018G","E01014910","Total",622,205,27,178,182,81,135,25,110
"2011","South Gloucestershire 019A","E01014867","Total",523,197,17,180,124,31,147,23,124
"2011","South Gloucestershire 019B","E01014868","Total",630,122,15,107,197,67,107,23,84
"2011","South Gloucestershire 019D","E01014994","Total",734,279,8,271,158,40,225,39,186
"2011","South Gloucestershire 019E","E01014995","Total",689,242,1,241,172,49,173,19,154
"2011","South Gloucestershire 019F","E01033338","Total",630,93,17,76,234,91,101,36,65
"2011","South Gloucestershire 019G","E01033339","Total",607,162,37,125,208,89,141,38,103
"2011","South Gloucestershire 020A","E01014901","Total",660,197,5,192,225,81,142,17,125
"2011","South Gloucestershire 020B","E01014902","Total",537,175,3,172,166,57,105,18,87
"2011","South Gloucestershire 020C","E01014903","Total",641,261,2,259,168,48,169,21,148
"2011","South Gloucestershire 020D","E01014965","Total",607,223,4,219,165,60,163,20,143
"2011","South Gloucestershire 021A","E01014964","Total",667,145,7,138,251,102,117,25,92
"2011","South Gloucestershire 021B","E01014966","Total",640,80,8,72,272,130,84,23,61
"2011","South Gloucestershire 021C","E01014967","Total",811,128,12,116,334,143,122,36,86
"2011","South Gloucestershire 021D","E01014969","Total",634,173,5,168,214,78,141,27,114
"2011","South Gloucestershire 021F","E01033334","Total",639,46,9,37,265,151,67,23,44
"2011","South Gloucestershire 021G","E01033336","Total",607,74,10,64,332,140,90,29,61
"2011","South Gloucestershire 022A","E01014897","Total",594,208,7,201,190,68,138,18,120
"2011","South Gloucestershire 022B","E01014898","Total",720,263,7,256,198,87,219,31,188
"2011","South Gloucestershire 022C","E01014899","Total",744,253,9,244,181,67,202,22,180
"2011","South Gloucestershire 022D","E01014900","Total",631,216,6,210,168,63,166,23,143
"2011","South Gloucestershire 023A","E01014959","Total",535,160,13,147,164,56,137,23,114
"2011","South Gloucestershire 023B","E01014960","Total",685,220,28,192,198,80,196,42,154
"2011","South Gloucestershire 023C","E01014961","Total",668,254,45,209,231,88,215,55,160
"2011","South Gloucestershire 023D","E01014968","Total",747,325,42,283,227,90,263,46,217
"2011","South Gloucestershire 024A","E01014865","Total",784,237,41,196,237,84,197,35,162
"2011","South Gloucestershire 024B","E01014869","Total",719,210,16,194,228,81,153,25,128
"2011","South Gloucestershire 024C","E01014870","Total",635,174,18,156,178,51,137,31,106
"2011","South Gloucestershire 024D","E01014871","Total",518,193,11,182,137,43,139,16,123
"2011","South Gloucestershire 024E","E01014890","Total",817,203,16,187,243,89,171,27,144
"2011","South Gloucestershire 024F","E01014891","Total",688,179,10,169,174,60,137,17,120
"2011","South Gloucestershire 025A","E01014955","Total",557,188,9,179,139,54,132,17,115
"2011","South Gloucestershire 025B","E01014956","Total",658,230,12,218,175,46,162,21,141
"2011","South Gloucestershire 025C","E01014957","Total",509,150,9,141,153,59,119,23,96
"2011","South Gloucestershire 025D","E01014974","Total",713,264,11,253,174,84,233,23,210
"2011","South Gloucestershire 025E","E01014977","Total",696,324,51,273,156,74,248,26,222
"2011","South Gloucestershire 026A","E01014922","Total",547,150,13,137,179,66,124,27,97
"2011","South Gloucestershire 026B","E01014923","Total",651,216,27,189,207,89,168,27,141
"2011","South Gloucestershire 026C","E01014924","Total",792,215,29,186,207,101,173,24,149
"2011","South Gloucestershire 026D","E01014973","Total",638,246,24,222,179,84,201,37,164
"2011","South Gloucestershire 026E","E01014975","Total",706,195,13,182,181,74,150,26,124
"2011","South Gloucestershire 026F","E01014976","Total",660,211,20,191,169,69,186,25,161
"2011","South Gloucestershire 027A","E01014925","Total",625,193,19,174,183,76,159,24,135
"2011","South Gloucestershire 027B","E01014926","Total",686,273,62,211,236,93,201,56,145
"2011","South Gloucestershire 027C","E01014927","Total",826,325,22,303,173,82,243,25,218
"2011","South Gloucestershire 027D","E01014928","Total",644,243,35,208,191,74,204,39,165
"2011","South Gloucestershire 027E","E01014958","Total",483,169,38,131,172,82,137,29,108
"2011","South Gloucestershire 028A","E01014915","Total",651,217,16,201,202,74,196,37,159
"2011","South Gloucestershire 028B","E01015003","Total",657,198,6,192,184,80,150,27,123
"2011","South Gloucestershire 028C","E01015005","Total",850,212,42,170,285,155,174,44,130
"2011","South Gloucestershire 028D","E01015007","Total",794,293,41,252,205,103,196,25,171
"2011","South Gloucestershire 028E","E01015008","Total",663,220,29,191,206,77,172,26,146
"2011","South Gloucestershire 029A","E01014943","Total",815,114,14,100,243,106,139,35,104
"2011","South Gloucestershire 029B","E01014944","Total",710,119,14,105,296,118,103,25,78
"2011","South Gloucestershire 029C","E01014972","Total",701,201,4,197,218,75,173,25,148
"2011","South Gloucestershire 029D","E01015002","Total",643,157,22,135,203,75,138,32,106
"2011","South Gloucestershire 029E","E01015004","Total",716,160,24,136,212,94,144,42,102
"2011","South Gloucestershire 029F","E01015006","Total",665,237,19,218,188,70,189,42,147
"2011","South Gloucestershire 030A","E01014936","Total",554,152,23,129,195,61,125,29,96
"2011","South Gloucestershire 030B","E01014938","Total",624,143,30,113,222,75,129,33,96
"2011","South Gloucestershire 030C","E01014939","Total",498,112,19,93,161,59,109,24,85
"2011","South Gloucestershire 030D","E01014940","Total",501,92,9,83,165,41,86,23,63
"2011","South Gloucestershire 030E","E01014941","Total",645,262,53,209,210,80,213,44,169
"2011","South Gloucestershire 030F","E01014942","Total",654,263,38,225,192,77,213,34,179
"2011","South Gloucestershire 030G","E01014945","Total",687,214,22,192,207,80,176,29,147
"2011","South Gloucestershire 031A","E01014916","Total",685,241,17,224,188,74,198,25,173
"2011","South Gloucestershire 031B","E01014917","Total",616,226,18,208,167,50,166,22,144
"2011","South Gloucestershire 031C","E01014918","Total",644,251,7,244,146,42,182,25,157
"2011","South Gloucestershire 031D","E01014919","Total",501,201,6,195,138,40,117,15,102
"2011","South Gloucestershire 031E","E01014920","Total",532,169,10,159,139,38,121,17,104
"2011","South Gloucestershire 031F","E01014921","Total",553,178,12,166,166,47,117,18,99
"2011","South Gloucestershire 032A","E01014866","Total",646,204,10,194,174,57,142,19,123
"2011","South Gloucestershire 032B","E01014931","Total",613,220,10,210,127,42,165,14,151
"2011","South Gloucestershire 032C","E01014932","Total",728,234,8,226,172,63,157,18,139
"2011","South Gloucestershire 032D","E01014933","Total",623,122,6,116,171,64,111,23,88
"2011","South Gloucestershire 032E","E01014934","Total",502,174,6,168,127,36,122,15,107
"2011","South Gloucestershire 032F","E01014935","Total",664,151,5,146,185,67,132,28,104
"2011","South Gloucestershire 032G","E01014937","Total",524,175,6,169,147,51,133,16,117
"2011","Swindon 001A","E01015519","Total",691,301,20,281,158,58,232,25,207
"2011","Swindon 001B","E01015520","Total",549,230,14,216,117,40,162,17,145
"2011","Swindon 001C","E01015521","Total",604,189,11,178,159,36,133,19,114
"2011","Swindon 001D","E01015522","Total",643,179,17,162,179,65,143,20,123
"2011","Swindon 001E","E01015523","Total",655,226,7,219,156,40,165,21,144
"2011","Swindon 001F","E01015524","Total",465,114,9,105,171,58,103,30,73
"2011","Swindon 003A","E01015543","Total",605,262,43,219,162,65,194,32,162
"2011","Swindon 003B","E01015544","Total",743,345,77,268,249,115,245,46,199
"2011","Swindon 003C","E01015545","Total",698,308,88,220,269,143,223,43,180
"2011","Swindon 003D","E01015546","Total",699,330,121,209,301,139,244,79,165
"2011","Swindon 004A","E01015513","Total",672,102,18,84,234,95,97,22,75
"2011","Swindon 004B","E01015514","Total",523,200,4,196,139,45,144,24,120
"2011","Swindon 004C","E01015515","Total",580,116,8,108,182,61,105,17,88
"2011","Swindon 004D","E01015516","Total",624,275,10,265,123,40,199,14,185
"2011","Swindon 004E","E01015517","Total",669,285,7,278,124,47,198,21,177
"2011","Swindon 005A","E01015555","Total",668,275,16,259,147,48,211,23,188
"2011","Swindon 005B","E01015556","Total",669,184,18,166,197,75,143,21,122
"2011","Swindon 005C","E01015557","Total",627,155,6,149,147,43,141,18,123
"2011","Swindon 005D","E01015558","Total",640,292,45,247,208,77,238,49,189
"2011","Swindon 005E","E01015559","Total",638,238,12,226,148,49,168,23,145
"2011","Swindon 005F","E01015560","Total",669,186,17,169,207,66,149,26,123
"2011","Swindon 006A","E01015526","Total",607,111,22,89,198,93,94,28,66
"2011","Swindon 006B","E01015528","Total",794,319,57,262,253,110,282,62,220
"2011","Swindon 006C","E01015529","Total",676,265,23,242,158,57,203,31,172
"2011","Swindon 006D","E01015530","Total",698,296,35,261,197,75,264,38,226
"2011","Swindon 007A","E01015506","Total",633,239,49,190,199,70,208,39,169
"2011","Swindon 007B","E01015507","Total",644,276,78,198,263,113,232,62,170
"2011","Swindon 007C","E01015527","Total",682,242,44,198,241,90,197,40,157
"2011","Swindon 007D","E01015580","Total",637,230,33,197,231,78,202,51,151
"2011","Swindon 008A","E01015473","Total",674,200,10,190,185,60,151,25,126
"2011","Swindon 008B","E01015474","Total",649,180,16,164,193,63,157,32,125
"2011","Swindon 008C","E01015547","Total",594,154,14,140,198,61,113,30,83
"2011","Swindon 008D","E01015548","Total",619,140,8,132,205,64,121,25,96
"2011","Swindon 009A","E01015549","Total",702,202,17,185,211,72,153,33,120
"2011","Swindon 009B","E01015550","Total",876,294,12,282,164,61,193,22,171
"2011","Swindon 009C","E01015551","Total",619,201,4,197,168,57,152,14,138
"2011","Swindon 009D","E01015552","Total",814,181,20,161,293,105,145,36,109
"2011","Swindon 009E","E01015553","Total",670,128,12,116,219,80,119,28,91
"2011","Swindon 009F","E01015554","Total",640,293,10,283,157,55,199,25,174
"2011","Swindon 010A","E01015508","Total",614,243,35,208,190,58,222,38,184
"2011","Swindon 010B","E01015509","Total",705,192,33,159,208,93,167,31,136
"2011","Swindon 010C","E01015510","Total",844,275,28,247,210,93,227,40,187
"2011","Swindon 010D","E01015511","Total",709,192,20,172,188,98,164,26,138
"2011","Swindon 011A","E01015562","Total",599,82,28,54,280,109,103,32,71
"2011","Swindon 011B","E01015563","Total",601,68,5,63,256,77,66,23,43
"2011","Swindon 011C","E01015565","Total",646,142,23,119,237,89,142,49,93
"2011","Swindon 011D","E01015566","Total",679,98,23,75,233,98,98,28,70
"2011","Swindon 012B","E01015578","Total",748,218,27,191,191,88,204,40,164
"2011","Swindon 012C","E01015579","Total",696,161,19,142,209,100,146,25,121
"2011","Swindon 012D","E01015581","Total",617,181,10,171,179,61,158,21,137
"2011","Swindon 012E","E01015582","Total",832,214,15,199,241,124,157,26,131
"2011","Swindon 012F","E01032708","Total",769,75,16,59,198,123,94,27,67
"2011","Swindon 012G","E01032716","Total",644,147,22,125,187,97,133,29,104
"2011","Swindon 013A","E01015481","Total",758,201,18,183,220,82,152,23,129
"2011","Swindon 013B","E01015482","Total",512,145,4,141,138,41,97,13,84
"2011","Swindon 013C","E01015483","Total",648,282,3,279,122,39,183,18,165
"2011","Swindon 013D","E01015484","Total",621,238,7,231,132,38,172,18,154
"2011","Swindon 013E","E01015485","Total",654,110,6,104,181,68,97,19,78
"2011","Swindon 013F","E01015486","Total",621,207,20,187,160,67,127,13,114
"2011","Swindon 014A","E01015561","Total",650,131,11,120,182,72,111,19,92
"2011","Swindon 014B","E01015564","Total",607,102,10,92,208,73,102,28,74
"2011","Swindon 014C","E01015567","Total",673,120,11,109,190,71,140,27,113
"2011","Swindon 014D","E01015568","Total",622,134,16,118,171,68,128,14,114
"2011","Swindon 015A","E01015475","Total",683,150,22,128,272,132,154,40,114
"2011","Swindon 015B","E01015476","Total",1198,372,39,333,217,127,288,21,267
"2011","Swindon 015C","E01015477","Total",713,192,20,172,194,93,158,28,130
"2011","Swindon 015D","E01015480","Total",751,147,36,111,302,151,153,49,104
"2011","Swindon 016A","E01015538","Total",841,391,61,330,247,112,292,44,248
"2011","Swindon 016B","E01015572","Total",523,195,45,150,176,65,162,36,126
"2011","Swindon 016C","E01015573","Total",936,397,82,315,324,136,305,53,252
"2011","Swindon 016D","E01015575","Total",489,221,61,160,166,69,178,34,144
"2011","Swindon 017A","E01015479","Total",661,132,15,117,202,89,117,24,93
"2011","Swindon 017B","E01015493","Total",712,153,14,139,219,95,142,30,112
"2011","Swindon 017C","E01015574","Total",644,180,20,160,209,83,158,39,119
"2011","Swindon 017D","E01015576","Total",681,298,12,286,164,51,205,24,181
"2011","Swindon 018A","E01015499","Total",463,49,3,46,165,47,66,20,46
"2011","Swindon 018B","E01015500","Total",653,126,28,98,215,91,133,33,100
"2011","Swindon 018C","E01015504","Total",516,67,11,56,219,72,90,32,58
"2011","Swindon 018D","E01015505","Total",668,127,39,88,236,83,144,49,95
"2011","Swindon 019A","E01015494","Total",811,136,19,117,181,91,107,19,88
"2011","Swindon 019C","E01015496","Total",816,140,17,123,164,93,143,23,120
"2011","Swindon 019D","E01015497","Total",711,143,9,134,180,88,135,17,118
"2011","Swindon 019E","E01032714","Total",670,124,14,110,109,74,94,14,80
"2011","Swindon 019F","E01032715","Total",540,133,12,121,79,42,124,9,115
"2011","Swindon 020A","E01015537","Total",707,267,81,186,266,123,237,56,181
"2011","Swindon 020B","E01015539","Total",630,228,65,163,224,101,194,36,158
"2011","Swindon 020C","E01015540","Total",736,294,63,231,252,106,226,50,176
"2011","Swindon 020D","E01015541","Total",749,312,85,227,272,111,241,61,180
"2011","Swindon 020E","E01015542","Total",623,273,58,215,212,78,220,42,178
"2011","Swindon 021A","E01015478","Total",657,158,14,144,185,72,131,20,111
"2011","Swindon 021B","E01015498","Total",783,139,13,126,226,94,136,34,102
"2011","Swindon 021D","E01015532","Total",636,124,10,114,177,83,104,12,92
"2011","Swindon 021E","E01032706","Total",710,63,20,43,156,94,55,13,42
"2011","Swindon 021F","E01032707","Total",736,165,6,159,228,96,140,25,115
"2011","Swindon 022A","E01015501","Total",523,96,10,86,176,48,106,26,80
"2011","Swindon 022B","E01015502","Total",640,195,41,154,219,93,182,45,137
"2011","Swindon 022C","E01015503","Total",613,252,30,222,165,74,215,29,186
"2011","Swindon 022D","E01015569","Total",643,215,49,166,194,87,201,47,154
"2011","Swindon 022E","E01015570","Total",771,349,48,301,181,70,260,37,223
"2011","Swindon 022F","E01015571","Total",648,201,29,172,185,68,159,27,132
"2011","Swindon 023A","E01015487","Total",608,175,17,158,186,58,117,31,86
"2011","Swindon 023B","E01015488","Total",654,237,19,218,165,66,202,27,175
"2011","Swindon 023C","E01015489","Total",549,151,12,139,164,56,121,29,92
"2011","Swindon 023D","E01015490","Total",543,113,18,95,157,64,95,16,79
"2011","Swindon 023E","E01015491","Total",721,287,30,257,179,86,243,28,215
"2011","Swindon 023F","E01015492","Total",540,132,34,98,199,76,119,26,93
"2011","Swindon 024A","E01015533","Total",673,284,5,279,152,47,193,19,174
"2011","Swindon 024B","E01015534","Total",1046,369,9,360,170,70,270,22,248
"2011","Swindon 024C","E01015535","Total",618,204,2,202,168,64,128,19,109
"2011","Swindon 024D","E01015536","Total",1012,311,43,268,314,146,216,46,170
"2011","Swindon 025A","E01015583","Total",860,164,25,139,337,124,161,50,111
"2011","Swindon 025B","E01015584","Total",646,286,4,282,126,28,197,18,179
"2011","Swindon 025C","E01015585","Total",661,163,15,148,218,73,137,32,105
"2011","Swindon 025D","E01015586","Total",631,256,9,247,139,45,182,16,166
"2011","Swindon 025E","E01015587","Total",865,371,22,349,196,61,301,34,267
"2011","Swindon 025F","E01015588","Total",740,248,13,235,225,71,179,35,144
"2011","Swindon 026A","E01015525","Total",664,104,9,95,222,103,96,23,73
"2011","Swindon 026B","E01032700","Total",583,42,9,33,294,173,58,30,28
"2011","Swindon 026C","E01032703","Total",555,42,12,30,259,140,58,24,34
"2011","Swindon 026D","E01032705","Total",582,57,25,32,267,139,63,30,33
"2011","Swindon 026E","E01032709","Total",545,56,22,34,243,135,59,16,43
"2011","Swindon 026F","E01032713","Total",622,35,13,22,314,162,60,29,31
"2011","Swindon 027A","E01032701","Total",543,47,14,33,183,118,57,18,39
"2011","Swindon 027B","E01032702","Total",573,78,9,69,237,141,63,16,47
"2011","Swindon 027C","E01032704","Total",584,67,26,41,246,146,66,34,32
"2011","Swindon 027D","E01032711","Total",603,41,17,24,195,118,48,15,33
"2011","Swindon 027E","E01032712","Total",589,71,34,37,231,140,72,27,45
"2011","Swindon 028A","E01015471","Total",675,103,8,95,257,109,98,29,69
"2011","Swindon 028B","E01015472","Total",1088,136,38,98,452,204,165,64,101
"2011","Swindon 028C","E01015512","Total",612,59,5,54,286,123,62,20,42
"2011","Swindon 028D","E01015518","Total",537,56,16,40,273,110,78,28,50
"2011","Swindon 028E","E01032710","Total",525,62,5,57,212,92,70,25,45
"2011","Torbay 001A","E01015262","Total",525,204,46,158,176,46,172,45,127
"2011","Torbay 001B","E01015263","Total",624,278,82,196,237,117,195,48,147
"2011","Torbay 001C","E01015264","Total",618,287,14,273,114,51,191,25,166
"2011","Torbay 001D","E01015265","Total",653,299,48,251,141,47,231,40,191
"2011","Torbay 001E","E01015266","Total",618,301,53,248,217,72,238,62,176
"2011","Torbay 002A","E01015236","Total",647,257,22,235,150,56,177,22,155
"2011","Torbay 002B","E01015237","Total",519,165,28,137,208,68,140,35,105
"2011","Torbay 002C","E01015238","Total",611,225,30,195,171,74,157,26,131
"2011","Torbay 002D","E01015239","Total",791,439,24,415,141,54,293,20,273
"2011","Torbay 003A","E01015249","Total",619,265,31,234,200,83,250,47,203
"2011","Torbay 003B","E01015250","Total",608,160,22,138,218,96,144,46,98
"2011","Torbay 003C","E01015251","Total",461,133,7,126,143,41,118,21,97
"2011","Torbay 003D","E01015252","Total",1001,258,67,191,386,191,217,55,162
"2011","Torbay 003E","E01015253","Total",645,125,30,95,264,109,114,32,82
"2011","Torbay 003F","E01015254","Total",610,266,14,252,137,45,178,28,150
"2011","Torbay 004A","E01015257","Total",566,242,63,179,186,72,187,57,130
"2011","Torbay 004B","E01015258","Total",885,283,45,238,222,78,212,40,172
"2011","Torbay 004C","E01015259","Total",585,180,32,148,205,76,165,39,126
"2011","Torbay 004D","E01015260","Total",783,352,38,314,162,71,278,28,250
"2011","Torbay 005A","E01015240","Total",790,444,20,424,99,44,311,15,296
"2011","Torbay 005B","E01015241","Total",627,242,21,221,182,76,218,40,178
"2011","Torbay 005C","E01015242","Total",518,192,29,163,186,52,158,38,120
"2011","Torbay 005D","E01015243","Total",594,260,13,247,120,41,175,22,153
"2011","Torbay 006A","E01015214","Total",630,219,59,160,190,85,182,45,137
"2011","Torbay 006B","E01015215","Total",608,189,16,173,207,74,177,34,143
"2011","Torbay 006C","E01015216","Total",625,204,40,164,201,82,168,35,133
"2011","Torbay 006D","E01015218","Total",586,210,28,182,167,69,184,39,145
"2011","Torbay 008A","E01015217","Total",778,345,60,285,182,76,280,45,235
"2011","Torbay 008B","E01015255","Total",823,336,44,292,134,80,248,21,227
"2011","Torbay 008C","E01015256","Total",1034,428,38,390,137,66,331,30,301
"2011","Torbay 008D","E01015261","Total",918,411,48,363,201,93,319,38,281
"2011","Torbay 010A","E01015267","Total",852,383,15,368,86,42,234,12,222
"2011","Torbay 010B","E01015268","Total",875,413,14,399,113,51,237,20,217
"2011","Torbay 010C","E01015269","Total",796,346,11,335,116,48,249,14,235
"2011","Torbay 010D","E01015270","Total",882,439,18,421,104,52,268,18,250
"2011","Torbay 010E","E01015271","Total",704,383,9,374,94,24,206,12,194
"2011","Torbay 011A","E01015224","Total",623,230,25,205,188,77,185,37,148
"2011","Torbay 011B","E01015225","Total",597,238,19,219,161,52,201,30,171
"2011","Torbay 011C","E01015226","Total",603,245,6,239,144,57,165,23,142
"2011","Torbay 011D","E01015227","Total",622,230,7,223,171,59,176,26,150
"2011","Torbay 011E","E01015228","Total",737,366,27,339,145,52,292,37,255
"2011","Torbay 011F","E01015230","Total",639,293,5,288,119,40,185,20,165
"2011","Torbay 012A","E01015202","Total",601,191,22,169,199,68,173,31,142
"2011","Torbay 012B","E01015203","Total",547,229,6,223,129,44,155,22,133
"2011","Torbay 012C","E01015204","Total",622,227,24,203,164,63,194,34,160
"2011","Torbay 012D","E01015205","Total",639,233,19,214,180,57,161,20,141
"2011","Torbay 012E","E01015206","Total",629,222,25,197,167,71,180,29,151
"2011","Torbay 013A","E01015190","Total",708,300,41,259,186,66,198,42,156
"2011","Torbay 013B","E01015191","Total",662,177,37,140,234,106,166,54,112
"2011","Torbay 013C","E01015192","Total",589,213,48,165,203,81,192,43,149
"2011","Torbay 013D","E01015193","Total",552,229,21,208,151,55,183,33,150
"2011","Torbay 013E","E01015194","Total",606,255,44,211,160,68,215,42,173
"2011","Torbay 013F","E01015195","Total",639,274,37,237,182,53,220,45,175
"2011","Torbay 013G","E01015196","Total",593,261,87,174,262,90,219,78,141
"2011","Torbay 014A","E01015229","Total",609,306,11,295,113,39,226,14,212
"2011","Torbay 014B","E01015231","Total",856,459,73,386,192,72,355,43,312
"2011","Torbay 014C","E01015232","Total",842,387,22,365,115,38,293,28,265
"2011","Torbay 014D","E01015233","Total",701,331,35,296,138,54,214,34,180
"2011","Torbay 014E","E01015234","Total",595,242,37,205,185,70,222,45,177
"2011","Torbay 014F","E01015235","Total",845,475,18,457,102,29,304,25,279
"2011","Torbay 015A","E01015219","Total",688,362,13,349,124,41,258,22,236
"2011","Torbay 015B","E01015220","Total",618,257,16,241,142,38,169,25,144
"2011","Torbay 015C","E01015221","Total",634,253,17,236,168,40,219,37,182
"2011","Torbay 015D","E01015222","Total",631,263,19,244,144,51,186,27,159
"2011","Torbay 015E","E01015223","Total",510,136,6,130,173,33,107,22,85
"2011","Torbay 016A","E01015197","Total",637,303,6,297,119,30,192,16,176
"2011","Torbay 016B","E01015198","Total",740,412,15,397,123,31,244,23,221
"2011","Torbay 016C","E01015199","Total",628,365,7,358,72,11,225,16,209
"2011","Torbay 016D","E01015200","Total",442,190,12,178,112,33,130,21,109
"2011","Torbay 016E","E01015201","Total",580,253,11,242,123,31,166,21,145
"2011","Torbay 017A","E01015183","Total",582,270,11,259,122,46,235,25,210
"2011","Torbay 017B","E01015184","Total",620,352,7,345,89,31,202,16,186
"2011","Torbay 017C","E01015185","Total",681,356,24,332,124,41,233,17,216
"2011","Torbay 017D","E01015186","Total",681,292,42,250,158,64,212,30,182
"2011","Torbay 017E","E01015187","Total",705,381,14,367,97,30,241,17,224
"2011","Torbay 017F","E01015188","Total",667,331,22,309,135,40,233,22,211
"2011","Torbay 017G","E01015189","Total",564,241,28,213,121,41,163,27,136
"2011","Torbay 018A","E01015244","Total",641,283,20,263,162,49,202,21,181
"2011","Torbay 018B","E01015245","Total",603,331,38,293,140,45,207,24,183
"2011","Torbay 018C","E01015246","Total",600,290,18,272,140,41,204,21,183
"2011","Torbay 018D","E01015247","Total",735,306,45,261,201,78,238,51,187
"2011","Torbay 018E","E01015248","Total",657,280,29,251,188,60,204,32,172
"2011","Torbay 019E","E01015207","Total",649,191,25,166,206,74,167,32,135
"2011","Torbay 019F","E01015208","Total",847,423,13,410,152,43,236,23,213
"2011","Torbay 019A","E01015209","Total",625,259,20,239,136,47,181,21,160
"2011","Torbay 019B","E01015210","Total",639,253,51,202,216,80,197,36,161
"2011","Torbay 019G","E01015211","Total",586,219,15,204,177,73,144,29,115
"2011","Torbay 019C","E01015212","Total",586,174,26,148,184,75,158,34,124
"2011","Torbay 019D","E01015213","Total",569,192,21,171,186,69,155,36,119
"2011","Wiltshire 012A","E01031841","Total",783,244,18,226,221,71,176,33,143
"2011","Wiltshire 012B","E01031868","Total",683,137,10,127,208,57,135,21,114
"2011","Wiltshire 012C","E01031873","Total",738,208,11,197,214,76,138,25,113
"2011","Wiltshire 012D","E01031874","Total",654,214,9,205,179,54,165,16,149
"2011","Wiltshire 012E","E01031884","Total",675,198,11,187,195,56,159,32,127
"2011","Wiltshire 019A","E01031861","Total",1024,313,17,296,262,81,252,29,223
"2011","Wiltshire 019B","E01031862","Total",722,254,36,218,216,93,204,39,165
"2011","Wiltshire 019C","E01031863","Total",576,180,6,174,104,41,117,12,105
"2011","Wiltshire 019D","E01031864","Total",522,141,3,138,184,45,94,25,69
"2011","Wiltshire 019E","E01031865","Total",571,244,13,231,126,48,164,20,144
"2011","Wiltshire 024A","E01031866","Total",687,175,9,166,170,55,128,18,110
"2011","Wiltshire 024B","E01031869","Total",850,340,28,312,223,76,273,33,240
"2011","Wiltshire 024C","E01031870","Total",810,255,12,243,188,72,166,11,155
"2011","Wiltshire 024D","E01031871","Total",712,200,15,185,205,73,142,29,113
"2011","Wiltshire 025A","E01031850","Total",938,348,15,333,207,95,258,29,229
"2011","Wiltshire 025B","E01031851","Total",630,179,34,145,206,70,168,41,127
"2011","Wiltshire 025C","E01031852","Total",824,256,16,240,259,110,205,34,171
"2011","Wiltshire 025E","E01032688","Total",501,91,20,71,224,92,85,27,58
"2011","Wiltshire 025F","E01032689","Total",532,148,22,126,200,85,117,32,85
"2011","Wiltshire 025G","E01032692","Total",509,95,17,78,174,95,105,30,75
"2011","Wiltshire 025H","E01032693","Total",571,140,30,110,201,106,102,26,76
"2011","Wiltshire 026A","E01031853","Total",657,225,18,207,156,63,159,25,134
"2011","Wiltshire 026B","E01031854","Total",1024,474,33,441,161,69,340,26,314
"2011","Wiltshire 026C","E01031855","Total",645,246,12,234,159,55,145,17,128
"2011","Wiltshire 026D","E01031856","Total",750,327,30,297,151,56,241,29,212
"2011","Wiltshire 028A","E01031845","Total",666,197,14,183,160,39,156,21,135
"2011","Wiltshire 028B","E01031846","Total",704,212,16,196,195,56,175,34,141
"2011","Wiltshire 028C","E01031848","Total",724,220,10,210,213,51,147,22,125
"2011","Wiltshire 028D","E01031872","Total",675,234,25,209,194,57,164,37,127
"2011","Wiltshire 028E","E01031876","Total",622,210,19,191,166,64,161,32,129
"2011","Wiltshire 029A","E01031843","Total",774,247,14,233,218,57,199,26,173
"2011","Wiltshire 029B","E01031847","Total",728,213,7,206,207,78,168,23,145
"2011","Wiltshire 029C","E01031849","Total",672,153,13,140,191,85,150,27,123
"2011","Wiltshire 029D","E01031877","Total",767,197,12,185,218,93,169,25,144
"2011","Wiltshire 034A","E01031844","Total",830,205,25,180,252,98,170,34,136
"2011","Wiltshire 034B","E01031857","Total",640,176,16,160,207,48,153,36,117
"2011","Wiltshire 034C","E01031858","Total",713,181,12,169,217,64,159,29,130
"2011","Wiltshire 034D","E01031883","Total",785,303,7,296,173,56,222,20,202
"2011","Wiltshire 038A","E01031842","Total",768,207,8,199,228,58,175,30,145
"2011","Wiltshire 038B","E01031867","Total",795,198,16,182,206,81,181,28,153
"2011","Wiltshire 038C","E01031882","Total",849,224,13,211,247,117,168,30,138
"2011","Wiltshire 041A","E01031859","Total",744,241,42,199,213,89,191,39,152
"2011","Wiltshire 041B","E01031860","Total",634,165,18,147,199,75,141,31,110
"2011","Wiltshire 041C","E01031878","Total",763,108,26,82,369,185,116,41,75
"2011","Wiltshire 041D","E01031879","Total",597,43,20,23,366,274,75,43,32
"2011","Wiltshire 041E","E01031880","Total",582,40,14,26,373,200,84,39,45
"2011","Wiltshire 041G","E01032697","Total",574,89,40,49,286,170,95,43,52
"2011","Wiltshire 041H","E01032698","Total",618,149,35,114,261,101,156,40,116
"2011","Wiltshire 001A","E01031887","Total",714,214,17,197,216,80,161,25,136
"2011","Wiltshire 001B","E01031934","Total",698,197,7,190,208,62,167,29,138
"2011","Wiltshire 001C","E01031935","Total",736,209,10,199,212,57,160,29,131
"2011","Wiltshire 001D","E01031936","Total",634,211,26,185,194,76,187,35,152
"2011","Wiltshire 002A","E01031885","Total",634,170,13,157,191,69,133,28,105
"2011","Wiltshire 002B","E01031947","Total",697,261,35,226,217,76,192,33,159
"2011","Wiltshire 002C","E01031948","Total",828,170,20,150,320,137,136,33,103
"2011","Wiltshire 002D","E01031949","Total",833,212,10,202,182,71,171,31,140
"2011","Wiltshire 003A","E01031954","Total",530,151,6,145,171,53,116,24,92
"2011","Wiltshire 003B","E01031955","Total",659,235,6,229,170,48,151,21,130
"2011","Wiltshire 003C","E01031956","Total",512,180,26,154,165,68,132,26,106
"2011","Wiltshire 003D","E01031962","Total",541,180,3,177,163,38,124,15,109
"2011","Wiltshire 004A","E01031886","Total",566,139,5,134,159,53,110,16,94
"2011","Wiltshire 004B","E01031892","Total",558,167,3,164,158,43,123,19,104
"2011","Wiltshire 004C","E01031893","Total",612,129,3,126,194,64,130,22,108
"2011","Wiltshire 004D","E01031894","Total",601,150,5,145,179,42,128,17,111
"2011","Wiltshire 005A","E01031957","Total",619,175,14,161,200,78,122,21,101
"2011","Wiltshire 005B","E01031958","Total",563,148,7,141,174,55,145,20,125
"2011","Wiltshire 005C","E01031959","Total",690,239,7,232,168,74,161,22,139
"2011","Wiltshire 005D","E01031960","Total",526,109,14,95,216,115,96,24,72
"2011","Wiltshire 006A","E01031963","Total",737,295,41,254,228,66,246,45,201
"2011","Wiltshire 006B","E01031964","Total",776,259,19,240,168,45,203,35,168
"2011","Wiltshire 006C","E01031967","Total",880,312,33,279,232,78,254,37,217
"2011","Wiltshire 006D","E01031969","Total",586,95,5,90,203,64,102,26,76
"2011","Wiltshire 007B","E01031944","Total",457,87,9,78,128,47,88,19,69
"2011","Wiltshire 007D","E01031946","Total",482,12,2,10,316,178,56,30,26
"2011","Wiltshire 007E","E01031961","Total",526,132,6,126,136,49,90,9,81
"2011","Wiltshire 007F","E01031965","Total",620,197,8,189,139,51,153,26,127
"2011","Wiltshire 007G","E01031966","Total",628,205,6,199,173,51,158,28,130
"2011","Wiltshire 007H","E01031968","Total",678,188,6,182,184,63,139,21,118
"2011","Wiltshire 007I","E01032699","Total",996,289,8,281,297,140,238,34,204
"2011","Wiltshire 008A","E01031939","Total",842,231,14,217,282,73,176,37,139
"2011","Wiltshire 008B","E01031940","Total",917,263,16,247,283,88,195,40,155
"2011","Wiltshire 008C","E01031950","Total",536,102,5,97,174,53,96,18,78
"2011","Wiltshire 008D","E01031951","Total",465,112,9,103,158,59,95,25,70
"2011","Wiltshire 009A","E01031907","Total",921,142,17,125,394,117,128,45,83
"2011","Wiltshire 009B","E01031910","Total",586,152,19,133,199,66,141,30,111
"2011","Wiltshire 009C","E01031914","Total",495,163,45,118,215,86,160,51,109
"2011","Wiltshire 009D","E01031915","Total",603,192,13,179,180,61,170,24,146
"2011","Wiltshire 009E","E01031919","Total",593,184,15,169,226,69,134,27,107
"2011","Wiltshire 009F","E01031920","Total",505,108,10,98,178,72,108,24,84
"2011","Wiltshire 010A","E01031905","Total",497,62,10,52,233,51,70,32,38
"2011","Wiltshire 010B","E01031906","Total",643,91,8,83,210,88,103,32,71
"2011","Wiltshire 010C","E01031908","Total",706,200,37,163,219,68,167,40,127
"2011","Wiltshire 010D","E01031909","Total",526,176,11,165,153,40,135,28,107
"2011","Wiltshire 010E","E01031925","Total",495,195,30,165,156,72,136,22,114
"2011","Wiltshire 010F","E01031926","Total",620,192,23,169,203,86,173,42,131
"2011","Wiltshire 010G","E01031927","Total",502,144,5,139,161,47,93,23,70
"2011","Wiltshire 011A","E01031911","Total",572,206,35,171,195,77,184,40,144
"2011","Wiltshire 011B","E01031912","Total",739,279,37,242,161,83,198,20,178
"2011","Wiltshire 011C","E01031913","Total",556,143,9,134,153,65,114,17,97
"2011","Wiltshire 011D","E01031917","Total",673,213,31,182,162,78,180,31,149
"2011","Wiltshire 011E","E01031918","Total",1138,484,27,457,260,104,286,41,245
"2011","Wiltshire 011F","E01031928","Total",613,255,41,214,183,77,200,31,169
"2011","Wiltshire 013A","E01031891","Total",883,230,14,216,261,61,177,38,139
"2011","Wiltshire 013B","E01031904","Total",808,211,17,194,270,79,161,31,130
"2011","Wiltshire 013C","E01031937","Total",444,124,7,117,118,40,125,25,100
"2011","Wiltshire 013D","E01031938","Total",568,127,8,119,186,57,117,26,91
"2011","Wiltshire 014A","E01031916","Total",538,179,21,158,170,59,161,27,134
"2011","Wiltshire 014B","E01031921","Total",533,77,6,71,238,72,86,26,60
"2011","Wiltshire 014C","E01031922","Total",594,97,11,86,167,59,91,20,71
"2011","Wiltshire 014D","E01031923","Total",536,100,10,90,198,63,90,20,70
"2011","Wiltshire 014E","E01031924","Total",666,90,18,72,276,101,81,36,45
"2011","Wiltshire 015A","E01031895","Total",628,218,29,189,206,76,177,49,128
"2011","Wiltshire 015B","E01031896","Total",571,244,41,203,149,61,184,27,157
"2011","Wiltshire 015C","E01031897","Total",842,184,27,157,322,141,176,58,118
"2011","Wiltshire 015D","E01031898","Total",656,184,34,150,209,103,164,39,125
"2011","Wiltshire 015F","E01032690","Total",659,95,30,65,308,140,103,46,57
"2011","Wiltshire 015G","E01032691","Total",595,152,30,122,249,108,139,38,101
"2011","Wiltshire 016A","E01031900","Total",1043,392,16,376,232,71,277,25,252
"2011","Wiltshire 016B","E01031901","Total",645,213,41,172,203,92,166,36,130
"2011","Wiltshire 016C","E01031902","Total",475,122,25,97,158,55,102,22,80
"2011","Wiltshire 016D","E01031903","Total",999,307,21,286,291,101,216,38,178
"2011","Wiltshire 017A","E01031888","Total",574,183,9,174,146,43,149,26,123
"2011","Wiltshire 017B","E01031889","Total",762,168,29,139,283,144,139,43,96
"2011","Wiltshire 017C","E01031890","Total",628,200,10,190,175,63,170,25,145
"2011","Wiltshire 017D","E01031929","Total",548,187,10,177,155,48,127,15,112
"2011","Wiltshire 017E","E01031930","Total",485,37,6,31,242,134,67,26,41
"2011","Wiltshire 018A","E01031931","Total",729,286,11,275,171,61,187,28,159
"2011","Wiltshire 018B","E01031932","Total",667,267,5,262,123,33,191,18,173
"2011","Wiltshire 018C","E01031933","Total",620,183,29,154,222,85,156,35,121
"2011","Wiltshire 018D","E01031941","Total",637,184,30,154,237,90,140,30,110
"2011","Wiltshire 018E","E01031942","Total",549,142,9,133,142,53,113,22,91
"2011","Wiltshire 018F","E01031952","Total",1094,381,47,334,293,118,313,40,273
"2011","Wiltshire 018G","E01031953","Total",1185,261,39,222,447,203,231,61,170
"2011","Wiltshire 045B","E01031988","Total",561,18,5,13,303,219,53,32,21
"2011","Wiltshire 045C","E01031998","Total",719,27,16,11,484,314,98,69,29
"2011","Wiltshire 045D","E01032026","Total",670,199,11,188,188,67,152,22,130
"2011","Wiltshire 045F","E01032696","Total",858,202,14,188,263,106,186,32,154
"2011","Wiltshire 046A","E01031989","Total",577,152,22,130,228,96,152,37,115
"2011","Wiltshire 046B","E01031996","Total",556,181,21,160,163,62,181,27,154
"2011","Wiltshire 046C","E01031997","Total",584,126,10,116,170,70,120,28,92
"2011","Wiltshire 046D","E01031999","Total",650,196,10,186,165,50,154,22,132
"2011","Wiltshire 048A","E01031974","Total",586,245,9,236,115,28,192,23,169
"2011","Wiltshire 048B","E01031975","Total",531,211,28,183,155,46,177,30,147
"2011","Wiltshire 048C","E01031976","Total",490,64,17,47,258,121,89,34,55
"2011","Wiltshire 048D","E01031977","Total",1083,187,33,154,456,182,187,52,135
"2011","Wiltshire 048E","E01031978","Total",693,132,38,94,285,115,119,34,85
"2011","Wiltshire 048F","E01031979","Total",881,246,16,230,219,74,205,40,165
"2011","Wiltshire 049A","E01032013","Total",829,260,15,245,216,78,190,26,164
"2011","Wiltshire 049B","E01032032","Total",662,214,8,206,170,43,153,22,131
"2011","Wiltshire 049C","E01032033","Total",609,162,11,151,163,60,153,24,129
"2011","Wiltshire 049D","E01032034","Total",583,180,7,173,173,63,120,18,102
"2011","Wiltshire 050A","E01032010","Total",931,329,7,322,203,65,218,31,187
"2011","Wiltshire 050B","E01032035","Total",686,298,9,289,133,39,183,25,158
"2011","Wiltshire 050C","E01032036","Total",638,222,15,207,153,46,161,21,140
"2011","Wiltshire 050D","E01032037","Total",698,282,20,262,152,54,204,20,184
"2011","Wiltshire 051A","E01031984","Total",602,111,8,103,260,78,111,37,74
"2011","Wiltshire 051B","E01031985","Total",524,154,16,138,184,78,141,38,103
"2011","Wiltshire 051C","E01031986","Total",603,252,17,235,133,53,210,29,181
"2011","Wiltshire 051D","E01032017","Total",609,203,2,201,172,49,145,23,122
"2011","Wiltshire 052A","E01031980","Total",600,138,31,107,220,90,144,38,106
"2011","Wiltshire 052B","E01031981","Total",619,193,58,135,255,94,189,62,127
"2011","Wiltshire 052C","E01031982","Total",567,152,21,131,198,64,147,29,118
"2011","Wiltshire 052D","E01031983","Total",723,232,71,161,293,137,197,56,141
"2011","Wiltshire 053A","E01032018","Total",634,211,3,208,168,61,145,17,128
"2011","Wiltshire 053B","E01032019","Total",623,240,31,209,171,68,223,34,189
"2011","Wiltshire 053C","E01032020","Total",634,208,9,199,165,54,153,22,131
"2011","Wiltshire 053D","E01032025","Total",626,183,8,175,157,62,162,30,132
"2011","Wiltshire 054A","E01031990","Total",809,249,16,233,216,74,195,35,160
"2011","Wiltshire 054B","E01032004","Total",999,342,25,317,248,81,244,41,203
"2011","Wiltshire 054C","E01032027","Total",612,215,11,204,118,37,154,21,133
"2011","Wiltshire 054D","E01032038","Total",639,251,6,245,104,41,175,15,160
"2011","Wiltshire 054E","E01032039","Total",674,220,15,205,159,90,192,27,165
"2011","Wiltshire 054F","E01032040","Total",625,188,17,171,172,75,159,27,132
"2011","Wiltshire 055A","E01032001","Total",609,159,14,145,185,84,142,28,114
"2011","Wiltshire 055B","E01032002","Total",600,157,12,145,155,79,136,16,120
"2011","Wiltshire 055C","E01032003","Total",734,235,8,227,133,78,190,11,179
"2011","Wiltshire 055D","E01032024","Total",1125,256,30,226,272,141,216,32,184
"2011","Wiltshire 056A","E01032014","Total",865,339,12,327,150,63,235,19,216
"2011","Wiltshire 056B","E01032015","Total",602,159,19,140,156,50,158,31,127
"2011","Wiltshire 056C","E01032016","Total",624,130,10,120,153,61,89,11,78
"2011","Wiltshire 056D","E01032021","Total",700,187,13,174,150,73,119,10,109
"2011","Wiltshire 057A","E01032000","Total",947,309,26,283,272,110,199,30,169
"2011","Wiltshire 057B","E01032011","Total",1022,274,48,226,363,165,195,54,141
"2011","Wiltshire 057C","E01032012","Total",759,325,8,317,176,57,207,23,184
"2011","Wiltshire 058A","E01032008","Total",668,277,17,260,163,57,238,23,215
"2011","Wiltshire 058B","E01032009","Total",836,359,6,353,163,60,208,16,192
"2011","Wiltshire 058C","E01032022","Total",931,417,16,401,120,60,291,19,272
"2011","Wiltshire 059A","E01032005","Total",532,162,13,149,166,58,137,22,115
"2011","Wiltshire 059B","E01032006","Total",510,132,4,128,174,61,74,13,61
"2011","Wiltshire 059C","E01032007","Total",543,111,17,94,200,84,104,36,68
"2011","Wiltshire 059D","E01032023","Total",840,400,57,343,208,110,278,33,245
"2011","Wiltshire 060A","E01031970","Total",658,197,6,191,179,49,133,21,112
"2011","Wiltshire 060B","E01031971","Total",512,150,9,141,131,50,124,22,102
"2011","Wiltshire 060C","E01031972","Total",598,183,7,176,179,61,120,29,91
"2011","Wiltshire 060D","E01032041","Total",784,264,8,256,197,50,202,31,171
"2011","Wiltshire 060E","E01032042","Total",677,184,10,174,227,70,156,27,129
"2011","Wiltshire 061A","E01031991","Total",845,281,14,267,173,52,179,22,157
"2011","Wiltshire 061B","E01032029","Total",605,198,12,186,142,43,136,13,123
"2011","Wiltshire 061C","E01032030","Total",718,275,25,250,168,68,212,26,186
"2011","Wiltshire 061D","E01032031","Total",490,198,1,197,83,37,163,11,152
"2011","Wiltshire 062A","E01031973","Total",720,219,12,207,198,71,159,32,127
"2011","Wiltshire 062B","E01031992","Total",623,203,5,198,142,38,161,26,135
"2011","Wiltshire 062C","E01031993","Total",625,238,11,227,163,62,180,29,151
"2011","Wiltshire 062D","E01031994","Total",512,160,19,141,163,57,128,19,109
"2011","Wiltshire 062E","E01031995","Total",721,245,6,239,181,60,149,18,131
"2011","Wiltshire 020A","E01032063","Total",776,235,39,196,262,99,176,48,128
"2011","Wiltshire 020B","E01032064","Total",508,163,36,127,193,73,162,44,118
"2011","Wiltshire 020C","E01032065","Total",646,202,28,174,223,80,168,41,127
"2011","Wiltshire 020D","E01032073","Total",571,104,19,85,211,97,97,25,72
"2011","Wiltshire 020E","E01032074","Total",532,236,5,231,84,29,148,10,138
"2011","Wiltshire 021A","E01032043","Total",513,172,7,165,139,36,133,20,113
"2011","Wiltshire 021B","E01032044","Total",555,220,11,209,130,40,162,19,143
"2011","Wiltshire 021C","E01032057","Total",492,147,4,143,131,46,106,16,90
"2011","Wiltshire 021D","E01032070","Total",685,258,19,239,155,59,214,21,193
"2011","Wiltshire 021E","E01032071","Total",889,220,21,199,294,107,208,44,164
"2011","Wiltshire 021F","E01032072","Total",738,117,26,91,330,124,121,42,79
"2011","Wiltshire 022A","E01032062","Total",766,322,41,281,176,88,260,28,232
"2011","Wiltshire 022B","E01032066","Total",626,211,30,181,216,95,166,33,133
"2011","Wiltshire 022C","E01032067","Total",653,232,19,213,169,64,165,21,144
"2011","Wiltshire 022D","E01032068","Total",707,329,22,307,152,62,251,25,226
"2011","Wiltshire 022E","E01032069","Total",499,133,10,123,154,50,112,23,89
"2011","Wiltshire 023A","E01032058","Total",595,191,9,182,170,65,133,20,113
"2011","Wiltshire 023B","E01032059","Total",728,239,10,229,216,55,174,25,149
"2011","Wiltshire 023C","E01032060","Total",701,314,12,302,157,49,197,13,184
"2011","Wiltshire 023D","E01032061","Total",514,196,5,191,125,51,111,10,101
"2011","Wiltshire 027A","E01032045","Total",604,200,9,191,179,58,130,22,108
"2011","Wiltshire 027B","E01032046","Total",708,284,26,258,195,77,203,29,174
"2011","Wiltshire 027C","E01032047","Total",608,254,12,242,163,50,178,21,157
"2011","Wiltshire 027D","E01032048","Total",754,306,24,282,205,84,244,35,209
"2011","Wiltshire 027E","E01032049","Total",701,272,13,259,165,53,172,12,160
"2011","Wiltshire 027F","E01032050","Total",911,347,12,335,161,66,210,22,188
"2011","Wiltshire 030A","E01032077","Total",671,186,9,177,188,50,162,27,135
"2011","Wiltshire 030B","E01032078","Total",1173,249,68,181,424,208,239,74,165
"2011","Wiltshire 030C","E01032079","Total",633,232,15,217,163,55,180,29,151
"2011","Wiltshire 030D","E01032080","Total",617,123,3,120,278,101,100,33,67
"2011","Wiltshire 031A","E01032085","Total",670,151,11,140,203,95,135,26,109
"2011","Wiltshire 031B","E01032086","Total",1172,367,69,298,308,146,307,59,248
"2011","Wiltshire 031C","E01032087","Total",936,360,30,330,228,95,258,43,215
"2011","Wiltshire 032A","E01032099","Total",1131,287,45,242,463,213,208,58,150
"2011","Wiltshire 032B","E01032100","Total",654,226,17,209,176,73,157,22,135
"2011","Wiltshire 032C","E01032101","Total",792,289,26,263,188,82,207,24,183
"2011","Wiltshire 032D","E01032102","Total",657,256,13,243,173,53,176,30,146
"2011","Wiltshire 033A","E01032096","Total",758,349,100,249,289,117,287,69,218
"2011","Wiltshire 033B","E01032097","Total",740,229,5,224,210,55,179,27,152
"2011","Wiltshire 033C","E01032098","Total",632,208,22,186,191,50,164,36,128
"2011","Wiltshire 035A","E01032092","Total",621,141,10,131,160,59,119,14,105
"2011","Wiltshire 035B","E01032093","Total",718,234,72,162,315,116,199,65,134
"2011","Wiltshire 035C","E01032094","Total",1009,298,52,246,347,167,239,49,190
"2011","Wiltshire 035D","E01032095","Total",669,170,20,150,224,89,134,24,110
"2011","Wiltshire 036A","E01032088","Total",632,226,12,214,178,65,156,23,133
"2011","Wiltshire 036B","E01032089","Total",655,129,15,114,190,87,131,23,108
"2011","Wiltshire 036C","E01032090","Total",616,216,18,198,180,68,158,30,128
"2011","Wiltshire 036D","E01032091","Total",544,187,28,159,165,64,131,19,112
"2011","Wiltshire 037A","E01032053","Total",583,195,15,180,159,62,131,18,113
"2011","Wiltshire 037B","E01032083","Total",916,261,18,243,268,107,244,37,207
"2011","Wiltshire 037C","E01032084","Total",1085,363,20,343,287,113,253,33,220
"2011","Wiltshire 039A","E01032052","Total",562,177,3,174,118,31,138,19,119
"2011","Wiltshire 039B","E01032054","Total",519,157,26,131,154,70,133,25,108
"2011","Wiltshire 039C","E01032055","Total",542,177,5,172,116,35,133,14,119
"2011","Wiltshire 039D","E01032056","Total",548,164,18,146,175,59,139,30,109
"2011","Wiltshire 039E","E01032121","Total",694,245,10,235,179,69,191,33,158
"2011","Wiltshire 040A","E01032115","Total",825,327,40,287,210,83,253,36,217
"2011","Wiltshire 040B","E01032116","Total",1063,309,35,274,341,144,249,53,196
"2011","Wiltshire 040C","E01032117","Total",1014,238,51,187,407,174,239,70,169
"2011","Wiltshire 040D","E01032118","Total",564,202,50,152,248,100,171,47,124
"2011","Wiltshire 040E","E01032119","Total",926,270,39,231,247,119,193,42,151
"2011","Wiltshire 040G","E01032694","Total",601,91,46,45,292,125,106,48,58
"2011","Wiltshire 040H","E01032695","Total",602,200,9,191,142,53,157,19,138
"2011","Wiltshire 042A","E01032104","Total",510,204,37,167,171,53,179,41,138
"2011","Wiltshire 042B","E01032105","Total",667,267,8,259,134,32,182,17,165
"2011","Wiltshire 042C","E01032107","Total",493,28,10,18,317,206,73,41,32
"2011","Wiltshire 042D","E01032108","Total",620,267,5,262,126,43,179,14,165
"2011","Wiltshire 043A","E01032110","Total",696,232,11,221,174,58,180,29,151
"2011","Wiltshire 043B","E01032111","Total",547,201,20,181,154,56,185,39,146
"2011","Wiltshire 043C","E01032112","Total",618,117,11,106,208,80,125,29,96
"2011","Wiltshire 043D","E01032113","Total",601,194,19,175,161,59,163,21,142
"2011","Wiltshire 044A","E01032103","Total",874,342,17,325,161,53,272,29,243
"2011","Wiltshire 044B","E01032106","Total",595,238,5,233,133,44,165,21,144
"2011","Wiltshire 044C","E01032109","Total",676,227,20,207,177,66,181,24,157
"2011","Wiltshire 044D","E01032114","Total",646,240,17,223,156,58,174,26,148
"2011","Wiltshire 047A","E01032051","Total",582,194,5,189,148,43,134,21,113
"2011","Wiltshire 047B","E01032075","Total",584,197,14,183,141,51,145,24,121
"2011","Wiltshire 047C","E01032076","Total",533,184,8,176,126,35,119,22,97
"2011","Wiltshire 047D","E01032081","Total",540,171,7,164,116,38,136,17,119
"2011","Wiltshire 047E","E01032082","Total",523,142,2,140,118,34,122,23,99
"2011","East Devon 001A","E01019902","Total",917,397,14,383,195,79,258,25,233
"2011","East Devon 001B","E01019938","Total",905,273,8,265,205,76,227,32,195
"2011","East Devon 001C","E01019967","Total",541,177,7,170,131,44,130,19,111
"2011","East Devon 002A","E01019927","Total",625,278,20,258,131,48,211,30,181
"2011","East Devon 002B","E01019932","Total",819,353,15,338,154,57,286,18,268
"2011","East Devon 002C","E01019933","Total",604,258,16,242,117,48,183,13,170
"2011","East Devon 002D","E01019934","Total",825,396,15,381,158,49,229,23,206
"2011","East Devon 003A","E01019928","Total",597,176,17,159,191,67,162,24,138
"2011","East Devon 003B","E01019929","Total",625,177,12,165,192,74,154,28,126
"2011","East Devon 003C","E01019930","Total",667,300,16,284,142,54,182,17,165
"2011","East Devon 003D","E01019931","Total",532,195,4,191,148,49,119,17,102
"2011","East Devon 004A","E01019925","Total",522,147,5,142,170,70,132,23,109
"2011","East Devon 004D","E01019959","Total",485,176,10,166,130,44,141,31,110
"2011","East Devon 004E","E01019960","Total",530,130,4,126,158,62,110,19,91
"2011","East Devon 004F","E01019962","Total",961,290,15,275,291,78,209,42,167
"2011","East Devon 004G","E01032628","Total",851,272,10,262,227,62,205,30,175
"2011","East Devon 005A","E01019886","Total",1112,430,25,405,286,89,320,49,271
"2011","East Devon 005B","E01019887","Total",654,255,26,229,170,64,209,25,184
"2011","East Devon 005C","E01019888","Total",817,342,11,331,122,44,226,17,209
"2011","East Devon 005D","E01019889","Total",657,282,5,277,150,48,188,23,165
"2011","East Devon 005E","E01019966","Total",471,201,10,191,98,28,128,12,116
"2011","East Devon 006A","E01019891","Total",574,139,4,135,162,47,140,29,111
"2011","East Devon 006B","E01019892","Total",617,162,4,158,180,56,148,21,127
"2011","East Devon 006C","E01019893","Total",728,214,14,200,223,76,183,37,146
"2011","East Devon 006D","E01019903","Total",891,320,7,313,210,67,227,25,202
"2011","East Devon 007A","E01019899","Total",629,269,16,253,144,38,191,31,160
"2011","East Devon 007B","E01019900","Total",812,395,14,381,157,40,233,22,211
"2011","East Devon 007C","E01019935","Total",563,245,4,241,95,22,167,17,150
"2011","East Devon 007D","E01019936","Total",507,231,8,223,107,29,139,16,123
"2011","East Devon 007E","E01019961","Total",1093,439,16,423,248,63,302,37,265
"2011","East Devon 008A","E01019939","Total",628,272,5,267,158,47,150,26,124
"2011","East Devon 008B","E01019940","Total",659,297,9,288,155,25,170,20,150
"2011","East Devon 008C","E01019942","Total",796,296,16,280,226,78,220,28,192
"2011","East Devon 008D","E01019943","Total",630,223,11,212,188,45,169,32,137
"2011","East Devon 008E","E01019944","Total",685,228,19,209,195,69,150,20,130
"2011","East Devon 009A","E01019890","Total",821,305,9,296,165,65,217,24,193
"2011","East Devon 009B","E01019901","Total",579,227,4,223,126,39,157,19,138
"2011","East Devon 009C","E01019951","Total",975,487,5,482,162,34,256,27,229
"2011","East Devon 010A","E01019946","Total",645,356,7,349,86,25,203,13,190
"2011","East Devon 010B","E01019947","Total",982,485,12,473,129,50,296,13,283
"2011","East Devon 010C","E01019948","Total",637,357,3,354,95,25,219,19,200
"2011","East Devon 010D","E01019949","Total",703,379,9,370,106,39,214,14,200
"2011","East Devon 010E","E01019950","Total",597,307,8,299,109,28,217,17,200
"2011","East Devon 011A","E01019952","Total",842,413,8,405,153,51,237,20,217
"2011","East Devon 011B","E01019953","Total",727,408,9,399,120,44,222,17,205
"2011","East Devon 011C","E01019954","Total",688,285,22,263,183,57,206,29,177
"2011","East Devon 011D","E01019955","Total",775,398,7,391,156,44,248,26,222
"2011","East Devon 012A","E01019956","Total",879,449,7,442,118,34,273,11,262
"2011","East Devon 012B","E01019957","Total",918,677,7,670,64,15,305,3,302
"2011","East Devon 012C","E01019958","Total",809,400,3,397,151,46,240,17,223
"2011","East Devon 013A","E01019937","Total",928,378,15,363,212,56,234,30,204
"2011","East Devon 013B","E01019945","Total",835,269,14,255,203,68,203,28,175
"2011","East Devon 013C","E01019963","Total",709,246,13,233,197,74,161,25,136
"2011","East Devon 014A","E01019898","Total",1023,385,9,376,215,68,270,33,237
"2011","East Devon 014B","E01019964","Total",428,149,6,143,103,28,82,13,69
"2011","East Devon 014C","E01019965","Total",773,299,20,279,218,95,212,31,181
"2011","East Devon 015A","E01019904","Total",603,237,8,229,161,49,200,29,171
"2011","East Devon 015B","E01019905","Total",743,208,6,202,237,69,168,34,134
"2011","East Devon 015C","E01019906","Total",658,246,14,232,169,68,181,24,157
"2011","East Devon 015D","E01019907","Total",675,303,3,300,153,49,218,17,201
"2011","East Devon 016A","E01019908","Total",709,141,24,117,288,104,138,44,94
"2011","East Devon 016B","E01019909","Total",813,358,9,349,163,62,233,25,208
"2011","East Devon 016C","E01019910","Total",668,226,10,216,180,59,166,22,144
"2011","East Devon 016D","E01019911","Total",783,436,5,431,101,49,266,13,253
"2011","East Devon 017A","E01019894","Total",786,526,9,517,80,22,264,13,251
"2011","East Devon 017B","E01019895","Total",656,348,2,346,106,27,207,13,194
"2011","East Devon 017C","E01019896","Total",757,420,9,411,113,36,234,19,215
"2011","East Devon 017D","E01019897","Total",697,291,19,272,198,85,217,32,185
"2011","East Devon 018A","E01019920","Total",626,192,27,165,191,76,147,22,125
"2011","East Devon 018B","E01019921","Total",635,227,9,218,187,65,159,21,138
"2011","East Devon 018C","E01019922","Total",643,290,14,276,163,50,248,27,221
"2011","East Devon 018D","E01019923","Total",534,212,15,197,137,49,157,27,130
"2011","East Devon 018E","E01019924","Total",605,143,19,124,227,78,153,43,110
"2011","East Devon 019A","E01019916","Total",952,294,35,259,225,122,260,38,222
"2011","East Devon 019B","E01019917","Total",650,195,20,175,199,87,187,26,161
"2011","East Devon 019C","E01019918","Total",948,334,17,317,164,79,247,30,217
"2011","East Devon 019D","E01019919","Total",778,231,27,204,223,107,219,25,194
"2011","East Devon 020A","E01019912","Total",855,430,15,415,134,62,279,17,262
"2011","East Devon 020B","E01019913","Total",794,494,4,490,71,19,265,12,253
"2011","East Devon 020C","E01019914","Total",948,430,50,380,257,108,361,65,296
"2011","East Devon 020D","E01019915","Total",753,415,11,404,149,43,244,26,218
"2011","Exeter 001C","E01019998","Total",608,175,9,166,169,77,129,17,112
"2011","Exeter 001D","E01019999","Total",503,173,6,167,117,45,112,17,95
"2011","Exeter 001E","E01020001","Total",601,174,8,166,119,40,121,13,108
"2011","Exeter 001F","E01033233","Total",969,400,13,387,162,54,234,23,211
"2011","Exeter 002A","E01019990","Total",607,197,41,156,185,88,174,32,142
"2011","Exeter 002B","E01019991","Total",620,208,49,159,231,111,161,38,123
"2011","Exeter 002C","E01019993","Total",497,112,3,109,128,41,99,15,84
"2011","Exeter 002D","E01020000","Total",604,248,17,231,152,67,214,34,180
"2011","Exeter 002E","E01020007","Total",507,130,11,119,84,47,72,12,60
"2011","Exeter 003A","E01019992","Total",616,207,23,184,171,62,193,30,163
"2011","Exeter 003B","E01020002","Total",638,252,41,211,188,84,182,34,148
"2011","Exeter 003C","E01020003","Total",695,290,19,271,169,64,194,21,173
"2011","Exeter 003D","E01020004","Total",631,186,6,180,180,68,146,20,126
"2011","Exeter 003E","E01020005","Total",704,266,43,223,255,103,237,53,184
"2011","Exeter 004A","E01019997","Total",620,164,10,154,80,39,93,4,89
"2011","Exeter 004B","E01020019","Total",558,216,9,207,47,21,115,4,111
"2011","Exeter 004C","E01020020","Total",599,157,9,148,81,29,100,15,85
"2011","Exeter 004D","E01020021","Total",536,156,6,150,81,38,90,13,77
"2011","Exeter 004E","E01020022","Total",673,272,21,251,94,60,164,15,149
"2011","Exeter 005A","E01019980","Total",738,175,42,133,241,141,148,34,114
"2011","Exeter 005B","E01019982","Total",727,128,34,94,218,106,139,39,100
"2011","Exeter 005C","E01019983","Total",626,219,18,201,158,65,148,23,125
"2011","Exeter 005D","E01019984","Total",549,105,7,98,173,68,118,27,91
"2011","Exeter 005E","E01019985","Total",579,189,46,143,224,91,191,51,140
"2011","Exeter 006A","E01019987","Total",648,220,11,209,125,64,160,15,145
"2011","Exeter 006B","E01019989","Total",528,135,12,123,143,67,108,18,90
"2011","Exeter 006C","E01020006","Total",785,220,26,194,232,92,190,43,147
"2011","Exeter 006D","E01020008","Total",607,161,15,146,109,55,107,14,93
"2011","Exeter 006E","E01020009","Total",615,130,5,125,177,67,112,27,85
"2011","Exeter 007A","E01019986","Total",627,181,0,181,166,82,152,13,139
"2011","Exeter 007B","E01020036","Total",655,262,25,237,185,70,206,25,181
"2011","Exeter 007C","E01020037","Total",602,241,37,204,195,81,174,35,139
"2011","Exeter 007D","E01020039","Total",839,371,47,324,265,123,300,57,243
"2011","Exeter 007E","E01020040","Total",582,218,16,202,153,59,177,26,151
"2011","Exeter 008A","E01019994","Total",659,230,19,211,104,47,185,11,174
"2011","Exeter 008B","E01019995","Total",816,434,27,407,103,57,324,18,306
"2011","Exeter 008C","E01020016","Total",1166,469,39,430,118,74,340,25,315
"2011","Exeter 008D","E01020017","Total",1009,339,41,298,174,98,175,20,155
"2011","Exeter 008E","E01020018","Total",1116,459,26,433,111,58,295,16,279
"2011","Exeter 009A","E01019996","Total",563,177,11,166,81,41,128,15,113
"2011","Exeter 009B","E01020023","Total",1004,326,13,313,263,95,241,33,208
"2011","Exeter 009C","E01020024","Total",667,231,10,221,171,62,152,26,126
"2011","Exeter 009D","E01020025","Total",759,173,8,165,144,78,148,24,124
"2011","Exeter 010A","E01019975","Total",500,150,29,121,190,74,132,39,93
"2011","Exeter 010B","E01020029","Total",661,163,6,157,196,82,149,24,125
"2011","Exeter 010C","E01020030","Total",889,260,27,233,219,114,246,31,215
"2011","Exeter 010D","E01020031","Total",645,144,17,127,209,103,157,32,125
"2011","Exeter 010E","E01020032","Total",622,167,14,153,141,56,145,21,124
"2011","Exeter 011A","E01020026","Total",742,248,5,243,188,64,172,28,144
"2011","Exeter 011B","E01020027","Total",695,196,14,182,184,78,159,29,130
"2011","Exeter 011D","E01020035","Total",669,207,18,189,199,96,140,24,116
"2011","Exeter 011E","E01020038","Total",606,173,13,160,169,54,127,27,100
"2011","Exeter 011F","E01033232","Total",619,84,22,62,218,110,103,30,73
"2011","Exeter 011G","E01033234","Total",608,103,18,85,201,88,85,23,62
"2011","Exeter 012A","E01019973","Total",616,224,16,208,170,60,183,25,158
"2011","Exeter 012B","E01019974","Total",648,253,13,240,140,57,186,20,166
"2011","Exeter 012C","E01019976","Total",555,227,8,219,121,51,165,16,149
"2011","Exeter 012D","E01019977","Total",612,221,11,210,166,69,154,15,139
"2011","Exeter 012E","E01019981","Total",599,166,34,132,206,63,163,42,121
"2011","Exeter 013A","E01019988","Total",645,257,9,248,167,61,196,19,177
"2011","Exeter 013B","E01020010","Total",742,249,55,194,266,131,204,49,155
"2011","Exeter 013C","E01020013","Total",558,163,15,148,139,57,146,20,126
"2011","Exeter 013D","E01020014","Total",651,236,47,189,213,83,195,39,156
"2011","Exeter 013E","E01020015","Total",717,255,76,179,281,132,234,56,178
"2011","Exeter 014A","E01019968","Total",703,287,7,280,149,55,190,16,174
"2011","Exeter 014B","E01019969","Total",612,193,9,184,123,34,144,19,125
"2011","Exeter 014C","E01019970","Total",529,148,12,136,183,72,113,19,94
"2011","Exeter 014D","E01019971","Total",801,192,31,161,147,80,148,23,125
"2011","Exeter 014E","E01019972","Total",602,131,23,108,190,88,131,32,99
"2011","Exeter 015A","E01020011","Total",514,179,9,170,118,41,152,27,125
"2011","Exeter 015B","E01020012","Total",621,196,34,162,195,75,186,36,150
"2011","Exeter 015C","E01020033","Total",739,338,14,324,161,66,226,23,203
"2011","Exeter 015E","E01033235","Total",711,325,2,323,108,42,222,13,209
"2011","Exeter 015F","E01033236","Total",559,257,5,252,71,38,145,12,133
"2011","Mid Devon 001A","E01020046","Total",625,157,10,147,185,49,160,25,135
"2011","Mid Devon 001B","E01020049","Total",547,159,10,149,126,44,128,18,110
"2011","Mid Devon 001C","E01020050","Total",953,371,20,351,197,80,241,32,209
"2011","Mid Devon 001D","E01020077","Total",622,144,6,138,190,62,151,24,127
"2011","Mid Devon 002A","E01020047","Total",956,359,12,347,217,93,243,26,217
"2011","Mid Devon 002B","E01020051","Total",826,356,6,350,160,48,201,16,185
"2011","Mid Devon 002C","E01020066","Total",1115,271,29,242,413,156,207,55,152
"2011","Mid Devon 002D","E01020080","Total",536,216,10,206,114,41,131,17,114
"2011","Mid Devon 003A","E01020063","Total",1049,388,29,359,291,101,286,57,229
"2011","Mid Devon 003B","E01020074","Total",876,228,10,218,242,70,199,30,169
"2011","Mid Devon 003C","E01020075","Total",790,247,14,233,222,72,211,32,179
"2011","Mid Devon 004A","E01020052","Total",867,341,26,315,205,92,263,26,237
"2011","Mid Devon 004B","E01020053","Total",606,224,28,196,179,82,163,23,140
"2011","Mid Devon 004C","E01020065","Total",758,246,37,209,239,104,202,36,166
"2011","Mid Devon 004D","E01020067","Total",784,270,62,208,299,149,211,47,164
"2011","Mid Devon 005A","E01020048","Total",965,323,49,274,246,112,228,28,200
"2011","Mid Devon 005B","E01020078","Total",653,278,21,257,156,65,232,30,202
"2011","Mid Devon 005C","E01020079","Total",603,263,23,240,166,71,212,30,182
"2011","Mid Devon 005D","E01020081","Total",513,180,17,163,166,69,141,25,116
"2011","Mid Devon 006A","E01020045","Total",665,209,13,196,198,52,171,31,140
"2011","Mid Devon 006B","E01020059","Total",825,208,11,197,259,74,171,43,128
"2011","Mid Devon 006C","E01020062","Total",643,216,10,206,179,49,149,33,116
"2011","Mid Devon 006D","E01020064","Total",725,218,12,206,243,107,179,40,139
"2011","Mid Devon 007A","E01020054","Total",840,209,15,194,273,137,171,38,133
"2011","Mid Devon 007B","E01020055","Total",789,255,30,225,220,98,219,32,187
"2011","Mid Devon 007C","E01020057","Total",757,258,22,236,209,91,224,31,193
"2011","Mid Devon 007D","E01020058","Total",837,240,6,234,235,99,185,26,159
"2011","Mid Devon 008A","E01020043","Total",831,272,33,239,275,111,215,44,171
"2011","Mid Devon 008B","E01020044","Total",671,203,5,198,180,58,171,26,145
"2011","Mid Devon 008C","E01020056","Total",803,196,7,189,232,75,170,28,142
"2011","Mid Devon 008D","E01020071","Total",839,315,19,296,208,80,183,23,160
"2011","Mid Devon 009A","E01020072","Total",676,190,9,181,171,52,176,32,144
"2011","Mid Devon 009B","E01020073","Total",715,279,8,271,144,45,224,30,194
"2011","Mid Devon 009C","E01020076","Total",699,186,8,178,197,73,165,29,136
"2011","Mid Devon 009D","E01020082","Total",481,139,9,130,115,40,136,20,116
"2011","Mid Devon 010A","E01020068","Total",655,209,4,205,151,56,156,15,141
"2011","Mid Devon 010B","E01020069","Total",597,158,8,150,172,54,154,27,127
"2011","Mid Devon 010C","E01020070","Total",760,229,12,217,195,68,207,31,176
"2011","Mid Devon 010D","E01020083","Total",910,217,14,203,298,118,202,37,165
"2011","Mid Devon 011A","E01020041","Total",916,265,41,224,287,128,232,47,185
"2011","Mid Devon 011B","E01020042","Total",726,254,6,248,169,66,169,14,155
"2011","Mid Devon 011C","E01020060","Total",888,391,16,375,152,74,261,16,245
"2011","Mid Devon 011D","E01020061","Total",866,293,21,272,257,87,208,36,172
"2011","North Devon 001A","E01020111","Total",667,304,52,252,187,77,226,31,195
"2011","North Devon 001B","E01020112","Total",799,325,33,292,169,91,257,32,225
"2011","North Devon 001C","E01020114","Total",502,158,18,140,154,57,150,30,120
"2011","North Devon 001D","E01020115","Total",523,177,7,170,121,52,144,12,132
"2011","North Devon 002A","E01020099","Total",600,245,14,231,130,52,161,17,144
"2011","North Devon 002B","E01020100","Total",464,184,5,179,100,26,135,14,121
"2011","North Devon 002C","E01020101","Total",642,265,16,249,151,56,193,27,166
"2011","North Devon 002D","E01020126","Total",715,273,11,262,130,42,185,20,165
"2011","North Devon 003A","E01020113","Total",644,272,42,230,163,72,161,20,141
"2011","North Devon 003B","E01020116","Total",685,238,25,213,198,76,211,35,176
"2011","North Devon 003C","E01020117","Total",670,249,7,242,149,47,192,27,165
"2011","North Devon 003D","E01020118","Total",542,184,39,145,199,77,145,31,114
"2011","North Devon 004A","E01020090","Total",676,252,15,237,184,62,155,32,123
"2011","North Devon 004B","E01020108","Total",964,315,18,297,235,91,223,33,190
"2011","North Devon 004C","E01020109","Total",620,228,10,218,166,52,160,27,133
"2011","North Devon 005A","E01020089","Total",960,305,19,286,271,94,229,36,193
"2011","North Devon 005B","E01020091","Total",574,222,7,215,134,46,151,16,135
"2011","North Devon 005C","E01020092","Total",634,300,0,300,125,41,192,10,182
"2011","North Devon 005D","E01020093","Total",708,292,13,279,157,71,228,28,200
"2011","North Devon 005E","E01020110","Total",841,226,16,210,329,186,171,38,133
"2011","North Devon 006A","E01020088","Total",819,232,13,219,236,72,229,48,181
"2011","North Devon 006B","E01020120","Total",737,235,6,229,226,73,159,28,131
"2011","North Devon 006C","E01020127","Total",717,183,6,177,201,69,164,30,134
"2011","North Devon 007A","E01020132","Total",827,310,11,299,187,65,253,28,225
"2011","North Devon 007B","E01020133","Total",624,184,9,175,169,72,122,15,107
"2011","North Devon 007C","E01020134","Total",495,161,26,135,154,59,141,25,116
"2011","North Devon 007D","E01020139","Total",625,238,21,217,159,64,186,29,157
"2011","North Devon 008A","E01020094","Total",1012,528,28,500,133,59,381,18,363
"2011","North Devon 008B","E01020095","Total",658,202,29,173,199,90,169,26,143
"2011","North Devon 008C","E01020140","Total",516,209,10,199,121,41,148,16,132
"2011","North Devon 008D","E01020141","Total",710,234,73,161,279,126,183,52,131
"2011","North Devon 009A","E01020096","Total",864,321,25,296,162,73,265,26,239
"2011","North Devon 009B","E01020123","Total",601,260,28,232,160,52,186,32,154
"2011","North Devon 009C","E01020124","Total",592,229,11,218,118,39,151,14,137
"2011","North Devon 009D","E01020125","Total",597,261,5,256,103,35,153,7,146
"2011","North Devon 010A","E01020102","Total",654,140,17,123,257,98,131,34,97
"2011","North Devon 010B","E01020103","Total",569,200,57,143,237,100,168,48,120
"2011","North Devon 010C","E01020104","Total",577,142,57,85,236,122,140,48,92
"2011","North Devon 010D","E01020128","Total",522,179,1,178,128,32,122,14,108
"2011","North Devon 010E","E01020129","Total",523,204,20,184,150,59,137,24,113
"2011","North Devon 010F","E01020130","Total",687,174,20,154,205,81,149,21,128
"2011","North Devon 011A","E01020105","Total",616,233,22,211,180,71,153,26,127
"2011","North Devon 011B","E01020106","Total",513,257,1,256,81,30,149,9,140
"2011","North Devon 011C","E01020107","Total",708,336,11,325,148,45,228,29,199
"2011","North Devon 011D","E01020119","Total",673,276,9,267,131,40,170,17,153
"2011","North Devon 012A","E01020084","Total",672,259,25,234,180,67,185,38,147
"2011","North Devon 012B","E01020085","Total",628,151,18,133,239,97,110,26,84
"2011","North Devon 012C","E01020086","Total",638,247,10,237,161,52,147,20,127
"2011","North Devon 012D","E01020121","Total",794,244,12,232,246,80,198,28,170
"2011","North Devon 012E","E01020122","Total",694,237,9,228,171,50,169,19,150
"2011","North Devon 013A","E01020097","Total",913,284,13,271,231,72,239,35,204
"2011","North Devon 013B","E01020131","Total",882,271,19,252,220,72,212,30,182
"2011","North Devon 013C","E01020135","Total",697,281,35,246,201,72,209,33,176
"2011","North Devon 013D","E01020136","Total",775,289,17,272,193,74,237,33,204
"2011","North Devon 013E","E01020137","Total",699,240,25,215,172,71,201,29,172
"2011","North Devon 014A","E01020087","Total",840,322,4,318,164,41,259,33,226
"2011","North Devon 014B","E01020098","Total",921,332,13,319,211,54,266,42,224
"2011","North Devon 014C","E01020138","Total",982,351,18,333,230,73,270,35,235
"2011","South Hams 001A","E01020144","Total",616,90,11,79,231,91,107,24,83
"2011","South Hams 001B","E01020145","Total",749,229,18,211,196,65,185,29,156
"2011","South Hams 001C","E01020146","Total",525,103,4,99,134,53,96,10,86
"2011","South Hams 001D","E01020149","Total",527,152,13,139,132,51,134,21,113
"2011","South Hams 002A","E01020148","Total",483,157,13,144,127,41,131,21,110
"2011","South Hams 002B","E01020157","Total",941,289,13,276,266,68,228,49,179
"2011","South Hams 002C","E01020160","Total",754,202,17,185,235,75,189,32,157
"2011","South Hams 002D","E01020176","Total",505,182,6,176,114,31,134,21,113
"2011","South Hams 002E","E01020177","Total",602,250,21,229,157,54,197,26,171
"2011","South Hams 003A","E01020180","Total",834,294,31,263,227,70,267,41,226
"2011","South Hams 003B","E01020181","Total",778,352,23,329,193,53,237,41,196
"2011","South Hams 003C","E01020182","Total",624,185,26,159,199,62,189,40,149
"2011","South Hams 003D","E01020183","Total",766,308,19,289,135,40,239,19,220
"2011","South Hams 003E","E01020184","Total",846,375,17,358,181,50,309,30,279
"2011","South Hams 004A","E01020153","Total",615,281,7,274,84,24,151,18,133
"2011","South Hams 004B","E01020156","Total",836,354,9,345,180,53,235,26,209
"2011","South Hams 004C","E01020170","Total",942,386,17,369,224,61,300,43,257
"2011","South Hams 004D","E01020188","Total",837,265,12,253,195,57,208,33,175
"2011","South Hams 005A","E01020161","Total",1074,459,35,424,301,132,341,55,286
"2011","South Hams 005B","E01020162","Total",644,131,8,123,242,77,154,38,116
"2011","South Hams 005C","E01020163","Total",679,154,8,146,268,75,127,31,96
"2011","South Hams 005D","E01020164","Total",643,193,14,179,222,68,171,36,135
"2011","South Hams 005E","E01020165","Total",621,121,13,108,228,76,114,26,88
"2011","South Hams 005F","E01020166","Total",577,164,2,162,173,46,145,28,117
"2011","South Hams 005G","E01020167","Total",503,126,9,117,196,46,100,26,74
"2011","South Hams 006A","E01020142","Total",973,300,13,287,240,99,227,33,194
"2011","South Hams 006B","E01020143","Total",933,266,18,248,248,77,216,33,183
"2011","South Hams 006C","E01020150","Total",749,275,13,262,185,47,213,35,178
"2011","South Hams 007A","E01020151","Total",796,358,10,348,106,46,203,13,190
"2011","South Hams 007B","E01020152","Total",857,391,15,376,68,31,260,9,251
"2011","South Hams 007C","E01020154","Total",500,122,16,106,191,60,126,34,92
"2011","South Hams 007D","E01020155","Total",482,184,22,162,124,44,151,29,122
"2011","South Hams 008A","E01020147","Total",869,306,15,291,167,52,218,27,191
"2011","South Hams 008B","E01020158","Total",745,275,11,264,197,63,196,22,174
"2011","South Hams 008C","E01020159","Total",597,174,5,169,155,54,146,29,117
"2011","South Hams 008D","E01020190","Total",900,368,17,351,221,74,241,31,210
"2011","South Hams 009A","E01020171","Total",853,395,8,387,151,36,230,28,202
"2011","South Hams 009B","E01020185","Total",594,258,4,254,124,34,161,23,138
"2011","South Hams 009C","E01020186","Total",691,343,7,336,101,27,170,16,154
"2011","South Hams 009D","E01020187","Total",736,249,19,230,206,77,185,30,155
"2011","South Hams 010A","E01020168","Total",924,427,26,401,198,79,276,31,245
"2011","South Hams 010B","E01020169","Total",1067,342,24,318,279,97,259,33,226
"2011","South Hams 010C","E01020189","Total",989,440,18,422,209,63,350,35,315
"2011","South Hams 011A","E01020174","Total",724,330,11,319,129,35,186,26,160
"2011","South Hams 011B","E01020175","Total",926,454,15,439,147,42,267,31,236
"2011","South Hams 011C","E01020178","Total",900,437,15,422,160,47,259,29,230
"2011","South Hams 012A","E01020172","Total",855,372,12,360,146,62,234,16,218
"2011","South Hams 012B","E01020173","Total",800,364,10,354,104,36,203,12,191
"2011","South Hams 012C","E01020179","Total",877,408,9,399,140,41,247,18,229
"2011","Teignbridge 001A","E01020243","Total",498,147,5,142,125,48,107,22,85
"2011","Teignbridge 001B","E01020262","Total",506,158,4,154,96,21,126,16,110
"2011","Teignbridge 001C","E01020263","Total",691,331,4,327,114,40,231,16,215
"2011","Teignbridge 001D","E01020274","Total",536,127,3,124,136,36,107,16,91
"2011","Teignbridge 002A","E01020240","Total",671,243,4,239,155,61,179,20,159
"2011","Teignbridge 002B","E01020241","Total",738,196,10,186,211,66,159,26,133
"2011","Teignbridge 002C","E01020242","Total",587,161,8,153,204,76,104,19,85
"2011","Teignbridge 002D","E01020244","Total",640,239,19,220,168,55,218,30,188
"2011","Teignbridge 002E","E01020245","Total",696,221,9,212,174,47,160,24,136
"2011","Teignbridge 003A","E01020205","Total",612,220,1,219,132,34,154,21,133
"2011","Teignbridge 003B","E01020258","Total",727,245,16,229,179,49,193,24,169
"2011","Teignbridge 003C","E01020259","Total",491,128,5,123,97,22,101,10,91
"2011","Teignbridge 003D","E01020273","Total",595,231,10,221,154,45,141,18,123
"2011","Teignbridge 004A","E01020203","Total",794,394,6,388,151,51,221,15,206
"2011","Teignbridge 004B","E01020206","Total",710,259,14,245,171,64,184,22,162
"2011","Teignbridge 004C","E01020220","Total",542,184,12,172,161,49,162,26,136
"2011","Teignbridge 004D","E01020221","Total",710,188,15,173,221,90,154,36,118
"2011","Teignbridge 004E","E01020222","Total",539,146,9,137,162,52,115,13,102
"2011","Teignbridge 004F","E01020223","Total",743,231,15,216,195,62,183,31,152
"2011","Teignbridge 005A","E01020229","Total",750,345,15,330,138,45,227,28,199
"2011","Teignbridge 005B","E01020230","Total",740,272,14,258,152,47,216,26,190
"2011","Teignbridge 005C","E01020231","Total",639,266,7,259,155,47,178,23,155
"2011","Teignbridge 005D","E01020232","Total",630,209,25,184,233,76,172,48,124
"2011","Teignbridge 006A","E01020228","Total",945,496,18,478,123,56,355,16,339
"2011","Teignbridge 006B","E01020233","Total",832,420,9,411,126,42,246,20,226
"2011","Teignbridge 006C","E01020234","Total",598,222,24,198,176,63,184,35,149
"2011","Teignbridge 006D","E01020235","Total",841,396,22,374,171,59,261,27,234
"2011","Teignbridge 007A","E01020202","Total",734,394,7,387,116,39,241,14,227
"2011","Teignbridge 007B","E01020204","Total",624,133,33,100,246,104,131,33,98
"2011","Teignbridge 007C","E01020236","Total",539,216,6,210,133,24,146,15,131
"2011","Teignbridge 007D","E01020237","Total",637,188,10,178,187,58,137,22,115
"2011","Teignbridge 008A","E01020265","Total",749,306,14,292,167,63,202,21,181
"2011","Teignbridge 008B","E01020266","Total",671,228,11,217,178,63,174,20,154
"2011","Teignbridge 008C","E01020267","Total",646,282,10,272,152,53,180,20,160
"2011","Teignbridge 008D","E01020268","Total",641,327,11,316,105,28,194,18,176
"2011","Teignbridge 008E","E01020270","Total",716,258,17,241,190,72,178,34,144
"2011","Teignbridge 009A","E01020250","Total",695,247,10,237,161,53,230,33,197
"2011","Teignbridge 009B","E01020252","Total",639,238,17,221,172,80,207,39,168
"2011","Teignbridge 009C","E01020253","Total",593,107,9,98,254,74,102,37,65
"2011","Teignbridge 009D","E01020254","Total",557,185,21,164,166,55,146,29,117
"2011","Teignbridge 009E","E01020255","Total",568,214,14,200,144,45,189,31,158
"2011","Teignbridge 009F","E01020257","Total",501,163,5,158,131,48,141,19,122
"2011","Teignbridge 010A","E01020264","Total",677,295,19,276,119,42,227,17,210
"2011","Teignbridge 010B","E01020269","Total",1158,626,23,603,122,58,478,20,458
"2011","Teignbridge 010C","E01020271","Total",674,245,31,214,200,68,208,33,175
"2011","Teignbridge 010D","E01020272","Total",759,257,67,190,283,120,247,76,171
"2011","Teignbridge 011A","E01020200","Total",521,212,6,206,86,30,132,15,117
"2011","Teignbridge 011B","E01020201","Total",695,331,12,319,100,36,193,15,178
"2011","Teignbridge 011C","E01020251","Total",576,138,9,129,173,58,124,22,102
"2011","Teignbridge 011D","E01020260","Total",628,306,15,291,98,36,172,13,159
"2011","Teignbridge 011E","E01020261","Total",526,213,9,204,125,47,123,19,104
"2011","Teignbridge 012A","E01020208","Total",523,207,28,179,160,49,163,28,135
"2011","Teignbridge 012B","E01020209","Total",627,195,24,171,192,90,167,25,142
"2011","Teignbridge 012C","E01020210","Total",499,169,2,167,97,26,119,16,103
"2011","Teignbridge 012D","E01020219","Total",845,213,24,189,277,102,182,44,138
"2011","Teignbridge 013A","E01020191","Total",431,127,2,125,98,41,107,16,91
"2011","Teignbridge 013B","E01020194","Total",589,162,12,150,191,57,121,25,96
"2011","Teignbridge 013C","E01020207","Total",427,107,7,100,153,51,95,20,75
"2011","Teignbridge 013D","E01020256","Total",602,186,10,176,154,61,140,15,125
"2011","Teignbridge 014A","E01020211","Total",675,272,48,224,211,102,243,47,196
"2011","Teignbridge 014B","E01020217","Total",879,335,20,315,182,82,294,32,262
"2011","Teignbridge 014C","E01020218","Total",746,241,34,207,173,87,210,24,186
"2011","Teignbridge 014D","E01020224","Total",521,111,19,92,185,91,108,26,82
"2011","Teignbridge 015A","E01020216","Total",675,258,48,210,240,95,200,50,150
"2011","Teignbridge 015B","E01020225","Total",603,193,20,173,164,69,164,14,150
"2011","Teignbridge 015C","E01020226","Total",469,146,6,140,117,22,107,20,87
"2011","Teignbridge 015D","E01020227","Total",643,260,15,245,160,54,193,27,166
"2011","Teignbridge 016A","E01020212","Total",497,180,34,146,154,46,166,35,131
"2011","Teignbridge 016B","E01020213","Total",637,251,26,225,150,65,185,26,159
"2011","Teignbridge 016C","E01020214","Total",674,272,12,260,150,48,193,29,164
"2011","Teignbridge 016D","E01020215","Total",575,225,0,225,132,37,140,16,124
"2011","Teignbridge 017A","E01020195","Total",716,229,11,218,204,64,184,27,157
"2011","Teignbridge 017B","E01020196","Total",794,293,30,263,201,67,240,51,189
"2011","Teignbridge 017C","E01020197","Total",543,210,11,199,109,44,157,29,128
"2011","Teignbridge 017D","E01020198","Total",618,192,25,167,195,75,194,38,156
"2011","Teignbridge 017E","E01020199","Total",711,224,28,196,214,81,182,26,156
"2011","Teignbridge 018A","E01020246","Total",460,123,9,114,126,39,101,20,81
"2011","Teignbridge 018B","E01020247","Total",689,273,26,247,190,71,204,37,167
"2011","Teignbridge 018C","E01020248","Total",701,250,12,238,173,53,184,21,163
"2011","Teignbridge 018D","E01020249","Total",612,259,6,253,126,33,184,19,165
"2011","Teignbridge 019A","E01020192","Total",648,241,7,234,156,51,175,24,151
"2011","Teignbridge 019B","E01020193","Total",571,165,10,155,188,53,128,29,99
"2011","Teignbridge 019C","E01020238","Total",538,214,9,205,130,41,160,14,146
"2011","Teignbridge 019D","E01020239","Total",540,203,10,193,130,42,139,24,115
"2011","Torridge 001A","E01020275","Total",672,273,28,245,127,59,212,27,185
"2011","Torridge 001B","E01020276","Total",682,324,12,312,142,47,224,27,197
"2011","Torridge 001C","E01020297","Total",765,371,41,330,185,82,276,25,251
"2011","Torridge 001D","E01020299","Total",908,416,16,400,136,47,248,18,230
"2011","Torridge 002A","E01020298","Total",940,481,13,468,167,67,258,21,237
"2011","Torridge 002B","E01020300","Total",738,302,7,295,145,41,212,17,195
"2011","Torridge 002C","E01020310","Total",1089,545,20,525,147,55,318,19,299
"2011","Torridge 003A","E01020280","Total",1166,444,55,389,255,130,344,42,302
"2011","Torridge 003B","E01020281","Total",794,273,8,265,205,62,210,26,184
"2011","Torridge 003C","E01020282","Total",802,386,28,358,169,68,295,33,262
"2011","Torridge 004A","E01020277","Total",859,392,75,317,278,122,297,70,227
"2011","Torridge 004B","E01020278","Total",637,172,13,159,194,70,152,29,123
"2011","Torridge 004C","E01020279","Total",993,305,63,242,300,151,219,66,153
"2011","Torridge 004D","E01020283","Total",653,261,18,243,141,38,199,20,179
"2011","Torridge 004E","E01020284","Total",827,255,42,213,262,112,222,51,171
"2011","Torridge 004F","E01020285","Total",824,309,74,235,292,129,224,49,175
"2011","Torridge 005A","E01020288","Total",709,240,10,230,158,46,197,29,168
"2011","Torridge 005B","E01020292","Total",646,244,13,231,151,52,179,30,149
"2011","Torridge 005C","E01020295","Total",669,236,9,227,171,54,161,21,140
"2011","Torridge 005D","E01020296","Total",616,212,11,201,155,49,145,30,115
"2011","Torridge 006A","E01020304","Total",739,291,34,257,209,78,226,38,188
"2011","Torridge 006B","E01020305","Total",524,200,26,174,122,49,159,22,137
"2011","Torridge 006C","E01020306","Total",521,181,10,171,155,56,120,17,103
"2011","Torridge 006D","E01020307","Total",654,237,43,194,239,90,173,31,142
"2011","Torridge 007A","E01020287","Total",650,222,8,214,140,26,170,25,145
"2011","Torridge 007B","E01020303","Total",754,322,13,309,150,47,210,30,180
"2011","Torridge 007C","E01020308","Total",703,222,3,219,164,52,184,26,158
"2011","Torridge 007D","E01020311","Total",940,360,18,342,201,80,255,37,218
"2011","Torridge 008A","E01020291","Total",640,183,10,173,171,50,162,22,140
"2011","Torridge 008B","E01020293","Total",938,314,24,290,244,83,276,44,232
"2011","Torridge 008C","E01020294","Total",761,329,21,308,187,74,222,27,195
"2011","Torridge 008D","E01020302","Total",680,226,17,209,174,51,175,32,143
"2011","Torridge 008E","E01020309","Total",663,192,11,181,166,43,177,25,152
"2011","Torridge 009A","E01020286","Total",670,215,12,203,174,53,177,29,148
"2011","Torridge 009B","E01020289","Total",659,252,4,248,122,32,187,13,174
"2011","Torridge 009C","E01020290","Total",711,271,7,264,166,49,222,34,188
"2011","Torridge 009D","E01020301","Total",790,282,11,271,200,59,203,29,174
"2011","West Devon 001A","E01020320","Total",706,263,7,256,141,48,202,31,171
"2011","West Devon 001B","E01020321","Total",905,282,20,262,245,86,242,44,198
"2011","West Devon 001C","E01020322","Total",798,265,12,253,202,72,229,33,196
"2011","West Devon 001D","E01020326","Total",863,286,19,267,238,96,245,47,198
"2011","West Devon 002A","E01020327","Total",807,285,25,260,205,90,183,24,159
"2011","West Devon 002B","E01020328","Total",934,269,45,224,335,157,219,59,160
"2011","West Devon 002C","E01020329","Total",671,245,6,239,134,35,192,27,165
"2011","West Devon 002D","E01020330","Total",830,355,35,320,202,81,268,33,235
"2011","West Devon 003A","E01020318","Total",685,271,11,260,144,47,201,23,178
"2011","West Devon 003B","E01020319","Total",679,198,7,191,169,50,165,28,137
"2011","West Devon 003C","E01020323","Total",642,184,20,164,168,57,184,34,150
"2011","West Devon 003D","E01020339","Total",704,220,13,207,182,53,165,24,141
"2011","West Devon 004A","E01020314","Total",662,227,10,217,156,37,187,27,160
"2011","West Devon 004B","E01020325","Total",643,163,6,157,184,57,139,27,112
"2011","West Devon 004C","E01020331","Total",628,195,14,181,175,56,156,33,123
"2011","West Devon 004D","E01020340","Total",706,220,11,209,185,49,192,23,169
"2011","West Devon 005A","E01020332","Total",932,360,21,339,161,54,247,21,226
"2011","West Devon 005B","E01020333","Total",811,282,18,264,216,80,212,39,173
"2011","West Devon 005C","E01020334","Total",840,303,29,274,222,76,219,38,181
"2011","West Devon 005D","E01020335","Total",668,324,6,318,132,34,199,11,188
"2011","West Devon 005E","E01020336","Total",606,292,4,288,123,28,146,15,131
"2011","West Devon 005F","E01020337","Total",581,265,13,252,131,54,207,26,181
"2011","West Devon 005G","E01020338","Total",1029,353,35,318,320,138,265,39,226
"2011","West Devon 006A","E01020317","Total",648,265,9,256,134,43,193,19,174
"2011","West Devon 006B","E01020324","Total",661,225,6,219,137,43,182,26,156
"2011","West Devon 006C","E01020341","Total",668,258,6,252,139,37,175,21,154
"2011","West Devon 006D","E01020342","Total",653,228,18,210,188,69,203,52,151
"2011","West Devon 007A","E01020312","Total",714,293,6,287,123,24,212,20,192
"2011","West Devon 007B","E01020313","Total",632,245,14,231,159,67,205,26,179
"2011","West Devon 007C","E01020315","Total",645,243,14,229,168,62,207,34,173
"2011","West Devon 007D","E01020316","Total",774,290,10,280,215,68,177,25,152
"2011","Christchurch 001A","E01020343","Total",641,250,6,244,137,47,180,21,159
"2011","Christchurch 001B","E01020344","Total",562,112,16,96,206,88,119,27,92
"2011","Christchurch 001C","E01020345","Total",528,192,8,184,117,39,155,22,133
"2011","Christchurch 001D","E01020365","Total",709,319,4,315,129,39,212,20,192
"2011","Christchurch 002A","E01020351","Total",511,180,13,167,155,57,141,25,116
"2011","Christchurch 002B","E01020352","Total",518,185,5,180,170,48,142,23,119
"2011","Christchurch 002C","E01020353","Total",674,271,21,250,213,70,218,34,184
"2011","Christchurch 002D","E01020359","Total",496,149,21,128,189,66,136,36,100
"2011","Christchurch 002E","E01020366","Total",906,407,5,402,217,52,247,27,220
"2011","Christchurch 003A","E01020349","Total",1046,737,8,729,81,30,408,11,397
"2011","Christchurch 003B","E01020350","Total",919,629,4,625,79,16,331,12,319
"2011","Christchurch 003C","E01020357","Total",867,335,19,316,232,77,236,37,199
"2011","Christchurch 003D","E01020358","Total",671,346,3,343,128,31,195,12,183
"2011","Christchurch 004A","E01020369","Total",630,345,10,335,103,35,191,13,178
"2011","Christchurch 004B","E01020370","Total",649,225,9,216,181,72,167,22,145
"2011","Christchurch 004C","E01020371","Total",742,439,4,435,98,28,242,15,227
"2011","Christchurch 004D","E01020372","Total",606,305,6,299,101,35,171,16,155
"2011","Christchurch 005A","E01020346","Total",704,283,35,248,189,64,247,40,207
"2011","Christchurch 005B","E01020347","Total",740,323,56,267,206,93,307,58,249
"2011","Christchurch 005C","E01020348","Total",633,215,35,180,211,67,216,49,167
"2011","Christchurch 005D","E01020363","Total",499,143,23,120,163,54,139,40,99
"2011","Christchurch 006A","E01020360","Total",654,234,15,219,201,83,179,24,155
"2011","Christchurch 006B","E01020361","Total",647,183,19,164,228,99,154,30,124
"2011","Christchurch 006C","E01020364","Total",773,335,24,311,175,81,217,21,196
"2011","Christchurch 006D","E01020367","Total",913,372,18,354,181,61,238,27,211
"2011","Christchurch 006E","E01020368","Total",1145,503,22,481,246,94,381,50,331
"2011","Christchurch 007A","E01020354","Total",719,322,17,305,151,68,212,22,190
"2011","Christchurch 007B","E01020355","Total",913,540,7,533,117,42,276,13,263
"2011","Christchurch 007C","E01020356","Total",782,423,8,415,102,33,236,15,221
"2011","Christchurch 007D","E01020362","Total",678,347,7,340,119,29,206,14,192
"2011","East Dorset 001A","E01020373","Total",495,123,16,107,196,79,93,23,70
"2011","East Dorset 001B","E01020374","Total",646,242,5,237,159,50,161,16,145
"2011","East Dorset 001C","E01020389","Total",851,233,16,217,247,76,203,43,160
"2011","East Dorset 001D","E01020397","Total",613,196,8,188,153,58,172,26,146
"2011","East Dorset 002A","E01020416","Total",674,156,13,143,218,79,120,28,92
"2011","East Dorset 002B","E01020417","Total",447,141,4,137,119,41,98,15,83
"2011","East Dorset 002C","E01020418","Total",673,368,4,364,115,37,194,18,176
"2011","East Dorset 002D","E01020419","Total",776,292,4,288,227,84,187,27,160
"2011","East Dorset 002E","E01020420","Total",526,188,5,183,166,55,111,18,93
"2011","East Dorset 003A","E01020411","Total",422,144,14,130,127,59,118,17,101
"2011","East Dorset 003B","E01020412","Total",567,176,39,137,218,92,160,41,119
"2011","East Dorset 003C","E01020413","Total",571,192,6,186,188,74,118,17,101
"2011","East Dorset 003D","E01020414","Total",808,308,10,298,264,98,183,20,163
"2011","East Dorset 003E","E01020415","Total",597,220,9,211,178,41,128,17,111
"2011","East Dorset 004A","E01020403","Total",628,287,7,280,120,24,148,13,135
"2011","East Dorset 004B","E01020404","Total",689,305,11,294,121,34,200,26,174
"2011","East Dorset 004C","E01020405","Total",675,307,6,301,105,29,185,9,176
"2011","East Dorset 004D","E01020406","Total",1048,548,6,542,123,33,272,18,254
"2011","East Dorset 005A","E01020396","Total",450,128,2,126,110,32,95,16,79
"2011","East Dorset 005B","E01020398","Total",913,273,10,263,221,56,203,27,176
"2011","East Dorset 005C","E01020409","Total",482,119,4,115,150,40,104,19,85
"2011","East Dorset 005D","E01020410","Total",528,148,14,134,157,44,128,31,97
"2011","East Dorset 006A","E01020421","Total",529,208,8,200,147,50,140,27,113
"2011","East Dorset 006B","E01020422","Total",867,534,14,520,100,43,327,13,314
"2011","East Dorset 006C","E01020423","Total",637,289,9,280,127,25,177,17,160
"2011","East Dorset 006D","E01020424","Total",643,295,10,285,114,33,202,23,179
"2011","East Dorset 006E","E01020425","Total",816,449,14,435,134,44,286,23,263
"2011","East Dorset 007A","E01020377","Total",631,186,3,183,198,49,152,27,125
"2011","East Dorset 007B","E01020379","Total",642,257,8,249,152,51,188,20,168
"2011","East Dorset 007C","E01020380","Total",447,168,2,166,108,24,91,5,86
"2011","East Dorset 007D","E01020381","Total",503,174,4,170,122,31,108,11,97
"2011","East Dorset 008A","E01020390","Total",732,439,10,429,75,28,222,13,209
"2011","East Dorset 008B","E01020391","Total",668,348,10,338,100,22,189,20,169
"2011","East Dorset 008C","E01020392","Total",786,481,6,475,98,37,311,18,293
"2011","East Dorset 008D","E01020393","Total",563,126,58,68,253,118,131,48,83
"2011","East Dorset 008E","E01020394","Total",820,449,30,419,137,52,321,31,290
"2011","East Dorset 009A","E01020375","Total",642,272,6,266,131,52,169,15,154
"2011","East Dorset 009B","E01020376","Total",483,209,7,202,108,28,139,18,121
"2011","East Dorset 009C","E01020378","Total",634,189,6,183,173,50,153,28,125
"2011","East Dorset 009D","E01020407","Total",518,212,1,211,106,37,138,11,127
"2011","East Dorset 009E","E01020408","Total",480,165,3,162,102,23,130,17,113
"2011","East Dorset 010A","E01020426","Total",806,338,9,329,191,61,230,28,202
"2011","East Dorset 010B","E01020427","Total",725,309,30,279,199,80,234,25,209
"2011","East Dorset 010C","E01020428","Total",1095,527,14,513,157,49,364,24,340
"2011","East Dorset 010D","E01020429","Total",796,283,14,269,194,79,194,24,170
"2011","East Dorset 011A","E01020395","Total",904,530,9,521,93,19,285,14,271
"2011","East Dorset 011B","E01020399","Total",1014,356,17,339,287,96,250,41,209
"2011","East Dorset 011C","E01020400","Total",671,277,8,269,135,37,198,25,173
"2011","East Dorset 011D","E01020401","Total",722,412,3,409,111,31,220,25,195
"2011","East Dorset 011E","E01020402","Total",633,238,0,238,152,45,153,13,140
"2011","East Dorset 012A","E01020382","Total",628,165,14,151,186,55,132,21,111
"2011","East Dorset 012B","E01020383","Total",741,286,3,283,175,44,206,20,186
"2011","East Dorset 012C","E01020384","Total",638,140,15,125,279,96,129,40,89
"2011","East Dorset 012D","E01020385","Total",481,132,12,120,166,54,109,24,85
"2011","East Dorset 012E","E01020386","Total",477,143,3,140,138,39,92,18,74
"2011","East Dorset 012F","E01020387","Total",470,205,2,203,111,29,118,20,98
"2011","East Dorset 012G","E01020388","Total",643,216,24,192,211,72,159,23,136
"2011","North Dorset 001A","E01020443","Total",1106,305,40,265,312,127,285,47,238
"2011","North Dorset 001B","E01020447","Total",846,410,19,391,149,50,287,21,266
"2011","North Dorset 001C","E01020463","Total",756,293,11,282,190,59,189,20,169
"2011","North Dorset 001D","E01020464","Total",691,288,3,285,153,49,168,17,151
"2011","North Dorset 002A","E01020440","Total",826,288,8,280,165,54,212,17,195
"2011","North Dorset 002B","E01020450","Total",956,264,27,237,301,123,205,44,161
"2011","North Dorset 002D","E01020462","Total",767,266,5,261,176,54,198,27,171
"2011","North Dorset 002E","E01033156","Total",656,118,12,106,257,105,122,32,90
"2011","North Dorset 002F","E01033158","Total",564,211,10,201,151,52,131,23,108
"2011","North Dorset 003A","E01020454","Total",968,396,20,376,221,83,305,32,273
"2011","North Dorset 003B","E01020455","Total",780,212,15,197,251,117,149,27,122
"2011","North Dorset 003C","E01020456","Total",761,193,24,169,226,90,158,25,133
"2011","North Dorset 003D","E01020457","Total",726,315,7,308,113,35,214,17,197
"2011","North Dorset 004A","E01020433","Total",745,230,12,218,197,69,180,28,152
"2011","North Dorset 004B","E01020434","Total",788,314,13,301,172,64,215,21,194
"2011","North Dorset 004C","E01020449","Total",905,414,10,404,166,52,269,23,246
"2011","North Dorset 004D","E01020458","Total",940,323,12,311,225,84,217,30,187
"2011","North Dorset 004E","E01020459","Total",1167,466,39,427,298,126,356,41,315
"2011","North Dorset 005A","E01020444","Total",752,269,20,249,179,64,196,28,168
"2011","North Dorset 005B","E01020445","Total",513,200,9,191,121,43,123,15,108
"2011","North Dorset 005C","E01020446","Total",652,281,11,270,134,46,179,25,154
"2011","North Dorset 005D","E01020460","Total",842,308,11,297,184,57,216,29,187
"2011","North Dorset 006A","E01020442","Total",888,287,10,277,204,63,227,33,194
"2011","North Dorset 006B","E01020452","Total",826,254,21,233,219,94,228,27,201
"2011","North Dorset 006C","E01020453","Total",716,231,12,219,184,61,188,26,162
"2011","North Dorset 006E","E01033154","Total",469,31,9,22,299,178,53,26,27
"2011","North Dorset 006F","E01033159","Total",429,98,5,93,134,77,74,13,61
"2011","North Dorset 007A","E01020435","Total",782,200,11,189,184,80,176,30,146
"2011","North Dorset 007B","E01020436","Total",809,183,27,156,285,125,153,52,101
"2011","North Dorset 007C","E01020437","Total",774,271,29,242,198,76,219,40,179
"2011","North Dorset 007D","E01020438","Total",1086,479,30,449,176,83,345,27,318
"2011","North Dorset 007E","E01020439","Total",987,316,26,290,284,124,263,45,218
"2011","North Dorset 008A","E01020430","Total",618,230,8,222,143,48,162,25,137
"2011","North Dorset 008B","E01020431","Total",438,145,9,136,117,35,114,23,91
"2011","North Dorset 008C","E01020432","Total",539,176,11,165,128,44,132,23,109
"2011","North Dorset 008D","E01020441","Total",786,246,18,228,198,62,188,28,160
"2011","North Dorset 008E","E01020448","Total",816,267,17,250,201,63,171,26,145
"2011","Purbeck 001A","E01020465","Total",883,299,14,285,206,68,234,27,207
"2011","Purbeck 001B","E01020469","Total",840,291,9,282,237,78,228,38,190
"2011","Purbeck 001C","E01020470","Total",740,257,6,251,184,48,171,26,145
"2011","Purbeck 002A","E01020471","Total",537,134,31,103,224,88,107,31,76
"2011","Purbeck 002B","E01020472","Total",604,235,25,210,173,53,174,23,151
"2011","Purbeck 002C","E01020473","Total",640,228,25,203,158,70,169,21,148
"2011","Purbeck 002D","E01020474","Total",746,290,10,280,162,40,190,22,168
"2011","Purbeck 002E","E01020475","Total",845,274,13,261,242,81,209,31,178
"2011","Purbeck 003A","E01020476","Total",544,218,5,213,113,40,155,17,138
"2011","Purbeck 003B","E01020477","Total",589,193,21,172,198,65,156,29,127
"2011","Purbeck 003C","E01020485","Total",745,376,27,349,121,41,280,18,262
"2011","Purbeck 003D","E01020486","Total",643,301,11,290,122,36,219,23,196
"2011","Purbeck 003E","E01020487","Total",516,153,10,143,150,55,110,24,86
"2011","Purbeck 003F","E01020488","Total",653,258,13,245,158,71,213,30,183
"2011","Purbeck 004A","E01020489","Total",581,163,6,157,158,68,149,18,131
"2011","Purbeck 004B","E01020490","Total",717,229,9,220,146,56,165,22,143
"2011","Purbeck 004C","E01020491","Total",669,233,15,218,178,74,168,29,139
"2011","Purbeck 004D","E01020492","Total",538,244,11,233,105,27,161,17,144
"2011","Purbeck 004E","E01020493","Total",808,141,39,102,397,184,188,65,123
"2011","Purbeck 005A","E01020466","Total",794,332,8,324,152,45,232,33,199
"2011","Purbeck 005B","E01020467","Total",781,287,16,271,169,45,211,25,186
"2011","Purbeck 005C","E01020468","Total",666,284,7,277,108,33,181,21,160
"2011","Purbeck 006A","E01020478","Total",477,192,3,189,114,39,144,19,125
"2011","Purbeck 006B","E01020479","Total",648,370,7,363,67,32,233,8,225
"2011","Purbeck 006C","E01020480","Total",730,404,2,402,82,19,225,9,216
"2011","Purbeck 006D","E01020481","Total",748,308,11,297,118,44,205,20,185
"2011","Purbeck 006E","E01020482","Total",778,311,23,288,154,65,229,20,209
"2011","Purbeck 006F","E01020483","Total",498,165,13,152,156,44,137,27,110
"2011","Purbeck 006G","E01020484","Total",625,253,15,238,145,38,200,28,172
"2011","West Dorset 001A","E01020542","Total",665,317,10,307,114,37,185,18,167
"2011","West Dorset 001B","E01020543","Total",614,240,36,204,197,76,190,38,152
"2011","West Dorset 001C","E01020544","Total",821,413,7,406,118,40,241,15,226
"2011","West Dorset 001E","E01020546","Total",582,259,7,252,81,26,170,11,159
"2011","West Dorset 001F","E01020547","Total",510,177,9,168,137,54,123,19,104
"2011","West Dorset 001H","E01032642","Total",1021,493,16,477,193,67,293,29,264
"2011","West Dorset 002A","E01020497","Total",811,323,8,315,208,53,216,24,192
"2011","West Dorset 002B","E01020508","Total",840,317,11,306,177,38,206,22,184
"2011","West Dorset 002C","E01020541","Total",863,299,10,289,206,62,218,24,194
"2011","West Dorset 002D","E01020550","Total",712,312,5,307,144,42,209,16,193
"2011","West Dorset 003A","E01020494","Total",490,167,6,161,137,40,133,32,101
"2011","West Dorset 003B","E01020495","Total",665,322,16,306,138,55,187,25,162
"2011","West Dorset 003C","E01020496","Total",792,436,20,416,144,50,273,19,254
"2011","West Dorset 003D","E01020506","Total",771,298,7,291,151,45,217,18,199
"2011","West Dorset 003E","E01020530","Total",785,269,11,258,164,45,197,28,169
"2011","West Dorset 003F","E01020534","Total",905,280,23,257,213,92,232,39,193
"2011","West Dorset 004A","E01020509","Total",1146,409,17,392,315,90,276,38,238
"2011","West Dorset 004B","E01020510","Total",901,348,30,318,208,85,246,37,209
"2011","West Dorset 004C","E01020529","Total",974,288,12,276,237,83,234,35,199
"2011","West Dorset 004D","E01020539","Total",856,266,6,260,211,62,203,33,170
"2011","West Dorset 004E","E01020540","Total",1048,341,13,328,272,87,243,30,213
"2011","West Dorset 005A","E01020511","Total",815,424,9,415,142,31,259,25,234
"2011","West Dorset 005B","E01020532","Total",835,432,6,426,99,27,229,17,212
"2011","West Dorset 005C","E01020533","Total",935,424,21,403,228,66,290,30,260
"2011","West Dorset 005D","E01020535","Total",753,284,8,276,157,48,196,17,179
"2011","West Dorset 006A","E01020498","Total",933,404,13,391,191,72,279,29,250
"2011","West Dorset 006B","E01020499","Total",619,226,27,199,187,74,220,43,177
"2011","West Dorset 006C","E01020500","Total",850,368,11,357,137,49,289,27,262
"2011","West Dorset 006D","E01020501","Total",599,240,5,235,138,44,163,16,147
"2011","West Dorset 007A","E01020507","Total",912,452,16,436,142,40,283,19,264
"2011","West Dorset 007B","E01020517","Total",811,336,4,332,143,41,215,20,195
"2011","West Dorset 007C","E01020531","Total",762,289,12,277,156,44,197,19,178
"2011","West Dorset 007D","E01020536","Total",881,301,17,284,236,109,215,37,178
"2011","West Dorset 008A","E01020502","Total",819,355,41,314,196,89,272,36,236
"2011","West Dorset 008B","E01020503","Total",902,396,23,373,172,64,290,36,254
"2011","West Dorset 008C","E01020504","Total",1092,523,11,512,137,43,327,18,309
"2011","West Dorset 009C","E01020526","Total",509,174,12,162,158,54,134,25,109
"2011","West Dorset 009D","E01020527","Total",584,133,11,122,187,69,135,34,101
"2011","West Dorset 009E","E01020528","Total",853,307,30,277,242,88,230,36,194
"2011","West Dorset 009F","E01032641","Total",694,229,33,196,206,68,153,39,114
"2011","West Dorset 009G","E01032643","Total",704,204,20,184,194,72,164,30,134
"2011","West Dorset 009H","E01032644","Total",669,359,8,351,52,20,261,9,252
"2011","West Dorset 009I","E01032645","Total",560,287,10,277,89,33,227,20,207
"2011","West Dorset 010A","E01020518","Total",746,309,23,286,172,73,241,21,220
"2011","West Dorset 010B","E01020519","Total",809,291,16,275,239,93,213,36,177
"2011","West Dorset 010C","E01020520","Total",657,254,4,250,133,42,179,17,162
"2011","West Dorset 010D","E01020523","Total",514,124,1,123,160,47,109,21,88
"2011","West Dorset 010E","E01020524","Total",629,250,5,245,144,43,184,25,159
"2011","West Dorset 010F","E01020525","Total",521,200,5,195,163,34,141,27,114
"2011","West Dorset 011A","E01020505","Total",807,283,7,276,194,55,215,33,182
"2011","West Dorset 011B","E01020537","Total",807,292,20,272,180,67,201,28,173
"2011","West Dorset 011C","E01020538","Total",813,319,19,300,206,90,239,27,212
"2011","West Dorset 011D","E01020549","Total",896,319,17,302,201,81,233,30,203
"2011","West Dorset 012A","E01020512","Total",938,355,15,340,199,56,237,32,205
"2011","West Dorset 012B","E01020513","Total",676,266,16,250,177,65,187,25,162
"2011","West Dorset 012C","E01020514","Total",531,151,7,144,143,51,111,19,92
"2011","West Dorset 012D","E01020515","Total",505,175,10,165,142,55,135,18,117
"2011","West Dorset 012E","E01020516","Total",674,278,14,264,146,56,196,24,172
"2011","Weymouth and Portland 001A","E01020551","Total",836,261,48,213,266,116,222,47,175
"2011","Weymouth and Portland 001B","E01020552","Total",739,299,72,227,274,121,273,79,194
"2011","Weymouth and Portland 001C","E01020570","Total",705,256,7,249,143,46,185,27,158
"2011","Weymouth and Portland 001D","E01020571","Total",896,274,41,233,275,117,249,45,204
"2011","Weymouth and Portland 002A","E01020557","Total",754,400,2,398,96,29,226,19,207
"2011","Weymouth and Portland 002B","E01020558","Total",787,345,6,339,152,47,210,24,186
"2011","Weymouth and Portland 002C","E01020559","Total",739,392,1,391,103,27,204,13,191
"2011","Weymouth and Portland 002D","E01020560","Total",820,301,6,295,212,76,205,26,179
"2011","Weymouth and Portland 002E","E01020561","Total",812,300,13,287,202,88,246,29,217
"2011","Weymouth and Portland 003A","E01020574","Total",766,287,40,247,233,84,217,39,178
"2011","Weymouth and Portland 003B","E01020575","Total",730,334,36,298,216,75,311,51,260
"2011","Weymouth and Portland 003C","E01020576","Total",779,368,8,360,163,55,234,22,212
"2011","Weymouth and Portland 003D","E01020579","Total",829,320,10,310,198,61,237,41,196
"2011","Weymouth and Portland 003E","E01020580","Total",605,211,11,200,157,44,156,25,131
"2011","Weymouth and Portland 004A","E01020553","Total",579,175,23,152,132,69,137,20,117
"2011","Weymouth and Portland 004B","E01020554","Total",991,419,43,376,152,88,327,19,308
"2011","Weymouth and Portland 004C","E01020555","Total",669,235,28,207,139,64,210,15,195
"2011","Weymouth and Portland 004D","E01020556","Total",744,334,16,318,100,46,234,13,221
"2011","Weymouth and Portland 004E","E01020581","Total",992,418,11,407,161,52,267,20,247
"2011","Weymouth and Portland 004F","E01020582","Total",768,341,40,301,181,78,249,34,215
"2011","Weymouth and Portland 005A","E01020572","Total",850,220,29,191,250,104,204,40,164
"2011","Weymouth and Portland 005B","E01020573","Total",869,360,32,328,195,66,272,36,236
"2011","Weymouth and Portland 005C","E01020577","Total",640,210,35,175,214,57,181,38,143
"2011","Weymouth and Portland 005D","E01020578","Total",940,414,23,391,218,73,339,43,296
"2011","Weymouth and Portland 006A","E01020583","Total",800,295,25,270,202,57,191,36,155
"2011","Weymouth and Portland 006B","E01020584","Total",719,226,21,205,204,77,193,28,165
"2011","Weymouth and Portland 006C","E01020585","Total",603,224,53,171,229,73,169,51,118
"2011","Weymouth and Portland 007A","E01020586","Total",533,193,17,176,156,47,153,31,122
"2011","Weymouth and Portland 007B","E01020587","Total",675,247,27,220,196,81,217,46,171
"2011","Weymouth and Portland 007C","E01020588","Total",545,185,8,177,149,53,128,18,110
"2011","Weymouth and Portland 007D","E01020589","Total",646,236,30,206,186,55,201,42,159
"2011","Weymouth and Portland 008A","E01020563","Total",516,178,12,166,136,43,158,28,130
"2011","Weymouth and Portland 008D","E01020569","Total",640,284,61,223,202,88,232,42,190
"2011","Weymouth and Portland 008E","E01033200","Total",938,319,44,275,243,87,253,51,202
"2011","Weymouth and Portland 009A","E01020562","Total",876,297,19,278,232,77,250,38,212
"2011","Weymouth and Portland 009B","E01020564","Total",659,212,62,150,244,111,181,47,134
"2011","Weymouth and Portland 009C","E01020565","Total",646,226,25,201,174,73,183,28,155
"2011","Weymouth and Portland 009D","E01020566","Total",900,298,13,285,217,79,242,38,204
"2011","Cheltenham 001A","E01022163","Total",605,122,17,105,185,73,127,22,105
"2011","Cheltenham 001B","E01022164","Total",597,199,40,159,172,92,163,25,138
"2011","Cheltenham 001C","E01022165","Total",709,205,12,193,152,65,144,20,124
"2011","Cheltenham 001D","E01022166","Total",540,137,11,126,163,57,99,24,75
"2011","Cheltenham 002A","E01022143","Total",667,269,5,264,139,53,147,13,134
"2011","Cheltenham 002B","E01022144","Total",536,256,8,248,104,40,166,13,153
"2011","Cheltenham 002C","E01022145","Total",512,175,4,171,147,44,131,10,121
"2011","Cheltenham 002D","E01022146","Total",626,273,5,268,117,44,153,16,137
"2011","Cheltenham 003A","E01022122","Total",572,237,58,179,207,99,182,33,149
"2011","Cheltenham 003B","E01022160","Total",879,268,75,193,298,167,211,45,166
"2011","Cheltenham 003C","E01022161","Total",631,134,36,98,186,77,123,37,86
"2011","Cheltenham 003D","E01022162","Total",689,248,31,217,158,64,186,25,161
"2011","Cheltenham 004A","E01022139","Total",526,234,5,229,84,32,126,5,121
"2011","Cheltenham 004B","E01022151","Total",640,167,29,138,109,55,137,22,115
"2011","Cheltenham 004C","E01022152","Total",434,190,38,152,106,50,149,20,129
"2011","Cheltenham 004D","E01022153","Total",658,150,21,129,104,53,128,24,104
"2011","Cheltenham 004E","E01022154","Total",700,169,25,144,124,61,132,20,112
"2011","Cheltenham 005A","E01022120","Total",691,268,41,227,218,102,207,32,175
"2011","Cheltenham 005B","E01022121","Total",732,227,83,144,276,154,175,49,126
"2011","Cheltenham 005C","E01022147","Total",768,313,65,248,212,94,261,41,220
"2011","Cheltenham 005D","E01022157","Total",643,208,63,145,227,124,154,29,125
"2011","Cheltenham 005E","E01022159","Total",603,188,33,155,203,96,180,41,139
"2011","Cheltenham 006A","E01022131","Total",572,257,39,218,161,76,194,22,172
"2011","Cheltenham 006B","E01022132","Total",596,219,38,181,181,73,189,30,159
"2011","Cheltenham 006C","E01022133","Total",508,165,52,113,208,93,121,31,90
"2011","Cheltenham 006D","E01022134","Total",767,311,33,278,146,76,225,17,208
"2011","Cheltenham 007A","E01022148","Total",648,209,4,205,165,73,173,27,146
"2011","Cheltenham 007B","E01022149","Total",525,146,26,120,177,65,133,33,100
"2011","Cheltenham 007C","E01022150","Total",657,171,28,143,164,71,130,20,110
"2011","Cheltenham 007D","E01022155","Total",612,198,15,183,143,66,138,13,125
"2011","Cheltenham 007E","E01022156","Total",657,165,39,126,177,92,138,31,107
"2011","Cheltenham 007F","E01022158","Total",1048,201,20,181,168,88,163,12,151
"2011","Cheltenham 008A","E01022100","Total",770,176,6,170,203,97,134,17,117
"2011","Cheltenham 008B","E01022101","Total",857,213,11,202,177,82,159,14,145
"2011","Cheltenham 008C","E01022102","Total",1038,218,18,200,101,62,157,7,150
"2011","Cheltenham 008D","E01022140","Total",570,199,7,192,114,52,131,16,115
"2011","Cheltenham 008E","E01022141","Total",787,175,6,169,85,40,112,5,107
"2011","Cheltenham 008F","E01022142","Total",772,220,10,210,99,53,173,11,162
"2011","Cheltenham 009A","E01022116","Total",554,153,8,145,83,36,101,7,94
"2011","Cheltenham 009B","E01022117","Total",967,226,3,223,58,23,153,2,151
"2011","Cheltenham 009C","E01022119","Total",577,118,8,110,159,73,93,16,77
"2011","Cheltenham 009D","E01022124","Total",761,261,6,255,44,18,181,2,179
"2011","Cheltenham 009E","E01022125","Total",592,174,7,167,109,35,98,8,90
"2011","Cheltenham 009F","E01022126","Total",943,227,11,216,44,15,141,6,135
"2011","Cheltenham 009G","E01022127","Total",678,166,6,160,59,33,103,9,94
"2011","Cheltenham 010A","E01022106","Total",747,237,12,225,198,66,165,22,143
"2011","Cheltenham 010B","E01022107","Total",656,201,10,191,191,54,150,20,130
"2011","Cheltenham 010C","E01022108","Total",734,211,8,203,218,72,158,23,135
"2011","Cheltenham 010D","E01022123","Total",988,218,30,188,249,103,179,31,148
"2011","Cheltenham 011A","E01022135","Total",624,223,2,221,150,57,140,12,128
"2011","Cheltenham 011B","E01022136","Total",742,286,11,275,128,46,197,14,183
"2011","Cheltenham 011C","E01022137","Total",879,235,14,221,134,57,160,9,151
"2011","Cheltenham 011D","E01022138","Total",776,237,8,229,157,51,127,19,108
"2011","Cheltenham 011E","E01022174","Total",597,229,10,219,156,53,139,20,119
"2011","Cheltenham 012A","E01022103","Total",1001,235,18,217,293,141,157,31,126
"2011","Cheltenham 012B","E01022104","Total",721,220,21,199,207,87,165,31,134
"2011","Cheltenham 012C","E01022105","Total",584,190,3,187,186,52,139,26,113
"2011","Cheltenham 012D","E01022109","Total",606,199,3,196,195,46,147,23,124
"2011","Cheltenham 012E","E01022110","Total",616,220,15,205,206,77,155,19,136
"2011","Cheltenham 012F","E01022111","Total",589,185,11,174,204,60,108,16,92
"2011","Cheltenham 012G","E01022112","Total",469,130,10,120,176,54,85,22,63
"2011","Cheltenham 013A","E01022167","Total",509,187,7,180,148,54,120,16,104
"2011","Cheltenham 013B","E01022168","Total",476,182,6,176,132,52,134,15,119
"2011","Cheltenham 013C","E01022169","Total",667,206,10,196,197,71,187,30,157
"2011","Cheltenham 013D","E01022170","Total",628,162,13,149,203,60,122,23,99
"2011","Cheltenham 013E","E01022171","Total",551,69,7,62,216,77,66,18,48
"2011","Cheltenham 013F","E01022172","Total",711,319,4,315,130,35,201,12,189
"2011","Cheltenham 013G","E01022173","Total",613,228,30,198,140,62,153,28,125
"2011","Cheltenham 014A","E01022113","Total",714,322,5,317,189,44,184,14,170
"2011","Cheltenham 014B","E01022114","Total",662,267,10,257,180,60,157,16,141
"2011","Cheltenham 014C","E01022115","Total",807,265,6,259,168,52,183,19,164
"2011","Cheltenham 014D","E01022118","Total",572,153,6,147,210,79,113,19,94
"2011","Cheltenham 015A","E01022128","Total",670,232,4,228,198,92,139,19,120
"2011","Cheltenham 015B","E01022129","Total",874,324,20,304,264,99,185,28,157
"2011","Cheltenham 015C","E01022130","Total",732,199,4,195,187,83,152,22,130
"2011","Cotswold 001A","E01022179","Total",905,296,16,280,236,72,191,29,162
"2011","Cotswold 001B","E01022182","Total",689,276,8,268,139,48,180,19,161
"2011","Cotswold 001C","E01022183","Total",694,297,10,287,137,43,166,17,149
"2011","Cotswold 001D","E01022184","Total",674,257,10,247,132,35,171,14,157
"2011","Cotswold 001E","E01022185","Total",627,240,11,229,159,52,178,23,155
"2011","Cotswold 002A","E01022177","Total",966,382,12,370,180,56,292,24,268
"2011","Cotswold 002B","E01022178","Total",595,192,9,183,140,41,120,19,101
"2011","Cotswold 002C","E01022205","Total",841,268,7,261,173,63,188,14,174
"2011","Cotswold 002D","E01022211","Total",931,407,14,393,177,72,265,14,251
"2011","Cotswold 002E","E01022212","Total",722,252,11,241,177,65,190,26,164
"2011","Cotswold 003A","E01022180","Total",923,317,22,295,246,90,237,22,215
"2011","Cotswold 003B","E01022181","Total",782,373,4,369,129,35,220,18,202
"2011","Cotswold 003C","E01022214","Total",848,171,13,158,298,101,155,32,123
"2011","Cotswold 003D","E01022222","Total",875,252,15,237,170,55,166,16,150
"2011","Cotswold 004A","E01022186","Total",721,189,8,181,189,66,138,26,112
"2011","Cotswold 004B","E01022187","Total",732,209,14,195,194,63,145,25,120
"2011","Cotswold 004C","E01022201","Total",749,188,11,177,190,48,155,27,128
"2011","Cotswold 004D","E01022216","Total",788,189,5,184,216,81,135,23,112
"2011","Cotswold 005A","E01022175","Total",818,264,20,244,185,53,170,28,142
"2011","Cotswold 005B","E01022207","Total",751,225,4,221,199,66,169,22,147
"2011","Cotswold 005C","E01022213","Total",787,259,9,250,208,85,187,23,164
"2011","Cotswold 005D","E01022215","Total",815,216,6,210,166,53,159,14,145
"2011","Cotswold 006A","E01022188","Total",601,194,24,170,169,62,158,22,136
"2011","Cotswold 006B","E01022189","Total",512,121,3,118,168,54,113,21,92
"2011","Cotswold 006C","E01022190","Total",529,120,20,100,185,61,114,21,93
"2011","Cotswold 006D","E01022196","Total",731,235,12,223,222,84,169,29,140
"2011","Cotswold 006E","E01022197","Total",776,227,9,218,210,66,157,25,132
"2011","Cotswold 007A","E01022194","Total",995,487,12,475,110,40,349,13,336
"2011","Cotswold 007B","E01022195","Total",641,272,8,264,126,39,167,13,154
"2011","Cotswold 007C","E01022199","Total",860,306,5,301,159,64,210,9,201
"2011","Cotswold 007D","E01022200","Total",607,238,26,212,152,72,193,19,174
"2011","Cotswold 008A","E01022191","Total",653,172,16,156,169,63,136,18,118
"2011","Cotswold 008B","E01022192","Total",532,169,15,154,158,46,148,29,119
"2011","Cotswold 008C","E01022193","Total",417,127,2,125,123,29,88,15,73
"2011","Cotswold 008D","E01022198","Total",563,150,16,134,148,57,116,21,95
"2011","Cotswold 008E","E01022225","Total",633,230,17,213,193,84,153,27,126
"2011","Cotswold 009A","E01022202","Total",429,127,5,122,128,50,93,15,78
"2011","Cotswold 009B","E01022203","Total",642,279,3,276,125,40,187,15,172
"2011","Cotswold 009C","E01022204","Total",611,180,14,166,191,52,165,25,140
"2011","Cotswold 009D","E01022208","Total",671,242,3,239,176,52,142,17,125
"2011","Cotswold 009E","E01022209","Total",447,105,7,98,145,41,87,13,74
"2011","Cotswold 009F","E01022210","Total",651,290,9,281,111,32,201,18,183
"2011","Cotswold 010A","E01022221","Total",782,211,16,195,245,82,166,26,140
"2011","Cotswold 010B","E01022223","Total",1020,260,11,249,287,84,202,33,169
"2011","Cotswold 010C","E01022224","Total",686,199,9,190,144,50,142,24,118
"2011","Cotswold 011A","E01022176","Total",815,190,12,178,217,80,170,32,138
"2011","Cotswold 011B","E01022206","Total",796,174,9,165,188,72,127,18,109
"2011","Cotswold 011C","E01022217","Total",561,163,8,155,151,62,119,15,104
"2011","Cotswold 011D","E01022218","Total",525,164,14,150,173,68,143,30,113
"2011","Cotswold 011E","E01022219","Total",522,172,4,168,149,69,113,14,99
"2011","Cotswold 011F","E01022220","Total",795,312,11,301,139,57,206,15,191
"2011","Forest of Dean 001A","E01022233","Total",785,228,7,221,196,66,181,25,156
"2011","Forest of Dean 001B","E01022235","Total",735,259,5,254,172,58,204,19,185
"2011","Forest of Dean 001C","E01022247","Total",673,197,7,190,183,49,141,31,110
"2011","Forest of Dean 001D","E01022270","Total",749,248,19,229,216,65,180,34,146
"2011","Forest of Dean 001E","E01022271","Total",703,228,6,222,151,43,151,12,139
"2011","Forest of Dean 002A","E01022261","Total",781,257,22,235,233,79,194,36,158
"2011","Forest of Dean 002B","E01022262","Total",861,285,20,265,198,64,235,31,204
"2011","Forest of Dean 002C","E01022267","Total",660,246,6,240,128,37,177,18,159
"2011","Forest of Dean 003A","E01022251","Total",629,230,23,207,164,58,177,22,155
"2011","Forest of Dean 003B","E01022252","Total",710,227,10,217,179,46,190,25,165
"2011","Forest of Dean 003C","E01022258","Total",470,174,21,153,149,54,129,26,103
"2011","Forest of Dean 003D","E01022259","Total",640,178,11,167,197,58,150,29,121
"2011","Forest of Dean 003E","E01022260","Total",752,266,44,222,226,84,203,38,165
"2011","Forest of Dean 004A","E01022236","Total",898,288,21,267,238,100,225,34,191
"2011","Forest of Dean 004B","E01022237","Total",628,249,44,205,200,78,202,43,159
"2011","Forest of Dean 004C","E01022238","Total",607,288,36,252,165,79,239,33,206
"2011","Forest of Dean 004D","E01022239","Total",691,229,18,211,185,69,192,38,154
"2011","Forest of Dean 004E","E01022240","Total",930,341,38,303,232,109,271,34,237
"2011","Forest of Dean 004F","E01022249","Total",817,263,14,249,205,73,233,33,200
"2011","Forest of Dean 004G","E01022250","Total",762,284,37,247,198,86,227,41,186
"2011","Forest of Dean 005A","E01022228","Total",686,197,5,192,171,52,206,31,175
"2011","Forest of Dean 005B","E01022230","Total",689,228,8,220,181,54,165,27,138
"2011","Forest of Dean 005C","E01022265","Total",704,240,8,232,166,53,166,24,142
"2011","Forest of Dean 005D","E01022266","Total",526,165,7,158,146,44,128,19,109
"2011","Forest of Dean 006A","E01022234","Total",639,242,11,231,136,32,176,32,144
"2011","Forest of Dean 006B","E01022253","Total",713,226,12,214,191,75,166,25,141
"2011","Forest of Dean 006C","E01022263","Total",778,251,12,239,191,53,178,29,149
"2011","Forest of Dean 007A","E01022229","Total",677,248,19,229,177,74,197,31,166
"2011","Forest of Dean 007B","E01022241","Total",819,385,11,374,141,52,274,17,257
"2011","Forest of Dean 007C","E01022242","Total",592,230,29,201,168,62,175,36,139
"2011","Forest of Dean 007D","E01022243","Total",532,205,30,175,167,72,158,33,125
"2011","Forest of Dean 007E","E01022244","Total",616,213,24,189,183,68,180,28,152
"2011","Forest of Dean 007F","E01022245","Total",594,183,18,165,161,76,175,32,143
"2011","Forest of Dean 007G","E01022246","Total",532,164,7,157,141,56,142,24,118
"2011","Forest of Dean 008A","E01022231","Total",692,242,20,222,195,71,207,36,171
"2011","Forest of Dean 008B","E01022232","Total",643,206,17,189,184,67,173,35,138
"2011","Forest of Dean 008C","E01022264","Total",613,206,17,189,156,40,179,34,145
"2011","Forest of Dean 008D","E01022268","Total",674,263,17,246,169,51,208,33,175
"2011","Forest of Dean 008E","E01022269","Total",801,251,18,233,219,65,214,35,179
"2011","Forest of Dean 009A","E01022226","Total",690,262,18,244,201,75,216,33,183
"2011","Forest of Dean 009B","E01022227","Total",682,250,6,244,154,50,180,23,157
"2011","Forest of Dean 009C","E01022254","Total",757,275,47,228,237,89,233,43,190
"2011","Forest of Dean 009D","E01022255","Total",622,163,14,149,212,61,158,37,121
"2011","Forest of Dean 009E","E01022256","Total",742,343,30,313,170,63,242,21,221
"2011","Forest of Dean 009F","E01022257","Total",770,239,9,230,203,66,196,34,162
"2011","Forest of Dean 010A","E01022248","Total",711,233,6,227,174,55,189,29,160
"2011","Forest of Dean 010B","E01022272","Total",564,222,15,207,145,47,181,25,156
"2011","Forest of Dean 010C","E01022273","Total",457,122,9,113,191,106,102,19,83
"2011","Forest of Dean 010D","E01022274","Total",496,133,4,129,132,38,108,26,82
"2011","Forest of Dean 010E","E01022275","Total",675,241,4,237,169,54,194,13,181
"2011","Gloucester 001A","E01022313","Total",702,169,12,157,210,86,146,22,124
"2011","Gloucester 001B","E01022315","Total",628,195,5,190,177,48,154,27,127
"2011","Gloucester 001C","E01022316","Total",676,159,7,152,209,72,130,22,108
"2011","Gloucester 001D","E01022317","Total",610,179,7,172,214,74,144,25,119
"2011","Gloucester 001E","E01022318","Total",656,233,6,227,169,51,172,25,147
"2011","Gloucester 002A","E01022309","Total",618,177,9,168,160,61,154,19,135
"2011","Gloucester 002B","E01022310","Total",742,251,29,222,170,67,190,26,164
"2011","Gloucester 002C","E01022311","Total",1000,414,28,386,152,85,308,19,289
"2011","Gloucester 002D","E01022312","Total",958,256,25,231,208,109,191,21,170
"2011","Gloucester 002E","E01022314","Total",647,267,6,261,133,55,163,14,149
"2011","Gloucester 003A","E01022295","Total",590,215,11,204,167,67,143,22,121
"2011","Gloucester 003B","E01022296","Total",597,166,25,141,220,86,150,31,119
"2011","Gloucester 003C","E01022297","Total",496,138,3,135,155,40,105,16,89
"2011","Gloucester 003D","E01022298","Total",602,129,13,116,206,77,127,26,101
"2011","Gloucester 004A","E01022332","Total",671,175,26,149,185,84,156,24,132
"2011","Gloucester 004B","E01022347","Total",919,269,20,249,102,57,214,12,202
"2011","Gloucester 004C","E01022348","Total",1113,269,30,239,302,151,212,47,165
"2011","Gloucester 004E","E01032932","Total",628,338,5,333,70,42,240,8,232
"2011","Gloucester 004F","E01032937","Total",604,243,7,236,60,29,179,12,167
"2011","Gloucester 005A","E01022288","Total",705,203,59,144,277,146,177,46,131
"2011","Gloucester 005B","E01022289","Total",625,230,43,187,218,104,193,41,152
"2011","Gloucester 005C","E01022290","Total",529,177,38,139,210,90,169,43,126
"2011","Gloucester 005D","E01022291","Total",635,194,59,135,271,143,157,56,101
"2011","Gloucester 005E","E01022292","Total",493,141,28,113,177,81,144,40,104
"2011","Gloucester 006A","E01022283","Total",635,221,5,216,162,37,166,17,149
"2011","Gloucester 006B","E01022303","Total",622,250,17,233,158,66,218,31,187
"2011","Gloucester 006C","E01022304","Total",765,342,13,329,152,55,236,21,215
"2011","Gloucester 006D","E01022305","Total",589,240,6,234,153,39,168,24,144
"2011","Gloucester 006E","E01022308","Total",649,265,7,258,134,43,173,15,158
"2011","Gloucester 007A","E01022278","Total",638,146,18,128,207,83,128,27,101
"2011","Gloucester 007B","E01022279","Total",569,138,13,125,210,71,129,34,95
"2011","Gloucester 007C","E01022282","Total",1043,150,24,126,470,169,177,64,113
"2011","Gloucester 007D","E01022284","Total",511,133,25,108,178,67,135,29,106
"2011","Gloucester 007E","E01022285","Total",497,182,45,137,203,76,140,47,93
"2011","Gloucester 007F","E01022286","Total",611,160,33,127,214,101,170,41,129
"2011","Gloucester 007G","E01022287","Total",711,221,16,205,202,77,184,34,150
"2011","Gloucester 008A","E01022293","Total",633,202,32,170,193,82,158,38,120
"2011","Gloucester 008B","E01022294","Total",634,172,38,134,216,91,154,31,123
"2011","Gloucester 008C","E01022323","Total",633,212,82,130,295,111,190,72,118
"2011","Gloucester 008D","E01022328","Total",501,164,26,138,172,64,159,29,130
"2011","Gloucester 008E","E01022329","Total",599,200,61,139,230,100,179,54,125
"2011","Gloucester 009A","E01022326","Total",555,120,31,89,194,97,114,27,87
"2011","Gloucester 009B","E01022327","Total",618,147,21,126,208,98,142,27,115
"2011","Gloucester 009C","E01022330","Total",587,113,14,99,206,88,129,38,91
"2011","Gloucester 009D","E01022331","Total",496,135,24,111,184,77,141,34,107
"2011","Gloucester 009E","E01022333","Total",641,313,70,243,177,73,250,51,199
"2011","Gloucester 009F","E01022334","Total",650,245,13,232,173,73,200,23,177
"2011","Gloucester 010A","E01022276","Total",685,218,2,216,179,66,169,22,147
"2011","Gloucester 010B","E01022277","Total",659,214,7,207,167,62,181,17,164
"2011","Gloucester 010C","E01022280","Total",685,80,18,62,215,101,76,23,53
"2011","Gloucester 010D","E01022281","Total",690,145,8,137,258,79,129,25,104
"2011","Gloucester 010E","E01022306","Total",584,116,11,105,187,73,106,14,92
"2011","Gloucester 010F","E01022307","Total",638,80,10,70,258,100,109,26,83
"2011","Gloucester 011A","E01022319","Total",703,329,77,252,225,126,223,37,186
"2011","Gloucester 011B","E01022320","Total",626,216,35,181,184,83,182,29,153
"2011","Gloucester 011C","E01022321","Total",609,171,20,151,190,86,151,23,128
"2011","Gloucester 011D","E01022322","Total",609,279,27,252,152,74,239,27,212
"2011","Gloucester 011E","E01022324","Total",649,246,43,203,187,75,202,31,171
"2011","Gloucester 011F","E01022325","Total",586,222,23,199,132,56,175,24,151
"2011","Gloucester 012A","E01022343","Total",510,179,7,172,130,47,128,21,107
"2011","Gloucester 012B","E01022344","Total",625,220,23,197,169,62,200,36,164
"2011","Gloucester 012C","E01022345","Total",630,241,11,230,152,41,183,15,168
"2011","Gloucester 012D","E01022346","Total",658,273,60,213,221,83,224,44,180
"2011","Gloucester 013A","E01022299","Total",629,201,13,188,144,47,172,22,150
"2011","Gloucester 013B","E01022300","Total",635,266,10,256,129,45,161,16,145
"2011","Gloucester 013C","E01022301","Total",660,203,25,178,210,90,152,22,130
"2011","Gloucester 013D","E01022302","Total",625,223,22,201,192,56,163,23,140
"2011","Gloucester 014A","E01022339","Total",660,111,18,93,268,109,110,30,80
"2011","Gloucester 014B","E01022340","Total",622,71,22,49,216,99,83,23,60
"2011","Gloucester 014C","E01022341","Total",853,147,20,127,313,121,139,31,108
"2011","Gloucester 014D","E01022342","Total",677,54,14,40,277,103,67,25,42
"2011","Gloucester 015A","E01022335","Total",612,158,5,153,180,69,161,31,130
"2011","Gloucester 015B","E01022336","Total",496,147,7,140,147,47,117,16,101
"2011","Gloucester 015D","E01022338","Total",630,106,25,81,210,113,100,34,66
"2011","Gloucester 015E","E01032933","Total",535,67,29,38,271,146,83,41,42
"2011","Gloucester 015F","E01032934","Total",573,121,10,111,184,68,133,33,100
"2011","Gloucester 015G","E01032935","Total",556,41,19,22,288,169,66,30,36
"2011","Gloucester 015H","E01032936","Total",623,106,73,33,373,227,92,47,45
"2011","Stroud 001A","E01022378","Total",739,121,8,113,250,96,126,26,100
"2011","Stroud 001B","E01022379","Total",665,158,20,138,180,92,158,29,129
"2011","Stroud 001C","E01022380","Total",606,150,7,143,171,49,123,27,96
"2011","Stroud 001D","E01022412","Total",1163,352,29,323,331,142,270,45,225
"2011","Stroud 002A","E01022354","Total",936,317,6,311,219,63,210,26,184
"2011","Stroud 002B","E01022390","Total",594,291,14,277,127,42,172,19,153
"2011","Stroud 002C","E01022391","Total",640,271,8,263,136,47,149,15,134
"2011","Stroud 002D","E01022392","Total",658,216,7,209,150,48,148,12,136
"2011","Stroud 003A","E01022376","Total",736,219,9,210,191,68,172,19,153
"2011","Stroud 003B","E01022396","Total",667,164,8,156,192,70,129,22,107
"2011","Stroud 003C","E01022397","Total",717,176,12,164,231,82,158,18,140
"2011","Stroud 003D","E01022398","Total",449,143,8,135,120,33,116,13,103
"2011","Stroud 004A","E01022355","Total",641,174,19,155,215,72,157,34,123
"2011","Stroud 004B","E01022356","Total",952,250,30,220,293,129,227,46,181
"2011","Stroud 004C","E01022357","Total",778,243,11,232,213,79,192,26,166
"2011","Stroud 004D","E01022358","Total",656,264,15,249,191,69,239,39,200
"2011","Stroud 004E","E01022377","Total",987,359,19,340,256,75,293,39,254
"2011","Stroud 004F","E01022389","Total",717,204,5,199,214,57,151,27,124
"2011","Stroud 005A","E01022400","Total",789,241,17,224,213,75,240,36,204
"2011","Stroud 005B","E01022401","Total",596,188,16,172,187,61,162,26,136
"2011","Stroud 005C","E01022402","Total",648,136,19,117,206,80,133,31,102
"2011","Stroud 005D","E01022403","Total",609,273,29,244,154,64,247,36,211
"2011","Stroud 005E","E01022404","Total",551,151,2,149,123,42,125,12,113
"2011","Stroud 006A","E01022365","Total",1005,303,19,284,207,100,262,26,236
"2011","Stroud 006B","E01022399","Total",917,289,36,253,276,99,239,45,194
"2011","Stroud 006C","E01022410","Total",986,309,50,259,281,102,252,48,204
"2011","Stroud 006D","E01022411","Total",950,284,16,268,267,99,249,36,213
"2011","Stroud 006E","E01022414","Total",1109,267,31,236,315,108,270,50,220
"2011","Stroud 007A","E01022393","Total",619,221,6,215,157,63,153,19,134
"2011","Stroud 007B","E01022394","Total",672,122,12,110,204,83,127,29,98
"2011","Stroud 007C","E01022395","Total",635,197,7,190,181,55,126,10,116
"2011","Stroud 007D","E01022408","Total",435,102,3,99,126,34,101,13,88
"2011","Stroud 007E","E01022409","Total",499,103,9,94,162,45,104,19,85
"2011","Stroud 008A","E01022366","Total",676,174,6,168,261,76,124,23,101
"2011","Stroud 008B","E01022367","Total",674,197,5,192,211,59,153,29,124
"2011","Stroud 008C","E01022368","Total",587,182,2,180,142,35,123,11,112
"2011","Stroud 008D","E01022369","Total",744,160,25,135,265,113,126,27,99
"2011","Stroud 009A","E01022370","Total",534,170,9,161,147,45,115,18,97
"2011","Stroud 009B","E01022371","Total",413,130,6,124,105,25,99,12,87
"2011","Stroud 009C","E01022405","Total",625,237,12,225,162,57,208,19,189
"2011","Stroud 009D","E01022406","Total",521,168,7,161,131,46,124,18,106
"2011","Stroud 009E","E01022407","Total",547,181,6,175,127,39,134,18,116
"2011","Stroud 010A","E01022350","Total",888,318,9,309,229,73,200,21,179
"2011","Stroud 010B","E01022382","Total",662,267,5,262,145,44,159,14,145
"2011","Stroud 010C","E01022383","Total",593,288,13,275,137,49,194,19,175
"2011","Stroud 010D","E01022384","Total",617,231,8,223,133,46,148,21,127
"2011","Stroud 011A","E01022359","Total",638,220,2,218,176,59,152,22,130
"2011","Stroud 011B","E01022360","Total",567,169,6,163,150,43,109,17,92
"2011","Stroud 011C","E01022361","Total",603,267,14,253,130,55,212,21,191
"2011","Stroud 011D","E01022362","Total",512,201,7,194,121,39,136,14,122
"2011","Stroud 011E","E01022363","Total",765,230,20,210,204,79,180,29,151
"2011","Stroud 011F","E01022364","Total",488,208,24,184,139,45,166,24,142
"2011","Stroud 012A","E01022351","Total",592,184,12,172,154,59,162,25,137
"2011","Stroud 012B","E01022352","Total",578,190,4,186,134,48,154,17,137
"2011","Stroud 012C","E01022353","Total",643,186,9,177,154,61,162,24,138
"2011","Stroud 012D","E01022413","Total",727,186,7,179,207,59,159,28,131
"2011","Stroud 013A","E01022385","Total",663,205,17,188,194,71,166,26,140
"2011","Stroud 013B","E01022386","Total",746,261,6,255,148,54,202,26,176
"2011","Stroud 013C","E01022387","Total",722,213,22,191,205,76,194,37,157
"2011","Stroud 013D","E01022388","Total",696,188,18,170,235,92,165,30,135
"2011","Stroud 014A","E01022372","Total",755,238,12,226,199,77,155,21,134
"2011","Stroud 014B","E01022373","Total",737,230,26,204,216,84,165,23,142
"2011","Stroud 014C","E01022374","Total",932,327,33,294,222,97,252,34,218
"2011","Stroud 014D","E01022375","Total",485,128,48,80,212,98,111,36,75
"2011","Stroud 015A","E01022381","Total",784,169,14,155,287,93,154,37,117
"2011","Stroud 015B","E01022415","Total",628,194,3,191,172,49,142,23,119
"2011","Stroud 015C","E01022416","Total",585,178,12,166,198,74,154,27,127
"2011","Stroud 015D","E01022417","Total",727,232,7,225,191,67,168,28,140
"2011","Stroud 015E","E01022418","Total",819,301,11,290,186,70,224,23,201
"2011","Tewkesbury 001B","E01022450","Total",885,231,37,194,281,135,234,52,182
"2011","Tewkesbury 001C","E01022451","Total",636,156,14,142,179,57,158,25,133
"2011","Tewkesbury 001D","E01022452","Total",534,81,8,73,197,70,104,23,81
"2011","Tewkesbury 001E","E01022455","Total",812,243,9,234,202,58,190,29,161
"2011","Tewkesbury 001F","E01032938","Total",608,108,15,93,209,85,99,21,78
"2011","Tewkesbury 001G","E01032939","Total",584,78,20,58,283,111,77,27,50
"2011","Tewkesbury 001H","E01032940","Total",541,50,16,34,246,139,60,29,31
"2011","Tewkesbury 002A","E01022456","Total",539,139,4,135,157,51,134,21,113
"2011","Tewkesbury 002B","E01022457","Total",600,229,31,198,157,62,192,29,163
"2011","Tewkesbury 002C","E01022458","Total",668,278,43,235,201,97,221,40,181
"2011","Tewkesbury 002D","E01022459","Total",850,301,11,290,88,35,217,12,205
"2011","Tewkesbury 002E","E01022460","Total",832,303,6,297,175,83,251,29,222
"2011","Tewkesbury 002F","E01022461","Total",635,276,3,273,136,36,167,17,150
"2011","Tewkesbury 002G","E01022462","Total",695,236,9,227,158,46,162,16,146
"2011","Tewkesbury 003A","E01022449","Total",848,273,5,268,196,49,184,24,160
"2011","Tewkesbury 003B","E01022463","Total",718,281,8,273,123,47,172,10,162
"2011","Tewkesbury 003C","E01022464","Total",743,355,16,339,167,66,216,21,195
"2011","Tewkesbury 003D","E01022465","Total",627,192,4,188,177,53,121,16,105
"2011","Tewkesbury 003E","E01022466","Total",748,265,12,253,198,82,162,19,143
"2011","Tewkesbury 004A","E01022434","Total",852,287,8,279,218,88,169,27,142
"2011","Tewkesbury 004B","E01022441","Total",667,185,21,164,148,61,133,13,120
"2011","Tewkesbury 004C","E01022445","Total",564,151,5,146,139,42,124,11,113
"2011","Tewkesbury 004D","E01022453","Total",648,247,3,244,181,49,157,20,137
"2011","Tewkesbury 005A","E01022432","Total",950,371,16,355,209,75,255,24,231
"2011","Tewkesbury 005B","E01022433","Total",854,299,15,284,238,96,206,37,169
"2011","Tewkesbury 005C","E01022435","Total",958,362,34,328,286,110,290,45,245
"2011","Tewkesbury 005D","E01022436","Total",914,397,19,378,201,73,241,31,210
"2011","Tewkesbury 005E","E01022437","Total",584,180,11,169,190,74,147,20,127
"2011","Tewkesbury 005F","E01022438","Total",604,121,9,112,183,73,93,13,80
"2011","Tewkesbury 005G","E01022439","Total",710,141,8,133,234,92,99,16,83
"2011","Tewkesbury 006A","E01022440","Total",735,223,9,214,145,57,195,20,175
"2011","Tewkesbury 006B","E01022442","Total",618,162,3,159,156,41,138,18,120
"2011","Tewkesbury 006C","E01022443","Total",548,168,8,160,143,42,118,20,98
"2011","Tewkesbury 006D","E01022444","Total",579,170,7,163,150,45,116,22,94
"2011","Tewkesbury 007A","E01022425","Total",499,161,5,156,149,43,121,25,96
"2011","Tewkesbury 007B","E01022426","Total",642,300,8,292,142,29,167,19,148
"2011","Tewkesbury 007C","E01022427","Total",643,223,11,212,154,46,162,18,144
"2011","Tewkesbury 007D","E01022428","Total",797,255,34,221,263,108,207,39,168
"2011","Tewkesbury 007E","E01022429","Total",672,184,7,177,186,66,156,31,125
"2011","Tewkesbury 007F","E01022430","Total",632,224,6,218,144,51,145,18,127
"2011","Tewkesbury 007G","E01022431","Total",893,163,10,153,278,102,154,41,113
"2011","Tewkesbury 007H","E01022447","Total",473,60,10,50,246,137,78,33,45
"2011","Tewkesbury 008A","E01022420","Total",910,313,11,302,188,65,268,20,248
"2011","Tewkesbury 008B","E01022448","Total",580,255,15,240,149,56,186,26,160
"2011","Tewkesbury 008C","E01022454","Total",861,364,21,343,198,71,259,29,230
"2011","Tewkesbury 009A","E01022421","Total",735,226,28,198,211,102,192,33,159
"2011","Tewkesbury 009B","E01022422","Total",642,119,10,109,214,97,134,40,94
"2011","Tewkesbury 009C","E01022423","Total",839,273,12,261,208,84,204,22,182
"2011","Tewkesbury 009D","E01022424","Total",658,245,45,200,205,81,193,30,163
"2011","Tewkesbury 009E","E01022446","Total",762,192,11,181,227,92,149,22,127
"2011","Mendip 001A","E01029022","Total",584,182,8,174,153,56,121,18,103
"2011","Mendip 001B","E01029023","Total",481,155,7,148,142,45,118,21,97
"2011","Mendip 001C","E01029044","Total",570,148,26,122,191,82,132,34,98
"2011","Mendip 001D","E01029053","Total",953,260,17,243,249,84,248,46,202
"2011","Mendip 001E","E01029057","Total",830,229,18,211,232,77,177,20,157
"2011","Mendip 002A","E01029024","Total",823,234,15,219,256,96,185,33,152
"2011","Mendip 002B","E01029025","Total",544,187,13,174,147,64,169,32,137
"2011","Mendip 002C","E01029026","Total",417,118,9,109,115,29,98,18,80
"2011","Mendip 002D","E01029068","Total",485,135,17,118,143,44,138,26,112
"2011","Mendip 002E","E01029069","Total",445,154,7,147,115,34,119,18,101
"2011","Mendip 003A","E01029030","Total",784,183,11,172,240,71,149,30,119
"2011","Mendip 003B","E01029031","Total",676,218,11,207,190,62,146,26,120
"2011","Mendip 003C","E01029032","Total",497,249,3,246,72,28,140,10,130
"2011","Mendip 003D","E01029033","Total",628,159,13,146,196,78,145,24,121
"2011","Mendip 003E","E01029034","Total",582,162,12,150,143,61,129,21,108
"2011","Mendip 004A","E01029036","Total",713,205,35,170,207,92,165,27,138
"2011","Mendip 004B","E01029041","Total",950,361,29,332,240,98,309,28,281
"2011","Mendip 004C","E01029042","Total",673,255,51,204,213,78,196,44,152
"2011","Mendip 004D","E01029043","Total",620,160,23,137,196,75,141,33,108
"2011","Mendip 004E","E01029045","Total",657,202,18,184,193,72,162,30,132
"2011","Mendip 005A","E01029052","Total",862,303,20,283,220,68,251,40,211
"2011","Mendip 005B","E01029060","Total",764,241,10,231,210,74,182,31,151
"2011","Mendip 005C","E01029061","Total",930,301,18,283,259,89,234,42,192
"2011","Mendip 005D","E01029083","Total",543,252,3,249,99,22,133,7,126
"2011","Mendip 006A","E01029018","Total",921,259,11,248,282,89,205,34,171
"2011","Mendip 006B","E01029056","Total",963,247,8,239,264,84,218,33,185
"2011","Mendip 006C","E01029064","Total",633,187,11,176,166,63,140,25,115
"2011","Mendip 006D","E01029084","Total",670,269,21,248,177,58,192,25,167
"2011","Mendip 007A","E01029029","Total",708,289,48,241,220,95,223,44,179
"2011","Mendip 007B","E01029035","Total",623,140,7,133,220,95,117,36,81
"2011","Mendip 007C","E01029037","Total",597,156,15,141,175,66,136,29,107
"2011","Mendip 007D","E01029038","Total",568,153,40,113,209,95,137,31,106
"2011","Mendip 007E","E01029039","Total",635,242,13,229,156,49,187,30,157
"2011","Mendip 007F","E01029040","Total",717,232,27,205,210,98,200,29,171
"2011","Mendip 008A","E01029078","Total",929,464,13,451,150,45,323,16,307
"2011","Mendip 008B","E01029079","Total",763,321,26,295,169,67,246,23,223
"2011","Mendip 008C","E01029080","Total",634,240,12,228,171,50,185,26,159
"2011","Mendip 008D","E01029081","Total",728,285,24,261,160,46,219,34,185
"2011","Mendip 008E","E01029082","Total",645,304,4,300,137,35,183,22,161
"2011","Mendip 009A","E01029062","Total",685,209,45,164,191,106,155,27,128
"2011","Mendip 009B","E01029063","Total",995,184,32,152,340,149,176,48,128
"2011","Mendip 009C","E01029065","Total",660,139,10,129,223,71,130,32,98
"2011","Mendip 009D","E01029066","Total",739,211,30,181,195,75,150,27,123
"2011","Mendip 009E","E01029067","Total",665,271,22,249,165,62,222,22,200
"2011","Mendip 010A","E01029020","Total",592,167,14,153,175,57,150,25,125
"2011","Mendip 010B","E01029021","Total",488,124,5,119,131,41,110,19,91
"2011","Mendip 010C","E01029027","Total",490,148,5,143,125,36,129,19,110
"2011","Mendip 010D","E01029028","Total",552,202,11,191,122,52,153,17,136
"2011","Mendip 010E","E01029058","Total",946,288,21,267,262,96,245,35,210
"2011","Mendip 011A","E01029046","Total",771,340,33,307,144,76,274,27,247
"2011","Mendip 011D","E01029050","Total",965,311,46,265,272,96,277,61,216
"2011","Mendip 011E","E01029051","Total",707,245,10,235,145,46,223,32,191
"2011","Mendip 011F","E01032627","Total",967,349,42,307,241,82,323,47,276
"2011","Mendip 012A","E01029047","Total",626,182,35,147,189,53,156,33,123
"2011","Mendip 012B","E01029054","Total",624,178,9,169,183,62,164,26,138
"2011","Mendip 012C","E01029055","Total",499,151,13,138,162,45,113,21,92
"2011","Mendip 012D","E01029074","Total",513,179,9,170,144,54,112,19,93
"2011","Mendip 012E","E01029076","Total",823,239,10,229,247,82,185,26,159
"2011","Mendip 013A","E01029019","Total",973,315,16,299,255,67,245,42,203
"2011","Mendip 013B","E01029059","Total",872,267,12,255,228,58,197,34,163
"2011","Mendip 013C","E01029077","Total",828,241,17,224,232,58,175,28,147
"2011","Mendip 014A","E01029070","Total",825,225,21,204,230,95,196,28,168
"2011","Mendip 014B","E01029071","Total",683,235,25,210,207,101,175,32,143
"2011","Mendip 014C","E01029072","Total",767,310,42,268,224,104,259,39,220
"2011","Mendip 014D","E01029073","Total",545,230,18,212,166,63,187,29,158
"2011","Mendip 014E","E01029075","Total",612,271,12,259,124,39,194,20,174
"2011","Sedgemoor 001A","E01029085","Total",878,259,18,241,256,74,212,31,181
"2011","Sedgemoor 001B","E01029126","Total",658,218,14,204,165,61,175,21,154
"2011","Sedgemoor 001C","E01029127","Total",782,376,14,362,150,47,255,20,235
"2011","Sedgemoor 001D","E01029128","Total",754,228,3,225,228,69,175,26,149
"2011","Sedgemoor 001E","E01029129","Total",719,205,4,201,260,68,162,33,129
"2011","Sedgemoor 002C","E01029089","Total",846,222,16,206,296,78,213,54,159
"2011","Sedgemoor 002D","E01029113","Total",736,382,11,371,141,45,240,17,223
"2011","Sedgemoor 002E","E01029115","Total",734,319,10,309,184,64,195,13,182
"2011","Sedgemoor 002F","E01029140","Total",1140,316,31,285,351,143,279,70,209
"2011","Sedgemoor 002G","E01032633","Total",967,395,15,380,177,51,294,24,270
"2011","Sedgemoor 003A","E01029086","Total",864,262,10,252,251,66,184,38,146
"2011","Sedgemoor 003B","E01029147","Total",679,225,12,213,204,51,157,31,126
"2011","Sedgemoor 003C","E01029148","Total",651,231,10,221,195,52,146,17,129
"2011","Sedgemoor 003D","E01029149","Total",554,161,4,157,170,30,145,28,117
"2011","Sedgemoor 004A","E01029114","Total",710,370,9,361,102,34,249,15,234
"2011","Sedgemoor 004B","E01029116","Total",817,376,19,357,116,52,271,15,256
"2011","Sedgemoor 004C","E01029117","Total",791,353,21,332,140,49,270,25,245
"2011","Sedgemoor 004D","E01029119","Total",764,372,14,358,160,59,313,32,281
"2011","Sedgemoor 004E","E01029120","Total",658,215,21,194,204,77,175,33,142
"2011","Sedgemoor 005A","E01029118","Total",717,254,20,234,232,88,190,49,141
"2011","Sedgemoor 005B","E01029131","Total",936,323,76,247,301,151,277,52,225
"2011","Sedgemoor 005C","E01029132","Total",636,294,54,240,206,80,248,52,196
"2011","Sedgemoor 005D","E01029133","Total",597,263,9,254,116,38,198,18,180
"2011","Sedgemoor 005E","E01029134","Total",857,369,28,341,174,58,299,39,260
"2011","Sedgemoor 006A","E01029135","Total",716,280,13,267,139,42,214,23,191
"2011","Sedgemoor 006B","E01029136","Total",809,253,21,232,227,73,223,44,179
"2011","Sedgemoor 006C","E01029145","Total",843,296,11,285,218,76,235,40,195
"2011","Sedgemoor 006D","E01029152","Total",941,409,28,381,223,73,273,39,234
"2011","Sedgemoor 007A","E01029121","Total",535,159,4,155,130,31,135,21,114
"2011","Sedgemoor 007B","E01029122","Total",589,188,9,179,157,40,150,24,126
"2011","Sedgemoor 007C","E01029123","Total",488,210,10,200,115,49,174,20,154
"2011","Sedgemoor 007D","E01029124","Total",792,333,10,323,166,53,217,16,201
"2011","Sedgemoor 007E","E01029125","Total",568,174,5,169,139,42,140,16,124
"2011","Sedgemoor 008A","E01029093","Total",728,266,58,208,239,116,173,35,138
"2011","Sedgemoor 008B","E01029096","Total",597,174,36,138,204,86,149,24,125
"2011","Sedgemoor 008C","E01029106","Total",617,272,76,196,227,103,196,44,152
"2011","Sedgemoor 008D","E01029107","Total",633,276,57,219,194,74,207,45,162
"2011","Sedgemoor 008E","E01029109","Total",517,173,51,122,213,78,160,57,103
"2011","Sedgemoor 009A","E01029094","Total",722,183,36,147,209,121,136,24,112
"2011","Sedgemoor 009B","E01029095","Total",741,249,33,216,179,92,192,28,164
"2011","Sedgemoor 009C","E01029110","Total",999,314,52,262,268,128,246,43,203
"2011","Sedgemoor 009D","E01029111","Total",966,252,72,180,390,193,243,73,170
"2011","Sedgemoor 009E","E01029112","Total",1007,422,24,398,148,73,279,18,261
"2011","Sedgemoor 010A","E01029090","Total",656,196,14,182,182,57,176,30,146
"2011","Sedgemoor 010B","E01029091","Total",740,172,20,152,201,116,146,21,125
"2011","Sedgemoor 010C","E01029092","Total",615,106,17,89,220,74,123,40,83
"2011","Sedgemoor 010D","E01029108","Total",944,350,36,314,210,81,257,31,226
"2011","Sedgemoor 011A","E01029102","Total",626,196,15,181,182,60,193,32,161
"2011","Sedgemoor 011B","E01029103","Total",629,251,1,250,148,49,136,12,124
"2011","Sedgemoor 011C","E01029104","Total",618,222,10,212,187,50,164,24,140
"2011","Sedgemoor 011E","E01032631","Total",543,92,19,73,226,121,83,30,53
"2011","Sedgemoor 011F","E01032632","Total",491,129,5,124,162,65,120,28,92
"2011","Sedgemoor 011G","E01032634","Total",501,169,2,167,134,35,114,14,100
"2011","Sedgemoor 012A","E01029130","Total",862,269,10,259,209,59,204,24,180
"2011","Sedgemoor 012B","E01029137","Total",631,184,5,179,159,38,171,38,133
"2011","Sedgemoor 012C","E01029138","Total",584,216,12,204,161,66,155,22,133
"2011","Sedgemoor 012D","E01029139","Total",607,206,12,194,176,36,167,25,142
"2011","Sedgemoor 012E","E01029150","Total",514,154,5,149,128,36,124,22,102
"2011","Sedgemoor 012F","E01029151","Total",560,213,9,204,120,31,150,16,134
"2011","Sedgemoor 013A","E01029097","Total",596,209,59,150,227,99,143,30,113
"2011","Sedgemoor 013B","E01029098","Total",638,215,24,191,161,63,170,24,146
"2011","Sedgemoor 013C","E01029099","Total",507,200,30,170,155,65,195,47,148
"2011","Sedgemoor 013D","E01029100","Total",491,170,54,116,197,91,126,39,87
"2011","Sedgemoor 013E","E01029105","Total",728,390,39,351,167,73,258,23,235
"2011","Sedgemoor 014A","E01029101","Total",462,153,28,125,152,69,118,26,92
"2011","Sedgemoor 014C","E01029142","Total",642,233,8,225,156,56,177,19,158
"2011","Sedgemoor 014D","E01029143","Total",630,268,23,245,152,61,197,21,176
"2011","Sedgemoor 014E","E01029144","Total",498,128,4,124,147,41,122,23,99
"2011","Sedgemoor 014F","E01032629","Total",624,175,24,151,176,73,136,22,114
"2011","Sedgemoor 014G","E01032630","Total",611,88,19,69,242,133,111,32,79
"2011","South Somerset 001A","E01029157","Total",577,237,17,220,140,45,193,23,170
"2011","South Somerset 001B","E01029158","Total",505,134,16,118,197,59,107,26,81
"2011","South Somerset 001C","E01029221","Total",1017,303,9,294,249,86,205,27,178
"2011","South Somerset 002A","E01029166","Total",946,297,16,281,242,80,214,28,186
"2011","South Somerset 002B","E01029167","Total",740,303,23,280,175,76,216,25,191
"2011","South Somerset 002C","E01029168","Total",742,293,10,283,160,52,177,19,158
"2011","South Somerset 002D","E01029210","Total",639,185,8,177,188,56,125,25,100
"2011","South Somerset 002E","E01029211","Total",593,209,10,199,146,41,158,22,136
"2011","South Somerset 003A","E01029224","Total",702,253,8,245,154,47,188,16,172
"2011","South Somerset 003B","E01029225","Total",933,349,19,330,247,79,267,48,219
"2011","South Somerset 003C","E01029226","Total",809,364,20,344,180,71,231,24,207
"2011","South Somerset 004A","E01029200","Total",640,222,18,204,158,59,186,25,161
"2011","South Somerset 004B","E01029201","Total",611,223,10,213,152,49,162,20,142
"2011","South Somerset 004C","E01029222","Total",646,208,14,194,188,59,158,28,130
"2011","South Somerset 004D","E01029223","Total",513,184,5,179,121,30,121,23,98
"2011","South Somerset 005A","E01029155","Total",789,295,4,291,135,40,188,18,170
"2011","South Somerset 005B","E01029227","Total",658,205,14,191,196,63,182,27,155
"2011","South Somerset 005C","E01029228","Total",719,244,21,223,195,70,208,29,179
"2011","South Somerset 005D","E01029229","Total",948,332,21,311,222,113,269,29,240
"2011","South Somerset 006A","E01029164","Total",613,228,2,226,159,58,160,21,139
"2011","South Somerset 006B","E01029165","Total",522,209,13,196,114,32,130,14,116
"2011","South Somerset 006C","E01029198","Total",486,70,10,60,228,123,86,23,63
"2011","South Somerset 006D","E01029199","Total",881,267,14,253,197,63,225,32,193
"2011","South Somerset 007A","E01029187","Total",443,176,12,164,110,42,142,16,126
"2011","South Somerset 007B","E01029188","Total",654,253,3,250,156,40,167,18,149
"2011","South Somerset 007C","E01029196","Total",619,215,15,200,166,56,168,28,140
"2011","South Somerset 007D","E01029197","Total",537,189,8,181,129,44,163,29,134
"2011","South Somerset 008A","E01029154","Total",773,244,25,219,212,91,184,34,150
"2011","South Somerset 008B","E01029156","Total",816,265,23,242,208,79,221,33,188
"2011","South Somerset 008C","E01029206","Total",645,231,14,217,155,44,166,25,141
"2011","South Somerset 008D","E01029207","Total",606,222,15,207,136,39,142,24,118
"2011","South Somerset 009A","E01029202","Total",557,227,15,212,127,42,183,18,165
"2011","South Somerset 009B","E01029203","Total",645,183,10,173,165,45,132,16,116
"2011","South Somerset 009C","E01029204","Total",537,200,10,190,128,46,143,15,128
"2011","South Somerset 009D","E01029205","Total",765,245,24,221,228,74,170,31,139
"2011","South Somerset 010A","E01029163","Total",946,303,23,280,229,60,217,33,184
"2011","South Somerset 010B","E01029216","Total",660,273,10,263,128,52,167,13,154
"2011","South Somerset 010C","E01029217","Total",679,246,4,242,155,49,156,17,139
"2011","South Somerset 010D","E01029218","Total",880,406,34,372,211,90,277,32,245
"2011","South Somerset 011A","E01029238","Total",651,211,31,180,213,84,177,34,143
"2011","South Somerset 011B","E01029252","Total",601,165,10,155,179,79,125,15,110
"2011","South Somerset 011C","E01029253","Total",704,206,22,184,195,87,173,21,152
"2011","South Somerset 011D","E01029254","Total",593,234,6,228,132,36,140,17,123
"2011","South Somerset 012A","E01029160","Total",960,136,14,122,418,162,139,45,94
"2011","South Somerset 012B","E01029248","Total",641,226,38,188,216,86,185,39,146
"2011","South Somerset 012C","E01029250","Total",549,202,4,198,122,45,144,17,127
"2011","South Somerset 012D","E01029251","Total",556,223,4,219,120,37,172,21,151
"2011","South Somerset 013A","E01029161","Total",660,112,22,90,238,111,122,43,79
"2011","South Somerset 013B","E01029162","Total",754,208,10,198,142,76,157,16,141
"2011","South Somerset 013C","E01029247","Total",626,227,67,160,271,123,166,43,123
"2011","South Somerset 013D","E01029255","Total",600,208,11,197,172,80,154,17,137
"2011","South Somerset 014A","E01029231","Total",676,223,16,207,178,68,176,18,158
"2011","South Somerset 014B","E01029233","Total",571,187,27,160,191,77,164,29,135
"2011","South Somerset 014C","E01029235","Total",625,217,12,205,176,64,191,31,160
"2011","South Somerset 014D","E01029236","Total",613,230,55,175,208,100,188,44,144
"2011","South Somerset 014E","E01029237","Total",664,279,60,219,204,94,220,42,178
"2011","South Somerset 015A","E01029232","Total",620,130,23,107,212,95,128,37,91
"2011","South Somerset 015B","E01029234","Total",995,390,22,368,148,82,286,19,267
"2011","South Somerset 015C","E01029239","Total",700,268,31,237,182,80,186,28,158
"2011","South Somerset 015D","E01029240","Total",624,120,11,109,208,101,128,26,102
"2011","South Somerset 016A","E01029241","Total",813,202,27,175,270,117,166,36,130
"2011","South Somerset 016B","E01029245","Total",925,240,18,222,285,123,201,27,174
"2011","South Somerset 016C","E01029246","Total",612,204,7,197,141,53,147,17,130
"2011","South Somerset 016D","E01029249","Total",635,264,24,240,162,74,214,32,182
"2011","South Somerset 017A","E01029189","Total",481,187,11,176,144,41,130,15,115
"2011","South Somerset 017B","E01029190","Total",584,230,6,224,113,48,140,13,127
"2011","South Somerset 017C","E01029191","Total",548,206,10,196,145,50,149,18,131
"2011","South Somerset 017D","E01029192","Total",621,174,7,167,177,63,151,25,126
"2011","South Somerset 017E","E01029212","Total",479,188,3,185,96,26,120,12,108
"2011","South Somerset 017F","E01029213","Total",552,221,9,212,145,44,149,20,129
"2011","South Somerset 017G","E01029214","Total",483,148,11,137,114,36,118,19,99
"2011","South Somerset 017H","E01029215","Total",506,200,14,186,129,56,142,15,127
"2011","South Somerset 018A","E01029159","Total",634,96,1,95,220,81,87,15,72
"2011","South Somerset 018B","E01029242","Total",631,144,13,131,178,77,134,25,109
"2011","South Somerset 018C","E01029243","Total",775,389,12,377,131,30,244,22,222
"2011","South Somerset 018D","E01029244","Total",619,175,3,172,161,55,124,11,113
"2011","South Somerset 019A","E01029193","Total",911,367,35,332,220,93,246,25,221
"2011","South Somerset 019B","E01029194","Total",1080,385,22,363,299,149,249,33,216
"2011","South Somerset 019C","E01029195","Total",704,304,20,284,164,64,220,32,188
"2011","South Somerset 019D","E01029208","Total",488,200,13,187,106,35,145,17,128
"2011","South Somerset 019E","E01029209","Total",564,197,4,193,123,39,142,21,121
"2011","South Somerset 020A","E01029178","Total",642,235,5,230,136,45,151,23,128
"2011","South Somerset 020B","E01029179","Total",504,179,13,166,127,53,153,22,131
"2011","South Somerset 020C","E01029180","Total",591,194,11,183,155,54,144,25,119
"2011","South Somerset 020D","E01029181","Total",620,236,8,228,121,45,157,16,141
"2011","South Somerset 021A","E01029182","Total",618,232,6,226,149,54,153,20,133
"2011","South Somerset 021B","E01029183","Total",602,208,19,189,183,74,173,35,138
"2011","South Somerset 021C","E01029184","Total",831,335,12,323,170,74,201,15,186
"2011","South Somerset 021D","E01029185","Total",812,284,16,268,173,79,195,23,172
"2011","South Somerset 021E","E01029186","Total",722,343,27,316,136,57,256,19,237
"2011","South Somerset 022A","E01029169","Total",621,193,18,175,188,78,148,23,125
"2011","South Somerset 022B","E01029172","Total",624,228,3,225,171,50,149,22,127
"2011","South Somerset 022C","E01029173","Total",522,153,30,123,190,75,110,28,82
"2011","South Somerset 022D","E01029176","Total",556,194,1,193,120,40,140,10,130
"2011","South Somerset 022E","E01029177","Total",526,233,23,210,136,72,175,16,159
"2011","South Somerset 023A","E01029170","Total",493,167,15,152,150,59,124,18,106
"2011","South Somerset 023B","E01029171","Total",995,436,21,415,188,78,317,23,294
"2011","South Somerset 023C","E01029174","Total",501,225,12,213,90,33,162,14,148
"2011","South Somerset 023D","E01029175","Total",944,409,49,360,283,130,278,42,236
"2011","South Somerset 024A","E01029153","Total",1067,392,13,379,200,79,247,34,213
"2011","South Somerset 024B","E01029219","Total",583,217,8,209,137,33,149,18,131
"2011","South Somerset 024C","E01029220","Total",525,215,9,206,126,50,153,19,134
"2011","South Somerset 024D","E01029230","Total",983,357,16,341,207,72,263,40,223
"2011","Taunton Deane 001A","E01029258","Total",605,178,8,170,181,60,133,20,113
"2011","Taunton Deane 001B","E01029259","Total",610,233,16,217,182,68,186,23,163
"2011","Taunton Deane 001C","E01029260","Total",863,152,14,138,405,160,139,47,92
"2011","Taunton Deane 001D","E01029268","Total",658,196,4,192,183,52,161,31,130
"2011","Taunton Deane 002A","E01029276","Total",584,222,4,218,131,44,159,16,143
"2011","Taunton Deane 002B","E01029278","Total",540,189,11,178,141,38,131,28,103
"2011","Taunton Deane 002C","E01029290","Total",632,193,9,184,159,67,142,16,126
"2011","Taunton Deane 002D","E01029306","Total",617,236,13,223,164,60,190,21,169
"2011","Taunton Deane 002E","E01029319","Total",582,77,25,52,242,103,82,29,53
"2011","Taunton Deane 003A","E01029267","Total",744,289,22,267,203,57,191,26,165
"2011","Taunton Deane 003B","E01029320","Total",704,246,19,227,192,62,201,39,162
"2011","Taunton Deane 003C","E01029321","Total",972,311,19,292,260,83,236,33,203
"2011","Taunton Deane 004A","E01029297","Total",606,273,33,240,149,52,250,28,222
"2011","Taunton Deane 004B","E01029298","Total",610,213,35,178,211,92,172,35,137
"2011","Taunton Deane 004C","E01029304","Total",658,282,37,245,192,78,227,47,180
"2011","Taunton Deane 004D","E01029305","Total",599,195,21,174,172,64,151,21,130
"2011","Taunton Deane 004E","E01029307","Total",610,260,38,222,205,95,182,29,153
"2011","Taunton Deane 005A","E01029271","Total",769,281,10,271,181,60,184,17,167
"2011","Taunton Deane 005B","E01029273","Total",497,163,1,162,158,61,128,25,103
"2011","Taunton Deane 005C","E01029274","Total",647,257,9,248,147,39,180,21,159
"2011","Taunton Deane 005D","E01029275","Total",565,238,3,235,116,28,166,15,151
"2011","Taunton Deane 005E","E01029279","Total",601,185,12,173,176,53,171,30,141
"2011","Taunton Deane 006A","E01029282","Total",639,112,13,99,186,84,119,22,97
"2011","Taunton Deane 006B","E01029291","Total",763,281,42,239,164,81,221,19,202
"2011","Taunton Deane 006C","E01029294","Total",716,144,14,130,254,87,107,30,77
"2011","Taunton Deane 006D","E01029317","Total",523,169,13,156,179,60,130,26,104
"2011","Taunton Deane 006E","E01029318","Total",623,218,3,215,157,38,155,15,140
"2011","Taunton Deane 007A","E01029285","Total",1066,213,20,193,255,149,173,21,152
"2011","Taunton Deane 007B","E01029287","Total",678,118,21,97,188,91,109,22,87
"2011","Taunton Deane 007C","E01029288","Total",655,165,9,156,201,98,116,19,97
"2011","Taunton Deane 007D","E01029289","Total",897,305,26,279,201,105,234,30,204
"2011","Taunton Deane 007E","E01029299","Total",718,269,23,246,133,67,237,21,216
"2011","Taunton Deane 007F","E01029300","Total",666,146,20,126,197,98,112,20,92
"2011","Taunton Deane 008A","E01029256","Total",625,259,8,251,132,34,192,28,164
"2011","Taunton Deane 008B","E01029257","Total",867,303,26,277,273,94,258,49,209
"2011","Taunton Deane 008D","E01029277","Total",473,113,13,100,145,58,96,17,79
"2011","Taunton Deane 008E","E01032651","Total",536,112,12,100,145,65,103,17,86
"2011","Taunton Deane 008F","E01032652","Total",490,141,14,127,148,73,108,20,88
"2011","Taunton Deane 009A","E01029280","Total",690,243,30,213,207,81,217,33,184
"2011","Taunton Deane 009B","E01029281","Total",758,249,24,225,193,75,225,32,193
"2011","Taunton Deane 009C","E01029283","Total",769,210,29,181,227,73,225,45,180
"2011","Taunton Deane 009D","E01029292","Total",630,251,61,190,193,87,221,50,171
"2011","Taunton Deane 009E","E01029293","Total",611,263,118,145,327,185,152,45,107
"2011","Taunton Deane 010A","E01029266","Total",586,258,19,239,116,34,181,24,157
"2011","Taunton Deane 010B","E01029284","Total",881,370,16,354,86,39,279,9,270
"2011","Taunton Deane 010C","E01029286","Total",710,168,22,146,214,116,147,21,126
"2011","Taunton Deane 010D","E01029301","Total",1016,482,17,465,160,67,322,15,307
"2011","Taunton Deane 010E","E01029303","Total",836,386,10,376,200,66,208,22,186
"2011","Taunton Deane 011A","E01029263","Total",593,151,10,141,197,90,120,25,95
"2011","Taunton Deane 011B","E01029264","Total",575,246,6,240,128,45,152,9,143
"2011","Taunton Deane 011C","E01029265","Total",611,235,6,229,138,29,160,28,132
"2011","Taunton Deane 011D","E01029302","Total",716,324,5,319,175,52,218,19,199
"2011","Taunton Deane 011E","E01029308","Total",860,373,7,366,226,72,238,37,201
"2011","Taunton Deane 012A","E01029309","Total",899,318,52,266,259,109,257,42,215
"2011","Taunton Deane 012B","E01029311","Total",593,224,27,197,178,58,165,25,140
"2011","Taunton Deane 012C","E01029312","Total",600,190,13,177,180,54,162,20,142
"2011","Taunton Deane 012D","E01029313","Total",560,142,19,123,194,75,117,28,89
"2011","Taunton Deane 012E","E01029316","Total",789,300,20,280,180,77,224,29,195
"2011","Taunton Deane 013A","E01029262","Total",971,295,14,281,234,76,218,24,194
"2011","Taunton Deane 013B","E01029269","Total",859,226,9,217,214,75,180,24,156
"2011","Taunton Deane 013C","E01029310","Total",785,361,10,351,177,58,217,23,194
"2011","Taunton Deane 013D","E01029314","Total",1059,334,48,286,357,139,249,60,189
"2011","Taunton Deane 013E","E01029315","Total",648,277,8,269,166,45,195,21,174
"2011","Taunton Deane 014A","E01029261","Total",846,247,8,239,218,52,185,23,162
"2011","Taunton Deane 014B","E01029270","Total",921,296,6,290,222,65,219,29,190
"2011","Taunton Deane 014C","E01029295","Total",699,191,10,181,191,73,152,20,132
"2011","Taunton Deane 014D","E01029296","Total",628,246,4,242,158,50,163,13,150
"2011","West Somerset 001B","E01029324","Total",687,252,16,236,188,68,200,25,175
"2011","West Somerset 001C","E01029329","Total",735,320,12,308,168,61,252,31,221
"2011","West Somerset 001D","E01029330","Total",993,508,15,493,128,52,304,22,282
"2011","West Somerset 001F","E01032636","Total",925,440,17,423,183,77,310,24,286
"2011","West Somerset 002A","E01029322","Total",625,298,21,277,143,59,210,30,180
"2011","West Somerset 002B","E01029331","Total",722,433,6,427,89,32,244,11,233
"2011","West Somerset 002C","E01029333","Total",557,267,23,244,131,47,191,29,162
"2011","West Somerset 002D","E01029336","Total",983,470,19,451,168,56,289,38,251
"2011","West Somerset 003A","E01029326","Total",539,253,12,241,93,29,180,24,156
"2011","West Somerset 003B","E01029334","Total",530,256,19,237,92,28,182,20,162
"2011","West Somerset 003C","E01029339","Total",671,284,31,253,172,69,235,38,197
"2011","West Somerset 003E","E01029341","Total",619,291,23,268,131,60,217,25,192
"2011","West Somerset 003G","E01032635","Total",895,372,36,336,238,67,302,52,250
"2011","West Somerset 004A","E01029327","Total",875,277,9,268,177,72,217,27,190
"2011","West Somerset 004B","E01029335","Total",497,176,7,169,100,31,126,17,109
"2011","West Somerset 004C","E01029337","Total",931,374,27,347,195,67,274,42,232
"2011","West Somerset 004D","E01029342","Total",530,256,2,254,67,24,161,6,155
"2011","West Somerset 004E","E01029343","Total",686,300,18,282,139,56,204,31,173
"2011","West Somerset 005A","E01029325","Total",887,420,13,407,139,37,272,25,247
"2011","West Somerset 005B","E01029328","Total",971,459,21,438,156,57,317,27,290
"2011","West Somerset 005C","E01029338","Total",765,247,16,231,153,50,206,32,174
"2011","Isle of Anglesey 001A","W01000003","Total",1131,500,54,446,298,125,372,56,316
"2011","Isle of Anglesey 001B","W01000004","Total",555,265,19,246,135,52,165,22,143
"2011","Isle of Anglesey 001C","W01000018","Total",646,302,27,275,145,54,204,27,177
"2011","Isle of Anglesey 001D","W01000028","Total",802,281,41,240,238,105,241,41,200
"2011","Isle of Anglesey 001E","W01000031","Total",659,254,16,238,158,60,212,23,189
"2011","Isle of Anglesey 002A","W01000010","Total",899,447,17,430,162,59,308,36,272
"2011","Isle of Anglesey 002B","W01000020","Total",558,200,5,195,122,39,149,20,129
"2011","Isle of Anglesey 002C","W01000021","Total",968,399,25,374,224,85,323,46,277
"2011","Isle of Anglesey 002D","W01000032","Total",491,237,18,219,99,37,166,17,149
"2011","Isle of Anglesey 003A","W01000016","Total",579,239,38,201,154,75,178,26,152
"2011","Isle of Anglesey 003B","W01000017","Total",642,245,40,205,203,78,194,44,150
"2011","Isle of Anglesey 003C","W01000029","Total",718,354,60,294,198,93,250,36,214
"2011","Isle of Anglesey 003D","W01000030","Total",997,413,65,348,309,138,332,60,272
"2011","Isle of Anglesey 003E","W01000033","Total",697,371,50,321,189,72,251,34,217
"2011","Isle of Anglesey 003F","W01000036","Total",522,243,43,200,141,54,164,23,141
"2011","Isle of Anglesey 003G","W01000037","Total",518,216,15,201,137,56,159,24,135
"2011","Isle of Anglesey 004A","W01000022","Total",689,285,18,267,169,62,217,38,179
"2011","Isle of Anglesey 004B","W01000034","Total",520,199,10,189,139,43,142,18,124
"2011","Isle of Anglesey 004C","W01000039","Total",472,208,10,198,97,30,136,11,125
"2011","Isle of Anglesey 004D","W01000040","Total",537,257,9,248,97,20,171,16,155
"2011","Isle of Anglesey 004E","W01000043","Total",528,236,28,208,140,61,177,21,156
"2011","Isle of Anglesey 004F","W01000044","Total",495,197,6,191,110,36,125,19,106
"2011","Isle of Anglesey 005A","W01000005","Total",980,448,27,421,175,64,293,33,260
"2011","Isle of Anglesey 005B","W01000013","Total",942,339,17,322,241,78,229,30,199
"2011","Isle of Anglesey 005C","W01000019","Total",691,336,13,323,116,35,229,22,207
"2011","Isle of Anglesey 005D","W01000026","Total",580,263,7,256,100,31,208,10,198
"2011","Isle of Anglesey 005E","W01000035","Total",804,282,17,265,208,83,252,38,214
"2011","Isle of Anglesey 006A","W01000006","Total",654,219,14,205,153,52,204,24,180
"2011","Isle of Anglesey 006B","W01000012","Total",665,289,15,274,155,55,226,26,200
"2011","Isle of Anglesey 006C","W01000014","Total",891,296,29,267,277,122,252,40,212
"2011","Isle of Anglesey 006D","W01000041","Total",637,255,73,182,249,108,218,45,173
"2011","Isle of Anglesey 007A","W01000001","Total",559,251,14,237,90,35,184,12,172
"2011","Isle of Anglesey 007B","W01000002","Total",559,218,9,209,135,50,172,25,147
"2011","Isle of Anglesey 007C","W01000009","Total",778,289,29,260,214,87,244,42,202
"2011","Isle of Anglesey 007D","W01000023","Total",599,213,21,192,164,51,199,29,170
"2011","Isle of Anglesey 007E","W01000024","Total",508,121,41,80,251,145,122,47,75
"2011","Isle of Anglesey 008A","W01000008","Total",617,199,13,186,179,58,162,19,143
"2011","Isle of Anglesey 008B","W01000011","Total",609,247,9,238,106,39,149,15,134
"2011","Isle of Anglesey 008C","W01000015","Total",653,229,8,221,158,53,171,19,152
"2011","Isle of Anglesey 008D","W01000042","Total",910,309,31,278,260,109,244,30,214
"2011","Isle of Anglesey 009A","W01000007","Total",717,252,19,233,177,56,213,31,182
"2011","Isle of Anglesey 009B","W01000025","Total",859,248,18,230,235,82,232,33,199
"2011","Isle of Anglesey 009C","W01000027","Total",773,246,21,225,212,92,224,35,189
"2011","Isle of Anglesey 009D","W01000038","Total",986,425,41,384,245,97,335,51,284
"2011","Gwynedd 001A","W01000062","Total",553,229,21,208,76,45,132,10,122
"2011","Gwynedd 001B","W01000076","Total",439,185,16,169,78,29,119,10,109
"2011","Gwynedd 001C","W01000077","Total",586,292,28,264,105,47,181,17,164
"2011","Gwynedd 001D","W01000091","Total",510,246,44,202,141,61,182,34,148
"2011","Gwynedd 001E","W01000092","Total",697,302,8,294,72,23,172,9,163
"2011","Gwynedd 002A","W01000064","Total",693,238,40,198,245,103,176,35,141
"2011","Gwynedd 002B","W01000072","Total",700,256,25,231,190,64,217,34,183
"2011","Gwynedd 002C","W01000075","Total",622,260,44,216,172,64,191,44,147
"2011","Gwynedd 002D","W01000090","Total",519,209,57,152,221,96,168,47,121
"2011","Gwynedd 002E","W01000102","Total",477,132,7,125,140,55,112,15,97
"2011","Gwynedd 003A","W01000050","Total",580,186,17,169,173,61,155,37,118
"2011","Gwynedd 003B","W01000071","Total",1016,300,56,244,321,140,245,44,201
"2011","Gwynedd 003C","W01000096","Total",513,187,31,156,178,77,142,23,119
"2011","Gwynedd 003D","W01000097","Total",529,199,18,181,121,61,165,27,138
"2011","Gwynedd 003E","W01000115","Total",908,270,25,245,275,105,233,41,192
"2011","Gwynedd 004A","W01000052","Total",461,136,11,125,153,56,125,24,101
"2011","Gwynedd 004B","W01000053","Total",497,125,6,119,141,54,125,22,103
"2011","Gwynedd 004C","W01000087","Total",756,239,23,216,254,107,209,34,175
"2011","Gwynedd 004D","W01000119","Total",1006,316,37,279,257,118,233,37,196
"2011","Gwynedd 005A","W01000063","Total",802,281,44,237,266,116,239,51,188
"2011","Gwynedd 005B","W01000081","Total",896,304,22,282,227,85,245,36,209
"2011","Gwynedd 005C","W01000099","Total",724,195,18,177,230,86,195,45,150
"2011","Gwynedd 005D","W01000103","Total",527,171,16,155,141,49,136,19,117
"2011","Gwynedd 006A","W01000059","Total",954,436,52,384,260,111,344,48,296
"2011","Gwynedd 006B","W01000093","Total",1037,397,6,391,198,71,308,33,275
"2011","Gwynedd 006C","W01000098","Total",925,397,121,276,354,190,315,75,240
"2011","Gwynedd 006D","W01000110","Total",592,168,20,148,199,75,153,28,125
"2011","Gwynedd 007A","W01000054","Total",472,166,9,157,131,54,133,14,119
"2011","Gwynedd 007B","W01000088","Total",817,277,18,259,247,110,239,37,202
"2011","Gwynedd 007C","W01000111","Total",763,288,22,266,181,81,247,28,219
"2011","Gwynedd 007D","W01000118","Total",715,218,17,201,203,72,185,26,159
"2011","Gwynedd 008A","W01000073","Total",729,260,8,252,195,72,215,27,188
"2011","Gwynedd 008B","W01000086","Total",952,369,49,320,260,117,265,37,228
"2011","Gwynedd 008C","W01000104","Total",793,297,34,263,212,80,236,22,214
"2011","Gwynedd 008D","W01000112","Total",861,379,59,320,238,105,286,47,239
"2011","Gwynedd 009A","W01000056","Total",869,355,40,315,234,96,284,40,244
"2011","Gwynedd 009B","W01000065","Total",584,266,18,248,120,46,196,31,165
"2011","Gwynedd 009C","W01000113","Total",830,353,41,312,215,85,265,40,225
"2011","Gwynedd 009D","W01000114","Total",714,277,20,257,163,57,208,22,186
"2011","Gwynedd 010A","W01000066","Total",513,192,10,182,117,48,146,26,120
"2011","Gwynedd 010B","W01000100","Total",466,169,10,159,114,47,118,17,101
"2011","Gwynedd 010C","W01000105","Total",779,277,28,249,202,92,200,28,172
"2011","Gwynedd 010D","W01000106","Total",872,411,8,403,132,36,241,16,225
"2011","Gwynedd 010E","W01000107","Total",588,252,16,236,139,55,187,21,166
"2011","Gwynedd 011A","W01000047","Total",586,200,7,193,143,56,184,17,167
"2011","Gwynedd 011B","W01000061","Total",801,372,13,359,168,48,243,31,212
"2011","Gwynedd 011C","W01000078","Total",722,285,38,247,208,83,220,34,186
"2011","Gwynedd 011D","W01000089","Total",849,271,15,256,228,87,225,41,184
"2011","Gwynedd 012A","W01000070","Total",543,173,6,167,130,53,161,31,130
"2011","Gwynedd 012B","W01000094","Total",574,221,11,210,116,45,164,10,154
"2011","Gwynedd 012C","W01000095","Total",618,252,16,236,166,57,170,22,148
"2011","Gwynedd 012D","W01000108","Total",1048,386,30,356,270,122,287,37,250
"2011","Gwynedd 012E","W01000109","Total",871,364,30,334,205,77,264,28,236
"2011","Gwynedd 013A","W01000069","Total",751,367,12,355,124,50,237,21,216
"2011","Gwynedd 013B","W01000074","Total",946,417,16,401,169,57,292,28,264
"2011","Gwynedd 013C","W01000079","Total",528,249,11,238,95,35,188,25,163
"2011","Gwynedd 013D","W01000101","Total",656,240,12,228,191,75,203,34,169
"2011","Gwynedd 014C","W01000080","Total",915,453,14,439,145,56,295,19,276
"2011","Gwynedd 014D","W01000084","Total",556,228,11,217,121,44,149,21,128
"2011","Gwynedd 014E","W01001932","Total",1227,449,35,414,324,132,362,63,299
"2011","Gwynedd 015A","W01000051","Total",936,380,23,357,218,97,272,31,241
"2011","Gwynedd 015B","W01000060","Total",624,211,14,197,156,55,165,24,141
"2011","Gwynedd 015C","W01000082","Total",436,131,14,117,121,48,123,23,100
"2011","Gwynedd 015D","W01000083","Total",560,173,8,165,131,54,140,20,120
"2011","Gwynedd 016A","W01000048","Total",625,285,30,255,150,61,202,23,179
"2011","Gwynedd 016B","W01000049","Total",620,264,27,237,117,59,177,14,163
"2011","Gwynedd 016C","W01000057","Total",635,234,8,226,132,44,182,15,167
"2011","Gwynedd 016D","W01000067","Total",592,224,7,217,104,40,156,17,139
"2011","Gwynedd 016E","W01000068","Total",688,315,30,285,165,61,203,27,176
"2011","Gwynedd 017C","W01000085","Total",978,447,14,433,155,49,315,28,287
"2011","Gwynedd 017D","W01000116","Total",864,470,9,461,128,46,259,14,245
"2011","Gwynedd 017E","W01000117","Total",737,315,35,280,173,74,276,46,230
"2011","Gwynedd 017F","W01001933","Total",1151,495,10,485,171,52,302,22,280
"2011","Conwy 001A","W01000132","Total",708,295,24,271,126,55,220,16,204
"2011","Conwy 001B","W01000146","Total",1016,354,39,315,172,86,293,36,257
"2011","Conwy 001C","W01000147","Total",760,403,16,387,122,43,246,17,229
"2011","Conwy 001D","W01000169","Total",916,443,31,412,136,68,350,25,325
"2011","Conwy 001E","W01000186","Total",828,425,35,390,192,66,319,41,278
"2011","Conwy 002A","W01000133","Total",873,457,13,444,147,50,284,20,264
"2011","Conwy 002B","W01000168","Total",757,278,41,237,239,84,234,46,188
"2011","Conwy 002C","W01000187","Total",633,267,79,188,259,103,244,67,177
"2011","Conwy 002D","W01000188","Total",780,336,16,320,188,50,233,26,207
"2011","Conwy 003A","W01000154","Total",610,258,13,245,145,37,188,21,167
"2011","Conwy 003B","W01000173","Total",652,191,5,186,182,63,141,23,118
"2011","Conwy 003C","W01000174","Total",745,306,9,297,204,57,211,28,183
"2011","Conwy 003D","W01000175","Total",799,442,5,437,128,44,269,15,254
"2011","Conwy 004A","W01000155","Total",673,319,10,309,126,37,211,19,192
"2011","Conwy 004B","W01000156","Total",819,479,7,472,101,30,282,17,265
"2011","Conwy 004C","W01000157","Total",731,340,29,311,163,71,253,30,223
"2011","Conwy 004D","W01000158","Total",779,442,9,433,116,35,269,17,252
"2011","Conwy 005A","W01000149","Total",677,376,39,337,147,59,263,30,233
"2011","Conwy 005B","W01000150","Total",632,260,19,241,189,60,188,35,153
"2011","Conwy 005C","W01000151","Total",621,239,53,186,238,96,188,57,131
"2011","Conwy 005D","W01000152","Total",614,263,29,234,182,70,214,37,177
"2011","Conwy 005E","W01000184","Total",1062,524,41,483,224,87,389,51,338
"2011","Conwy 006A","W01000135","Total",1009,504,11,493,159,53,311,18,293
"2011","Conwy 006B","W01000136","Total",852,359,22,337,177,61,234,30,204
"2011","Conwy 006C","W01000165","Total",865,372,9,363,195,64,228,16,212
"2011","Conwy 006D","W01000166","Total",813,289,36,253,259,108,238,42,196
"2011","Conwy 007A","W01000139","Total",691,232,17,215,222,67,191,37,154
"2011","Conwy 007B","W01000143","Total",649,225,38,187,212,94,201,43,158
"2011","Conwy 007C","W01000144","Total",712,307,49,258,185,79,229,45,184
"2011","Conwy 007D","W01000182","Total",950,499,34,465,168,64,366,34,332
"2011","Conwy 008A","W01000138","Total",886,423,27,396,203,71,299,36,263
"2011","Conwy 008B","W01000145","Total",578,230,34,196,175,67,183,35,148
"2011","Conwy 008C","W01000180","Total",599,174,10,164,221,71,144,28,116
"2011","Conwy 008D","W01000181","Total",610,129,14,115,242,81,117,38,79
"2011","Conwy 008E","W01000183","Total",585,269,12,257,142,37,201,28,173
"2011","Conwy 009A","W01000126","Total",743,229,17,212,219,68,190,36,154
"2011","Conwy 009B","W01000127","Total",578,251,43,208,164,74,178,39,139
"2011","Conwy 009C","W01000128","Total",677,305,21,284,160,51,218,21,197
"2011","Conwy 009D","W01000153","Total",713,273,14,259,169,52,234,33,201
"2011","Conwy 009E","W01000163","Total",503,221,80,141,200,81,168,49,119
"2011","Conwy 009F","W01000164","Total",549,139,27,112,203,80,134,37,97
"2011","Conwy 010B","W01000140","Total",651,270,37,233,177,60,193,29,164
"2011","Conwy 010C","W01000141","Total",802,493,7,486,105,48,281,19,262
"2011","Conwy 010D","W01000142","Total",715,363,5,358,139,43,205,15,190
"2011","Conwy 010E","W01000178","Total",839,389,59,330,242,91,300,54,246
"2011","Conwy 010F","W01000179","Total",775,397,14,383,121,41,260,23,237
"2011","Conwy 010G","W01001927","Total",582,269,31,238,142,59,192,28,164
"2011","Conwy 010H","W01001928","Total",622,391,31,360,90,38,252,12,240
"2011","Conwy 011C","W01000167","Total",815,337,52,285,236,100,255,45,210
"2011","Conwy 011D","W01000176","Total",718,272,40,232,226,97,199,38,161
"2011","Conwy 011E","W01000177","Total",489,170,17,153,150,44,121,22,99
"2011","Conwy 011F","W01001926","Total",1001,354,23,331,218,65,269,27,242
"2011","Conwy 012A","W01000124","Total",887,333,18,315,204,55,244,31,213
"2011","Conwy 012B","W01000129","Total",497,202,20,182,127,44,129,18,111
"2011","Conwy 012C","W01000130","Total",767,304,15,289,162,56,220,26,194
"2011","Conwy 012D","W01000131","Total",604,214,22,192,179,61,169,38,131
"2011","Conwy 013A","W01000123","Total",744,254,17,237,195,71,249,33,216
"2011","Conwy 013B","W01000125","Total",690,289,10,279,145,53,218,20,198
"2011","Conwy 013C","W01000170","Total",783,295,28,267,208,84,199,30,169
"2011","Conwy 013D","W01000171","Total",690,277,28,249,183,52,213,36,177
"2011","Conwy 013E","W01000172","Total",595,203,43,160,182,82,186,30,156
"2011","Conwy 014A","W01000122","Total",882,279,17,262,226,79,275,30,245
"2011","Conwy 014B","W01000159","Total",564,137,6,131,148,62,137,24,113
"2011","Conwy 014C","W01000162","Total",762,205,7,198,205,67,218,35,183
"2011","Conwy 014D","W01000190","Total",599,171,5,166,140,51,167,19,148
"2011","Conwy 015A","W01000121","Total",548,179,14,165,127,54,137,18,119
"2011","Conwy 015B","W01000134","Total",988,443,45,398,242,92,337,43,294
"2011","Conwy 015C","W01000137","Total",630,204,5,199,169,51,170,30,140
"2011","Conwy 015D","W01000148","Total",484,148,32,116,168,71,127,23,104
"2011","Conwy 015E","W01000185","Total",563,202,11,191,125,49,173,18,155
"2011","Conwy 015F","W01000189","Total",644,166,10,156,134,53,149,23,126
"2011","Denbighshire 001A","W01000218","Total",686,301,24,277,184,61,232,24,208
"2011","Denbighshire 001B","W01000219","Total",1058,399,59,340,365,158,311,65,246
"2011","Denbighshire 001C","W01000220","Total",878,548,11,537,86,27,342,15,327
"2011","Denbighshire 002A","W01000213","Total",588,300,56,244,183,72,229,39,190
"2011","Denbighshire 002B","W01000214","Total",475,196,33,163,160,64,143,26,117
"2011","Denbighshire 002C","W01000215","Total",582,262,6,256,163,50,154,25,129
"2011","Denbighshire 002D","W01000216","Total",572,202,30,172,196,68,186,44,142
"2011","Denbighshire 003A","W01000212","Total",919,390,19,371,237,70,279,35,244
"2011","Denbighshire 003B","W01000221","Total",672,305,20,285,155,63,232,25,207
"2011","Denbighshire 003C","W01000222","Total",800,402,17,385,150,58,275,23,252
"2011","Denbighshire 004A","W01000226","Total",709,351,29,322,141,55,258,36,222
"2011","Denbighshire 004B","W01000227","Total",732,368,20,348,155,61,270,29,241
"2011","Denbighshire 004C","W01000228","Total",534,254,27,227,108,43,185,24,161
"2011","Denbighshire 004D","W01000239","Total",897,498,70,428,205,115,365,40,325
"2011","Denbighshire 004E","W01000240","Total",720,432,65,367,140,82,329,39,290
"2011","Denbighshire 004F","W01000241","Total",492,211,62,149,190,75,177,53,124
"2011","Denbighshire 006A","W01000236","Total",774,381,99,282,278,125,299,83,216
"2011","Denbighshire 006B","W01000237","Total",639,314,124,190,307,129,238,83,155
"2011","Denbighshire 006C","W01000238","Total",645,209,37,172,224,97,184,48,136
"2011","Denbighshire 008A","W01000200","Total",524,175,13,162,162,45,152,33,119
"2011","Denbighshire 008B","W01000201","Total",660,215,34,181,233,87,206,44,162
"2011","Denbighshire 008C","W01000217","Total",862,358,57,301,261,103,283,66,217
"2011","Denbighshire 008D","W01000248","Total",663,197,11,186,187,62,170,28,142
"2011","Denbighshire 009A","W01000191","Total",881,257,30,227,294,127,234,47,187
"2011","Denbighshire 009B","W01000223","Total",580,218,8,210,144,47,165,23,142
"2011","Denbighshire 009C","W01000224","Total",610,270,20,250,149,55,197,28,169
"2011","Denbighshire 009D","W01000225","Total",718,283,23,260,193,76,186,21,165
"2011","Denbighshire 010A","W01000245","Total",737,291,17,274,187,66,190,28,162
"2011","Denbighshire 010B","W01000246","Total",711,263,29,234,199,66,203,35,168
"2011","Denbighshire 010C","W01000247","Total",815,295,13,282,193,75,218,27,191
"2011","Denbighshire 011A","W01000194","Total",951,303,46,257,252,118,256,46,210
"2011","Denbighshire 011B","W01000198","Total",639,301,70,231,215,97,247,40,207
"2011","Denbighshire 011C","W01000199","Total",715,253,28,225,199,70,217,39,178
"2011","Denbighshire 012A","W01000195","Total",622,249,7,242,144,46,185,26,159
"2011","Denbighshire 012B","W01000196","Total",563,107,9,98,198,69,105,23,82
"2011","Denbighshire 012C","W01000197","Total",697,235,14,221,210,65,213,30,183
"2011","Denbighshire 012D","W01000211","Total",749,221,5,216,190,68,199,37,162
"2011","Denbighshire 013A","W01000203","Total",986,294,15,279,265,81,251,40,211
"2011","Denbighshire 013B","W01000204","Total",622,206,5,201,137,35,123,13,110
"2011","Denbighshire 013C","W01000206","Total",852,259,11,248,255,87,215,29,186
"2011","Denbighshire 014A","W01000242","Total",881,333,32,301,237,98,245,34,211
"2011","Denbighshire 014B","W01000243","Total",792,289,23,266,193,81,224,22,202
"2011","Denbighshire 014C","W01000244","Total",733,264,11,253,206,77,188,26,162
"2011","Denbighshire 015A","W01000193","Total",572,187,19,168,154,50,143,31,112
"2011","Denbighshire 015B","W01000202","Total",654,174,13,161,215,63,150,33,117
"2011","Denbighshire 015C","W01000207","Total",946,267,16,251,238,79,244,31,213
"2011","Denbighshire 016A","W01000192","Total",451,161,6,155,96,32,124,11,113
"2011","Denbighshire 016B","W01000205","Total",489,159,6,153,104,33,138,13,125
"2011","Denbighshire 016C","W01000208","Total",561,199,18,181,112,36,151,19,132
"2011","Denbighshire 016D","W01000209","Total",678,279,29,250,167,60,203,36,167
"2011","Denbighshire 016E","W01000210","Total",607,250,10,240,129,48,147,13,134
"2011","Denbighshire 017E","W01000229","Total",772,385,32,353,142,67,267,23,244
"2011","Denbighshire 017F","W01000230","Total",888,364,21,343,200,68,300,44,256
"2011","Denbighshire 017A","W01000231","Total",615,237,17,220,188,53,192,27,165
"2011","Denbighshire 017B","W01000232","Total",680,249,16,233,199,80,192,34,158
"2011","Denbighshire 017C","W01000233","Total",568,212,14,198,141,58,192,27,165
"2011","Denbighshire 017G","W01000234","Total",567,215,64,151,222,99,208,64,144
"2011","Denbighshire 017D","W01000235","Total",563,144,11,133,184,64,144,26,118
"2011","Flintshire 001A","W01000287","Total",828,367,34,333,197,59,264,38,226
"2011","Flintshire 001B","W01000298","Total",675,299,28,271,169,70,250,36,214
"2011","Flintshire 001C","W01000338","Total",788,271,19,252,207,62,220,34,186
"2011","Flintshire 002A","W01000306","Total",972,369,56,313,305,126,291,55,236
"2011","Flintshire 002B","W01000320","Total",762,302,34,268,231,100,254,48,206
"2011","Flintshire 002C","W01000340","Total",957,282,17,265,261,81,243,34,209
"2011","Flintshire 003A","W01000253","Total",784,262,33,229,246,84,233,50,183
"2011","Flintshire 003B","W01000254","Total",920,344,60,284,300,134,309,61,248
"2011","Flintshire 003C","W01000296","Total",638,263,48,215,182,95,244,43,201
"2011","Flintshire 003D","W01000297","Total",500,128,36,92,200,94,129,35,94
"2011","Flintshire 003E","W01000304","Total",896,435,73,362,258,110,334,58,276
"2011","Flintshire 003F","W01000305","Total",753,291,33,258,204,93,243,39,204
"2011","Flintshire 004A","W01000288","Total",1027,488,72,416,287,134,421,50,371
"2011","Flintshire 004B","W01000290","Total",633,328,24,304,129,63,254,20,234
"2011","Flintshire 004C","W01000292","Total",546,197,54,143,232,90,192,53,139
"2011","Flintshire 004D","W01000293","Total",656,202,27,175,201,71,201,43,158
"2011","Flintshire 005A","W01000289","Total",493,109,17,92,185,68,115,29,86
"2011","Flintshire 005B","W01000291","Total",573,142,34,108,210,81,144,34,110
"2011","Flintshire 005C","W01000294","Total",709,164,6,158,236,72,167,32,135
"2011","Flintshire 005D","W01000295","Total",625,198,19,179,206,70,168,41,127
"2011","Flintshire 006A","W01000258","Total",918,308,16,292,223,79,262,33,229
"2011","Flintshire 006B","W01000270","Total",521,135,2,133,133,37,124,18,106
"2011","Flintshire 006C","W01000271","Total",569,184,11,173,139,59,148,17,131
"2011","Flintshire 006D","W01000272","Total",767,256,8,248,191,59,197,31,166
"2011","Flintshire 006E","W01000301","Total",731,224,11,213,200,70,217,32,185
"2011","Flintshire 007A","W01000273","Total",645,243,52,191,191,93,172,35,137
"2011","Flintshire 007B","W01000274","Total",837,351,58,293,250,120,294,52,242
"2011","Flintshire 007C","W01000275","Total",496,122,22,100,149,58,120,21,99
"2011","Flintshire 007D","W01000278","Total",618,246,67,179,228,112,209,45,164
"2011","Flintshire 008A","W01000276","Total",517,64,26,38,239,102,90,40,50
"2011","Flintshire 008B","W01000277","Total",522,87,19,68,197,88,106,36,70
"2011","Flintshire 008C","W01000279","Total",515,204,8,196,117,40,146,21,125
"2011","Flintshire 008D","W01000281","Total",515,165,19,146,145,56,132,21,111
"2011","Flintshire 008E","W01000283","Total",931,289,24,265,269,102,243,49,194
"2011","Flintshire 009A","W01000332","Total",645,159,28,131,196,110,156,30,126
"2011","Flintshire 009B","W01000333","Total",614,268,64,204,208,93,221,44,177
"2011","Flintshire 009C","W01000334","Total",871,304,45,259,231,117,247,38,209
"2011","Flintshire 009D","W01000335","Total",491,243,36,207,131,48,199,25,174
"2011","Flintshire 009E","W01000336","Total",575,262,73,189,231,97,212,53,159
"2011","Flintshire 009F","W01000337","Total",954,315,25,290,246,110,256,37,219
"2011","Flintshire 010A","W01000252","Total",723,309,5,304,139,50,209,18,191
"2011","Flintshire 010B","W01000280","Total",566,180,15,165,168,62,159,20,139
"2011","Flintshire 010C","W01000282","Total",561,46,10,36,330,94,74,33,41
"2011","Flintshire 010D","W01000325","Total",644,212,7,205,172,55,155,21,134
"2011","Flintshire 011A","W01000311","Total",748,242,15,227,204,75,211,28,183
"2011","Flintshire 011B","W01000312","Total",775,293,31,262,205,79,216,27,189
"2011","Flintshire 011C","W01000328","Total",930,297,46,251,236,103,255,33,222
"2011","Flintshire 012A","W01000264","Total",655,160,25,135,266,95,136,40,96
"2011","Flintshire 012B","W01000265","Total",596,223,7,216,131,55,157,17,140
"2011","Flintshire 012C","W01000323","Total",665,217,9,208,166,71,157,20,137
"2011","Flintshire 012D","W01000324","Total",608,169,11,158,199,70,139,24,115
"2011","Flintshire 013A","W01000251","Total",597,191,29,162,209,78,191,40,151
"2011","Flintshire 013B","W01000268","Total",681,191,5,186,252,93,155,25,130
"2011","Flintshire 013C","W01000284","Total",668,156,8,148,243,84,128,28,100
"2011","Flintshire 013D","W01000285","Total",608,181,3,178,160,50,153,21,132
"2011","Flintshire 013E","W01000286","Total",882,141,11,130,334,143,171,42,129
"2011","Flintshire 013F","W01000302","Total",830,344,6,338,202,69,230,32,198
"2011","Flintshire 014A","W01000249","Total",510,153,8,145,153,51,135,17,118
"2011","Flintshire 014B","W01000250","Total",647,228,9,219,173,63,170,30,140
"2011","Flintshire 014C","W01000261","Total",644,181,14,167,166,61,174,29,145
"2011","Flintshire 014D","W01000321","Total",685,203,3,200,203,83,173,24,149
"2011","Flintshire 014E","W01000322","Total",563,218,18,200,141,41,153,22,131
"2011","Flintshire 015A","W01000255","Total",955,307,26,281,283,110,249,41,208
"2011","Flintshire 015B","W01000256","Total",660,163,19,144,215,94,149,33,116
"2011","Flintshire 015C","W01000257","Total",900,235,15,220,258,94,217,39,178
"2011","Flintshire 015D","W01000329","Total",605,212,49,163,204,107,189,39,150
"2011","Flintshire 015E","W01000330","Total",913,265,54,211,304,146,252,53,199
"2011","Flintshire 015F","W01000331","Total",635,163,19,144,193,66,181,44,137
"2011","Flintshire 016A","W01000313","Total",650,220,24,196,216,90,176,36,140
"2011","Flintshire 016B","W01000314","Total",562,268,22,246,116,36,184,29,155
"2011","Flintshire 016C","W01000315","Total",898,383,32,351,226,96,286,41,245
"2011","Flintshire 016D","W01000316","Total",516,182,8,174,163,49,112,20,92
"2011","Flintshire 016E","W01000317","Total",508,122,3,119,190,53,101,19,82
"2011","Flintshire 016F","W01000318","Total",453,189,49,140,190,78,161,44,117
"2011","Flintshire 016G","W01000319","Total",726,290,21,269,174,74,208,27,181
"2011","Flintshire 017A","W01000259","Total",751,307,27,280,176,83,257,38,219
"2011","Flintshire 017B","W01000260","Total",763,224,14,210,220,87,190,38,152
"2011","Flintshire 017C","W01000262","Total",652,214,42,172,212,91,177,40,137
"2011","Flintshire 017D","W01000263","Total",639,259,38,221,193,63,233,46,187
"2011","Flintshire 017E","W01000266","Total",599,208,20,188,148,81,155,27,128
"2011","Flintshire 017F","W01000267","Total",694,249,18,231,187,86,193,23,170
"2011","Flintshire 018A","W01000303","Total",660,183,3,180,228,69,141,25,116
"2011","Flintshire 018B","W01000326","Total",686,221,7,214,201,69,166,29,137
"2011","Flintshire 018C","W01000327","Total",878,238,12,226,263,75,189,28,161
"2011","Flintshire 019A","W01000299","Total",842,305,2,303,199,65,228,28,200
"2011","Flintshire 019B","W01000300","Total",743,245,8,237,177,59,189,19,170
"2011","Flintshire 019C","W01000309","Total",906,286,29,257,284,109,248,50,198
"2011","Flintshire 019D","W01000339","Total",678,230,18,212,182,66,193,23,170
"2011","Flintshire 020A","W01000269","Total",735,276,22,254,171,75,239,30,209
"2011","Flintshire 020B","W01000307","Total",524,131,5,126,168,49,107,19,88
"2011","Flintshire 020C","W01000308","Total",510,179,15,164,163,53,163,28,135
"2011","Flintshire 020D","W01000310","Total",767,233,7,226,208,68,191,30,161
"2011","Wrexham 003A","W01000374","Total",604,248,20,228,169,69,212,33,179
"2011","Wrexham 003B","W01000375","Total",822,167,23,144,303,159,183,47,136
"2011","Wrexham 003C","W01000376","Total",555,163,14,149,169,64,138,24,114
"2011","Wrexham 003D","W01000391","Total",610,192,14,178,152,62,166,28,138
"2011","Wrexham 003E","W01000392","Total",696,270,49,221,259,120,239,49,190
"2011","Wrexham 004A","W01000377","Total",602,136,13,123,204,98,154,40,114
"2011","Wrexham 004B","W01000378","Total",532,198,61,137,225,100,150,44,106
"2011","Wrexham 004C","W01000379","Total",708,293,55,238,212,97,249,41,208
"2011","Wrexham 004D","W01000380","Total",489,86,6,80,154,51,109,19,90
"2011","Wrexham 005A","W01000351","Total",882,261,51,210,282,123,250,57,193
"2011","Wrexham 005B","W01000373","Total",753,273,60,213,274,122,246,55,191
"2011","Wrexham 005C","W01000400","Total",742,218,30,188,222,117,205,28,177
"2011","Wrexham 005D","W01000401","Total",794,257,48,209,257,124,230,52,178
"2011","Wrexham 006A","W01000347","Total",1047,192,27,165,345,180,217,53,164
"2011","Wrexham 006B","W01000348","Total",622,234,55,179,220,112,211,44,167
"2011","Wrexham 006C","W01000362","Total",622,216,49,167,222,98,199,51,148
"2011","Wrexham 006D","W01000363","Total",689,278,16,262,169,71,233,28,205
"2011","Wrexham 006E","W01000364","Total",688,198,8,190,200,72,176,27,149
"2011","Wrexham 007A","W01000343","Total",463,213,5,208,99,30,126,21,105
"2011","Wrexham 007B","W01000344","Total",586,245,4,241,114,31,164,14,150
"2011","Wrexham 007C","W01000415","Total",683,273,6,267,153,59,208,21,187
"2011","Wrexham 007D","W01000416","Total",508,99,3,96,150,55,92,21,71
"2011","Wrexham 008A","W01000368","Total",918,361,4,357,217,83,230,16,214
"2011","Wrexham 008B","W01000371","Total",527,159,11,148,131,60,105,16,89
"2011","Wrexham 008C","W01000372","Total",598,240,20,220,116,56,172,15,157
"2011","Wrexham 008D","W01000387","Total",508,187,12,175,158,43,138,30,108
"2011","Wrexham 008E","W01000388","Total",470,181,12,169,129,46,138,21,117
"2011","Wrexham 008F","W01000422","Total",944,385,19,366,221,79,303,44,259
"2011","Wrexham 009A","W01000341","Total",684,262,31,231,204,83,228,51,177
"2011","Wrexham 009B","W01000342","Total",727,342,42,300,189,82,304,45,259
"2011","Wrexham 009C","W01000393","Total",828,330,29,301,222,84,233,30,203
"2011","Wrexham 010A","W01000352","Total",408,168,28,140,130,43,133,20,113
"2011","Wrexham 010B","W01000353","Total",552,215,57,158,211,94,173,45,128
"2011","Wrexham 010C","W01000413","Total",553,295,137,158,279,156,171,59,112
"2011","Wrexham 010D","W01000414","Total",515,209,88,121,217,120,154,36,118
"2011","Wrexham 010E","W01000425","Total",910,449,164,285,377,178,351,101,250
"2011","Wrexham 011A","W01000349","Total",840,225,10,215,234,96,222,31,191
"2011","Wrexham 011B","W01000350","Total",716,223,30,193,165,89,160,26,134
"2011","Wrexham 011C","W01000365","Total",822,266,14,252,204,71,217,26,191
"2011","Wrexham 011D","W01000402","Total",1137,282,32,250,281,142,253,40,213
"2011","Wrexham 012A","W01000381","Total",534,240,11,229,114,41,204,22,182
"2011","Wrexham 012B","W01000382","Total",545,234,39,195,129,46,191,38,153
"2011","Wrexham 012D","W01000423","Total",886,235,70,165,370,193,194,64,130
"2011","Wrexham 012E","W01000424","Total",556,167,24,143,140,66,164,32,132
"2011","Wrexham 012F","W01001929","Total",621,200,22,178,144,77,165,20,145
"2011","Wrexham 012G","W01001931","Total",639,241,33,208,140,82,195,17,178
"2011","Wrexham 013A","W01000398","Total",571,202,17,185,145,49,166,36,130
"2011","Wrexham 013B","W01000399","Total",465,115,4,111,133,51,110,18,92
"2011","Wrexham 013C","W01000406","Total",880,332,79,253,325,135,273,61,212
"2011","Wrexham 013D","W01000408","Total",506,192,20,172,157,52,167,37,130
"2011","Wrexham 014A","W01000366","Total",619,232,38,194,191,94,183,38,145
"2011","Wrexham 014B","W01000367","Total",543,153,16,137,188,64,119,23,96
"2011","Wrexham 014C","W01000385","Total",750,244,12,232,208,78,185,29,156
"2011","Wrexham 014D","W01000410","Total",724,255,25,230,206,93,213,35,178
"2011","Wrexham 015A","W01000386","Total",661,239,42,197,209,94,208,45,163
"2011","Wrexham 015B","W01000405","Total",919,368,86,282,338,176,308,84,224
"2011","Wrexham 015C","W01000411","Total",796,405,62,343,217,112,300,32,268
"2011","Wrexham 015D","W01000412","Total",703,246,36,210,209,85,219,38,181
"2011","Wrexham 016A","W01000394","Total",506,99,2,97,150,33,114,22,92
"2011","Wrexham 016B","W01000395","Total",475,163,11,152,125,54,130,15,115
"2011","Wrexham 016C","W01000407","Total",596,169,5,164,168,65,137,20,117
"2011","Wrexham 016D","W01000419","Total",619,192,31,161,230,88,179,35,144
"2011","Wrexham 016E","W01000420","Total",630,225,20,205,176,81,195,24,171
"2011","Wrexham 017A","W01000354","Total",719,260,15,245,203,69,209,35,174
"2011","Wrexham 017B","W01000355","Total",770,371,38,333,177,76,292,43,249
"2011","Wrexham 017C","W01000356","Total",645,237,52,185,239,89,203,55,148
"2011","Wrexham 017D","W01000389","Total",869,315,23,292,265,100,251,43,208
"2011","Wrexham 017E","W01000409","Total",815,405,131,274,353,199,277,68,209
"2011","Wrexham 018A","W01000345","Total",684,236,9,227,178,50,181,23,158
"2011","Wrexham 018B","W01000346","Total",632,177,9,168,193,66,165,25,140
"2011","Wrexham 018C","W01000403","Total",555,182,13,169,148,39,136,15,121
"2011","Wrexham 018D","W01000404","Total",826,259,20,239,244,84,216,47,169
"2011","Wrexham 019C","W01000359","Total",507,146,21,125,151,61,125,26,99
"2011","Wrexham 019D","W01000360","Total",532,221,28,193,150,57,168,24,144
"2011","Wrexham 019E","W01000361","Total",893,311,33,278,244,105,251,28,223
"2011","Wrexham 019F","W01001930","Total",907,311,26,285,240,80,269,38,231
"2011","Wrexham 020F","W01000369","Total",594,266,5,261,130,27,177,20,157
"2011","Wrexham 020G","W01000370","Total",630,234,12,222,149,54,176,23,153
"2011","Wrexham 020A","W01000383","Total",922,176,19,157,358,116,184,43,141
"2011","Wrexham 020B","W01000384","Total",485,184,2,182,110,42,129,14,115
"2011","Wrexham 020C","W01000390","Total",670,222,14,208,187,59,185,36,149
"2011","Wrexham 020H","W01000396","Total",500,146,4,142,153,40,116,19,97
"2011","Wrexham 020I","W01000397","Total",412,125,2,123,121,28,77,11,66
"2011","Wrexham 020D","W01000417","Total",640,181,2,179,196,57,123,18,105
"2011","Wrexham 020E","W01000418","Total",724,250,20,230,194,77,175,25,150
"2011","Powys 001A","W01000461","Total",675,244,22,222,176,67,190,25,165
"2011","Powys 001D","W01000470","Total",828,303,13,290,179,58,240,31,209
"2011","Powys 001E","W01000475","Total",975,289,12,277,240,75,266,39,227
"2011","Powys 001F","W01001906","Total",843,275,6,269,196,69,221,27,194
"2011","Powys 001G","W01001907","Total",572,162,9,153,159,58,144,20,124
"2011","Powys 002A","W01000444","Total",1005,354,9,345,240,86,288,36,252
"2011","Powys 002B","W01000457","Total",867,257,11,246,263,85,197,32,165
"2011","Powys 002C","W01000458","Total",769,255,7,248,201,80,227,26,201
"2011","Powys 003A","W01000498","Total",734,301,30,271,198,78,263,47,216
"2011","Powys 003B","W01000499","Total",555,215,22,193,151,60,178,25,153
"2011","Powys 003C","W01000500","Total",655,207,18,189,188,58,190,42,148
"2011","Powys 003D","W01000501","Total",1011,382,26,356,242,93,327,42,285
"2011","Powys 004A","W01000442","Total",890,272,12,260,206,73,258,47,211
"2011","Powys 004B","W01000452","Total",825,290,16,274,198,63,253,36,217
"2011","Powys 004C","W01000473","Total",1033,390,24,366,250,102,329,43,286
"2011","Powys 005A","W01000428","Total",593,190,2,188,133,35,184,20,164
"2011","Powys 005B","W01000441","Total",598,199,7,192,168,67,133,22,111
"2011","Powys 005C","W01000476","Total",603,226,6,220,143,53,156,11,145
"2011","Powys 005D","W01000497","Total",556,158,11,147,175,61,133,21,112
"2011","Powys 006A","W01000433","Total",1032,364,24,340,235,100,285,28,257
"2011","Powys 006B","W01000460","Total",728,210,21,189,225,68,209,42,167
"2011","Powys 006C","W01000488","Total",892,243,11,232,232,78,205,41,164
"2011","Powys 007A","W01000434","Total",695,227,15,212,175,59,214,30,184
"2011","Powys 007B","W01000439","Total",816,217,8,209,227,73,213,34,179
"2011","Powys 007C","W01000447","Total",838,269,10,259,233,71,240,36,204
"2011","Powys 008A","W01000480","Total",970,328,41,287,249,105,293,43,250
"2011","Powys 008B","W01000481","Total",1093,396,17,379,236,89,300,30,270
"2011","Powys 008C","W01000482","Total",817,268,19,249,204,71,216,31,185
"2011","Powys 009A","W01000478","Total",719,246,69,177,286,131,202,61,141
"2011","Powys 009B","W01000479","Total",614,230,56,174,217,104,184,51,133
"2011","Powys 009C","W01000483","Total",802,331,80,251,309,124,282,65,217
"2011","Powys 010A","W01000429","Total",951,286,17,269,244,80,258,39,219
"2011","Powys 010B","W01000453","Total",587,172,3,169,146,38,167,22,145
"2011","Powys 010C","W01000466","Total",621,251,18,233,178,68,198,23,175
"2011","Powys 010D","W01000467","Total",795,305,22,283,145,61,238,22,216
"2011","Powys 011A","W01000427","Total",604,210,21,189,149,43,163,21,142
"2011","Powys 011B","W01000448","Total",639,245,29,216,169,49,173,28,145
"2011","Powys 011C","W01000449","Total",753,261,19,242,169,51,227,24,203
"2011","Powys 011D","W01000464","Total",534,167,8,159,107,34,134,17,117
"2011","Powys 011E","W01000484","Total",678,226,9,217,151,39,146,27,119
"2011","Powys 011F","W01000485","Total",740,343,5,338,129,39,212,16,196
"2011","Powys 011G","W01000486","Total",501,183,21,162,150,64,143,18,125
"2011","Powys 012A","W01000438","Total",608,324,23,301,97,31,221,16,205
"2011","Powys 012B","W01000451","Total",483,174,5,169,121,40,136,15,121
"2011","Powys 012C","W01000472","Total",511,205,5,200,117,38,167,20,147
"2011","Powys 012D","W01000477","Total",621,202,9,193,135,38,153,18,135
"2011","Powys 012E","W01000487","Total",987,409,23,386,206,89,317,34,283
"2011","Powys 013A","W01000454","Total",671,350,23,327,109,37,251,22,229
"2011","Powys 013B","W01000455","Total",901,340,50,290,264,108,281,55,226
"2011","Powys 013C","W01000456","Total",1011,525,43,482,195,75,341,40,301
"2011","Powys 014A","W01000431","Total",586,162,17,145,182,72,145,24,121
"2011","Powys 014B","W01000432","Total",532,191,9,182,137,48,138,13,125
"2011","Powys 014C","W01000450","Total",597,172,7,165,144,48,155,16,139
"2011","Powys 014D","W01000459","Total",519,152,9,143,133,47,139,17,122
"2011","Powys 014E","W01000471","Total",838,292,21,271,180,70,235,33,202
"2011","Powys 015A","W01000430","Total",554,185,12,173,138,57,156,23,133
"2011","Powys 015B","W01000443","Total",1009,311,6,305,225,87,242,28,214
"2011","Powys 015C","W01000445","Total",623,181,11,170,164,61,160,31,129
"2011","Powys 015D","W01000446","Total",828,316,26,290,172,56,240,31,209
"2011","Powys 015E","W01000494","Total",737,238,18,220,197,67,218,29,189
"2011","Powys 017A","W01000489","Total",742,267,19,248,202,92,229,32,197
"2011","Powys 017D","W01000492","Total",823,315,18,297,164,56,238,20,218
"2011","Powys 017E","W01000493","Total",595,220,16,204,200,65,151,24,127
"2011","Powys 017F","W01001901","Total",884,374,24,350,225,67,266,39,227
"2011","Powys 017G","W01001902","Total",591,211,54,157,215,78,189,39,150
"2011","Powys 018E","W01000465","Total",426,165,5,160,100,26,128,18,110
"2011","Powys 018F","W01001903","Total",937,380,10,370,202,61,303,34,269
"2011","Powys 018G","W01001904","Total",727,246,14,232,200,57,189,30,159
"2011","Powys 018H","W01001905","Total",880,251,9,242,228,60,235,39,196
"2011","Powys 020A","W01000440","Total",546,145,4,141,144,43,130,16,114
"2011","Powys 020B","W01000474","Total",750,216,14,202,184,61,221,27,194
"2011","Powys 020C","W01000503","Total",432,122,4,118,116,27,104,20,84
"2011","Powys 020D","W01001897","Total",837,275,12,263,204,71,237,39,198
"2011","Powys 021A","W01000426","Total",643,263,19,244,154,54,211,26,185
"2011","Powys 021B","W01000496","Total",895,359,23,336,233,62,286,42,244
"2011","Powys 021C","W01000502","Total",957,456,17,439,212,62,387,50,337
"2011","Powys 021D","W01000504","Total",546,272,47,225,166,72,218,32,186
"2011","Powys 021E","W01000505","Total",646,291,24,267,144,39,245,29,216
"2011","Powys 021F","W01001899","Total",866,363,32,331,233,75,310,48,262
"2011","Ceredigion 001C","W01000523","Total",834,262,10,252,226,78,216,43,173
"2011","Ceredigion 001D","W01000548","Total",764,263,26,237,241,91,219,36,183
"2011","Ceredigion 001E","W01000549","Total",744,208,7,201,212,78,174,24,150
"2011","Ceredigion 001F","W01001937","Total",949,353,19,334,229,72,274,38,236
"2011","Ceredigion 002A","W01000512","Total",604,238,4,234,90,39,145,15,130
"2011","Ceredigion 002B","W01000513","Total",1022,419,9,410,67,29,194,9,185
"2011","Ceredigion 002D","W01000517","Total",589,245,6,239,58,21,153,14,139
"2011","Ceredigion 002F","W01001934","Total",1106,521,20,501,137,62,309,24,285
"2011","Ceredigion 003A","W01000515","Total",608,234,37,197,200,83,202,50,152
"2011","Ceredigion 003B","W01000516","Total",674,236,46,190,224,85,214,51,163
"2011","Ceredigion 003C","W01000518","Total",627,264,9,255,93,39,191,16,175
"2011","Ceredigion 003E","W01001935","Total",469,149,7,142,107,60,106,10,96
"2011","Ceredigion 003F","W01001936","Total",462,153,10,143,118,45,112,23,89
"2011","Ceredigion 005A","W01000506","Total",732,370,6,364,107,43,238,19,219
"2011","Ceredigion 005B","W01000524","Total",831,284,21,263,215,74,227,30,197
"2011","Ceredigion 005C","W01000538","Total",654,196,10,186,184,64,178,25,153
"2011","Ceredigion 005D","W01000539","Total",506,164,13,151,119,30,155,28,127
"2011","Ceredigion 005E","W01000540","Total",534,229,16,213,112,48,169,20,149
"2011","Ceredigion 007A","W01000529","Total",664,232,29,203,181,84,197,29,168
"2011","Ceredigion 007B","W01000532","Total",838,348,10,338,184,67,262,27,235
"2011","Ceredigion 007C","W01000544","Total",517,232,16,216,103,40,158,23,135
"2011","Ceredigion 007D","W01000545","Total",902,373,15,358,185,58,271,30,241
"2011","Ceredigion 008A","W01000527","Total",461,191,20,171,101,43,151,14,137
"2011","Ceredigion 008B","W01000528","Total",641,259,31,228,171,63,210,29,181
"2011","Ceredigion 008C","W01000535","Total",885,351,17,334,212,79,282,46,236
"2011","Ceredigion 008D","W01000537","Total",664,256,25,231,145,47,206,35,171
"2011","Ceredigion 008E","W01000541","Total",781,265,17,248,205,76,229,30,199
"2011","Ceredigion 009A","W01000507","Total",554,273,16,257,106,40,174,27,147
"2011","Ceredigion 009B","W01000508","Total",538,240,33,207,139,57,163,21,142
"2011","Ceredigion 009C","W01000509","Total",802,384,36,348,186,83,271,39,232
"2011","Ceredigion 009D","W01000510","Total",643,344,28,316,127,55,280,24,256
"2011","Ceredigion 009E","W01000511","Total",560,244,43,201,155,66,197,39,158
"2011","Ceredigion 009F","W01000546","Total",532,245,17,228,100,36,170,12,158
"2011","Ceredigion 009G","W01000547","Total",536,216,8,208,118,42,155,15,140
"2011","Ceredigion 010A","W01000519","Total",720,283,13,270,146,48,217,24,193
"2011","Ceredigion 010B","W01000522","Total",553,209,8,201,125,33,175,18,157
"2011","Ceredigion 010C","W01000531","Total",800,319,25,294,201,80,266,39,227
"2011","Ceredigion 010D","W01000533","Total",660,270,42,228,168,60,213,42,171
"2011","Ceredigion 010E","W01000551","Total",575,226,16,210,135,45,197,35,162
"2011","Ceredigion 011A","W01000525","Total",500,213,1,212,104,32,139,14,125
"2011","Ceredigion 011B","W01000534","Total",655,217,13,204,187,84,155,22,133
"2011","Ceredigion 011E","W01000536","Total",663,256,10,246,137,54,204,25,179
"2011","Ceredigion 011F","W01000542","Total",937,316,22,294,236,84,296,46,250
"2011","Ceredigion 011C","W01000543","Total",880,277,22,255,226,77,264,40,224
"2011","Ceredigion 011G","W01000550","Total",565,242,20,222,129,53,188,26,162
"2011","Ceredigion 011D","W01000552","Total",827,243,16,227,253,81,199,42,157
"2011","Pembrokeshire 001A","W01000558","Total",887,295,23,272,250,97,239,25,214
"2011","Pembrokeshire 001B","W01000559","Total",611,210,11,199,134,43,194,36,158
"2011","Pembrokeshire 001C","W01000560","Total",521,158,17,141,125,44,137,17,120
"2011","Pembrokeshire 001D","W01000561","Total",502,146,9,137,149,50,136,28,108
"2011","Pembrokeshire 001E","W01000613","Total",1016,425,36,389,227,83,270,35,235
"2011","Pembrokeshire 002A","W01000562","Total",736,267,24,243,166,60,207,21,186
"2011","Pembrokeshire 002B","W01000565","Total",891,427,39,388,185,75,286,33,253
"2011","Pembrokeshire 002C","W01000566","Total",736,346,33,313,167,71,258,21,237
"2011","Pembrokeshire 002D","W01000567","Total",901,353,40,313,236,91,274,40,234
"2011","Pembrokeshire 002E","W01000597","Total",583,285,20,265,115,48,195,24,171
"2011","Pembrokeshire 002F","W01000617","Total",615,195,24,171,170,70,171,28,143
"2011","Pembrokeshire 003A","W01000579","Total",985,364,37,327,286,112,278,56,222
"2011","Pembrokeshire 003B","W01000581","Total",648,206,11,195,149,33,183,26,157
"2011","Pembrokeshire 003C","W01000612","Total",851,341,22,319,180,61,258,25,233
"2011","Pembrokeshire 003D","W01000618","Total",646,234,16,218,180,56,176,28,148
"2011","Pembrokeshire 004A","W01000582","Total",711,218,14,204,179,48,200,29,171
"2011","Pembrokeshire 004B","W01000583","Total",592,188,21,167,199,66,152,40,112
"2011","Pembrokeshire 004C","W01000611","Total",730,270,9,261,164,46,241,36,205
"2011","Pembrokeshire 004D","W01000623","Total",774,244,18,226,236,60,195,35,160
"2011","Pembrokeshire 005A","W01000568","Total",1193,460,61,399,279,104,375,48,327
"2011","Pembrokeshire 005B","W01000569","Total",526,157,21,136,213,101,140,36,104
"2011","Pembrokeshire 005C","W01000570","Total",610,211,101,110,295,130,158,64,94
"2011","Pembrokeshire 005D","W01000572","Total",789,299,20,279,218,74,246,30,216
"2011","Pembrokeshire 006A","W01000571","Total",1013,440,42,398,250,92,348,55,293
"2011","Pembrokeshire 006B","W01000573","Total",1119,353,39,314,325,142,271,53,218
"2011","Pembrokeshire 006C","W01000586","Total",888,317,51,266,287,114,290,67,223
"2011","Pembrokeshire 007A","W01000577","Total",634,211,13,198,178,54,165,27,138
"2011","Pembrokeshire 007B","W01000585","Total",540,142,7,135,142,38,149,30,119
"2011","Pembrokeshire 007C","W01000595","Total",908,380,29,351,224,69,310,38,272
"2011","Pembrokeshire 007D","W01000596","Total",620,202,17,185,178,55,157,32,125
"2011","Pembrokeshire 008A","W01000555","Total",579,195,6,189,134,40,140,19,121
"2011","Pembrokeshire 008B","W01000556","Total",509,208,5,203,102,32,159,15,144
"2011","Pembrokeshire 008C","W01000575","Total",985,345,25,320,293,105,278,51,227
"2011","Pembrokeshire 008D","W01000614","Total",612,225,12,213,144,46,177,21,156
"2011","Pembrokeshire 008E","W01000622","Total",637,215,11,204,170,59,138,26,112
"2011","Pembrokeshire 009A","W01000554","Total",752,246,12,234,205,67,206,33,173
"2011","Pembrokeshire 009B","W01000580","Total",961,330,20,310,300,111,248,55,193
"2011","Pembrokeshire 009C","W01000598","Total",1023,437,38,399,259,89,310,37,273
"2011","Pembrokeshire 009D","W01000599","Total",897,347,47,300,280,97,281,54,227
"2011","Pembrokeshire 010A","W01000587","Total",1003,436,26,410,215,92,301,37,264
"2011","Pembrokeshire 010B","W01000588","Total",931,398,88,310,337,146,271,68,203
"2011","Pembrokeshire 010C","W01000593","Total",1163,483,49,434,322,140,354,61,293
"2011","Pembrokeshire 011A","W01000553","Total",546,229,10,219,115,32,162,27,135
"2011","Pembrokeshire 011B","W01000563","Total",484,168,15,153,138,44,144,29,115
"2011","Pembrokeshire 011C","W01000564","Total",523,223,16,207,134,49,153,26,127
"2011","Pembrokeshire 011D","W01000576","Total",955,442,37,405,263,89,343,65,278
"2011","Pembrokeshire 011E","W01000615","Total",671,317,17,300,149,48,183,19,164
"2011","Pembrokeshire 011F","W01000616","Total",529,233,9,224,109,35,147,11,136
"2011","Pembrokeshire 012A","W01000589","Total",525,225,33,192,155,75,198,26,172
"2011","Pembrokeshire 012B","W01000590","Total",547,288,13,275,88,22,222,17,205
"2011","Pembrokeshire 012C","W01000591","Total",489,179,25,154,154,59,146,27,119
"2011","Pembrokeshire 012D","W01000592","Total",497,187,48,139,186,74,154,42,112
"2011","Pembrokeshire 012E","W01000594","Total",989,439,83,356,319,150,326,63,263
"2011","Pembrokeshire 013A","W01000600","Total",786,368,45,323,199,83,255,35,220
"2011","Pembrokeshire 013B","W01000601","Total",642,328,90,238,228,94,253,58,195
"2011","Pembrokeshire 013C","W01000602","Total",581,246,38,208,149,59,166,22,144
"2011","Pembrokeshire 013D","W01000603","Total",827,313,57,256,271,100,243,55,188
"2011","Pembrokeshire 013E","W01000604","Total",624,221,42,179,216,81,178,50,128
"2011","Pembrokeshire 013F","W01000605","Total",711,231,30,201,236,82,211,55,156
"2011","Pembrokeshire 014A","W01000557","Total",612,188,11,177,204,67,160,31,129
"2011","Pembrokeshire 014B","W01000578","Total",740,313,15,298,161,51,227,28,199
"2011","Pembrokeshire 014C","W01000584","Total",876,354,34,320,233,82,264,41,223
"2011","Pembrokeshire 014D","W01000609","Total",1090,501,19,482,230,81,323,36,287
"2011","Pembrokeshire 015A","W01000574","Total",791,292,25,267,207,69,217,37,180
"2011","Pembrokeshire 015B","W01000606","Total",707,354,100,254,267,108,252,51,201
"2011","Pembrokeshire 015C","W01000607","Total",848,352,75,277,286,126,269,66,203
"2011","Pembrokeshire 015D","W01000608","Total",700,318,29,289,162,54,199,28,171
"2011","Pembrokeshire 016A","W01000610","Total",751,332,18,314,175,58,234,28,206
"2011","Pembrokeshire 016B","W01000619","Total",969,398,21,377,237,67,307,43,264
"2011","Pembrokeshire 016C","W01000620","Total",595,262,13,249,93,43,188,11,177
"2011","Pembrokeshire 016D","W01000621","Total",689,272,35,237,181,73,231,36,195
"2011","Carmarthenshire 001A","W01000685","Total",682,241,37,204,181,65,208,38,170
"2011","Carmarthenshire 001B","W01000686","Total",531,189,14,175,134,41,160,25,135
"2011","Carmarthenshire 001C","W01000701","Total",678,248,33,215,195,78,208,33,175
"2011","Carmarthenshire 001D","W01000702","Total",515,201,31,170,158,77,161,34,127
"2011","Carmarthenshire 002A","W01000647","Total",630,222,25,197,160,53,205,38,167
"2011","Carmarthenshire 002B","W01000650","Total",716,249,20,229,151,60,236,39,197
"2011","Carmarthenshire 002C","W01000678","Total",615,282,23,259,136,42,202,21,181
"2011","Carmarthenshire 002D","W01000679","Total",555,211,13,198,133,45,181,18,163
"2011","Carmarthenshire 003A","W01000646","Total",960,367,48,319,245,88,290,50,240
"2011","Carmarthenshire 003B","W01000688","Total",772,312,54,258,223,87,262,55,207
"2011","Carmarthenshire 003C","W01000689","Total",707,276,19,257,171,55,228,36,192
"2011","Carmarthenshire 003D","W01000728","Total",835,258,9,249,205,63,245,39,206
"2011","Carmarthenshire 004A","W01000676","Total",684,237,16,221,165,47,201,29,172
"2011","Carmarthenshire 004B","W01000677","Total",702,301,25,276,170,67,240,21,219
"2011","Carmarthenshire 004C","W01000687","Total",817,271,12,259,191,60,228,24,204
"2011","Carmarthenshire 004D","W01000709","Total",921,334,26,308,239,65,274,39,235
"2011","Carmarthenshire 005A","W01000624","Total",946,309,16,293,269,76,281,52,229
"2011","Carmarthenshire 005B","W01000682","Total",560,201,18,183,163,59,153,19,134
"2011","Carmarthenshire 005C","W01000683","Total",452,131,8,123,102,27,120,14,106
"2011","Carmarthenshire 005D","W01000684","Total",774,258,15,243,209,63,228,34,194
"2011","Carmarthenshire 006A","W01000643","Total",699,240,34,206,236,109,201,45,156
"2011","Carmarthenshire 006B","W01000644","Total",565,157,30,127,203,97,128,26,102
"2011","Carmarthenshire 006C","W01000645","Total",742,293,25,268,220,103,224,38,186
"2011","Carmarthenshire 006D","W01000648","Total",566,150,4,146,155,57,183,32,151
"2011","Carmarthenshire 006E","W01000649","Total",649,237,3,234,149,45,178,21,157
"2011","Carmarthenshire 007A","W01000637","Total",641,274,39,235,197,67,236,44,192
"2011","Carmarthenshire 007B","W01000638","Total",484,190,52,138,172,88,140,28,112
"2011","Carmarthenshire 007C","W01000639","Total",638,249,28,221,165,57,181,27,154
"2011","Carmarthenshire 007D","W01000640","Total",504,182,9,173,106,39,125,18,107
"2011","Carmarthenshire 008A","W01000641","Total",1162,538,37,501,197,77,416,28,388
"2011","Carmarthenshire 008B","W01000642","Total",720,267,12,255,174,51,206,26,180
"2011","Carmarthenshire 008C","W01000693","Total",505,248,15,233,119,46,181,19,162
"2011","Carmarthenshire 008D","W01000694","Total",558,197,10,187,130,36,140,23,117
"2011","Carmarthenshire 010A","W01000656","Total",906,396,64,332,268,102,327,72,255
"2011","Carmarthenshire 010B","W01000657","Total",502,232,27,205,121,39,198,28,170
"2011","Carmarthenshire 010C","W01000658","Total",545,217,28,189,173,59,177,41,136
"2011","Carmarthenshire 010D","W01000718","Total",627,267,39,228,181,68,215,40,175
"2011","Carmarthenshire 010E","W01000719","Total",629,247,25,222,178,67,222,40,182
"2011","Carmarthenshire 011A","W01000680","Total",853,353,23,330,234,79,254,36,218
"2011","Carmarthenshire 011B","W01000681","Total",857,366,52,314,255,93,318,56,262
"2011","Carmarthenshire 011C","W01000724","Total",762,268,33,235,243,103,253,57,196
"2011","Carmarthenshire 011D","W01000725","Total",915,384,28,356,237,74,316,56,260
"2011","Carmarthenshire 012A","W01000675","Total",848,306,18,288,201,75,255,39,216
"2011","Carmarthenshire 012B","W01000695","Total",675,276,35,241,175,55,226,33,193
"2011","Carmarthenshire 012C","W01000696","Total",670,265,31,234,166,63,236,41,195
"2011","Carmarthenshire 012D","W01000722","Total",542,205,4,201,103,30,163,14,149
"2011","Carmarthenshire 012E","W01000723","Total",616,247,12,235,145,53,210,30,180
"2011","Carmarthenshire 013A","W01000625","Total",521,246,36,210,182,56,215,43,172
"2011","Carmarthenshire 013B","W01000626","Total",725,356,26,330,165,61,268,30,238
"2011","Carmarthenshire 013C","W01000627","Total",896,338,48,290,273,124,254,50,204
"2011","Carmarthenshire 013D","W01000714","Total",647,274,26,248,183,62,227,33,194
"2011","Carmarthenshire 013E","W01000715","Total",555,217,24,193,158,47,171,27,144
"2011","Carmarthenshire 015A","W01000697","Total",805,319,41,278,217,78,267,52,215
"2011","Carmarthenshire 015B","W01000698","Total",768,282,42,240,240,115,233,39,194
"2011","Carmarthenshire 015C","W01000699","Total",600,184,10,174,177,65,171,34,137
"2011","Carmarthenshire 015D","W01000712","Total",634,212,16,196,194,92,184,35,149
"2011","Carmarthenshire 015E","W01000713","Total",574,206,24,182,182,59,192,40,152
"2011","Carmarthenshire 016A","W01000662","Total",921,384,43,341,263,91,336,65,271
"2011","Carmarthenshire 016B","W01000663","Total",998,413,28,385,260,95,353,49,304
"2011","Carmarthenshire 016C","W01000664","Total",737,271,23,248,207,80,226,34,192
"2011","Carmarthenshire 016D","W01000716","Total",544,193,14,179,149,58,158,30,128
"2011","Carmarthenshire 016E","W01000717","Total",645,284,26,258,169,61,237,33,204
"2011","Carmarthenshire 017A","W01000665","Total",727,222,13,209,200,73,180,19,161
"2011","Carmarthenshire 017B","W01000666","Total",643,240,31,209,187,79,189,31,158
"2011","Carmarthenshire 017C","W01000731","Total",1039,371,46,325,299,110,303,48,255
"2011","Carmarthenshire 018A","W01000670","Total",733,354,51,303,208,71,298,61,237
"2011","Carmarthenshire 018B","W01000671","Total",774,309,34,275,247,93,270,55,215
"2011","Carmarthenshire 018C","W01000729","Total",546,265,41,224,151,63,231,36,195
"2011","Carmarthenshire 018D","W01000730","Total",522,211,32,179,146,55,202,39,163
"2011","Carmarthenshire 019A","W01000690","Total",754,299,21,278,213,87,258,45,213
"2011","Carmarthenshire 019B","W01000691","Total",682,296,15,281,186,61,228,34,194
"2011","Carmarthenshire 019C","W01000692","Total",648,227,24,203,226,100,187,40,147
"2011","Carmarthenshire 019D","W01000726","Total",630,213,2,211,173,54,159,28,131
"2011","Carmarthenshire 019E","W01000727","Total",479,230,12,218,95,29,160,15,145
"2011","Carmarthenshire 020A","W01000651","Total",700,244,33,211,209,73,210,46,164
"2011","Carmarthenshire 020B","W01000652","Total",793,365,73,292,271,121,274,51,223
"2011","Carmarthenshire 020C","W01000655","Total",827,347,66,281,297,125,284,51,233
"2011","Carmarthenshire 021A","W01000632","Total",618,274,36,238,188,74,199,36,163
"2011","Carmarthenshire 021B","W01000633","Total",703,384,36,348,153,46,288,34,254
"2011","Carmarthenshire 021C","W01000634","Total",653,343,17,326,130,50,212,25,187
"2011","Carmarthenshire 021D","W01000710","Total",899,338,22,316,277,93,265,55,210
"2011","Carmarthenshire 021E","W01000711","Total",908,452,71,381,236,72,345,52,293
"2011","Carmarthenshire 022A","W01000703","Total",818,324,53,271,253,120,272,44,228
"2011","Carmarthenshire 022B","W01000704","Total",719,327,17,310,180,65,227,27,200
"2011","Carmarthenshire 022C","W01000705","Total",834,387,76,311,271,114,299,61,238
"2011","Carmarthenshire 023A","W01000653","Total",642,282,22,260,166,51,214,36,178
"2011","Carmarthenshire 023B","W01000654","Total",788,324,34,290,207,77,279,55,224
"2011","Carmarthenshire 023C","W01000667","Total",625,254,20,234,174,62,185,24,161
"2011","Carmarthenshire 023F","W01001925","Total",980,393,50,343,267,83,291,56,235
"2011","Carmarthenshire 024A","W01000628","Total",617,204,13,191,184,59,169,32,137
"2011","Carmarthenshire 024B","W01000629","Total",761,303,32,271,216,91,259,43,216
"2011","Carmarthenshire 024C","W01000630","Total",666,230,38,192,227,100,209,49,160
"2011","Carmarthenshire 024D","W01000631","Total",783,380,85,295,250,108,289,55,234
"2011","Carmarthenshire 025A","W01000635","Total",916,236,24,212,302,115,224,41,183
"2011","Carmarthenshire 025B","W01000636","Total",789,321,64,257,276,121,250,54,196
"2011","Carmarthenshire 025C","W01000706","Total",683,257,47,210,226,94,212,40,172
"2011","Carmarthenshire 025D","W01000707","Total",615,299,78,221,222,104,222,52,170
"2011","Carmarthenshire 025E","W01000708","Total",613,323,81,242,207,103,230,46,184
"2011","Carmarthenshire 026A","W01000659","Total",650,297,70,227,223,109,205,38,167
"2011","Carmarthenshire 026B","W01000660","Total",747,370,49,321,182,83,301,48,253
"2011","Carmarthenshire 026D","W01000732","Total",623,234,29,205,155,63,195,37,158
"2011","Carmarthenshire 026E","W01000733","Total",654,365,58,307,146,56,295,37,258
"2011","Carmarthenshire 026F","W01000734","Total",651,302,73,229,215,104,240,57,183
"2011","Carmarthenshire 026G","W01001923","Total",603,196,33,163,150,70,164,28,136
"2011","Carmarthenshire 026H","W01001924","Total",623,308,48,260,188,94,240,30,210
"2011","Carmarthenshire 027E","W01000672","Total",681,250,16,234,166,64,225,37,188
"2011","Carmarthenshire 027F","W01000673","Total",544,200,16,184,134,47,160,20,140
"2011","Carmarthenshire 027A","W01000674","Total",831,260,23,237,229,63,241,48,193
"2011","Carmarthenshire 027G","W01000700","Total",883,338,21,317,201,55,261,40,221
"2011","Carmarthenshire 027B","W01000720","Total",696,251,12,239,156,59,220,33,187
"2011","Carmarthenshire 027C","W01000721","Total",536,170,25,145,178,59,166,36,130
"2011","Carmarthenshire 027D","W01000735","Total",978,346,37,309,275,89,281,56,225
"2011","Swansea 001A","W01000845","Total",819,235,19,216,277,102,220,48,172
"2011","Swansea 001B","W01000846","Total",815,294,29,265,234,86,259,43,216
"2011","Swansea 001C","W01000847","Total",522,203,21,182,157,50,165,30,135
"2011","Swansea 001D","W01000848","Total",505,217,52,165,168,59,190,33,157
"2011","Swansea 002A","W01000750","Total",717,334,35,299,190,64,283,39,244
"2011","Swansea 002B","W01000751","Total",626,239,5,234,132,52,199,28,171
"2011","Swansea 002C","W01000752","Total",641,247,69,178,228,101,225,60,165
"2011","Swansea 002D","W01000753","Total",602,230,37,193,196,81,197,36,161
"2011","Swansea 002E","W01000754","Total",681,261,36,225,204,74,225,42,183
"2011","Swansea 002F","W01000803","Total",767,253,20,233,204,80,228,35,193
"2011","Swansea 003A","W01000806","Total",631,245,29,216,197,79,186,34,152
"2011","Swansea 003B","W01000807","Total",562,136,11,125,156,57,139,24,115
"2011","Swansea 003C","W01000808","Total",625,272,17,255,148,52,208,20,188
"2011","Swansea 003D","W01000810","Total",667,365,66,299,189,65,272,40,232
"2011","Swansea 003E","W01000815","Total",671,222,14,208,168,52,190,34,156
"2011","Swansea 003F","W01000816","Total",712,172,19,153,234,101,141,32,109
"2011","Swansea 004A","W01000791","Total",636,140,11,129,220,84,128,37,91
"2011","Swansea 004B","W01000792","Total",686,205,8,197,206,59,169,33,136
"2011","Swansea 004C","W01000793","Total",766,147,14,133,295,121,142,32,110
"2011","Swansea 004D","W01000837","Total",641,179,6,173,214,78,146,27,119
"2011","Swansea 004E","W01000838","Total",559,248,38,210,172,79,202,44,158
"2011","Swansea 005A","W01000773","Total",1184,395,54,341,381,162,357,69,288
"2011","Swansea 005B","W01000774","Total",740,312,27,285,200,78,277,40,237
"2011","Swansea 005C","W01000841","Total",635,257,28,229,165,58,218,33,185
"2011","Swansea 005D","W01000842","Total",590,216,17,199,151,44,160,27,133
"2011","Swansea 005E","W01000843","Total",563,173,24,149,187,63,147,39,108
"2011","Swansea 005F","W01000844","Total",489,197,46,151,178,58,188,50,138
"2011","Swansea 006A","W01000795","Total",685,161,8,153,220,96,164,29,135
"2011","Swansea 006B","W01000796","Total",1063,177,30,147,427,219,197,50,147
"2011","Swansea 006C","W01000800","Total",604,157,8,149,189,75,145,23,122
"2011","Swansea 006D","W01000801","Total",635,275,57,218,215,80,250,61,189
"2011","Swansea 007A","W01000784","Total",586,237,15,222,152,54,202,26,176
"2011","Swansea 007B","W01000785","Total",528,170,2,168,149,45,126,21,105
"2011","Swansea 007C","W01000786","Total",573,187,5,182,152,51,149,20,129
"2011","Swansea 007D","W01000802","Total",1010,364,48,316,311,101,316,65,251
"2011","Swansea 007E","W01000877","Total",644,240,17,223,185,70,186,33,153
"2011","Swansea 007F","W01000878","Total",526,220,13,207,146,53,178,28,150
"2011","Swansea 008A","W01000809","Total",692,204,42,162,211,91,206,39,167
"2011","Swansea 008B","W01000811","Total",684,269,61,208,224,83,224,53,171
"2011","Swansea 008C","W01000812","Total",689,308,41,267,178,79,239,38,201
"2011","Swansea 008D","W01000813","Total",676,232,21,211,196,69,197,46,151
"2011","Swansea 008E","W01000814","Total",675,284,89,195,229,101,204,50,154
"2011","Swansea 009A","W01000817","Total",842,439,90,349,242,99,354,56,298
"2011","Swansea 009B","W01000818","Total",671,297,57,240,204,94,235,45,190
"2011","Swansea 009C","W01000819","Total",626,268,5,263,134,31,191,20,171
"2011","Swansea 009D","W01000820","Total",605,214,12,202,150,51,193,33,160
"2011","Swansea 009E","W01000821","Total",673,263,27,236,166,57,260,41,219
"2011","Swansea 009F","W01000822","Total",594,293,15,278,104,35,228,21,207
"2011","Swansea 010A","W01000794","Total",921,198,29,169,308,132,214,51,163
"2011","Swansea 010B","W01000797","Total",652,240,16,224,171,50,197,31,166
"2011","Swansea 010C","W01000798","Total",627,254,16,238,140,54,207,33,174
"2011","Swansea 010D","W01000799","Total",782,281,95,186,328,135,227,81,146
"2011","Swansea 011A","W01000830","Total",687,370,151,219,298,128,272,83,189
"2011","Swansea 011B","W01000832","Total",763,390,59,331,217,99,323,55,268
"2011","Swansea 011C","W01000833","Total",767,400,128,272,296,115,291,82,209
"2011","Swansea 011D","W01000834","Total",602,295,78,217,232,78,206,47,159
"2011","Swansea 011E","W01000836","Total",934,350,135,215,386,208,283,80,203
"2011","Swansea 012A","W01000759","Total",655,258,9,249,156,56,201,18,183
"2011","Swansea 012B","W01000777","Total",785,306,12,294,205,68,238,32,206
"2011","Swansea 012C","W01000778","Total",770,184,20,164,273,83,177,42,135
"2011","Swansea 012D","W01000779","Total",597,198,30,168,221,66,176,41,135
"2011","Swansea 013A","W01000760","Total",728,222,38,184,228,94,195,29,166
"2011","Swansea 013B","W01000761","Total",652,218,44,174,211,91,197,48,149
"2011","Swansea 013C","W01000762","Total",617,245,61,184,205,63,236,66,170
"2011","Swansea 013D","W01000831","Total",825,406,128,278,293,156,297,67,230
"2011","Swansea 013E","W01000835","Total",594,289,63,226,197,71,233,56,177
"2011","Swansea 014A","W01000738","Total",753,367,91,276,246,94,296,62,234
"2011","Swansea 014B","W01000739","Total",863,267,76,191,233,82,218,51,167
"2011","Swansea 014C","W01000740","Total",658,225,13,212,160,53,210,32,178
"2011","Swansea 014D","W01000741","Total",706,363,64,299,195,83,293,47,246
"2011","Swansea 015A","W01000763","Total",620,192,39,153,215,92,164,40,124
"2011","Swansea 015B","W01000764","Total",680,196,28,168,221,100,175,30,145
"2011","Swansea 015C","W01000765","Total",748,286,33,253,206,85,217,25,192
"2011","Swansea 015D","W01000766","Total",641,207,34,173,220,75,181,47,134
"2011","Swansea 015E","W01000767","Total",757,391,36,355,159,65,323,24,299
"2011","Swansea 016A","W01000742","Total",800,433,65,368,188,65,352,52,300
"2011","Swansea 016B","W01000744","Total",755,309,55,254,182,77,239,44,195
"2011","Swansea 016C","W01000787","Total",678,216,45,171,202,89,205,54,151
"2011","Swansea 016D","W01000788","Total",658,228,39,189,184,81,221,39,182
"2011","Swansea 016E","W01000789","Total",640,221,45,176,199,81,226,48,178
"2011","Swansea 016F","W01000790","Total",748,308,54,254,221,109,249,45,204
"2011","Swansea 017A","W01000755","Total",868,325,42,283,258,110,292,43,249
"2011","Swansea 017B","W01000756","Total",751,344,44,300,215,74,292,40,252
"2011","Swansea 017C","W01000757","Total",718,348,16,332,149,54,268,25,243
"2011","Swansea 017D","W01000758","Total",839,305,33,272,234,96,233,49,184
"2011","Swansea 018A","W01000772","Total",615,209,18,191,205,67,188,38,150
"2011","Swansea 018B","W01000828","Total",732,282,10,272,179,56,213,25,188
"2011","Swansea 018C","W01000829","Total",828,307,22,285,217,71,265,40,225
"2011","Swansea 019A","W01000862","Total",706,366,150,216,331,152,257,79,178
"2011","Swansea 019B","W01000863","Total",753,441,135,306,277,131,325,78,247
"2011","Swansea 019C","W01000864","Total",706,364,147,217,308,158,256,76,180
"2011","Swansea 019D","W01000865","Total",591,260,45,215,184,65,198,34,164
"2011","Swansea 019E","W01000866","Total",524,278,85,193,186,85,209,50,159
"2011","Swansea 019F","W01000867","Total",570,269,70,199,192,68,222,66,156
"2011","Swansea 020A","W01000768","Total",611,236,13,223,164,46,197,26,171
"2011","Swansea 020B","W01000769","Total",591,240,10,230,165,52,153,24,129
"2011","Swansea 020C","W01000770","Total",638,211,8,203,199,53,195,31,164
"2011","Swansea 020D","W01000771","Total",533,215,18,197,162,49,167,21,146
"2011","Swansea 021A","W01000849","Total",807,353,83,270,284,125,303,78,225
"2011","Swansea 021B","W01000850","Total",1195,490,60,430,199,89,349,52,297
"2011","Swansea 021C","W01000851","Total",682,211,31,180,199,79,224,48,176
"2011","Swansea 021D","W01000852","Total",637,242,43,199,196,66,230,53,177
"2011","Swansea 022A","W01000853","Total",607,210,10,200,180,59,183,22,161
"2011","Swansea 022B","W01000854","Total",529,132,11,121,181,55,124,31,93
"2011","Swansea 022C","W01000855","Total",645,277,12,265,157,45,193,23,170
"2011","Swansea 022D","W01000856","Total",997,563,54,509,180,48,444,52,392
"2011","Swansea 022E","W01000857","Total",900,501,18,483,183,48,366,26,340
"2011","Swansea 023B","W01000781","Total",708,309,6,303,190,51,206,27,179
"2011","Swansea 023C","W01000782","Total",516,229,7,222,106,35,156,15,141
"2011","Swansea 023E","W01001956","Total",803,298,18,280,202,67,200,25,175
"2011","Swansea 024A","W01000747","Total",743,269,23,246,112,47,180,28,152
"2011","Swansea 024B","W01000868","Total",482,147,8,139,124,57,126,18,108
"2011","Swansea 024C","W01000869","Total",727,306,19,287,111,53,203,25,178
"2011","Swansea 024D","W01000870","Total",640,244,27,217,125,43,139,14,125
"2011","Swansea 024E","W01000872","Total",615,210,9,201,160,62,158,27,131
"2011","Swansea 024F","W01000874","Total",709,274,12,262,118,39,164,15,149
"2011","Swansea 025B","W01000745","Total",1072,516,40,476,146,79,321,34,287
"2011","Swansea 025C","W01000746","Total",800,307,27,280,100,38,221,18,203
"2011","Swansea 025E","W01001938","Total",807,394,6,388,26,18,158,2,156
"2011","Swansea 025F","W01001955","Total",1153,710,7,703,30,20,461,6,455
"2011","Swansea 025G","W01001957","Total",411,215,22,193,64,20,108,11,97
"2011","Swansea 025H","W01001958","Total",836,408,9,399,51,27,197,10,187
"2011","Swansea 026A","W01000749","Total",894,468,19,449,137,56,345,28,317
"2011","Swansea 026B","W01000871","Total",714,271,13,258,82,28,168,19,149
"2011","Swansea 026C","W01000873","Total",593,198,4,194,49,19,128,10,118
"2011","Swansea 026D","W01000875","Total",771,327,7,320,62,24,213,8,205
"2011","Swansea 026E","W01000876","Total",637,232,13,219,94,38,130,23,107
"2011","Swansea 027A","W01000858","Total",687,211,3,208,164,45,155,22,133
"2011","Swansea 027B","W01000859","Total",679,370,8,362,107,27,233,17,216
"2011","Swansea 027C","W01000860","Total",631,305,9,296,129,36,183,15,168
"2011","Swansea 027D","W01000861","Total",451,225,4,221,72,26,148,13,135
"2011","Swansea 028A","W01000736","Total",763,333,7,326,183,59,203,23,180
"2011","Swansea 028B","W01000737","Total",700,293,4,289,151,34,198,25,173
"2011","Swansea 028C","W01000804","Total",730,387,15,372,142,55,246,25,221
"2011","Swansea 028D","W01000805","Total",479,174,3,171,144,39,121,25,96
"2011","Swansea 029A","W01000879","Total",767,298,12,286,189,64,200,21,179
"2011","Swansea 029B","W01000880","Total",759,386,12,374,140,49,248,20,228
"2011","Swansea 029C","W01000881","Total",710,403,33,370,135,51,292,35,257
"2011","Swansea 029D","W01000882","Total",826,396,61,335,239,84,326,66,260
"2011","Swansea 030A","W01000775","Total",738,243,10,233,208,70,196,22,174
"2011","Swansea 030B","W01000776","Total",733,254,11,243,198,70,193,36,157
"2011","Swansea 030C","W01000839","Total",460,209,4,205,122,37,133,18,115
"2011","Swansea 030D","W01000840","Total",706,303,10,293,165,68,220,28,192
"2011","Swansea 031A","W01000823","Total",738,339,7,332,174,57,186,16,170
"2011","Swansea 031B","W01000824","Total",765,347,10,337,141,65,217,19,198
"2011","Swansea 031C","W01000825","Total",718,269,13,256,134,52,191,17,174
"2011","Swansea 031D","W01000826","Total",642,278,6,272,119,50,173,18,155
"2011","Swansea 031E","W01000827","Total",615,225,9,216,135,56,144,22,122
"2011","Neath Port Talbot 002A","W01000918","Total",842,331,26,305,231,77,283,54,229
"2011","Neath Port Talbot 002B","W01000944","Total",524,242,25,217,133,47,192,31,161
"2011","Neath Port Talbot 002C","W01000965","Total",866,356,53,303,261,107,286,47,239
"2011","Neath Port Talbot 003A","W01000893","Total",817,349,54,295,247,83,300,47,253
"2011","Neath Port Talbot 003B","W01000925","Total",657,307,62,245,200,82,243,49,194
"2011","Neath Port Talbot 003C","W01000926","Total",862,380,33,347,207,83,269,38,231
"2011","Neath Port Talbot 004A","W01000888","Total",933,300,40,260,311,112,301,67,234
"2011","Neath Port Talbot 004B","W01000946","Total",616,226,31,195,202,71,185,37,148
"2011","Neath Port Talbot 004C","W01000947","Total",866,370,82,288,290,121,314,57,257
"2011","Neath Port Talbot 004D","W01000948","Total",842,336,26,310,187,63,303,33,270
"2011","Neath Port Talbot 004E","W01000955","Total",526,204,17,187,157,54,171,27,144
"2011","Neath Port Talbot 004F","W01000956","Total",522,233,5,228,110,34,178,22,156
"2011","Neath Port Talbot 004G","W01000971","Total",599,219,30,189,184,57,213,38,175
"2011","Neath Port Talbot 005A","W01000887","Total",953,332,56,276,343,128,299,63,236
"2011","Neath Port Talbot 005B","W01000953","Total",727,310,41,269,213,78,264,43,221
"2011","Neath Port Talbot 005C","W01000954","Total",633,261,25,236,162,51,217,44,173
"2011","Neath Port Talbot 005D","W01000970","Total",500,203,26,177,149,52,180,29,151
"2011","Neath Port Talbot 006A","W01000902","Total",438,201,8,193,102,25,141,24,117
"2011","Neath Port Talbot 006B","W01000903","Total",491,203,2,201,104,25,143,8,135
"2011","Neath Port Talbot 006C","W01000904","Total",640,162,10,152,218,74,125,24,101
"2011","Neath Port Talbot 006D","W01000905","Total",627,217,29,188,230,66,159,30,129
"2011","Neath Port Talbot 006E","W01000908","Total",744,334,15,319,187,54,255,34,221
"2011","Neath Port Talbot 007A","W01000906","Total",461,201,9,192,90,22,136,16,120
"2011","Neath Port Talbot 007B","W01000907","Total",762,343,49,294,248,93,279,44,235
"2011","Neath Port Talbot 007C","W01000922","Total",721,304,41,263,217,75,259,42,217
"2011","Neath Port Talbot 007D","W01000923","Total",651,240,17,223,152,47,215,32,183
"2011","Neath Port Talbot 008A","W01000934","Total",628,295,43,252,151,70,231,28,203
"2011","Neath Port Talbot 008B","W01000935","Total",842,438,37,401,140,63,355,38,317
"2011","Neath Port Talbot 008C","W01000938","Total",611,281,6,275,122,30,225,23,202
"2011","Neath Port Talbot 008D","W01000939","Total",690,397,27,370,106,52,322,21,301
"2011","Neath Port Talbot 008E","W01000940","Total",596,278,55,223,170,64,223,52,171
"2011","Neath Port Talbot 009A","W01000909","Total",494,221,18,203,117,33,187,24,163
"2011","Neath Port Talbot 009B","W01000910","Total",640,217,6,211,154,55,185,27,158
"2011","Neath Port Talbot 009C","W01000911","Total",490,131,8,123,164,60,141,30,111
"2011","Neath Port Talbot 009D","W01000969","Total",515,157,6,151,154,30,152,25,127
"2011","Neath Port Talbot 010A","W01000912","Total",537,228,15,213,130,36,193,29,164
"2011","Neath Port Talbot 010B","W01000913","Total",528,206,18,188,114,41,162,22,140
"2011","Neath Port Talbot 010C","W01000914","Total",647,260,58,202,205,88,239,49,190
"2011","Neath Port Talbot 010D","W01000915","Total",496,169,16,153,165,67,156,34,122
"2011","Neath Port Talbot 010E","W01000916","Total",479,138,16,122,146,66,131,22,109
"2011","Neath Port Talbot 010F","W01000917","Total",1086,318,30,288,331,118,272,50,222
"2011","Neath Port Talbot 011A","W01000920","Total",518,210,32,178,157,56,174,37,137
"2011","Neath Port Talbot 011B","W01000921","Total",666,406,98,308,201,74,287,59,228
"2011","Neath Port Talbot 011C","W01000924","Total",463,225,43,182,135,58,156,26,130
"2011","Neath Port Talbot 011D","W01000930","Total",617,318,61,257,180,64,283,55,228
"2011","Neath Port Talbot 012A","W01000936","Total",628,253,60,193,232,82,230,51,179
"2011","Neath Port Talbot 012B","W01000941","Total",639,268,61,207,218,92,207,50,157
"2011","Neath Port Talbot 012C","W01000942","Total",782,326,75,251,284,115,302,66,236
"2011","Neath Port Talbot 012D","W01000943","Total",614,212,18,194,199,65,152,29,123
"2011","Neath Port Talbot 013A","W01000894","Total",615,273,19,254,147,47,230,28,202
"2011","Neath Port Talbot 013B","W01000895","Total",783,365,43,322,177,64,318,34,284
"2011","Neath Port Talbot 013C","W01000896","Total",646,296,99,197,261,90,242,74,168
"2011","Neath Port Talbot 013D","W01000897","Total",594,255,30,225,149,54,238,42,196
"2011","Neath Port Talbot 013E","W01000937","Total",950,401,57,344,254,124,366,58,308
"2011","Neath Port Talbot 014A","W01000898","Total",636,246,25,221,191,63,209,43,166
"2011","Neath Port Talbot 014B","W01000899","Total",694,257,22,235,221,74,204,42,162
"2011","Neath Port Talbot 014C","W01000900","Total",787,380,59,321,208,59,299,55,244
"2011","Neath Port Talbot 014D","W01000901","Total",733,315,52,263,215,76,244,58,186
"2011","Neath Port Talbot 014E","W01000945","Total",492,182,24,158,131,50,169,32,137
"2011","Neath Port Talbot 015A","W01000889","Total",795,305,14,291,186,68,256,34,222
"2011","Neath Port Talbot 015B","W01000890","Total",675,245,9,236,193,62,185,24,161
"2011","Neath Port Talbot 015C","W01000891","Total",640,262,30,232,193,78,222,34,188
"2011","Neath Port Talbot 015D","W01000892","Total",814,340,15,325,191,65,249,35,214
"2011","Neath Port Talbot 016A","W01000883","Total",619,195,8,187,133,48,175,29,146
"2011","Neath Port Talbot 016B","W01000958","Total",650,328,95,233,224,84,274,66,208
"2011","Neath Port Talbot 016C","W01000961","Total",726,353,51,302,191,70,296,49,247
"2011","Neath Port Talbot 016D","W01000962","Total",606,295,92,203,228,91,235,66,169
"2011","Neath Port Talbot 016E","W01000963","Total",776,413,79,334,228,82,362,70,292
"2011","Neath Port Talbot 016F","W01000964","Total",774,405,69,336,217,62,326,56,270
"2011","Neath Port Talbot 017A","W01000884","Total",527,218,58,160,167,82,201,45,156
"2011","Neath Port Talbot 017B","W01000885","Total",623,321,51,270,163,73,250,37,213
"2011","Neath Port Talbot 017C","W01000886","Total",689,318,67,251,180,81,275,52,223
"2011","Neath Port Talbot 017D","W01000957","Total",852,499,64,435,168,64,372,42,330
"2011","Neath Port Talbot 017E","W01000959","Total",760,282,38,244,224,70,240,38,202
"2011","Neath Port Talbot 017F","W01000960","Total",783,363,54,309,210,77,301,52,249
"2011","Neath Port Talbot 018A","W01000949","Total",572,202,12,190,142,53,183,39,144
"2011","Neath Port Talbot 018B","W01000950","Total",676,247,44,203,188,68,224,39,185
"2011","Neath Port Talbot 018C","W01000951","Total",650,229,28,201,184,72,209,43,166
"2011","Neath Port Talbot 018D","W01000952","Total",484,173,13,160,140,59,161,22,139
"2011","Neath Port Talbot 018E","W01000966","Total",637,276,34,242,162,62,214,36,178
"2011","Neath Port Talbot 019A","W01000932","Total",491,232,16,216,101,40,186,22,164
"2011","Neath Port Talbot 019B","W01000933","Total",741,160,11,149,294,100,158,41,117
"2011","Neath Port Talbot 019C","W01000967","Total",681,320,52,268,181,72,234,42,192
"2011","Neath Port Talbot 019D","W01000968","Total",803,285,40,245,246,84,257,58,199
"2011","Neath Port Talbot 020A","W01000919","Total",504,198,20,178,131,51,177,34,143
"2011","Neath Port Talbot 020B","W01000927","Total",704,239,36,203,202,93,236,49,187
"2011","Neath Port Talbot 020C","W01000928","Total",698,291,30,261,185,61,255,38,217
"2011","Neath Port Talbot 020D","W01000929","Total",562,238,44,194,173,53,209,45,164
"2011","Neath Port Talbot 020E","W01000931","Total",560,230,26,204,169,61,197,36,161
"2011","Neath Port Talbot 020F","W01000973","Total",681,312,33,279,170,63,295,44,251
"2011","Neath Port Talbot 020G","W01001900","Total",684,301,51,250,205,68,255,49,206
"2011","Bridgend 001A","W01000991","Total",475,276,71,205,154,57,189,39,150
"2011","Bridgend 001B","W01000992","Total",636,317,69,248,208,86,240,65,175
"2011","Bridgend 001C","W01000993","Total",625,289,69,220,214,95,235,52,183
"2011","Bridgend 001D","W01000994","Total",576,252,49,203,199,74,215,41,174
"2011","Bridgend 001E","W01000995","Total",654,297,35,262,181,71,231,37,194
"2011","Bridgend 002A","W01001014","Total",779,364,38,326,196,73,304,43,261
"2011","Bridgend 002B","W01001015","Total",594,246,45,201,203,55,219,62,157
"2011","Bridgend 002C","W01001017","Total",601,217,16,201,189,52,193,33,160
"2011","Bridgend 002D","W01001018","Total",634,285,44,241,170,59,239,37,202
"2011","Bridgend 002E","W01001020","Total",615,244,38,206,196,75,218,39,179
"2011","Bridgend 003A","W01000976","Total",450,186,36,150,155,58,151,41,110
"2011","Bridgend 003B","W01000977","Total",579,241,39,202,163,62,218,46,172
"2011","Bridgend 003C","W01001024","Total",507,211,34,177,144,54,171,31,140
"2011","Bridgend 003D","W01001025","Total",519,200,22,178,148,57,177,34,143
"2011","Bridgend 003E","W01001033","Total",735,268,31,237,228,101,238,36,202
"2011","Bridgend 003F","W01001034","Total",659,284,25,259,159,57,233,24,209
"2011","Bridgend 004A","W01000975","Total",884,415,120,295,316,120,354,93,261
"2011","Bridgend 004B","W01000978","Total",774,307,42,265,239,79,264,45,219
"2011","Bridgend 004C","W01001009","Total",497,173,34,139,142,51,174,42,132
"2011","Bridgend 004D","W01001042","Total",573,220,44,176,197,83,196,49,147
"2011","Bridgend 004E","W01001043","Total",502,211,32,179,147,56,171,34,137
"2011","Bridgend 005A","W01001012","Total",584,154,16,138,237,76,142,41,101
"2011","Bridgend 005B","W01001013","Total",636,297,28,269,154,58,235,36,199
"2011","Bridgend 005C","W01001016","Total",744,361,18,343,161,58,283,41,242
"2011","Bridgend 005D","W01001019","Total",621,264,41,223,179,67,221,41,180
"2011","Bridgend 006A","W01000974","Total",900,290,31,259,240,81,244,29,215
"2011","Bridgend 006B","W01001057","Total",665,274,40,234,187,71,257,43,214
"2011","Bridgend 006C","W01001058","Total",772,223,31,192,272,92,183,30,153
"2011","Bridgend 007A","W01000986","Total",573,137,16,121,189,62,138,29,109
"2011","Bridgend 007B","W01000987","Total",962,363,85,278,327,141,290,62,228
"2011","Bridgend 007C","W01001055","Total",514,240,40,200,146,65,207,45,162
"2011","Bridgend 007D","W01001056","Total",507,210,19,191,113,38,181,27,154
"2011","Bridgend 008A","W01000996","Total",638,247,21,226,168,51,245,50,195
"2011","Bridgend 008B","W01001048","Total",607,184,18,166,169,60,173,28,145
"2011","Bridgend 008C","W01001049","Total",530,238,56,182,170,62,178,41,137
"2011","Bridgend 008D","W01001050","Total",669,261,41,220,186,67,236,28,208
"2011","Bridgend 008E","W01001051","Total",727,264,68,196,281,114,193,54,139
"2011","Bridgend 008F","W01001052","Total",612,272,33,239,169,67,253,45,208
"2011","Bridgend 009A","W01001004","Total",488,228,20,208,118,51,183,31,152
"2011","Bridgend 009B","W01001005","Total",740,243,11,232,202,69,219,33,186
"2011","Bridgend 009C","W01001006","Total",946,302,19,283,278,86,251,49,202
"2011","Bridgend 009D","W01001007","Total",700,261,47,214,236,102,208,31,177
"2011","Bridgend 009E","W01001039","Total",678,210,21,189,199,57,199,40,159
"2011","Bridgend 009F","W01001040","Total",611,191,14,177,174,62,178,35,143
"2011","Bridgend 010A","W01000999","Total",614,286,48,238,170,53,238,46,192
"2011","Bridgend 010B","W01001000","Total",726,246,27,219,211,78,201,33,168
"2011","Bridgend 010C","W01001001","Total",623,283,38,245,168,66,211,41,170
"2011","Bridgend 010D","W01001002","Total",1060,434,138,296,369,182,327,88,239
"2011","Bridgend 011A","W01000998","Total",513,135,12,123,160,65,118,28,90
"2011","Bridgend 011B","W01001008","Total",910,358,16,342,229,65,248,39,209
"2011","Bridgend 011C","W01001038","Total",927,351,35,316,269,103,292,57,235
"2011","Bridgend 012A","W01000997","Total",690,295,19,276,153,50,230,32,198
"2011","Bridgend 012B","W01001010","Total",510,171,27,144,165,67,144,35,109
"2011","Bridgend 012C","W01001011","Total",578,177,19,158,186,67,176,37,139
"2011","Bridgend 012D","W01001026","Total",838,385,62,323,241,92,322,52,270
"2011","Bridgend 013A","W01000989","Total",574,207,19,188,163,44,141,26,115
"2011","Bridgend 013B","W01001037","Total",671,258,14,244,165,42,181,25,156
"2011","Bridgend 013C","W01001041","Total",926,282,16,266,305,84,220,39,181
"2011","Bridgend 014A","W01001021","Total",764,322,20,302,170,87,239,21,218
"2011","Bridgend 014B","W01001022","Total",623,308,69,239,170,68,248,51,197
"2011","Bridgend 014C","W01001023","Total",815,391,43,348,173,68,317,39,278
"2011","Bridgend 014D","W01001028","Total",823,300,21,279,196,70,220,29,191
"2011","Bridgend 014E","W01001035","Total",745,305,42,263,198,93,239,38,201
"2011","Bridgend 015A","W01000979","Total",694,155,43,112,267,103,146,44,102
"2011","Bridgend 015B","W01000983","Total",638,118,21,97,236,91,131,40,91
"2011","Bridgend 015C","W01000985","Total",512,80,12,68,214,49,90,28,62
"2011","Bridgend 015D","W01001003","Total",583,265,4,261,107,25,177,16,161
"2011","Bridgend 016A","W01000980","Total",555,146,31,115,181,68,147,37,110
"2011","Bridgend 016B","W01000981","Total",489,223,77,146,204,83,164,51,113
"2011","Bridgend 016C","W01000982","Total",627,219,23,196,156,51,157,26,131
"2011","Bridgend 016D","W01000984","Total",931,230,51,179,316,148,184,51,133
"2011","Bridgend 017B","W01000990","Total",660,295,33,262,189,56,252,37,215
"2011","Bridgend 017C","W01001027","Total",720,335,20,315,160,48,256,32,224
"2011","Bridgend 017D","W01001036","Total",646,230,5,225,167,46,167,23,144
"2011","Bridgend 017E","W01001918","Total",536,48,9,39,303,144,78,41,37
"2011","Bridgend 017F","W01001919","Total",531,69,14,55,236,99,84,37,47
"2011","Bridgend 017G","W01001920","Total",443,63,6,57,189,73,80,23,57
"2011","Bridgend 017H","W01001921","Total",576,104,25,79,291,117,120,44,76
"2011","Bridgend 018A","W01001031","Total",628,260,5,255,145,36,183,23,160
"2011","Bridgend 018B","W01001032","Total",818,380,16,364,190,54,275,31,244
"2011","Bridgend 018C","W01001046","Total",873,453,35,418,184,54,362,41,321
"2011","Bridgend 018D","W01001047","Total",757,355,15,340,181,65,259,25,234
"2011","Bridgend 018E","W01001053","Total",465,232,6,226,87,27,149,17,132
"2011","Bridgend 018F","W01001054","Total",532,275,7,268,101,21,179,12,167
"2011","Bridgend 019A","W01001029","Total",798,368,15,353,157,50,230,27,203
"2011","Bridgend 019B","W01001030","Total",765,308,17,291,197,61,234,25,209
"2011","Bridgend 019C","W01001044","Total",771,389,42,347,194,51,317,45,272
"2011","Bridgend 019D","W01001045","Total",745,280,38,242,210,70,249,47,202
"2011","The Vale of Glamorgan 001A","W01001105","Total",1024,315,18,297,327,94,230,44,186
"2011","The Vale of Glamorgan 001B","W01001127","Total",535,212,8,204,114,30,131,10,121
"2011","The Vale of Glamorgan 001C","W01001128","Total",599,205,7,198,151,47,134,18,116
"2011","The Vale of Glamorgan 002A","W01001082","Total",754,369,8,361,122,34,237,15,222
"2011","The Vale of Glamorgan 002B","W01001083","Total",659,240,5,235,160,59,143,10,133
"2011","The Vale of Glamorgan 002C","W01001084","Total",721,287,12,275,160,52,205,23,182
"2011","The Vale of Glamorgan 002D","W01001085","Total",581,160,5,155,189,49,112,18,94
"2011","The Vale of Glamorgan 003A","W01001113","Total",913,268,10,258,288,98,217,35,182
"2011","The Vale of Glamorgan 003B","W01001119","Total",678,172,10,162,232,69,136,24,112
"2011","The Vale of Glamorgan 003C","W01001135","Total",600,179,4,175,173,49,151,25,126
"2011","The Vale of Glamorgan 003D","W01001136","Total",497,179,5,174,114,37,142,19,123
"2011","The Vale of Glamorgan 004A","W01001075","Total",496,156,6,150,166,55,125,29,96
"2011","The Vale of Glamorgan 004B","W01001076","Total",625,169,31,138,202,91,150,36,114
"2011","The Vale of Glamorgan 004C","W01001077","Total",616,274,16,258,144,45,204,25,179
"2011","The Vale of Glamorgan 004D","W01001078","Total",510,170,11,159,176,55,152,25,127
"2011","The Vale of Glamorgan 004E","W01001104","Total",864,284,15,269,228,85,217,40,177
"2011","The Vale of Glamorgan 004F","W01001129","Total",517,178,22,156,196,51,166,29,137
"2011","The Vale of Glamorgan 005A","W01001116","Total",833,325,3,322,211,63,205,17,188
"2011","The Vale of Glamorgan 005B","W01001123","Total",850,311,8,303,148,61,223,14,209
"2011","The Vale of Glamorgan 005C","W01001124","Total",683,200,16,184,171,73,183,20,163
"2011","The Vale of Glamorgan 005D","W01001125","Total",618,199,15,184,185,74,168,26,142
"2011","The Vale of Glamorgan 005E","W01001126","Total",1036,236,13,223,164,79,173,15,158
"2011","The Vale of Glamorgan 005F","W01001130","Total",534,152,7,145,174,63,154,22,132
"2011","The Vale of Glamorgan 006A","W01001086","Total",644,225,6,219,149,47,147,14,133
"2011","The Vale of Glamorgan 006B","W01001087","Total",657,270,14,256,173,54,184,27,157
"2011","The Vale of Glamorgan 006C","W01001088","Total",813,398,38,360,220,80,304,46,258
"2011","The Vale of Glamorgan 006D","W01001089","Total",604,217,12,205,159,55,167,30,137
"2011","The Vale of Glamorgan 006E","W01001090","Total",615,196,8,188,173,60,167,33,134
"2011","The Vale of Glamorgan 007A","W01001081","Total",670,303,66,237,242,95,247,63,184
"2011","The Vale of Glamorgan 007B","W01001092","Total",673,243,44,199,246,77,218,52,166
"2011","The Vale of Glamorgan 007C","W01001094","Total",531,190,59,131,225,90,158,49,109
"2011","The Vale of Glamorgan 007D","W01001095","Total",667,330,104,226,253,108,259,67,192
"2011","The Vale of Glamorgan 007E","W01001096","Total",636,280,27,253,164,66,239,34,205
"2011","The Vale of Glamorgan 007F","W01001097","Total",607,265,94,171,264,93,198,64,134
"2011","The Vale of Glamorgan 008A","W01001114","Total",661,276,7,269,168,56,179,30,149
"2011","The Vale of Glamorgan 008B","W01001115","Total",872,346,18,328,307,120,248,52,196
"2011","The Vale of Glamorgan 008C","W01001131","Total",760,296,33,263,251,100,262,34,228
"2011","The Vale of Glamorgan 008D","W01001132","Total",585,174,14,160,185,46,152,31,121
"2011","The Vale of Glamorgan 008E","W01001133","Total",904,343,7,336,183,58,215,26,189
"2011","The Vale of Glamorgan 008F","W01001134","Total",536,168,7,161,124,43,131,14,117
"2011","The Vale of Glamorgan 009A","W01001067","Total",648,321,39,282,156,56,275,29,246
"2011","The Vale of Glamorgan 009B","W01001068","Total",731,172,46,126,274,118,188,48,140
"2011","The Vale of Glamorgan 009C","W01001070","Total",539,218,44,174,153,83,171,32,139
"2011","The Vale of Glamorgan 009D","W01001071","Total",667,229,44,185,228,94,224,59,165
"2011","The Vale of Glamorgan 009E","W01001072","Total",1001,179,24,155,409,142,206,66,140
"2011","The Vale of Glamorgan 010A","W01001091","Total",724,272,10,262,173,44,215,32,183
"2011","The Vale of Glamorgan 010B","W01001098","Total",467,166,8,158,105,29,121,13,108
"2011","The Vale of Glamorgan 010C","W01001100","Total",636,240,3,237,172,46,184,20,164
"2011","The Vale of Glamorgan 010D","W01001103","Total",520,161,12,149,155,41,110,19,91
"2011","The Vale of Glamorgan 011A","W01001106","Total",582,201,9,192,152,37,150,19,131
"2011","The Vale of Glamorgan 011B","W01001107","Total",712,337,15,322,138,47,233,24,209
"2011","The Vale of Glamorgan 011C","W01001109","Total",625,268,20,248,169,50,221,37,184
"2011","The Vale of Glamorgan 011D","W01001110","Total",529,166,14,152,143,42,139,28,111
"2011","The Vale of Glamorgan 011E","W01001111","Total",594,221,42,179,193,65,179,41,138
"2011","The Vale of Glamorgan 011F","W01001112","Total",595,127,12,115,231,85,124,26,98
"2011","The Vale of Glamorgan 012A","W01001063","Total",711,209,50,159,250,118,194,52,142
"2011","The Vale of Glamorgan 012B","W01001065","Total",642,234,44,190,231,91,206,48,158
"2011","The Vale of Glamorgan 012C","W01001069","Total",686,283,63,220,212,104,221,39,182
"2011","The Vale of Glamorgan 012E","W01001079","Total",695,256,70,186,252,129,206,48,158
"2011","The Vale of Glamorgan 012F","W01001080","Total",648,226,49,177,228,91,206,44,162
"2011","The Vale of Glamorgan 012G","W01001910","Total",734,213,61,152,254,110,199,53,146
"2011","The Vale of Glamorgan 012H","W01001911","Total",508,182,47,135,176,83,155,36,119
"2011","The Vale of Glamorgan 013A","W01001062","Total",544,162,12,150,182,63,157,27,130
"2011","The Vale of Glamorgan 013B","W01001064","Total",640,310,52,258,192,77,259,46,213
"2011","The Vale of Glamorgan 013C","W01001093","Total",788,391,60,331,210,81,306,43,263
"2011","The Vale of Glamorgan 013D","W01001099","Total",600,271,40,231,185,68,205,39,166
"2011","The Vale of Glamorgan 013E","W01001101","Total",694,247,43,204,210,89,211,36,175
"2011","The Vale of Glamorgan 013F","W01001102","Total",668,187,32,155,239,126,172,48,124
"2011","The Vale of Glamorgan 014A","W01001108","Total",728,185,21,164,236,130,166,36,130
"2011","The Vale of Glamorgan 014B","W01001117","Total",585,203,18,185,159,58,173,29,144
"2011","The Vale of Glamorgan 014C","W01001118","Total",959,282,23,259,331,126,266,62,204
"2011","The Vale of Glamorgan 014D","W01001120","Total",589,168,14,154,162,51,136,21,115
"2011","The Vale of Glamorgan 014E","W01001121","Total",644,242,23,219,172,53,210,40,170
"2011","The Vale of Glamorgan 014F","W01001122","Total",802,178,72,106,408,177,196,85,111
"2011","The Vale of Glamorgan 015A","W01001059","Total",614,239,11,228,133,45,186,25,161
"2011","The Vale of Glamorgan 015B","W01001060","Total",659,275,5,270,142,43,176,12,164
"2011","The Vale of Glamorgan 015C","W01001061","Total",926,299,55,244,293,119,253,50,203
"2011","The Vale of Glamorgan 015D","W01001066","Total",688,235,40,195,226,92,211,37,174
"2011","The Vale of Glamorgan 015E","W01001073","Total",1005,408,58,350,243,126,343,39,304
"2011","Cardiff 001A","W01001777","Total",610,229,10,219,163,55,148,20,128
"2011","Cardiff 001B","W01001778","Total",700,211,3,208,232,59,140,19,121
"2011","Cardiff 001C","W01001794","Total",626,132,18,114,205,80,111,23,88
"2011","Cardiff 001D","W01001799","Total",520,210,3,207,130,36,141,9,132
"2011","Cardiff 002A","W01001793","Total",567,77,13,64,227,85,91,28,63
"2011","Cardiff 002B","W01001795","Total",644,120,11,109,228,76,96,33,63
"2011","Cardiff 002C","W01001796","Total",653,185,14,171,186,67,148,19,129
"2011","Cardiff 002D","W01001798","Total",624,198,11,187,190,79,154,29,125
"2011","Cardiff 003A","W01001841","Total",740,133,29,104,317,115,142,57,85
"2011","Cardiff 003B","W01001842","Total",726,92,14,78,284,159,90,29,61
"2011","Cardiff 003C","W01001843","Total",808,94,23,71,337,152,125,41,84
"2011","Cardiff 003D","W01001844","Total",841,146,34,112,327,144,156,52,104
"2011","Cardiff 004A","W01001849","Total",651,247,7,240,183,49,168,26,142
"2011","Cardiff 004B","W01001852","Total",723,264,2,262,221,78,181,20,161
"2011","Cardiff 004C","W01001853","Total",749,388,13,375,144,55,249,14,235
"2011","Cardiff 004D","W01001854","Total",834,449,1,448,135,41,302,24,278
"2011","Cardiff 005A","W01001791","Total",734,293,22,271,178,68,221,28,193
"2011","Cardiff 005B","W01001792","Total",705,266,39,227,212,81,236,37,199
"2011","Cardiff 005C","W01001797","Total",607,204,14,190,166,54,181,30,151
"2011","Cardiff 005D","W01001800","Total",665,298,41,257,218,83,278,49,229
"2011","Cardiff 005F","W01001949","Total",635,138,15,123,161,108,133,21,112
"2011","Cardiff 005G","W01001953","Total",643,220,26,194,194,87,198,38,160
"2011","Cardiff 006A","W01001820","Total",508,140,12,128,170,52,109,23,86
"2011","Cardiff 006C","W01001846","Total",641,111,14,97,293,98,114,29,85
"2011","Cardiff 006D","W01001847","Total",637,249,4,245,149,38,161,17,144
"2011","Cardiff 006E","W01001948","Total",637,84,20,64,283,135,77,29,48
"2011","Cardiff 006F","W01001954","Total",637,230,4,226,180,44,171,19,152
"2011","Cardiff 007A","W01001802","Total",684,283,17,266,181,69,237,36,201
"2011","Cardiff 007B","W01001807","Total",591,267,93,174,253,110,222,55,167
"2011","Cardiff 007C","W01001808","Total",638,302,111,191,278,123,229,54,175
"2011","Cardiff 007D","W01001840","Total",755,215,26,189,201,73,224,38,186
"2011","Cardiff 008A","W01001730","Total",647,273,4,269,152,49,180,14,166
"2011","Cardiff 008B","W01001731","Total",534,168,11,157,192,57,129,24,105
"2011","Cardiff 008C","W01001736","Total",601,237,4,233,163,41,155,16,139
"2011","Cardiff 008D","W01001815","Total",511,135,21,114,181,68,123,30,93
"2011","Cardiff 009A","W01001811","Total",540,232,104,128,246,130,190,70,120
"2011","Cardiff 009B","W01001816","Total",1065,270,106,164,416,239,241,90,151
"2011","Cardiff 009C","W01001817","Total",553,151,21,130,187,61,173,41,132
"2011","Cardiff 009D","W01001818","Total",625,138,38,100,211,112,145,39,106
"2011","Cardiff 010A","W01001888","Total",694,174,24,150,234,76,176,40,136
"2011","Cardiff 010B","W01001893","Total",793,230,34,196,250,96,202,37,165
"2011","Cardiff 010C","W01001894","Total",651,209,10,199,190,71,164,28,136
"2011","Cardiff 010D","W01001895","Total",851,456,28,428,162,87,365,28,337
"2011","Cardiff 011A","W01001877","Total",721,149,19,130,233,106,182,41,141
"2011","Cardiff 011B","W01001878","Total",630,173,45,128,215,101,158,36,122
"2011","Cardiff 011C","W01001882","Total",739,162,55,107,285,135,159,48,111
"2011","Cardiff 011D","W01001885","Total",786,207,67,140,331,179,192,60,132
"2011","Cardiff 012A","W01001773","Total",991,261,39,222,347,159,211,52,159
"2011","Cardiff 012B","W01001848","Total",618,216,7,209,183,74,162,25,137
"2011","Cardiff 012C","W01001850","Total",790,284,2,282,224,79,217,30,187
"2011","Cardiff 012D","W01001851","Total",697,306,5,301,151,54,194,13,181
"2011","Cardiff 013A","W01001879","Total",817,336,95,241,312,164,289,75,214
"2011","Cardiff 013B","W01001880","Total",573,232,121,111,301,144,169,75,94
"2011","Cardiff 013C","W01001881","Total",645,287,71,216,198,104,240,39,201
"2011","Cardiff 013D","W01001884","Total",527,236,118,118,291,143,160,57,103
"2011","Cardiff 014A","W01001727","Total",462,138,10,128,139,39,117,19,98
"2011","Cardiff 014B","W01001728","Total",582,160,6,154,199,54,114,19,95
"2011","Cardiff 014C","W01001729","Total",808,140,17,123,324,115,149,41,108
"2011","Cardiff 014D","W01001819","Total",912,267,23,244,283,88,230,47,183
"2011","Cardiff 015A","W01001803","Total",712,350,51,299,194,76,297,44,253
"2011","Cardiff 015B","W01001804","Total",643,248,48,200,206,79,219,35,184
"2011","Cardiff 015C","W01001805","Total",645,264,53,211,212,98,241,50,191
"2011","Cardiff 015D","W01001806","Total",799,354,33,321,167,47,245,36,209
"2011","Cardiff 016A","W01001866","Total",606,287,44,243,174,64,228,41,187
"2011","Cardiff 016B","W01001867","Total",545,239,90,149,218,97,202,64,138
"2011","Cardiff 016C","W01001883","Total",675,342,74,268,215,94,260,49,211
"2011","Cardiff 016D","W01001886","Total",516,231,60,171,195,80,205,64,141
"2011","Cardiff 017A","W01001809","Total",538,167,16,151,162,66,180,43,137
"2011","Cardiff 017B","W01001810","Total",635,236,71,165,258,106,182,51,131
"2011","Cardiff 017C","W01001812","Total",484,148,34,114,190,71,145,33,112
"2011","Cardiff 017D","W01001813","Total",698,331,68,263,219,111,262,50,212
"2011","Cardiff 017E","W01001814","Total",672,202,24,178,171,78,183,34,149
"2011","Cardiff 018A","W01001769","Total",617,177,2,175,207,80,148,26,122
"2011","Cardiff 018B","W01001770","Total",476,221,6,215,87,39,127,10,117
"2011","Cardiff 018C","W01001771","Total",688,218,15,203,212,92,160,31,129
"2011","Cardiff 018D","W01001774","Total",541,158,6,152,177,78,125,17,108
"2011","Cardiff 019A","W01001732","Total",667,228,5,223,198,66,164,27,137
"2011","Cardiff 019B","W01001733","Total",586,233,11,222,151,41,173,20,153
"2011","Cardiff 019C","W01001734","Total",592,211,8,203,190,58,142,20,122
"2011","Cardiff 019D","W01001735","Total",608,207,8,199,195,61,148,28,120
"2011","Cardiff 020A","W01001887","Total",613,170,1,169,203,70,145,22,123
"2011","Cardiff 020B","W01001889","Total",747,316,13,303,158,58,254,13,241
"2011","Cardiff 020C","W01001891","Total",762,317,17,300,186,77,260,31,229
"2011","Cardiff 020D","W01001892","Total",599,227,4,223,156,46,164,18,146
"2011","Cardiff 020E","W01001896","Total",628,194,6,188,187,71,168,24,144
"2011","Cardiff 021A","W01001772","Total",603,234,4,230,163,46,169,24,145
"2011","Cardiff 021B","W01001775","Total",693,208,16,192,187,91,173,27,146
"2011","Cardiff 021C","W01001776","Total",515,135,6,129,166,68,144,24,120
"2011","Cardiff 021D","W01001890","Total",608,197,12,185,159,60,146,19,127
"2011","Cardiff 022A","W01001863","Total",637,216,30,186,186,63,200,35,165
"2011","Cardiff 022B","W01001864","Total",623,216,17,199,165,63,187,36,151
"2011","Cardiff 022C","W01001865","Total",515,156,16,140,159,58,145,32,113
"2011","Cardiff 022D","W01001868","Total",609,261,61,200,206,72,214,57,157
"2011","Cardiff 023A","W01001785","Total",482,236,57,179,178,76,169,42,127
"2011","Cardiff 023B","W01001786","Total",628,199,34,165,210,78,191,48,143
"2011","Cardiff 023C","W01001787","Total",556,185,37,148,189,74,182,41,141
"2011","Cardiff 023D","W01001788","Total",608,255,43,212,189,84,215,36,179
"2011","Cardiff 023E","W01001789","Total",730,210,23,187,188,70,172,31,141
"2011","Cardiff 023F","W01001790","Total",500,198,28,170,163,66,182,38,144
"2011","Cardiff 024A","W01001821","Total",548,250,12,238,119,46,170,10,160
"2011","Cardiff 024B","W01001826","Total",561,222,13,209,136,51,146,20,126
"2011","Cardiff 024C","W01001827","Total",619,215,15,200,201,56,136,26,110
"2011","Cardiff 024D","W01001828","Total",637,230,5,225,149,44,192,19,173
"2011","Cardiff 025A","W01001755","Total",536,124,7,117,108,58,89,12,77
"2011","Cardiff 025B","W01001756","Total",667,270,48,222,170,75,182,39,143
"2011","Cardiff 025C","W01001757","Total",571,156,20,136,151,72,116,25,91
"2011","Cardiff 025D","W01001758","Total",652,203,13,190,106,61,124,18,106
"2011","Cardiff 026A","W01001779","Total",653,202,2,200,152,55,163,18,145
"2011","Cardiff 026B","W01001780","Total",628,188,8,180,163,43,169,30,139
"2011","Cardiff 026C","W01001781","Total",829,300,14,286,183,66,235,27,208
"2011","Cardiff 026D","W01001782","Total",591,155,6,149,169,58,128,16,112
"2011","Cardiff 026E","W01001783","Total",508,126,15,111,174,53,96,18,78
"2011","Cardiff 026F","W01001784","Total",585,179,8,171,161,46,150,23,127
"2011","Cardiff 027A","W01001747","Total",812,233,26,207,189,87,199,28,171
"2011","Cardiff 027B","W01001748","Total",650,246,40,206,218,98,241,38,203
"2011","Cardiff 027C","W01001749","Total",699,290,38,252,177,83,251,34,217
"2011","Cardiff 027D","W01001751","Total",802,372,85,287,242,120,248,50,198
"2011","Cardiff 028A","W01001718","Total",577,160,21,139,83,47,102,18,84
"2011","Cardiff 028B","W01001719","Total",534,156,6,150,81,44,112,15,97
"2011","Cardiff 028C","W01001720","Total",590,168,7,161,52,21,101,9,92
"2011","Cardiff 028D","W01001722","Total",514,156,15,141,50,25,84,9,75
"2011","Cardiff 028E","W01001726","Total",524,125,9,116,54,24,83,18,65
"2011","Cardiff 029A","W01001822","Total",739,246,24,222,168,65,202,26,176
"2011","Cardiff 029B","W01001823","Total",521,97,3,94,187,92,109,20,89
"2011","Cardiff 029C","W01001824","Total",693,179,14,165,132,66,156,24,132
"2011","Cardiff 029D","W01001825","Total",774,201,25,176,201,114,196,34,162
"2011","Cardiff 030A","W01001831","Total",620,127,15,112,107,55,112,16,96
"2011","Cardiff 030B","W01001836","Total",580,120,18,102,151,68,74,16,58
"2011","Cardiff 030C","W01001837","Total",510,157,11,146,69,37,128,20,108
"2011","Cardiff 030D","W01001838","Total",640,141,13,128,129,61,127,21,106
"2011","Cardiff 030E","W01001839","Total",613,163,21,142,97,51,123,17,106
"2011","Cardiff 031A","W01001750","Total",841,428,34,394,172,73,364,40,324
"2011","Cardiff 031B","W01001752","Total",673,210,22,188,192,60,195,34,161
"2011","Cardiff 031C","W01001753","Total",642,224,69,155,254,103,211,67,144
"2011","Cardiff 031D","W01001754","Total",829,336,23,313,188,78,266,23,243
"2011","Cardiff 032A","W01001721","Total",594,275,10,265,46,22,139,8,131
"2011","Cardiff 032C","W01001724","Total",549,192,13,179,28,16,79,7,72
"2011","Cardiff 032D","W01001725","Total",589,231,16,215,35,15,66,4,62
"2011","Cardiff 032E","W01001922","Total",424,179,14,165,29,21,56,5,51
"2011","Cardiff 032F","W01001939","Total",627,253,35,218,51,40,49,2,47
"2011","Cardiff 032G","W01001941","Total",670,233,29,204,48,37,43,4,39
"2011","Cardiff 033A","W01001829","Total",663,181,20,161,94,51,123,21,102
"2011","Cardiff 033B","W01001830","Total",883,278,22,256,88,47,158,10,148
"2011","Cardiff 033C","W01001832","Total",741,297,13,284,40,26,90,3,87
"2011","Cardiff 033D","W01001833","Total",716,197,29,168,170,84,153,20,133
"2011","Cardiff 033E","W01001834","Total",691,190,21,169,116,68,135,19,116
"2011","Cardiff 033F","W01001835","Total",908,436,14,422,63,27,318,10,308
"2011","Cardiff 034A","W01001858","Total",869,197,11,186,141,59,181,22,159
"2011","Cardiff 034B","W01001859","Total",722,164,10,154,126,69,124,11,113
"2011","Cardiff 034C","W01001860","Total",799,179,12,167,167,64,162,26,136
"2011","Cardiff 034D","W01001861","Total",757,133,14,119,157,76,128,21,107
"2011","Cardiff 035A","W01001714","Total",612,188,12,176,203,83,142,23,119
"2011","Cardiff 035B","W01001715","Total",765,199,9,190,158,67,177,24,153
"2011","Cardiff 035C","W01001716","Total",543,150,11,139,176,81,134,20,114
"2011","Cardiff 035D","W01001717","Total",768,240,32,208,172,85,202,33,169
"2011","Cardiff 036A","W01001694","Total",878,324,67,257,238,127,238,47,191
"2011","Cardiff 036B","W01001695","Total",845,351,79,272,180,106,205,37,168
"2011","Cardiff 036C","W01001696","Total",683,271,67,204,185,81,206,40,166
"2011","Cardiff 036D","W01001697","Total",762,235,26,209,153,76,227,35,192
"2011","Cardiff 036E","W01001698","Total",896,285,54,231,170,93,198,34,164
"2011","Cardiff 037A","W01001870","Total",580,160,33,127,169,86,158,31,127
"2011","Cardiff 037B","W01001871","Total",679,339,90,249,250,123,235,57,178
"2011","Cardiff 037C","W01001875","Total",1140,290,119,171,398,204,246,88,158
"2011","Cardiff 037D","W01001876","Total",678,328,91,237,244,117,249,58,191
"2011","Cardiff 038A","W01001869","Total",623,192,30,162,153,78,159,24,135
"2011","Cardiff 038B","W01001872","Total",662,235,32,203,182,82,185,37,148
"2011","Cardiff 038C","W01001873","Total",778,298,63,235,213,119,250,44,206
"2011","Cardiff 038D","W01001874","Total",723,333,77,256,205,113,255,45,210
"2011","Cardiff 039A","W01001737","Total",653,352,105,247,258,118,282,75,207
"2011","Cardiff 039B","W01001738","Total",525,245,109,136,252,130,187,68,119
"2011","Cardiff 039C","W01001739","Total",523,247,111,136,241,126,182,62,120
"2011","Cardiff 039D","W01001740","Total",682,362,111,251,235,99,258,63,195
"2011","Cardiff 039E","W01001741","Total",613,312,160,152,322,172,202,67,135
"2011","Cardiff 040A","W01001709","Total",721,187,34,153,235,102,174,45,129
"2011","Cardiff 040B","W01001710","Total",701,195,25,170,178,84,162,29,133
"2011","Cardiff 040C","W01001711","Total",720,315,51,264,196,96,250,45,205
"2011","Cardiff 040D","W01001712","Total",679,149,17,132,145,76,141,14,127
"2011","Cardiff 040E","W01001713","Total",745,198,26,172,187,99,178,34,144
"2011","Cardiff 041A","W01001704","Total",631,326,95,231,248,122,240,61,179
"2011","Cardiff 041B","W01001706","Total",540,214,35,179,151,73,161,26,135
"2011","Cardiff 041C","W01001707","Total",803,351,105,246,318,139,295,78,217
"2011","Cardiff 041D","W01001746","Total",663,301,90,211,226,97,232,51,181
"2011","Cardiff 042A","W01001855","Total",685,240,61,179,236,124,171,46,125
"2011","Cardiff 042B","W01001856","Total",776,281,36,245,167,90,197,37,160
"2011","Cardiff 042C","W01001857","Total",843,402,79,323,208,116,323,42,281
"2011","Cardiff 042D","W01001862","Total",707,230,42,188,175,94,169,40,129
"2011","Cardiff 043A","W01001742","Total",640,315,114,201,267,142,237,68,169
"2011","Cardiff 043B","W01001743","Total",605,193,15,178,157,54,153,26,127
"2011","Cardiff 043C","W01001744","Total",740,383,82,301,239,101,323,71,252
"2011","Cardiff 043D","W01001745","Total",556,168,18,150,171,63,152,35,117
"2011","Cardiff 044A","W01001764","Total",603,193,50,143,237,125,174,56,118
"2011","Cardiff 044B","W01001765","Total",521,191,41,150,183,110,162,44,118
"2011","Cardiff 044C","W01001766","Total",685,252,70,182,243,126,200,47,153
"2011","Cardiff 044D","W01001767","Total",691,221,65,156,217,136,187,41,146
"2011","Cardiff 044E","W01001768","Total",539,190,64,126,232,131,145,47,98
"2011","Cardiff 045A","W01001702","Total",745,245,67,178,282,135,206,48,158
"2011","Cardiff 045B","W01001703","Total",503,205,60,145,192,80,184,58,126
"2011","Cardiff 045C","W01001705","Total",718,253,69,184,255,108,220,60,160
"2011","Cardiff 045D","W01001708","Total",737,376,74,302,213,110,294,48,246
"2011","Cardiff 046A","W01001759","Total",674,157,29,128,193,91,163,33,130
"2011","Cardiff 046B","W01001760","Total",670,221,39,182,211,84,190,36,154
"2011","Cardiff 046C","W01001761","Total",724,299,61,238,215,117,203,38,165
"2011","Cardiff 046D","W01001762","Total",736,296,59,237,228,110,260,52,208
"2011","Cardiff 048A","W01001940","Total",728,91,5,86,50,43,81,5,76
"2011","Cardiff 048B","W01001943","Total",635,79,15,64,59,46,58,4,54
"2011","Cardiff 048C","W01001944","Total",580,75,15,60,50,32,46,3,43
"2011","Cardiff 048D","W01001945","Total",838,76,10,66,52,40,65,9,56
"2011","Cardiff 048E","W01001947","Total",873,96,24,72,111,88,80,13,67
"2011","Cardiff 049A","W01001699","Total",1000,440,76,364,213,117,325,46,279
"2011","Cardiff 049B","W01001942","Total",647,215,38,177,118,62,174,28,146
"2011","Cardiff 049C","W01001946","Total",707,249,49,200,134,78,211,33,178
"2011","Cardiff 049D","W01001950","Total",609,108,5,103,63,50,71,9,62
"2011","Cardiff 049E","W01001951","Total",548,91,17,74,71,53,75,7,68
"2011","Cardiff 049F","W01001952","Total",621,150,32,118,69,44,91,16,75
"2011","Rhondda Cynon Taf 001A","W01001186","Total",685,214,49,165,265,124,195,60,135
"2011","Rhondda Cynon Taf 001B","W01001187","Total",574,218,26,192,154,58,191,37,154
"2011","Rhondda Cynon Taf 001C","W01001188","Total",497,261,42,219,123,53,222,29,193
"2011","Rhondda Cynon Taf 001D","W01001221","Total",602,314,74,240,203,86,226,54,172
"2011","Rhondda Cynon Taf 001E","W01001222","Total",649,366,104,262,229,99,266,62,204
"2011","Rhondda Cynon Taf 001F","W01001233","Total",735,314,27,287,186,55,279,53,226
"2011","Rhondda Cynon Taf 002A","W01001148","Total",750,304,41,263,233,90,252,43,209
"2011","Rhondda Cynon Taf 002B","W01001152","Total",671,268,29,239,189,59,214,40,174
"2011","Rhondda Cynon Taf 002C","W01001153","Total",636,283,43,240,202,63,228,49,179
"2011","Rhondda Cynon Taf 002D","W01001155","Total",665,275,31,244,165,61,232,31,201
"2011","Rhondda Cynon Taf 003A","W01001149","Total",619,259,36,223,177,58,224,36,188
"2011","Rhondda Cynon Taf 003B","W01001150","Total",797,348,59,289,194,93,267,43,224
"2011","Rhondda Cynon Taf 003C","W01001151","Total",713,312,13,299,169,55,233,28,205
"2011","Rhondda Cynon Taf 003D","W01001154","Total",678,331,49,282,180,73,236,39,197
"2011","Rhondda Cynon Taf 003E","W01001156","Total",549,92,8,84,240,70,114,33,81
"2011","Rhondda Cynon Taf 004A","W01001147","Total",792,321,27,294,211,68,294,38,256
"2011","Rhondda Cynon Taf 004B","W01001168","Total",638,298,30,268,181,72,230,39,191
"2011","Rhondda Cynon Taf 004C","W01001169","Total",761,346,68,278,251,112,307,74,233
"2011","Rhondda Cynon Taf 004D","W01001170","Total",527,217,15,202,130,42,147,21,126
"2011","Rhondda Cynon Taf 005A","W01001137","Total",1064,478,79,399,302,137,371,61,310
"2011","Rhondda Cynon Taf 005B","W01001138","Total",636,307,53,254,202,74,237,42,195
"2011","Rhondda Cynon Taf 005C","W01001139","Total",611,225,29,196,209,84,184,36,148
"2011","Rhondda Cynon Taf 005D","W01001140","Total",637,277,40,237,185,79,220,35,185
"2011","Rhondda Cynon Taf 005E","W01001141","Total",677,325,69,256,223,101,236,49,187
"2011","Rhondda Cynon Taf 005F","W01001142","Total",704,370,72,298,215,91,285,63,222
"2011","Rhondda Cynon Taf 006A","W01001204","Total",584,228,36,192,180,79,169,20,149
"2011","Rhondda Cynon Taf 006B","W01001205","Total",728,321,38,283,196,69,274,41,233
"2011","Rhondda Cynon Taf 006C","W01001206","Total",635,288,40,248,183,69,248,43,205
"2011","Rhondda Cynon Taf 006D","W01001207","Total",585,315,79,236,184,74,226,52,174
"2011","Rhondda Cynon Taf 006E","W01001208","Total",750,360,43,317,199,82,283,46,237
"2011","Rhondda Cynon Taf 007A","W01001265","Total",667,311,41,270,191,78,231,27,204
"2011","Rhondda Cynon Taf 007B","W01001266","Total",636,374,54,320,172,66,281,47,234
"2011","Rhondda Cynon Taf 007C","W01001267","Total",634,323,48,275,164,62,251,35,216
"2011","Rhondda Cynon Taf 007D","W01001268","Total",636,302,49,253,177,70,228,36,192
"2011","Rhondda Cynon Taf 008A","W01001209","Total",567,309,98,211,210,86,209,53,156
"2011","Rhondda Cynon Taf 008B","W01001210","Total",625,295,48,247,178,69,230,42,188
"2011","Rhondda Cynon Taf 008C","W01001211","Total",650,274,44,230,216,91,211,46,165
"2011","Rhondda Cynon Taf 008D","W01001212","Total",585,263,60,203,194,73,202,46,156
"2011","Rhondda Cynon Taf 009A","W01001175","Total",620,265,29,236,173,58,222,33,189
"2011","Rhondda Cynon Taf 009B","W01001177","Total",587,270,35,235,162,61,200,26,174
"2011","Rhondda Cynon Taf 009C","W01001202","Total",839,474,76,398,221,85,340,49,291
"2011","Rhondda Cynon Taf 009D","W01001203","Total",594,331,66,265,181,66,231,47,184
"2011","Rhondda Cynon Taf 010A","W01001269","Total",626,283,19,264,151,40,228,29,199
"2011","Rhondda Cynon Taf 010B","W01001270","Total",622,283,27,256,157,47,205,18,187
"2011","Rhondda Cynon Taf 010C","W01001271","Total",724,320,53,267,216,84,281,53,228
"2011","Rhondda Cynon Taf 010D","W01001272","Total",632,263,50,213,210,80,213,47,166
"2011","Rhondda Cynon Taf 010E","W01001273","Total",758,359,43,316,189,74,278,34,244
"2011","Rhondda Cynon Taf 011A","W01001213","Total",618,287,29,258,167,67,214,29,185
"2011","Rhondda Cynon Taf 011B","W01001214","Total",531,187,16,171,149,49,172,34,138
"2011","Rhondda Cynon Taf 011C","W01001215","Total",519,260,22,238,112,50,188,16,172
"2011","Rhondda Cynon Taf 011D","W01001216","Total",654,245,47,198,198,89,229,52,177
"2011","Rhondda Cynon Taf 012A","W01001143","Total",633,221,33,188,209,83,195,37,158
"2011","Rhondda Cynon Taf 012B","W01001144","Total",668,305,73,232,225,98,227,61,166
"2011","Rhondda Cynon Taf 012C","W01001145","Total",753,284,38,246,241,100,239,45,194
"2011","Rhondda Cynon Taf 012D","W01001146","Total",640,237,28,209,171,62,205,41,164
"2011","Rhondda Cynon Taf 013A","W01001176","Total",620,252,29,223,209,78,204,35,169
"2011","Rhondda Cynon Taf 013B","W01001274","Total",577,348,95,253,196,87,235,61,174
"2011","Rhondda Cynon Taf 013C","W01001275","Total",792,363,73,290,238,96,291,60,231
"2011","Rhondda Cynon Taf 013D","W01001276","Total",668,334,64,270,167,59,254,36,218
"2011","Rhondda Cynon Taf 014A","W01001200","Total",420,160,25,135,132,38,158,38,120
"2011","Rhondda Cynon Taf 014B","W01001201","Total",537,258,34,224,145,53,227,35,192
"2011","Rhondda Cynon Taf 014C","W01001260","Total",476,232,55,177,143,60,205,40,165
"2011","Rhondda Cynon Taf 014D","W01001285","Total",605,262,22,240,143,47,221,27,194
"2011","Rhondda Cynon Taf 014E","W01001286","Total",643,250,45,205,190,69,203,43,160
"2011","Rhondda Cynon Taf 014F","W01001287","Total",623,261,42,219,183,57,223,45,178
"2011","Rhondda Cynon Taf 014G","W01001288","Total",640,314,50,264,177,73,241,41,200
"2011","Rhondda Cynon Taf 015A","W01001180","Total",648,343,93,250,218,117,249,48,201
"2011","Rhondda Cynon Taf 015B","W01001181","Total",606,230,28,202,180,58,216,36,180
"2011","Rhondda Cynon Taf 015C","W01001282","Total",867,362,63,299,264,108,310,61,249
"2011","Rhondda Cynon Taf 015D","W01001283","Total",639,256,32,224,174,71,223,39,184
"2011","Rhondda Cynon Taf 015E","W01001284","Total",423,88,13,75,192,65,113,40,73
"2011","Rhondda Cynon Taf 016A","W01001166","Total",553,254,47,207,165,59,203,42,161
"2011","Rhondda Cynon Taf 016B","W01001167","Total",632,274,45,229,196,75,237,40,197
"2011","Rhondda Cynon Taf 016C","W01001247","Total",755,329,43,286,209,89,269,35,234
"2011","Rhondda Cynon Taf 016D","W01001248","Total",864,355,50,305,267,99,265,46,219
"2011","Rhondda Cynon Taf 017A","W01001171","Total",581,240,23,217,147,52,212,40,172
"2011","Rhondda Cynon Taf 017B","W01001229","Total",648,249,28,221,179,72,194,33,161
"2011","Rhondda Cynon Taf 017C","W01001230","Total",612,220,24,196,203,76,186,36,150
"2011","Rhondda Cynon Taf 017D","W01001231","Total",696,291,45,246,199,81,242,45,197
"2011","Rhondda Cynon Taf 017E","W01001280","Total",752,381,50,331,199,70,292,39,253
"2011","Rhondda Cynon Taf 017F","W01001281","Total",741,307,30,277,208,83,241,40,201
"2011","Rhondda Cynon Taf 018A","W01001217","Total",483,212,34,178,159,72,164,28,136
"2011","Rhondda Cynon Taf 018B","W01001218","Total",643,231,41,190,207,68,216,41,175
"2011","Rhondda Cynon Taf 018C","W01001219","Total",624,333,49,284,159,57,273,32,241
"2011","Rhondda Cynon Taf 018D","W01001220","Total",623,250,33,217,206,70,223,38,185
"2011","Rhondda Cynon Taf 018E","W01001259","Total",684,291,43,248,222,88,245,45,200
"2011","Rhondda Cynon Taf 018F","W01001261","Total",541,218,28,190,146,64,175,34,141
"2011","Rhondda Cynon Taf 019A","W01001164","Total",656,204,29,175,224,97,192,35,157
"2011","Rhondda Cynon Taf 019B","W01001165","Total",554,170,25,145,181,63,179,32,147
"2011","Rhondda Cynon Taf 019C","W01001256","Total",522,179,32,147,149,75,142,27,115
"2011","Rhondda Cynon Taf 019D","W01001257","Total",520,192,14,178,130,41,165,32,133
"2011","Rhondda Cynon Taf 019E","W01001258","Total",636,260,23,237,145,67,196,18,178
"2011","Rhondda Cynon Taf 020A","W01001172","Total",642,269,45,224,202,88,211,41,170
"2011","Rhondda Cynon Taf 020B","W01001173","Total",612,314,51,263,177,65,240,53,187
"2011","Rhondda Cynon Taf 020C","W01001174","Total",624,334,85,249,208,80,253,61,192
"2011","Rhondda Cynon Taf 020D","W01001232","Total",609,275,40,235,165,61,224,29,195
"2011","Rhondda Cynon Taf 021A","W01001182","Total",594,197,43,154,207,98,151,35,116
"2011","Rhondda Cynon Taf 021B","W01001183","Total",500,226,29,197,105,59,171,29,142
"2011","Rhondda Cynon Taf 021C","W01001227","Total",543,182,17,165,157,60,136,29,107
"2011","Rhondda Cynon Taf 021D","W01001228","Total",662,261,10,251,158,50,183,17,166
"2011","Rhondda Cynon Taf 021E","W01001234","Total",632,205,15,190,167,69,200,33,167
"2011","Rhondda Cynon Taf 021F","W01001235","Total",718,303,42,261,217,86,266,45,221
"2011","Rhondda Cynon Taf 021G","W01001236","Total",645,239,21,218,191,70,181,27,154
"2011","Rhondda Cynon Taf 022A","W01001185","Total",762,335,45,290,200,94,284,42,242
"2011","Rhondda Cynon Taf 022B","W01001237","Total",633,282,45,237,187,74,253,53,200
"2011","Rhondda Cynon Taf 022C","W01001238","Total",672,365,137,228,275,99,246,85,161
"2011","Rhondda Cynon Taf 022D","W01001262","Total",546,194,24,170,118,58,149,19,130
"2011","Rhondda Cynon Taf 022E","W01001263","Total",600,247,26,221,87,34,118,15,103
"2011","Rhondda Cynon Taf 022F","W01001264","Total",519,207,18,189,72,26,102,11,91
"2011","Rhondda Cynon Taf 023A","W01001178","Total",723,306,49,257,228,89,268,51,217
"2011","Rhondda Cynon Taf 023B","W01001179","Total",728,368,86,282,245,81,291,82,209
"2011","Rhondda Cynon Taf 023C","W01001253","Total",596,234,40,194,207,76,188,38,150
"2011","Rhondda Cynon Taf 023E","W01001255","Total",691,315,62,253,225,68,257,58,199
"2011","Rhondda Cynon Taf 023F","W01001914","Total",577,79,12,67,323,122,106,43,63
"2011","Rhondda Cynon Taf 023G","W01001917","Total",606,258,32,226,195,69,197,42,155
"2011","Rhondda Cynon Taf 024A","W01001249","Total",645,278,21,257,147,52,258,24,234
"2011","Rhondda Cynon Taf 024B","W01001250","Total",562,218,30,188,168,57,190,43,147
"2011","Rhondda Cynon Taf 024C","W01001251","Total",675,353,101,252,242,112,250,57,193
"2011","Rhondda Cynon Taf 024D","W01001252","Total",619,189,19,170,199,77,169,33,136
"2011","Rhondda Cynon Taf 025A","W01001162","Total",763,333,66,267,247,101,268,53,215
"2011","Rhondda Cynon Taf 025B","W01001244","Total",612,285,13,272,122,37,208,27,181
"2011","Rhondda Cynon Taf 025C","W01001245","Total",518,173,9,164,133,47,122,17,105
"2011","Rhondda Cynon Taf 025D","W01001246","Total",625,294,17,277,142,51,211,25,186
"2011","Rhondda Cynon Taf 026A","W01001184","Total",864,332,21,311,201,61,300,36,264
"2011","Rhondda Cynon Taf 026B","W01001239","Total",633,325,68,257,189,62,262,56,206
"2011","Rhondda Cynon Taf 026C","W01001240","Total",845,221,18,203,210,82,210,42,168
"2011","Rhondda Cynon Taf 026D","W01001241","Total",756,228,18,210,207,102,183,27,156
"2011","Rhondda Cynon Taf 027B","W01001196","Total",630,131,24,107,219,76,123,38,85
"2011","Rhondda Cynon Taf 027C","W01001197","Total",481,147,3,144,145,41,119,24,95
"2011","Rhondda Cynon Taf 027D","W01001198","Total",662,158,12,146,202,78,152,34,118
"2011","Rhondda Cynon Taf 027E","W01001199","Total",694,192,28,164,227,99,161,31,130
"2011","Rhondda Cynon Taf 027F","W01001915","Total",609,102,14,88,298,126,104,36,68
"2011","Rhondda Cynon Taf 027G","W01001916","Total",547,67,15,52,261,111,86,35,51
"2011","Rhondda Cynon Taf 028A","W01001157","Total",591,161,18,143,176,77,162,31,131
"2011","Rhondda Cynon Taf 028B","W01001158","Total",614,193,34,159,178,70,173,32,141
"2011","Rhondda Cynon Taf 028C","W01001159","Total",509,86,19,67,202,76,98,23,75
"2011","Rhondda Cynon Taf 028D","W01001277","Total",456,116,13,103,147,49,115,24,91
"2011","Rhondda Cynon Taf 028E","W01001278","Total",464,185,34,151,174,75,144,37,107
"2011","Rhondda Cynon Taf 028F","W01001279","Total",532,286,66,220,169,74,211,43,168
"2011","Rhondda Cynon Taf 029A","W01001160","Total",664,196,17,179,179,68,170,26,144
"2011","Rhondda Cynon Taf 029B","W01001161","Total",898,240,35,205,306,134,270,58,212
"2011","Rhondda Cynon Taf 029C","W01001189","Total",686,247,55,192,242,100,216,49,167
"2011","Rhondda Cynon Taf 029D","W01001190","Total",1018,247,29,218,364,134,236,63,173
"2011","Rhondda Cynon Taf 030A","W01001193","Total",489,157,5,152,139,47,134,9,125
"2011","Rhondda Cynon Taf 030B","W01001194","Total",878,202,14,188,316,147,206,51,155
"2011","Rhondda Cynon Taf 030C","W01001195","Total",685,245,27,218,187,64,211,30,181
"2011","Rhondda Cynon Taf 030D","W01001242","Total",569,242,13,229,143,46,179,24,155
"2011","Rhondda Cynon Taf 030E","W01001243","Total",672,309,36,273,170,74,247,32,215
"2011","Rhondda Cynon Taf 031A","W01001191","Total",1011,211,25,186,368,170,230,50,180
"2011","Rhondda Cynon Taf 031B","W01001192","Total",626,296,48,248,210,88,250,50,200
"2011","Rhondda Cynon Taf 031C","W01001223","Total",702,225,5,220,188,68,156,25,131
"2011","Rhondda Cynon Taf 031D","W01001224","Total",779,140,8,132,362,163,124,32,92
"2011","Rhondda Cynon Taf 031E","W01001225","Total",653,202,9,193,187,73,144,34,110
"2011","Rhondda Cynon Taf 031F","W01001226","Total",722,236,23,213,236,113,209,47,162
"2011","Merthyr Tydfil 002A","W01001295","Total",683,322,72,250,225,92,259,54,205
"2011","Merthyr Tydfil 002B","W01001296","Total",651,195,28,167,205,65,175,39,136
"2011","Merthyr Tydfil 002C","W01001297","Total",775,260,41,219,260,108,256,57,199
"2011","Merthyr Tydfil 002D","W01001298","Total",780,337,53,284,244,99,286,50,236
"2011","Merthyr Tydfil 002E","W01001310","Total",659,241,27,214,193,82,229,43,186
"2011","Merthyr Tydfil 002F","W01001311","Total",500,183,28,155,171,73,174,35,139
"2011","Merthyr Tydfil 003A","W01001291","Total",679,174,40,134,261,110,199,49,150
"2011","Merthyr Tydfil 003B","W01001294","Total",649,195,5,190,195,72,196,32,164
"2011","Merthyr Tydfil 003C","W01001305","Total",517,192,22,170,146,46,153,26,127
"2011","Merthyr Tydfil 003D","W01001306","Total",644,205,19,186,186,50,190,32,158
"2011","Merthyr Tydfil 003E","W01001324","Total",896,368,25,343,211,68,301,45,256
"2011","Merthyr Tydfil 004A","W01001292","Total",692,307,80,227,252,109,264,67,197
"2011","Merthyr Tydfil 004B","W01001293","Total",734,332,43,289,199,78,265,42,223
"2011","Merthyr Tydfil 004C","W01001307","Total",731,374,34,340,148,59,330,39,291
"2011","Merthyr Tydfil 004D","W01001315","Total",809,378,37,341,187,77,315,41,274
"2011","Merthyr Tydfil 005A","W01001314","Total",895,313,41,272,296,113,289,50,239
"2011","Merthyr Tydfil 005B","W01001316","Total",1162,284,24,260,391,161,283,61,222
"2011","Merthyr Tydfil 005C","W01001317","Total",677,282,18,264,181,61,235,40,195
"2011","Merthyr Tydfil 005D","W01001318","Total",646,249,15,234,179,69,195,29,166
"2011","Merthyr Tydfil 006A","W01001289","Total",619,256,18,238,152,59,240,34,206
"2011","Merthyr Tydfil 006B","W01001302","Total",472,193,33,160,146,55,169,30,139
"2011","Merthyr Tydfil 006C","W01001303","Total",506,254,72,182,175,71,216,55,161
"2011","Merthyr Tydfil 006D","W01001304","Total",614,230,27,203,188,58,209,45,164
"2011","Merthyr Tydfil 006E","W01001312","Total",643,312,42,270,187,69,265,45,220
"2011","Merthyr Tydfil 006F","W01001313","Total",658,248,32,216,192,69,201,40,161
"2011","Merthyr Tydfil 007A","W01001290","Total",768,303,56,247,257,93,275,57,218
"2011","Merthyr Tydfil 007B","W01001319","Total",646,182,10,172,206,52,152,33,119
"2011","Merthyr Tydfil 007C","W01001320","Total",603,197,41,156,202,78,191,44,147
"2011","Merthyr Tydfil 007D","W01001321","Total",632,255,54,201,233,92,227,59,168
"2011","Merthyr Tydfil 007E","W01001322","Total",667,236,36,200,202,90,214,42,172
"2011","Merthyr Tydfil 008A","W01001299","Total",686,366,101,265,248,124,252,56,196
"2011","Merthyr Tydfil 008B","W01001300","Total",654,310,96,214,252,119,253,68,185
"2011","Merthyr Tydfil 008C","W01001301","Total",751,360,99,261,300,137,285,81,204
"2011","Merthyr Tydfil 008D","W01001308","Total",445,194,82,112,212,81,176,71,105
"2011","Merthyr Tydfil 008E","W01001309","Total",496,218,50,168,189,75,177,47,130
"2011","Merthyr Tydfil 008F","W01001898","Total",625,245,27,218,183,64,203,37,166
"2011","Caerphilly 001A","W01001374","Total",591,247,44,203,197,57,211,45,166
"2011","Caerphilly 001B","W01001375","Total",685,314,38,276,190,63,260,49,211
"2011","Caerphilly 001C","W01001376","Total",665,361,84,277,210,90,274,54,220
"2011","Caerphilly 001D","W01001406","Total",841,361,51,310,233,81,292,49,243
"2011","Caerphilly 001E","W01001428","Total",543,317,106,211,205,80,202,55,147
"2011","Caerphilly 001F","W01001429","Total",532,224,25,199,139,54,169,22,147
"2011","Caerphilly 002A","W01001360","Total",544,188,22,166,176,64,164,31,133
"2011","Caerphilly 002B","W01001361","Total",497,239,52,187,179,62,203,55,148
"2011","Caerphilly 002C","W01001384","Total",698,278,39,239,223,99,231,39,192
"2011","Caerphilly 002D","W01001385","Total",693,326,48,278,206,88,268,34,234
"2011","Caerphilly 002E","W01001386","Total",719,395,93,302,256,114,261,51,210
"2011","Caerphilly 003A","W01001325","Total",624,265,52,213,209,89,234,50,184
"2011","Caerphilly 003B","W01001326","Total",887,397,80,317,289,138,333,70,263
"2011","Caerphilly 003C","W01001362","Total",921,424,32,392,236,93,358,43,315
"2011","Caerphilly 004A","W01001336","Total",614,267,39,228,169,60,211,39,172
"2011","Caerphilly 004B","W01001337","Total",657,259,45,214,218,74,229,57,172
"2011","Caerphilly 004C","W01001338","Total",774,295,52,243,230,100,275,49,226
"2011","Caerphilly 004D","W01001339","Total",600,339,107,232,215,101,256,63,193
"2011","Caerphilly 005A","W01001334","Total",592,260,66,194,218,95,206,52,154
"2011","Caerphilly 005B","W01001335","Total",517,154,24,130,167,71,130,28,102
"2011","Caerphilly 005C","W01001347","Total",602,251,23,228,169,45,224,44,180
"2011","Caerphilly 005D","W01001351","Total",652,214,4,210,158,41,177,23,154
"2011","Caerphilly 006A","W01001356","Total",485,172,16,156,162,52,150,32,118
"2011","Caerphilly 006B","W01001357","Total",661,223,21,202,199,65,194,33,161
"2011","Caerphilly 006C","W01001358","Total",650,296,63,233,213,71,218,55,163
"2011","Caerphilly 006D","W01001359","Total",650,191,16,175,183,73,203,43,160
"2011","Caerphilly 006E","W01001390","Total",672,163,19,144,269,118,143,41,102
"2011","Caerphilly 006F","W01001391","Total",672,259,30,229,214,86,218,42,176
"2011","Caerphilly 007A","W01001352","Total",754,313,55,258,255,87,270,60,210
"2011","Caerphilly 007B","W01001353","Total",738,387,40,347,160,54,304,40,264
"2011","Caerphilly 007C","W01001387","Total",542,248,43,205,160,66,198,37,161
"2011","Caerphilly 007D","W01001388","Total",723,282,90,192,300,119,238,74,164
"2011","Caerphilly 007E","W01001389","Total",457,160,21,139,158,68,158,32,126
"2011","Caerphilly 008A","W01001414","Total",647,278,69,209,229,85,214,46,168
"2011","Caerphilly 008B","W01001415","Total",719,258,40,218,260,107,233,64,169
"2011","Caerphilly 008C","W01001416","Total",647,276,23,253,159,53,207,36,171
"2011","Caerphilly 008D","W01001417","Total",578,132,17,115,203,55,144,45,99
"2011","Caerphilly 008E","W01001418","Total",623,276,50,226,183,73,230,40,190
"2011","Caerphilly 009A","W01001348","Total",734,312,57,255,281,101,259,55,204
"2011","Caerphilly 009B","W01001349","Total",685,129,19,110,327,106,142,47,95
"2011","Caerphilly 009C","W01001350","Total",766,287,39,248,223,69,221,37,184
"2011","Caerphilly 009D","W01001392","Total",755,258,14,244,213,76,213,27,186
"2011","Caerphilly 010A","W01001380","Total",771,283,34,249,231,98,248,39,209
"2011","Caerphilly 010B","W01001381","Total",624,300,70,230,219,73,239,58,181
"2011","Caerphilly 010C","W01001382","Total",685,278,8,270,168,66,225,29,196
"2011","Caerphilly 010D","W01001383","Total",663,266,38,228,187,73,211,42,169
"2011","Caerphilly 011A","W01001401","Total",848,349,28,321,229,80,290,51,239
"2011","Caerphilly 011B","W01001402","Total",679,271,73,198,256,100,240,68,172
"2011","Caerphilly 011C","W01001403","Total",680,213,24,189,219,76,177,28,149
"2011","Caerphilly 011D","W01001404","Total",584,215,3,212,137,37,162,20,142
"2011","Caerphilly 011E","W01001405","Total",744,313,64,249,262,94,248,53,195
"2011","Caerphilly 012A","W01001363","Total",565,176,42,134,218,85,177,57,120
"2011","Caerphilly 012B","W01001364","Total",689,300,104,196,288,106,258,92,166
"2011","Caerphilly 012C","W01001365","Total",842,309,61,248,298,120,274,68,206
"2011","Caerphilly 012D","W01001369","Total",943,344,31,313,257,96,310,55,255
"2011","Caerphilly 013A","W01001377","Total",672,252,24,228,181,71,195,29,166
"2011","Caerphilly 013B","W01001378","Total",681,311,41,270,194,63,256,39,217
"2011","Caerphilly 013C","W01001379","Total",625,219,19,200,200,71,183,36,147
"2011","Caerphilly 013D","W01001432","Total",952,311,42,269,299,126,273,62,211
"2011","Caerphilly 013E","W01001433","Total",635,253,23,230,164,68,218,32,186
"2011","Caerphilly 013F","W01001434","Total",549,143,10,133,216,68,124,24,100
"2011","Caerphilly 014A","W01001327","Total",947,274,37,237,278,133,243,47,196
"2011","Caerphilly 014B","W01001328","Total",641,231,38,193,221,89,209,45,164
"2011","Caerphilly 014C","W01001329","Total",654,271,36,235,201,83,211,39,172
"2011","Caerphilly 014D","W01001354","Total",706,220,21,199,214,93,205,40,165
"2011","Caerphilly 015A","W01001355","Total",811,410,25,385,166,65,337,40,297
"2011","Caerphilly 015B","W01001430","Total",983,345,57,288,309,121,310,57,253
"2011","Caerphilly 015C","W01001431","Total",642,205,23,182,200,64,172,42,130
"2011","Caerphilly 016A","W01001407","Total",617,165,28,137,183,78,131,29,102
"2011","Caerphilly 016B","W01001408","Total",606,232,60,172,220,85,188,45,143
"2011","Caerphilly 016C","W01001409","Total",697,243,22,221,196,65,198,31,167
"2011","Caerphilly 016D","W01001410","Total",823,302,28,274,222,77,284,51,233
"2011","Caerphilly 017A","W01001411","Total",784,339,23,316,173,67,281,34,247
"2011","Caerphilly 017B","W01001412","Total",831,304,25,279,177,61,262,28,234
"2011","Caerphilly 017C","W01001413","Total",749,290,32,258,230,78,273,53,220
"2011","Caerphilly 018A","W01001330","Total",620,229,19,210,182,66,208,38,170
"2011","Caerphilly 018B","W01001331","Total",728,237,55,182,263,130,196,50,146
"2011","Caerphilly 018C","W01001332","Total",806,341,83,258,298,127,280,62,218
"2011","Caerphilly 018D","W01001333","Total",624,238,64,174,241,103,203,62,141
"2011","Caerphilly 019A","W01001366","Total",697,201,24,177,202,94,203,42,161
"2011","Caerphilly 019B","W01001367","Total",634,215,36,179,207,73,201,42,159
"2011","Caerphilly 019C","W01001368","Total",640,260,50,210,219,86,224,40,184
"2011","Caerphilly 019D","W01001393","Total",545,237,43,194,175,74,180,26,154
"2011","Caerphilly 019E","W01001397","Total",677,184,27,157,240,107,169,45,124
"2011","Caerphilly 019F","W01001400","Total",567,246,85,161,239,92,200,65,135
"2011","Caerphilly 020A","W01001340","Total",694,204,13,191,227,87,184,38,146
"2011","Caerphilly 020B","W01001341","Total",794,381,64,317,222,77,334,70,264
"2011","Caerphilly 020C","W01001344","Total",689,268,24,244,201,70,232,40,192
"2011","Caerphilly 020D","W01001346","Total",660,270,25,245,202,82,207,37,170
"2011","Caerphilly 021A","W01001342","Total",496,153,9,144,153,65,131,16,115
"2011","Caerphilly 021B","W01001343","Total",497,166,20,146,139,40,131,31,100
"2011","Caerphilly 021C","W01001345","Total",590,295,129,166,273,132,187,67,120
"2011","Caerphilly 021D","W01001419","Total",632,183,19,164,187,65,175,40,135
"2011","Caerphilly 022A","W01001371","Total",624,252,55,197,196,93,215,44,171
"2011","Caerphilly 022B","W01001372","Total",805,250,46,204,267,113,209,53,156
"2011","Caerphilly 022C","W01001373","Total",703,218,24,194,218,90,197,50,147
"2011","Caerphilly 022D","W01001420","Total",562,172,31,141,173,73,161,35,126
"2011","Caerphilly 022E","W01001421","Total",710,442,134,308,248,92,318,82,236
"2011","Caerphilly 022F","W01001422","Total",673,381,77,304,201,90,261,54,207
"2011","Caerphilly 023A","W01001370","Total",773,314,20,294,173,57,264,30,234
"2011","Caerphilly 023B","W01001394","Total",507,92,10,82,196,79,98,33,65
"2011","Caerphilly 023C","W01001395","Total",616,301,37,264,165,55,217,37,180
"2011","Caerphilly 023D","W01001396","Total",656,303,97,206,271,122,235,78,157
"2011","Caerphilly 023E","W01001399","Total",548,203,15,188,150,60,168,23,145
"2011","Caerphilly 024A","W01001398","Total",963,155,36,119,400,190,175,52,123
"2011","Caerphilly 024B","W01001423","Total",632,262,7,255,139,49,196,26,170
"2011","Caerphilly 024C","W01001424","Total",659,291,29,262,175,65,244,37,207
"2011","Caerphilly 024D","W01001425","Total",715,254,18,236,187,71,220,33,187
"2011","Caerphilly 024E","W01001426","Total",532,159,5,154,159,61,125,22,103
"2011","Caerphilly 024F","W01001427","Total",683,74,5,69,306,130,94,37,57
"2011","Blaenau Gwent 001A","W01001440","Total",604,267,37,230,173,63,195,33,162
"2011","Blaenau Gwent 001B","W01001441","Total",503,240,51,189,158,66,190,33,157
"2011","Blaenau Gwent 001C","W01001442","Total",504,177,17,160,157,61,138,23,115
"2011","Blaenau Gwent 001D","W01001470","Total",633,250,21,229,171,64,199,27,172
"2011","Blaenau Gwent 001E","W01001471","Total",767,367,83,284,233,106,278,43,235
"2011","Blaenau Gwent 002A","W01001446","Total",485,149,14,135,152,49,134,27,107
"2011","Blaenau Gwent 002B","W01001447","Total",622,261,75,186,229,96,177,39,138
"2011","Blaenau Gwent 002C","W01001448","Total",624,260,22,238,133,56,207,20,187
"2011","Blaenau Gwent 002D","W01001449","Total",726,330,23,307,165,89,263,28,235
"2011","Blaenau Gwent 003A","W01001472","Total",634,282,20,262,186,52,217,38,179
"2011","Blaenau Gwent 003B","W01001473","Total",603,337,88,249,200,87,234,47,187
"2011","Blaenau Gwent 003C","W01001474","Total",673,330,47,283,175,66,253,41,212
"2011","Blaenau Gwent 003D","W01001475","Total",513,203,23,180,154,65,169,35,134
"2011","Blaenau Gwent 003E","W01001480","Total",635,343,68,275,187,59,256,41,215
"2011","Blaenau Gwent 004A","W01001438","Total",670,328,21,307,165,34,274,35,239
"2011","Blaenau Gwent 004B","W01001439","Total",680,225,16,209,203,57,197,38,159
"2011","Blaenau Gwent 004C","W01001456","Total",552,243,45,198,163,68,188,35,153
"2011","Blaenau Gwent 004D","W01001457","Total",743,360,83,277,234,82,269,57,212
"2011","Blaenau Gwent 004E","W01001458","Total",638,238,31,207,207,70,173,29,144
"2011","Blaenau Gwent 005A","W01001443","Total",646,325,42,283,153,57,274,48,226
"2011","Blaenau Gwent 005B","W01001444","Total",796,325,59,266,259,93,283,62,221
"2011","Blaenau Gwent 005C","W01001445","Total",633,273,48,225,198,74,197,28,169
"2011","Blaenau Gwent 005D","W01001467","Total",798,360,58,302,254,105,292,62,230
"2011","Blaenau Gwent 005E","W01001468","Total",582,240,38,202,179,65,212,43,169
"2011","Blaenau Gwent 005F","W01001469","Total",504,236,69,167,185,69,166,44,122
"2011","Blaenau Gwent 006A","W01001462","Total",662,274,27,247,204,72,238,44,194
"2011","Blaenau Gwent 006B","W01001463","Total",868,320,34,286,239,80,242,26,216
"2011","Blaenau Gwent 006C","W01001478","Total",662,243,27,216,181,59,214,42,172
"2011","Blaenau Gwent 006D","W01001479","Total",706,422,86,336,218,88,305,58,247
"2011","Blaenau Gwent 006E","W01001481","Total",775,383,39,344,160,57,273,30,243
"2011","Blaenau Gwent 007A","W01001450","Total",570,253,31,222,166,62,213,42,171
"2011","Blaenau Gwent 007B","W01001451","Total",656,312,52,260,194,77,248,36,212
"2011","Blaenau Gwent 007C","W01001452","Total",624,179,25,154,208,65,178,37,141
"2011","Blaenau Gwent 007D","W01001459","Total",448,197,47,150,165,68,144,46,98
"2011","Blaenau Gwent 007E","W01001460","Total",764,260,30,230,213,84,200,27,173
"2011","Blaenau Gwent 007F","W01001461","Total",634,268,40,228,179,67,199,34,165
"2011","Blaenau Gwent 008A","W01001435","Total",632,230,50,180,199,58,214,45,169
"2011","Blaenau Gwent 008B","W01001436","Total",646,325,49,276,161,70,232,38,194
"2011","Blaenau Gwent 008C","W01001437","Total",658,256,44,212,201,72,210,37,173
"2011","Blaenau Gwent 008D","W01001453","Total",648,295,61,234,203,83,250,48,202
"2011","Blaenau Gwent 008E","W01001454","Total",609,264,43,221,166,69,207,38,169
"2011","Blaenau Gwent 008F","W01001455","Total",792,364,44,320,222,85,317,36,281
"2011","Blaenau Gwent 009A","W01001464","Total",689,331,60,271,190,70,273,45,228
"2011","Blaenau Gwent 009B","W01001465","Total",698,325,54,271,193,93,238,45,193
"2011","Blaenau Gwent 009C","W01001466","Total",787,360,61,299,204,80,298,49,249
"2011","Blaenau Gwent 009D","W01001476","Total",486,243,46,197,128,55,169,22,147
"2011","Blaenau Gwent 009E","W01001477","Total",634,251,27,224,186,61,209,35,174
"2011","Torfaen 001A","W01001487","Total",662,294,33,261,201,69,217,36,181
"2011","Torfaen 001B","W01001488","Total",683,317,63,254,218,96,238,38,200
"2011","Torfaen 001C","W01001489","Total",702,299,41,258,183,80,239,31,208
"2011","Torfaen 001D","W01001490","Total",598,242,29,213,167,74,191,40,151
"2011","Torfaen 002A","W01001482","Total",497,211,42,169,160,62,180,37,143
"2011","Torfaen 002B","W01001483","Total",564,262,64,198,215,76,220,50,170
"2011","Torfaen 002C","W01001484","Total",695,252,30,222,223,82,202,37,165
"2011","Torfaen 002D","W01001485","Total",529,253,38,215,170,58,209,36,173
"2011","Torfaen 002E","W01001486","Total",653,230,35,195,210,82,208,37,171
"2011","Torfaen 003A","W01001525","Total",602,259,40,219,210,67,207,47,160
"2011","Torfaen 003B","W01001529","Total",917,401,49,352,254,98,314,58,256
"2011","Torfaen 003C","W01001530","Total",698,326,114,212,291,126,250,75,175
"2011","Torfaen 003D","W01001531","Total",706,294,56,238,219,95,242,52,190
"2011","Torfaen 004A","W01001491","Total",802,319,45,274,241,126,269,48,221
"2011","Torfaen 004B","W01001496","Total",585,227,46,181,197,79,201,40,161
"2011","Torfaen 004C","W01001523","Total",638,209,35,174,186,79,186,38,148
"2011","Torfaen 004D","W01001524","Total",829,350,30,320,210,78,290,39,251
"2011","Torfaen 004E","W01001540","Total",532,154,15,139,157,57,162,30,132
"2011","Torfaen 004F","W01001541","Total",459,158,21,137,135,42,155,31,124
"2011","Torfaen 005A","W01001510","Total",670,256,23,233,195,70,213,36,177
"2011","Torfaen 005B","W01001511","Total",719,296,24,272,199,61,227,29,198
"2011","Torfaen 005C","W01001512","Total",607,247,5,242,119,38,183,17,166
"2011","Torfaen 005D","W01001513","Total",636,243,13,230,176,52,153,27,126
"2011","Torfaen 006A","W01001514","Total",495,173,11,162,122,55,138,19,119
"2011","Torfaen 006B","W01001515","Total",630,192,26,166,211,87,162,40,122
"2011","Torfaen 006C","W01001516","Total",619,246,33,213,175,61,220,41,179
"2011","Torfaen 006D","W01001517","Total",822,218,22,196,289,129,186,42,144
"2011","Torfaen 006E","W01001518","Total",477,201,13,188,114,32,126,18,108
"2011","Torfaen 007A","W01001519","Total",627,275,52,223,182,74,245,50,195
"2011","Torfaen 007B","W01001520","Total",729,248,38,210,236,89,205,53,152
"2011","Torfaen 007C","W01001521","Total",611,212,33,179,180,61,173,29,144
"2011","Torfaen 007D","W01001522","Total",759,340,32,308,222,87,300,48,252
"2011","Torfaen 007E","W01001537","Total",507,170,9,161,132,44,149,20,129
"2011","Torfaen 008A","W01001493","Total",905,360,19,341,211,86,256,31,225
"2011","Torfaen 008B","W01001494","Total",654,290,14,276,155,46,191,27,164
"2011","Torfaen 008C","W01001495","Total",850,416,17,399,183,58,317,38,279
"2011","Torfaen 008D","W01001507","Total",905,407,27,380,248,73,284,35,249
"2011","Torfaen 009A","W01001501","Total",510,156,56,100,218,82,142,44,98
"2011","Torfaen 009B","W01001503","Total",505,180,50,130,217,94,143,38,105
"2011","Torfaen 009C","W01001536","Total",471,190,62,128,206,85,147,42,105
"2011","Torfaen 009D","W01001538","Total",569,252,51,201,192,69,194,43,151
"2011","Torfaen 009E","W01001539","Total",598,213,41,172,193,92,194,46,148
"2011","Torfaen 010A","W01001506","Total",688,315,22,293,144,52,281,33,248
"2011","Torfaen 010B","W01001526","Total",574,252,46,206,173,77,191,39,152
"2011","Torfaen 010C","W01001527","Total",638,326,27,299,115,56,269,22,247
"2011","Torfaen 010D","W01001528","Total",484,210,29,181,139,64,170,31,139
"2011","Torfaen 010E","W01001532","Total",743,318,54,264,231,94,280,47,233
"2011","Torfaen 011A","W01001497","Total",613,260,36,224,199,69,199,32,167
"2011","Torfaen 011B","W01001498","Total",488,226,45,181,164,55,172,44,128
"2011","Torfaen 011C","W01001499","Total",513,114,19,95,167,67,123,29,94
"2011","Torfaen 011D","W01001500","Total",497,82,6,76,183,50,113,33,80
"2011","Torfaen 011E","W01001502","Total",500,116,18,98,184,54,102,27,75
"2011","Torfaen 012A","W01001492","Total",928,273,35,238,316,114,237,52,185
"2011","Torfaen 012B","W01001533","Total",611,117,6,111,239,75,136,38,98
"2011","Torfaen 012C","W01001534","Total",638,218,23,195,178,62,214,41,173
"2011","Torfaen 012D","W01001535","Total",576,172,27,145,167,56,163,33,130
"2011","Torfaen 013A","W01001504","Total",862,370,33,337,257,110,278,42,236
"2011","Torfaen 013B","W01001505","Total",800,267,26,241,260,91,227,50,177
"2011","Torfaen 013C","W01001508","Total",527,254,8,246,116,30,184,23,161
"2011","Torfaen 013D","W01001509","Total",618,235,8,227,179,34,156,26,130
"2011","Monmouthshire 001A","W01001545","Total",632,298,6,292,116,29,193,14,179
"2011","Monmouthshire 001B","W01001548","Total",857,250,17,233,238,85,211,31,180
"2011","Monmouthshire 001C","W01001557","Total",911,365,28,337,212,89,285,35,250
"2011","Monmouthshire 001D","W01001571","Total",508,168,9,159,125,37,129,18,111
"2011","Monmouthshire 001E","W01001579","Total",745,311,9,302,126,43,221,9,212
"2011","Monmouthshire 002A","W01001546","Total",645,246,41,205,215,73,199,32,167
"2011","Monmouthshire 002C","W01001558","Total",697,339,23,316,174,56,290,39,251
"2011","Monmouthshire 002E","W01001580","Total",809,341,18,323,203,81,263,30,233
"2011","Monmouthshire 002F","W01001909","Total",1165,510,67,443,337,149,442,75,367
"2011","Monmouthshire 003A","W01001561","Total",651,285,6,279,111,29,186,31,155
"2011","Monmouthshire 003B","W01001562","Total",604,192,17,175,164,54,179,34,145
"2011","Monmouthshire 003C","W01001563","Total",461,200,13,187,104,37,154,13,141
"2011","Monmouthshire 003D","W01001564","Total",999,432,35,397,265,101,312,49,263
"2011","Monmouthshire 003E","W01001569","Total",622,258,19,239,147,57,182,16,166
"2011","Monmouthshire 004A","W01001552","Total",635,235,6,229,168,38,161,24,137
"2011","Monmouthshire 004B","W01001553","Total",1113,348,46,302,409,145,300,73,227
"2011","Monmouthshire 004C","W01001554","Total",712,288,28,260,149,71,212,22,190
"2011","Monmouthshire 004D","W01001576","Total",490,153,14,139,144,55,123,26,97
"2011","Monmouthshire 004E","W01001577","Total",610,292,21,271,142,45,248,36,212
"2011","Monmouthshire 004F","W01001599","Total",960,386,21,365,222,79,307,34,273
"2011","Monmouthshire 005A","W01001566","Total",489,135,6,129,124,32,111,15,96
"2011","Monmouthshire 005B","W01001567","Total",433,161,7,154,91,23,134,12,122
"2011","Monmouthshire 005C","W01001568","Total",697,163,4,159,192,50,189,24,165
"2011","Monmouthshire 005D","W01001575","Total",500,143,3,140,130,46,124,21,103
"2011","Monmouthshire 005E","W01001581","Total",852,318,5,313,202,67,240,24,216
"2011","Monmouthshire 006A","W01001555","Total",484,166,8,158,139,28,137,23,114
"2011","Monmouthshire 006B","W01001556","Total",509,183,14,169,142,53,159,30,129
"2011","Monmouthshire 006C","W01001560","Total",514,128,9,119,142,34,131,29,102
"2011","Monmouthshire 006D","W01001565","Total",719,202,17,185,212,59,187,33,154
"2011","Monmouthshire 006E","W01001596","Total",495,263,12,251,94,36,187,20,167
"2011","Monmouthshire 006F","W01001597","Total",660,191,9,182,194,57,161,20,141
"2011","Monmouthshire 007A","W01001549","Total",598,177,6,171,162,45,126,15,111
"2011","Monmouthshire 007B","W01001583","Total",659,217,8,209,173,53,178,19,159
"2011","Monmouthshire 007C","W01001585","Total",509,171,5,166,163,67,125,17,108
"2011","Monmouthshire 007D","W01001586","Total",950,248,11,237,359,145,182,37,145
"2011","Monmouthshire 007E","W01001594","Total",537,148,5,143,155,48,137,21,116
"2011","Monmouthshire 007F","W01001595","Total",527,164,5,159,148,40,124,18,106
"2011","Monmouthshire 008A","W01001559","Total",559,220,12,208,149,54,172,21,151
"2011","Monmouthshire 008B","W01001584","Total",778,235,37,198,256,91,210,37,173
"2011","Monmouthshire 008C","W01001587","Total",964,375,33,342,200,88,295,31,264
"2011","Monmouthshire 008D","W01001592","Total",679,237,63,174,264,115,213,59,154
"2011","Monmouthshire 008E","W01001593","Total",729,200,28,172,228,81,175,34,141
"2011","Monmouthshire 009A","W01001542","Total",728,221,9,212,197,65,180,20,160
"2011","Monmouthshire 009B","W01001543","Total",553,155,8,147,191,54,127,25,102
"2011","Monmouthshire 009C","W01001578","Total",884,293,11,282,234,69,264,38,226
"2011","Monmouthshire 009D","W01001590","Total",868,282,6,276,251,68,196,22,174
"2011","Monmouthshire 010C","W01001551","Total",466,192,20,172,155,50,159,36,123
"2011","Monmouthshire 010D","W01001588","Total",731,285,12,273,177,53,230,25,205
"2011","Monmouthshire 010E","W01001589","Total",655,245,29,216,157,63,195,27,168
"2011","Monmouthshire 010F","W01001598","Total",672,254,43,211,217,95,204,38,166
"2011","Monmouthshire 010G","W01001908","Total",934,410,44,366,247,104,314,48,266
"2011","Monmouthshire 011A","W01001572","Total",618,203,11,192,228,68,181,37,144
"2011","Monmouthshire 011B","W01001573","Total",560,126,4,122,194,52,134,27,107
"2011","Monmouthshire 011C","W01001574","Total",617,146,9,137,198,62,145,31,114
"2011","Monmouthshire 011D","W01001582","Total",698,192,21,171,266,88,178,42,136
"2011","Monmouthshire 011E","W01001591","Total",582,105,6,99,239,81,100,23,77
"2011","Newport 001A","W01001623","Total",654,211,11,200,168,53,165,23,142
"2011","Newport 001B","W01001624","Total",501,108,9,99,184,54,105,31,74
"2011","Newport 001C","W01001625","Total",560,178,8,170,153,41,135,18,117
"2011","Newport 001D","W01001626","Total",577,231,19,212,159,40,191,40,151
"2011","Newport 001E","W01001627","Total",630,203,8,195,174,34,132,17,115
"2011","Newport 001F","W01001628","Total",511,243,26,217,134,43,195,23,172
"2011","Newport 002A","W01001651","Total",637,237,10,227,160,34,177,30,147
"2011","Newport 002B","W01001652","Total",791,408,99,309,256,114,284,63,221
"2011","Newport 002C","W01001653","Total",608,218,10,208,166,60,188,32,156
"2011","Newport 002D","W01001654","Total",676,213,22,191,213,78,183,26,157
"2011","Newport 002E","W01001655","Total",651,217,12,205,180,67,172,26,146
"2011","Newport 003A","W01001617","Total",582,295,71,224,191,85,209,41,168
"2011","Newport 003B","W01001618","Total",494,230,48,182,134,52,162,28,134
"2011","Newport 003C","W01001619","Total",599,267,52,215,202,90,189,30,159
"2011","Newport 003D","W01001620","Total",482,220,51,169,174,60,166,41,125
"2011","Newport 003E","W01001621","Total",614,301,55,246,177,73,232,39,193
"2011","Newport 003F","W01001622","Total",535,172,27,145,160,67,156,31,125
"2011","Newport 004A","W01001639","Total",719,151,15,136,286,91,151,39,112
"2011","Newport 004B","W01001640","Total",495,189,4,185,102,28,154,19,135
"2011","Newport 004C","W01001641","Total",537,177,6,171,136,22,135,19,116
"2011","Newport 004D","W01001649","Total",608,233,24,209,167,51,177,27,150
"2011","Newport 004E","W01001650","Total",615,184,32,152,192,83,179,40,139
"2011","Newport 005A","W01001614","Total",778,435,45,390,183,67,329,38,291
"2011","Newport 005B","W01001615","Total",604,234,37,197,225,90,180,36,144
"2011","Newport 005C","W01001616","Total",633,236,12,224,154,60,191,27,164
"2011","Newport 005D","W01001678","Total",700,258,46,212,208,78,226,44,182
"2011","Newport 006A","W01001601","Total",638,252,70,182,220,90,199,53,146
"2011","Newport 006B","W01001681","Total",660,296,54,242,171,89,208,27,181
"2011","Newport 006C","W01001682","Total",599,247,28,219,159,53,203,31,172
"2011","Newport 006D","W01001683","Total",485,145,21,124,151,57,115,19,96
"2011","Newport 006E","W01001684","Total",637,170,35,135,173,71,151,25,126
"2011","Newport 007A","W01001675","Total",619,186,24,162,211,79,167,38,129
"2011","Newport 007B","W01001676","Total",720,243,56,187,237,106,194,41,153
"2011","Newport 007C","W01001677","Total",653,225,16,209,187,87,165,19,146
"2011","Newport 007D","W01001679","Total",457,160,8,152,142,40,132,16,116
"2011","Newport 007E","W01001680","Total",506,162,32,130,169,68,125,30,95
"2011","Newport 008A","W01001606","Total",517,201,13,188,151,46,140,19,121
"2011","Newport 008B","W01001608","Total",638,240,24,216,203,64,174,40,134
"2011","Newport 008C","W01001663","Total",689,356,54,302,172,60,251,32,219
"2011","Newport 008D","W01001665","Total",743,343,36,307,179,74,251,35,216
"2011","Newport 009A","W01001669","Total",528,145,4,141,161,36,102,16,86
"2011","Newport 009B","W01001670","Total",862,195,21,174,377,144,152,42,110
"2011","Newport 009C","W01001672","Total",733,282,33,249,246,94,228,35,193
"2011","Newport 009D","W01001673","Total",644,251,8,243,141,45,171,22,149
"2011","Newport 009E","W01001674","Total",619,251,34,217,191,75,212,46,166
"2011","Newport 010A","W01001664","Total",647,352,63,289,183,89,265,52,213
"2011","Newport 010B","W01001666","Total",623,311,64,247,205,94,251,47,204
"2011","Newport 010C","W01001667","Total",521,234,78,156,206,89,175,63,112
"2011","Newport 010D","W01001668","Total",482,215,47,168,157,66,172,34,138
"2011","Newport 011A","W01001611","Total",531,173,32,141,195,98,152,35,117
"2011","Newport 011B","W01001612","Total",651,239,20,219,166,65,205,32,173
"2011","Newport 011C","W01001613","Total",616,180,18,162,218,86,150,38,112
"2011","Newport 011D","W01001691","Total",657,268,42,226,179,73,228,38,190
"2011","Newport 011E","W01001692","Total",834,302,70,232,259,129,219,50,169
"2011","Newport 012A","W01001600","Total",669,244,9,235,165,66,172,19,153
"2011","Newport 012B","W01001602","Total",676,266,4,262,164,64,176,15,161
"2011","Newport 012C","W01001603","Total",569,169,7,162,148,58,133,25,108
"2011","Newport 012D","W01001604","Total",620,240,8,232,176,57,172,30,142
"2011","Newport 013A","W01001642","Total",779,298,77,221,242,129,206,40,166
"2011","Newport 013B","W01001643","Total",566,202,90,112,264,130,158,53,105
"2011","Newport 013C","W01001644","Total",1136,262,95,167,404,223,200,64,136
"2011","Newport 013D","W01001690","Total",946,332,76,256,331,161,239,62,177
"2011","Newport 013E","W01001693","Total",647,212,29,183,189,91,172,42,130
"2011","Newport 014A","W01001605","Total",625,255,11,244,138,57,213,27,186
"2011","Newport 014B","W01001685","Total",773,285,41,244,184,94,219,27,192
"2011","Newport 014C","W01001686","Total",554,150,11,139,148,51,124,26,98
"2011","Newport 014D","W01001687","Total",879,334,26,308,148,78,235,27,208
"2011","Newport 015A","W01001607","Total",497,210,99,111,258,131,150,58,92
"2011","Newport 015B","W01001609","Total",567,247,106,141,266,116,212,73,139
"2011","Newport 015C","W01001610","Total",507,200,38,162,182,66,150,39,111
"2011","Newport 015D","W01001645","Total",513,176,44,132,215,82,125,33,92
"2011","Newport 015E","W01001646","Total",623,340,82,258,213,101,227,53,174
"2011","Newport 015F","W01001647","Total",633,250,13,237,151,44,186,32,154
"2011","Newport 015G","W01001648","Total",637,254,35,219,207,76,207,37,170
"2011","Newport 016A","W01001635","Total",596,202,7,195,187,55,156,18,138
"2011","Newport 016B","W01001637","Total",700,271,29,242,244,68,220,51,169
"2011","Newport 016C","W01001638","Total",468,159,6,153,159,42,119,18,101
"2011","Newport 016D","W01001671","Total",841,338,30,308,217,74,266,39,227
"2011","Newport 017A","W01001629","Total",634,267,9,258,123,43,214,29,185
"2011","Newport 017B","W01001630","Total",788,446,32,414,143,50,349,26,323
"2011","Newport 017C","W01001631","Total",617,175,16,159,178,69,166,29,137
"2011","Newport 017D","W01001632","Total",585,230,37,193,185,66,227,39,188
"2011","Newport 018A","W01001659","Total",782,415,89,326,248,111,278,52,226
"2011","Newport 018B","W01001660","Total",616,212,44,168,207,86,156,42,114
"2011","Newport 018C","W01001661","Total",945,336,82,254,277,156,241,64,177
"2011","Newport 018D","W01001662","Total",614,350,42,308,160,81,270,33,237
"2011","Newport 019A","W01001633","Total",609,251,81,170,250,118,196,46,150
"2011","Newport 019B","W01001634","Total",611,205,38,167,225,96,187,40,147
"2011","Newport 019C","W01001688","Total",1080,246,95,151,424,217,206,67,139
"2011","Newport 019D","W01001689","Total",777,466,106,360,267,107,351,66,285
"2011","Newport 020A","W01001636","Total",696,124,8,116,324,119,110,33,77
"2011","Newport 020C","W01001657","Total",547,109,6,103,225,76,106,34,72
"2011","Newport 020D","W01001658","Total",697,187,18,169,281,106,160,48,112
"2011","Newport 020E","W01001912","Total",648,201,11,190,165,73,152,25,127
"2011","Newport 020F","W01001913","Total",605,65,15,50,214,126,70,21,49
