"date","geography","geography code","Rural Urban","Family Type: All lone parent housholds with dependent children; measures: Value","Family Type: Lone parent in part-time employment: Total; measures: Value","Family Type: Lone parent in full-time employment: Total; measures: Value","Family Type: Lone parent not in employment: Total; measures: Value","Family Type: Male lone parent: Total; measures: Value","Family Type: Male lone parent: In part-time employment; measures: Value","Family Type: Male lone parent: In full-time employment; measures: Value","Family Type: Male lone parent: Not in employment; measures: Value","Family Type: Female lone parent: Total; measures: Value","Family Type: Female lone parent: In part-time employment; measures: Value","Family Type: Female lone parent: In full-time employment; measures: Value","Family Type: Female lone parent: Not in employment; measures: Value"
"2011","Darlington 001B","E01012334","Total",45,11,26,8,6,1,5,0,39,10,21,8
"2011","Darlington 001C","E01012335","Total",21,4,10,7,4,0,2,2,17,4,8,5
"2011","Darlington 001D","E01012366","Total",48,19,14,15,3,0,2,1,45,19,12,14
"2011","Darlington 001E","E01033481","Total",43,15,20,8,8,0,6,2,35,15,14,6
"2011","Darlington 001F","E01033482","Total",41,15,20,6,4,0,4,0,37,15,16,6
"2011","Darlington 002C","E01012323","Total",58,22,21,15,10,1,7,2,48,21,14,13
"2011","Darlington 002D","E01012324","Total",47,16,20,11,5,1,4,0,42,15,16,11
"2011","Darlington 002E","E01032545","Total",42,19,10,13,3,2,0,1,39,17,10,12
"2011","Darlington 002F","E01032546","Total",31,12,11,8,4,0,2,2,27,12,9,6
"2011","Darlington 003A","E01012328","Total",74,28,19,27,5,1,2,2,69,27,17,25
"2011","Darlington 003B","E01012329","Total",29,11,11,7,3,0,3,0,26,11,8,7
"2011","Darlington 003C","E01012330","Total",27,8,11,8,3,1,2,0,24,7,9,8
"2011","Darlington 003D","E01012331","Total",50,19,16,15,5,1,4,0,45,18,12,15
"2011","Darlington 004A","E01012349","Total",103,33,13,57,7,0,3,4,96,33,10,53
"2011","Darlington 004B","E01012350","Total",79,18,28,33,13,0,10,3,66,18,18,30
"2011","Darlington 004C","E01012351","Total",44,25,8,11,2,0,2,0,42,25,6,11
"2011","Darlington 004D","E01012352","Total",88,30,12,46,10,2,2,6,78,28,10,40
"2011","Darlington 005A","E01012325","Total",40,21,10,9,5,2,2,1,35,19,8,8
"2011","Darlington 005B","E01012326","Total",43,18,16,9,3,0,3,0,40,18,13,9
"2011","Darlington 005C","E01012332","Total",60,23,17,20,2,1,0,1,58,22,17,19
"2011","Darlington 005D","E01012333","Total",62,25,17,20,10,0,5,5,52,25,12,15
"2011","Darlington 006A","E01012309","Total",47,20,21,6,5,0,5,0,42,20,16,6
"2011","Darlington 006B","E01012310","Total",65,28,17,20,5,0,2,3,60,28,15,17
"2011","Darlington 006C","E01012311","Total",61,29,12,20,2,1,1,0,59,28,11,20
"2011","Darlington 006D","E01012312","Total",86,28,10,48,10,0,3,7,76,28,7,41
"2011","Darlington 006E","E01012313","Total",66,30,12,24,5,0,1,4,61,30,11,20
"2011","Darlington 006F","E01012314","Total",84,32,18,34,6,0,2,4,78,32,16,30
"2011","Darlington 007A","E01012362","Total",84,30,25,29,10,0,6,4,74,30,19,25
"2011","Darlington 007B","E01012363","Total",80,29,29,22,7,1,4,2,73,28,25,20
"2011","Darlington 007C","E01012364","Total",75,26,31,18,10,2,8,0,65,24,23,18
"2011","Darlington 007D","E01012365","Total",39,17,15,7,2,0,2,0,37,17,13,7
"2011","Darlington 008B","E01012353","Total",90,23,20,47,12,0,4,8,78,23,16,39
"2011","Darlington 008C","E01012354","Total",67,21,9,37,9,2,3,4,58,19,6,33
"2011","Darlington 008D","E01012355","Total",55,16,10,29,9,1,2,6,46,15,8,23
"2011","Darlington 008E","E01033483","Total",49,18,9,22,7,1,2,4,42,17,7,18
"2011","Darlington 008F","E01033484","Total",40,11,7,22,6,0,2,4,34,11,5,18
"2011","Darlington 009A","E01012307","Total",88,34,19,35,9,3,3,3,79,31,16,32
"2011","Darlington 009B","E01012327","Total",110,28,15,67,12,1,3,8,98,27,12,59
"2011","Darlington 009C","E01012342","Total",114,40,31,43,11,3,8,0,103,37,23,43
"2011","Darlington 009D","E01012343","Total",67,26,16,25,4,1,3,0,63,25,13,25
"2011","Darlington 010A","E01012315","Total",44,14,25,5,9,1,7,1,35,13,18,4
"2011","Darlington 010B","E01012316","Total",46,12,24,10,10,0,8,2,36,12,16,8
"2011","Darlington 010C","E01012360","Total",29,9,15,5,3,0,3,0,26,9,12,5
"2011","Darlington 011A","E01012336","Total",14,5,4,5,1,0,0,1,13,5,4,4
"2011","Darlington 011B","E01012337","Total",24,10,9,5,4,1,3,0,20,9,6,5
"2011","Darlington 011C","E01012347","Total",28,10,13,5,5,3,2,0,23,7,11,5
"2011","Darlington 011D","E01012348","Total",25,11,9,5,1,0,1,0,24,11,8,5
"2011","Darlington 011E","E01012361","Total",31,9,15,7,7,1,5,1,24,8,10,6
"2011","Darlington 012A","E01012304","Total",62,29,9,24,1,0,1,0,61,29,8,24
"2011","Darlington 012B","E01012305","Total",83,28,18,37,10,1,8,1,73,27,10,36
"2011","Darlington 012C","E01012306","Total",48,17,20,11,7,1,6,0,41,16,14,11
"2011","Darlington 012D","E01012340","Total",115,39,35,41,15,0,11,4,100,39,24,37
"2011","Darlington 012E","E01012341","Total",131,31,31,69,5,0,5,0,126,31,26,69
"2011","Darlington 013A","E01012317","Total",40,18,8,14,7,1,5,1,33,17,3,13
"2011","Darlington 013B","E01012318","Total",157,60,24,73,16,1,5,10,141,59,19,63
"2011","Darlington 013C","E01012319","Total",147,53,41,53,19,4,6,9,128,49,35,44
"2011","Darlington 014A","E01012356","Total",70,18,24,28,11,4,2,5,59,14,22,23
"2011","Darlington 014B","E01012357","Total",79,27,23,29,14,1,8,5,65,26,15,24
"2011","Darlington 014C","E01012358","Total",55,17,20,18,7,1,2,4,48,16,18,14
"2011","Darlington 014D","E01012359","Total",146,30,13,103,8,0,0,8,138,30,13,95
"2011","Darlington 015A","E01012338","Total",59,27,17,15,5,0,5,0,54,27,12,15
"2011","Darlington 015B","E01012339","Total",28,14,11,3,1,0,1,0,27,14,10,3
"2011","Darlington 015C","E01012344","Total",46,15,16,15,3,0,2,1,43,15,14,14
"2011","Darlington 015D","E01012345","Total",17,5,7,5,2,0,1,1,15,5,6,4
"2011","Darlington 015E","E01012346","Total",57,18,27,12,4,0,4,0,53,18,23,12
"2011","County Durham 002A","E01020613","Total",18,2,8,8,1,0,0,1,17,2,8,7
"2011","County Durham 002B","E01020614","Total",50,18,19,13,5,0,3,2,45,18,16,11
"2011","County Durham 002C","E01020622","Total",35,11,12,12,4,0,4,0,31,11,8,12
"2011","County Durham 002D","E01020623","Total",36,15,18,3,2,0,2,0,34,15,16,3
"2011","County Durham 005A","E01020606","Total",63,17,13,33,12,1,6,5,51,16,7,28
"2011","County Durham 005B","E01020615","Total",77,34,18,25,3,2,0,1,74,32,18,24
"2011","County Durham 005C","E01020616","Total",95,34,20,41,7,0,4,3,88,34,16,38
"2011","County Durham 005D","E01020617","Total",44,19,16,9,4,1,3,0,40,18,13,9
"2011","County Durham 007A","E01020596","Total",74,23,26,25,4,1,2,1,70,22,24,24
"2011","County Durham 007B","E01020597","Total",32,13,13,6,2,0,2,0,30,13,11,6
"2011","County Durham 007C","E01020598","Total",40,9,21,10,7,0,7,0,33,9,14,10
"2011","County Durham 007D","E01020611","Total",18,4,8,6,1,0,0,1,17,4,8,5
"2011","County Durham 007E","E01020612","Total",17,4,10,3,4,0,4,0,13,4,6,3
"2011","County Durham 011A","E01020592","Total",114,42,11,61,9,1,2,6,105,41,9,55
"2011","County Durham 011B","E01020593","Total",47,19,8,20,2,0,0,2,45,19,8,18
"2011","County Durham 011C","E01020599","Total",60,28,19,13,5,0,4,1,55,28,15,12
"2011","County Durham 011D","E01020601","Total",34,11,17,6,8,0,6,2,26,11,11,4
"2011","County Durham 011E","E01020602","Total",64,23,16,25,4,1,2,1,60,22,14,24
"2011","County Durham 011F","E01020618","Total",69,19,20,30,6,2,3,1,63,17,17,29
"2011","County Durham 013A","E01020594","Total",63,20,25,18,9,1,5,3,54,19,20,15
"2011","County Durham 013B","E01020595","Total",38,14,22,2,7,2,5,0,31,12,17,2
"2011","County Durham 013C","E01020600","Total",16,4,8,4,1,0,1,0,15,4,7,4
"2011","County Durham 013D","E01020603","Total",22,7,14,1,6,0,6,0,16,7,8,1
"2011","County Durham 013E","E01020605","Total",33,11,17,5,4,1,3,0,29,10,14,5
"2011","County Durham 015A","E01020590","Total",42,13,11,18,3,1,2,0,39,12,9,18
"2011","County Durham 015B","E01020591","Total",63,18,20,25,9,1,6,2,54,17,14,23
"2011","County Durham 015C","E01020608","Total",56,17,18,21,5,0,3,2,51,17,15,19
"2011","County Durham 015D","E01020609","Total",55,23,18,14,2,1,0,1,53,22,18,13
"2011","County Durham 015E","E01020610","Total",51,19,25,7,13,0,12,1,38,19,13,6
"2011","County Durham 019A","E01020604","Total",39,15,15,9,5,0,3,2,34,15,12,7
"2011","County Durham 019B","E01020607","Total",41,17,7,17,2,0,1,1,39,17,6,16
"2011","County Durham 019C","E01020619","Total",36,19,7,10,6,3,1,2,30,16,6,8
"2011","County Durham 019D","E01020620","Total",63,25,16,22,8,0,3,5,55,25,13,17
"2011","County Durham 019E","E01020621","Total",79,32,14,33,6,2,2,2,73,30,12,31
"2011","County Durham 001A","E01020634","Total",32,8,13,11,6,1,3,2,26,7,10,9
"2011","County Durham 001B","E01020635","Total",27,11,11,5,4,1,3,0,23,10,8,5
"2011","County Durham 001C","E01020636","Total",62,20,21,21,3,0,3,0,59,20,18,21
"2011","County Durham 001D","E01020654","Total",50,12,27,11,9,1,4,4,41,11,23,7
"2011","County Durham 001E","E01020676","Total",44,11,19,14,11,1,7,3,33,10,12,11
"2011","County Durham 003A","E01020627","Total",40,14,17,9,2,1,1,0,38,13,16,9
"2011","County Durham 003B","E01020628","Total",24,7,12,5,5,0,5,0,19,7,7,5
"2011","County Durham 003C","E01020629","Total",57,21,16,20,8,0,5,3,49,21,11,17
"2011","County Durham 003D","E01020655","Total",43,8,18,17,7,1,3,3,36,7,15,14
"2011","County Durham 003E","E01020656","Total",40,12,8,20,6,2,2,2,34,10,6,18
"2011","County Durham 003F","E01020657","Total",39,8,18,13,4,0,3,1,35,8,15,12
"2011","County Durham 004A","E01020661","Total",81,29,27,25,5,1,4,0,76,28,23,25
"2011","County Durham 004B","E01020662","Total",60,22,21,17,4,2,2,0,56,20,19,17
"2011","County Durham 004C","E01020663","Total",45,14,12,19,5,0,3,2,40,14,9,17
"2011","County Durham 004D","E01020674","Total",53,15,16,22,6,0,6,0,47,15,10,22
"2011","County Durham 004E","E01020678","Total",52,13,17,22,9,1,7,1,43,12,10,21
"2011","County Durham 006A","E01020626","Total",67,29,15,23,12,3,3,6,55,26,12,17
"2011","County Durham 006B","E01020638","Total",50,17,11,22,4,1,1,2,46,16,10,20
"2011","County Durham 006C","E01020639","Total",65,22,10,33,8,1,2,5,57,21,8,28
"2011","County Durham 006D","E01020653","Total",65,22,14,29,7,3,3,1,58,19,11,28
"2011","County Durham 006E","E01020677","Total",42,18,7,17,3,1,1,1,39,17,6,16
"2011","County Durham 008A","E01020647","Total",128,37,18,73,6,2,2,2,122,35,16,71
"2011","County Durham 008B","E01020648","Total",97,18,24,55,11,0,4,7,86,18,20,48
"2011","County Durham 008C","E01020649","Total",71,21,22,28,8,0,4,4,63,21,18,24
"2011","County Durham 008D","E01020673","Total",71,23,8,40,1,0,0,1,70,23,8,39
"2011","County Durham 008E","E01020675","Total",67,29,17,21,6,0,4,2,61,29,13,19
"2011","County Durham 009A","E01020624","Total",65,21,20,24,7,0,5,2,58,21,15,22
"2011","County Durham 009B","E01020625","Total",61,22,16,23,8,2,6,0,53,20,10,23
"2011","County Durham 009C","E01020670","Total",57,20,7,30,5,0,1,4,52,20,6,26
"2011","County Durham 009D","E01020671","Total",76,19,14,43,7,0,2,5,69,19,12,38
"2011","County Durham 009E","E01020672","Total",66,17,14,35,15,2,6,7,51,15,8,28
"2011","County Durham 010A","E01020632","Total",56,23,16,17,3,1,2,0,53,22,14,17
"2011","County Durham 010B","E01020640","Total",67,27,16,24,12,2,5,5,55,25,11,19
"2011","County Durham 010C","E01020641","Total",78,27,27,24,10,1,7,2,68,26,20,22
"2011","County Durham 010D","E01020642","Total",38,7,19,12,4,0,2,2,34,7,17,10
"2011","County Durham 010E","E01020643","Total",95,34,26,35,13,2,8,3,82,32,18,32
"2011","County Durham 010F","E01020667","Total",50,14,16,20,6,0,5,1,44,14,11,19
"2011","County Durham 012A","E01020650","Total",107,34,27,46,11,2,3,6,96,32,24,40
"2011","County Durham 012B","E01020651","Total",56,15,22,19,8,0,6,2,48,15,16,17
"2011","County Durham 012C","E01020652","Total",71,24,16,31,7,0,2,5,64,24,14,26
"2011","County Durham 012D","E01020668","Total",69,20,17,32,6,1,3,2,63,19,14,30
"2011","County Durham 012E","E01020669","Total",58,20,10,28,5,0,0,5,53,20,10,23
"2011","County Durham 014A","E01020630","Total",69,25,20,24,3,1,1,1,66,24,19,23
"2011","County Durham 014B","E01020631","Total",61,22,17,22,3,0,1,2,58,22,16,20
"2011","County Durham 014C","E01020637","Total",35,11,19,5,6,0,6,0,29,11,13,5
"2011","County Durham 014D","E01020644","Total",121,41,31,49,9,2,5,2,112,39,26,47
"2011","County Durham 014E","E01020645","Total",98,40,31,27,12,0,11,1,86,40,20,26
"2011","County Durham 020A","E01020633","Total",50,16,11,23,5,2,2,1,45,14,9,22
"2011","County Durham 020B","E01020664","Total",23,4,14,5,2,0,2,0,21,4,12,5
"2011","County Durham 020C","E01020665","Total",49,16,17,16,7,3,3,1,42,13,14,15
"2011","County Durham 020D","E01020666","Total",17,2,7,8,1,1,0,0,16,1,7,8
"2011","County Durham 024A","E01020646","Total",43,14,16,13,7,1,5,1,36,13,11,12
"2011","County Durham 024B","E01020658","Total",98,34,23,41,7,0,3,4,91,34,20,37
"2011","County Durham 024C","E01020659","Total",46,15,20,11,5,1,3,1,41,14,17,10
"2011","County Durham 024D","E01020660","Total",43,20,14,9,2,1,1,0,41,19,13,9
"2011","County Durham 022A","E01020709","Total",32,10,17,5,2,0,2,0,30,10,15,5
"2011","County Durham 022B","E01020717","Total",24,5,16,3,5,0,3,2,19,5,13,1
"2011","County Durham 022C","E01020718","Total",21,8,10,3,5,0,4,1,16,8,6,2
"2011","County Durham 022D","E01020719","Total",35,15,15,5,2,0,2,0,33,15,13,5
"2011","County Durham 022E","E01020721","Total",19,8,7,4,2,0,1,1,17,8,6,3
"2011","County Durham 023A","E01020708","Total",18,3,9,6,4,0,4,0,14,3,5,6
"2011","County Durham 023B","E01020710","Total",41,17,13,11,5,1,1,3,36,16,12,8
"2011","County Durham 023C","E01020711","Total",55,16,23,16,8,2,3,3,47,14,20,13
"2011","County Durham 023D","E01020720","Total",44,23,9,12,5,3,1,1,39,20,8,11
"2011","County Durham 026A","E01020679","Total",63,25,8,30,4,0,1,3,59,25,7,27
"2011","County Durham 026B","E01020680","Total",24,8,11,5,4,0,4,0,20,8,7,5
"2011","County Durham 026C","E01020681","Total",65,20,26,19,7,1,5,1,58,19,21,18
"2011","County Durham 026D","E01020714","Total",34,14,12,8,5,0,2,3,29,14,10,5
"2011","County Durham 026E","E01020716","Total",103,33,14,56,9,4,4,1,94,29,10,55
"2011","County Durham 027A","E01020725","Total",41,11,22,8,6,2,4,0,35,9,18,8
"2011","County Durham 027B","E01020726","Total",35,12,15,8,5,1,4,0,30,11,11,8
"2011","County Durham 027C","E01020727","Total",40,10,8,22,5,1,0,4,35,9,8,18
"2011","County Durham 027D","E01020729","Total",91,30,24,37,6,1,4,1,85,29,20,36
"2011","County Durham 027E","E01020730","Total",58,28,17,13,5,0,4,1,53,28,13,12
"2011","County Durham 027F","E01020731","Total",41,13,21,7,4,0,4,0,37,13,17,7
"2011","County Durham 028A","E01020682","Total",29,5,14,10,3,0,3,0,26,5,11,10
"2011","County Durham 028B","E01020683","Total",32,11,15,6,3,0,3,0,29,11,12,6
"2011","County Durham 028C","E01020690","Total",34,13,14,7,2,0,2,0,32,13,12,7
"2011","County Durham 028D","E01020691","Total",44,19,15,10,2,0,2,0,42,19,13,10
"2011","County Durham 028E","E01020692","Total",14,2,6,6,3,0,2,1,11,2,4,5
"2011","County Durham 029A","E01020693","Total",35,8,10,17,6,0,3,3,29,8,7,14
"2011","County Durham 029B","E01020722","Total",70,22,9,39,9,3,3,3,61,19,6,36
"2011","County Durham 029C","E01020723","Total",36,11,8,17,1,0,1,0,35,11,7,17
"2011","County Durham 029D","E01020724","Total",110,41,7,62,10,0,2,8,100,41,5,54
"2011","County Durham 030A","E01020703","Total",8,0,4,4,2,0,2,0,6,0,2,4
"2011","County Durham 030D","E01033164","Total",4,0,3,1,2,0,2,0,2,0,1,1
"2011","County Durham 030E","E01033195","Total",3,0,2,1,1,0,1,0,2,0,1,1
"2011","County Durham 030F","E01033197","Total",4,1,1,2,1,0,0,1,3,1,1,1
"2011","County Durham 030G","E01033221","Total",3,0,2,1,0,0,0,0,3,0,2,1
"2011","County Durham 033A","E01020684","Total",82,27,37,18,19,6,11,2,63,21,26,16
"2011","County Durham 033B","E01020702","Total",15,6,7,2,0,0,0,0,15,6,7,2
"2011","County Durham 033C","E01020704","Total",8,3,2,3,0,0,0,0,8,3,2,3
"2011","County Durham 033D","E01020712","Total",13,4,8,1,3,0,3,0,10,4,5,1
"2011","County Durham 033E","E01020713","Total",19,5,12,2,2,0,2,0,17,5,10,2
"2011","County Durham 031A","E01020705","Total",58,17,20,21,3,0,3,0,55,17,17,21
"2011","County Durham 031B","E01020706","Total",41,17,11,13,3,0,2,1,38,17,9,12
"2011","County Durham 031C","E01020715","Total",83,26,17,40,8,1,4,3,75,25,13,37
"2011","County Durham 038A","E01020685","Total",35,13,12,10,3,1,1,1,32,12,11,9
"2011","County Durham 038B","E01020686","Total",71,22,26,23,11,2,7,2,60,20,19,21
"2011","County Durham 038C","E01020687","Total",35,13,13,9,4,0,4,0,31,13,9,9
"2011","County Durham 038D","E01020688","Total",66,28,15,23,5,1,2,2,61,27,13,21
"2011","County Durham 038E","E01020689","Total",70,16,16,38,8,1,4,3,62,15,12,35
"2011","County Durham 041A","E01020694","Total",57,16,15,26,5,2,3,0,52,14,12,26
"2011","County Durham 041B","E01020696","Total",21,6,3,12,1,0,1,0,20,6,2,12
"2011","County Durham 041C","E01020697","Total",38,13,9,16,0,0,0,0,38,13,9,16
"2011","County Durham 041D","E01020732","Total",27,6,10,11,3,0,2,1,24,6,8,10
"2011","County Durham 044A","E01020695","Total",59,20,22,17,8,1,4,3,51,19,18,14
"2011","County Durham 044B","E01020698","Total",29,10,14,5,4,0,4,0,25,10,10,5
"2011","County Durham 044C","E01020699","Total",62,19,18,25,5,0,5,0,57,19,13,25
"2011","County Durham 044D","E01020700","Total",47,14,12,21,3,1,2,0,44,13,10,21
"2011","County Durham 044E","E01020701","Total",27,5,13,9,5,0,4,1,22,5,9,8
"2011","County Durham 016A","E01020750","Total",23,6,11,6,3,0,3,0,20,6,8,6
"2011","County Durham 016B","E01020781","Total",23,8,7,8,3,0,2,1,20,8,5,7
"2011","County Durham 016D","E01020786","Total",25,11,11,3,7,1,6,0,18,10,5,3
"2011","County Durham 016E","E01020787","Total",78,37,15,26,8,4,4,0,70,33,11,26
"2011","County Durham 016F","E01033163","Total",39,14,16,9,5,0,4,1,34,14,12,8
"2011","County Durham 016G","E01033202","Total",52,14,20,18,11,3,5,3,41,11,15,15
"2011","County Durham 017A","E01020740","Total",40,21,5,14,3,1,2,0,37,20,3,14
"2011","County Durham 017B","E01020741","Total",55,18,10,27,5,1,4,0,50,17,6,27
"2011","County Durham 017C","E01020742","Total",87,26,20,41,6,1,2,3,81,25,18,38
"2011","County Durham 017D","E01020782","Total",33,5,20,8,5,0,4,1,28,5,16,7
"2011","County Durham 017E","E01020783","Total",43,10,14,19,2,0,2,0,41,10,12,19
"2011","County Durham 017F","E01020784","Total",49,13,16,20,7,1,3,3,42,12,13,17
"2011","County Durham 018A","E01020743","Total",89,32,6,51,5,0,1,4,84,32,5,47
"2011","County Durham 018B","E01020747","Total",98,26,12,60,9,3,2,4,89,23,10,56
"2011","County Durham 018C","E01020748","Total",59,19,15,25,5,2,1,2,54,17,14,23
"2011","County Durham 018D","E01020749","Total",38,8,14,16,3,1,2,0,35,7,12,16
"2011","County Durham 018E","E01020773","Total",54,14,17,23,5,0,3,2,49,14,14,21
"2011","County Durham 018F","E01020775","Total",102,30,15,57,7,1,2,4,95,29,13,53
"2011","County Durham 021C","E01020776","Total",36,12,15,9,1,0,0,1,35,12,15,8
"2011","County Durham 021D","E01033161","Total",52,16,18,18,12,1,5,6,40,15,13,12
"2011","County Durham 021E","E01033198","Total",67,17,15,35,10,4,3,3,57,13,12,32
"2011","County Durham 021F","E01033205","Total",43,9,12,22,3,0,2,1,40,9,10,21
"2011","County Durham 021G","E01033206","Total",71,25,19,27,6,1,3,2,65,24,16,25
"2011","County Durham 025A","E01020751","Total",92,26,22,44,10,2,2,6,82,24,20,38
"2011","County Durham 025B","E01020752","Total",104,31,14,59,16,5,2,9,88,26,12,50
"2011","County Durham 025C","E01020754","Total",28,8,7,13,1,0,0,1,27,8,7,12
"2011","County Durham 025D","E01020756","Total",29,4,18,7,7,0,7,0,22,4,11,7
"2011","County Durham 032A","E01020745","Total",65,20,11,34,6,2,1,3,59,18,10,31
"2011","County Durham 032B","E01020753","Total",73,17,21,35,7,0,4,3,66,17,17,32
"2011","County Durham 032C","E01020757","Total",58,14,9,35,7,0,2,5,51,14,7,30
"2011","County Durham 032D","E01020758","Total",110,31,17,62,19,5,6,8,91,26,11,54
"2011","County Durham 032E","E01020759","Total",76,21,6,49,8,0,3,5,68,21,3,44
"2011","County Durham 032F","E01020765","Total",89,21,20,48,13,2,5,6,76,19,15,42
"2011","County Durham 034A","E01020760","Total",37,11,10,16,8,1,2,5,29,10,8,11
"2011","County Durham 034B","E01020761","Total",45,11,11,23,2,0,2,0,43,11,9,23
"2011","County Durham 034C","E01020762","Total",83,26,13,44,5,1,2,2,78,25,11,42
"2011","County Durham 034D","E01020763","Total",58,14,18,26,6,1,2,3,52,13,16,23
"2011","County Durham 036A","E01020764","Total",85,18,14,53,8,2,2,4,77,16,12,49
"2011","County Durham 036B","E01020766","Total",32,12,8,12,6,0,3,3,26,12,5,9
"2011","County Durham 036C","E01020767","Total",104,20,23,61,12,0,8,4,92,20,15,57
"2011","County Durham 036D","E01020768","Total",73,22,20,31,10,1,6,3,63,21,14,28
"2011","County Durham 035A","E01020733","Total",67,18,17,32,3,0,1,2,64,18,16,30
"2011","County Durham 035B","E01020734","Total",87,31,27,29,9,3,3,3,78,28,24,26
"2011","County Durham 035C","E01020735","Total",36,10,17,9,2,0,1,1,34,10,16,8
"2011","County Durham 035D","E01020770","Total",57,24,15,18,7,1,5,1,50,23,10,17
"2011","County Durham 035E","E01020771","Total",43,15,7,21,7,3,2,2,36,12,5,19
"2011","County Durham 035F","E01020780","Total",57,23,13,21,6,0,4,2,51,23,9,19
"2011","County Durham 037A","E01020746","Total",22,7,7,8,3,0,0,3,19,7,7,5
"2011","County Durham 037B","E01020769","Total",47,18,12,17,4,1,0,3,43,17,12,14
"2011","County Durham 037C","E01020777","Total",74,28,22,24,3,1,1,1,71,27,21,23
"2011","County Durham 037D","E01020778","Total",21,6,8,7,1,0,1,0,20,6,7,7
"2011","County Durham 037E","E01020779","Total",24,9,9,6,2,0,1,1,22,9,8,5
"2011","County Durham 039A","E01020736","Total",35,9,6,20,4,1,1,2,31,8,5,18
"2011","County Durham 039B","E01020737","Total",47,19,17,11,2,0,1,1,45,19,16,10
"2011","County Durham 039C","E01020738","Total",20,8,3,9,2,0,1,1,18,8,2,8
"2011","County Durham 039D","E01020739","Total",59,16,12,31,3,0,1,2,56,16,11,29
"2011","County Durham 039E","E01020744","Total",29,15,8,6,8,1,5,2,21,14,3,4
"2011","County Durham 040A","E01020788","Total",58,11,12,35,9,0,5,4,49,11,7,31
"2011","County Durham 040B","E01020789","Total",50,18,8,24,6,2,3,1,44,16,5,23
"2011","County Durham 040C","E01020790","Total",76,18,16,42,15,2,4,9,61,16,12,33
"2011","County Durham 040D","E01020791","Total",42,20,4,18,6,2,1,3,36,18,3,15
"2011","County Durham 040E","E01020792","Total",37,11,4,22,3,0,0,3,34,11,4,19
"2011","County Durham 043A","E01020772","Total",36,18,8,10,2,0,1,1,34,18,7,9
"2011","County Durham 043B","E01020793","Total",74,26,16,32,8,1,3,4,66,25,13,28
"2011","County Durham 043C","E01020794","Total",49,14,24,11,7,1,5,1,42,13,19,10
"2011","County Durham 043D","E01020795","Total",77,19,14,44,8,2,5,1,69,17,9,43
"2011","County Durham 047A","E01020817","Total",20,7,10,3,6,0,5,1,14,7,5,2
"2011","County Durham 047B","E01020818","Total",42,13,12,17,8,3,3,2,34,10,9,15
"2011","County Durham 047C","E01020819","Total",50,22,5,23,4,0,0,4,46,22,5,19
"2011","County Durham 047D","E01020837","Total",30,11,14,5,1,0,1,0,29,11,13,5
"2011","County Durham 047E","E01020843","Total",32,12,13,7,3,0,2,1,29,12,11,6
"2011","County Durham 048A","E01020809","Total",69,19,14,36,7,1,2,4,62,18,12,32
"2011","County Durham 048B","E01020810","Total",41,15,11,15,8,2,5,1,33,13,6,14
"2011","County Durham 048C","E01020811","Total",60,19,11,30,4,1,1,2,56,18,10,28
"2011","County Durham 048D","E01020812","Total",43,18,13,12,8,1,6,1,35,17,7,11
"2011","County Durham 048E","E01020827","Total",60,17,21,22,13,1,7,5,47,16,14,17
"2011","County Durham 049A","E01020806","Total",48,20,11,17,5,2,2,1,43,18,9,16
"2011","County Durham 049B","E01020807","Total",68,17,10,41,9,0,5,4,59,17,5,37
"2011","County Durham 049C","E01020820","Total",58,19,10,29,5,1,0,4,53,18,10,25
"2011","County Durham 049D","E01020842","Total",91,29,12,50,6,0,2,4,85,29,10,46
"2011","County Durham 050A","E01020797","Total",96,34,20,42,9,1,5,3,87,33,15,39
"2011","County Durham 050B","E01020798","Total",50,20,13,17,5,0,5,0,45,20,8,17
"2011","County Durham 050C","E01020799","Total",49,18,14,17,6,1,4,1,43,17,10,16
"2011","County Durham 050D","E01020808","Total",26,8,8,10,5,0,5,0,21,8,3,10
"2011","County Durham 052A","E01020821","Total",44,20,11,13,1,0,0,1,43,20,11,12
"2011","County Durham 052B","E01020822","Total",27,9,12,6,3,1,2,0,24,8,10,6
"2011","County Durham 052C","E01020823","Total",76,18,24,34,13,1,7,5,63,17,17,29
"2011","County Durham 052D","E01020835","Total",60,18,20,22,4,1,2,1,56,17,18,21
"2011","County Durham 052E","E01020836","Total",76,21,21,34,14,1,6,7,62,20,15,27
"2011","County Durham 053B","E01020803","Total",48,9,13,26,5,0,2,3,43,9,11,23
"2011","County Durham 053D","E01020805","Total",91,31,21,39,6,1,1,4,85,30,20,35
"2011","County Durham 053E","E01033203","Total",112,26,36,50,10,1,6,3,102,25,30,47
"2011","County Durham 054A","E01020796","Total",23,8,9,6,0,0,0,0,23,8,9,6
"2011","County Durham 054B","E01020828","Total",22,8,12,2,2,0,2,0,20,8,10,2
"2011","County Durham 054C","E01020829","Total",48,12,26,10,4,0,4,0,44,12,22,10
"2011","County Durham 054D","E01020830","Total",39,18,10,11,3,0,3,0,36,18,7,11
"2011","County Durham 059A","E01020801","Total",61,18,17,26,5,0,3,2,56,18,14,24
"2011","County Durham 059B","E01020802","Total",71,28,13,30,5,0,2,3,66,28,11,27
"2011","County Durham 059C","E01020838","Total",60,13,15,32,9,1,4,4,51,12,11,28
"2011","County Durham 059D","E01020839","Total",69,17,14,38,5,1,1,3,64,16,13,35
"2011","County Durham 059E","E01020840","Total",75,25,11,39,4,1,2,1,71,24,9,38
"2011","County Durham 059F","E01020841","Total",117,41,11,65,9,2,2,5,108,39,9,60
"2011","County Durham 060A","E01020813","Total",19,6,9,4,1,0,1,0,18,6,8,4
"2011","County Durham 060B","E01020814","Total",40,16,14,10,5,3,2,0,35,13,12,10
"2011","County Durham 060C","E01020815","Total",38,9,13,16,8,3,3,2,30,6,10,14
"2011","County Durham 060D","E01020848","Total",37,19,11,7,4,0,4,0,33,19,7,7
"2011","County Durham 060E","E01020850","Total",49,12,20,17,5,1,2,2,44,11,18,15
"2011","County Durham 060F","E01020851","Total",25,8,11,6,4,1,2,1,21,7,9,5
"2011","County Durham 061A","E01020816","Total",100,31,20,49,12,1,5,6,88,30,15,43
"2011","County Durham 061B","E01020844","Total",95,27,22,46,8,0,3,5,87,27,19,41
"2011","County Durham 061C","E01020847","Total",121,38,21,62,11,1,5,5,110,37,16,57
"2011","County Durham 061D","E01020849","Total",76,25,16,35,10,0,6,4,66,25,10,31
"2011","County Durham 062A","E01020825","Total",44,16,11,17,9,1,5,3,35,15,6,14
"2011","County Durham 062B","E01020831","Total",72,23,16,33,5,2,2,1,67,21,14,32
"2011","County Durham 062C","E01020833","Total",44,15,17,12,3,0,3,0,41,15,14,12
"2011","County Durham 062D","E01020834","Total",78,29,22,27,6,1,3,2,72,28,19,25
"2011","County Durham 063A","E01020824","Total",53,27,12,14,5,1,3,1,48,26,9,13
"2011","County Durham 063B","E01020826","Total",47,12,15,20,3,0,1,2,44,12,14,18
"2011","County Durham 063C","E01020832","Total",32,7,13,12,6,0,4,2,26,7,9,10
"2011","County Durham 063D","E01020845","Total",64,15,21,28,2,0,1,1,62,15,20,27
"2011","County Durham 063E","E01020846","Total",30,7,7,16,2,0,0,2,28,7,7,14
"2011","County Durham 064A","E01020856","Total",47,16,17,14,11,2,7,2,36,14,10,12
"2011","County Durham 064B","E01020858","Total",25,10,7,8,1,0,1,0,24,10,6,8
"2011","County Durham 064C","E01020859","Total",24,5,9,10,2,0,1,1,22,5,8,9
"2011","County Durham 064D","E01020860","Total",54,18,18,18,2,0,2,0,52,18,16,18
"2011","County Durham 064E","E01020861","Total",28,5,14,9,3,0,3,0,25,5,11,9
"2011","County Durham 064F","E01020862","Total",52,20,21,11,6,1,4,1,46,19,17,10
"2011","County Durham 064G","E01020864","Total",21,8,8,5,2,1,1,0,19,7,7,5
"2011","County Durham 064H","E01020867","Total",66,28,23,15,5,1,3,1,61,27,20,14
"2011","County Durham 065A","E01020857","Total",40,13,14,13,5,0,4,1,35,13,10,12
"2011","County Durham 065B","E01020863","Total",14,6,5,3,6,2,3,1,8,4,2,2
"2011","County Durham 065C","E01020865","Total",15,8,2,5,0,0,0,0,15,8,2,5
"2011","County Durham 065D","E01020866","Total",17,11,3,3,2,1,1,0,15,10,2,3
"2011","County Durham 066A","E01020852","Total",39,18,10,11,2,0,1,1,37,18,9,10
"2011","County Durham 066B","E01020853","Total",36,18,10,8,4,1,1,2,32,17,9,6
"2011","County Durham 066C","E01020854","Total",58,20,20,18,4,0,1,3,54,20,19,15
"2011","County Durham 066D","E01020855","Total",31,12,11,8,4,0,4,0,27,12,7,8
"2011","County Durham 042A","E01020889","Total",16,3,9,4,4,1,2,1,12,2,7,3
"2011","County Durham 042B","E01020890","Total",38,12,14,12,2,0,2,0,36,12,12,12
"2011","County Durham 042C","E01020891","Total",36,15,10,11,7,0,5,2,29,15,5,9
"2011","County Durham 042D","E01020905","Total",49,17,20,12,6,1,5,0,43,16,15,12
"2011","County Durham 042E","E01020906","Total",29,13,12,4,3,1,2,0,26,12,10,4
"2011","County Durham 045A","E01020876","Total",59,24,13,22,5,1,2,2,54,23,11,20
"2011","County Durham 045B","E01020878","Total",85,30,13,42,7,0,3,4,78,30,10,38
"2011","County Durham 045C","E01020887","Total",56,13,26,17,8,1,5,2,48,12,21,15
"2011","County Durham 045D","E01020892","Total",35,13,5,17,4,0,1,3,31,13,4,14
"2011","County Durham 045E","E01020894","Total",47,25,7,15,5,2,1,2,42,23,6,13
"2011","County Durham 045F","E01020898","Total",88,15,17,56,5,1,1,3,83,14,16,53
"2011","County Durham 046A","E01020877","Total",62,19,17,26,13,2,6,5,49,17,11,21
"2011","County Durham 046B","E01020879","Total",61,20,34,7,6,0,4,2,55,20,30,5
"2011","County Durham 046C","E01020893","Total",59,20,13,26,11,4,4,3,48,16,9,23
"2011","County Durham 046D","E01020899","Total",33,16,11,6,7,1,6,0,26,15,5,6
"2011","County Durham 046E","E01020903","Total",28,11,9,8,1,0,1,0,27,11,8,8
"2011","County Durham 046F","E01020904","Total",48,16,15,17,7,1,3,3,41,15,12,14
"2011","County Durham 051A","E01020873","Total",93,32,15,46,9,1,1,7,84,31,14,39
"2011","County Durham 051B","E01020875","Total",40,14,7,19,5,1,2,2,35,13,5,17
"2011","County Durham 051C","E01020900","Total",41,9,13,19,3,0,1,2,38,9,12,17
"2011","County Durham 051D","E01020901","Total",56,16,10,30,7,0,3,4,49,16,7,26
"2011","County Durham 051E","E01020902","Total",85,24,10,51,11,2,1,8,74,22,9,43
"2011","County Durham 055A","E01020868","Total",43,13,15,15,3,1,2,0,40,12,13,15
"2011","County Durham 055B","E01020869","Total",49,18,10,21,4,1,1,2,45,17,9,19
"2011","County Durham 055C","E01020874","Total",57,18,10,29,5,0,1,4,52,18,9,25
"2011","County Durham 055D","E01020880","Total",77,26,12,39,9,2,2,5,68,24,10,34
"2011","County Durham 055E","E01020881","Total",37,10,8,19,2,0,1,1,35,10,7,18
"2011","County Durham 056A","E01020870","Total",13,4,7,2,1,0,1,0,12,4,6,2
"2011","County Durham 056B","E01020871","Total",67,27,14,26,2,0,1,1,65,27,13,25
"2011","County Durham 056C","E01020872","Total",55,20,19,16,7,0,6,1,48,20,13,15
"2011","County Durham 056D","E01020883","Total",29,8,15,6,2,0,2,0,27,8,13,6
"2011","County Durham 056E","E01020886","Total",61,28,12,21,1,1,0,0,60,27,12,21
"2011","County Durham 057A","E01020882","Total",43,15,14,14,7,1,5,1,36,14,9,13
"2011","County Durham 057B","E01020888","Total",49,13,18,18,5,2,3,0,44,11,15,18
"2011","County Durham 057C","E01020895","Total",79,21,19,39,9,3,3,3,70,18,16,36
"2011","County Durham 057D","E01020896","Total",41,13,9,19,4,0,3,1,37,13,6,18
"2011","County Durham 057E","E01020897","Total",138,50,38,50,12,3,3,6,126,47,35,44
"2011","County Durham 058A","E01020884","Total",47,16,9,22,4,0,2,2,43,16,7,20
"2011","County Durham 058B","E01020885","Total",43,8,13,22,9,1,6,2,34,7,7,20
"2011","County Durham 058C","E01020907","Total",88,29,13,46,5,0,2,3,83,29,11,43
"2011","County Durham 058D","E01020908","Total",72,17,14,41,8,1,1,6,64,16,13,35
"2011","County Durham 058E","E01020909","Total",148,33,9,106,18,3,1,14,130,30,8,92
"2011","Hartlepool 001A","E01011954","Total",122,50,20,52,4,0,4,0,118,50,16,52
"2011","Hartlepool 001B","E01011969","Total",24,11,5,8,3,2,1,0,21,9,4,8
"2011","Hartlepool 001C","E01011970","Total",25,13,10,2,2,1,1,0,23,12,9,2
"2011","Hartlepool 001D","E01011971","Total",32,9,17,6,2,0,2,0,30,9,15,6
"2011","Hartlepool 001F","E01033465","Total",52,16,22,14,4,0,4,0,48,16,18,14
"2011","Hartlepool 001G","E01033467","Total",55,24,16,15,5,0,4,1,50,24,12,14
"2011","Hartlepool 002A","E01011952","Total",83,31,10,42,5,1,1,3,78,30,9,39
"2011","Hartlepool 002B","E01011953","Total",121,34,8,79,12,2,2,8,109,32,6,71
"2011","Hartlepool 002C","E01011991","Total",57,20,10,27,10,0,1,9,47,20,9,18
"2011","Hartlepool 002D","E01011992","Total",94,27,11,56,6,1,0,5,88,26,11,51
"2011","Hartlepool 002E","E01011993","Total",101,46,13,42,12,6,1,5,89,40,12,37
"2011","Hartlepool 002F","E01011994","Total",83,21,12,50,4,0,2,2,79,21,10,48
"2011","Hartlepool 003A","E01011955","Total",74,21,6,47,4,0,0,4,70,21,6,43
"2011","Hartlepool 003C","E01011957","Total",55,14,5,36,10,0,3,7,45,14,2,29
"2011","Hartlepool 003G","E01032540","Total",42,11,12,19,5,1,2,2,37,10,10,17
"2011","Hartlepool 003H","E01032541","Total",88,35,20,33,10,2,5,3,78,33,15,30
"2011","Hartlepool 003I","E01033466","Total",131,36,16,79,13,4,1,8,118,32,15,71
"2011","Hartlepool 005A","E01011973","Total",111,19,10,82,8,1,1,6,103,18,9,76
"2011","Hartlepool 005B","E01011974","Total",66,22,10,34,13,0,8,5,53,22,2,29
"2011","Hartlepool 005C","E01011975","Total",73,20,16,37,6,0,1,5,67,20,15,32
"2011","Hartlepool 005D","E01011976","Total",57,17,11,29,8,0,3,5,49,17,8,24
"2011","Hartlepool 006A","E01011965","Total",33,9,19,5,2,0,2,0,31,9,17,5
"2011","Hartlepool 006B","E01011966","Total",35,10,11,14,5,1,4,0,30,9,7,14
"2011","Hartlepool 006C","E01011983","Total",21,9,9,3,2,0,2,0,19,9,7,3
"2011","Hartlepool 006D","E01012002","Total",52,16,21,15,5,0,3,2,47,16,18,13
"2011","Hartlepool 007A","E01011951","Total",113,40,15,58,6,0,2,4,107,40,13,54
"2011","Hartlepool 007B","E01011964","Total",33,11,9,13,7,1,3,3,26,10,6,10
"2011","Hartlepool 007C","E01011967","Total",51,21,16,14,5,1,2,2,46,20,14,12
"2011","Hartlepool 007D","E01011999","Total",119,27,15,77,14,4,1,9,105,23,14,68
"2011","Hartlepool 007E","E01012000","Total",73,18,14,41,7,0,5,2,66,18,9,39
"2011","Hartlepool 008A","E01011950","Total",100,35,10,55,10,6,1,3,90,29,9,52
"2011","Hartlepool 008B","E01011986","Total",46,21,12,13,9,1,4,4,37,20,8,9
"2011","Hartlepool 008C","E01011987","Total",72,30,12,30,11,3,2,6,61,27,10,24
"2011","Hartlepool 008D","E01012001","Total",112,43,9,60,2,0,2,0,110,43,7,60
"2011","Hartlepool 009A","E01011949","Total",103,45,15,43,11,3,4,4,92,42,11,39
"2011","Hartlepool 009B","E01011980","Total",71,29,10,32,8,0,2,6,63,29,8,26
"2011","Hartlepool 009C","E01011981","Total",103,41,20,42,7,3,2,2,96,38,18,40
"2011","Hartlepool 009D","E01011984","Total",23,12,6,5,3,0,3,0,20,12,3,5
"2011","Hartlepool 010A","E01011985","Total",24,6,3,15,0,0,0,0,24,6,3,15
"2011","Hartlepool 010B","E01011988","Total",75,33,22,20,3,1,1,1,72,32,21,19
"2011","Hartlepool 010C","E01011989","Total",114,38,16,60,16,1,3,12,98,37,13,48
"2011","Hartlepool 010D","E01011990","Total",58,19,17,22,0,0,0,0,58,19,17,22
"2011","Hartlepool 011A","E01011995","Total",25,11,9,5,4,0,3,1,21,11,6,4
"2011","Hartlepool 011B","E01011996","Total",45,15,18,12,6,0,6,0,39,15,12,12
"2011","Hartlepool 011C","E01011997","Total",61,27,16,18,1,1,0,0,60,26,16,18
"2011","Hartlepool 011D","E01011998","Total",30,13,6,11,0,0,0,0,30,13,6,11
"2011","Hartlepool 012A","E01011961","Total",78,25,14,39,8,1,2,5,70,24,12,34
"2011","Hartlepool 012B","E01011962","Total",79,26,15,38,2,0,0,2,77,26,15,36
"2011","Hartlepool 012C","E01011977","Total",142,56,9,77,8,2,2,4,134,54,7,73
"2011","Hartlepool 012D","E01011978","Total",135,35,16,84,10,1,0,9,125,34,16,75
"2011","Hartlepool 012E","E01011979","Total",111,33,11,67,6,0,2,4,105,33,9,63
"2011","Hartlepool 014A","E01011959","Total",35,13,14,8,6,0,6,0,29,13,8,8
"2011","Hartlepool 014B","E01011960","Total",17,6,8,3,3,0,2,1,14,6,6,2
"2011","Hartlepool 014C","E01011963","Total",26,12,10,4,3,1,1,1,23,11,9,3
"2011","Hartlepool 014D","E01011968","Total",66,28,15,23,11,2,3,6,55,26,12,17
"2011","Hartlepool 014E","E01011982","Total",15,4,8,3,3,0,3,0,12,4,5,3
"2011","Hartlepool 014F","E01012003","Total",33,17,10,6,1,0,1,0,32,17,9,6
"2011","Hartlepool 014G","E01012005","Total",38,13,20,5,8,1,6,1,30,12,14,4
"2011","Middlesbrough 001A","E01012068","Total",65,10,7,48,5,1,0,4,60,9,7,44
"2011","Middlesbrough 001D","E01012092","Total",57,13,4,40,5,1,2,2,52,12,2,38
"2011","Middlesbrough 001E","E01012093","Total",70,14,7,49,12,1,2,9,58,13,5,40
"2011","Middlesbrough 001F","E01012094","Total",79,23,5,51,10,0,1,9,69,23,4,42
"2011","Middlesbrough 001G","E01033468","Total",73,20,5,48,7,2,1,4,66,18,4,44
"2011","Middlesbrough 002A","E01012058","Total",113,29,10,74,12,3,2,7,101,26,8,67
"2011","Middlesbrough 002B","E01012059","Total",94,21,13,60,4,2,2,0,90,19,11,60
"2011","Middlesbrough 002C","E01012060","Total",137,42,9,86,7,1,3,3,130,41,6,83
"2011","Middlesbrough 002D","E01012061","Total",103,34,11,58,3,0,1,2,100,34,10,56
"2011","Middlesbrough 003A","E01012036","Total",59,11,5,43,10,1,1,8,49,10,4,35
"2011","Middlesbrough 003B","E01012037","Total",103,23,10,70,6,0,4,2,97,23,6,68
"2011","Middlesbrough 003C","E01012038","Total",89,24,9,56,7,1,1,5,82,23,8,51
"2011","Middlesbrough 003D","E01012039","Total",43,8,5,30,4,0,0,4,39,8,5,26
"2011","Middlesbrough 003E","E01012040","Total",89,24,7,58,10,2,1,7,79,22,6,51
"2011","Middlesbrough 003F","E01012041","Total",45,11,4,30,6,0,2,4,39,11,2,26
"2011","Middlesbrough 004A","E01012074","Total",92,35,13,44,8,0,3,5,84,35,10,39
"2011","Middlesbrough 004B","E01012075","Total",137,41,25,71,10,1,6,3,127,40,19,68
"2011","Middlesbrough 004C","E01012076","Total",178,59,14,105,5,0,4,1,173,59,10,104
"2011","Middlesbrough 004D","E01012077","Total",65,24,8,33,0,0,0,0,65,24,8,33
"2011","Middlesbrough 004E","E01012088","Total",108,33,12,63,13,2,3,8,95,31,9,55
"2011","Middlesbrough 005A","E01012078","Total",89,33,18,38,5,1,2,2,84,32,16,36
"2011","Middlesbrough 005B","E01012079","Total",33,12,12,9,3,1,2,0,30,11,10,9
"2011","Middlesbrough 005C","E01012080","Total",35,12,10,13,3,0,2,1,32,12,8,12
"2011","Middlesbrough 005D","E01012081","Total",46,21,9,16,0,0,0,0,46,21,9,16
"2011","Middlesbrough 006A","E01012026","Total",40,14,9,17,2,0,1,1,38,14,8,16
"2011","Middlesbrough 006B","E01012027","Total",103,38,22,43,7,2,2,3,96,36,20,40
"2011","Middlesbrough 006E","E01033469","Total",123,35,20,68,6,0,3,3,117,35,17,65
"2011","Middlesbrough 007A","E01012015","Total",75,33,10,32,6,1,3,2,69,32,7,30
"2011","Middlesbrough 007B","E01012016","Total",113,44,12,57,10,1,2,7,103,43,10,50
"2011","Middlesbrough 007C","E01012017","Total",52,21,9,22,4,0,1,3,48,21,8,19
"2011","Middlesbrough 007D","E01012089","Total",104,27,9,68,2,0,0,2,102,27,9,66
"2011","Middlesbrough 007E","E01012090","Total",96,23,10,63,7,0,2,5,89,23,8,58
"2011","Middlesbrough 007F","E01012091","Total",115,23,13,79,9,3,0,6,106,20,13,73
"2011","Middlesbrough 008A","E01012011","Total",159,66,13,80,6,5,0,1,153,61,13,79
"2011","Middlesbrough 008B","E01012012","Total",48,23,8,17,0,0,0,0,48,23,8,17
"2011","Middlesbrough 008C","E01012013","Total",64,27,8,29,4,0,2,2,60,27,6,27
"2011","Middlesbrough 008D","E01012014","Total",112,38,19,55,7,0,4,3,105,38,15,52
"2011","Middlesbrough 009A","E01012053","Total",19,6,10,3,2,0,2,0,17,6,8,3
"2011","Middlesbrough 009B","E01012054","Total",47,11,19,17,7,0,4,3,40,11,15,14
"2011","Middlesbrough 009C","E01012055","Total",23,5,7,11,3,0,3,0,20,5,4,11
"2011","Middlesbrough 009D","E01012056","Total",119,50,33,36,15,1,9,5,104,49,24,31
"2011","Middlesbrough 009E","E01012057","Total",73,19,29,25,10,0,6,4,63,19,23,21
"2011","Middlesbrough 010A","E01012082","Total",110,27,12,71,5,2,1,2,105,25,11,69
"2011","Middlesbrough 010B","E01012083","Total",111,38,10,63,3,0,2,1,108,38,8,62
"2011","Middlesbrough 010C","E01012084","Total",140,41,24,75,9,0,4,5,131,41,20,70
"2011","Middlesbrough 010D","E01012085","Total",104,43,4,57,2,0,1,1,102,43,3,56
"2011","Middlesbrough 011A","E01012018","Total",74,27,12,35,6,1,1,4,68,26,11,31
"2011","Middlesbrough 011B","E01012019","Total",133,39,14,80,11,2,3,6,122,37,11,74
"2011","Middlesbrough 011C","E01012020","Total",85,24,14,47,2,0,0,2,83,24,14,45
"2011","Middlesbrough 011D","E01012021","Total",112,35,11,66,10,2,3,5,102,33,8,61
"2011","Middlesbrough 012A","E01012007","Total",26,12,10,4,1,0,1,0,25,12,9,4
"2011","Middlesbrough 012B","E01012008","Total",47,21,17,9,6,0,6,0,41,21,11,9
"2011","Middlesbrough 012C","E01012009","Total",37,13,13,11,2,0,1,1,35,13,12,10
"2011","Middlesbrough 012D","E01012010","Total",19,9,5,5,2,1,1,0,17,8,4,5
"2011","Middlesbrough 013A","E01012046","Total",33,23,3,7,5,4,1,0,28,19,2,7
"2011","Middlesbrough 013B","E01012047","Total",31,11,13,7,3,0,1,2,28,11,12,5
"2011","Middlesbrough 013C","E01012048","Total",21,12,6,3,3,0,3,0,18,12,3,3
"2011","Middlesbrough 014A","E01012049","Total",36,15,11,10,1,0,1,0,35,15,10,10
"2011","Middlesbrough 014B","E01012050","Total",100,36,8,56,5,2,3,0,95,34,5,56
"2011","Middlesbrough 014C","E01012051","Total",77,23,13,41,5,1,1,3,72,22,12,38
"2011","Middlesbrough 014D","E01012052","Total",32,14,12,6,5,0,4,1,27,14,8,5
"2011","Middlesbrough 015A","E01012022","Total",38,15,13,10,5,0,2,3,33,15,11,7
"2011","Middlesbrough 015B","E01012023","Total",18,5,9,4,1,0,1,0,17,5,8,4
"2011","Middlesbrough 015C","E01012024","Total",43,20,14,9,4,0,2,2,39,20,12,7
"2011","Middlesbrough 015D","E01012025","Total",21,5,8,8,3,1,2,0,18,4,6,8
"2011","Middlesbrough 017A","E01012065","Total",49,21,20,8,11,2,8,1,38,19,12,7
"2011","Middlesbrough 017B","E01012066","Total",51,21,24,6,7,0,7,0,44,21,17,6
"2011","Middlesbrough 017C","E01012067","Total",22,7,12,3,1,1,0,0,21,6,12,3
"2011","Middlesbrough 018A","E01012042","Total",66,24,19,23,3,0,3,0,63,24,16,23
"2011","Middlesbrough 018B","E01012043","Total",34,14,9,11,2,0,1,1,32,14,8,10
"2011","Middlesbrough 018C","E01012044","Total",119,43,17,59,8,0,1,7,111,43,16,52
"2011","Middlesbrough 018D","E01012045","Total",114,41,11,62,6,0,1,5,108,41,10,57
"2011","Middlesbrough 018G","E01032552","Total",77,38,14,25,3,0,3,0,74,38,11,25
"2011","Middlesbrough 018H","E01032553","Total",13,6,2,5,2,0,1,1,11,6,1,4
"2011","Middlesbrough 019A","E01012030","Total",30,11,14,5,4,0,4,0,26,11,10,5
"2011","Middlesbrough 019B","E01012031","Total",63,28,18,17,4,0,4,0,59,28,14,17
"2011","Middlesbrough 019C","E01012032","Total",39,18,15,6,5,0,4,1,34,18,11,5
"2011","Middlesbrough 019D","E01012033","Total",49,17,12,20,4,2,1,1,45,15,11,19
"2011","Middlesbrough 019E","E01012034","Total",51,18,10,23,2,0,0,2,49,18,10,21
"2011","Middlesbrough 019F","E01012035","Total",43,11,9,23,2,1,0,1,41,10,9,22
"2011","Middlesbrough 020A","E01012062","Total",37,10,16,11,3,0,1,2,34,10,15,9
"2011","Middlesbrough 020B","E01012063","Total",25,11,9,5,1,0,1,0,24,11,8,5
"2011","Middlesbrough 020C","E01012064","Total",48,16,23,9,4,0,4,0,44,16,19,9
"2011","Middlesbrough 020D","E01012071","Total",10,3,4,3,2,0,2,0,8,3,2,3
"2011","Middlesbrough 020E","E01012073","Total",17,4,10,3,4,0,3,1,13,4,7,2
"2011","Middlesbrough 020F","E01032593","Total",27,8,10,9,2,0,2,0,25,8,8,9
"2011","Northumberland 004A","E01027356","Total",19,6,10,3,5,0,4,1,14,6,6,2
"2011","Northumberland 004B","E01027357","Total",10,3,6,1,1,0,1,0,9,3,5,1
"2011","Northumberland 004C","E01027366","Total",27,9,7,11,4,0,3,1,23,9,4,10
"2011","Northumberland 004D","E01027367","Total",39,15,17,7,5,0,4,1,34,15,13,6
"2011","Northumberland 005A","E01027358","Total",35,15,10,10,3,1,1,1,32,14,9,9
"2011","Northumberland 005B","E01027359","Total",94,40,21,33,8,4,3,1,86,36,18,32
"2011","Northumberland 005D","E01033715","Total",31,9,10,12,5,0,3,2,26,9,7,10
"2011","Northumberland 005E","E01033717","Total",39,19,15,5,4,1,3,0,35,18,12,5
"2011","Northumberland 006A","E01027361","Total",67,22,20,25,8,1,4,3,59,21,16,22
"2011","Northumberland 006B","E01027362","Total",41,11,15,15,3,0,1,2,38,11,14,13
"2011","Northumberland 006C","E01027363","Total",56,17,10,29,1,0,0,1,55,17,10,28
"2011","Northumberland 006D","E01027364","Total",58,23,19,16,6,0,3,3,52,23,16,13
"2011","Northumberland 006E","E01027370","Total",28,15,7,6,1,0,0,1,27,15,7,5
"2011","Northumberland 006F","E01027371","Total",40,13,15,12,2,1,1,0,38,12,14,12
"2011","Northumberland 006G","E01027372","Total",18,4,5,9,3,0,0,3,15,4,5,6
"2011","Northumberland 007A","E01027365","Total",24,6,12,6,5,0,3,2,19,6,9,4
"2011","Northumberland 007B","E01027368","Total",26,9,7,10,2,0,1,1,24,9,6,9
"2011","Northumberland 007C","E01027369","Total",19,9,4,6,2,0,1,1,17,9,3,5
"2011","Northumberland 007D","E01027373","Total",27,14,10,3,3,0,2,1,24,14,8,2
"2011","Northumberland 001A","E01027376","Total",55,27,11,17,3,0,1,2,52,27,10,15
"2011","Northumberland 001B","E01027377","Total",32,12,6,14,6,3,1,2,26,9,5,12
"2011","Northumberland 001C","E01027385","Total",69,31,12,26,1,1,0,0,68,30,12,26
"2011","Northumberland 001D","E01027387","Total",54,24,12,18,6,0,2,4,48,24,10,14
"2011","Northumberland 001E","E01027388","Total",73,23,20,30,10,1,6,3,63,22,14,27
"2011","Northumberland 001F","E01027389","Total",37,18,5,14,0,0,0,0,37,18,5,14
"2011","Northumberland 002A","E01027378","Total",17,7,8,2,3,0,3,0,14,7,5,2
"2011","Northumberland 002B","E01027379","Total",16,11,2,3,0,0,0,0,16,11,2,3
"2011","Northumberland 002C","E01027380","Total",32,12,12,8,8,1,7,0,24,11,5,8
"2011","Northumberland 002D","E01027382","Total",30,15,10,5,3,1,2,0,27,14,8,5
"2011","Northumberland 002E","E01027386","Total",36,19,8,9,1,1,0,0,35,18,8,9
"2011","Northumberland 003A","E01027374","Total",33,10,18,5,6,0,6,0,27,10,12,5
"2011","Northumberland 003B","E01027375","Total",31,13,12,6,4,0,3,1,27,13,9,5
"2011","Northumberland 003C","E01027381","Total",21,7,5,9,3,1,1,1,18,6,4,8
"2011","Northumberland 003D","E01027383","Total",19,10,4,5,0,0,0,0,19,10,4,5
"2011","Northumberland 003E","E01027384","Total",29,15,7,7,7,0,6,1,22,15,1,6
"2011","Northumberland 003F","E01027390","Total",41,20,11,10,3,0,2,1,38,20,9,9
"2011","Northumberland 022A","E01027392","Total",81,23,14,44,8,0,2,6,73,23,12,38
"2011","Northumberland 022B","E01027393","Total",77,27,13,37,5,1,3,1,72,26,10,36
"2011","Northumberland 022C","E01027416","Total",112,25,17,70,9,0,4,5,103,25,13,65
"2011","Northumberland 022D","E01027424","Total",95,27,12,56,10,2,1,7,85,25,11,49
"2011","Northumberland 023A","E01027414","Total",55,16,17,22,3,0,1,2,52,16,16,20
"2011","Northumberland 023B","E01027415","Total",78,18,17,43,7,0,2,5,71,18,15,38
"2011","Northumberland 023C","E01027431","Total",90,33,16,41,15,2,6,7,75,31,10,34
"2011","Northumberland 023D","E01027441","Total",54,15,22,17,12,0,10,2,42,15,12,15
"2011","Northumberland 023E","E01027442","Total",25,8,7,10,3,0,2,1,22,8,5,9
"2011","Northumberland 024A","E01027391","Total",67,25,12,30,6,0,3,3,61,25,9,27
"2011","Northumberland 024B","E01027422","Total",78,28,13,37,2,0,0,2,76,28,13,35
"2011","Northumberland 024C","E01027423","Total",46,16,15,15,7,0,2,5,39,16,13,10
"2011","Northumberland 024D","E01027429","Total",93,38,16,39,10,2,3,5,83,36,13,34
"2011","Northumberland 024E","E01027430","Total",80,31,12,37,11,0,3,8,69,31,9,29
"2011","Northumberland 025A","E01027425","Total",45,16,20,9,5,0,4,1,40,16,16,8
"2011","Northumberland 025B","E01027426","Total",98,31,12,55,18,4,2,12,80,27,10,43
"2011","Northumberland 025C","E01027427","Total",81,26,12,43,8,1,5,2,73,25,7,41
"2011","Northumberland 025D","E01027428","Total",39,12,16,11,4,1,2,1,35,11,14,10
"2011","Northumberland 026A","E01027437","Total",27,11,5,11,0,0,0,0,27,11,5,11
"2011","Northumberland 026B","E01027438","Total",50,24,22,4,2,0,2,0,48,24,20,4
"2011","Northumberland 026C","E01027439","Total",35,16,17,2,5,0,5,0,30,16,12,2
"2011","Northumberland 026D","E01027440","Total",19,8,10,1,5,0,5,0,14,8,5,1
"2011","Northumberland 027A","E01027400","Total",31,15,14,2,1,1,0,0,30,14,14,2
"2011","Northumberland 027B","E01027401","Total",18,5,10,3,0,0,0,0,18,5,10,3
"2011","Northumberland 027C","E01027402","Total",17,7,8,2,3,0,3,0,14,7,5,2
"2011","Northumberland 027D","E01027403","Total",17,7,10,0,0,0,0,0,17,7,10,0
"2011","Northumberland 029A","E01027398","Total",120,45,26,49,10,1,4,5,110,44,22,44
"2011","Northumberland 029B","E01027409","Total",33,14,8,11,3,0,1,2,30,14,7,9
"2011","Northumberland 029C","E01027411","Total",46,19,10,17,3,0,2,1,43,19,8,16
"2011","Northumberland 029D","E01027412","Total",84,32,16,36,14,8,4,2,70,24,12,34
"2011","Northumberland 029E","E01027413","Total",79,28,19,32,4,1,2,1,75,27,17,31
"2011","Northumberland 028A","E01027395","Total",57,26,15,16,5,2,1,2,52,24,14,14
"2011","Northumberland 028B","E01027396","Total",58,24,11,23,6,1,2,3,52,23,9,20
"2011","Northumberland 028C","E01027397","Total",61,16,14,31,8,0,3,5,53,16,11,26
"2011","Northumberland 028D","E01027399","Total",28,12,9,7,2,0,1,1,26,12,8,6
"2011","Northumberland 028E","E01027404","Total",34,9,20,5,5,1,4,0,29,8,16,5
"2011","Northumberland 028F","E01027405","Total",26,9,12,5,0,0,0,0,26,9,12,5
"2011","Northumberland 030A","E01027417","Total",26,12,10,4,2,0,2,0,24,12,8,4
"2011","Northumberland 030B","E01027418","Total",48,15,22,11,7,0,7,0,41,15,15,11
"2011","Northumberland 030C","E01027419","Total",41,16,18,7,6,0,5,1,35,16,13,6
"2011","Northumberland 030D","E01027420","Total",26,12,10,4,0,0,0,0,26,12,10,4
"2011","Northumberland 030E","E01027421","Total",47,24,17,6,8,2,6,0,39,22,11,6
"2011","Northumberland 031A","E01027394","Total",27,14,7,6,2,0,1,1,25,14,6,5
"2011","Northumberland 031B","E01027406","Total",13,4,6,3,1,0,1,0,12,4,5,3
"2011","Northumberland 031C","E01027407","Total",24,12,11,1,5,0,5,0,19,12,6,1
"2011","Northumberland 031D","E01027408","Total",51,28,11,12,3,0,2,1,48,28,9,11
"2011","Northumberland 031E","E01027410","Total",27,8,11,8,3,0,2,1,24,8,9,7
"2011","Northumberland 032A","E01027432","Total",46,20,11,15,3,1,1,1,43,19,10,14
"2011","Northumberland 032B","E01027433","Total",61,25,16,20,2,2,0,0,59,23,16,20
"2011","Northumberland 032C","E01027434","Total",41,13,13,15,6,1,2,3,35,12,11,12
"2011","Northumberland 032D","E01027435","Total",38,11,16,11,2,1,0,1,36,10,16,10
"2011","Northumberland 032E","E01027436","Total",45,19,14,12,5,0,4,1,40,19,10,11
"2011","Northumberland 008A","E01027443","Total",73,25,15,33,7,0,1,6,66,25,14,27
"2011","Northumberland 008B","E01027444","Total",17,3,8,6,3,0,3,0,14,3,5,6
"2011","Northumberland 008C","E01027445","Total",36,14,13,9,5,3,2,0,31,11,11,9
"2011","Northumberland 008D","E01027446","Total",19,5,13,1,4,0,4,0,15,5,9,1
"2011","Northumberland 008E","E01027451","Total",81,19,15,47,20,0,7,13,61,19,8,34
"2011","Northumberland 008F","E01027474","Total",83,25,25,33,11,1,6,4,72,24,19,29
"2011","Northumberland 008G","E01027475","Total",23,12,7,4,1,0,1,0,22,12,6,4
"2011","Northumberland 011A","E01027457","Total",26,9,13,4,2,0,2,0,24,9,11,4
"2011","Northumberland 011B","E01027462","Total",57,16,15,26,2,0,2,0,55,16,13,26
"2011","Northumberland 011C","E01027463","Total",33,14,15,4,6,1,5,0,27,13,10,4
"2011","Northumberland 015A","E01027447","Total",30,11,10,9,2,0,1,1,28,11,9,8
"2011","Northumberland 015B","E01027448","Total",32,16,10,6,1,0,1,0,31,16,9,6
"2011","Northumberland 015C","E01027450","Total",35,17,13,5,3,0,2,1,32,17,11,4
"2011","Northumberland 015D","E01027473","Total",26,9,9,8,1,0,0,1,25,9,9,7
"2011","Northumberland 016A","E01027452","Total",38,22,9,7,4,0,3,1,34,22,6,6
"2011","Northumberland 016B","E01027453","Total",29,16,7,6,1,1,0,0,28,15,7,6
"2011","Northumberland 016E","E01027461","Total",79,22,25,32,2,0,2,0,77,22,23,32
"2011","Northumberland 016F","E01033718","Total",83,37,27,19,4,1,1,2,79,36,26,17
"2011","Northumberland 018A","E01027455","Total",14,7,5,2,2,2,0,0,12,5,5,2
"2011","Northumberland 018B","E01027456","Total",8,5,3,0,1,0,1,0,7,5,2,0
"2011","Northumberland 018C","E01027458","Total",20,8,12,0,5,2,3,0,15,6,9,0
"2011","Northumberland 018D","E01027460","Total",27,10,11,6,3,0,3,0,24,10,8,6
"2011","Northumberland 033A","E01027464","Total",20,4,10,6,2,0,1,1,18,4,9,5
"2011","Northumberland 033B","E01027465","Total",31,13,12,6,1,0,0,1,30,13,12,5
"2011","Northumberland 033C","E01027466","Total",49,24,12,13,4,0,1,3,45,24,11,10
"2011","Northumberland 033F","E01033714","Total",22,13,5,4,1,1,0,0,21,12,5,4
"2011","Northumberland 034A","E01027449","Total",23,9,11,3,3,0,3,0,20,9,8,3
"2011","Northumberland 034B","E01027468","Total",10,5,2,3,1,0,1,0,9,5,1,3
"2011","Northumberland 034C","E01027469","Total",10,4,4,2,1,0,1,0,9,4,3,2
"2011","Northumberland 034D","E01027471","Total",14,8,3,3,0,0,0,0,14,8,3,3
"2011","Northumberland 034E","E01027472","Total",25,8,10,7,2,0,1,1,23,8,9,6
"2011","Northumberland 019A","E01027479","Total",43,18,16,9,11,4,6,1,32,14,10,8
"2011","Northumberland 019B","E01027480","Total",19,13,3,3,1,0,1,0,18,13,2,3
"2011","Northumberland 019C","E01027503","Total",19,6,7,6,2,0,2,0,17,6,5,6
"2011","Northumberland 019D","E01027511","Total",14,10,2,2,0,0,0,0,14,10,2,2
"2011","Northumberland 037A","E01027484","Total",33,12,10,11,3,0,2,1,30,12,8,10
"2011","Northumberland 037B","E01027485","Total",42,22,9,11,2,0,2,0,40,22,7,11
"2011","Northumberland 037C","E01027486","Total",34,17,9,8,4,0,3,1,30,17,6,7
"2011","Northumberland 037D","E01027487","Total",30,12,10,8,3,0,3,0,27,12,7,8
"2011","Northumberland 037E","E01027512","Total",16,8,4,4,1,1,0,0,15,7,4,4
"2011","Northumberland 036A","E01027483","Total",18,6,8,4,1,0,1,0,17,6,7,4
"2011","Northumberland 036B","E01027496","Total",32,13,12,7,3,0,2,1,29,13,10,6
"2011","Northumberland 036C","E01027508","Total",22,10,8,4,1,0,1,0,21,10,7,4
"2011","Northumberland 036D","E01027513","Total",36,13,18,5,7,4,3,0,29,9,15,5
"2011","Northumberland 035A","E01027476","Total",61,24,20,17,4,1,1,2,57,23,19,15
"2011","Northumberland 035B","E01027489","Total",44,14,18,12,5,0,3,2,39,14,15,10
"2011","Northumberland 035C","E01027490","Total",64,24,23,17,3,0,3,0,61,24,20,17
"2011","Northumberland 035D","E01027491","Total",15,5,3,7,1,0,0,1,14,5,3,6
"2011","Northumberland 035E","E01027492","Total",28,9,14,5,4,0,2,2,24,9,12,3
"2011","Northumberland 035F","E01027493","Total",69,19,18,32,9,1,3,5,60,18,15,27
"2011","Northumberland 035G","E01027494","Total",42,15,15,12,5,0,3,2,37,15,12,10
"2011","Northumberland 038A","E01027497","Total",78,34,20,24,6,1,3,2,72,33,17,22
"2011","Northumberland 038B","E01027498","Total",113,48,30,35,11,0,8,3,102,48,22,32
"2011","Northumberland 038C","E01027499","Total",26,7,12,7,4,1,3,0,22,6,9,7
"2011","Northumberland 038D","E01027500","Total",66,17,22,27,10,1,3,6,56,16,19,21
"2011","Northumberland 038E","E01027501","Total",23,9,7,7,2,0,0,2,21,9,7,5
"2011","Northumberland 038F","E01027502","Total",18,9,6,3,1,0,1,0,17,9,5,3
"2011","Northumberland 039A","E01027481","Total",23,11,10,2,3,1,2,0,20,10,8,2
"2011","Northumberland 039B","E01027482","Total",18,9,6,3,0,0,0,0,18,9,6,3
"2011","Northumberland 039C","E01027504","Total",16,5,7,4,3,1,2,0,13,4,5,4
"2011","Northumberland 039D","E01027506","Total",15,3,9,3,2,0,2,0,13,3,7,3
"2011","Northumberland 039E","E01027507","Total",8,3,5,0,1,0,1,0,7,3,4,0
"2011","Northumberland 039F","E01027509","Total",17,7,8,2,1,0,0,1,16,7,8,1
"2011","Northumberland 040A","E01027477","Total",13,4,7,2,5,2,2,1,8,2,5,1
"2011","Northumberland 040B","E01027478","Total",15,8,2,5,0,0,0,0,15,8,2,5
"2011","Northumberland 040C","E01027488","Total",49,26,11,12,6,1,4,1,43,25,7,11
"2011","Northumberland 040D","E01027495","Total",16,6,8,2,2,0,2,0,14,6,6,2
"2011","Northumberland 040E","E01027505","Total",15,8,3,4,1,0,1,0,14,8,2,4
"2011","Northumberland 040F","E01027510","Total",25,14,8,3,1,0,1,0,24,14,7,3
"2011","Northumberland 009A","E01027541","Total",72,24,20,28,7,0,3,4,65,24,17,24
"2011","Northumberland 009B","E01027542","Total",103,23,19,61,14,2,7,5,89,21,12,56
"2011","Northumberland 009C","E01027543","Total",69,23,12,34,10,0,4,6,59,23,8,28
"2011","Northumberland 009D","E01027544","Total",32,12,5,15,3,1,0,2,29,11,5,13
"2011","Northumberland 010A","E01027528","Total",65,17,16,32,8,0,4,4,57,17,12,28
"2011","Northumberland 010B","E01027529","Total",26,10,10,6,4,0,3,1,22,10,7,5
"2011","Northumberland 010C","E01027539","Total",90,23,16,51,9,3,4,2,81,20,12,49
"2011","Northumberland 010D","E01027545","Total",123,31,16,76,9,1,4,4,114,30,12,72
"2011","Northumberland 010E","E01027546","Total",108,33,17,58,12,0,5,7,96,33,12,51
"2011","Northumberland 013A","E01027533","Total",72,18,11,43,8,2,2,4,64,16,9,39
"2011","Northumberland 013B","E01027540","Total",109,22,21,66,16,1,6,9,93,21,15,57
"2011","Northumberland 013E","E01027549","Total",29,16,7,6,2,0,1,1,27,16,6,5
"2011","Northumberland 013F","E01033716","Total",74,18,12,44,12,0,2,10,62,18,10,34
"2011","Northumberland 012A","E01027524","Total",65,15,30,20,7,2,3,2,58,13,27,18
"2011","Northumberland 012B","E01027525","Total",35,16,14,5,7,0,5,2,28,16,9,3
"2011","Northumberland 012C","E01027526","Total",15,5,9,1,0,0,0,0,15,5,9,1
"2011","Northumberland 012D","E01027527","Total",73,27,10,36,6,2,2,2,67,25,8,34
"2011","Northumberland 012E","E01027536","Total",48,21,8,19,2,2,0,0,46,19,8,19
"2011","Northumberland 014A","E01027532","Total",47,21,11,15,8,0,5,3,39,21,6,12
"2011","Northumberland 014B","E01027537","Total",39,10,12,17,2,1,1,0,37,9,11,17
"2011","Northumberland 014C","E01027538","Total",23,6,7,10,2,0,2,0,21,6,5,10
"2011","Northumberland 017A","E01027530","Total",70,19,22,29,9,1,6,2,61,18,16,27
"2011","Northumberland 017B","E01027531","Total",49,15,9,25,0,0,0,0,49,15,9,25
"2011","Northumberland 017C","E01027534","Total",91,27,20,44,8,2,1,5,83,25,19,39
"2011","Northumberland 017D","E01027535","Total",23,11,9,3,1,0,0,1,22,11,9,2
"2011","Northumberland 017E","E01027553","Total",49,23,14,12,5,0,3,2,44,23,11,10
"2011","Northumberland 017F","E01027554","Total",34,17,7,10,4,2,1,1,30,15,6,9
"2011","Northumberland 020A","E01027515","Total",43,22,9,12,1,0,1,0,42,22,8,12
"2011","Northumberland 020B","E01027517","Total",44,18,13,13,5,0,3,2,39,18,10,11
"2011","Northumberland 020C","E01027518","Total",78,22,20,36,12,1,4,7,66,21,16,29
"2011","Northumberland 020D","E01027519","Total",81,18,19,44,11,1,4,6,70,17,15,38
"2011","Northumberland 020E","E01027550","Total",57,20,18,19,5,1,3,1,52,19,15,18
"2011","Northumberland 020F","E01027551","Total",62,20,15,27,7,0,3,4,55,20,12,23
"2011","Northumberland 020G","E01027552","Total",34,9,7,18,6,0,1,5,28,9,6,13
"2011","Northumberland 021A","E01027514","Total",40,17,11,12,3,1,1,1,37,16,10,11
"2011","Northumberland 021B","E01027516","Total",24,5,6,13,1,0,0,1,23,5,6,12
"2011","Northumberland 021C","E01027520","Total",16,4,7,5,2,0,1,1,14,4,6,4
"2011","Northumberland 021D","E01027521","Total",30,5,19,6,9,0,8,1,21,5,11,5
"2011","Northumberland 021E","E01027522","Total",59,19,14,26,2,0,0,2,57,19,14,24
"2011","Northumberland 021F","E01027523","Total",53,16,18,19,1,0,1,0,52,16,17,19
"2011","Redcar and Cleveland 001A","E01012100","Total",71,17,7,47,8,0,0,8,63,17,7,39
"2011","Redcar and Cleveland 001B","E01012101","Total",50,10,12,28,10,2,3,5,40,8,9,23
"2011","Redcar and Cleveland 001C","E01012102","Total",163,51,37,75,20,0,9,11,143,51,28,64
"2011","Redcar and Cleveland 001D","E01012184","Total",60,36,11,13,8,4,2,2,52,32,9,11
"2011","Redcar and Cleveland 002A","E01012105","Total",43,22,10,11,1,0,0,1,42,22,10,10
"2011","Redcar and Cleveland 002B","E01012142","Total",58,30,12,16,1,0,0,1,57,30,12,15
"2011","Redcar and Cleveland 002C","E01012143","Total",104,28,12,64,10,3,1,6,94,25,11,58
"2011","Redcar and Cleveland 002D","E01012144","Total",40,20,8,12,5,2,2,1,35,18,6,11
"2011","Redcar and Cleveland 003C","E01012106","Total",44,16,8,20,5,2,1,2,39,14,7,18
"2011","Redcar and Cleveland 003D","E01012107","Total",65,25,9,31,4,1,2,1,61,24,7,30
"2011","Redcar and Cleveland 003E","E01032560","Total",18,3,11,4,6,0,6,0,12,3,5,4
"2011","Redcar and Cleveland 003F","E01032561","Total",136,40,13,83,7,0,2,5,129,40,11,78
"2011","Redcar and Cleveland 004A","E01012176","Total",20,8,6,6,2,0,0,2,18,8,6,4
"2011","Redcar and Cleveland 004B","E01012177","Total",33,9,15,9,6,0,5,1,27,9,10,8
"2011","Redcar and Cleveland 004C","E01012178","Total",45,20,15,10,2,0,2,0,43,20,13,10
"2011","Redcar and Cleveland 004D","E01012179","Total",48,24,19,5,1,0,1,0,47,24,18,5
"2011","Redcar and Cleveland 004E","E01012180","Total",39,15,17,7,5,1,2,2,34,14,15,5
"2011","Redcar and Cleveland 004F","E01012185","Total",64,25,18,21,4,0,2,2,60,25,16,19
"2011","Redcar and Cleveland 004G","E01012186","Total",33,13,10,10,4,0,1,3,29,13,9,7
"2011","Redcar and Cleveland 005A","E01012127","Total",66,16,9,41,4,0,2,2,62,16,7,39
"2011","Redcar and Cleveland 005B","E01012128","Total",74,27,9,38,3,2,0,1,71,25,9,37
"2011","Redcar and Cleveland 005C","E01012129","Total",50,14,10,26,4,1,1,2,46,13,9,24
"2011","Redcar and Cleveland 005D","E01012130","Total",33,11,12,10,1,0,0,1,32,11,12,9
"2011","Redcar and Cleveland 005E","E01012131","Total",82,26,8,48,2,0,0,2,80,26,8,46
"2011","Redcar and Cleveland 006A","E01012138","Total",66,28,34,4,7,3,4,0,59,25,30,4
"2011","Redcar and Cleveland 006B","E01012139","Total",22,8,10,4,6,0,3,3,16,8,7,1
"2011","Redcar and Cleveland 006C","E01012140","Total",49,12,12,25,3,0,0,3,46,12,12,22
"2011","Redcar and Cleveland 006D","E01012141","Total",32,13,15,4,6,1,4,1,26,12,11,3
"2011","Redcar and Cleveland 006E","E01012154","Total",24,12,5,7,3,1,1,1,21,11,4,6
"2011","Redcar and Cleveland 006F","E01012155","Total",50,22,13,15,5,1,3,1,45,21,10,14
"2011","Redcar and Cleveland 006G","E01012156","Total",29,13,11,5,1,1,0,0,28,12,11,5
"2011","Redcar and Cleveland 006H","E01012157","Total",46,19,13,14,4,1,1,2,42,18,12,12
"2011","Redcar and Cleveland 007A","E01012158","Total",26,10,10,6,5,1,3,1,21,9,7,5
"2011","Redcar and Cleveland 007B","E01012159","Total",54,14,14,26,9,1,4,4,45,13,10,22
"2011","Redcar and Cleveland 007C","E01012160","Total",48,23,10,15,4,2,0,2,44,21,10,13
"2011","Redcar and Cleveland 007D","E01012161","Total",58,21,15,22,8,1,3,4,50,20,12,18
"2011","Redcar and Cleveland 009A","E01012113","Total",117,31,14,72,14,1,3,10,103,30,11,62
"2011","Redcar and Cleveland 009B","E01012114","Total",120,30,7,83,10,3,1,6,110,27,6,77
"2011","Redcar and Cleveland 009E","E01012175","Total",115,38,14,63,9,3,2,4,106,35,12,59
"2011","Redcar and Cleveland 009F","E01033471","Total",197,54,25,118,8,0,1,7,189,54,24,111
"2011","Redcar and Cleveland 010A","E01012095","Total",34,14,10,10,2,0,2,0,32,14,8,10
"2011","Redcar and Cleveland 010B","E01012097","Total",21,7,6,8,6,0,3,3,15,7,3,5
"2011","Redcar and Cleveland 010C","E01012098","Total",39,19,8,12,1,0,1,0,38,19,7,12
"2011","Redcar and Cleveland 010D","E01012099","Total",79,23,8,48,12,2,2,8,67,21,6,40
"2011","Redcar and Cleveland 011A","E01012108","Total",101,35,14,52,3,0,2,1,98,35,12,51
"2011","Redcar and Cleveland 011B","E01012109","Total",47,17,9,21,3,0,1,2,44,17,8,19
"2011","Redcar and Cleveland 011C","E01012110","Total",46,19,14,13,2,0,1,1,44,19,13,12
"2011","Redcar and Cleveland 011D","E01012111","Total",46,16,9,21,5,0,2,3,41,16,7,18
"2011","Redcar and Cleveland 011E","E01012171","Total",62,27,10,25,1,0,0,1,61,27,10,24
"2011","Redcar and Cleveland 011F","E01012172","Total",29,11,10,8,3,0,3,0,26,11,7,8
"2011","Redcar and Cleveland 012A","E01012162","Total",54,22,13,19,3,1,2,0,51,21,11,19
"2011","Redcar and Cleveland 012B","E01012163","Total",39,20,12,7,2,0,2,0,37,20,10,7
"2011","Redcar and Cleveland 012C","E01012164","Total",58,24,8,26,3,0,1,2,55,24,7,24
"2011","Redcar and Cleveland 012D","E01012165","Total",116,26,21,69,14,2,5,7,102,24,16,62
"2011","Redcar and Cleveland 013A","E01012096","Total",69,20,10,39,10,1,2,7,59,19,8,32
"2011","Redcar and Cleveland 013D","E01012136","Total",52,16,13,23,7,2,2,3,45,14,11,20
"2011","Redcar and Cleveland 013E","E01033473","Total",110,30,12,68,5,0,2,3,105,30,10,65
"2011","Redcar and Cleveland 015A","E01012112","Total",90,36,17,37,9,1,4,4,81,35,13,33
"2011","Redcar and Cleveland 015B","E01012145","Total",61,25,14,22,3,1,1,1,58,24,13,21
"2011","Redcar and Cleveland 015C","E01012147","Total",28,9,17,2,0,0,0,0,28,9,17,2
"2011","Redcar and Cleveland 015D","E01012149","Total",16,11,2,3,0,0,0,0,16,11,2,3
"2011","Redcar and Cleveland 016A","E01012132","Total",69,20,6,43,5,1,0,4,64,19,6,39
"2011","Redcar and Cleveland 016B","E01012134","Total",23,5,5,13,2,0,2,0,21,5,3,13
"2011","Redcar and Cleveland 016C","E01012137","Total",24,6,6,12,2,0,2,0,22,6,4,12
"2011","Redcar and Cleveland 016D","E01012181","Total",81,31,16,34,15,1,7,7,66,30,9,27
"2011","Redcar and Cleveland 018A","E01012117","Total",60,25,11,24,3,1,2,0,57,24,9,24
"2011","Redcar and Cleveland 018B","E01012118","Total",50,21,13,16,4,1,3,0,46,20,10,16
"2011","Redcar and Cleveland 018C","E01012119","Total",99,40,21,38,11,1,3,7,88,39,18,31
"2011","Redcar and Cleveland 018D","E01012121","Total",46,13,14,19,2,0,2,0,44,13,12,19
"2011","Redcar and Cleveland 019E","E01032548","Total",15,7,3,5,3,0,1,2,12,7,2,3
"2011","Redcar and Cleveland 019F","E01032549","Total",24,7,10,7,3,0,3,0,21,7,7,7
"2011","Redcar and Cleveland 019G","E01033472","Total",105,45,22,38,9,0,5,4,96,45,17,34
"2011","Redcar and Cleveland 020A","E01012120","Total",25,4,17,4,2,0,2,0,23,4,15,4
"2011","Redcar and Cleveland 020B","E01012124","Total",17,6,9,2,2,0,1,1,15,6,8,1
"2011","Redcar and Cleveland 020C","E01012182","Total",11,4,6,1,0,0,0,0,11,4,6,1
"2011","Redcar and Cleveland 020D","E01012183","Total",21,12,7,2,0,0,0,0,21,12,7,2
"2011","Redcar and Cleveland 021A","E01012148","Total",97,35,17,45,6,0,1,5,91,35,16,40
"2011","Redcar and Cleveland 021B","E01012150","Total",128,50,21,57,8,2,4,2,120,48,17,55
"2011","Redcar and Cleveland 021C","E01012151","Total",30,14,9,7,2,0,1,1,28,14,8,6
"2011","Redcar and Cleveland 021D","E01012152","Total",37,14,13,10,4,1,3,0,33,13,10,10
"2011","Redcar and Cleveland 021E","E01032594","Total",24,12,5,7,3,0,1,2,21,12,4,5
"2011","Redcar and Cleveland 022A","E01012146","Total",19,3,9,7,0,0,0,0,19,3,9,7
"2011","Redcar and Cleveland 022B","E01012167","Total",62,33,7,22,6,3,1,2,56,30,6,20
"2011","Redcar and Cleveland 022C","E01012168","Total",97,35,13,49,5,2,1,2,92,33,12,47
"2011","Redcar and Cleveland 022D","E01012170","Total",116,31,13,72,6,0,2,4,110,31,11,68
"2011","Redcar and Cleveland 022E","E01012173","Total",31,15,5,11,4,1,1,2,27,14,4,9
"2011","Redcar and Cleveland 022F","E01012174","Total",18,10,4,4,3,1,2,0,15,9,2,4
"2011","Redcar and Cleveland 022G","E01033470","Total",106,31,22,53,14,0,6,8,92,31,16,45
"2011","Stockton-on-Tees 001A","E01012242","Total",23,6,11,6,4,0,3,1,19,6,8,5
"2011","Stockton-on-Tees 001B","E01012243","Total",37,9,15,13,3,0,3,0,34,9,12,13
"2011","Stockton-on-Tees 001C","E01012244","Total",37,20,10,7,2,1,0,1,35,19,10,6
"2011","Stockton-on-Tees 001D","E01012246","Total",29,16,10,3,1,0,1,0,28,16,9,3
"2011","Stockton-on-Tees 001E","E01012296","Total",26,5,14,7,8,0,5,3,18,5,9,4
"2011","Stockton-on-Tees 001F","E01012297","Total",49,21,22,6,3,1,2,0,46,20,20,6
"2011","Stockton-on-Tees 002A","E01012197","Total",125,42,27,56,7,1,4,2,118,41,23,54
"2011","Stockton-on-Tees 002B","E01012256","Total",28,11,11,6,4,0,4,0,24,11,7,6
"2011","Stockton-on-Tees 002C","E01012257","Total",23,9,9,5,2,0,2,0,21,9,7,5
"2011","Stockton-on-Tees 002D","E01012275","Total",74,19,21,34,9,1,5,3,65,18,16,31
"2011","Stockton-on-Tees 002E","E01012276","Total",56,20,18,18,6,1,2,3,50,19,16,15
"2011","Stockton-on-Tees 002F","E01012277","Total",89,29,26,34,5,0,1,4,84,29,25,30
"2011","Stockton-on-Tees 003A","E01012196","Total",68,23,11,34,4,0,0,4,64,23,11,30
"2011","Stockton-on-Tees 003B","E01012198","Total",85,22,16,47,15,4,5,6,70,18,11,41
"2011","Stockton-on-Tees 003C","E01012214","Total",80,27,15,38,6,0,3,3,74,27,12,35
"2011","Stockton-on-Tees 003D","E01012215","Total",74,20,10,44,11,0,4,7,63,20,6,37
"2011","Stockton-on-Tees 003E","E01012216","Total",81,28,21,32,4,1,2,1,77,27,19,31
"2011","Stockton-on-Tees 003F","E01012245","Total",77,25,10,42,6,0,2,4,71,25,8,38
"2011","Stockton-on-Tees 004A","E01012278","Total",59,22,10,27,7,1,4,2,52,21,6,25
"2011","Stockton-on-Tees 004B","E01012279","Total",55,26,16,13,2,0,2,0,53,26,14,13
"2011","Stockton-on-Tees 004C","E01012280","Total",35,17,7,11,1,0,1,0,34,17,6,11
"2011","Stockton-on-Tees 004D","E01012281","Total",70,20,15,35,11,0,4,7,59,20,11,28
"2011","Stockton-on-Tees 005A","E01012255","Total",13,5,6,2,3,0,3,0,10,5,3,2
"2011","Stockton-on-Tees 005B","E01012269","Total",22,11,8,3,5,1,3,1,17,10,5,2
"2011","Stockton-on-Tees 005D","E01012294","Total",13,7,5,1,1,0,1,0,12,7,4,1
"2011","Stockton-on-Tees 005E","E01012295","Total",49,19,15,15,4,0,1,3,45,19,14,12
"2011","Stockton-on-Tees 005F","E01033476","Total",19,7,6,6,1,1,0,0,18,6,6,6
"2011","Stockton-on-Tees 005G","E01033480","Total",19,5,9,5,1,0,1,0,18,5,8,5
"2011","Stockton-on-Tees 006A","E01012210","Total",24,12,9,3,0,0,0,0,24,12,9,3
"2011","Stockton-on-Tees 006B","E01012211","Total",36,9,14,13,4,1,1,2,32,8,13,11
"2011","Stockton-on-Tees 006C","E01012212","Total",23,9,6,8,3,1,0,2,20,8,6,6
"2011","Stockton-on-Tees 006D","E01012213","Total",26,14,4,8,5,0,1,4,21,14,3,4
"2011","Stockton-on-Tees 007A","E01012192","Total",61,25,16,20,7,1,3,3,54,24,13,17
"2011","Stockton-on-Tees 007B","E01012193","Total",83,38,6,39,7,1,1,5,76,37,5,34
"2011","Stockton-on-Tees 007C","E01012260","Total",27,9,11,7,4,1,3,0,23,8,8,7
"2011","Stockton-on-Tees 007D","E01012261","Total",50,25,16,9,3,0,3,0,47,25,13,9
"2011","Stockton-on-Tees 008A","E01012247","Total",54,23,5,26,4,1,1,2,50,22,4,24
"2011","Stockton-on-Tees 008B","E01012249","Total",79,29,10,40,9,0,3,6,70,29,7,34
"2011","Stockton-on-Tees 008C","E01012271","Total",102,36,15,51,9,0,1,8,93,36,14,43
"2011","Stockton-on-Tees 008D","E01012272","Total",10,5,3,2,2,0,1,1,8,5,2,1
"2011","Stockton-on-Tees 008E","E01012273","Total",111,36,20,55,8,1,4,3,103,35,16,52
"2011","Stockton-on-Tees 008F","E01012274","Total",61,23,13,25,2,0,2,0,59,23,11,25
"2011","Stockton-on-Tees 009D","E01012248","Total",58,25,8,25,7,1,2,4,51,24,6,21
"2011","Stockton-on-Tees 009E","E01012250","Total",74,22,15,37,4,1,0,3,70,21,15,34
"2011","Stockton-on-Tees 009F","E01032542","Total",72,15,8,49,8,3,1,4,64,12,7,45
"2011","Stockton-on-Tees 009G","E01032543","Total",161,49,24,88,16,2,5,9,145,47,19,79
"2011","Stockton-on-Tees 009H","E01032544","Total",98,33,28,37,12,2,7,3,86,31,21,34
"2011","Stockton-on-Tees 010A","E01012194","Total",90,23,21,46,7,0,4,3,83,23,17,43
"2011","Stockton-on-Tees 010B","E01012195","Total",131,36,24,71,8,1,3,4,123,35,21,67
"2011","Stockton-on-Tees 010C","E01012258","Total",54,12,8,34,8,0,4,4,46,12,4,30
"2011","Stockton-on-Tees 010D","E01012259","Total",57,21,20,16,6,0,4,2,51,21,16,14
"2011","Stockton-on-Tees 010E","E01012268","Total",108,33,15,60,11,2,2,7,97,31,13,53
"2011","Stockton-on-Tees 011A","E01012187","Total",31,11,13,7,3,0,3,0,28,11,10,7
"2011","Stockton-on-Tees 011B","E01012188","Total",25,8,11,6,2,0,1,1,23,8,10,5
"2011","Stockton-on-Tees 011C","E01012189","Total",27,11,12,4,3,1,1,1,24,10,11,3
"2011","Stockton-on-Tees 011D","E01012205","Total",32,15,10,7,3,1,1,1,29,14,9,6
"2011","Stockton-on-Tees 012A","E01012219","Total",51,11,19,21,5,0,4,1,46,11,15,20
"2011","Stockton-on-Tees 012B","E01012251","Total",107,33,22,52,13,0,5,8,94,33,17,44
"2011","Stockton-on-Tees 012C","E01012252","Total",152,39,19,94,22,1,6,15,130,38,13,79
"2011","Stockton-on-Tees 012D","E01012253","Total",48,18,17,13,3,0,3,0,45,18,14,13
"2011","Stockton-on-Tees 012E","E01012254","Total",124,36,16,72,14,2,4,8,110,34,12,64
"2011","Stockton-on-Tees 013A","E01012204","Total",16,6,7,3,3,2,1,0,13,4,6,3
"2011","Stockton-on-Tees 013B","E01012206","Total",36,17,7,12,1,1,0,0,35,16,7,12
"2011","Stockton-on-Tees 013C","E01012207","Total",37,22,10,5,5,1,4,0,32,21,6,5
"2011","Stockton-on-Tees 013D","E01012208","Total",20,9,9,2,1,0,1,0,19,9,8,2
"2011","Stockton-on-Tees 014A","E01012262","Total",113,39,17,57,9,3,3,3,104,36,14,54
"2011","Stockton-on-Tees 014C","E01012264","Total",92,38,23,31,7,1,3,3,85,37,20,28
"2011","Stockton-on-Tees 014E","E01012266","Total",161,48,27,86,26,5,8,13,135,43,19,73
"2011","Stockton-on-Tees 014F","E01012267","Total",74,13,10,51,4,0,2,2,70,13,8,49
"2011","Stockton-on-Tees 014G","E01033477","Total",83,23,16,44,4,1,2,1,79,22,14,43
"2011","Stockton-on-Tees 015A","E01012190","Total",37,21,7,9,2,0,1,1,35,21,6,8
"2011","Stockton-on-Tees 015B","E01012191","Total",49,16,18,15,7,0,6,1,42,16,12,14
"2011","Stockton-on-Tees 015C","E01012224","Total",32,12,14,6,6,0,6,0,26,12,8,6
"2011","Stockton-on-Tees 015D","E01012225","Total",27,8,13,6,3,0,3,0,24,8,10,6
"2011","Stockton-on-Tees 015E","E01012226","Total",23,11,11,1,3,0,3,0,20,11,8,1
"2011","Stockton-on-Tees 016A","E01012209","Total",28,7,10,11,3,0,3,0,25,7,7,11
"2011","Stockton-on-Tees 016B","E01012217","Total",80,24,12,44,3,0,0,3,77,24,12,41
"2011","Stockton-on-Tees 016C","E01012218","Total",45,11,17,17,5,1,4,0,40,10,13,17
"2011","Stockton-on-Tees 016D","E01012223","Total",20,7,9,4,2,0,2,0,18,7,7,4
"2011","Stockton-on-Tees 017A","E01012286","Total",107,26,9,72,8,1,0,7,99,25,9,65
"2011","Stockton-on-Tees 017B","E01012287","Total",69,24,11,34,6,0,4,2,63,24,7,32
"2011","Stockton-on-Tees 017C","E01012288","Total",100,33,18,49,5,0,2,3,95,33,16,46
"2011","Stockton-on-Tees 017D","E01012289","Total",44,6,12,26,6,2,1,3,38,4,11,23
"2011","Stockton-on-Tees 018A","E01012238","Total",85,31,22,32,5,0,2,3,80,31,20,29
"2011","Stockton-on-Tees 018B","E01012239","Total",135,44,37,54,8,0,5,3,127,44,32,51
"2011","Stockton-on-Tees 018C","E01012240","Total",70,23,21,26,4,1,3,0,66,22,18,26
"2011","Stockton-on-Tees 018D","E01012241","Total",37,18,13,6,7,1,4,2,30,17,9,4
"2011","Stockton-on-Tees 019A","E01012290","Total",37,17,11,9,2,0,2,0,35,17,9,9
"2011","Stockton-on-Tees 019B","E01012291","Total",84,27,12,45,11,3,2,6,73,24,10,39
"2011","Stockton-on-Tees 019C","E01012292","Total",103,39,34,30,9,0,8,1,94,39,26,29
"2011","Stockton-on-Tees 020A","E01012282","Total",75,34,4,37,6,2,1,3,69,32,3,34
"2011","Stockton-on-Tees 020B","E01012283","Total",86,35,10,41,7,4,3,0,79,31,7,41
"2011","Stockton-on-Tees 020C","E01012284","Total",76,20,10,46,5,0,1,4,71,20,9,42
"2011","Stockton-on-Tees 020D","E01012285","Total",42,16,8,18,5,1,2,2,37,15,6,16
"2011","Stockton-on-Tees 021A","E01012199","Total",25,7,10,8,1,0,0,1,24,7,10,7
"2011","Stockton-on-Tees 021B","E01012200","Total",55,22,20,13,5,0,4,1,50,22,16,12
"2011","Stockton-on-Tees 021C","E01012201","Total",43,22,16,5,4,0,3,1,39,22,13,4
"2011","Stockton-on-Tees 021D","E01012202","Total",36,17,8,11,3,0,1,2,33,17,7,9
"2011","Stockton-on-Tees 021E","E01012203","Total",52,21,20,11,1,0,0,1,51,21,20,10
"2011","Stockton-on-Tees 021F","E01012270","Total",38,14,13,11,1,0,1,0,37,14,12,11
"2011","Stockton-on-Tees 022A","E01012228","Total",32,12,15,5,5,0,3,2,27,12,12,3
"2011","Stockton-on-Tees 022B","E01012230","Total",55,23,22,10,8,0,7,1,47,23,15,9
"2011","Stockton-on-Tees 022C","E01012233","Total",19,6,8,5,2,1,1,0,17,5,7,5
"2011","Stockton-on-Tees 022D","E01012236","Total",32,14,13,5,4,0,3,1,28,14,10,4
"2011","Stockton-on-Tees 022E","E01012237","Total",20,7,10,3,2,1,1,0,18,6,9,3
"2011","Stockton-on-Tees 023A","E01012227","Total",70,29,32,9,5,0,5,0,65,29,27,9
"2011","Stockton-on-Tees 023C","E01012231","Total",58,27,26,5,6,2,4,0,52,25,22,5
"2011","Stockton-on-Tees 023D","E01012232","Total",51,26,20,5,10,1,8,1,41,25,12,4
"2011","Stockton-on-Tees 023E","E01012234","Total",35,11,19,5,3,0,3,0,32,11,16,5
"2011","Stockton-on-Tees 023F","E01033474","Total",55,24,20,11,3,0,1,2,52,24,19,9
"2011","Stockton-on-Tees 023G","E01033475","Total",32,9,17,6,6,0,5,1,26,9,12,5
"2011","Stockton-on-Tees 023H","E01033478","Total",30,12,16,2,5,0,5,0,25,12,11,2
"2011","Stockton-on-Tees 023I","E01033479","Total",44,21,15,8,4,0,4,0,40,21,11,8
"2011","Stockton-on-Tees 024A","E01012235","Total",5,2,3,0,2,0,2,0,3,2,1,0
"2011","Stockton-on-Tees 024B","E01012298","Total",13,5,6,2,1,0,1,0,12,5,5,2
"2011","Stockton-on-Tees 024C","E01012299","Total",54,21,27,6,9,2,7,0,45,19,20,6
"2011","Stockton-on-Tees 024D","E01012300","Total",53,23,14,16,2,1,1,0,51,22,13,16
"2011","Stockton-on-Tees 024E","E01012301","Total",28,11,13,4,5,1,4,0,23,10,9,4
"2011","Stockton-on-Tees 024F","E01012302","Total",32,11,15,6,1,0,1,0,31,11,14,6
"2011","Stockton-on-Tees 024G","E01012303","Total",25,10,8,7,3,0,3,0,22,10,5,7
"2011","Gateshead 001A","E01008246","Total",60,24,14,22,6,0,2,4,54,24,12,18
"2011","Gateshead 001B","E01008247","Total",61,18,14,29,3,0,2,1,58,18,12,28
"2011","Gateshead 001C","E01008248","Total",31,13,12,6,5,1,4,0,26,12,8,6
"2011","Gateshead 001D","E01008249","Total",21,11,7,3,4,1,3,0,17,10,4,3
"2011","Gateshead 001E","E01008250","Total",50,23,14,13,2,0,1,1,48,23,13,12
"2011","Gateshead 002A","E01008195","Total",65,27,12,26,5,0,2,3,60,27,10,23
"2011","Gateshead 002B","E01008197","Total",28,12,14,2,7,2,5,0,21,10,9,2
"2011","Gateshead 002C","E01008198","Total",56,26,11,19,3,0,3,0,53,26,8,19
"2011","Gateshead 002D","E01008199","Total",35,9,16,10,1,0,0,1,34,9,16,9
"2011","Gateshead 002E","E01008200","Total",26,14,8,4,5,0,5,0,21,14,3,4
"2011","Gateshead 002F","E01008245","Total",26,9,13,4,6,1,4,1,20,8,9,3
"2011","Gateshead 003A","E01008214","Total",126,35,15,76,9,2,2,5,117,33,13,71
"2011","Gateshead 003B","E01008215","Total",80,18,9,53,11,1,6,4,69,17,3,49
"2011","Gateshead 003C","E01008243","Total",39,8,18,13,3,0,1,2,36,8,17,11
"2011","Gateshead 003D","E01008244","Total",101,34,28,39,9,5,2,2,92,29,26,37
"2011","Gateshead 004A","E01008178","Total",90,26,18,46,7,1,3,3,83,25,15,43
"2011","Gateshead 004B","E01008180","Total",101,34,14,53,7,0,0,7,94,34,14,46
"2011","Gateshead 004C","E01008182","Total",76,28,21,27,7,1,4,2,69,27,17,25
"2011","Gateshead 004D","E01008277","Total",37,11,9,17,2,0,1,1,35,11,8,16
"2011","Gateshead 004E","E01008280","Total",71,25,17,29,10,2,4,4,61,23,13,25
"2011","Gateshead 005A","E01008177","Total",41,10,12,19,6,1,4,1,35,9,8,18
"2011","Gateshead 005B","E01008179","Total",32,13,12,7,1,0,1,0,31,13,11,7
"2011","Gateshead 005C","E01008181","Total",43,16,10,17,6,2,4,0,37,14,6,17
"2011","Gateshead 005D","E01008276","Total",43,16,8,19,5,0,4,1,38,16,4,18
"2011","Gateshead 005E","E01008279","Total",5,3,1,1,1,0,1,0,4,3,0,1
"2011","Gateshead 007A","E01008209","Total",94,29,24,41,5,1,2,2,89,28,22,39
"2011","Gateshead 007B","E01008210","Total",65,23,12,30,2,0,1,1,63,23,11,29
"2011","Gateshead 007C","E01008258","Total",133,35,19,79,11,1,2,8,122,34,17,71
"2011","Gateshead 007D","E01008259","Total",67,23,6,38,7,1,2,4,60,22,4,34
"2011","Gateshead 008A","E01008167","Total",51,10,7,34,6,1,0,5,45,9,7,29
"2011","Gateshead 008B","E01008169","Total",26,8,3,15,6,0,1,5,20,8,2,10
"2011","Gateshead 008C","E01008170","Total",74,24,13,37,7,1,4,2,67,23,9,35
"2011","Gateshead 008D","E01008171","Total",59,13,11,35,5,0,2,3,54,13,9,32
"2011","Gateshead 008E","E01008257","Total",58,27,8,23,4,0,1,3,54,27,7,20
"2011","Gateshead 009A","E01008262","Total",72,21,19,32,3,0,2,1,69,21,17,31
"2011","Gateshead 009B","E01008263","Total",100,44,24,32,6,0,6,0,94,44,18,32
"2011","Gateshead 009C","E01008264","Total",10,4,6,0,0,0,0,0,10,4,6,0
"2011","Gateshead 009D","E01008265","Total",71,22,23,26,7,3,2,2,64,19,21,24
"2011","Gateshead 009E","E01008266","Total",20,7,7,6,2,0,2,0,18,7,5,6
"2011","Gateshead 010A","E01008251","Total",53,15,13,25,4,0,2,2,49,15,11,23
"2011","Gateshead 010B","E01008252","Total",52,18,15,19,8,1,5,2,44,17,10,17
"2011","Gateshead 010C","E01008253","Total",76,24,18,34,6,0,4,2,70,24,14,32
"2011","Gateshead 010D","E01008254","Total",61,22,4,35,6,0,1,5,55,22,3,30
"2011","Gateshead 010E","E01008255","Total",58,28,13,17,13,8,5,0,45,20,8,17
"2011","Gateshead 011A","E01008165","Total",71,21,10,40,7,3,3,1,64,18,7,39
"2011","Gateshead 011B","E01008201","Total",96,20,11,65,10,0,2,8,86,20,9,57
"2011","Gateshead 011C","E01008202","Total",101,39,16,46,8,0,3,5,93,39,13,41
"2011","Gateshead 011D","E01008204","Total",108,33,17,58,16,1,5,10,92,32,12,48
"2011","Gateshead 012A","E01008212","Total",89,27,16,46,4,0,1,3,85,27,15,43
"2011","Gateshead 012B","E01008213","Total",37,9,12,16,3,2,1,0,34,7,11,16
"2011","Gateshead 012C","E01008216","Total",59,16,6,37,10,0,1,9,49,16,5,28
"2011","Gateshead 012D","E01008228","Total",61,19,11,31,6,0,0,6,55,19,11,25
"2011","Gateshead 013A","E01008206","Total",47,22,10,15,4,0,4,0,43,22,6,15
"2011","Gateshead 013B","E01008207","Total",23,8,8,7,4,1,2,1,19,7,6,6
"2011","Gateshead 013C","E01008208","Total",72,23,24,25,5,1,3,1,67,22,21,24
"2011","Gateshead 013D","E01008211","Total",61,20,21,20,7,0,6,1,54,20,15,19
"2011","Gateshead 014A","E01008283","Total",15,4,9,2,0,0,0,0,15,4,9,2
"2011","Gateshead 014B","E01008284","Total",43,16,9,18,4,0,0,4,39,16,9,14
"2011","Gateshead 014C","E01008286","Total",61,19,15,27,7,0,5,2,54,19,10,25
"2011","Gateshead 014D","E01008287","Total",44,17,19,8,5,0,4,1,39,17,15,7
"2011","Gateshead 015A","E01008231","Total",98,38,9,51,2,0,1,1,96,38,8,50
"2011","Gateshead 015B","E01008240","Total",51,13,14,24,2,0,1,1,49,13,13,23
"2011","Gateshead 015C","E01008241","Total",69,25,12,32,5,1,2,2,64,24,10,30
"2011","Gateshead 015D","E01008242","Total",92,33,16,43,5,0,2,3,87,33,14,40
"2011","Gateshead 015E","E01008281","Total",78,32,18,28,6,0,4,2,72,32,14,26
"2011","Gateshead 015F","E01008282","Total",78,33,11,34,2,0,1,1,76,33,10,33
"2011","Gateshead 016A","E01008219","Total",53,13,17,23,4,0,3,1,49,13,14,22
"2011","Gateshead 016B","E01008235","Total",31,12,9,10,2,0,2,0,29,12,7,10
"2011","Gateshead 016C","E01008236","Total",42,11,19,12,3,0,2,1,39,11,17,11
"2011","Gateshead 016D","E01008237","Total",21,7,13,1,1,1,0,0,20,6,13,1
"2011","Gateshead 016E","E01008238","Total",28,10,16,2,2,0,2,0,26,10,14,2
"2011","Gateshead 017A","E01008267","Total",30,9,10,11,4,1,3,0,26,8,7,11
"2011","Gateshead 017B","E01008269","Total",13,4,6,3,1,0,0,1,12,4,6,2
"2011","Gateshead 017C","E01008270","Total",16,6,8,2,0,0,0,0,16,6,8,2
"2011","Gateshead 017D","E01008271","Total",21,6,11,4,4,0,3,1,17,6,8,3
"2011","Gateshead 017E","E01008275","Total",29,7,18,4,0,0,0,0,29,7,18,4
"2011","Gateshead 018A","E01008229","Total",26,11,8,7,1,0,0,1,25,11,8,6
"2011","Gateshead 018B","E01008230","Total",34,17,5,12,3,1,2,0,31,16,3,12
"2011","Gateshead 018C","E01008232","Total",77,34,13,30,7,1,3,3,70,33,10,27
"2011","Gateshead 018D","E01008233","Total",16,6,4,6,1,0,1,0,15,6,3,6
"2011","Gateshead 018E","E01008285","Total",91,28,18,45,5,0,3,2,86,28,15,43
"2011","Gateshead 019A","E01008256","Total",47,17,16,14,1,0,1,0,46,17,15,14
"2011","Gateshead 019B","E01008260","Total",25,11,10,4,4,0,4,0,21,11,6,4
"2011","Gateshead 019C","E01008261","Total",72,25,20,27,4,0,3,1,68,25,17,26
"2011","Gateshead 019D","E01008268","Total",48,14,19,15,3,1,2,0,45,13,17,15
"2011","Gateshead 019E","E01008272","Total",21,8,8,5,0,0,0,0,21,8,8,5
"2011","Gateshead 019F","E01008273","Total",43,26,12,5,7,2,4,1,36,24,8,4
"2011","Gateshead 019G","E01008274","Total",79,32,23,24,8,0,6,2,71,32,17,22
"2011","Gateshead 020A","E01008193","Total",16,9,5,2,2,1,1,0,14,8,4,2
"2011","Gateshead 020B","E01008194","Total",17,4,10,3,2,0,0,2,15,4,10,1
"2011","Gateshead 020C","E01008234","Total",29,9,15,5,3,0,3,0,26,9,12,5
"2011","Gateshead 020D","E01008239","Total",21,10,6,5,1,0,1,0,20,10,5,5
"2011","Gateshead 021A","E01008218","Total",64,30,11,23,4,0,3,1,60,30,8,22
"2011","Gateshead 021B","E01008220","Total",92,28,12,52,8,1,2,5,84,27,10,47
"2011","Gateshead 021C","E01008221","Total",73,28,10,35,6,1,2,3,67,27,8,32
"2011","Gateshead 021D","E01008225","Total",45,15,12,18,4,0,3,1,41,15,9,17
"2011","Gateshead 021E","E01008227","Total",145,45,22,78,12,0,6,6,133,45,16,72
"2011","Gateshead 022A","E01008184","Total",11,3,4,4,2,0,2,0,9,3,2,4
"2011","Gateshead 022B","E01008185","Total",65,18,17,30,5,1,2,2,60,17,15,28
"2011","Gateshead 022C","E01008188","Total",36,13,15,8,3,0,3,0,33,13,12,8
"2011","Gateshead 022D","E01008278","Total",12,2,6,4,0,0,0,0,12,2,6,4
"2011","Gateshead 023A","E01008189","Total",46,19,9,18,3,0,2,1,43,19,7,17
"2011","Gateshead 023B","E01008190","Total",23,5,12,6,1,0,0,1,22,5,12,5
"2011","Gateshead 023C","E01008191","Total",60,28,14,18,5,0,4,1,55,28,10,17
"2011","Gateshead 023D","E01008192","Total",52,20,18,14,2,0,1,1,50,20,17,13
"2011","Gateshead 023E","E01008217","Total",73,29,18,26,1,0,0,1,72,29,18,25
"2011","Gateshead 024A","E01008183","Total",69,20,14,35,9,2,2,5,60,18,12,30
"2011","Gateshead 024B","E01008186","Total",96,24,20,52,11,3,1,7,85,21,19,45
"2011","Gateshead 024C","E01008187","Total",56,22,12,22,3,2,1,0,53,20,11,22
"2011","Gateshead 024D","E01008196","Total",50,16,16,18,1,0,1,0,49,16,15,18
"2011","Gateshead 025A","E01008222","Total",61,22,19,20,8,1,4,3,53,21,15,17
"2011","Gateshead 025B","E01008223","Total",119,36,24,59,12,1,4,7,107,35,20,52
"2011","Gateshead 025C","E01008224","Total",51,20,18,13,2,0,2,0,49,20,16,13
"2011","Gateshead 025D","E01008226","Total",49,17,8,24,7,2,1,4,42,15,7,20
"2011","Gateshead 026A","E01008172","Total",55,27,14,14,2,0,2,0,53,27,12,14
"2011","Gateshead 026B","E01008173","Total",89,25,19,45,9,0,2,7,80,25,17,38
"2011","Gateshead 026C","E01008174","Total",61,21,14,26,7,1,4,2,54,20,10,24
"2011","Gateshead 026D","E01008175","Total",44,14,13,17,4,1,1,2,40,13,12,15
"2011","Gateshead 026E","E01008176","Total",40,14,10,16,6,0,4,2,34,14,6,14
"2011","Gateshead 027A","E01008162","Total",72,17,19,36,6,0,5,1,66,17,14,35
"2011","Gateshead 027B","E01008164","Total",47,11,9,27,5,1,3,1,42,10,6,26
"2011","Gateshead 027C","E01008166","Total",26,8,3,15,2,0,0,2,24,8,3,13
"2011","Gateshead 027D","E01008168","Total",49,20,8,21,6,1,5,0,43,19,3,21
"2011","Gateshead 028A","E01008163","Total",60,17,17,26,4,1,2,1,56,16,15,25
"2011","Gateshead 028B","E01008203","Total",74,22,17,35,9,2,4,3,65,20,13,32
"2011","Gateshead 028C","E01008205","Total",20,7,10,3,1,0,1,0,19,7,9,3
"2011","Newcastle upon Tyne 001A","E01008294","Total",28,11,11,6,3,0,2,1,25,11,9,5
"2011","Newcastle upon Tyne 001B","E01008306","Total",46,16,11,19,8,3,3,2,38,13,8,17
"2011","Newcastle upon Tyne 001C","E01008307","Total",59,25,14,20,4,1,2,1,55,24,12,19
"2011","Newcastle upon Tyne 001D","E01008308","Total",51,17,18,16,4,0,0,4,47,17,18,12
"2011","Newcastle upon Tyne 001E","E01008311","Total",27,9,13,5,2,1,1,0,25,8,12,5
"2011","Newcastle upon Tyne 001F","E01008312","Total",35,12,16,7,4,0,2,2,31,12,14,5
"2011","Newcastle upon Tyne 001G","E01008313","Total",26,9,12,5,4,0,3,1,22,9,9,4
"2011","Newcastle upon Tyne 002A","E01008309","Total",20,3,15,2,3,0,3,0,17,3,12,2
"2011","Newcastle upon Tyne 002C","E01008352","Total",44,15,14,15,5,2,2,1,39,13,12,14
"2011","Newcastle upon Tyne 002D","E01008357","Total",19,9,6,4,1,1,0,0,18,8,6,4
"2011","Newcastle upon Tyne 002E","E01008358","Total",48,20,17,11,5,1,2,2,43,19,15,9
"2011","Newcastle upon Tyne 002F","E01033550","Total",28,9,13,6,3,1,2,0,25,8,11,6
"2011","Newcastle upon Tyne 002G","E01033551","Total",13,4,8,1,3,2,1,0,10,2,7,1
"2011","Newcastle upon Tyne 003A","E01008336","Total",61,23,12,26,4,0,1,3,57,23,11,23
"2011","Newcastle upon Tyne 003B","E01008337","Total",80,24,11,45,10,1,4,5,70,23,7,40
"2011","Newcastle upon Tyne 003C","E01008338","Total",49,17,10,22,9,2,3,4,40,15,7,18
"2011","Newcastle upon Tyne 003D","E01008339","Total",72,22,8,42,9,1,2,6,63,21,6,36
"2011","Newcastle upon Tyne 003E","E01008340","Total",118,42,18,58,9,1,4,4,109,41,14,54
"2011","Newcastle upon Tyne 003F","E01008341","Total",61,22,11,28,5,0,3,2,56,22,8,26
"2011","Newcastle upon Tyne 003G","E01008342","Total",22,12,8,2,5,2,3,0,17,10,5,2
"2011","Newcastle upon Tyne 004A","E01008293","Total",47,19,19,9,5,0,4,1,42,19,15,8
"2011","Newcastle upon Tyne 004B","E01008456","Total",98,40,15,43,7,1,1,5,91,39,14,38
"2011","Newcastle upon Tyne 004C","E01008457","Total",83,23,19,41,11,3,3,5,72,20,16,36
"2011","Newcastle upon Tyne 004D","E01008458","Total",22,11,8,3,4,1,3,0,18,10,5,3
"2011","Newcastle upon Tyne 004E","E01008459","Total",164,46,20,98,15,0,4,11,149,46,16,87
"2011","Newcastle upon Tyne 004F","E01008460","Total",74,22,9,43,6,0,3,3,68,22,6,40
"2011","Newcastle upon Tyne 005A","E01008351","Total",34,9,12,13,7,0,5,2,27,9,7,11
"2011","Newcastle upon Tyne 005B","E01008354","Total",41,10,16,15,7,0,6,1,34,10,10,14
"2011","Newcastle upon Tyne 005C","E01008418","Total",19,6,9,4,1,0,1,0,18,6,8,4
"2011","Newcastle upon Tyne 005D","E01008420","Total",23,4,12,7,4,0,2,2,19,4,10,5
"2011","Newcastle upon Tyne 005E","E01008422","Total",19,7,8,4,3,0,2,1,16,7,6,3
"2011","Newcastle upon Tyne 005F","E01008424","Total",26,5,10,11,6,0,5,1,20,5,5,10
"2011","Newcastle upon Tyne 006A","E01008353","Total",61,19,11,31,6,2,2,2,55,17,9,29
"2011","Newcastle upon Tyne 006B","E01008355","Total",25,8,11,6,3,0,3,0,22,8,8,6
"2011","Newcastle upon Tyne 006C","E01008356","Total",29,10,8,11,7,2,4,1,22,8,4,10
"2011","Newcastle upon Tyne 006D","E01008378","Total",12,4,5,3,1,0,1,0,11,4,4,3
"2011","Newcastle upon Tyne 006E","E01008419","Total",17,5,7,5,3,0,2,1,14,5,5,4
"2011","Newcastle upon Tyne 006F","E01008421","Total",22,7,11,4,3,0,3,0,19,7,8,4
"2011","Newcastle upon Tyne 006G","E01008423","Total",12,2,8,2,2,0,2,0,10,2,6,2
"2011","Newcastle upon Tyne 007A","E01008317","Total",17,3,8,6,5,0,2,3,12,3,6,3
"2011","Newcastle upon Tyne 007B","E01008319","Total",29,14,12,3,2,1,1,0,27,13,11,3
"2011","Newcastle upon Tyne 007C","E01008320","Total",26,12,6,8,1,1,0,0,25,11,6,8
"2011","Newcastle upon Tyne 007D","E01008321","Total",27,9,14,4,7,1,4,2,20,8,10,2
"2011","Newcastle upon Tyne 007E","E01008322","Total",20,6,8,6,4,1,3,0,16,5,5,6
"2011","Newcastle upon Tyne 007F","E01008323","Total",32,9,15,8,5,0,4,1,27,9,11,7
"2011","Newcastle upon Tyne 008A","E01008295","Total",127,34,21,72,11,2,6,3,116,32,15,69
"2011","Newcastle upon Tyne 008B","E01008374","Total",33,9,9,15,6,3,2,1,27,6,7,14
"2011","Newcastle upon Tyne 008C","E01008375","Total",65,21,12,32,6,1,1,4,59,20,11,28
"2011","Newcastle upon Tyne 008D","E01008376","Total",10,2,5,3,0,0,0,0,10,2,5,3
"2011","Newcastle upon Tyne 008E","E01008377","Total",115,27,24,64,16,0,9,7,99,27,15,57
"2011","Newcastle upon Tyne 008F","E01008379","Total",53,15,12,26,4,2,0,2,49,13,12,24
"2011","Newcastle upon Tyne 008G","E01008380","Total",117,33,10,74,8,1,1,6,109,32,9,68
"2011","Newcastle upon Tyne 011A","E01008296","Total",44,16,8,20,2,0,2,0,42,16,6,20
"2011","Newcastle upon Tyne 011B","E01008297","Total",56,16,10,30,4,0,0,4,52,16,10,26
"2011","Newcastle upon Tyne 011C","E01008298","Total",52,16,13,23,8,0,6,2,44,16,7,21
"2011","Newcastle upon Tyne 011D","E01008299","Total",64,23,11,30,7,0,4,3,57,23,7,27
"2011","Newcastle upon Tyne 012A","E01008314","Total",26,13,9,4,1,0,1,0,25,13,8,4
"2011","Newcastle upon Tyne 012B","E01008315","Total",44,14,12,18,2,0,0,2,42,14,12,16
"2011","Newcastle upon Tyne 012C","E01008316","Total",31,14,15,2,4,2,2,0,27,12,13,2
"2011","Newcastle upon Tyne 012D","E01008318","Total",50,24,10,16,1,1,0,0,49,23,10,16
"2011","Newcastle upon Tyne 012E","E01008363","Total",30,7,13,10,4,0,3,1,26,7,10,9
"2011","Newcastle upon Tyne 012F","E01008365","Total",9,1,7,1,0,0,0,0,9,1,7,1
"2011","Newcastle upon Tyne 013A","E01008366","Total",4,0,2,2,0,0,0,0,4,0,2,2
"2011","Newcastle upon Tyne 013B","E01008369","Total",6,1,3,2,1,0,1,0,5,1,2,2
"2011","Newcastle upon Tyne 013C","E01008371","Total",7,3,2,2,0,0,0,0,7,3,2,2
"2011","Newcastle upon Tyne 013D","E01008372","Total",8,1,3,4,1,0,1,0,7,1,2,4
"2011","Newcastle upon Tyne 013E","E01008373","Total",9,4,3,2,1,0,1,0,8,4,2,2
"2011","Newcastle upon Tyne 014A","E01008400","Total",57,18,9,30,9,1,3,5,48,17,6,25
"2011","Newcastle upon Tyne 014B","E01008401","Total",63,23,11,29,1,0,0,1,62,23,11,28
"2011","Newcastle upon Tyne 014C","E01008402","Total",59,21,14,24,10,0,3,7,49,21,11,17
"2011","Newcastle upon Tyne 014D","E01008403","Total",35,10,12,13,8,1,6,1,27,9,6,12
"2011","Newcastle upon Tyne 014E","E01008404","Total",60,22,16,22,4,3,1,0,56,19,15,22
"2011","Newcastle upon Tyne 014F","E01008405","Total",77,30,13,34,6,0,2,4,71,30,11,30
"2011","Newcastle upon Tyne 014G","E01008443","Total",23,11,10,2,2,0,2,0,21,11,8,2
"2011","Newcastle upon Tyne 015A","E01008324","Total",76,28,17,31,2,0,1,1,74,28,16,30
"2011","Newcastle upon Tyne 015B","E01008325","Total",68,22,19,27,8,0,5,3,60,22,14,24
"2011","Newcastle upon Tyne 015C","E01008326","Total",35,13,16,6,2,0,2,0,33,13,14,6
"2011","Newcastle upon Tyne 015D","E01008327","Total",98,27,14,57,6,1,2,3,92,26,12,54
"2011","Newcastle upon Tyne 015E","E01008328","Total",15,8,6,1,1,0,1,0,14,8,5,1
"2011","Newcastle upon Tyne 015F","E01008329","Total",54,20,18,16,3,1,1,1,51,19,17,15
"2011","Newcastle upon Tyne 015G","E01008330","Total",93,31,12,50,9,0,2,7,84,31,10,43
"2011","Newcastle upon Tyne 016A","E01008300","Total",84,27,12,45,4,0,0,4,80,27,12,41
"2011","Newcastle upon Tyne 016B","E01008450","Total",114,40,14,60,15,2,4,9,99,38,10,51
"2011","Newcastle upon Tyne 016C","E01008451","Total",81,24,13,44,8,0,1,7,73,24,12,37
"2011","Newcastle upon Tyne 016D","E01008452","Total",24,8,14,2,4,1,3,0,20,7,11,2
"2011","Newcastle upon Tyne 017A","E01008367","Total",4,2,1,1,1,0,1,0,3,2,0,1
"2011","Newcastle upon Tyne 017B","E01008368","Total",1,0,1,0,0,0,0,0,1,0,1,0
"2011","Newcastle upon Tyne 017C","E01008370","Total",11,3,6,2,0,0,0,0,11,3,6,2
"2011","Newcastle upon Tyne 017D","E01008409","Total",17,4,7,6,1,0,1,0,16,4,6,6
"2011","Newcastle upon Tyne 017E","E01008411","Total",18,6,5,7,2,0,1,1,16,6,4,6
"2011","Newcastle upon Tyne 018A","E01008303","Total",67,21,13,33,4,2,2,0,63,19,11,33
"2011","Newcastle upon Tyne 018B","E01008359","Total",23,10,5,8,1,0,1,0,22,10,4,8
"2011","Newcastle upon Tyne 018C","E01008360","Total",22,7,5,10,3,0,3,0,19,7,2,10
"2011","Newcastle upon Tyne 018D","E01008361","Total",38,11,7,20,5,0,3,2,33,11,4,18
"2011","Newcastle upon Tyne 018E","E01008362","Total",22,5,7,10,2,0,2,0,20,5,5,10
"2011","Newcastle upon Tyne 018F","E01008364","Total",19,4,6,9,4,0,2,2,15,4,4,7
"2011","Newcastle upon Tyne 019A","E01008343","Total",36,16,12,8,4,1,2,1,32,15,10,7
"2011","Newcastle upon Tyne 019B","E01008344","Total",57,22,10,25,6,0,3,3,51,22,7,22
"2011","Newcastle upon Tyne 019C","E01008345","Total",105,25,16,64,5,0,3,2,100,25,13,62
"2011","Newcastle upon Tyne 019D","E01008346","Total",41,12,9,20,4,0,4,0,37,12,5,20
"2011","Newcastle upon Tyne 019E","E01008347","Total",26,9,4,13,7,4,2,1,19,5,2,12
"2011","Newcastle upon Tyne 019F","E01008348","Total",58,17,9,32,6,0,3,3,52,17,6,29
"2011","Newcastle upon Tyne 019G","E01008349","Total",28,14,2,12,6,5,0,1,22,9,2,11
"2011","Newcastle upon Tyne 019H","E01008350","Total",57,17,18,22,9,1,4,4,48,16,14,18
"2011","Newcastle upon Tyne 020A","E01008430","Total",58,17,13,28,6,1,2,3,52,16,11,25
"2011","Newcastle upon Tyne 020B","E01008431","Total",47,21,15,11,3,0,3,0,44,21,12,11
"2011","Newcastle upon Tyne 020C","E01008433","Total",18,6,6,6,5,0,2,3,13,6,4,3
"2011","Newcastle upon Tyne 020D","E01008434","Total",20,5,7,8,3,0,2,1,17,5,5,7
"2011","Newcastle upon Tyne 020E","E01008435","Total",78,32,7,39,2,0,1,1,76,32,6,38
"2011","Newcastle upon Tyne 020F","E01008436","Total",61,18,12,31,8,0,3,5,53,18,9,26
"2011","Newcastle upon Tyne 021A","E01008381","Total",32,13,13,6,1,1,0,0,31,12,13,6
"2011","Newcastle upon Tyne 021B","E01008382","Total",86,25,22,39,12,1,7,4,74,24,15,35
"2011","Newcastle upon Tyne 021C","E01008383","Total",111,45,20,46,5,0,2,3,106,45,18,43
"2011","Newcastle upon Tyne 021D","E01008384","Total",50,20,11,19,3,0,2,1,47,20,9,18
"2011","Newcastle upon Tyne 021E","E01008385","Total",77,18,18,41,9,0,2,7,68,18,16,34
"2011","Newcastle upon Tyne 021F","E01008386","Total",45,16,12,17,4,1,3,0,41,15,9,17
"2011","Newcastle upon Tyne 021G","E01008387","Total",27,7,7,13,1,0,1,0,26,7,6,13
"2011","Newcastle upon Tyne 022B","E01008396","Total",47,12,4,31,7,2,2,3,40,10,2,28
"2011","Newcastle upon Tyne 022C","E01008398","Total",61,20,6,35,5,4,0,1,56,16,6,34
"2011","Newcastle upon Tyne 022D","E01008449","Total",28,5,6,17,6,1,0,5,22,4,6,12
"2011","Newcastle upon Tyne 022E","E01008453","Total",19,6,4,9,3,1,2,0,16,5,2,9
"2011","Newcastle upon Tyne 022G","E01008455","Total",27,7,4,16,1,0,1,0,26,7,3,16
"2011","Newcastle upon Tyne 022H","E01033556","Total",36,13,5,18,2,0,0,2,34,13,5,16
"2011","Newcastle upon Tyne 023A","E01008406","Total",44,7,8,29,6,0,2,4,38,7,6,25
"2011","Newcastle upon Tyne 023B","E01008407","Total",30,7,9,14,5,0,4,1,25,7,5,13
"2011","Newcastle upon Tyne 023D","E01008410","Total",31,11,10,10,1,0,1,0,30,11,9,10
"2011","Newcastle upon Tyne 023E","E01008412","Total",28,10,11,7,2,0,2,0,26,10,9,7
"2011","Newcastle upon Tyne 023F","E01008413","Total",22,9,6,7,2,1,1,0,20,8,5,7
"2011","Newcastle upon Tyne 023G","E01033548","Total",19,5,2,12,1,0,0,1,18,5,2,11
"2011","Newcastle upon Tyne 023H","E01033553","Total",18,7,4,7,3,1,0,2,15,6,4,5
"2011","Newcastle upon Tyne 024A","E01008394","Total",5,2,1,2,1,1,0,0,4,1,1,2
"2011","Newcastle upon Tyne 024B","E01008395","Total",25,3,3,19,3,0,2,1,22,3,1,18
"2011","Newcastle upon Tyne 024C","E01008397","Total",5,2,1,2,0,0,0,0,5,2,1,2
"2011","Newcastle upon Tyne 024D","E01008399","Total",95,23,9,63,7,1,0,6,88,22,9,57
"2011","Newcastle upon Tyne 024E","E01008439","Total",124,41,15,68,14,0,4,10,110,41,11,58
"2011","Newcastle upon Tyne 024G","E01033543","Total",4,1,1,2,2,0,1,1,2,1,0,1
"2011","Newcastle upon Tyne 024H","E01033545","Total",5,0,2,3,1,0,1,0,4,0,1,3
"2011","Newcastle upon Tyne 024I","E01033554","Total",6,1,1,4,2,0,1,1,4,1,0,3
"2011","Newcastle upon Tyne 025B","E01008415","Total",81,23,11,47,5,1,3,1,76,22,8,46
"2011","Newcastle upon Tyne 025C","E01008416","Total",41,11,14,16,0,0,0,0,41,11,14,16
"2011","Newcastle upon Tyne 025E","E01033547","Total",148,41,14,93,9,0,5,4,139,41,9,89
"2011","Newcastle upon Tyne 026A","E01008301","Total",80,28,8,44,7,0,1,6,73,28,7,38
"2011","Newcastle upon Tyne 026B","E01008302","Total",99,31,14,54,2,0,2,0,97,31,12,54
"2011","Newcastle upon Tyne 026C","E01008304","Total",102,27,14,61,11,2,2,7,91,25,12,54
"2011","Newcastle upon Tyne 026D","E01008305","Total",149,54,13,82,12,3,2,7,137,51,11,75
"2011","Newcastle upon Tyne 026E","E01008391","Total",110,31,13,66,6,0,2,4,104,31,11,62
"2011","Newcastle upon Tyne 026F","E01008392","Total",75,18,18,39,9,1,3,5,66,17,15,34
"2011","Newcastle upon Tyne 026G","E01008432","Total",48,10,16,22,4,1,2,1,44,9,14,21
"2011","Newcastle upon Tyne 027A","E01008288","Total",58,17,17,24,6,0,3,3,52,17,14,21
"2011","Newcastle upon Tyne 027B","E01008289","Total",86,29,14,43,3,1,0,2,83,28,14,41
"2011","Newcastle upon Tyne 027C","E01008290","Total",75,27,10,38,9,1,3,5,66,26,7,33
"2011","Newcastle upon Tyne 027D","E01008291","Total",156,49,15,92,15,1,3,11,141,48,12,81
"2011","Newcastle upon Tyne 027E","E01008292","Total",20,8,6,6,0,0,0,0,20,8,6,6
"2011","Newcastle upon Tyne 028A","E01008388","Total",134,43,16,75,14,3,2,9,120,40,14,66
"2011","Newcastle upon Tyne 028B","E01008389","Total",143,37,23,83,9,2,3,4,134,35,20,79
"2011","Newcastle upon Tyne 028C","E01008426","Total",130,44,11,75,11,5,3,3,119,39,8,72
"2011","Newcastle upon Tyne 028D","E01008429","Total",90,33,16,41,4,0,0,4,86,33,16,37
"2011","Newcastle upon Tyne 029A","E01008331","Total",66,11,11,44,8,1,1,6,58,10,10,38
"2011","Newcastle upon Tyne 029B","E01008332","Total",104,30,11,63,11,5,0,6,93,25,11,57
"2011","Newcastle upon Tyne 029C","E01008333","Total",28,4,7,17,4,0,2,2,24,4,5,15
"2011","Newcastle upon Tyne 029D","E01008334","Total",66,18,9,39,6,0,3,3,60,18,6,36
"2011","Newcastle upon Tyne 029E","E01008335","Total",39,9,6,24,2,1,1,0,37,8,5,24
"2011","Newcastle upon Tyne 029F","E01008437","Total",47,14,4,29,2,1,1,0,45,13,3,29
"2011","Newcastle upon Tyne 029G","E01008438","Total",79,27,10,42,10,1,3,6,69,26,7,36
"2011","Newcastle upon Tyne 030A","E01008390","Total",167,50,22,95,16,2,3,11,151,48,19,84
"2011","Newcastle upon Tyne 030B","E01008425","Total",73,20,12,41,9,2,1,6,64,18,11,35
"2011","Newcastle upon Tyne 030C","E01008427","Total",81,23,5,53,10,0,1,9,71,23,4,44
"2011","Newcastle upon Tyne 030D","E01008428","Total",65,18,14,33,9,2,4,3,56,16,10,30
"2011","Newcastle upon Tyne 031A","E01008441","Total",72,35,8,29,9,2,1,6,63,33,7,23
"2011","Newcastle upon Tyne 031B","E01008442","Total",20,11,7,2,3,2,0,1,17,9,7,1
"2011","Newcastle upon Tyne 031C","E01008444","Total",29,9,11,9,1,0,0,1,28,9,11,8
"2011","Newcastle upon Tyne 031D","E01008445","Total",55,16,21,18,6,0,4,2,49,16,17,16
"2011","Newcastle upon Tyne 031E","E01008446","Total",19,8,8,3,5,0,4,1,14,8,4,2
"2011","Newcastle upon Tyne 031F","E01008447","Total",17,3,8,6,0,0,0,0,17,3,8,6
"2011","Newcastle upon Tyne 031G","E01008448","Total",15,3,9,3,4,0,4,0,11,3,5,3
"2011","North Tyneside 001A","E01008547","Total",17,3,13,1,3,0,3,0,14,3,10,1
"2011","North Tyneside 001B","E01008548","Total",11,2,8,1,4,0,4,0,7,2,4,1
"2011","North Tyneside 001C","E01008549","Total",22,14,6,2,1,0,1,0,21,14,5,2
"2011","North Tyneside 001D","E01008551","Total",13,3,7,3,1,0,1,0,12,3,6,3
"2011","North Tyneside 002A","E01008478","Total",78,25,18,35,9,1,6,2,69,24,12,33
"2011","North Tyneside 002B","E01008480","Total",69,28,9,32,7,0,1,6,62,28,8,26
"2011","North Tyneside 002C","E01008504","Total",30,10,13,7,5,0,4,1,25,10,9,6
"2011","North Tyneside 002D","E01008578","Total",56,21,16,19,4,0,3,1,52,21,13,18
"2011","North Tyneside 002E","E01008583","Total",53,14,11,28,9,1,2,6,44,13,9,22
"2011","North Tyneside 003A","E01008520","Total",36,14,12,10,4,1,2,1,32,13,10,9
"2011","North Tyneside 003B","E01008523","Total",24,7,11,6,4,0,2,2,20,7,9,4
"2011","North Tyneside 003C","E01008546","Total",16,7,9,0,4,0,4,0,12,7,5,0
"2011","North Tyneside 003D","E01008550","Total",32,13,16,3,4,1,2,1,28,12,14,2
"2011","North Tyneside 004A","E01008577","Total",53,21,19,13,5,0,5,0,48,21,14,13
"2011","North Tyneside 004B","E01008579","Total",24,11,8,5,5,1,4,0,19,10,4,5
"2011","North Tyneside 004C","E01008580","Total",32,8,15,9,9,0,8,1,23,8,7,8
"2011","North Tyneside 004D","E01008581","Total",14,4,5,5,2,0,1,1,12,4,4,4
"2011","North Tyneside 004E","E01008582","Total",47,19,9,19,5,0,2,3,42,19,7,16
"2011","North Tyneside 005A","E01008517","Total",36,10,22,4,3,0,3,0,33,10,19,4
"2011","North Tyneside 005B","E01008519","Total",44,10,20,14,5,0,3,2,39,10,17,12
"2011","North Tyneside 005C","E01008521","Total",38,12,19,7,5,0,4,1,33,12,15,6
"2011","North Tyneside 005D","E01008522","Total",20,9,6,5,2,1,1,0,18,8,5,5
"2011","North Tyneside 006A","E01008584","Total",57,22,15,20,6,4,1,1,51,18,14,19
"2011","North Tyneside 006B","E01008585","Total",53,15,21,17,8,0,6,2,45,15,15,15
"2011","North Tyneside 006C","E01008587","Total",27,5,13,9,5,1,3,1,22,4,10,8
"2011","North Tyneside 006D","E01008588","Total",45,15,16,14,7,1,6,0,38,14,10,14
"2011","North Tyneside 006E","E01008589","Total",19,10,5,4,4,0,3,1,15,10,2,3
"2011","North Tyneside 007A","E01008518","Total",38,11,21,6,4,0,3,1,34,11,18,5
"2011","North Tyneside 007B","E01008564","Total",28,11,11,6,2,0,2,0,26,11,9,6
"2011","North Tyneside 007C","E01008565","Total",94,19,37,38,10,2,2,6,84,17,35,32
"2011","North Tyneside 007D","E01008567","Total",95,46,13,36,4,1,1,2,91,45,12,34
"2011","North Tyneside 008A","E01008475","Total",40,18,16,6,3,0,2,1,37,18,14,5
"2011","North Tyneside 008B","E01008476","Total",112,45,17,50,7,0,3,4,105,45,14,46
"2011","North Tyneside 008C","E01008477","Total",106,36,25,45,6,0,1,5,100,36,24,40
"2011","North Tyneside 008D","E01008479","Total",28,10,14,4,4,2,1,1,24,8,13,3
"2011","North Tyneside 009A","E01008552","Total",36,16,8,12,2,1,1,0,34,15,7,12
"2011","North Tyneside 009B","E01008553","Total",84,32,31,21,12,1,6,5,72,31,25,16
"2011","North Tyneside 009C","E01008554","Total",71,23,25,23,4,0,3,1,67,23,22,22
"2011","North Tyneside 009D","E01008555","Total",67,25,21,21,6,1,4,1,61,24,17,20
"2011","North Tyneside 009E","E01008586","Total",37,18,12,7,4,0,3,1,33,18,9,6
"2011","North Tyneside 010A","E01008495","Total",31,15,13,3,6,0,5,1,25,15,8,2
"2011","North Tyneside 010B","E01008496","Total",34,7,15,12,12,1,7,4,22,6,8,8
"2011","North Tyneside 010C","E01008497","Total",26,14,7,5,3,0,2,1,23,14,5,4
"2011","North Tyneside 010D","E01008498","Total",20,6,13,1,0,0,0,0,20,6,13,1
"2011","North Tyneside 011B","E01008568","Total",43,16,12,15,3,0,2,1,40,16,10,14
"2011","North Tyneside 011C","E01008569","Total",96,32,20,44,5,0,2,3,91,32,18,41
"2011","North Tyneside 011D","E01008570","Total",38,12,16,10,3,2,1,0,35,10,15,10
"2011","North Tyneside 011E","E01032647","Total",33,8,19,6,7,0,6,1,26,8,13,5
"2011","North Tyneside 011F","E01032648","Total",84,29,20,35,4,0,2,2,80,29,18,33
"2011","North Tyneside 012A","E01008500","Total",29,10,13,6,3,1,2,0,26,9,11,6
"2011","North Tyneside 012B","E01008505","Total",39,18,14,7,4,2,2,0,35,16,12,7
"2011","North Tyneside 012C","E01008506","Total",55,23,12,20,2,0,0,2,53,23,12,18
"2011","North Tyneside 012D","E01008507","Total",27,9,11,7,3,0,2,1,24,9,9,6
"2011","North Tyneside 013A","E01008493","Total",33,11,18,4,2,0,2,0,31,11,16,4
"2011","North Tyneside 013B","E01008494","Total",70,34,19,17,6,2,1,3,64,32,18,14
"2011","North Tyneside 013C","E01008556","Total",42,15,22,5,5,1,2,2,37,14,20,3
"2011","North Tyneside 013D","E01008557","Total",22,13,7,2,3,2,1,0,19,11,6,2
"2011","North Tyneside 014A","E01008470","Total",61,17,26,18,10,1,7,2,51,16,19,16
"2011","North Tyneside 014B","E01008499","Total",72,32,24,16,9,1,8,0,63,31,16,16
"2011","North Tyneside 014C","E01008502","Total",68,19,21,28,6,1,4,1,62,18,17,27
"2011","North Tyneside 014D","E01008516","Total",25,11,6,8,6,1,4,1,19,10,2,7
"2011","North Tyneside 015A","E01008488","Total",77,20,19,38,6,0,3,3,71,20,16,35
"2011","North Tyneside 015B","E01008489","Total",117,41,22,54,8,2,5,1,109,39,17,53
"2011","North Tyneside 015C","E01008490","Total",43,16,14,13,4,1,1,2,39,15,13,11
"2011","North Tyneside 015D","E01008491","Total",91,37,21,33,1,0,0,1,90,37,21,32
"2011","North Tyneside 016A","E01008558","Total",40,11,23,6,4,0,4,0,36,11,19,6
"2011","North Tyneside 016B","E01008560","Total",30,9,11,10,4,0,2,2,26,9,9,8
"2011","North Tyneside 016C","E01008561","Total",57,18,13,26,4,0,2,2,53,18,11,24
"2011","North Tyneside 016D","E01008562","Total",28,11,9,8,5,1,4,0,23,10,5,8
"2011","North Tyneside 017A","E01008525","Total",31,11,15,5,5,1,4,0,26,10,11,5
"2011","North Tyneside 017B","E01008527","Total",35,6,15,14,6,1,3,2,29,5,12,12
"2011","North Tyneside 017C","E01008559","Total",38,21,13,4,2,1,1,0,36,20,12,4
"2011","North Tyneside 017D","E01008563","Total",24,10,10,4,7,1,6,0,17,9,4,4
"2011","North Tyneside 018A","E01008469","Total",29,12,11,6,2,0,2,0,27,12,9,6
"2011","North Tyneside 018B","E01008472","Total",21,8,7,6,3,1,1,1,18,7,6,5
"2011","North Tyneside 018C","E01008473","Total",26,6,11,9,3,1,1,1,23,5,10,8
"2011","North Tyneside 018D","E01008501","Total",49,23,18,8,2,0,1,1,47,23,17,7
"2011","North Tyneside 018E","E01008503","Total",63,15,16,32,5,1,0,4,58,14,16,28
"2011","North Tyneside 019A","E01008471","Total",63,27,14,22,4,0,4,0,59,27,10,22
"2011","North Tyneside 019B","E01008474","Total",85,32,18,35,6,3,0,3,79,29,18,32
"2011","North Tyneside 019C","E01008513","Total",98,38,28,32,12,0,9,3,86,38,19,29
"2011","North Tyneside 019D","E01008514","Total",83,31,17,35,4,1,0,3,79,30,17,32
"2011","North Tyneside 019F","E01032649","Total",44,14,11,19,6,0,0,6,38,14,11,13
"2011","North Tyneside 019G","E01032650","Total",50,16,8,26,9,2,2,5,41,14,6,21
"2011","North Tyneside 020A","E01008486","Total",82,32,16,34,4,0,3,1,78,32,13,33
"2011","North Tyneside 020B","E01008487","Total",59,21,10,28,2,0,0,2,57,21,10,26
"2011","North Tyneside 020C","E01008526","Total",27,9,13,5,2,0,2,0,25,9,11,5
"2011","North Tyneside 020D","E01008530","Total",34,9,13,12,2,0,2,0,32,9,11,12
"2011","North Tyneside 021A","E01008461","Total",73,30,16,27,7,0,6,1,66,30,10,26
"2011","North Tyneside 021B","E01008466","Total",18,6,10,2,0,0,0,0,18,6,10,2
"2011","North Tyneside 021C","E01008467","Total",60,20,25,15,7,0,6,1,53,20,19,14
"2011","North Tyneside 021D","E01008468","Total",65,20,13,32,6,2,2,2,59,18,11,30
"2011","North Tyneside 022A","E01008483","Total",69,23,17,29,5,0,4,1,64,23,13,28
"2011","North Tyneside 022B","E01008524","Total",46,18,14,14,5,0,5,0,41,18,9,14
"2011","North Tyneside 022C","E01008528","Total",45,13,23,9,7,0,5,2,38,13,18,7
"2011","North Tyneside 022D","E01008529","Total",34,9,18,7,4,0,2,2,30,9,16,5
"2011","North Tyneside 023A","E01008481","Total",96,43,21,32,5,0,4,1,91,43,17,31
"2011","North Tyneside 023B","E01008482","Total",106,36,17,53,2,0,1,1,104,36,16,52
"2011","North Tyneside 023C","E01008484","Total",85,32,4,49,5,1,1,3,80,31,3,46
"2011","North Tyneside 023D","E01008485","Total",152,40,17,95,6,1,1,4,146,39,16,91
"2011","North Tyneside 023E","E01008492","Total",92,30,22,40,3,1,0,2,89,29,22,38
"2011","North Tyneside 024A","E01008462","Total",54,24,14,16,1,0,1,0,53,24,13,16
"2011","North Tyneside 024B","E01008463","Total",54,16,18,20,3,0,1,2,51,16,17,18
"2011","North Tyneside 024C","E01008464","Total",48,20,12,16,6,0,3,3,42,20,9,13
"2011","North Tyneside 024D","E01008465","Total",41,18,11,12,3,0,0,3,38,18,11,9
"2011","North Tyneside 025A","E01008531","Total",20,6,10,4,1,0,1,0,19,6,9,4
"2011","North Tyneside 025B","E01008532","Total",82,35,13,34,4,0,2,2,78,35,11,32
"2011","North Tyneside 025C","E01008534","Total",35,13,16,6,6,0,6,0,29,13,10,6
"2011","North Tyneside 025D","E01008538","Total",32,12,11,9,6,0,4,2,26,12,7,7
"2011","North Tyneside 026A","E01008508","Total",70,21,18,31,12,0,9,3,58,21,9,28
"2011","North Tyneside 026B","E01008509","Total",80,31,13,36,9,1,2,6,71,30,11,30
"2011","North Tyneside 026C","E01008510","Total",56,18,17,21,1,0,0,1,55,18,17,20
"2011","North Tyneside 026D","E01008512","Total",68,25,15,28,7,0,4,3,61,25,11,25
"2011","North Tyneside 027A","E01008539","Total",44,12,24,8,7,0,7,0,37,12,17,8
"2011","North Tyneside 027B","E01008540","Total",125,42,16,67,13,6,3,4,112,36,13,63
"2011","North Tyneside 027C","E01008541","Total",84,21,13,50,9,0,3,6,75,21,10,44
"2011","North Tyneside 027D","E01008544","Total",81,24,7,50,12,2,2,8,69,22,5,42
"2011","North Tyneside 027E","E01008545","Total",69,30,8,31,10,4,4,2,59,26,4,29
"2011","North Tyneside 028A","E01008511","Total",100,43,15,42,5,0,1,4,95,43,14,38
"2011","North Tyneside 028B","E01008542","Total",139,42,25,72,7,0,2,5,132,42,23,67
"2011","North Tyneside 028C","E01008543","Total",136,39,31,66,13,1,5,7,123,38,26,59
"2011","North Tyneside 028D","E01008571","Total",74,23,16,35,10,4,5,1,64,19,11,34
"2011","North Tyneside 029A","E01008572","Total",83,18,21,44,9,1,5,3,74,17,16,41
"2011","North Tyneside 029B","E01008573","Total",92,26,22,44,15,2,10,3,77,24,12,41
"2011","North Tyneside 029C","E01008574","Total",41,18,14,9,1,0,1,0,40,18,13,9
"2011","North Tyneside 029D","E01008576","Total",105,34,24,47,6,0,4,2,99,34,20,45
"2011","North Tyneside 030A","E01008533","Total",78,25,22,31,3,0,3,0,75,25,19,31
"2011","North Tyneside 030B","E01008535","Total",41,17,14,10,2,0,0,2,39,17,14,8
"2011","North Tyneside 030C","E01008536","Total",39,18,6,15,1,0,1,0,38,18,5,15
"2011","North Tyneside 030D","E01008537","Total",37,13,12,12,3,0,2,1,34,13,10,11
"2011","North Tyneside 030E","E01008575","Total",53,22,13,18,5,0,4,1,48,22,9,17
"2011","South Tyneside 001A","E01008595","Total",83,28,25,30,11,4,4,3,72,24,21,27
"2011","South Tyneside 001B","E01008596","Total",80,21,14,45,3,1,1,1,77,20,13,44
"2011","South Tyneside 001C","E01008597","Total",82,34,29,19,7,1,4,2,75,33,25,17
"2011","South Tyneside 001D","E01008598","Total",52,20,10,22,7,1,3,3,45,19,7,19
"2011","South Tyneside 001E","E01008599","Total",77,20,19,38,12,3,4,5,65,17,15,33
"2011","South Tyneside 002A","E01008664","Total",60,10,20,30,3,0,2,1,57,10,18,29
"2011","South Tyneside 002B","E01008665","Total",77,20,24,33,13,3,8,2,64,17,16,31
"2011","South Tyneside 002C","E01008666","Total",91,19,18,54,5,1,3,1,86,18,15,53
"2011","South Tyneside 002D","E01008667","Total",84,19,21,44,13,0,2,11,71,19,19,33
"2011","South Tyneside 002E","E01008668","Total",71,17,17,37,11,0,6,5,60,17,11,32
"2011","South Tyneside 003A","E01008673","Total",22,6,13,3,1,0,0,1,21,6,13,2
"2011","South Tyneside 003B","E01008675","Total",59,17,23,19,8,1,6,1,51,16,17,18
"2011","South Tyneside 003C","E01008676","Total",40,12,18,10,6,1,4,1,34,11,14,9
"2011","South Tyneside 003D","E01008677","Total",36,15,14,7,4,0,4,0,32,15,10,7
"2011","South Tyneside 003E","E01008678","Total",44,14,14,16,5,1,3,1,39,13,11,15
"2011","South Tyneside 004A","E01008647","Total",19,9,7,3,5,0,4,1,14,9,3,2
"2011","South Tyneside 004B","E01008648","Total",29,8,12,9,6,1,4,1,23,7,8,8
"2011","South Tyneside 004C","E01008649","Total",68,17,16,35,3,0,2,1,65,17,14,34
"2011","South Tyneside 004D","E01008651","Total",190,56,22,112,14,1,2,11,176,55,20,101
"2011","South Tyneside 005A","E01008679","Total",48,22,16,10,6,0,6,0,42,22,10,10
"2011","South Tyneside 005B","E01008680","Total",15,6,5,4,1,0,1,0,14,6,4,4
"2011","South Tyneside 005C","E01008682","Total",92,20,23,49,8,0,5,3,84,20,18,46
"2011","South Tyneside 005D","E01008683","Total",76,20,20,36,12,2,5,5,64,18,15,31
"2011","South Tyneside 006A","E01008635","Total",44,18,11,15,5,2,3,0,39,16,8,15
"2011","South Tyneside 006B","E01008650","Total",34,8,16,10,3,0,2,1,31,8,14,9
"2011","South Tyneside 006C","E01008674","Total",19,9,7,3,1,0,1,0,18,9,6,3
"2011","South Tyneside 006D","E01008681","Total",14,5,4,5,3,1,0,2,11,4,4,3
"2011","South Tyneside 007A","E01008600","Total",77,25,15,37,8,1,4,3,69,24,11,34
"2011","South Tyneside 007B","E01008604","Total",89,20,17,52,3,2,0,1,86,18,17,51
"2011","South Tyneside 007C","E01008660","Total",31,10,12,9,1,0,1,0,30,10,11,9
"2011","South Tyneside 007D","E01008661","Total",39,10,9,20,6,1,3,2,33,9,6,18
"2011","South Tyneside 008A","E01008633","Total",94,27,21,46,5,0,3,2,89,27,18,44
"2011","South Tyneside 008B","E01008634","Total",75,26,16,33,6,2,3,1,69,24,13,32
"2011","South Tyneside 008C","E01008636","Total",51,19,12,20,3,1,1,1,48,18,11,19
"2011","South Tyneside 008D","E01008637","Total",47,13,20,14,3,0,1,2,44,13,19,12
"2011","South Tyneside 009A","E01008639","Total",127,38,34,55,8,1,4,3,119,37,30,52
"2011","South Tyneside 009B","E01008652","Total",41,11,11,19,4,0,1,3,37,11,10,16
"2011","South Tyneside 009C","E01008653","Total",77,18,15,44,7,1,1,5,70,17,14,39
"2011","South Tyneside 009D","E01008654","Total",40,14,10,16,4,1,1,2,36,13,9,14
"2011","South Tyneside 009E","E01008655","Total",75,21,18,36,7,0,4,3,68,21,14,33
"2011","South Tyneside 009F","E01008657","Total",30,8,16,6,6,1,5,0,24,7,11,6
"2011","South Tyneside 010A","E01008638","Total",55,21,19,15,2,0,1,1,53,21,18,14
"2011","South Tyneside 010B","E01008640","Total",70,21,18,31,5,0,2,3,65,21,16,28
"2011","South Tyneside 010C","E01008641","Total",68,18,17,33,8,0,3,5,60,18,14,28
"2011","South Tyneside 010D","E01008642","Total",31,7,15,9,2,0,2,0,29,7,13,9
"2011","South Tyneside 011A","E01008590","Total",86,27,19,40,8,2,3,3,78,25,16,37
"2011","South Tyneside 011B","E01008591","Total",103,30,30,43,7,2,3,2,96,28,27,41
"2011","South Tyneside 011C","E01008592","Total",76,21,20,35,2,0,2,0,74,21,18,35
"2011","South Tyneside 011D","E01008594","Total",92,21,28,43,10,1,2,7,82,20,26,36
"2011","South Tyneside 012A","E01008601","Total",77,25,11,41,4,1,1,2,73,24,10,39
"2011","South Tyneside 012B","E01008669","Total",81,19,22,40,10,0,5,5,71,19,17,35
"2011","South Tyneside 012C","E01008671","Total",69,17,14,38,8,2,4,2,61,15,10,36
"2011","South Tyneside 012D","E01008672","Total",39,12,8,19,2,0,1,1,37,12,7,18
"2011","South Tyneside 013A","E01008622","Total",35,12,7,16,2,0,1,1,33,12,6,15
"2011","South Tyneside 013C","E01008625","Total",94,33,10,51,9,2,1,6,85,31,9,45
"2011","South Tyneside 013E","E01033074","Total",87,37,20,30,3,0,2,1,84,37,18,29
"2011","South Tyneside 014A","E01008602","Total",102,45,19,38,8,1,4,3,94,44,15,35
"2011","South Tyneside 014B","E01008603","Total",57,20,9,28,6,0,4,2,51,20,5,26
"2011","South Tyneside 014C","E01008608","Total",87,30,11,46,4,0,0,4,83,30,11,42
"2011","South Tyneside 014D","E01008670","Total",70,21,11,38,6,0,3,3,64,21,8,35
"2011","South Tyneside 015A","E01008643","Total",35,8,12,15,1,0,1,0,34,8,11,15
"2011","South Tyneside 015B","E01008644","Total",63,27,10,26,8,0,5,3,55,27,5,23
"2011","South Tyneside 015C","E01008645","Total",94,36,22,36,11,2,7,2,83,34,15,34
"2011","South Tyneside 015D","E01008646","Total",40,18,8,14,3,1,1,1,37,17,7,13
"2011","South Tyneside 015E","E01008656","Total",50,14,14,22,4,0,2,2,46,14,12,20
"2011","South Tyneside 015F","E01008658","Total",116,35,31,50,8,2,2,4,108,33,29,46
"2011","South Tyneside 016A","E01008593","Total",85,29,11,45,0,0,0,0,85,29,11,45
"2011","South Tyneside 016B","E01008605","Total",44,19,7,18,4,0,4,0,40,19,3,18
"2011","South Tyneside 016C","E01008606","Total",100,24,13,63,5,0,3,2,95,24,10,61
"2011","South Tyneside 016D","E01008607","Total",133,37,16,80,12,0,6,6,121,37,10,74
"2011","South Tyneside 016E","E01008609","Total",104,32,14,58,5,0,3,2,99,32,11,56
"2011","South Tyneside 017A","E01008631","Total",63,20,21,22,3,0,2,1,60,20,19,21
"2011","South Tyneside 017B","E01008632","Total",55,20,15,20,2,0,1,1,53,20,14,19
"2011","South Tyneside 017C","E01008659","Total",71,24,22,25,7,0,3,4,64,24,19,21
"2011","South Tyneside 017D","E01008662","Total",46,15,12,19,4,0,2,2,42,15,10,17
"2011","South Tyneside 017E","E01008663","Total",77,24,23,30,6,2,2,2,71,22,21,28
"2011","South Tyneside 018A","E01008624","Total",69,20,21,28,5,0,2,3,64,20,19,25
"2011","South Tyneside 018B","E01008684","Total",41,8,14,19,1,0,1,0,40,8,13,19
"2011","South Tyneside 018C","E01008685","Total",74,20,19,35,7,0,3,4,67,20,16,31
"2011","South Tyneside 018D","E01008686","Total",46,20,13,13,3,0,1,2,43,20,12,11
"2011","South Tyneside 018E","E01008687","Total",36,10,15,11,5,0,4,1,31,10,11,10
"2011","South Tyneside 019A","E01008688","Total",74,29,13,32,3,0,0,3,71,29,13,29
"2011","South Tyneside 019B","E01008689","Total",60,20,9,31,10,2,4,4,50,18,5,27
"2011","South Tyneside 019C","E01008690","Total",75,25,20,30,6,0,4,2,69,25,16,28
"2011","South Tyneside 019D","E01008691","Total",23,9,8,6,2,0,1,1,21,9,7,5
"2011","South Tyneside 019E","E01008692","Total",59,13,18,28,6,0,4,2,53,13,14,26
"2011","South Tyneside 020A","E01008627","Total",26,5,12,9,3,0,2,1,23,5,10,8
"2011","South Tyneside 020B","E01008628","Total",103,30,21,52,12,0,7,5,91,30,14,47
"2011","South Tyneside 020C","E01008629","Total",36,11,19,6,3,0,2,1,33,11,17,5
"2011","South Tyneside 020D","E01008630","Total",104,23,27,54,4,2,1,1,100,21,26,53
"2011","South Tyneside 021A","E01008610","Total",106,42,16,48,9,2,5,2,97,40,11,46
"2011","South Tyneside 021B","E01008611","Total",25,9,12,4,1,0,1,0,24,9,11,4
"2011","South Tyneside 021C","E01008612","Total",39,10,18,11,7,1,3,3,32,9,15,8
"2011","South Tyneside 021D","E01008613","Total",76,28,10,38,8,0,1,7,68,28,9,31
"2011","South Tyneside 022A","E01008616","Total",32,7,16,9,2,1,1,0,30,6,15,9
"2011","South Tyneside 022B","E01008618","Total",11,6,4,1,1,1,0,0,10,5,4,1
"2011","South Tyneside 022C","E01008619","Total",20,8,9,3,2,0,2,0,18,8,7,3
"2011","South Tyneside 022D","E01008621","Total",14,5,6,3,3,1,1,1,11,4,5,2
"2011","South Tyneside 023A","E01008614","Total",49,13,19,17,3,0,1,2,46,13,18,15
"2011","South Tyneside 023B","E01008615","Total",59,19,21,19,4,1,2,1,55,18,19,18
"2011","South Tyneside 023C","E01008617","Total",24,12,7,5,2,0,2,0,22,12,5,5
"2011","South Tyneside 023D","E01008620","Total",28,8,14,6,5,2,3,0,23,6,11,6
"2011","Sunderland 001A","E01008713","Total",26,7,13,6,1,1,0,0,25,6,13,6
"2011","Sunderland 001B","E01008722","Total",33,15,12,6,1,0,1,0,32,15,11,6
"2011","Sunderland 001C","E01008724","Total",19,8,7,4,1,0,1,0,18,8,6,4
"2011","Sunderland 001D","E01008726","Total",30,10,13,7,2,1,1,0,28,9,12,7
"2011","Sunderland 002A","E01008723","Total",25,9,9,7,2,0,2,0,23,9,7,7
"2011","Sunderland 002B","E01008725","Total",13,6,3,4,0,0,0,0,13,6,3,4
"2011","Sunderland 002C","E01008727","Total",51,16,21,14,3,0,3,0,48,16,18,14
"2011","Sunderland 002D","E01008728","Total",29,9,12,8,1,0,0,1,28,9,12,7
"2011","Sunderland 002E","E01008792","Total",12,6,6,0,1,0,1,0,11,6,5,0
"2011","Sunderland 003A","E01008698","Total",62,21,12,29,3,0,3,0,59,21,9,29
"2011","Sunderland 003B","E01008837","Total",85,23,13,49,5,3,1,1,80,20,12,48
"2011","Sunderland 003C","E01008838","Total",86,39,15,32,4,0,2,2,82,39,13,30
"2011","Sunderland 003D","E01008839","Total",94,34,8,52,5,2,0,3,89,32,8,49
"2011","Sunderland 003E","E01008840","Total",69,27,10,32,4,2,1,1,65,25,9,31
"2011","Sunderland 003F","E01008841","Total",82,22,10,50,5,0,2,3,77,22,8,47
"2011","Sunderland 004A","E01008712","Total",71,19,11,41,8,0,3,5,63,19,8,36
"2011","Sunderland 004B","E01008817","Total",88,28,15,45,2,0,1,1,86,28,14,44
"2011","Sunderland 004C","E01008819","Total",73,33,12,28,4,1,3,0,69,32,9,28
"2011","Sunderland 004D","E01008821","Total",87,33,13,41,1,0,0,1,86,33,13,40
"2011","Sunderland 004E","E01008822","Total",111,46,15,50,5,1,2,2,106,45,13,48
"2011","Sunderland 004F","E01008842","Total",52,21,14,17,0,0,0,0,52,21,14,17
"2011","Sunderland 005A","E01008708","Total",48,19,9,20,3,0,1,2,45,19,8,18
"2011","Sunderland 005B","E01008709","Total",94,23,17,54,10,1,3,6,84,22,14,48
"2011","Sunderland 005D","E01008711","Total",42,13,15,14,7,0,5,2,35,13,10,12
"2011","Sunderland 005F","E01008820","Total",49,22,8,19,7,1,4,2,42,21,4,17
"2011","Sunderland 005G","E01033075","Total",109,31,21,57,11,1,4,6,98,30,17,51
"2011","Sunderland 006A","E01008786","Total",39,10,16,13,2,0,2,0,37,10,14,13
"2011","Sunderland 006B","E01008787","Total",53,15,22,16,3,0,2,1,50,15,20,15
"2011","Sunderland 006C","E01008788","Total",45,20,16,9,4,0,4,0,41,20,12,9
"2011","Sunderland 006D","E01008789","Total",29,8,15,6,1,0,1,0,28,8,14,6
"2011","Sunderland 006E","E01008790","Total",40,13,12,15,3,0,3,0,37,13,9,15
"2011","Sunderland 006F","E01008791","Total",41,19,7,15,4,1,1,2,37,18,6,13
"2011","Sunderland 007A","E01008855","Total",34,17,10,7,7,1,6,0,27,16,4,7
"2011","Sunderland 007B","E01008856","Total",21,5,11,5,1,0,1,0,20,5,10,5
"2011","Sunderland 007C","E01008876","Total",23,6,10,7,1,0,1,0,22,6,9,7
"2011","Sunderland 007D","E01008877","Total",26,9,14,3,1,0,1,0,25,9,13,3
"2011","Sunderland 008A","E01008693","Total",43,16,13,14,5,0,2,3,38,16,11,11
"2011","Sunderland 008B","E01008694","Total",56,21,13,22,3,0,1,2,53,21,12,20
"2011","Sunderland 008C","E01008695","Total",72,26,14,32,9,1,6,2,63,25,8,30
"2011","Sunderland 008D","E01008696","Total",28,10,8,10,2,0,2,0,26,10,6,10
"2011","Sunderland 008E","E01008697","Total",44,20,14,10,0,0,0,0,44,20,14,10
"2011","Sunderland 008F","E01008699","Total",74,21,11,42,9,0,3,6,65,21,8,36
"2011","Sunderland 009A","E01008853","Total",92,34,12,46,3,2,0,1,89,32,12,45
"2011","Sunderland 009B","E01008854","Total",66,16,22,28,7,2,3,2,59,14,19,26
"2011","Sunderland 009C","E01008857","Total",63,23,10,30,3,1,2,0,60,22,8,30
"2011","Sunderland 009D","E01008858","Total",126,45,23,58,3,0,2,1,123,45,21,57
"2011","Sunderland 009E","E01008859","Total",89,29,17,43,5,1,2,2,84,28,15,41
"2011","Sunderland 009F","E01008860","Total",79,19,14,46,6,1,2,3,73,18,12,43
"2011","Sunderland 009G","E01008878","Total",61,25,17,19,7,2,2,3,54,23,15,16
"2011","Sunderland 010A","E01008873","Total",20,8,9,3,3,1,2,0,17,7,7,3
"2011","Sunderland 010B","E01008874","Total",79,26,21,32,5,0,4,1,74,26,17,31
"2011","Sunderland 010C","E01008875","Total",70,23,19,28,5,0,4,1,65,23,15,27
"2011","Sunderland 010D","E01008879","Total",39,15,14,10,3,0,2,1,36,15,12,9
"2011","Sunderland 010E","E01008880","Total",40,15,8,17,3,0,1,2,37,15,7,15
"2011","Sunderland 011A","E01008701","Total",87,27,13,47,2,2,0,0,85,25,13,47
"2011","Sunderland 011B","E01008704","Total",49,11,19,19,3,0,0,3,46,11,19,16
"2011","Sunderland 011C","E01008706","Total",62,24,11,27,10,3,3,4,52,21,8,23
"2011","Sunderland 011D","E01008707","Total",47,11,14,22,3,1,1,1,44,10,13,21
"2011","Sunderland 012A","E01008756","Total",64,21,15,28,5,1,3,1,59,20,12,27
"2011","Sunderland 012B","E01008762","Total",88,26,13,49,4,1,1,2,84,25,12,47
"2011","Sunderland 012C","E01008812","Total",121,42,23,56,8,0,2,6,113,42,21,50
"2011","Sunderland 012F","E01033076","Total",77,18,6,53,2,1,1,0,75,17,5,53
"2011","Sunderland 013A","E01008700","Total",52,20,9,23,6,0,4,2,46,20,5,21
"2011","Sunderland 013B","E01008703","Total",31,13,5,13,2,0,0,2,29,13,5,11
"2011","Sunderland 013C","E01008705","Total",50,14,8,28,7,4,2,1,43,10,6,27
"2011","Sunderland 013D","E01008831","Total",48,14,14,20,8,1,3,4,40,13,11,16
"2011","Sunderland 013E","E01008834","Total",41,8,16,17,5,0,3,2,36,8,13,15
"2011","Sunderland 014A","E01008810","Total",80,24,22,34,7,1,5,1,73,23,17,33
"2011","Sunderland 014B","E01008811","Total",52,19,13,20,4,1,2,1,48,18,11,19
"2011","Sunderland 014C","E01008813","Total",68,25,15,28,11,2,4,5,57,23,11,23
"2011","Sunderland 014D","E01008814","Total",58,23,16,19,5,0,4,1,53,23,12,18
"2011","Sunderland 015A","E01008757","Total",62,18,10,34,4,0,4,0,58,18,6,34
"2011","Sunderland 015B","E01008758","Total",38,14,9,15,1,0,1,0,37,14,8,15
"2011","Sunderland 015C","E01008759","Total",40,11,17,12,5,0,4,1,35,11,13,11
"2011","Sunderland 015D","E01008761","Total",20,7,7,6,1,0,0,1,19,7,7,5
"2011","Sunderland 016A","E01008702","Total",80,30,13,37,7,0,4,3,73,30,9,34
"2011","Sunderland 016B","E01008735","Total",64,16,5,43,8,4,1,3,56,12,4,40
"2011","Sunderland 016C","E01008736","Total",89,30,7,52,6,1,2,3,83,29,5,49
"2011","Sunderland 016D","E01008737","Total",69,12,16,41,6,0,1,5,63,12,15,36
"2011","Sunderland 016E","E01008738","Total",65,13,11,41,5,1,2,2,60,12,9,39
"2011","Sunderland 016F","E01008836","Total",38,10,9,19,5,0,3,2,33,10,6,17
"2011","Sunderland 017A","E01008845","Total",25,7,10,8,1,0,1,0,24,7,9,8
"2011","Sunderland 017B","E01008846","Total",71,23,12,36,2,0,2,0,69,23,10,36
"2011","Sunderland 017C","E01008847","Total",87,32,17,38,4,1,0,3,83,31,17,35
"2011","Sunderland 017D","E01008850","Total",38,13,19,6,1,0,1,0,37,13,18,6
"2011","Sunderland 017E","E01008851","Total",54,20,20,14,2,0,2,0,52,20,18,14
"2011","Sunderland 018A","E01008760","Total",40,20,9,11,3,0,2,1,37,20,7,10
"2011","Sunderland 018B","E01008830","Total",31,10,10,11,2,0,1,1,29,10,9,10
"2011","Sunderland 018C","E01008832","Total",47,12,13,22,4,0,3,1,43,12,10,21
"2011","Sunderland 018D","E01008833","Total",24,7,10,7,4,1,2,1,20,6,8,6
"2011","Sunderland 019A","E01008843","Total",26,11,10,5,5,0,4,1,21,11,6,4
"2011","Sunderland 019B","E01008844","Total",33,16,8,9,2,0,0,2,31,16,8,7
"2011","Sunderland 019C","E01008848","Total",21,8,9,4,1,1,0,0,20,7,9,4
"2011","Sunderland 019D","E01008849","Total",94,38,18,38,4,0,4,0,90,38,14,38
"2011","Sunderland 019E","E01008852","Total",30,9,14,7,4,0,3,1,26,9,11,6
"2011","Sunderland 020A","E01008867","Total",82,27,13,42,10,1,3,6,72,26,10,36
"2011","Sunderland 020B","E01008868","Total",29,10,15,4,4,0,4,0,25,10,11,4
"2011","Sunderland 020C","E01008869","Total",33,17,9,7,2,0,2,0,31,17,7,7
"2011","Sunderland 020D","E01008870","Total",25,14,8,3,3,2,1,0,22,12,7,3
"2011","Sunderland 020E","E01008871","Total",61,22,25,14,7,0,5,2,54,22,20,12
"2011","Sunderland 020F","E01008872","Total",27,9,11,7,5,1,3,1,22,8,8,6
"2011","Sunderland 021A","E01008729","Total",65,20,11,34,1,0,0,1,64,20,11,33
"2011","Sunderland 021B","E01008730","Total",95,31,12,52,1,0,0,1,94,31,12,51
"2011","Sunderland 021C","E01008731","Total",70,27,9,34,2,0,1,1,68,27,8,33
"2011","Sunderland 021D","E01008732","Total",106,32,30,44,10,3,3,4,96,29,27,40
"2011","Sunderland 021E","E01008733","Total",76,23,19,34,10,2,3,5,66,21,16,29
"2011","Sunderland 021F","E01008734","Total",21,8,9,4,6,1,5,0,15,7,4,4
"2011","Sunderland 022A","E01008740","Total",32,10,13,9,1,0,1,0,31,10,12,9
"2011","Sunderland 022B","E01008781","Total",21,3,13,5,2,0,1,1,19,3,12,4
"2011","Sunderland 022C","E01008782","Total",15,0,8,7,4,0,3,1,11,0,5,6
"2011","Sunderland 022D","E01008783","Total",13,6,5,2,0,0,0,0,13,6,5,2
"2011","Sunderland 022E","E01008784","Total",26,11,14,1,5,0,5,0,21,11,9,1
"2011","Sunderland 022F","E01008785","Total",19,9,7,3,1,1,0,0,18,8,7,3
"2011","Sunderland 022G","E01008835","Total",26,9,11,6,2,1,1,0,24,8,10,6
"2011","Sunderland 023A","E01008823","Total",64,16,17,31,5,1,3,1,59,15,14,30
"2011","Sunderland 023B","E01008824","Total",104,45,14,45,7,0,2,5,97,45,12,40
"2011","Sunderland 023C","E01008825","Total",56,14,15,27,7,0,3,4,49,14,12,23
"2011","Sunderland 023D","E01008826","Total",58,17,10,31,6,0,0,6,52,17,10,25
"2011","Sunderland 023E","E01008827","Total",75,30,7,38,5,1,2,2,70,29,5,36
"2011","Sunderland 023F","E01008828","Total",108,35,19,54,5,0,1,4,103,35,18,50
"2011","Sunderland 023G","E01008829","Total",71,20,14,37,4,0,0,4,67,20,14,33
"2011","Sunderland 024A","E01008739","Total",73,22,9,42,7,2,1,4,66,20,8,38
"2011","Sunderland 024B","E01008741","Total",41,16,11,14,6,1,3,2,35,15,8,12
"2011","Sunderland 024C","E01008779","Total",49,16,17,16,5,0,3,2,44,16,14,14
"2011","Sunderland 024D","E01008780","Total",66,17,18,31,4,0,3,1,62,17,15,30
"2011","Sunderland 025A","E01008799","Total",31,13,14,4,3,0,3,0,28,13,11,4
"2011","Sunderland 025B","E01008861","Total",52,15,17,20,7,1,4,2,45,14,13,18
"2011","Sunderland 025C","E01008862","Total",15,9,5,1,1,1,0,0,14,8,5,1
"2011","Sunderland 025D","E01008863","Total",26,12,10,4,5,0,5,0,21,12,5,4
"2011","Sunderland 025E","E01008864","Total",9,2,4,3,1,0,1,0,8,2,3,3
"2011","Sunderland 025F","E01008865","Total",42,23,9,10,3,2,1,0,39,21,8,10
"2011","Sunderland 025G","E01008866","Total",54,21,24,9,3,0,3,0,51,21,21,9
"2011","Sunderland 026A","E01008773","Total",98,29,22,47,11,0,3,8,87,29,19,39
"2011","Sunderland 026B","E01008776","Total",64,30,10,24,4,2,0,2,60,28,10,22
"2011","Sunderland 026C","E01008777","Total",29,7,7,15,3,0,2,1,26,7,5,14
"2011","Sunderland 026D","E01008778","Total",76,32,20,24,6,1,3,2,70,31,17,22
"2011","Sunderland 026E","E01008809","Total",44,14,13,17,0,0,0,0,44,14,13,17
"2011","Sunderland 027A","E01008803","Total",56,14,17,25,4,0,2,2,52,14,15,23
"2011","Sunderland 027B","E01008804","Total",53,21,13,19,4,1,2,1,49,20,11,18
"2011","Sunderland 027C","E01008805","Total",69,28,20,21,5,1,2,2,64,27,18,19
"2011","Sunderland 027F","E01033077","Total",64,28,19,17,7,1,3,3,57,27,16,14
"2011","Sunderland 028A","E01008763","Total",74,30,13,31,0,0,0,0,74,30,13,31
"2011","Sunderland 028B","E01008764","Total",53,19,19,15,1,0,1,0,52,19,18,15
"2011","Sunderland 028C","E01008766","Total",84,28,19,37,7,0,4,3,77,28,15,34
"2011","Sunderland 028D","E01008768","Total",38,12,13,13,4,0,4,0,34,12,9,13
"2011","Sunderland 028E","E01008769","Total",73,12,18,43,5,0,0,5,68,12,18,38
"2011","Sunderland 029A","E01008772","Total",7,2,4,1,1,1,0,0,6,1,4,1
"2011","Sunderland 029B","E01008774","Total",40,19,11,10,5,3,2,0,35,16,9,10
"2011","Sunderland 029C","E01008775","Total",15,4,7,4,1,0,1,0,14,4,6,4
"2011","Sunderland 029D","E01008802","Total",22,11,6,5,1,0,1,0,21,11,5,5
"2011","Sunderland 029E","E01008808","Total",33,10,15,8,7,2,3,2,26,8,12,6
"2011","Sunderland 030A","E01008793","Total",103,33,12,58,7,0,2,5,96,33,10,53
"2011","Sunderland 030B","E01008795","Total",53,20,18,15,5,1,3,1,48,19,15,14
"2011","Sunderland 030C","E01008797","Total",52,22,22,8,3,0,2,1,49,22,20,7
"2011","Sunderland 030D","E01008800","Total",85,34,19,32,6,0,3,3,79,34,16,29
"2011","Sunderland 030E","E01008801","Total",30,11,16,3,3,1,2,0,27,10,14,3
"2011","Sunderland 031A","E01008765","Total",31,12,12,7,6,1,4,1,25,11,8,6
"2011","Sunderland 031B","E01008767","Total",47,19,14,14,4,0,3,1,43,19,11,13
"2011","Sunderland 031C","E01008770","Total",33,8,18,7,2,0,2,0,31,8,16,7
"2011","Sunderland 031D","E01008771","Total",41,14,11,16,6,1,3,2,35,13,8,14
"2011","Sunderland 032A","E01008720","Total",55,18,10,27,9,0,4,5,46,18,6,22
"2011","Sunderland 032B","E01008721","Total",31,9,13,9,4,0,4,0,27,9,9,9
"2011","Sunderland 032D","E01008796","Total",35,12,16,7,3,1,2,0,32,11,14,7
"2011","Sunderland 032F","E01032483","Total",60,17,10,33,3,0,1,2,57,17,9,31
"2011","Sunderland 032G","E01032484","Total",29,11,9,9,0,0,0,0,29,11,9,9
"2011","Sunderland 033A","E01008750","Total",52,23,25,4,4,1,3,0,48,22,22,4
"2011","Sunderland 033B","E01008751","Total",42,15,5,22,4,0,2,2,38,15,3,20
"2011","Sunderland 033C","E01008752","Total",72,27,14,31,0,0,0,0,72,27,14,31
"2011","Sunderland 033D","E01008753","Total",46,19,10,17,3,0,3,0,43,19,7,17
"2011","Sunderland 033E","E01008755","Total",39,13,10,16,2,0,0,2,37,13,10,14
"2011","Sunderland 034A","E01008714","Total",81,19,15,47,6,2,1,3,75,17,14,44
"2011","Sunderland 034B","E01008715","Total",50,10,20,20,7,0,4,3,43,10,16,17
"2011","Sunderland 034C","E01008716","Total",16,2,13,1,2,0,2,0,14,2,11,1
"2011","Sunderland 034D","E01008717","Total",74,27,15,32,4,1,2,1,70,26,13,31
"2011","Sunderland 034E","E01008749","Total",18,5,10,3,3,1,2,0,15,4,8,3
"2011","Sunderland 034F","E01008754","Total",55,17,16,22,3,0,2,1,52,17,14,21
"2011","Sunderland 035A","E01008718","Total",23,10,5,8,0,0,0,0,23,10,5,8
"2011","Sunderland 035B","E01008719","Total",41,15,8,18,1,0,1,0,40,15,7,18
"2011","Sunderland 035C","E01008742","Total",71,27,20,24,7,0,4,3,64,27,16,21
"2011","Sunderland 035D","E01008747","Total",30,8,11,11,1,0,1,0,29,8,10,11
"2011","Sunderland 035E","E01008748","Total",20,6,8,6,3,0,2,1,17,6,6,5
"2011","Sunderland 036A","E01008743","Total",108,33,17,58,11,3,3,5,97,30,14,53
"2011","Sunderland 036B","E01008744","Total",79,24,15,40,7,1,5,1,72,23,10,39
"2011","Sunderland 036C","E01008745","Total",34,11,15,8,2,1,0,1,32,10,15,7
"2011","Sunderland 036D","E01008746","Total",84,14,14,56,4,0,1,3,80,14,13,53
"2011","Blackburn with Darwen 001A","E01012607","Total",34,8,10,16,5,1,2,2,29,7,8,14
"2011","Blackburn with Darwen 001B","E01012608","Total",79,26,16,37,9,2,1,6,70,24,15,31
"2011","Blackburn with Darwen 001C","E01012633","Total",64,21,27,16,8,0,6,2,56,21,21,14
"2011","Blackburn with Darwen 001D","E01012634","Total",46,12,20,14,2,0,2,0,44,12,18,14
"2011","Blackburn with Darwen 001E","E01012635","Total",39,13,10,16,4,1,2,1,35,12,8,15
"2011","Blackburn with Darwen 001F","E01012636","Total",35,20,7,8,3,0,1,2,32,20,6,6
"2011","Blackburn with Darwen 002A","E01012581","Total",14,5,5,4,3,1,2,0,11,4,3,4
"2011","Blackburn with Darwen 002B","E01012582","Total",17,6,7,4,1,0,1,0,16,6,6,4
"2011","Blackburn with Darwen 002C","E01012583","Total",22,7,9,6,2,0,2,0,20,7,7,6
"2011","Blackburn with Darwen 002D","E01012587","Total",39,11,14,14,5,0,1,4,34,11,13,10
"2011","Blackburn with Darwen 002E","E01012588","Total",41,18,7,16,1,0,1,0,40,18,6,16
"2011","Blackburn with Darwen 003A","E01012574","Total",42,10,8,24,4,1,0,3,38,9,8,21
"2011","Blackburn with Darwen 003B","E01012577","Total",43,8,5,30,6,1,1,4,37,7,4,26
"2011","Blackburn with Darwen 003C","E01012578","Total",53,10,3,40,2,0,0,2,51,10,3,38
"2011","Blackburn with Darwen 003D","E01012605","Total",43,16,7,20,2,0,1,1,41,16,6,19
"2011","Blackburn with Darwen 003E","E01012606","Total",46,18,3,25,3,0,1,2,43,18,2,23
"2011","Blackburn with Darwen 004A","E01012579","Total",37,15,4,18,1,1,0,0,36,14,4,18
"2011","Blackburn with Darwen 004B","E01012580","Total",22,5,1,16,3,1,0,2,19,4,1,14
"2011","Blackburn with Darwen 004C","E01012642","Total",36,11,5,20,7,1,3,3,29,10,2,17
"2011","Blackburn with Darwen 004D","E01012645","Total",33,10,11,12,3,0,2,1,30,10,9,11
"2011","Blackburn with Darwen 005A","E01012585","Total",10,2,4,4,3,0,1,2,7,2,3,2
"2011","Blackburn with Darwen 005B","E01012586","Total",23,6,2,15,4,1,1,2,19,5,1,13
"2011","Blackburn with Darwen 005C","E01012656","Total",45,13,9,23,4,1,2,1,41,12,7,22
"2011","Blackburn with Darwen 005D","E01012657","Total",56,12,5,39,8,3,3,2,48,9,2,37
"2011","Blackburn with Darwen 005E","E01012658","Total",75,25,20,30,11,4,4,3,64,21,16,27
"2011","Blackburn with Darwen 006A","E01012629","Total",63,15,19,29,6,0,4,2,57,15,15,27
"2011","Blackburn with Darwen 006B","E01012631","Total",43,12,11,20,6,0,4,2,37,12,7,18
"2011","Blackburn with Darwen 006C","E01012643","Total",32,5,4,23,1,0,1,0,31,5,3,23
"2011","Blackburn with Darwen 006D","E01012644","Total",26,10,5,11,5,2,2,1,21,8,3,10
"2011","Blackburn with Darwen 006E","E01012655","Total",100,22,16,62,14,4,3,7,86,18,13,55
"2011","Blackburn with Darwen 007A","E01012571","Total",38,7,4,27,4,0,1,3,34,7,3,24
"2011","Blackburn with Darwen 007B","E01012572","Total",42,12,7,23,1,0,0,1,41,12,7,22
"2011","Blackburn with Darwen 007C","E01012573","Total",32,11,2,19,3,2,1,0,29,9,1,19
"2011","Blackburn with Darwen 007D","E01012575","Total",29,6,4,19,1,0,0,1,28,6,4,18
"2011","Blackburn with Darwen 007E","E01012630","Total",54,24,3,27,7,4,2,1,47,20,1,26
"2011","Blackburn with Darwen 008A","E01012576","Total",36,8,5,23,2,0,2,0,34,8,3,23
"2011","Blackburn with Darwen 008B","E01012637","Total",115,24,28,63,15,0,8,7,100,24,20,56
"2011","Blackburn with Darwen 008C","E01012638","Total",105,28,14,63,10,2,0,8,95,26,14,55
"2011","Blackburn with Darwen 008D","E01012639","Total",134,23,27,84,24,3,7,14,110,20,20,70
"2011","Blackburn with Darwen 008E","E01012640","Total",73,17,11,45,3,0,0,3,70,17,11,42
"2011","Blackburn with Darwen 008F","E01012641","Total",95,21,8,66,5,1,2,2,90,20,6,64
"2011","Blackburn with Darwen 009A","E01012595","Total",110,33,27,50,9,0,5,4,101,33,22,46
"2011","Blackburn with Darwen 009B","E01012596","Total",103,25,32,46,9,1,5,3,94,24,27,43
"2011","Blackburn with Darwen 009C","E01012622","Total",96,26,13,57,12,0,4,8,84,26,9,49
"2011","Blackburn with Darwen 009D","E01012623","Total",62,25,14,23,5,1,2,2,57,24,12,21
"2011","Blackburn with Darwen 009E","E01012624","Total",70,26,20,24,9,0,3,6,61,26,17,18
"2011","Blackburn with Darwen 009F","E01012625","Total",114,40,34,40,14,4,8,2,100,36,26,38
"2011","Blackburn with Darwen 010A","E01012584","Total",18,9,8,1,2,2,0,0,16,7,8,1
"2011","Blackburn with Darwen 010B","E01012609","Total",24,6,14,4,3,1,1,1,21,5,13,3
"2011","Blackburn with Darwen 010C","E01012610","Total",47,18,21,8,9,3,6,0,38,15,15,8
"2011","Blackburn with Darwen 010D","E01012611","Total",22,13,7,2,3,1,2,0,19,12,5,2
"2011","Blackburn with Darwen 010E","E01012612","Total",28,13,11,4,6,0,6,0,22,13,5,4
"2011","Blackburn with Darwen 010F","E01012613","Total",21,7,10,4,3,0,3,0,18,7,7,4
"2011","Blackburn with Darwen 011A","E01012600","Total",63,16,16,31,8,1,2,5,55,15,14,26
"2011","Blackburn with Darwen 011B","E01012601","Total",118,29,16,73,13,1,5,7,105,28,11,66
"2011","Blackburn with Darwen 011C","E01012602","Total",45,16,18,11,4,0,1,3,41,16,17,8
"2011","Blackburn with Darwen 011D","E01012603","Total",115,33,25,57,11,1,4,6,104,32,21,51
"2011","Blackburn with Darwen 011E","E01012604","Total",71,30,20,21,2,0,0,2,69,30,20,19
"2011","Blackburn with Darwen 011F","E01012632","Total",58,18,20,20,7,0,6,1,51,18,14,19
"2011","Blackburn with Darwen 012A","E01012594","Total",88,23,22,43,5,1,2,2,83,22,20,41
"2011","Blackburn with Darwen 012B","E01012618","Total",45,15,19,11,6,1,3,2,39,14,16,9
"2011","Blackburn with Darwen 012C","E01012619","Total",91,23,12,56,10,2,3,5,81,21,9,51
"2011","Blackburn with Darwen 012D","E01012620","Total",35,11,10,14,7,2,2,3,28,9,8,11
"2011","Blackburn with Darwen 012E","E01012621","Total",82,31,20,31,4,1,2,1,78,30,18,30
"2011","Blackburn with Darwen 013A","E01012593","Total",60,13,27,20,6,0,4,2,54,13,23,18
"2011","Blackburn with Darwen 013B","E01012597","Total",34,10,20,4,5,0,5,0,29,10,15,4
"2011","Blackburn with Darwen 013C","E01012598","Total",67,30,27,10,12,2,9,1,55,28,18,9
"2011","Blackburn with Darwen 013D","E01012599","Total",29,14,10,5,3,0,3,0,26,14,7,5
"2011","Blackburn with Darwen 014A","E01012589","Total",75,22,17,36,10,1,5,4,65,21,12,32
"2011","Blackburn with Darwen 014B","E01012590","Total",76,28,15,33,7,3,2,2,69,25,13,31
"2011","Blackburn with Darwen 014C","E01012591","Total",53,20,17,16,7,2,3,2,46,18,14,14
"2011","Blackburn with Darwen 014D","E01012648","Total",61,11,18,32,7,1,5,1,54,10,13,31
"2011","Blackburn with Darwen 014E","E01012652","Total",27,15,9,3,8,4,3,1,19,11,6,2
"2011","Blackburn with Darwen 015A","E01012617","Total",81,35,24,22,5,1,1,3,76,34,23,19
"2011","Blackburn with Darwen 015B","E01012646","Total",115,41,22,52,10,2,5,3,105,39,17,49
"2011","Blackburn with Darwen 015C","E01012647","Total",68,16,9,43,9,0,2,7,59,16,7,36
"2011","Blackburn with Darwen 015D","E01012650","Total",77,26,12,39,9,1,4,4,68,25,8,35
"2011","Blackburn with Darwen 016A","E01012649","Total",74,22,12,40,8,1,2,5,66,21,10,35
"2011","Blackburn with Darwen 016B","E01012651","Total",79,25,24,30,7,0,1,6,72,25,23,24
"2011","Blackburn with Darwen 016C","E01012653","Total",67,24,20,23,7,0,6,1,60,24,14,22
"2011","Blackburn with Darwen 016D","E01012654","Total",74,28,11,35,10,1,4,5,64,27,7,30
"2011","Blackburn with Darwen 017A","E01012614","Total",37,13,13,11,7,1,3,3,30,12,10,8
"2011","Blackburn with Darwen 017B","E01012615","Total",58,23,16,19,5,1,4,0,53,22,12,19
"2011","Blackburn with Darwen 017C","E01012616","Total",57,12,31,14,17,0,13,4,40,12,18,10
"2011","Blackburn with Darwen 017D","E01012659","Total",32,14,15,3,3,0,3,0,29,14,12,3
"2011","Blackburn with Darwen 017E","E01012660","Total",19,4,8,7,1,0,1,0,18,4,7,7
"2011","Blackburn with Darwen 017F","E01012661","Total",53,18,18,17,4,0,4,0,49,18,14,17
"2011","Blackburn with Darwen 018A","E01012592","Total",34,8,21,5,5,0,5,0,29,8,16,5
"2011","Blackburn with Darwen 018D","E01012628","Total",10,4,3,3,1,0,1,0,9,4,2,3
"2011","Blackburn with Darwen 018E","E01032485","Total",26,11,12,3,4,0,4,0,22,11,8,3
"2011","Blackburn with Darwen 018F","E01032486","Total",29,10,15,4,4,0,2,2,25,10,13,2
"2011","Blackpool 001A","E01012663","Total",49,17,13,19,4,0,3,1,45,17,10,18
"2011","Blackpool 001B","E01012664","Total",66,21,23,22,10,2,2,6,56,19,21,16
"2011","Blackpool 001C","E01012665","Total",41,18,11,12,3,0,1,2,38,18,10,10
"2011","Blackpool 001D","E01012716","Total",38,15,11,12,3,0,2,1,35,15,9,11
"2011","Blackpool 001E","E01012719","Total",43,18,18,7,6,0,6,0,37,18,12,7
"2011","Blackpool 002A","E01012662","Total",34,9,17,8,1,0,1,0,33,9,16,8
"2011","Blackpool 002B","E01012703","Total",50,16,19,15,6,0,5,1,44,16,14,14
"2011","Blackpool 002C","E01012704","Total",105,43,14,48,12,2,4,6,93,41,10,42
"2011","Blackpool 002D","E01012706","Total",65,24,25,16,4,0,2,2,61,24,23,14
"2011","Blackpool 002E","E01012717","Total",18,5,5,8,4,1,0,3,14,4,5,5
"2011","Blackpool 003A","E01012666","Total",42,16,12,14,5,0,3,2,37,16,9,12
"2011","Blackpool 003B","E01012667","Total",47,19,16,12,7,1,6,0,40,18,10,12
"2011","Blackpool 003C","E01012668","Total",42,21,13,8,7,3,3,1,35,18,10,7
"2011","Blackpool 003D","E01012669","Total",29,15,10,4,4,1,3,0,25,14,7,4
"2011","Blackpool 003E","E01012718","Total",35,18,8,9,5,1,2,2,30,17,6,7
"2011","Blackpool 004A","E01012690","Total",67,34,19,14,10,3,5,2,57,31,14,12
"2011","Blackpool 004B","E01012691","Total",81,38,20,23,5,0,5,0,76,38,15,23
"2011","Blackpool 004C","E01012692","Total",74,26,12,36,8,2,1,5,66,24,11,31
"2011","Blackpool 004D","E01012705","Total",79,37,17,25,10,6,4,0,69,31,13,25
"2011","Blackpool 004E","E01012723","Total",59,19,23,17,8,0,5,3,51,19,18,14
"2011","Blackpool 005A","E01012693","Total",48,24,16,8,3,1,2,0,45,23,14,8
"2011","Blackpool 005B","E01012711","Total",65,19,21,25,8,0,6,2,57,19,15,23
"2011","Blackpool 005C","E01012747","Total",39,14,20,5,4,0,4,0,35,14,16,5
"2011","Blackpool 005D","E01012750","Total",62,28,20,14,9,2,6,1,53,26,14,13
"2011","Blackpool 006A","E01012681","Total",45,9,4,32,7,1,2,4,38,8,2,28
"2011","Blackpool 006B","E01012683","Total",50,17,7,26,5,0,1,4,45,17,6,22
"2011","Blackpool 006C","E01012748","Total",58,24,13,21,9,1,4,4,49,23,9,17
"2011","Blackpool 006D","E01012749","Total",42,15,16,11,6,1,2,3,36,14,14,8
"2011","Blackpool 007A","E01012707","Total",50,14,7,29,5,0,0,5,45,14,7,24
"2011","Blackpool 007B","E01012720","Total",112,31,16,65,10,1,4,5,102,30,12,60
"2011","Blackpool 007C","E01012721","Total",115,32,9,74,14,1,2,11,101,31,7,63
"2011","Blackpool 007D","E01012724","Total",60,15,15,30,7,0,2,5,53,15,13,25
"2011","Blackpool 008A","E01012678","Total",62,16,5,41,8,1,1,6,54,15,4,35
"2011","Blackpool 008B","E01012679","Total",111,22,14,75,12,3,2,7,99,19,12,68
"2011","Blackpool 008C","E01012680","Total",93,26,18,49,6,0,0,6,87,26,18,43
"2011","Blackpool 008D","E01012682","Total",72,21,8,43,6,1,2,3,66,20,6,40
"2011","Blackpool 008E","E01012684","Total",87,26,10,51,11,2,2,7,76,24,8,44
"2011","Blackpool 009A","E01012676","Total",49,12,15,22,10,0,2,8,39,12,13,14
"2011","Blackpool 009B","E01012677","Total",38,9,16,13,4,1,3,0,34,8,13,13
"2011","Blackpool 009C","E01012708","Total",65,25,21,19,5,0,5,0,60,25,16,19
"2011","Blackpool 009D","E01012709","Total",136,53,24,59,11,4,3,4,125,49,21,55
"2011","Blackpool 009E","E01012710","Total",35,12,13,10,1,0,1,0,34,12,12,10
"2011","Blackpool 009F","E01012722","Total",28,6,12,10,1,0,1,0,27,6,11,10
"2011","Blackpool 010A","E01012673","Total",65,10,6,49,2,0,0,2,63,10,6,47
"2011","Blackpool 010B","E01012675","Total",98,21,16,61,24,5,4,15,74,16,12,46
"2011","Blackpool 010C","E01012735","Total",25,9,6,10,8,0,4,4,17,9,2,6
"2011","Blackpool 010D","E01012736","Total",13,3,5,5,0,0,0,0,13,3,5,5
"2011","Blackpool 010E","E01012737","Total",41,9,6,26,4,1,2,1,37,8,4,25
"2011","Blackpool 011A","E01012670","Total",104,32,13,59,10,0,4,6,94,32,9,53
"2011","Blackpool 011B","E01012733","Total",49,15,10,24,7,0,2,5,42,15,8,19
"2011","Blackpool 011C","E01012734","Total",73,23,25,25,2,0,1,1,71,23,24,24
"2011","Blackpool 011D","E01012738","Total",66,18,16,32,6,2,3,1,60,16,13,31
"2011","Blackpool 011E","E01012739","Total",78,27,8,43,8,1,0,7,70,26,8,36
"2011","Blackpool 011F","E01012742","Total",48,18,16,14,6,0,4,2,42,18,12,12
"2011","Blackpool 012A","E01012712","Total",49,20,19,10,3,0,0,3,46,20,19,7
"2011","Blackpool 012B","E01012713","Total",88,33,27,28,9,0,6,3,79,33,21,25
"2011","Blackpool 012C","E01012715","Total",69,35,22,12,5,3,2,0,64,32,20,12
"2011","Blackpool 012D","E01012740","Total",35,10,12,13,6,0,3,3,29,10,9,10
"2011","Blackpool 012E","E01012741","Total",52,14,20,18,5,0,4,1,47,14,16,17
"2011","Blackpool 013A","E01012671","Total",58,17,4,37,6,0,2,4,52,17,2,33
"2011","Blackpool 013B","E01012672","Total",27,6,2,19,7,1,0,6,20,5,2,13
"2011","Blackpool 013C","E01012674","Total",71,22,6,43,13,3,1,9,58,19,5,34
"2011","Blackpool 013D","E01012751","Total",24,7,2,15,3,0,0,3,21,7,2,12
"2011","Blackpool 014A","E01012686","Total",104,27,16,61,15,3,2,10,89,24,14,51
"2011","Blackpool 014B","E01012687","Total",78,34,8,36,9,1,3,5,69,33,5,31
"2011","Blackpool 014C","E01012688","Total",53,25,11,17,2,1,1,0,51,24,10,17
"2011","Blackpool 014D","E01012689","Total",46,21,8,17,4,0,3,1,42,21,5,16
"2011","Blackpool 014E","E01012714","Total",51,18,21,12,5,1,4,0,46,17,17,12
"2011","Blackpool 015A","E01012695","Total",92,37,15,40,6,2,1,3,86,35,14,37
"2011","Blackpool 015B","E01012743","Total",87,30,15,42,13,1,7,5,74,29,8,37
"2011","Blackpool 015C","E01012744","Total",95,36,17,42,12,1,5,6,83,35,12,36
"2011","Blackpool 015D","E01012745","Total",74,24,15,35,10,2,1,7,64,22,14,28
"2011","Blackpool 015E","E01012746","Total",98,32,19,47,8,2,5,1,90,30,14,46
"2011","Blackpool 016A","E01012685","Total",85,28,17,40,8,1,3,4,77,27,14,36
"2011","Blackpool 016B","E01012694","Total",74,32,12,30,9,3,4,2,65,29,8,28
"2011","Blackpool 016C","E01012696","Total",113,40,20,53,12,3,2,7,101,37,18,46
"2011","Blackpool 016D","E01012697","Total",36,23,5,8,3,1,0,2,33,22,5,6
"2011","Blackpool 016E","E01012698","Total",109,34,19,56,10,2,5,3,99,32,14,53
"2011","Blackpool 017A","E01012726","Total",54,21,15,18,6,0,5,1,48,21,10,17
"2011","Blackpool 017B","E01012728","Total",66,32,11,23,3,1,2,0,63,31,9,23
"2011","Blackpool 017C","E01012752","Total",38,14,10,14,5,1,2,2,33,13,8,12
"2011","Blackpool 017D","E01012753","Total",27,12,9,6,4,1,1,2,23,11,8,4
"2011","Blackpool 017E","E01012754","Total",54,16,13,25,9,3,3,3,45,13,10,22
"2011","Blackpool 017F","E01012755","Total",30,11,13,6,1,0,1,0,29,11,12,6
"2011","Blackpool 018A","E01012701","Total",55,23,18,14,3,1,1,1,52,22,17,13
"2011","Blackpool 018B","E01012729","Total",49,18,16,15,5,0,2,3,44,18,14,12
"2011","Blackpool 018C","E01012730","Total",46,24,12,10,4,2,2,0,42,22,10,10
"2011","Blackpool 018D","E01012731","Total",80,34,23,23,7,2,3,2,73,32,20,21
"2011","Blackpool 018E","E01012732","Total",74,21,17,36,10,1,2,7,64,20,15,29
"2011","Blackpool 019A","E01012699","Total",60,17,16,27,9,2,1,6,51,15,15,21
"2011","Blackpool 019B","E01012700","Total",58,21,23,14,5,1,2,2,53,20,21,12
"2011","Blackpool 019C","E01012702","Total",40,17,8,15,3,0,3,0,37,17,5,15
"2011","Blackpool 019D","E01012725","Total",34,14,13,7,2,0,2,0,32,14,11,7
"2011","Blackpool 019E","E01012727","Total",26,14,8,4,4,1,2,1,22,13,6,3
"2011","Cheshire East 022A","E01018393","Total",25,9,12,4,4,2,2,0,21,7,10,4
"2011","Cheshire East 022B","E01018411","Total",18,8,7,3,1,0,1,0,17,8,6,3
"2011","Cheshire East 022C","E01018412","Total",18,8,6,4,2,0,2,0,16,8,4,4
"2011","Cheshire East 023A","E01018413","Total",35,18,13,4,8,4,4,0,27,14,9,4
"2011","Cheshire East 023B","E01018414","Total",12,8,4,0,0,0,0,0,12,8,4,0
"2011","Cheshire East 023C","E01018415","Total",48,21,14,13,3,1,2,0,45,20,12,13
"2011","Cheshire East 023D","E01018416","Total",18,6,10,2,3,0,3,0,15,6,7,2
"2011","Cheshire East 024A","E01018424","Total",46,24,17,5,4,0,4,0,42,24,13,5
"2011","Cheshire East 024B","E01018425","Total",21,7,7,7,2,0,1,1,19,7,6,6
"2011","Cheshire East 024C","E01018426","Total",39,15,10,14,1,0,1,0,38,15,9,14
"2011","Cheshire East 024D","E01018427","Total",33,8,16,9,5,0,3,2,28,8,13,7
"2011","Cheshire East 025A","E01018419","Total",36,10,18,8,5,0,5,0,31,10,13,8
"2011","Cheshire East 025B","E01018420","Total",62,32,23,7,2,1,1,0,60,31,22,7
"2011","Cheshire East 025C","E01018421","Total",34,8,15,11,7,1,4,2,27,7,11,9
"2011","Cheshire East 025D","E01018422","Total",52,20,15,17,0,0,0,0,52,20,15,17
"2011","Cheshire East 025E","E01018423","Total",54,19,15,20,4,0,4,0,50,19,11,20
"2011","Cheshire East 026A","E01018395","Total",37,14,12,11,5,1,2,2,32,13,10,9
"2011","Cheshire East 026B","E01018396","Total",60,24,16,20,7,3,4,0,53,21,12,20
"2011","Cheshire East 026C","E01018400","Total",93,36,13,44,9,2,2,5,84,34,11,39
"2011","Cheshire East 026D","E01018401","Total",61,25,11,25,7,2,3,2,54,23,8,23
"2011","Cheshire East 027A","E01018398","Total",67,32,12,23,5,0,2,3,62,32,10,20
"2011","Cheshire East 027B","E01018399","Total",30,15,10,5,5,1,3,1,25,14,7,4
"2011","Cheshire East 027C","E01018402","Total",63,20,14,29,9,0,6,3,54,20,8,26
"2011","Cheshire East 027D","E01018403","Total",43,14,18,11,4,0,2,2,39,14,16,9
"2011","Cheshire East 028A","E01018397","Total",31,10,13,8,3,0,2,1,28,10,11,7
"2011","Cheshire East 028B","E01018408","Total",28,18,7,3,5,3,2,0,23,15,5,3
"2011","Cheshire East 028C","E01018409","Total",51,24,17,10,9,0,4,5,42,24,13,5
"2011","Cheshire East 028D","E01018410","Total",21,12,5,4,2,0,1,1,19,12,4,3
"2011","Cheshire East 029A","E01018404","Total",14,6,7,1,2,0,2,0,12,6,5,1
"2011","Cheshire East 029B","E01018405","Total",34,12,17,5,6,0,6,0,28,12,11,5
"2011","Cheshire East 029C","E01018406","Total",19,6,7,6,6,0,4,2,13,6,3,4
"2011","Cheshire East 029D","E01018407","Total",22,13,7,2,6,3,3,0,16,10,4,2
"2011","Cheshire East 030A","E01018436","Total",24,11,9,4,4,0,4,0,20,11,5,4
"2011","Cheshire East 030B","E01018437","Total",48,12,14,22,3,0,2,1,45,12,12,21
"2011","Cheshire East 030C","E01018438","Total",26,8,12,6,8,1,7,0,18,7,5,6
"2011","Cheshire East 030D","E01018439","Total",16,6,6,4,1,1,0,0,15,5,6,4
"2011","Cheshire East 031A","E01018440","Total",56,21,25,10,6,0,5,1,50,21,20,9
"2011","Cheshire East 031B","E01018441","Total",63,32,20,11,9,1,6,2,54,31,14,9
"2011","Cheshire East 031C","E01018442","Total",43,12,16,15,4,1,3,0,39,11,13,15
"2011","Cheshire East 031D","E01018443","Total",22,15,6,1,1,0,1,0,21,15,5,1
"2011","Cheshire East 032A","E01018432","Total",31,16,10,5,5,3,1,1,26,13,9,4
"2011","Cheshire East 032B","E01018433","Total",21,7,12,2,1,0,1,0,20,7,11,2
"2011","Cheshire East 032C","E01018434","Total",24,11,5,8,3,2,1,0,21,9,4,8
"2011","Cheshire East 032D","E01018435","Total",55,15,19,21,8,0,5,3,47,15,14,18
"2011","Cheshire East 033A","E01018394","Total",23,7,11,5,1,0,1,0,22,7,10,5
"2011","Cheshire East 033B","E01018417","Total",25,15,7,3,1,0,1,0,24,15,6,3
"2011","Cheshire East 033C","E01018418","Total",32,8,13,11,3,0,3,0,29,8,10,11
"2011","Cheshire East 033D","E01018428","Total",31,12,6,13,4,1,2,1,27,11,4,12
"2011","Cheshire East 033E","E01018429","Total",40,15,14,11,6,1,5,0,34,14,9,11
"2011","Cheshire East 033F","E01018430","Total",33,10,14,9,7,0,6,1,26,10,8,8
"2011","Cheshire East 033G","E01018431","Total",20,6,9,5,4,0,4,0,16,6,5,5
"2011","Cheshire East 040A","E01018387","Total",28,14,12,2,5,1,4,0,23,13,8,2
"2011","Cheshire East 040B","E01018388","Total",71,25,15,31,12,5,3,4,59,20,12,27
"2011","Cheshire East 040C","E01018389","Total",40,16,18,6,3,0,3,0,37,16,15,6
"2011","Cheshire East 040D","E01018390","Total",43,18,14,11,2,0,2,0,41,18,12,11
"2011","Cheshire East 042A","E01018386","Total",32,12,15,5,10,2,5,3,22,10,10,2
"2011","Cheshire East 042B","E01018391","Total",65,31,17,17,1,0,1,0,64,31,16,17
"2011","Cheshire East 042C","E01018392","Total",27,12,10,5,3,0,3,0,24,12,7,5
"2011","Cheshire East 034A","E01018472","Total",34,14,10,10,5,0,5,0,29,14,5,10
"2011","Cheshire East 034B","E01018473","Total",45,26,12,7,9,3,5,1,36,23,7,6
"2011","Cheshire East 034C","E01018474","Total",28,15,6,7,2,2,0,0,26,13,6,7
"2011","Cheshire East 034D","E01018475","Total",33,14,15,4,8,0,8,0,25,14,7,4
"2011","Cheshire East 035A","E01018463","Total",54,16,10,28,3,0,1,2,51,16,9,26
"2011","Cheshire East 035B","E01018476","Total",98,30,14,54,4,1,2,1,94,29,12,53
"2011","Cheshire East 035C","E01018477","Total",56,23,10,23,6,1,4,1,50,22,6,22
"2011","Cheshire East 035D","E01018478","Total",67,22,9,36,5,0,1,4,62,22,8,32
"2011","Cheshire East 035E","E01018479","Total",44,16,14,14,7,0,5,2,37,16,9,12
"2011","Cheshire East 036A","E01018459","Total",88,27,17,44,8,4,3,1,80,23,14,43
"2011","Cheshire East 036B","E01018460","Total",42,17,10,15,7,0,3,4,35,17,7,11
"2011","Cheshire East 036C","E01018461","Total",58,15,24,19,7,1,6,0,51,14,18,19
"2011","Cheshire East 036D","E01018466","Total",120,32,16,72,7,1,2,4,113,31,14,68
"2011","Cheshire East 036E","E01018467","Total",108,25,23,60,17,3,6,8,91,22,17,52
"2011","Cheshire East 037A","E01018482","Total",53,26,8,19,5,0,4,1,48,26,4,18
"2011","Cheshire East 037B","E01018483","Total",28,8,6,14,1,0,1,0,27,8,5,14
"2011","Cheshire East 037C","E01018484","Total",144,42,26,76,19,2,11,6,125,40,15,70
"2011","Cheshire East 037D","E01018485","Total",85,31,11,43,7,0,4,3,78,31,7,40
"2011","Cheshire East 038A","E01018499","Total",45,22,17,6,3,0,3,0,42,22,14,6
"2011","Cheshire East 038B","E01018500","Total",18,7,10,1,1,0,1,0,17,7,9,1
"2011","Cheshire East 038C","E01018501","Total",36,15,16,5,5,0,5,0,31,15,11,5
"2011","Cheshire East 038D","E01018502","Total",21,4,13,4,4,0,3,1,17,4,10,3
"2011","Cheshire East 039A","E01018462","Total",79,22,15,42,6,0,3,3,73,22,12,39
"2011","Cheshire East 039B","E01018464","Total",43,16,12,15,6,1,3,2,37,15,9,13
"2011","Cheshire East 039C","E01018496","Total",52,19,15,18,5,0,4,1,47,19,11,17
"2011","Cheshire East 039D","E01018497","Total",47,15,9,23,2,0,2,0,45,15,7,23
"2011","Cheshire East 039E","E01018498","Total",100,35,27,38,10,4,4,2,90,31,23,36
"2011","Cheshire East 041A","E01018465","Total",45,8,18,19,7,0,4,3,38,8,14,16
"2011","Cheshire East 041B","E01018468","Total",37,15,14,8,2,0,2,0,35,15,12,8
"2011","Cheshire East 041C","E01018469","Total",31,10,19,2,4,0,3,1,27,10,16,1
"2011","Cheshire East 041D","E01018470","Total",27,12,13,2,2,0,2,0,25,12,11,2
"2011","Cheshire East 041E","E01018471","Total",41,17,20,4,4,1,3,0,37,16,17,4
"2011","Cheshire East 043A","E01018486","Total",44,15,13,16,7,1,3,3,37,14,10,13
"2011","Cheshire East 043B","E01018487","Total",77,32,19,26,8,2,5,1,69,30,14,25
"2011","Cheshire East 043C","E01018488","Total",35,18,12,5,4,0,3,1,31,18,9,4
"2011","Cheshire East 043D","E01018489","Total",43,17,12,14,2,0,2,0,41,17,10,14
"2011","Cheshire East 044A","E01018510","Total",40,19,8,13,1,0,0,1,39,19,8,12
"2011","Cheshire East 044B","E01018511","Total",40,17,5,18,3,0,1,2,37,17,4,16
"2011","Cheshire East 044C","E01018512","Total",62,19,17,26,6,0,2,4,56,19,15,22
"2011","Cheshire East 044D","E01018513","Total",32,13,13,6,6,0,5,1,26,13,8,5
"2011","Cheshire East 045A","E01018445","Total",116,34,20,62,14,1,6,7,102,33,14,55
"2011","Cheshire East 045B","E01018446","Total",65,22,19,24,6,1,3,2,59,21,16,22
"2011","Cheshire East 045C","E01018447","Total",94,35,25,34,17,5,6,6,77,30,19,28
"2011","Cheshire East 045D","E01018448","Total",52,15,25,12,8,1,6,1,44,14,19,11
"2011","Cheshire East 046A","E01018490","Total",18,7,5,6,2,1,0,1,16,6,5,5
"2011","Cheshire East 046B","E01018491","Total",17,6,9,2,0,0,0,0,17,6,9,2
"2011","Cheshire East 046C","E01018492","Total",19,8,9,2,3,0,3,0,16,8,6,2
"2011","Cheshire East 046D","E01018505","Total",12,4,7,1,4,1,3,0,8,3,4,1
"2011","Cheshire East 046E","E01018506","Total",12,5,7,0,1,0,1,0,11,5,6,0
"2011","Cheshire East 046F","E01018507","Total",14,6,4,4,1,0,1,0,13,6,3,4
"2011","Cheshire East 047A","E01018451","Total",37,14,14,9,5,2,1,2,32,12,13,7
"2011","Cheshire East 047B","E01018454","Total",56,21,14,21,4,2,2,0,52,19,12,21
"2011","Cheshire East 047C","E01018455","Total",24,11,10,3,4,1,3,0,20,10,7,3
"2011","Cheshire East 047D","E01018456","Total",15,3,8,4,1,0,0,1,14,3,8,3
"2011","Cheshire East 047E","E01018457","Total",48,17,20,11,4,1,2,1,44,16,18,10
"2011","Cheshire East 049A","E01018444","Total",36,10,14,12,6,0,5,1,30,10,9,11
"2011","Cheshire East 049B","E01018480","Total",31,9,10,12,6,2,2,2,25,7,8,10
"2011","Cheshire East 049C","E01018515","Total",28,12,10,6,2,0,2,0,26,12,8,6
"2011","Cheshire East 049D","E01018516","Total",25,12,5,8,2,0,1,1,23,12,4,7
"2011","Cheshire East 049F","E01033375","Total",37,18,13,6,2,0,2,0,35,18,11,6
"2011","Cheshire East 049G","E01033376","Total",38,13,14,11,7,1,4,2,31,12,10,9
"2011","Cheshire East 049H","E01033378","Total",14,6,6,2,3,0,3,0,11,6,3,2
"2011","Cheshire East 048A","E01018493","Total",30,14,11,5,7,2,5,0,23,12,6,5
"2011","Cheshire East 048B","E01018494","Total",15,6,6,3,4,1,3,0,11,5,3,3
"2011","Cheshire East 048C","E01018495","Total",31,11,13,7,1,0,1,0,30,11,12,7
"2011","Cheshire East 048D","E01018508","Total",20,7,12,1,7,2,4,1,13,5,8,0
"2011","Cheshire East 048E","E01018509","Total",46,15,23,8,3,1,2,0,43,14,21,8
"2011","Cheshire East 050A","E01018452","Total",49,20,19,10,5,1,4,0,44,19,15,10
"2011","Cheshire East 050C","E01018503","Total",22,7,8,7,2,0,2,0,20,7,6,7
"2011","Cheshire East 050D","E01018504","Total",42,16,9,17,8,1,3,4,34,15,6,13
"2011","Cheshire East 050E","E01033372","Total",38,18,16,4,3,0,2,1,35,18,14,3
"2011","Cheshire East 050F","E01033373","Total",52,24,12,16,8,2,3,3,44,22,9,13
"2011","Cheshire East 051A","E01018449","Total",21,8,7,6,1,0,0,1,20,8,7,5
"2011","Cheshire East 051B","E01018450","Total",39,8,19,12,8,0,7,1,31,8,12,11
"2011","Cheshire East 051C","E01018458","Total",29,11,6,12,3,0,1,2,26,11,5,10
"2011","Cheshire East 051D","E01018481","Total",22,12,8,2,4,1,2,1,18,11,6,1
"2011","Cheshire East 051E","E01018514","Total",31,13,10,8,6,1,4,1,25,12,6,7
"2011","Cheshire East 001A","E01018585","Total",34,7,19,8,5,0,4,1,29,7,15,7
"2011","Cheshire East 001B","E01018586","Total",27,10,10,7,3,0,2,1,24,10,8,6
"2011","Cheshire East 001C","E01018587","Total",24,7,12,5,0,0,0,0,24,7,12,5
"2011","Cheshire East 001D","E01018661","Total",15,5,6,4,3,0,2,1,12,5,4,3
"2011","Cheshire East 002A","E01018657","Total",41,21,10,10,5,1,3,1,36,20,7,9
"2011","Cheshire East 002B","E01018662","Total",30,14,9,7,1,0,1,0,29,14,8,7
"2011","Cheshire East 002C","E01018663","Total",24,14,6,4,0,0,0,0,24,14,6,4
"2011","Cheshire East 002D","E01018664","Total",19,6,10,3,2,0,1,1,17,6,9,2
"2011","Cheshire East 002E","E01018665","Total",35,13,18,4,2,0,2,0,33,13,16,4
"2011","Cheshire East 003A","E01018655","Total",28,14,9,5,2,0,1,1,26,14,8,4
"2011","Cheshire East 003B","E01018656","Total",30,12,10,8,3,1,1,1,27,11,9,7
"2011","Cheshire East 003C","E01018658","Total",24,9,11,4,6,0,5,1,18,9,6,3
"2011","Cheshire East 003D","E01018659","Total",10,4,2,4,2,0,0,2,8,4,2,2
"2011","Cheshire East 003E","E01018660","Total",9,4,3,2,3,0,2,1,6,4,1,1
"2011","Cheshire East 004A","E01018582","Total",29,15,9,5,3,1,2,0,26,14,7,5
"2011","Cheshire East 004B","E01018592","Total",45,22,22,1,7,1,6,0,38,21,16,1
"2011","Cheshire East 004C","E01018593","Total",33,18,7,8,0,0,0,0,33,18,7,8
"2011","Cheshire East 004D","E01018594","Total",55,24,19,12,10,2,7,1,45,22,12,11
"2011","Cheshire East 004E","E01018595","Total",31,17,6,8,3,1,2,0,28,16,4,8
"2011","Cheshire East 004F","E01018596","Total",124,46,20,58,9,1,0,8,115,45,20,50
"2011","Cheshire East 005A","E01018583","Total",51,14,21,16,5,1,3,1,46,13,18,15
"2011","Cheshire East 005B","E01018584","Total",30,15,10,5,1,1,0,0,29,14,10,5
"2011","Cheshire East 005C","E01018612","Total",42,17,14,11,6,3,3,0,36,14,11,11
"2011","Cheshire East 005D","E01018613","Total",54,23,16,15,6,2,3,1,48,21,13,14
"2011","Cheshire East 006A","E01018600","Total",21,6,12,3,5,0,5,0,16,6,7,3
"2011","Cheshire East 006B","E01018601","Total",46,19,17,10,7,1,5,1,39,18,12,9
"2011","Cheshire East 006C","E01018602","Total",19,9,5,5,3,1,2,0,16,8,3,5
"2011","Cheshire East 006D","E01018652","Total",24,10,7,7,2,0,2,0,22,10,5,7
"2011","Cheshire East 007A","E01018598","Total",12,2,6,4,5,2,3,0,7,0,3,4
"2011","Cheshire East 007B","E01018599","Total",11,4,3,4,1,0,1,0,10,4,2,4
"2011","Cheshire East 007C","E01018648","Total",50,22,19,9,6,1,4,1,44,21,15,8
"2011","Cheshire East 007D","E01018649","Total",1,1,0,0,0,0,0,0,1,1,0,0
"2011","Cheshire East 007E","E01018650","Total",31,15,10,6,1,0,0,1,30,15,10,5
"2011","Cheshire East 007F","E01018651","Total",19,11,7,1,5,3,2,0,14,8,5,1
"2011","Cheshire East 007G","E01018654","Total",27,12,9,6,4,1,3,0,23,11,6,6
"2011","Cheshire East 008A","E01018588","Total",38,14,17,7,3,0,3,0,35,14,14,7
"2011","Cheshire East 008B","E01018589","Total",19,7,11,1,1,0,1,0,18,7,10,1
"2011","Cheshire East 008C","E01018590","Total",39,19,11,9,3,0,3,0,36,19,8,9
"2011","Cheshire East 008D","E01018653","Total",35,19,14,2,1,1,0,0,34,18,14,2
"2011","Cheshire East 009A","E01018605","Total",16,5,3,8,2,0,0,2,14,5,3,6
"2011","Cheshire East 009B","E01018609","Total",35,15,11,9,2,0,2,0,33,15,9,9
"2011","Cheshire East 009C","E01018610","Total",76,27,28,21,7,0,7,0,69,27,21,21
"2011","Cheshire East 009D","E01018611","Total",98,41,20,37,8,2,4,2,90,39,16,35
"2011","Cheshire East 011A","E01018666","Total",28,8,10,10,2,0,2,0,26,8,8,10
"2011","Cheshire East 011B","E01018667","Total",23,12,7,4,2,0,2,0,21,12,5,4
"2011","Cheshire East 011C","E01018668","Total",12,3,6,3,3,0,3,0,9,3,3,3
"2011","Cheshire East 010A","E01018603","Total",10,4,5,1,3,1,2,0,7,3,3,1
"2011","Cheshire East 010B","E01018604","Total",40,15,16,9,3,0,2,1,37,15,14,8
"2011","Cheshire East 010C","E01018606","Total",37,13,13,11,4,0,3,1,33,13,10,10
"2011","Cheshire East 010D","E01018607","Total",10,4,3,3,2,0,2,0,8,4,1,3
"2011","Cheshire East 010E","E01018608","Total",21,5,6,10,6,2,3,1,15,3,3,9
"2011","Cheshire East 012A","E01018572","Total",25,8,9,8,5,0,3,2,20,8,6,6
"2011","Cheshire East 012B","E01018573","Total",28,7,14,7,4,0,4,0,24,7,10,7
"2011","Cheshire East 012C","E01018574","Total",63,14,36,13,10,0,9,1,53,14,27,12
"2011","Cheshire East 012D","E01018580","Total",22,6,9,7,5,0,5,0,17,6,4,7
"2011","Cheshire East 012E","E01018581","Total",15,6,5,4,4,1,3,0,11,5,2,4
"2011","Cheshire East 013A","E01018575","Total",30,13,11,6,7,1,6,0,23,12,5,6
"2011","Cheshire East 013B","E01018576","Total",40,13,22,5,7,1,6,0,33,12,16,5
"2011","Cheshire East 013C","E01018577","Total",54,21,19,14,3,3,0,0,51,18,19,14
"2011","Cheshire East 013D","E01018578","Total",14,7,6,1,2,0,2,0,12,7,4,1
"2011","Cheshire East 013E","E01018579","Total",36,13,7,16,4,1,0,3,32,12,7,13
"2011","Cheshire East 014A","E01018641","Total",16,6,8,2,2,0,2,0,14,6,6,2
"2011","Cheshire East 014B","E01018642","Total",21,5,12,4,4,1,2,1,17,4,10,3
"2011","Cheshire East 014C","E01018643","Total",30,9,14,7,5,0,5,0,25,9,9,7
"2011","Cheshire East 014D","E01018644","Total",17,5,7,5,2,0,1,1,15,5,6,4
"2011","Cheshire East 015A","E01018614","Total",53,21,22,10,2,0,2,0,51,21,20,10
"2011","Cheshire East 015B","E01018618","Total",80,25,22,33,8,2,2,4,72,23,20,29
"2011","Cheshire East 015C","E01018619","Total",40,14,17,9,3,0,3,0,37,14,14,9
"2011","Cheshire East 015D","E01018620","Total",59,15,15,29,18,1,6,11,41,14,9,18
"2011","Cheshire East 015E","E01018621","Total",26,10,11,5,5,0,5,0,21,10,6,5
"2011","Cheshire East 016A","E01018626","Total",61,26,18,17,4,0,3,1,57,26,15,16
"2011","Cheshire East 016B","E01018628","Total",15,7,4,4,2,1,1,0,13,6,3,4
"2011","Cheshire East 016C","E01018629","Total",95,30,20,45,10,3,6,1,85,27,14,44
"2011","Cheshire East 016D","E01018630","Total",41,17,16,8,5,2,1,2,36,15,15,6
"2011","Cheshire East 016E","E01018631","Total",51,16,15,20,11,0,7,4,40,16,8,16
"2011","Cheshire East 017A","E01018615","Total",23,8,10,5,4,0,4,0,19,8,6,5
"2011","Cheshire East 017B","E01018616","Total",16,7,8,1,2,0,2,0,14,7,6,1
"2011","Cheshire East 017C","E01018617","Total",26,7,13,6,5,1,3,1,21,6,10,5
"2011","Cheshire East 017D","E01018632","Total",27,14,10,3,1,0,0,1,26,14,10,2
"2011","Cheshire East 017E","E01018633","Total",9,0,9,0,2,0,2,0,7,0,7,0
"2011","Cheshire East 018A","E01018622","Total",48,15,19,14,5,1,3,1,43,14,16,13
"2011","Cheshire East 018B","E01018623","Total",43,12,16,15,6,0,2,4,37,12,14,11
"2011","Cheshire East 018C","E01018624","Total",55,13,23,19,9,3,6,0,46,10,17,19
"2011","Cheshire East 018D","E01018625","Total",61,23,15,23,7,0,6,1,54,23,9,22
"2011","Cheshire East 018E","E01018627","Total",43,14,15,14,4,2,2,0,39,12,13,14
"2011","Cheshire East 018F","E01018635","Total",36,16,13,7,5,0,4,1,31,16,9,6
"2011","Cheshire East 018G","E01018636","Total",34,9,20,5,5,0,5,0,29,9,15,5
"2011","Cheshire East 019A","E01018634","Total",34,16,10,8,5,1,3,1,29,15,7,7
"2011","Cheshire East 019B","E01018645","Total",73,24,17,32,11,2,6,3,62,22,11,29
"2011","Cheshire East 019C","E01018646","Total",88,30,23,35,7,0,4,3,81,30,19,32
"2011","Cheshire East 019D","E01018647","Total",51,20,15,16,7,0,5,2,44,20,10,14
"2011","Cheshire East 020A","E01018591","Total",31,13,8,10,4,0,3,1,27,13,5,9
"2011","Cheshire East 020B","E01018597","Total",33,15,10,8,5,1,3,1,28,14,7,7
"2011","Cheshire East 020C","E01018669","Total",38,18,16,4,4,0,4,0,34,18,12,4
"2011","Cheshire East 020D","E01018670","Total",30,7,12,11,4,1,3,0,26,6,9,11
"2011","Cheshire East 021A","E01018637","Total",110,40,21,49,7,2,3,2,103,38,18,47
"2011","Cheshire East 021B","E01018638","Total",72,29,17,26,9,1,7,1,63,28,10,25
"2011","Cheshire East 021C","E01018639","Total",84,36,27,21,9,2,3,4,75,34,24,17
"2011","Cheshire East 021D","E01018640","Total",59,20,21,18,11,2,5,4,48,18,16,14
"2011","Cheshire West and Chester 022A","E01018308","Total",36,12,6,18,5,0,2,3,31,12,4,15
"2011","Cheshire West and Chester 022B","E01018336","Total",31,13,10,8,2,1,1,0,29,12,9,8
"2011","Cheshire West and Chester 022C","E01018337","Total",24,10,11,3,5,0,5,0,19,10,6,3
"2011","Cheshire West and Chester 022D","E01018338","Total",59,28,18,13,5,0,4,1,54,28,14,12
"2011","Cheshire West and Chester 022E","E01018358","Total",21,7,6,8,1,0,0,1,20,7,6,7
"2011","Cheshire West and Chester 022F","E01018359","Total",13,6,6,1,2,0,2,0,11,6,4,1
"2011","Cheshire West and Chester 025A","E01018360","Total",28,11,10,7,3,1,1,1,25,10,9,6
"2011","Cheshire West and Chester 025B","E01018366","Total",23,11,7,5,3,0,3,0,20,11,4,5
"2011","Cheshire West and Chester 025C","E01018367","Total",51,21,13,17,5,1,4,0,46,20,9,17
"2011","Cheshire West and Chester 027A","E01018364","Total",101,42,9,50,6,1,1,4,95,41,8,46
"2011","Cheshire West and Chester 027B","E01018365","Total",37,13,17,7,6,1,4,1,31,12,13,6
"2011","Cheshire West and Chester 027C","E01018378","Total",54,16,15,23,11,0,8,3,43,16,7,20
"2011","Cheshire West and Chester 027D","E01018379","Total",28,14,7,7,2,1,1,0,26,13,6,7
"2011","Cheshire West and Chester 027E","E01018380","Total",27,10,9,8,6,0,5,1,21,10,4,7
"2011","Cheshire West and Chester 028A","E01018362","Total",26,8,14,4,5,0,5,0,21,8,9,4
"2011","Cheshire West and Chester 028B","E01018363","Total",19,6,6,7,3,0,2,1,16,6,4,6
"2011","Cheshire West and Chester 028C","E01018374","Total",29,4,21,4,4,0,3,1,25,4,18,3
"2011","Cheshire West and Chester 028D","E01018375","Total",31,10,13,8,3,0,3,0,28,10,10,8
"2011","Cheshire West and Chester 028E","E01018376","Total",32,10,9,13,1,0,1,0,31,10,8,13
"2011","Cheshire West and Chester 028F","E01018377","Total",38,11,20,7,8,0,7,1,30,11,13,6
"2011","Cheshire West and Chester 029A","E01018309","Total",61,21,14,26,5,0,4,1,56,21,10,25
"2011","Cheshire West and Chester 029B","E01018310","Total",101,42,10,49,6,0,0,6,95,42,10,43
"2011","Cheshire West and Chester 029C","E01018311","Total",92,35,13,44,12,3,5,4,80,32,8,40
"2011","Cheshire West and Chester 029D","E01018312","Total",77,32,14,31,8,1,5,2,69,31,9,29
"2011","Cheshire West and Chester 031A","E01018313","Total",40,16,11,13,2,0,0,2,38,16,11,11
"2011","Cheshire West and Chester 031B","E01018314","Total",74,23,17,34,7,2,2,3,67,21,15,31
"2011","Cheshire West and Chester 031C","E01018315","Total",25,11,7,7,4,1,2,1,21,10,5,6
"2011","Cheshire West and Chester 031D","E01018316","Total",93,37,10,46,3,0,0,3,90,37,10,43
"2011","Cheshire West and Chester 031E","E01018317","Total",94,45,10,39,10,1,2,7,84,44,8,32
"2011","Cheshire West and Chester 030A","E01018349","Total",26,7,14,5,4,0,4,0,22,7,10,5
"2011","Cheshire West and Chester 030B","E01018350","Total",20,8,8,4,2,0,2,0,18,8,6,4
"2011","Cheshire West and Chester 030C","E01018368","Total",33,20,8,5,1,1,0,0,32,19,8,5
"2011","Cheshire West and Chester 030D","E01018370","Total",21,9,7,5,3,2,1,0,18,7,6,5
"2011","Cheshire West and Chester 032A","E01018345","Total",36,13,12,11,1,0,1,0,35,13,11,11
"2011","Cheshire West and Chester 032B","E01018346","Total",18,9,6,3,2,0,2,0,16,9,4,3
"2011","Cheshire West and Chester 032C","E01018347","Total",48,17,9,22,4,2,1,1,44,15,8,21
"2011","Cheshire West and Chester 032D","E01018383","Total",30,12,11,7,3,0,2,1,27,12,9,6
"2011","Cheshire West and Chester 032E","E01018384","Total",21,12,4,5,1,0,1,0,20,12,3,5
"2011","Cheshire West and Chester 033B","E01018327","Total",54,22,8,24,5,0,0,5,49,22,8,19
"2011","Cheshire West and Chester 033C","E01018343","Total",43,18,12,13,3,1,1,1,40,17,11,12
"2011","Cheshire West and Chester 033D","E01018361","Total",16,4,6,6,1,0,0,1,15,4,6,5
"2011","Cheshire West and Chester 033E","E01032930","Total",26,8,7,11,3,1,1,1,23,7,6,10
"2011","Cheshire West and Chester 033F","E01032931","Total",19,9,8,2,4,1,2,1,15,8,6,1
"2011","Cheshire West and Chester 034A","E01018326","Total",27,10,7,10,4,0,2,2,23,10,5,8
"2011","Cheshire West and Chester 034B","E01018328","Total",17,6,3,8,2,0,2,0,15,6,1,8
"2011","Cheshire West and Chester 034C","E01018329","Total",25,6,7,12,4,0,3,1,21,6,4,11
"2011","Cheshire West and Chester 034D","E01018330","Total",17,6,10,1,4,1,3,0,13,5,7,1
"2011","Cheshire West and Chester 034E","E01018331","Total",19,11,5,3,2,0,1,1,17,11,4,2
"2011","Cheshire West and Chester 036A","E01018319","Total",72,30,20,22,5,1,2,2,67,29,18,20
"2011","Cheshire West and Chester 036B","E01018344","Total",64,23,23,18,7,0,7,0,57,23,16,18
"2011","Cheshire West and Chester 036C","E01018381","Total",16,8,6,2,2,1,1,0,14,7,5,2
"2011","Cheshire West and Chester 036D","E01018382","Total",46,21,19,6,5,0,5,0,41,21,14,6
"2011","Cheshire West and Chester 039A","E01018323","Total",33,14,8,11,5,1,3,1,28,13,5,10
"2011","Cheshire West and Chester 039B","E01018324","Total",24,16,6,2,0,0,0,0,24,16,6,2
"2011","Cheshire West and Chester 039C","E01018325","Total",22,6,8,8,2,0,2,0,20,6,6,8
"2011","Cheshire West and Chester 039D","E01018385","Total",23,9,9,5,1,0,0,1,22,9,9,4
"2011","Cheshire West and Chester 041A","E01018320","Total",33,13,17,3,3,0,3,0,30,13,14,3
"2011","Cheshire West and Chester 041B","E01018321","Total",23,10,10,3,4,3,1,0,19,7,9,3
"2011","Cheshire West and Chester 041C","E01018322","Total",11,4,6,1,4,0,4,0,7,4,2,1
"2011","Cheshire West and Chester 041D","E01018348","Total",52,23,26,3,6,2,4,0,46,21,22,3
"2011","Cheshire West and Chester 043A","E01018332","Total",11,7,4,0,0,0,0,0,11,7,4,0
"2011","Cheshire West and Chester 043B","E01018333","Total",17,5,7,5,2,0,2,0,15,5,5,5
"2011","Cheshire West and Chester 043C","E01018334","Total",17,4,7,6,1,0,1,0,16,4,6,6
"2011","Cheshire West and Chester 043D","E01018340","Total",36,17,12,7,3,0,3,0,33,17,9,7
"2011","Cheshire West and Chester 043E","E01018341","Total",16,6,6,4,1,0,1,0,15,6,5,4
"2011","Cheshire West and Chester 043F","E01018342","Total",49,18,22,9,0,0,0,0,49,18,22,9
"2011","Cheshire West and Chester 044A","E01018351","Total",84,28,16,40,9,1,4,4,75,27,12,36
"2011","Cheshire West and Chester 044B","E01018352","Total",51,29,13,9,1,0,1,0,50,29,12,9
"2011","Cheshire West and Chester 044C","E01018353","Total",36,11,13,12,3,0,2,1,33,11,11,11
"2011","Cheshire West and Chester 044D","E01018354","Total",96,30,12,54,7,2,1,4,89,28,11,50
"2011","Cheshire West and Chester 046A","E01018335","Total",42,16,15,11,8,1,5,2,34,15,10,9
"2011","Cheshire West and Chester 046B","E01018369","Total",29,11,13,5,3,0,3,0,26,11,10,5
"2011","Cheshire West and Chester 046C","E01018371","Total",47,26,12,9,5,0,5,0,42,26,7,9
"2011","Cheshire West and Chester 046D","E01018372","Total",27,16,7,4,3,1,2,0,24,15,5,4
"2011","Cheshire West and Chester 047A","E01018339","Total",39,13,16,10,6,1,5,0,33,12,11,10
"2011","Cheshire West and Chester 047B","E01018355","Total",23,8,4,11,2,0,0,2,21,8,4,9
"2011","Cheshire West and Chester 047C","E01018356","Total",22,11,3,8,0,0,0,0,22,11,3,8
"2011","Cheshire West and Chester 047D","E01018357","Total",19,9,5,5,3,1,1,1,16,8,4,4
"2011","Cheshire West and Chester 047E","E01018373","Total",24,10,10,4,3,0,3,0,21,10,7,4
"2011","Cheshire West and Chester 001A","E01018534","Total",98,35,19,44,4,0,4,0,94,35,15,44
"2011","Cheshire West and Chester 001B","E01018535","Total",43,11,13,19,5,0,2,3,38,11,11,16
"2011","Cheshire West and Chester 001C","E01018536","Total",39,10,18,11,8,0,6,2,31,10,12,9
"2011","Cheshire West and Chester 001D","E01018537","Total",21,5,12,4,8,0,6,2,13,5,6,2
"2011","Cheshire West and Chester 004A","E01018518","Total",10,4,4,2,2,0,2,0,8,4,2,2
"2011","Cheshire West and Chester 004B","E01018569","Total",12,4,6,2,2,0,2,0,10,4,4,2
"2011","Cheshire West and Chester 004C","E01018570","Total",14,6,4,4,1,0,1,0,13,6,3,4
"2011","Cheshire West and Chester 004D","E01018571","Total",19,8,9,2,2,0,2,0,17,8,7,2
"2011","Cheshire West and Chester 005A","E01018546","Total",82,29,15,38,4,0,2,2,78,29,13,36
"2011","Cheshire West and Chester 005B","E01018547","Total",37,25,3,9,2,2,0,0,35,23,3,9
"2011","Cheshire West and Chester 005C","E01018548","Total",47,16,18,13,7,1,5,1,40,15,13,12
"2011","Cheshire West and Chester 005D","E01018549","Total",30,14,9,7,1,0,0,1,29,14,9,6
"2011","Cheshire West and Chester 006A","E01018532","Total",59,27,14,18,7,1,3,3,52,26,11,15
"2011","Cheshire West and Chester 006B","E01018533","Total",19,12,2,5,1,0,1,0,18,12,1,5
"2011","Cheshire West and Chester 006C","E01018544","Total",32,14,12,6,3,0,2,1,29,14,10,5
"2011","Cheshire West and Chester 006D","E01018545","Total",32,11,19,2,3,1,2,0,29,10,17,2
"2011","Cheshire West and Chester 007A","E01018519","Total",74,27,10,37,7,1,3,3,67,26,7,34
"2011","Cheshire West and Chester 007B","E01018520","Total",58,25,6,27,1,0,1,0,57,25,5,27
"2011","Cheshire West and Chester 007C","E01018525","Total",100,36,16,48,5,0,2,3,95,36,14,45
"2011","Cheshire West and Chester 007D","E01018563","Total",103,33,20,50,8,0,1,7,95,33,19,43
"2011","Cheshire West and Chester 007E","E01018564","Total",94,28,17,49,7,3,3,1,87,25,14,48
"2011","Cheshire West and Chester 008A","E01018523","Total",86,34,21,31,8,0,5,3,78,34,16,28
"2011","Cheshire West and Chester 008B","E01018524","Total",121,53,18,50,8,2,3,3,113,51,15,47
"2011","Cheshire West and Chester 008C","E01018541","Total",43,11,15,17,8,0,5,3,35,11,10,14
"2011","Cheshire West and Chester 008D","E01018542","Total",104,44,15,45,3,0,1,2,101,44,14,43
"2011","Cheshire West and Chester 008E","E01018543","Total",67,31,10,26,2,0,2,0,65,31,8,26
"2011","Cheshire West and Chester 009A","E01018528","Total",25,11,9,5,3,0,2,1,22,11,7,4
"2011","Cheshire West and Chester 009B","E01018529","Total",19,9,7,3,1,0,1,0,18,9,6,3
"2011","Cheshire West and Chester 009C","E01018530","Total",22,5,14,3,5,1,3,1,17,4,11,2
"2011","Cheshire West and Chester 009D","E01018531","Total",28,16,7,5,2,0,1,1,26,16,6,4
"2011","Cheshire West and Chester 009E","E01018560","Total",14,6,6,2,1,0,1,0,13,6,5,2
"2011","Cheshire West and Chester 009F","E01018561","Total",18,6,7,5,1,0,0,1,17,6,7,4
"2011","Cheshire West and Chester 009G","E01018562","Total",39,16,15,8,2,0,2,0,37,16,13,8
"2011","Cheshire West and Chester 010A","E01018522","Total",68,25,19,24,9,1,5,3,59,24,14,21
"2011","Cheshire West and Chester 010B","E01018538","Total",63,27,14,22,2,0,2,0,61,27,12,22
"2011","Cheshire West and Chester 010C","E01018539","Total",63,25,7,31,1,0,1,0,62,25,6,31
"2011","Cheshire West and Chester 010D","E01018540","Total",51,19,14,18,5,0,4,1,46,19,10,17
"2011","Cheshire West and Chester 011A","E01018521","Total",63,26,13,24,7,0,5,2,56,26,8,22
"2011","Cheshire West and Chester 011B","E01018550","Total",73,24,13,36,8,1,2,5,65,23,11,31
"2011","Cheshire West and Chester 011C","E01018551","Total",73,29,16,28,7,2,4,1,66,27,12,27
"2011","Cheshire West and Chester 011D","E01018552","Total",74,28,16,30,13,3,5,5,61,25,11,25
"2011","Cheshire West and Chester 011E","E01018553","Total",70,24,17,29,7,0,4,3,63,24,13,26
"2011","Cheshire West and Chester 013A","E01018556","Total",34,12,12,10,4,1,3,0,30,11,9,10
"2011","Cheshire West and Chester 013B","E01018557","Total",54,17,14,23,4,0,3,1,50,17,11,22
"2011","Cheshire West and Chester 013C","E01018558","Total",38,17,11,10,6,0,4,2,32,17,7,8
"2011","Cheshire West and Chester 013D","E01018559","Total",25,14,7,4,4,3,1,0,21,11,6,4
"2011","Cheshire West and Chester 014A","E01018565","Total",32,14,14,4,4,1,2,1,28,13,12,3
"2011","Cheshire West and Chester 014B","E01018566","Total",18,7,6,5,3,1,0,2,15,6,6,3
"2011","Cheshire West and Chester 014C","E01018567","Total",31,13,12,6,1,0,1,0,30,13,11,6
"2011","Cheshire West and Chester 014D","E01018568","Total",35,15,14,6,4,0,3,1,31,15,11,5
"2011","Cheshire West and Chester 016A","E01018526","Total",36,15,16,5,2,0,1,1,34,15,15,4
"2011","Cheshire West and Chester 016B","E01018527","Total",30,14,13,3,2,1,1,0,28,13,12,3
"2011","Cheshire West and Chester 016C","E01018554","Total",41,19,21,1,5,0,5,0,36,19,16,1
"2011","Cheshire West and Chester 016D","E01018555","Total",22,12,9,1,5,0,5,0,17,12,4,1
"2011","Cheshire West and Chester 002A","E01018685","Total",45,16,9,20,2,0,1,1,43,16,8,19
"2011","Cheshire West and Chester 002B","E01018686","Total",57,18,23,16,11,1,9,1,46,17,14,15
"2011","Cheshire West and Chester 002C","E01018687","Total",19,5,10,4,3,0,3,0,16,5,7,4
"2011","Cheshire West and Chester 002D","E01018688","Total",33,9,16,8,7,0,3,4,26,9,13,4
"2011","Cheshire West and Chester 002E","E01018689","Total",38,13,12,13,5,1,4,0,33,12,8,13
"2011","Cheshire West and Chester 002F","E01018690","Total",31,13,14,4,5,1,4,0,26,12,10,4
"2011","Cheshire West and Chester 003A","E01018675","Total",23,15,5,3,4,1,2,1,19,14,3,2
"2011","Cheshire West and Chester 003B","E01018708","Total",13,3,5,5,1,0,1,0,12,3,4,5
"2011","Cheshire West and Chester 003C","E01018721","Total",30,6,15,9,2,0,1,1,28,6,14,8
"2011","Cheshire West and Chester 012A","E01018671","Total",14,6,4,4,1,0,1,0,13,6,3,4
"2011","Cheshire West and Chester 012B","E01018672","Total",56,20,13,23,6,1,4,1,50,19,9,22
"2011","Cheshire West and Chester 012C","E01018673","Total",33,10,9,14,3,0,3,0,30,10,6,14
"2011","Cheshire West and Chester 012D","E01018674","Total",52,20,11,21,4,1,2,1,48,19,9,20
"2011","Cheshire West and Chester 015A","E01018684","Total",22,9,11,2,8,2,6,0,14,7,5,2
"2011","Cheshire West and Chester 015B","E01018695","Total",42,17,14,11,1,0,1,0,41,17,13,11
"2011","Cheshire West and Chester 015C","E01018696","Total",15,4,8,3,4,0,4,0,11,4,4,3
"2011","Cheshire West and Chester 015D","E01018697","Total",54,19,26,9,8,0,5,3,46,19,21,6
"2011","Cheshire West and Chester 015E","E01018698","Total",22,9,8,5,3,1,1,1,19,8,7,4
"2011","Cheshire West and Chester 017A","E01018704","Total",32,9,13,10,8,0,5,3,24,9,8,7
"2011","Cheshire West and Chester 017B","E01018705","Total",35,15,12,8,4,0,2,2,31,15,10,6
"2011","Cheshire West and Chester 017C","E01018706","Total",43,20,16,7,5,0,4,1,38,20,12,6
"2011","Cheshire West and Chester 017D","E01018718","Total",33,8,14,11,5,0,5,0,28,8,9,11
"2011","Cheshire West and Chester 017E","E01018722","Total",27,10,10,7,6,0,4,2,21,10,6,5
"2011","Cheshire West and Chester 018A","E01018713","Total",93,32,30,31,5,0,4,1,88,32,26,30
"2011","Cheshire West and Chester 018B","E01018714","Total",74,18,20,36,6,0,3,3,68,18,17,33
"2011","Cheshire West and Chester 018C","E01018715","Total",80,30,15,35,10,0,7,3,70,30,8,32
"2011","Cheshire West and Chester 019A","E01018726","Total",48,16,14,18,7,1,5,1,41,15,9,17
"2011","Cheshire West and Chester 019B","E01018727","Total",25,8,9,8,2,0,2,0,23,8,7,8
"2011","Cheshire West and Chester 019C","E01018728","Total",41,18,14,9,4,1,2,1,37,17,12,8
"2011","Cheshire West and Chester 019D","E01018729","Total",50,18,16,16,6,0,5,1,44,18,11,15
"2011","Cheshire West and Chester 020A","E01018709","Total",59,22,19,18,6,0,5,1,53,22,14,17
"2011","Cheshire West and Chester 020B","E01018710","Total",56,19,10,27,9,0,1,8,47,19,9,19
"2011","Cheshire West and Chester 020C","E01018711","Total",39,11,15,13,3,0,2,1,36,11,13,12
"2011","Cheshire West and Chester 020D","E01018712","Total",41,10,15,16,8,2,4,2,33,8,11,14
"2011","Cheshire West and Chester 021A","E01018699","Total",53,25,15,13,3,1,1,1,50,24,14,12
"2011","Cheshire West and Chester 021B","E01018701","Total",68,30,10,28,7,0,2,5,61,30,8,23
"2011","Cheshire West and Chester 021C","E01018716","Total",49,9,11,29,7,1,3,3,42,8,8,26
"2011","Cheshire West and Chester 021D","E01018717","Total",63,22,13,28,3,0,3,0,60,22,10,28
"2011","Cheshire West and Chester 021E","E01018719","Total",40,9,17,14,4,0,3,1,36,9,14,13
"2011","Cheshire West and Chester 021F","E01018720","Total",65,28,20,17,6,1,4,1,59,27,16,16
"2011","Cheshire West and Chester 023A","E01018691","Total",44,16,16,12,5,1,4,0,39,15,12,12
"2011","Cheshire West and Chester 023B","E01018693","Total",21,5,12,4,5,0,4,1,16,5,8,3
"2011","Cheshire West and Chester 023C","E01018694","Total",21,9,8,4,4,1,3,0,17,8,5,4
"2011","Cheshire West and Chester 023D","E01018700","Total",49,21,22,6,8,3,4,1,41,18,18,5
"2011","Cheshire West and Chester 023E","E01018702","Total",35,16,15,4,5,0,5,0,30,16,10,4
"2011","Cheshire West and Chester 023F","E01018703","Total",42,10,23,9,5,0,4,1,37,10,19,8
"2011","Cheshire West and Chester 024A","E01018676","Total",15,5,9,1,1,0,1,0,14,5,8,1
"2011","Cheshire West and Chester 024B","E01018677","Total",10,1,7,2,1,0,1,0,9,1,6,2
"2011","Cheshire West and Chester 024C","E01018678","Total",13,9,2,2,1,0,1,0,12,9,1,2
"2011","Cheshire West and Chester 024D","E01018679","Total",64,22,27,15,10,1,7,2,54,21,20,13
"2011","Cheshire West and Chester 024E","E01018692","Total",21,7,11,3,2,1,1,0,19,6,10,3
"2011","Cheshire West and Chester 026A","E01018680","Total",22,5,13,4,4,1,2,1,18,4,11,3
"2011","Cheshire West and Chester 026B","E01018681","Total",32,13,5,14,0,0,0,0,32,13,5,14
"2011","Cheshire West and Chester 026C","E01018682","Total",33,22,6,5,3,0,1,2,30,22,5,3
"2011","Cheshire West and Chester 026D","E01018683","Total",25,14,7,4,5,2,3,0,20,12,4,4
"2011","Cheshire West and Chester 035A","E01018733","Total",36,15,13,8,1,0,1,0,35,15,12,8
"2011","Cheshire West and Chester 035B","E01018734","Total",44,15,13,16,6,1,4,1,38,14,9,15
"2011","Cheshire West and Chester 035C","E01018748","Total",113,23,14,76,5,0,2,3,108,23,12,73
"2011","Cheshire West and Chester 035D","E01018749","Total",71,22,19,30,11,3,7,1,60,19,12,29
"2011","Cheshire West and Chester 037A","E01018736","Total",48,17,13,18,2,0,1,1,46,17,12,17
"2011","Cheshire West and Chester 037B","E01018737","Total",27,6,15,6,5,0,5,0,22,6,10,6
"2011","Cheshire West and Chester 037C","E01018743","Total",32,15,9,8,1,0,1,0,31,15,8,8
"2011","Cheshire West and Chester 037D","E01018744","Total",75,21,30,24,12,4,5,3,63,17,25,21
"2011","Cheshire West and Chester 038A","E01018732","Total",44,18,10,16,3,0,1,2,41,18,9,14
"2011","Cheshire West and Chester 038B","E01018745","Total",79,23,13,43,11,2,3,6,68,21,10,37
"2011","Cheshire West and Chester 038C","E01018746","Total",49,20,11,18,10,1,3,6,39,19,8,12
"2011","Cheshire West and Chester 038D","E01018747","Total",58,19,18,21,3,0,1,2,55,19,17,19
"2011","Cheshire West and Chester 040A","E01018730","Total",40,14,13,13,6,1,3,2,34,13,10,11
"2011","Cheshire West and Chester 040B","E01018738","Total",112,34,17,61,10,3,4,3,102,31,13,58
"2011","Cheshire West and Chester 040C","E01018739","Total",101,38,15,48,8,2,1,5,93,36,14,43
"2011","Cheshire West and Chester 040D","E01018741","Total",15,8,2,5,0,0,0,0,15,8,2,5
"2011","Cheshire West and Chester 042A","E01018731","Total",75,29,18,28,4,0,3,1,71,29,15,27
"2011","Cheshire West and Chester 042B","E01018735","Total",39,20,4,15,2,0,0,2,37,20,4,13
"2011","Cheshire West and Chester 042C","E01018740","Total",80,21,17,42,5,0,2,3,75,21,15,39
"2011","Cheshire West and Chester 042D","E01018742","Total",30,13,10,7,2,1,1,0,28,12,9,7
"2011","Cheshire West and Chester 045A","E01018707","Total",22,8,10,4,2,0,2,0,20,8,8,4
"2011","Cheshire West and Chester 045B","E01018723","Total",25,10,7,8,2,1,1,0,23,9,6,8
"2011","Cheshire West and Chester 045C","E01018724","Total",20,10,7,3,1,1,0,0,19,9,7,3
"2011","Cheshire West and Chester 045D","E01018725","Total",26,19,4,3,2,0,2,0,24,19,2,3
"2011","Halton 001A","E01012392","Total",61,21,33,7,10,0,9,1,51,21,24,6
"2011","Halton 001B","E01012393","Total",36,7,20,9,5,0,3,2,31,7,17,7
"2011","Halton 001C","E01012395","Total",21,6,13,2,4,0,3,1,17,6,10,1
"2011","Halton 001D","E01012411","Total",35,10,14,11,7,0,6,1,28,10,8,10
"2011","Halton 002A","E01012374","Total",63,30,19,14,8,2,2,4,55,28,17,10
"2011","Halton 002B","E01012375","Total",19,7,11,1,6,0,6,0,13,7,5,1
"2011","Halton 002C","E01012376","Total",63,23,24,16,8,2,5,1,55,21,19,15
"2011","Halton 002D","E01012421","Total",21,5,10,6,1,0,1,0,20,5,9,6
"2011","Halton 002E","E01012423","Total",34,14,16,4,5,2,3,0,29,12,13,4
"2011","Halton 003A","E01012368","Total",83,23,20,40,7,0,3,4,76,23,17,36
"2011","Halton 003B","E01012410","Total",28,10,13,5,3,0,3,0,25,10,10,5
"2011","Halton 003C","E01012412","Total",71,22,19,30,5,0,3,2,66,22,16,28
"2011","Halton 003D","E01012413","Total",74,24,18,32,3,0,0,3,71,24,18,29
"2011","Halton 003E","E01012414","Total",32,16,7,9,1,0,1,0,31,16,6,9
"2011","Halton 004A","E01012377","Total",69,24,14,31,9,2,5,2,60,22,9,29
"2011","Halton 004B","E01012390","Total",58,19,13,26,7,2,2,3,51,17,11,23
"2011","Halton 004C","E01012419","Total",79,23,17,39,6,1,1,4,73,22,16,35
"2011","Halton 004D","E01012420","Total",89,38,14,37,13,6,3,4,76,32,11,33
"2011","Halton 004E","E01012422","Total",115,36,19,60,7,1,2,4,108,35,17,56
"2011","Halton 005A","E01012369","Total",42,12,12,18,6,0,3,3,36,12,9,15
"2011","Halton 005B","E01012394","Total",48,12,14,22,6,0,4,2,42,12,10,20
"2011","Halton 005C","E01012425","Total",74,21,16,37,5,0,2,3,69,21,14,34
"2011","Halton 005D","E01012426","Total",27,9,10,8,6,1,4,1,21,8,6,7
"2011","Halton 005E","E01012427","Total",68,17,19,32,9,4,4,1,59,13,15,31
"2011","Halton 006A","E01012378","Total",33,11,11,11,5,0,1,4,28,11,10,7
"2011","Halton 006B","E01012379","Total",62,14,25,23,9,0,6,3,53,14,19,20
"2011","Halton 006C","E01012380","Total",80,36,11,33,6,0,3,3,74,36,8,30
"2011","Halton 006D","E01012388","Total",122,33,22,67,10,1,7,2,112,32,15,65
"2011","Halton 006E","E01012442","Total",107,34,13,60,7,1,3,3,100,33,10,57
"2011","Halton 007A","E01012367","Total",98,27,16,55,4,0,2,2,94,27,14,53
"2011","Halton 007B","E01012370","Total",93,31,23,39,5,0,3,2,88,31,20,37
"2011","Halton 007C","E01012424","Total",113,27,14,72,10,0,4,6,103,27,10,66
"2011","Halton 007D","E01012441","Total",153,34,28,91,20,2,8,10,133,32,20,81
"2011","Halton 008A","E01012389","Total",22,12,9,1,2,0,1,1,20,12,8,0
"2011","Halton 008B","E01012391","Total",92,27,21,44,4,0,2,2,88,27,19,42
"2011","Halton 008C","E01012401","Total",28,16,8,4,1,0,1,0,27,16,7,4
"2011","Halton 008D","E01012443","Total",61,23,22,16,9,2,6,1,52,21,16,15
"2011","Halton 009A","E01012385","Total",26,9,12,5,7,1,6,0,19,8,6,5
"2011","Halton 009B","E01012386","Total",34,6,21,7,2,0,2,0,32,6,19,7
"2011","Halton 009C","E01012387","Total",23,12,8,3,3,0,2,1,20,12,6,2
"2011","Halton 009D","E01012434","Total",37,12,17,8,3,0,3,0,34,12,14,8
"2011","Halton 009E","E01012435","Total",40,7,21,12,9,0,5,4,31,7,16,8
"2011","Halton 010A","E01012381","Total",76,14,13,49,8,0,3,5,68,14,10,44
"2011","Halton 010B","E01012382","Total",109,26,24,59,19,2,6,11,90,24,18,48
"2011","Halton 010C","E01012384","Total",31,17,4,10,1,0,1,0,30,17,3,10
"2011","Halton 010D","E01012444","Total",85,24,15,46,10,2,5,3,75,22,10,43
"2011","Halton 010E","E01012445","Total",88,29,9,50,6,0,2,4,82,29,7,46
"2011","Halton 011A","E01012398","Total",33,15,9,9,2,0,1,1,31,15,8,8
"2011","Halton 011B","E01012400","Total",45,20,15,10,3,0,2,1,42,20,13,9
"2011","Halton 011C","E01012402","Total",91,25,22,44,6,1,4,1,85,24,18,43
"2011","Halton 011D","E01012404","Total",46,5,19,22,12,0,7,5,34,5,12,17
"2011","Halton 011E","E01012405","Total",75,24,23,28,10,0,9,1,65,24,14,27
"2011","Halton 012A","E01012416","Total",49,19,14,16,4,0,2,2,45,19,12,14
"2011","Halton 012B","E01012417","Total",74,25,18,31,10,0,4,6,64,25,14,25
"2011","Halton 012C","E01012428","Total",91,32,20,39,9,1,3,5,82,31,17,34
"2011","Halton 012D","E01012429","Total",77,21,23,33,7,0,3,4,70,21,20,29
"2011","Halton 012E","E01012430","Total",124,25,24,75,28,3,12,13,96,22,12,62
"2011","Halton 012F","E01012431","Total",96,27,27,42,15,0,10,5,81,27,17,37
"2011","Halton 013A","E01012383","Total",61,21,13,27,7,1,3,3,54,20,10,24
"2011","Halton 013B","E01012396","Total",95,27,17,51,10,2,5,3,85,25,12,48
"2011","Halton 013C","E01012397","Total",109,34,12,63,6,2,1,3,103,32,11,60
"2011","Halton 013D","E01012399","Total",81,25,22,34,5,1,2,2,76,24,20,32
"2011","Halton 013E","E01012403","Total",119,28,20,71,12,0,3,9,107,28,17,62
"2011","Halton 013F","E01012408","Total",146,33,18,95,10,0,3,7,136,33,15,88
"2011","Halton 014A","E01012432","Total",80,29,19,32,2,1,0,1,78,28,19,31
"2011","Halton 014B","E01012433","Total",125,29,26,70,11,1,5,5,114,28,21,65
"2011","Halton 014C","E01012436","Total",146,32,25,89,16,0,5,11,130,32,20,78
"2011","Halton 014D","E01012438","Total",84,19,12,53,7,0,2,5,77,19,10,48
"2011","Halton 014E","E01012440","Total",39,9,17,13,5,1,3,1,34,8,14,12
"2011","Halton 015A","E01012406","Total",78,20,26,32,11,1,7,3,67,19,19,29
"2011","Halton 015B","E01012407","Total",99,31,16,52,7,0,4,3,92,31,12,49
"2011","Halton 015C","E01012409","Total",73,13,20,40,14,0,6,8,59,13,14,32
"2011","Halton 015D","E01012437","Total",95,24,21,50,8,1,5,2,87,23,16,48
"2011","Halton 015E","E01012439","Total",101,25,18,58,9,2,4,3,92,23,14,55
"2011","Halton 016A","E01012371","Total",22,4,10,8,2,0,0,2,20,4,10,6
"2011","Halton 016B","E01012372","Total",18,8,8,2,3,0,2,1,15,8,6,1
"2011","Halton 016C","E01012373","Total",12,5,7,0,1,1,0,0,11,4,7,0
"2011","Halton 016D","E01012415","Total",23,6,12,5,2,0,2,0,21,6,10,5
"2011","Halton 016E","E01012418","Total",20,9,9,2,3,0,3,0,17,9,6,2
"2011","Warrington 001A","E01012471","Total",23,7,11,5,5,2,2,1,18,5,9,4
"2011","Warrington 001B","E01012472","Total",35,11,15,9,2,0,1,1,33,11,14,8
"2011","Warrington 001C","E01012476","Total",33,16,11,6,7,2,4,1,26,14,7,5
"2011","Warrington 001D","E01012477","Total",18,8,7,3,2,0,2,0,16,8,5,3
"2011","Warrington 002A","E01012473","Total",28,5,19,4,2,0,2,0,26,5,17,4
"2011","Warrington 002B","E01012474","Total",43,18,10,15,5,0,4,1,38,18,6,14
"2011","Warrington 002C","E01012475","Total",55,12,28,15,11,0,8,3,44,12,20,12
"2011","Warrington 002D","E01012554","Total",39,12,18,9,6,1,4,1,33,11,14,8
"2011","Warrington 003A","E01012467","Total",11,4,4,3,2,0,1,1,9,4,3,2
"2011","Warrington 003B","E01012468","Total",37,17,14,6,1,0,1,0,36,17,13,6
"2011","Warrington 003C","E01012469","Total",38,8,24,6,1,0,1,0,37,8,23,6
"2011","Warrington 003D","E01012470","Total",49,13,10,26,6,1,0,5,43,12,10,21
"2011","Warrington 004A","E01012460","Total",75,28,14,33,4,0,2,2,71,28,12,31
"2011","Warrington 004B","E01012462","Total",34,9,20,5,4,0,4,0,30,9,16,5
"2011","Warrington 004C","E01012463","Total",12,5,6,1,1,0,1,0,11,5,5,1
"2011","Warrington 004D","E01012464","Total",49,17,13,19,4,0,1,3,45,17,12,16
"2011","Warrington 005A","E01012459","Total",62,22,15,25,5,0,2,3,57,22,13,22
"2011","Warrington 005B","E01012461","Total",20,9,8,3,1,0,0,1,19,9,8,2
"2011","Warrington 005C","E01012465","Total",31,6,18,7,5,0,3,2,26,6,15,5
"2011","Warrington 005D","E01012466","Total",90,25,26,39,7,2,4,1,83,23,22,38
"2011","Warrington 006A","E01012526","Total",126,31,27,68,18,0,9,9,108,31,18,59
"2011","Warrington 006B","E01012534","Total",93,39,17,37,6,1,0,5,87,38,17,32
"2011","Warrington 006C","E01012535","Total",110,40,23,47,6,1,3,2,104,39,20,45
"2011","Warrington 006D","E01012537","Total",99,29,28,42,10,2,7,1,89,27,21,41
"2011","Warrington 006E","E01012539","Total",78,24,30,24,11,0,8,3,67,24,22,21
"2011","Warrington 007A","E01012538","Total",23,9,11,3,5,1,3,1,18,8,8,2
"2011","Warrington 007B","E01012540","Total",25,9,13,3,5,0,4,1,20,9,9,2
"2011","Warrington 007C","E01012541","Total",35,16,7,12,0,0,0,0,35,16,7,12
"2011","Warrington 007D","E01012542","Total",41,12,15,14,4,0,4,0,37,12,11,14
"2011","Warrington 007E","E01012543","Total",35,10,19,6,5,1,4,0,30,9,15,6
"2011","Warrington 007F","E01012544","Total",43,19,11,13,6,2,4,0,37,17,7,13
"2011","Warrington 008A","E01012521","Total",60,25,12,23,2,0,2,0,58,25,10,23
"2011","Warrington 008B","E01012522","Total",55,14,15,26,8,1,3,4,47,13,12,22
"2011","Warrington 008C","E01012533","Total",119,26,24,69,12,1,5,6,107,25,19,63
"2011","Warrington 008D","E01012536","Total",78,27,26,25,8,1,5,2,70,26,21,23
"2011","Warrington 008E","E01012545","Total",130,52,21,57,13,0,5,8,117,52,16,49
"2011","Warrington 008F","E01012546","Total",117,48,17,52,10,0,6,4,107,48,11,48
"2011","Warrington 009A","E01012561","Total",28,11,10,7,4,3,1,0,24,8,9,7
"2011","Warrington 009B","E01012562","Total",40,10,22,8,3,0,3,0,37,10,19,8
"2011","Warrington 009C","E01012567","Total",45,20,20,5,5,0,5,0,40,20,15,5
"2011","Warrington 009D","E01012568","Total",66,28,33,5,5,1,2,2,61,27,31,3
"2011","Warrington 010A","E01012563","Total",31,13,14,4,5,2,3,0,26,11,11,4
"2011","Warrington 010B","E01012564","Total",28,8,15,5,6,0,5,1,22,8,10,4
"2011","Warrington 010C","E01012565","Total",66,19,30,17,9,3,6,0,57,16,24,17
"2011","Warrington 010D","E01012566","Total",36,13,16,7,8,1,6,1,28,12,10,6
"2011","Warrington 010E","E01012569","Total",34,12,13,9,3,0,3,0,31,12,10,9
"2011","Warrington 010F","E01012570","Total",41,11,11,19,6,1,2,3,35,10,9,16
"2011","Warrington 011A","E01012481","Total",98,36,36,26,11,2,6,3,87,34,30,23
"2011","Warrington 011B","E01012482","Total",79,31,24,24,11,3,4,4,68,28,20,20
"2011","Warrington 011C","E01012520","Total",78,30,15,33,8,1,2,5,70,29,13,28
"2011","Warrington 011D","E01012523","Total",52,23,14,15,6,0,3,3,46,23,11,12
"2011","Warrington 011E","E01012524","Total",26,12,7,7,2,2,0,0,24,10,7,7
"2011","Warrington 011F","E01012525","Total",68,34,14,20,3,0,2,1,65,34,12,19
"2011","Warrington 012A","E01012478","Total",55,27,17,11,4,1,3,0,51,26,14,11
"2011","Warrington 012B","E01012547","Total",42,13,21,8,3,1,2,0,39,12,19,8
"2011","Warrington 012C","E01012548","Total",34,13,20,1,7,0,7,0,27,13,13,1
"2011","Warrington 012D","E01012549","Total",24,6,15,3,6,0,6,0,18,6,9,3
"2011","Warrington 012E","E01012550","Total",35,15,16,4,2,0,2,0,33,15,14,4
"2011","Warrington 013A","E01012453","Total",111,34,19,58,7,1,3,3,104,33,16,55
"2011","Warrington 013B","E01012454","Total",80,31,19,30,9,0,2,7,71,31,17,23
"2011","Warrington 013C","E01012455","Total",131,30,25,76,13,1,6,6,118,29,19,70
"2011","Warrington 013D","E01012457","Total",70,26,17,27,10,0,8,2,60,26,9,25
"2011","Warrington 014A","E01012551","Total",27,8,17,2,10,1,8,1,17,7,9,1
"2011","Warrington 014B","E01012552","Total",38,14,16,8,5,0,4,1,33,14,12,7
"2011","Warrington 014C","E01012553","Total",18,9,8,1,2,0,2,0,16,9,6,1
"2011","Warrington 014D","E01012555","Total",28,7,17,4,7,3,3,1,21,4,14,3
"2011","Warrington 014E","E01012556","Total",19,5,12,2,5,0,5,0,14,5,7,2
"2011","Warrington 015A","E01012491","Total",37,18,10,9,2,0,1,1,35,18,9,8
"2011","Warrington 015B","E01012492","Total",23,9,11,3,2,0,2,0,21,9,9,3
"2011","Warrington 015C","E01012493","Total",30,12,15,3,3,0,1,2,27,12,14,1
"2011","Warrington 015D","E01012494","Total",35,4,23,8,2,0,2,0,33,4,21,8
"2011","Warrington 015E","E01012500","Total",25,5,16,4,8,1,7,0,17,4,9,4
"2011","Warrington 016A","E01012495","Total",37,18,16,3,4,0,4,0,33,18,12,3
"2011","Warrington 016B","E01012496","Total",37,14,17,6,3,0,3,0,34,14,14,6
"2011","Warrington 016C","E01012497","Total",58,20,21,17,8,0,7,1,50,20,14,16
"2011","Warrington 016D","E01012498","Total",61,17,27,17,2,0,2,0,59,17,25,17
"2011","Warrington 016E","E01012499","Total",70,29,30,11,5,0,5,0,65,29,25,11
"2011","Warrington 016F","E01012501","Total",47,20,20,7,7,0,5,2,40,20,15,5
"2011","Warrington 017A","E01012479","Total",85,33,14,38,8,2,3,3,77,31,11,35
"2011","Warrington 017B","E01012480","Total",52,16,20,16,7,0,4,3,45,16,16,13
"2011","Warrington 017D","E01012510","Total",58,17,18,23,5,1,4,0,53,16,14,23
"2011","Warrington 017E","E01012511","Total",80,25,23,32,6,0,2,4,74,25,21,28
"2011","Warrington 017F","E01033299","Total",110,39,35,36,19,4,8,7,91,35,27,29
"2011","Warrington 017G","E01033303","Total",61,24,10,27,4,2,0,2,57,22,10,25
"2011","Warrington 018B","E01012458","Total",97,26,36,35,12,0,11,1,85,26,25,34
"2011","Warrington 018C","E01012483","Total",89,28,21,40,13,2,6,5,76,26,15,35
"2011","Warrington 018D","E01012509","Total",56,23,20,13,3,0,3,0,53,23,17,13
"2011","Warrington 018E","E01012512","Total",26,9,11,6,3,0,3,0,23,9,8,6
"2011","Warrington 018F","E01033300","Total",10,2,3,5,2,0,1,1,8,2,2,4
"2011","Warrington 018G","E01033302","Total",59,20,10,29,5,0,3,2,54,20,7,27
"2011","Warrington 019A","E01012527","Total",28,12,12,4,1,0,1,0,27,12,11,4
"2011","Warrington 019B","E01012528","Total",17,6,8,3,2,0,2,0,15,6,6,3
"2011","Warrington 019C","E01012529","Total",30,8,12,10,3,0,2,1,27,8,10,9
"2011","Warrington 019D","E01012530","Total",17,6,6,5,2,0,1,1,15,6,5,4
"2011","Warrington 019E","E01012531","Total",35,14,14,7,2,0,2,0,33,14,12,7
"2011","Warrington 019F","E01012532","Total",24,6,13,5,6,0,4,2,18,6,9,3
"2011","Warrington 020A","E01012504","Total",89,20,27,42,15,1,7,7,74,19,20,35
"2011","Warrington 020B","E01012505","Total",64,23,23,18,10,0,7,3,54,23,16,15
"2011","Warrington 020C","E01012506","Total",78,27,22,29,6,0,2,4,72,27,20,25
"2011","Warrington 020D","E01012507","Total",78,19,37,22,14,1,12,1,64,18,25,21
"2011","Warrington 020E","E01012508","Total",75,27,15,33,1,0,1,0,74,27,14,33
"2011","Warrington 021A","E01012513","Total",40,13,21,6,6,1,4,1,34,12,17,5
"2011","Warrington 021B","E01012514","Total",37,13,19,5,2,0,2,0,35,13,17,5
"2011","Warrington 021C","E01012515","Total",39,16,12,11,6,1,4,1,33,15,8,10
"2011","Warrington 021D","E01012516","Total",19,8,9,2,6,2,3,1,13,6,6,1
"2011","Warrington 021E","E01012517","Total",55,18,30,7,11,1,10,0,44,17,20,7
"2011","Warrington 021F","E01012518","Total",79,31,24,24,9,3,5,1,70,28,19,23
"2011","Warrington 021G","E01012519","Total",35,9,21,5,10,0,9,1,25,9,12,4
"2011","Warrington 022A","E01012485","Total",60,20,22,18,3,1,2,0,57,19,20,18
"2011","Warrington 022B","E01012486","Total",39,15,20,4,5,0,4,1,34,15,16,3
"2011","Warrington 022C","E01012487","Total",41,16,21,4,1,0,1,0,40,16,20,4
"2011","Warrington 022D","E01012489","Total",23,13,9,1,0,0,0,0,23,13,9,1
"2011","Warrington 022E","E01012490","Total",30,11,15,4,2,0,2,0,28,11,13,4
"2011","Warrington 023A","E01012450","Total",13,3,6,4,2,0,2,0,11,3,4,4
"2011","Warrington 023B","E01012451","Total",62,13,27,22,4,1,2,1,58,12,25,21
"2011","Warrington 023C","E01012557","Total",38,5,24,9,2,0,2,0,36,5,22,9
"2011","Warrington 023D","E01012558","Total",37,15,17,5,6,0,6,0,31,15,11,5
"2011","Warrington 023E","E01012559","Total",14,4,5,5,3,0,1,2,11,4,4,3
"2011","Warrington 023F","E01012560","Total",23,6,12,5,0,0,0,0,23,6,12,5
"2011","Warrington 024A","E01012448","Total",19,7,10,2,2,0,2,0,17,7,8,2
"2011","Warrington 024B","E01012488","Total",19,6,10,3,7,0,6,1,12,6,4,2
"2011","Warrington 024C","E01012502","Total",25,11,13,1,2,0,2,0,23,11,11,1
"2011","Warrington 024D","E01012503","Total",23,11,8,4,6,3,3,0,17,8,5,4
"2011","Warrington 025A","E01012446","Total",16,5,10,1,2,1,1,0,14,4,9,1
"2011","Warrington 025B","E01012447","Total",15,5,9,1,2,1,1,0,13,4,8,1
"2011","Warrington 025C","E01012449","Total",20,6,12,2,6,0,6,0,14,6,6,2
"2011","Warrington 025D","E01012452","Total",21,7,8,6,3,0,2,1,18,7,6,5
"2011","Allerdale 001A","E01019126","Total",40,12,4,24,3,0,2,1,37,12,2,23
"2011","Allerdale 001B","E01019127","Total",7,3,0,4,0,0,0,0,7,3,0,4
"2011","Allerdale 001C","E01019132","Total",12,5,3,4,2,0,2,0,10,5,1,4
"2011","Allerdale 001D","E01019134","Total",29,14,5,10,4,0,3,1,25,14,2,9
"2011","Allerdale 001E","E01019135","Total",57,27,6,24,10,1,4,5,47,26,2,19
"2011","Allerdale 001F","E01019136","Total",39,16,15,8,5,0,5,0,34,16,10,8
"2011","Allerdale 001G","E01019137","Total",34,13,8,13,0,0,0,0,34,13,8,13
"2011","Allerdale 002A","E01019083","Total",14,3,7,4,2,0,2,0,12,3,5,4
"2011","Allerdale 002B","E01019107","Total",19,3,7,9,3,0,3,0,16,3,4,9
"2011","Allerdale 002C","E01019130","Total",22,9,6,7,1,0,0,1,21,9,6,6
"2011","Allerdale 002D","E01019131","Total",19,12,6,1,2,0,2,0,17,12,4,1
"2011","Allerdale 003A","E01019081","Total",62,21,16,25,5,0,4,1,57,21,12,24
"2011","Allerdale 003B","E01019082","Total",32,15,5,12,1,0,1,0,31,15,4,12
"2011","Allerdale 003C","E01019102","Total",43,18,7,18,6,0,1,5,37,18,6,13
"2011","Allerdale 003D","E01019128","Total",21,9,3,9,3,2,1,0,18,7,2,9
"2011","Allerdale 003E","E01019133","Total",24,12,8,4,2,1,1,0,22,11,7,4
"2011","Allerdale 004A","E01019093","Total",34,14,7,13,4,0,3,1,30,14,4,12
"2011","Allerdale 004B","E01019094","Total",30,18,3,9,1,0,1,0,29,18,2,9
"2011","Allerdale 004C","E01019096","Total",43,24,8,11,2,0,2,0,41,24,6,11
"2011","Allerdale 004D","E01019114","Total",38,18,10,10,3,1,2,0,35,17,8,10
"2011","Allerdale 004E","E01019115","Total",37,12,10,15,4,0,3,1,33,12,7,14
"2011","Allerdale 005A","E01019095","Total",78,35,12,31,5,1,4,0,73,34,8,31
"2011","Allerdale 005B","E01019097","Total",86,32,14,40,5,1,1,3,81,31,13,37
"2011","Allerdale 005C","E01019098","Total",50,19,7,24,3,0,1,2,47,19,6,22
"2011","Allerdale 005D","E01019099","Total",47,13,12,22,4,0,2,2,43,13,10,20
"2011","Allerdale 006A","E01019084","Total",56,31,12,13,4,1,3,0,52,30,9,13
"2011","Allerdale 006B","E01019085","Total",20,5,8,7,4,1,3,0,16,4,5,7
"2011","Allerdale 006C","E01019086","Total",7,3,3,1,1,0,1,0,6,3,2,1
"2011","Allerdale 006D","E01019088","Total",38,15,18,5,6,1,4,1,32,14,14,4
"2011","Allerdale 006E","E01019091","Total",34,11,17,6,7,0,7,0,27,11,10,6
"2011","Allerdale 007A","E01019078","Total",16,7,9,0,6,1,5,0,10,6,4,0
"2011","Allerdale 007B","E01019079","Total",34,10,13,11,4,0,2,2,30,10,11,9
"2011","Allerdale 007C","E01019080","Total",84,33,19,32,11,1,4,6,73,32,15,26
"2011","Allerdale 007D","E01019087","Total",26,11,11,4,4,0,3,1,22,11,8,3
"2011","Allerdale 007E","E01019090","Total",11,6,3,2,0,0,0,0,11,6,3,2
"2011","Allerdale 008A","E01019116","Total",43,17,13,13,8,0,5,3,35,17,8,10
"2011","Allerdale 008B","E01019118","Total",55,21,20,14,6,0,5,1,49,21,15,13
"2011","Allerdale 008C","E01019122","Total",66,23,7,36,7,0,2,5,59,23,5,31
"2011","Allerdale 008D","E01019123","Total",54,31,6,17,4,1,1,2,50,30,5,15
"2011","Allerdale 008E","E01019124","Total",29,14,13,2,3,0,3,0,26,14,10,2
"2011","Allerdale 008F","E01019125","Total",32,14,14,4,4,1,3,0,28,13,11,4
"2011","Allerdale 009A","E01019111","Total",88,28,14,46,7,1,4,2,81,27,10,44
"2011","Allerdale 009B","E01019112","Total",86,29,13,44,9,1,3,5,77,28,10,39
"2011","Allerdale 009C","E01019113","Total",131,43,27,61,12,1,5,6,119,42,22,55
"2011","Allerdale 009D","E01019120","Total",57,21,16,20,5,0,3,2,52,21,13,18
"2011","Allerdale 009E","E01019121","Total",77,37,14,26,6,1,3,2,71,36,11,24
"2011","Allerdale 010A","E01019108","Total",97,46,11,40,3,1,1,1,94,45,10,39
"2011","Allerdale 010B","E01019109","Total",74,21,19,34,3,0,0,3,71,21,19,31
"2011","Allerdale 010C","E01019110","Total",116,56,16,44,6,1,2,3,110,55,14,41
"2011","Allerdale 010D","E01019117","Total",21,8,9,4,4,0,4,0,17,8,5,4
"2011","Allerdale 010E","E01019119","Total",14,6,6,2,2,0,2,0,12,6,4,2
"2011","Allerdale 011A","E01019089","Total",36,17,11,8,1,0,1,0,35,17,10,8
"2011","Allerdale 011B","E01019100","Total",30,14,12,4,2,0,2,0,28,14,10,4
"2011","Allerdale 011C","E01019101","Total",13,1,8,4,2,0,2,0,11,1,6,4
"2011","Allerdale 011D","E01019129","Total",19,10,7,2,4,3,1,0,15,7,6,2
"2011","Allerdale 012A","E01019092","Total",13,4,8,1,3,0,3,0,10,4,5,1
"2011","Allerdale 012B","E01019103","Total",38,23,11,4,8,2,6,0,30,21,5,4
"2011","Allerdale 012C","E01019104","Total",38,13,13,12,9,0,8,1,29,13,5,11
"2011","Allerdale 012D","E01019105","Total",20,10,7,3,2,0,2,0,18,10,5,3
"2011","Allerdale 012E","E01019106","Total",17,7,5,5,6,1,4,1,11,6,1,4
"2011","Barrow-in-Furness 001A","E01019144","Total",37,20,6,11,6,3,2,1,31,17,4,10
"2011","Barrow-in-Furness 001B","E01019145","Total",50,24,16,10,6,0,5,1,44,24,11,9
"2011","Barrow-in-Furness 001C","E01019146","Total",17,5,8,4,2,0,2,0,15,5,6,4
"2011","Barrow-in-Furness 001D","E01019147","Total",68,29,17,22,5,2,3,0,63,27,14,22
"2011","Barrow-in-Furness 002A","E01019148","Total",29,14,12,3,7,2,4,1,22,12,8,2
"2011","Barrow-in-Furness 002B","E01019149","Total",43,18,17,8,5,0,4,1,38,18,13,7
"2011","Barrow-in-Furness 002C","E01019150","Total",57,28,14,15,8,0,4,4,49,28,10,11
"2011","Barrow-in-Furness 002D","E01019151","Total",43,16,11,16,5,1,2,2,38,15,9,14
"2011","Barrow-in-Furness 003A","E01019152","Total",7,2,4,1,3,0,2,1,4,2,2,0
"2011","Barrow-in-Furness 003B","E01019153","Total",17,7,8,2,4,0,4,0,13,7,4,2
"2011","Barrow-in-Furness 003C","E01019154","Total",6,2,3,1,0,0,0,0,6,2,3,1
"2011","Barrow-in-Furness 003D","E01019155","Total",11,3,5,3,1,0,1,0,10,3,4,3
"2011","Barrow-in-Furness 003E","E01019162","Total",28,13,12,3,4,0,4,0,24,13,8,3
"2011","Barrow-in-Furness 003F","E01019163","Total",6,2,2,2,0,0,0,0,6,2,2,2
"2011","Barrow-in-Furness 004A","E01019156","Total",69,26,14,29,3,0,0,3,66,26,14,26
"2011","Barrow-in-Furness 004B","E01019159","Total",53,20,9,24,2,0,0,2,51,20,9,22
"2011","Barrow-in-Furness 004C","E01019164","Total",102,33,10,59,11,1,0,10,91,32,10,49
"2011","Barrow-in-Furness 004D","E01019165","Total",52,16,9,27,5,0,2,3,47,16,7,24
"2011","Barrow-in-Furness 004E","E01019166","Total",56,22,14,20,6,0,3,3,50,22,11,17
"2011","Barrow-in-Furness 005A","E01019167","Total",65,30,15,20,5,1,2,2,60,29,13,18
"2011","Barrow-in-Furness 005B","E01019168","Total",28,12,11,5,7,2,4,1,21,10,7,4
"2011","Barrow-in-Furness 005C","E01019169","Total",18,4,7,7,1,0,0,1,17,4,7,6
"2011","Barrow-in-Furness 005D","E01019170","Total",52,14,25,13,6,0,6,0,46,14,19,13
"2011","Barrow-in-Furness 005E","E01019171","Total",61,25,11,25,15,0,6,9,46,25,5,16
"2011","Barrow-in-Furness 006A","E01019161","Total",54,22,14,18,6,2,3,1,48,20,11,17
"2011","Barrow-in-Furness 006B","E01019176","Total",16,8,4,4,0,0,0,0,16,8,4,4
"2011","Barrow-in-Furness 006C","E01019177","Total",71,26,9,36,7,0,2,5,64,26,7,31
"2011","Barrow-in-Furness 006D","E01019178","Total",29,15,11,3,1,0,1,0,28,15,10,3
"2011","Barrow-in-Furness 006E","E01019179","Total",18,7,7,4,4,2,2,0,14,5,5,4
"2011","Barrow-in-Furness 007A","E01019140","Total",84,30,8,46,6,1,3,2,78,29,5,44
"2011","Barrow-in-Furness 007B","E01019160","Total",55,21,8,26,8,1,1,6,47,20,7,20
"2011","Barrow-in-Furness 007C","E01019172","Total",64,23,17,24,5,1,1,3,59,22,16,21
"2011","Barrow-in-Furness 007D","E01019173","Total",63,19,18,26,6,1,2,3,57,18,16,23
"2011","Barrow-in-Furness 007E","E01019174","Total",57,15,9,33,6,1,2,3,51,14,7,30
"2011","Barrow-in-Furness 007F","E01019175","Total",67,25,17,25,2,0,2,0,65,25,15,25
"2011","Barrow-in-Furness 008A","E01019141","Total",66,21,6,39,9,1,0,8,57,20,6,31
"2011","Barrow-in-Furness 008B","E01019142","Total",101,32,11,58,4,0,3,1,97,32,8,57
"2011","Barrow-in-Furness 008C","E01019143","Total",92,28,17,47,11,2,7,2,81,26,10,45
"2011","Barrow-in-Furness 008D","E01019157","Total",87,26,14,47,10,2,2,6,77,24,12,41
"2011","Barrow-in-Furness 008E","E01019158","Total",75,24,13,38,9,2,4,3,66,22,9,35
"2011","Barrow-in-Furness 009A","E01019180","Total",23,9,8,6,2,1,1,0,21,8,7,6
"2011","Barrow-in-Furness 009C","E01019182","Total",38,18,13,7,4,0,4,0,34,18,9,7
"2011","Barrow-in-Furness 009E","E01019184","Total",57,24,13,20,7,2,2,3,50,22,11,17
"2011","Barrow-in-Furness 009F","E01033160","Total",69,31,13,25,8,0,5,3,61,31,8,22
"2011","Barrow-in-Furness 010A","E01019138","Total",40,20,8,12,2,0,1,1,38,20,7,11
"2011","Barrow-in-Furness 010B","E01019139","Total",63,17,6,40,10,0,1,9,53,17,5,31
"2011","Barrow-in-Furness 010C","E01019185","Total",24,12,7,5,3,0,2,1,21,12,5,4
"2011","Barrow-in-Furness 010D","E01019186","Total",49,20,11,18,7,2,2,3,42,18,9,15
"2011","Barrow-in-Furness 010E","E01019187","Total",33,10,11,12,5,0,3,2,28,10,8,10
"2011","Carlisle 001A","E01019226","Total",20,10,2,8,2,0,1,1,18,10,1,7
"2011","Carlisle 001B","E01019227","Total",31,14,5,12,1,0,1,0,30,14,4,12
"2011","Carlisle 001C","E01019228","Total",35,14,13,8,8,2,6,0,27,12,7,8
"2011","Carlisle 001D","E01019229","Total",19,6,9,4,1,0,1,0,18,6,8,4
"2011","Carlisle 002A","E01019200","Total",23,9,9,5,4,1,2,1,19,8,7,4
"2011","Carlisle 002B","E01019201","Total",50,22,16,12,9,2,4,3,41,20,12,9
"2011","Carlisle 002C","E01019202","Total",56,23,17,16,3,1,2,0,53,22,15,16
"2011","Carlisle 002D","E01019225","Total",27,12,11,4,3,0,1,2,24,12,10,2
"2011","Carlisle 003A","E01019188","Total",49,21,13,15,3,1,1,1,46,20,12,14
"2011","Carlisle 003B","E01019189","Total",65,28,20,17,3,1,2,0,62,27,18,17
"2011","Carlisle 003C","E01019190","Total",13,8,2,3,2,0,2,0,11,8,0,3
"2011","Carlisle 003D","E01019191","Total",28,10,13,5,3,0,3,0,25,10,10,5
"2011","Carlisle 003E","E01019244","Total",24,12,8,4,2,0,1,1,22,12,7,3
"2011","Carlisle 004A","E01019196","Total",54,17,18,19,2,0,2,0,52,17,16,19
"2011","Carlisle 004B","E01019238","Total",17,8,9,0,4,0,4,0,13,8,5,0
"2011","Carlisle 004C","E01019240","Total",28,11,12,5,6,0,5,1,22,11,7,4
"2011","Carlisle 004D","E01019241","Total",23,9,10,4,5,1,4,0,18,8,6,4
"2011","Carlisle 004E","E01019243","Total",29,14,13,2,1,0,1,0,28,14,12,2
"2011","Carlisle 004F","E01019251","Total",26,8,13,5,4,0,4,0,22,8,9,5
"2011","Carlisle 005A","E01019192","Total",29,13,10,6,4,0,4,0,25,13,6,6
"2011","Carlisle 005B","E01019195","Total",27,12,4,11,1,0,1,0,26,12,3,11
"2011","Carlisle 005C","E01019203","Total",28,12,8,8,6,0,6,0,22,12,2,8
"2011","Carlisle 005D","E01019254","Total",17,7,7,3,1,0,1,0,16,7,6,3
"2011","Carlisle 005E","E01019255","Total",25,15,8,2,6,1,5,0,19,14,3,2
"2011","Carlisle 006A","E01019204","Total",29,11,10,8,1,0,0,1,28,11,10,7
"2011","Carlisle 006B","E01019206","Total",33,17,8,8,5,0,2,3,28,17,6,5
"2011","Carlisle 006C","E01019234","Total",42,14,14,14,3,1,2,0,39,13,12,14
"2011","Carlisle 006D","E01019235","Total",36,15,16,5,5,0,5,0,31,15,11,5
"2011","Carlisle 006E","E01019237","Total",36,12,14,10,3,0,2,1,33,12,12,9
"2011","Carlisle 006F","E01019242","Total",25,8,9,8,1,0,1,0,24,8,8,8
"2011","Carlisle 007A","E01019219","Total",26,13,10,3,6,2,3,1,20,11,7,2
"2011","Carlisle 007B","E01019224","Total",35,13,11,11,5,2,3,0,30,11,8,11
"2011","Carlisle 007C","E01019239","Total",23,8,10,5,2,0,1,1,21,8,9,4
"2011","Carlisle 007D","E01019249","Total",22,15,5,2,1,1,0,0,21,14,5,2
"2011","Carlisle 007E","E01019250","Total",20,10,7,3,6,1,3,2,14,9,4,1
"2011","Carlisle 008A","E01019205","Total",75,30,15,30,4,0,2,2,71,30,13,28
"2011","Carlisle 008B","E01019207","Total",83,32,15,36,5,1,3,1,78,31,12,35
"2011","Carlisle 008C","E01019215","Total",50,12,10,28,5,0,2,3,45,12,8,25
"2011","Carlisle 008D","E01019218","Total",62,21,13,28,4,0,2,2,58,21,11,26
"2011","Carlisle 008E","E01019233","Total",29,14,7,8,7,0,4,3,22,14,3,5
"2011","Carlisle 009A","E01019193","Total",107,32,17,58,9,0,4,5,98,32,13,53
"2011","Carlisle 009B","E01019194","Total",93,42,18,33,11,4,6,1,82,38,12,32
"2011","Carlisle 009C","E01019230","Total",61,21,18,22,8,0,7,1,53,21,11,21
"2011","Carlisle 009D","E01019231","Total",41,18,11,12,4,0,1,3,37,18,10,9
"2011","Carlisle 009E","E01019232","Total",32,14,8,10,8,3,5,0,24,11,3,10
"2011","Carlisle 009F","E01019252","Total",34,15,4,15,2,0,1,1,32,15,3,14
"2011","Carlisle 010A","E01019209","Total",37,10,16,11,10,0,10,0,27,10,6,11
"2011","Carlisle 010B","E01019211","Total",53,26,15,12,7,0,4,3,46,26,11,9
"2011","Carlisle 010C","E01019216","Total",51,18,17,16,2,1,1,0,49,17,16,16
"2011","Carlisle 010D","E01019217","Total",84,35,28,21,8,4,4,0,76,31,24,21
"2011","Carlisle 010E","E01019220","Total",35,14,11,10,4,0,3,1,31,14,8,9
"2011","Carlisle 010F","E01019236","Total",54,21,11,22,6,0,5,1,48,21,6,21
"2011","Carlisle 011A","E01019197","Total",114,36,16,62,13,1,4,8,101,35,12,54
"2011","Carlisle 011B","E01019198","Total",75,35,16,24,7,2,4,1,68,33,12,23
"2011","Carlisle 011C","E01019199","Total",59,15,8,36,4,0,2,2,55,15,6,34
"2011","Carlisle 011D","E01019221","Total",83,28,20,35,3,0,2,1,80,28,18,34
"2011","Carlisle 011E","E01019222","Total",77,38,14,25,7,0,3,4,70,38,11,21
"2011","Carlisle 011F","E01019245","Total",94,31,10,53,11,4,3,4,83,27,7,49
"2011","Carlisle 012A","E01019208","Total",86,36,8,42,8,1,3,4,78,35,5,38
"2011","Carlisle 012B","E01019210","Total",99,33,15,51,13,2,7,4,86,31,8,47
"2011","Carlisle 012C","E01019246","Total",37,15,8,14,3,1,1,1,34,14,7,13
"2011","Carlisle 012D","E01019247","Total",42,16,10,16,4,1,3,0,38,15,7,16
"2011","Carlisle 012E","E01019248","Total",87,41,15,31,10,0,5,5,77,41,10,26
"2011","Carlisle 013A","E01019212","Total",17,6,7,4,2,0,2,0,15,6,5,4
"2011","Carlisle 013B","E01019213","Total",41,20,17,4,7,0,6,1,34,20,11,3
"2011","Carlisle 013C","E01019214","Total",39,22,12,5,7,1,5,1,32,21,7,4
"2011","Carlisle 013D","E01019223","Total",22,8,4,10,2,1,1,0,20,7,3,10
"2011","Carlisle 013E","E01019253","Total",32,20,4,8,3,2,0,1,29,18,4,7
"2011","Copeland 001A","E01019268","Total",19,7,3,9,4,1,1,2,15,6,2,7
"2011","Copeland 001B","E01019269","Total",75,26,13,36,6,0,5,1,69,26,8,35
"2011","Copeland 001C","E01019270","Total",51,22,8,21,3,0,2,1,48,22,6,20
"2011","Copeland 001D","E01019297","Total",23,11,8,4,1,0,1,0,22,11,7,4
"2011","Copeland 002A","E01019260","Total",40,8,13,19,4,1,2,1,36,7,11,18
"2011","Copeland 002B","E01019280","Total",23,5,7,11,2,0,0,2,21,5,7,9
"2011","Copeland 002C","E01019281","Total",21,10,4,7,4,1,1,2,17,9,3,5
"2011","Copeland 002D","E01019282","Total",18,7,3,8,1,0,0,1,17,7,3,7
"2011","Copeland 003A","E01019261","Total",12,6,4,2,0,0,0,0,12,6,4,2
"2011","Copeland 003B","E01019262","Total",25,12,8,5,2,0,2,0,23,12,6,5
"2011","Copeland 003C","E01019284","Total",46,18,14,14,2,1,1,0,44,17,13,14
"2011","Copeland 003D","E01019285","Total",74,18,16,40,7,0,2,5,67,18,14,35
"2011","Copeland 003E","E01019286","Total",21,6,12,3,1,1,0,0,20,5,12,3
"2011","Copeland 003F","E01019287","Total",18,9,7,2,0,0,0,0,18,9,7,2
"2011","Copeland 003G","E01019288","Total",19,8,9,2,3,0,3,0,16,8,6,2
"2011","Copeland 004A","E01019256","Total",24,11,7,6,3,0,3,0,21,11,4,6
"2011","Copeland 004B","E01019263","Total",42,11,4,27,2,0,1,1,40,11,3,26
"2011","Copeland 004C","E01019264","Total",39,16,10,13,2,0,2,0,37,16,8,13
"2011","Copeland 004D","E01019265","Total",36,9,8,19,4,0,2,2,32,9,6,17
"2011","Copeland 004E","E01019266","Total",37,12,6,19,2,2,0,0,35,10,6,19
"2011","Copeland 004F","E01019267","Total",67,32,11,24,7,2,3,2,60,30,8,22
"2011","Copeland 004G","E01019276","Total",16,6,5,5,6,1,4,1,10,5,1,4
"2011","Copeland 004H","E01019277","Total",51,15,6,30,8,2,1,5,43,13,5,25
"2011","Copeland 004I","E01019278","Total",15,3,4,8,3,0,2,1,12,3,2,7
"2011","Copeland 005A","E01019291","Total",41,20,6,15,7,0,4,3,34,20,2,12
"2011","Copeland 005B","E01019292","Total",23,6,6,11,3,0,2,1,20,6,4,10
"2011","Copeland 005C","E01019294","Total",52,21,9,22,3,0,2,1,49,21,7,21
"2011","Copeland 005D","E01019295","Total",99,33,10,56,7,1,2,4,92,32,8,52
"2011","Copeland 005E","E01019296","Total",39,19,9,11,0,0,0,0,39,19,9,11
"2011","Copeland 005F","E01019301","Total",111,27,11,73,15,4,2,9,96,23,9,64
"2011","Copeland 005G","E01019302","Total",33,14,8,11,4,0,3,1,29,14,5,10
"2011","Copeland 006A","E01019271","Total",59,16,14,29,7,0,4,3,52,16,10,26
"2011","Copeland 006B","E01019272","Total",68,21,15,32,9,1,3,5,59,20,12,27
"2011","Copeland 006C","E01019273","Total",28,9,9,10,3,0,2,1,25,9,7,9
"2011","Copeland 006D","E01019274","Total",52,16,15,21,8,1,6,1,44,15,9,20
"2011","Copeland 006E","E01019275","Total",38,16,14,8,7,0,5,2,31,16,9,6
"2011","Copeland 007A","E01019257","Total",37,19,7,11,1,0,0,1,36,19,7,10
"2011","Copeland 007B","E01019258","Total",18,4,8,6,3,0,2,1,15,4,6,5
"2011","Copeland 007C","E01019279","Total",8,2,5,1,1,0,1,0,7,2,4,1
"2011","Copeland 007D","E01019300","Total",23,6,14,3,4,0,3,1,19,6,11,2
"2011","Copeland 007E","E01019303","Total",22,7,13,2,2,1,1,0,20,6,12,2
"2011","Copeland 007F","E01019304","Total",6,3,1,2,0,0,0,0,6,3,1,2
"2011","Copeland 008A","E01019259","Total",14,6,5,3,1,1,0,0,13,5,5,3
"2011","Copeland 008B","E01019283","Total",16,10,1,5,0,0,0,0,16,10,1,5
"2011","Copeland 008C","E01019289","Total",37,16,8,13,1,0,0,1,36,16,8,12
"2011","Copeland 008D","E01019290","Total",40,13,13,14,8,0,6,2,32,13,7,12
"2011","Copeland 008E","E01019293","Total",7,3,3,1,2,0,2,0,5,3,1,1
"2011","Copeland 008F","E01019298","Total",34,13,12,9,4,0,4,0,30,13,8,9
"2011","Copeland 008G","E01019299","Total",71,29,16,26,4,2,1,1,67,27,15,25
"2011","Eden 001A","E01019305","Total",58,25,16,17,9,0,9,0,49,25,7,17
"2011","Eden 001B","E01019314","Total",18,3,7,8,4,0,3,1,14,3,4,7
"2011","Eden 001C","E01019320","Total",19,6,9,4,5,0,5,0,14,6,4,4
"2011","Eden 001D","E01019321","Total",16,5,10,1,6,0,6,0,10,5,4,1
"2011","Eden 002A","E01019315","Total",23,11,9,3,1,0,1,0,22,11,8,3
"2011","Eden 002B","E01019316","Total",15,6,7,2,2,0,1,1,13,6,6,1
"2011","Eden 002C","E01019322","Total",22,9,10,3,5,0,5,0,17,9,5,3
"2011","Eden 002D","E01019338","Total",16,8,4,4,1,0,1,0,15,8,3,4
"2011","Eden 003A","E01019327","Total",56,30,17,9,5,0,4,1,51,30,13,8
"2011","Eden 003B","E01019332","Total",32,17,5,10,1,0,1,0,31,17,4,10
"2011","Eden 003C","E01019333","Total",43,17,12,14,11,2,4,5,32,15,8,9
"2011","Eden 003D","E01019335","Total",39,21,11,7,6,0,4,2,33,21,7,5
"2011","Eden 003E","E01019336","Total",62,33,12,17,3,1,1,1,59,32,11,16
"2011","Eden 004A","E01019312","Total",12,3,7,2,0,0,0,0,12,3,7,2
"2011","Eden 004B","E01019326","Total",43,14,20,9,3,1,2,0,40,13,18,9
"2011","Eden 004C","E01019328","Total",17,8,4,5,2,1,0,1,15,7,4,4
"2011","Eden 004D","E01019329","Total",15,8,4,3,1,0,1,0,14,8,3,3
"2011","Eden 004E","E01019330","Total",27,15,10,2,3,0,3,0,24,15,7,2
"2011","Eden 004F","E01019331","Total",43,28,8,7,9,1,6,2,34,27,2,5
"2011","Eden 004G","E01019334","Total",22,14,5,3,1,1,0,0,21,13,5,3
"2011","Eden 005A","E01019308","Total",30,12,11,7,4,0,4,0,26,12,7,7
"2011","Eden 005B","E01019311","Total",14,4,8,2,1,0,1,0,13,4,7,2
"2011","Eden 005C","E01019313","Total",21,12,8,1,4,2,2,0,17,10,6,1
"2011","Eden 005D","E01019339","Total",20,10,7,3,2,0,2,0,18,10,5,3
"2011","Eden 006A","E01019306","Total",23,12,4,7,1,0,0,1,22,12,4,6
"2011","Eden 006B","E01019307","Total",41,20,11,10,5,1,2,2,36,19,9,8
"2011","Eden 006C","E01019310","Total",17,9,7,1,1,0,1,0,16,9,6,1
"2011","Eden 006D","E01019319","Total",31,15,11,5,3,1,1,1,28,14,10,4
"2011","Eden 006E","E01019323","Total",23,10,11,2,4,0,4,0,19,10,7,2
"2011","Eden 006F","E01019324","Total",22,12,8,2,4,0,4,0,18,12,4,2
"2011","Eden 006G","E01019337","Total",20,11,3,6,1,0,0,1,19,11,3,5
"2011","Eden 007A","E01019309","Total",30,14,12,4,3,0,3,0,27,14,9,4
"2011","Eden 007B","E01019317","Total",9,6,2,1,1,0,1,0,8,6,1,1
"2011","Eden 007C","E01019318","Total",54,16,18,20,12,1,6,5,42,15,12,15
"2011","Eden 007D","E01019325","Total",27,12,10,5,2,1,1,0,25,11,9,5
"2011","Eden 007E","E01019340","Total",13,8,3,2,0,0,0,0,13,8,3,2
"2011","South Lakeland 001A","E01019374","Total",40,25,7,8,2,0,2,0,38,25,5,8
"2011","South Lakeland 001B","E01019375","Total",18,10,7,1,1,0,1,0,17,10,6,1
"2011","South Lakeland 001C","E01019376","Total",11,2,7,2,3,0,2,1,8,2,5,1
"2011","South Lakeland 001D","E01019395","Total",29,18,5,6,3,1,2,0,26,17,3,6
"2011","South Lakeland 002A","E01019387","Total",33,11,12,10,1,0,1,0,32,11,11,10
"2011","South Lakeland 002B","E01019396","Total",45,23,16,6,6,0,5,1,39,23,11,5
"2011","South Lakeland 002C","E01019397","Total",49,24,17,8,4,1,3,0,45,23,14,8
"2011","South Lakeland 002D","E01019398","Total",38,21,9,8,7,2,3,2,31,19,6,6
"2011","South Lakeland 002E","E01019399","Total",22,10,9,3,5,0,5,0,17,10,4,3
"2011","South Lakeland 003A","E01019346","Total",37,19,8,10,4,0,4,0,33,19,4,10
"2011","South Lakeland 003B","E01019359","Total",71,36,18,17,6,1,5,0,65,35,13,17
"2011","South Lakeland 003C","E01019365","Total",40,20,15,5,0,0,0,0,40,20,15,5
"2011","South Lakeland 003D","E01019370","Total",48,18,19,11,6,0,5,1,42,18,14,10
"2011","South Lakeland 004A","E01019360","Total",40,18,11,11,2,1,0,1,38,17,11,10
"2011","South Lakeland 004B","E01019363","Total",47,16,15,16,5,1,3,1,42,15,12,15
"2011","South Lakeland 004C","E01019364","Total",72,35,16,21,11,4,5,2,61,31,11,19
"2011","South Lakeland 004D","E01019371","Total",90,43,17,30,7,2,3,2,83,41,14,28
"2011","South Lakeland 005A","E01019358","Total",36,25,9,2,3,1,2,0,33,24,7,2
"2011","South Lakeland 005B","E01019362","Total",28,15,9,4,4,0,4,0,24,15,5,4
"2011","South Lakeland 005C","E01019366","Total",27,16,5,6,0,0,0,0,27,16,5,6
"2011","South Lakeland 005D","E01019394","Total",13,8,4,1,2,1,1,0,11,7,3,1
"2011","South Lakeland 006A","E01019361","Total",34,22,7,5,1,0,1,0,33,22,6,5
"2011","South Lakeland 006B","E01019367","Total",55,28,12,15,7,3,4,0,48,25,8,15
"2011","South Lakeland 006C","E01019368","Total",43,24,17,2,6,0,6,0,37,24,11,2
"2011","South Lakeland 006D","E01019369","Total",27,9,13,5,8,1,3,4,19,8,10,1
"2011","South Lakeland 007A","E01019356","Total",15,9,3,3,0,0,0,0,15,9,3,3
"2011","South Lakeland 007B","E01019381","Total",27,15,5,7,1,0,1,0,26,15,4,7
"2011","South Lakeland 007C","E01019386","Total",27,11,11,5,7,3,2,2,20,8,9,3
"2011","South Lakeland 008A","E01019344","Total",21,9,9,3,2,1,1,0,19,8,8,3
"2011","South Lakeland 008B","E01019345","Total",10,5,5,0,4,1,3,0,6,4,2,0
"2011","South Lakeland 008C","E01019350","Total",23,12,9,2,2,0,2,0,21,12,7,2
"2011","South Lakeland 008D","E01019351","Total",19,9,5,5,6,1,5,0,13,8,0,5
"2011","South Lakeland 009A","E01019372","Total",19,6,8,5,3,0,3,0,16,6,5,5
"2011","South Lakeland 009B","E01019373","Total",19,11,5,3,3,2,1,0,16,9,4,3
"2011","South Lakeland 009C","E01019384","Total",25,9,14,2,7,1,6,0,18,8,8,2
"2011","South Lakeland 009D","E01019385","Total",23,8,10,5,2,0,2,0,21,8,8,5
"2011","South Lakeland 010A","E01019348","Total",9,3,4,2,1,0,1,0,8,3,3,2
"2011","South Lakeland 010B","E01019352","Total",29,12,11,6,3,1,2,0,26,11,9,6
"2011","South Lakeland 010C","E01019377","Total",18,7,6,5,0,0,0,0,18,7,6,5
"2011","South Lakeland 010D","E01019383","Total",16,10,4,2,0,0,0,0,16,10,4,2
"2011","South Lakeland 011A","E01019341","Total",10,5,5,0,1,0,1,0,9,5,4,0
"2011","South Lakeland 011B","E01019342","Total",14,9,4,1,2,0,2,0,12,9,2,1
"2011","South Lakeland 011C","E01019343","Total",10,4,6,0,0,0,0,0,10,4,6,0
"2011","South Lakeland 011D","E01019347","Total",37,12,15,10,5,0,3,2,32,12,12,8
"2011","South Lakeland 011E","E01019382","Total",56,24,17,15,5,0,4,1,51,24,13,14
"2011","South Lakeland 012A","E01019388","Total",50,19,14,17,3,1,2,0,47,18,12,17
"2011","South Lakeland 012B","E01019389","Total",104,37,20,47,9,2,3,4,95,35,17,43
"2011","South Lakeland 012C","E01019390","Total",33,11,12,10,3,0,2,1,30,11,10,9
"2011","South Lakeland 012D","E01019392","Total",58,25,17,16,7,0,2,5,51,25,15,11
"2011","South Lakeland 013A","E01019349","Total",29,10,11,8,3,0,2,1,26,10,9,7
"2011","South Lakeland 013B","E01019353","Total",32,18,6,8,1,0,1,0,31,18,5,8
"2011","South Lakeland 013C","E01019354","Total",10,3,5,2,1,0,1,0,9,3,4,2
"2011","South Lakeland 013D","E01019355","Total",6,3,1,2,0,0,0,0,6,3,1,2
"2011","South Lakeland 013E","E01019357","Total",36,27,5,4,1,0,1,0,35,27,4,4
"2011","South Lakeland 014A","E01019378","Total",25,10,12,3,3,0,3,0,22,10,9,3
"2011","South Lakeland 014B","E01019379","Total",15,8,5,2,2,0,2,0,13,8,3,2
"2011","South Lakeland 014C","E01019380","Total",15,1,7,7,4,0,3,1,11,1,4,6
"2011","South Lakeland 014D","E01019391","Total",34,18,7,9,2,0,2,0,32,18,5,9
"2011","South Lakeland 014E","E01019393","Total",13,9,1,3,0,0,0,0,13,9,1,3
"2011","Bolton 001A","E01004768","Total",29,10,15,4,5,0,4,1,24,10,11,3
"2011","Bolton 001B","E01004803","Total",30,9,16,5,5,1,4,0,25,8,12,5
"2011","Bolton 001C","E01004804","Total",16,6,8,2,2,0,2,0,14,6,6,2
"2011","Bolton 001D","E01004807","Total",40,16,19,5,2,0,2,0,38,16,17,5
"2011","Bolton 001E","E01004808","Total",36,14,16,6,2,1,1,0,34,13,15,6
"2011","Bolton 002A","E01004788","Total",13,2,8,3,1,0,0,1,12,2,8,2
"2011","Bolton 002B","E01004790","Total",49,16,23,10,3,2,0,1,46,14,23,9
"2011","Bolton 002C","E01004805","Total",38,17,13,8,2,0,2,0,36,17,11,8
"2011","Bolton 002D","E01004806","Total",29,10,15,4,4,0,4,0,25,10,11,4
"2011","Bolton 002E","E01004810","Total",41,16,17,8,4,1,2,1,37,15,15,7
"2011","Bolton 003A","E01004769","Total",28,11,17,0,2,0,2,0,26,11,15,0
"2011","Bolton 003B","E01004770","Total",22,11,9,2,4,1,3,0,18,10,6,2
"2011","Bolton 003C","E01004771","Total",23,5,16,2,1,0,1,0,22,5,15,2
"2011","Bolton 003D","E01004773","Total",58,19,29,10,11,3,7,1,47,16,22,9
"2011","Bolton 003E","E01004809","Total",71,17,37,17,3,0,2,1,68,17,35,16
"2011","Bolton 004A","E01004777","Total",72,29,22,21,5,2,3,0,67,27,19,21
"2011","Bolton 004B","E01004881","Total",52,22,15,15,4,1,3,0,48,21,12,15
"2011","Bolton 004C","E01004888","Total",46,20,14,12,6,2,3,1,40,18,11,11
"2011","Bolton 004D","E01004889","Total",57,21,14,22,6,0,3,3,51,21,11,19
"2011","Bolton 004E","E01004890","Total",44,19,14,11,2,2,0,0,42,17,14,11
"2011","Bolton 005A","E01004766","Total",58,22,18,18,8,3,4,1,50,19,14,17
"2011","Bolton 005B","E01004767","Total",35,15,10,10,4,2,2,0,31,13,8,10
"2011","Bolton 005C","E01004772","Total",93,25,24,44,2,0,1,1,91,25,23,43
"2011","Bolton 005D","E01004774","Total",82,24,29,29,11,1,8,2,71,23,21,27
"2011","Bolton 005E","E01004824","Total",24,7,4,13,7,2,2,3,17,5,2,10
"2011","Bolton 006A","E01004784","Total",14,6,7,1,1,0,1,0,13,6,6,1
"2011","Bolton 006B","E01004785","Total",45,16,17,12,4,1,2,1,41,15,15,11
"2011","Bolton 006C","E01004786","Total",39,16,16,7,5,2,2,1,34,14,14,6
"2011","Bolton 006D","E01004789","Total",17,3,10,4,3,0,3,0,14,3,7,4
"2011","Bolton 006E","E01004791","Total",19,9,8,2,0,0,0,0,19,9,8,2
"2011","Bolton 006F","E01004792","Total",13,2,10,1,4,0,3,1,9,2,7,0
"2011","Bolton 007A","E01004779","Total",45,18,13,14,3,0,2,1,42,18,11,13
"2011","Bolton 007B","E01004781","Total",52,15,19,18,6,0,4,2,46,15,15,16
"2011","Bolton 007C","E01004882","Total",41,14,18,9,3,0,3,0,38,14,15,9
"2011","Bolton 007D","E01004883","Total",34,14,12,8,6,4,2,0,28,10,10,8
"2011","Bolton 007E","E01004884","Total",9,2,6,1,1,0,1,0,8,2,5,1
"2011","Bolton 008A","E01004864","Total",53,20,24,9,4,1,3,0,49,19,21,9
"2011","Bolton 008B","E01004867","Total",57,17,13,27,4,1,2,1,53,16,11,26
"2011","Bolton 008C","E01004921","Total",42,10,15,17,6,0,2,4,36,10,13,13
"2011","Bolton 008D","E01004924","Total",26,9,13,4,7,2,4,1,19,7,9,3
"2011","Bolton 008E","E01004925","Total",28,12,12,4,4,2,2,0,24,10,10,4
"2011","Bolton 009A","E01004778","Total",25,11,13,1,7,1,6,0,18,10,7,1
"2011","Bolton 009B","E01004780","Total",56,18,28,10,4,0,4,0,52,18,24,10
"2011","Bolton 009C","E01004782","Total",31,14,11,6,6,2,4,0,25,12,7,6
"2011","Bolton 009D","E01004783","Total",30,12,14,4,6,2,3,1,24,10,11,3
"2011","Bolton 010A","E01004802","Total",116,39,20,57,9,2,4,3,107,37,16,54
"2011","Bolton 010B","E01004926","Total",91,35,9,47,7,1,2,4,84,34,7,43
"2011","Bolton 010C","E01004927","Total",122,40,19,63,10,1,3,6,112,39,16,57
"2011","Bolton 010D","E01004929","Total",84,25,28,31,9,2,5,2,75,23,23,29
"2011","Bolton 011A","E01004820","Total",69,14,15,40,3,1,2,0,66,13,13,40
"2011","Bolton 011B","E01004825","Total",45,8,7,30,4,0,2,2,41,8,5,28
"2011","Bolton 011C","E01004826","Total",86,23,21,42,12,0,4,8,74,23,17,34
"2011","Bolton 011D","E01004865","Total",43,16,16,11,3,0,3,0,40,16,13,11
"2011","Bolton 011E","E01004866","Total",86,24,19,43,4,0,3,1,82,24,16,42
"2011","Bolton 012A","E01004840","Total",59,21,23,15,13,2,9,2,46,19,14,13
"2011","Bolton 012B","E01004841","Total",90,28,16,46,12,1,3,8,78,27,13,38
"2011","Bolton 012C","E01004842","Total",25,8,12,5,2,0,2,0,23,8,10,5
"2011","Bolton 012D","E01004919","Total",40,12,18,10,8,1,6,1,32,11,12,9
"2011","Bolton 012E","E01004920","Total",57,19,10,28,3,0,0,3,54,19,10,25
"2011","Bolton 013A","E01004787","Total",111,37,20,54,22,6,10,6,89,31,10,48
"2011","Bolton 013B","E01004793","Total",72,16,13,43,11,0,6,5,61,16,7,38
"2011","Bolton 013C","E01004794","Total",114,32,16,66,5,0,1,4,109,32,15,62
"2011","Bolton 013D","E01004795","Total",51,18,7,26,9,0,2,7,42,18,5,19
"2011","Bolton 013E","E01004797","Total",93,34,19,40,10,0,3,7,83,34,16,33
"2011","Bolton 014A","E01004775","Total",26,8,14,4,5,0,3,2,21,8,11,2
"2011","Bolton 014B","E01004885","Total",18,5,10,3,3,0,3,0,15,5,7,3
"2011","Bolton 014C","E01004886","Total",60,19,17,24,4,2,2,0,56,17,15,24
"2011","Bolton 014D","E01004887","Total",44,16,10,18,4,0,2,2,40,16,8,16
"2011","Bolton 015A","E01004868","Total",71,21,16,34,5,0,2,3,66,21,14,31
"2011","Bolton 015B","E01004869","Total",86,24,10,52,4,0,1,3,82,24,9,49
"2011","Bolton 015C","E01004870","Total",42,15,12,15,7,0,3,4,35,15,9,11
"2011","Bolton 015D","E01004871","Total",49,7,7,35,5,1,1,3,44,6,6,32
"2011","Bolton 015E","E01004922","Total",103,48,24,31,8,3,4,1,95,45,20,30
"2011","Bolton 016B","E01004822","Total",51,13,8,30,6,1,3,2,45,12,5,28
"2011","Bolton 016C","E01004823","Total",92,26,19,47,6,0,2,4,86,26,17,43
"2011","Bolton 016D","E01004848","Total",57,12,7,38,8,0,3,5,49,12,4,33
"2011","Bolton 016E","E01033217","Total",42,16,12,14,16,3,8,5,26,13,4,9
"2011","Bolton 016F","E01033220","Total",51,17,7,27,4,2,1,1,47,15,6,26
"2011","Bolton 017A","E01004818","Total",52,14,20,18,8,1,1,6,44,13,19,12
"2011","Bolton 017B","E01004819","Total",42,20,11,11,4,2,1,1,38,18,10,10
"2011","Bolton 017C","E01004928","Total",89,30,22,37,4,0,3,1,85,30,19,36
"2011","Bolton 017D","E01004930","Total",47,16,14,17,5,1,4,0,42,15,10,17
"2011","Bolton 017E","E01004931","Total",68,25,12,31,5,0,2,3,63,25,10,28
"2011","Bolton 017F","E01004932","Total",61,31,12,18,4,1,2,1,57,30,10,17
"2011","Bolton 018A","E01004834","Total",45,15,11,19,3,1,1,1,42,14,10,18
"2011","Bolton 018B","E01004838","Total",70,19,12,39,5,1,0,4,65,18,12,35
"2011","Bolton 018C","E01004843","Total",28,8,17,3,4,1,3,0,24,7,14,3
"2011","Bolton 018D","E01004845","Total",41,12,24,5,7,0,7,0,34,12,17,5
"2011","Bolton 018E","E01004923","Total",53,21,19,13,1,0,1,0,52,21,18,13
"2011","Bolton 019A","E01004796","Total",39,16,9,14,6,0,1,5,33,16,8,9
"2011","Bolton 019B","E01004798","Total",86,25,22,39,8,3,1,4,78,22,21,35
"2011","Bolton 019C","E01004799","Total",24,6,11,7,5,0,5,0,19,6,6,7
"2011","Bolton 019D","E01004800","Total",34,11,19,4,4,0,3,1,30,11,16,3
"2011","Bolton 019E","E01004801","Total",140,42,28,70,6,4,1,1,134,38,27,69
"2011","Bolton 019F","E01004917","Total",87,21,22,44,8,0,3,5,79,21,19,39
"2011","Bolton 020A","E01004835","Total",19,12,5,2,2,1,0,1,17,11,5,1
"2011","Bolton 020B","E01004836","Total",11,3,4,4,2,1,1,0,9,2,3,4
"2011","Bolton 020C","E01004837","Total",20,5,13,2,2,0,2,0,18,5,11,2
"2011","Bolton 020D","E01004844","Total",11,3,4,4,1,0,0,1,10,3,4,3
"2011","Bolton 020E","E01004897","Total",24,9,6,9,4,2,1,1,20,7,5,8
"2011","Bolton 021A","E01004827","Total",81,20,20,41,9,2,3,4,72,18,17,37
"2011","Bolton 021B","E01004849","Total",36,7,5,24,3,0,1,2,33,7,4,22
"2011","Bolton 021C","E01004850","Total",73,17,17,39,14,2,9,3,59,15,8,36
"2011","Bolton 021D","E01004851","Total",33,11,5,17,3,1,0,2,30,10,5,15
"2011","Bolton 021E","E01004853","Total",58,22,4,32,5,2,0,3,53,20,4,29
"2011","Bolton 022A","E01004811","Total",68,16,12,40,10,0,3,7,58,16,9,33
"2011","Bolton 022B","E01004812","Total",51,13,8,30,5,0,2,3,46,13,6,27
"2011","Bolton 022C","E01004813","Total",56,19,10,27,7,3,2,2,49,16,8,25
"2011","Bolton 022D","E01004815","Total",52,11,13,28,14,1,7,6,38,10,6,22
"2011","Bolton 022E","E01004817","Total",41,16,10,15,10,1,4,5,31,15,6,10
"2011","Bolton 023A","E01004828","Total",81,35,11,35,8,2,2,4,73,33,9,31
"2011","Bolton 023B","E01004829","Total",38,12,9,17,2,1,1,0,36,11,8,17
"2011","Bolton 023C","E01004832","Total",68,27,18,23,8,2,3,3,60,25,15,20
"2011","Bolton 023D","E01004854","Total",35,8,8,19,7,1,3,3,28,7,5,16
"2011","Bolton 023E","E01004878","Total",33,10,9,14,2,0,1,1,31,10,8,13
"2011","Bolton 024A","E01004911","Total",58,21,15,22,3,0,1,2,55,21,14,20
"2011","Bolton 024B","E01004912","Total",38,14,19,5,7,2,4,1,31,12,15,4
"2011","Bolton 024C","E01004913","Total",75,25,27,23,7,2,3,2,68,23,24,21
"2011","Bolton 024D","E01004914","Total",26,7,13,6,5,1,4,0,21,6,9,6
"2011","Bolton 024E","E01004915","Total",28,13,6,9,3,1,2,0,25,12,4,9
"2011","Bolton 024F","E01004916","Total",75,32,25,18,4,2,2,0,71,30,23,18
"2011","Bolton 024G","E01004918","Total",24,13,9,2,0,0,0,0,24,13,9,2
"2011","Bolton 025A","E01004846","Total",48,10,9,29,9,0,1,8,39,10,8,21
"2011","Bolton 025B","E01004847","Total",84,16,9,59,8,1,2,5,76,15,7,54
"2011","Bolton 025C","E01004852","Total",30,5,8,17,2,1,0,1,28,4,8,16
"2011","Bolton 025D","E01004877","Total",86,24,14,48,8,2,1,5,78,22,13,43
"2011","Bolton 025E","E01004879","Total",68,21,14,33,6,2,1,3,62,19,13,30
"2011","Bolton 026A","E01004830","Total",68,23,17,28,6,0,4,2,62,23,13,26
"2011","Bolton 026B","E01004831","Total",42,16,16,10,4,1,2,1,38,15,14,9
"2011","Bolton 026C","E01004833","Total",41,16,19,6,6,3,1,2,35,13,18,4
"2011","Bolton 026D","E01004839","Total",102,29,27,46,12,1,6,5,90,28,21,41
"2011","Bolton 027A","E01004814","Total",63,15,19,29,2,0,2,0,61,15,17,29
"2011","Bolton 027B","E01004855","Total",78,26,22,30,4,2,2,0,74,24,20,30
"2011","Bolton 027C","E01004856","Total",66,20,8,38,10,1,2,7,56,19,6,31
"2011","Bolton 027D","E01004857","Total",79,22,11,46,7,0,2,5,72,22,9,41
"2011","Bolton 028A","E01004891","Total",26,15,9,2,2,0,2,0,24,15,7,2
"2011","Bolton 028B","E01004893","Total",16,10,4,2,2,1,0,1,14,9,4,1
"2011","Bolton 028C","E01004894","Total",68,23,25,20,6,0,5,1,62,23,20,19
"2011","Bolton 028E","E01004901","Total",36,12,20,4,8,1,7,0,28,11,13,4
"2011","Bolton 028F","E01033218","Total",44,12,24,8,6,0,6,0,38,12,18,8
"2011","Bolton 028G","E01033219","Total",34,13,17,4,7,2,5,0,27,11,12,4
"2011","Bolton 029A","E01004816","Total",34,12,4,18,3,0,1,2,31,12,3,16
"2011","Bolton 029B","E01004872","Total",76,24,16,36,3,1,1,1,73,23,15,35
"2011","Bolton 029C","E01004873","Total",85,22,15,48,5,0,2,3,80,22,13,45
"2011","Bolton 029D","E01004875","Total",46,7,18,21,7,0,4,3,39,7,14,18
"2011","Bolton 029E","E01004880","Total",31,10,12,9,5,0,4,1,26,10,8,8
"2011","Bolton 030A","E01004892","Total",28,9,17,2,9,2,6,1,19,7,11,1
"2011","Bolton 030B","E01004896","Total",14,6,6,2,1,0,1,0,13,6,5,2
"2011","Bolton 030C","E01004899","Total",36,13,10,13,3,0,2,1,33,13,8,12
"2011","Bolton 030D","E01004900","Total",46,18,17,11,3,2,1,0,43,16,16,11
"2011","Bolton 031A","E01004776","Total",63,26,16,21,1,0,1,0,62,26,15,21
"2011","Bolton 031B","E01004895","Total",44,11,17,16,3,0,2,1,41,11,15,15
"2011","Bolton 031C","E01004936","Total",58,18,32,8,4,0,4,0,54,18,28,8
"2011","Bolton 031D","E01004938","Total",77,29,13,35,7,0,4,3,70,29,9,32
"2011","Bolton 031E","E01004939","Total",54,16,14,24,5,0,2,3,49,16,12,21
"2011","Bolton 032A","E01004858","Total",52,18,18,16,5,1,3,1,47,17,15,15
"2011","Bolton 032B","E01004859","Total",67,15,16,36,10,0,4,6,57,15,12,30
"2011","Bolton 032C","E01004860","Total",67,16,19,32,7,0,4,3,60,16,15,29
"2011","Bolton 032D","E01004902","Total",53,18,16,19,7,0,7,0,46,18,9,19
"2011","Bolton 032E","E01004906","Total",70,27,18,25,7,2,3,2,63,25,15,23
"2011","Bolton 033A","E01004861","Total",108,36,18,54,6,0,2,4,102,36,16,50
"2011","Bolton 033B","E01004862","Total",83,19,15,49,5,0,1,4,78,19,14,45
"2011","Bolton 033C","E01004863","Total",80,24,19,37,4,1,2,1,76,23,17,36
"2011","Bolton 033D","E01004874","Total",103,31,27,45,8,3,3,2,95,28,24,43
"2011","Bolton 033E","E01004876","Total",96,26,20,50,5,1,0,4,91,25,20,46
"2011","Bolton 034A","E01004903","Total",44,17,19,8,1,0,1,0,43,17,18,8
"2011","Bolton 034B","E01004904","Total",67,21,31,15,4,0,4,0,63,21,27,15
"2011","Bolton 034C","E01004905","Total",72,27,19,26,9,2,4,3,63,25,15,23
"2011","Bolton 034D","E01004907","Total",84,28,28,28,6,0,5,1,78,28,23,27
"2011","Bolton 034E","E01004908","Total",35,15,8,12,5,1,1,3,30,14,7,9
"2011","Bolton 034F","E01004909","Total",65,16,19,30,6,1,4,1,59,15,15,29
"2011","Bolton 034G","E01004910","Total",83,27,40,16,6,0,6,0,77,27,34,16
"2011","Bolton 035A","E01004933","Total",42,19,18,5,7,1,5,1,35,18,13,4
"2011","Bolton 035B","E01004934","Total",65,23,17,25,5,1,1,3,60,22,16,22
"2011","Bolton 035C","E01004935","Total",55,22,22,11,3,1,2,0,52,21,20,11
"2011","Bolton 035D","E01004937","Total",28,9,11,8,3,0,2,1,25,9,9,7
"2011","Bolton 035E","E01004940","Total",35,9,15,11,1,0,1,0,34,9,14,11
"2011","Bury 001A","E01005014","Total",58,21,17,20,4,1,1,2,54,20,16,18
"2011","Bury 001B","E01005015","Total",59,20,19,20,2,0,1,1,57,20,18,19
"2011","Bury 001C","E01005016","Total",36,13,13,10,4,0,4,0,32,13,9,10
"2011","Bury 001D","E01005017","Total",45,18,24,3,3,0,3,0,42,18,21,3
"2011","Bury 001E","E01005018","Total",64,23,24,17,4,1,1,2,60,22,23,15
"2011","Bury 001F","E01005021","Total",11,2,9,0,3,0,3,0,8,2,6,0
"2011","Bury 002A","E01005019","Total",48,14,23,11,3,0,3,0,45,14,20,11
"2011","Bury 002B","E01005023","Total",31,11,13,7,3,0,3,0,28,11,10,7
"2011","Bury 002C","E01005046","Total",15,6,9,0,3,0,3,0,12,6,6,0
"2011","Bury 002D","E01005048","Total",15,1,11,3,4,0,4,0,11,1,7,3
"2011","Bury 003A","E01005020","Total",33,8,24,1,3,1,2,0,30,7,22,1
"2011","Bury 003B","E01005022","Total",47,16,20,11,8,2,6,0,39,14,14,11
"2011","Bury 003C","E01005047","Total",22,9,13,0,3,1,2,0,19,8,11,0
"2011","Bury 003D","E01005049","Total",41,16,15,10,4,0,3,1,37,16,12,9
"2011","Bury 003E","E01005051","Total",47,17,24,6,4,0,4,0,43,17,20,6
"2011","Bury 004A","E01004976","Total",66,21,17,28,3,1,2,0,63,20,15,28
"2011","Bury 004B","E01004977","Total",38,14,15,9,4,0,4,0,34,14,11,9
"2011","Bury 004C","E01004978","Total",44,14,12,18,3,0,2,1,41,14,10,17
"2011","Bury 004D","E01004981","Total",31,11,6,14,4,0,1,3,27,11,5,11
"2011","Bury 004E","E01004982","Total",25,11,9,5,3,1,1,1,22,10,8,4
"2011","Bury 005A","E01004961","Total",80,37,17,26,6,4,1,1,74,33,16,25
"2011","Bury 005B","E01004965","Total",18,5,6,7,0,0,0,0,18,5,6,7
"2011","Bury 005C","E01004966","Total",121,42,35,44,14,1,8,5,107,41,27,39
"2011","Bury 005D","E01004967","Total",21,5,13,3,1,0,1,0,20,5,12,3
"2011","Bury 006A","E01004963","Total",46,18,19,9,5,0,3,2,41,18,16,7
"2011","Bury 006B","E01004968","Total",31,11,15,5,2,1,1,0,29,10,14,5
"2011","Bury 006C","E01005050","Total",73,29,32,12,9,0,8,1,64,29,24,11
"2011","Bury 006D","E01005052","Total",27,11,12,4,2,0,2,0,25,11,10,4
"2011","Bury 006E","E01005053","Total",70,29,29,12,7,1,5,1,63,28,24,11
"2011","Bury 007A","E01004954","Total",36,14,10,12,2,0,0,2,34,14,10,10
"2011","Bury 007B","E01004955","Total",60,26,13,21,4,0,2,2,56,26,11,19
"2011","Bury 007C","E01004956","Total",61,18,13,30,5,0,2,3,56,18,11,27
"2011","Bury 007D","E01004957","Total",117,31,25,61,8,1,2,5,109,30,23,56
"2011","Bury 007E","E01004960","Total",126,32,23,71,18,2,7,9,108,30,16,62
"2011","Bury 008A","E01004958","Total",66,20,18,28,9,2,4,3,57,18,14,25
"2011","Bury 008B","E01004959","Total",82,26,24,32,6,2,3,1,76,24,21,31
"2011","Bury 008C","E01004979","Total",71,31,11,29,7,0,2,5,64,31,9,24
"2011","Bury 008D","E01004980","Total",58,21,17,20,2,0,1,1,56,21,16,19
"2011","Bury 008E","E01005024","Total",60,13,16,31,11,3,3,5,49,10,13,26
"2011","Bury 008F","E01005026","Total",44,13,11,20,2,0,0,2,42,13,11,18
"2011","Bury 009A","E01004947","Total",75,19,22,34,7,1,4,2,68,18,18,32
"2011","Bury 009B","E01004948","Total",87,29,22,36,9,0,6,3,78,29,16,33
"2011","Bury 009C","E01004962","Total",61,24,23,14,4,2,2,0,57,22,21,14
"2011","Bury 009D","E01004964","Total",85,36,34,15,7,0,7,0,78,36,27,15
"2011","Bury 010A","E01004949","Total",24,7,12,5,6,3,3,0,18,4,9,5
"2011","Bury 010B","E01004950","Total",23,5,16,2,2,0,2,0,21,5,14,2
"2011","Bury 010C","E01004951","Total",21,6,11,4,1,0,0,1,20,6,11,3
"2011","Bury 010D","E01004952","Total",11,4,5,2,2,1,1,0,9,3,4,2
"2011","Bury 010E","E01004953","Total",33,12,19,2,4,0,4,0,29,12,15,2
"2011","Bury 011A","E01005025","Total",42,10,24,8,5,1,4,0,37,9,20,8
"2011","Bury 011B","E01005027","Total",47,13,14,20,10,4,5,1,37,9,9,19
"2011","Bury 011C","E01005028","Total",93,33,21,39,7,2,2,3,86,31,19,36
"2011","Bury 011D","E01005029","Total",54,20,13,21,4,0,3,1,50,20,10,20
"2011","Bury 012A","E01005000","Total",49,18,25,6,4,1,3,0,45,17,22,6
"2011","Bury 012B","E01005001","Total",33,12,10,11,0,0,0,0,33,12,10,11
"2011","Bury 012C","E01005005","Total",27,9,14,4,7,0,7,0,20,9,7,4
"2011","Bury 012D","E01005006","Total",48,20,15,13,5,0,4,1,43,20,11,12
"2011","Bury 013A","E01005030","Total",67,28,10,29,8,2,4,2,59,26,6,27
"2011","Bury 013B","E01005054","Total",36,17,10,9,3,0,3,0,33,17,7,9
"2011","Bury 013C","E01005059","Total",52,19,18,15,2,0,1,1,50,19,17,14
"2011","Bury 013D","E01005060","Total",48,18,18,12,5,0,3,2,43,18,15,10
"2011","Bury 014A","E01004997","Total",56,22,18,16,5,0,5,0,51,22,13,16
"2011","Bury 014B","E01004998","Total",37,14,15,8,3,0,3,0,34,14,12,8
"2011","Bury 014C","E01004999","Total",54,20,16,18,7,1,4,2,47,19,12,16
"2011","Bury 014D","E01005002","Total",48,11,25,12,3,0,1,2,45,11,24,10
"2011","Bury 014E","E01005003","Total",61,19,21,21,3,0,3,0,58,19,18,21
"2011","Bury 015A","E01004991","Total",75,28,23,24,3,1,2,0,72,27,21,24
"2011","Bury 015B","E01004992","Total",59,20,19,20,2,0,1,1,57,20,18,19
"2011","Bury 015C","E01004993","Total",51,11,17,23,3,0,2,1,48,11,15,22
"2011","Bury 015D","E01004994","Total",70,15,19,36,7,2,2,3,63,13,17,33
"2011","Bury 016A","E01004990","Total",54,14,23,17,3,0,3,0,51,14,20,17
"2011","Bury 016B","E01004996","Total",81,22,17,42,5,2,1,2,76,20,16,40
"2011","Bury 016C","E01005004","Total",57,14,16,27,5,1,1,3,52,13,15,24
"2011","Bury 016D","E01005008","Total",111,34,22,55,8,0,4,4,103,34,18,51
"2011","Bury 016E","E01005009","Total",78,18,21,39,5,1,4,0,73,17,17,39
"2011","Bury 017A","E01004945","Total",29,11,14,4,4,2,1,1,25,9,13,3
"2011","Bury 017B","E01005055","Total",22,8,11,3,1,0,1,0,21,8,10,3
"2011","Bury 017C","E01005056","Total",24,4,14,6,5,1,2,2,19,3,12,4
"2011","Bury 017D","E01005057","Total",60,23,17,20,5,2,3,0,55,21,14,20
"2011","Bury 017E","E01005058","Total",12,5,4,3,1,0,1,0,11,5,3,3
"2011","Bury 018A","E01004995","Total",34,14,12,8,5,2,2,1,29,12,10,7
"2011","Bury 018B","E01005010","Total",59,22,21,16,7,2,2,3,52,20,19,13
"2011","Bury 018C","E01005012","Total",93,33,15,45,13,1,5,7,80,32,10,38
"2011","Bury 018D","E01005013","Total",134,40,35,59,14,1,8,5,120,39,27,54
"2011","Bury 019A","E01004984","Total",10,2,5,3,3,1,1,1,7,1,4,2
"2011","Bury 019B","E01004985","Total",15,9,4,2,4,1,2,1,11,8,2,1
"2011","Bury 019C","E01004989","Total",25,7,14,4,6,1,5,0,19,6,9,4
"2011","Bury 019D","E01005007","Total",30,11,14,5,3,0,2,1,27,11,12,4
"2011","Bury 019E","E01005011","Total",39,17,19,3,5,1,4,0,34,16,15,3
"2011","Bury 020A","E01004983","Total",48,17,18,13,6,1,4,1,42,16,14,12
"2011","Bury 020B","E01004986","Total",76,26,20,30,7,0,5,2,69,26,15,28
"2011","Bury 020C","E01004987","Total",39,15,7,17,1,0,0,1,38,15,7,16
"2011","Bury 020D","E01004988","Total",49,23,15,11,2,0,1,1,47,23,14,10
"2011","Bury 021A","E01004941","Total",82,32,21,29,5,2,2,1,77,30,19,28
"2011","Bury 021B","E01004942","Total",101,37,19,45,6,3,3,0,95,34,16,45
"2011","Bury 021C","E01004943","Total",73,27,18,28,4,0,3,1,69,27,15,27
"2011","Bury 021D","E01004944","Total",47,17,20,10,2,0,2,0,45,17,18,10
"2011","Bury 021E","E01004946","Total",108,41,26,41,8,2,3,3,100,39,23,38
"2011","Bury 022A","E01004969","Total",26,10,10,6,1,1,0,0,25,9,10,6
"2011","Bury 022B","E01004970","Total",36,12,18,6,5,0,3,2,31,12,15,4
"2011","Bury 022C","E01004971","Total",28,8,13,7,2,1,0,1,26,7,13,6
"2011","Bury 022D","E01005034","Total",33,13,14,6,2,1,1,0,31,12,13,6
"2011","Bury 023A","E01004972","Total",81,30,18,33,4,0,3,1,77,30,15,32
"2011","Bury 023B","E01004973","Total",50,22,10,18,2,0,2,0,48,22,8,18
"2011","Bury 023C","E01004975","Total",64,22,18,24,2,0,2,0,62,22,16,24
"2011","Bury 023D","E01005039","Total",78,17,19,42,7,1,2,4,71,16,17,38
"2011","Bury 023E","E01005045","Total",72,24,26,22,7,1,4,2,65,23,22,20
"2011","Bury 024A","E01004974","Total",33,14,13,6,1,1,0,0,32,13,13,6
"2011","Bury 024B","E01005033","Total",31,8,18,5,4,1,3,0,27,7,15,5
"2011","Bury 024C","E01005036","Total",43,14,15,14,6,0,5,1,37,14,10,13
"2011","Bury 024D","E01005037","Total",35,12,6,17,3,0,2,1,32,12,4,16
"2011","Bury 025A","E01005031","Total",64,29,16,19,2,0,1,1,62,29,15,18
"2011","Bury 025B","E01005032","Total",63,24,17,22,2,1,0,1,61,23,17,21
"2011","Bury 025C","E01005035","Total",46,21,15,10,2,0,2,0,44,21,13,10
"2011","Bury 025D","E01005038","Total",30,10,13,7,4,0,3,1,26,10,10,6
"2011","Bury 026A","E01005040","Total",33,8,15,10,3,1,2,0,30,7,13,10
"2011","Bury 026B","E01005041","Total",28,14,10,4,1,0,1,0,27,14,9,4
"2011","Bury 026C","E01005042","Total",32,13,11,8,3,1,1,1,29,12,10,7
"2011","Bury 026D","E01005043","Total",5,1,1,3,0,0,0,0,5,1,1,3
"2011","Bury 026E","E01005044","Total",16,4,8,4,0,0,0,0,16,4,8,4
"2011","Manchester 001A","E01005098","Total",103,26,28,49,9,0,3,6,94,26,25,43
"2011","Manchester 001B","E01005099","Total",169,49,28,92,12,1,3,8,157,48,25,84
"2011","Manchester 001C","E01005100","Total",80,26,10,44,1,0,0,1,79,26,10,43
"2011","Manchester 001D","E01005102","Total",63,22,16,25,2,0,1,1,61,22,15,24
"2011","Manchester 001E","E01005103","Total",94,24,21,49,2,0,0,2,92,24,21,47
"2011","Manchester 002A","E01005101","Total",113,36,34,43,4,0,3,1,109,36,31,42
"2011","Manchester 002B","E01005135","Total",115,30,19,66,8,0,4,4,107,30,15,62
"2011","Manchester 002C","E01005136","Total",53,19,15,19,1,0,0,1,52,19,15,18
"2011","Manchester 002D","E01005138","Total",148,34,25,89,14,5,3,6,134,29,22,83
"2011","Manchester 002E","E01005140","Total",138,29,40,69,12,1,7,4,126,28,33,65
"2011","Manchester 003B","E01005139","Total",82,31,15,36,4,0,2,2,78,31,13,34
"2011","Manchester 003C","E01005141","Total",106,25,24,57,5,0,3,2,101,25,21,55
"2011","Manchester 003D","E01005251","Total",118,30,30,58,6,0,4,2,112,30,26,56
"2011","Manchester 003E","E01005252","Total",101,30,25,46,6,3,2,1,95,27,23,45
"2011","Manchester 003F","E01033685","Total",72,17,32,23,6,0,5,1,66,17,27,22
"2011","Manchester 003G","E01033687","Total",61,16,18,27,10,1,4,5,51,15,14,22
"2011","Manchester 004A","E01005104","Total",123,28,26,69,10,1,3,6,113,27,23,63
"2011","Manchester 004B","E01005160","Total",39,11,9,19,3,0,1,2,36,11,8,17
"2011","Manchester 004C","E01005161","Total",65,26,11,28,3,2,0,1,62,24,11,27
"2011","Manchester 004D","E01005162","Total",29,5,5,19,3,1,0,2,26,4,5,17
"2011","Manchester 004E","E01005163","Total",42,8,11,23,8,2,1,5,34,6,10,18
"2011","Manchester 005A","E01005247","Total",52,13,25,14,4,0,2,2,48,13,23,12
"2011","Manchester 005B","E01005248","Total",26,7,11,8,1,0,1,0,25,7,10,8
"2011","Manchester 005C","E01005249","Total",67,22,17,28,6,0,3,3,61,22,14,25
"2011","Manchester 005D","E01005250","Total",123,39,17,67,2,0,0,2,121,39,17,65
"2011","Manchester 005E","E01005253","Total",117,41,23,53,2,0,0,2,115,41,23,51
"2011","Manchester 005F","E01005254","Total",52,14,21,17,6,0,5,1,46,14,16,16
"2011","Manchester 006A","E01005164","Total",69,15,10,44,11,1,3,7,58,14,7,37
"2011","Manchester 006B","E01005205","Total",140,55,21,64,12,1,3,8,128,54,18,56
"2011","Manchester 006C","E01005206","Total",89,28,21,40,8,1,6,1,81,27,15,39
"2011","Manchester 006D","E01005207","Total",99,25,18,56,10,2,3,5,89,23,15,51
"2011","Manchester 007A","E01005223","Total",56,17,11,28,1,0,1,0,55,17,10,28
"2011","Manchester 007B","E01005224","Total",120,41,21,58,20,7,7,6,100,34,14,52
"2011","Manchester 007C","E01005225","Total",105,30,22,53,10,0,4,6,95,30,18,47
"2011","Manchester 007D","E01005226","Total",84,23,17,44,1,0,0,1,83,23,17,43
"2011","Manchester 007E","E01005229","Total",47,18,15,14,5,3,2,0,42,15,13,14
"2011","Manchester 008A","E01005145","Total",61,13,4,44,10,3,1,6,51,10,3,38
"2011","Manchester 008B","E01005146","Total",66,12,15,39,8,1,4,3,58,11,11,36
"2011","Manchester 008C","E01005149","Total",41,14,4,23,4,2,0,2,37,12,4,21
"2011","Manchester 008D","E01005165","Total",71,15,6,50,9,1,2,6,62,14,4,44
"2011","Manchester 008E","E01005166","Total",45,11,8,26,9,4,1,4,36,7,7,22
"2011","Manchester 008F","E01005167","Total",58,16,4,38,1,1,0,0,57,15,4,38
"2011","Manchester 009A","E01005202","Total",161,32,18,111,15,3,2,10,146,29,16,101
"2011","Manchester 009B","E01005203","Total",137,33,21,83,12,0,2,10,125,33,19,73
"2011","Manchester 009D","E01005227","Total",117,26,23,68,17,2,3,12,100,24,20,56
"2011","Manchester 009E","E01005228","Total",124,37,17,70,12,0,6,6,112,37,11,64
"2011","Manchester 009F","E01033678","Total",96,22,17,57,11,1,2,8,85,21,15,49
"2011","Manchester 009G","E01033679","Total",98,18,18,62,13,1,2,10,85,17,16,52
"2011","Manchester 011A","E01005256","Total",142,44,28,70,16,3,8,5,126,41,20,65
"2011","Manchester 011B","E01005257","Total",148,43,20,85,11,2,3,6,137,41,17,79
"2011","Manchester 011C","E01005258","Total",94,20,30,44,5,0,1,4,89,20,29,40
"2011","Manchester 011D","E01005259","Total",136,32,17,87,10,3,1,6,126,29,16,81
"2011","Manchester 011E","E01005260","Total",41,6,14,21,6,1,4,1,35,5,10,20
"2011","Manchester 012A","E01005093","Total",117,33,15,69,10,1,3,6,107,32,12,63
"2011","Manchester 012B","E01005094","Total",102,21,20,61,6,0,2,4,96,21,18,57
"2011","Manchester 012C","E01005097","Total",143,34,28,81,14,3,3,8,129,31,25,73
"2011","Manchester 012D","E01005255","Total",114,35,16,63,11,2,2,7,103,33,14,56
"2011","Manchester 012E","E01005261","Total",135,40,22,73,9,1,3,5,126,39,19,68
"2011","Manchester 013B","E01005129","Total",107,36,15,56,4,1,3,0,103,35,12,56
"2011","Manchester 013C","E01005132","Total",120,31,15,74,11,1,1,9,109,30,14,65
"2011","Manchester 013D","E01005133","Total",65,23,6,36,8,0,2,6,57,23,4,30
"2011","Manchester 013E","E01033663","Total",12,3,1,8,1,0,0,1,11,3,1,7
"2011","Manchester 013F","E01033684","Total",3,1,1,1,0,0,0,0,3,1,1,1
"2011","Manchester 013G","E01033688","Total",87,19,15,53,5,1,2,2,82,18,13,51
"2011","Manchester 015A","E01005092","Total",116,32,20,64,14,2,6,6,102,30,14,58
"2011","Manchester 015C","E01005105","Total",120,20,23,77,8,0,3,5,112,20,20,72
"2011","Manchester 015D","E01005106","Total",126,45,25,56,14,5,7,2,112,40,18,54
"2011","Manchester 015E","E01005107","Total",131,39,17,75,12,1,2,9,119,38,15,66
"2011","Manchester 015F","E01033668","Total",49,9,8,32,6,0,3,3,43,9,5,29
"2011","Manchester 015G","E01033669","Total",86,22,17,47,9,1,4,4,77,21,13,43
"2011","Manchester 017A","E01005108","Total",225,63,37,125,19,4,3,12,206,59,34,113
"2011","Manchester 017D","E01005189","Total",112,34,18,60,10,1,2,7,102,33,16,53
"2011","Manchester 017E","E01005190","Total",137,35,31,71,10,1,5,4,127,34,26,67
"2011","Manchester 017F","E01033666","Total",115,40,29,46,12,2,8,2,103,38,21,44
"2011","Manchester 018A","E01005061","Total",113,22,19,72,9,1,1,7,104,21,18,65
"2011","Manchester 018B","E01005062","Total",75,14,14,47,5,0,2,3,70,14,12,44
"2011","Manchester 018C","E01005063","Total",95,25,26,44,10,1,4,5,85,24,22,39
"2011","Manchester 018D","E01005065","Total",111,32,20,59,11,3,3,5,100,29,17,54
"2011","Manchester 018E","E01005066","Total",33,6,11,16,3,1,0,2,30,5,11,14
"2011","Manchester 019A","E01005208","Total",104,31,26,47,13,4,6,3,91,27,20,44
"2011","Manchester 019B","E01005209","Total",82,26,14,42,8,2,3,3,74,24,11,39
"2011","Manchester 019C","E01005210","Total",41,11,6,24,8,3,2,3,33,8,4,21
"2011","Manchester 019D","E01005214","Total",75,23,15,37,3,0,1,2,72,23,14,35
"2011","Manchester 020A","E01005067","Total",100,27,17,56,9,2,2,5,91,25,15,51
"2011","Manchester 020B","E01005186","Total",116,40,22,54,14,3,5,6,102,37,17,48
"2011","Manchester 020C","E01005232","Total",69,24,15,30,4,1,2,1,65,23,13,29
"2011","Manchester 020D","E01005235","Total",102,24,20,58,9,1,4,4,93,23,16,54
"2011","Manchester 020E","E01005239","Total",125,26,16,83,8,4,2,2,117,22,14,81
"2011","Manchester 021A","E01005187","Total",126,32,20,74,6,0,2,4,120,32,18,70
"2011","Manchester 021B","E01005188","Total",84,26,17,41,5,0,2,3,79,26,15,38
"2011","Manchester 021C","E01005191","Total",122,37,28,57,17,1,6,10,105,36,22,47
"2011","Manchester 021D","E01005192","Total",66,23,17,26,4,0,1,3,62,23,16,23
"2011","Manchester 021E","E01005193","Total",101,24,28,49,3,0,2,1,98,24,26,48
"2011","Manchester 022B","E01005230","Total",38,10,3,25,1,1,0,0,37,9,3,25
"2011","Manchester 022C","E01005231","Total",7,3,0,4,0,0,0,0,7,3,0,4
"2011","Manchester 022D","E01005236","Total",46,11,5,30,8,3,0,5,38,8,5,25
"2011","Manchester 022E","E01005237","Total",26,4,3,19,0,0,0,0,26,4,3,19
"2011","Manchester 022F","E01033652","Total",29,4,7,18,3,1,0,2,26,3,7,16
"2011","Manchester 022G","E01033657","Total",37,10,8,19,3,1,1,1,34,9,7,18
"2011","Manchester 023A","E01005195","Total",131,42,21,68,8,3,3,2,123,39,18,66
"2011","Manchester 023B","E01005196","Total",185,42,31,112,23,5,6,12,162,37,25,100
"2011","Manchester 023C","E01005197","Total",100,35,22,43,8,0,5,3,92,35,17,40
"2011","Manchester 023D","E01005198","Total",92,19,20,53,7,0,2,5,85,19,18,48
"2011","Manchester 023E","E01005201","Total",153,36,25,92,14,4,6,4,139,32,19,88
"2011","Manchester 024A","E01005240","Total",174,35,28,111,11,3,3,5,163,32,25,106
"2011","Manchester 024B","E01005243","Total",189,55,28,106,11,2,1,8,178,53,27,98
"2011","Manchester 024C","E01005245","Total",167,44,20,103,10,2,1,7,157,42,19,96
"2011","Manchester 024D","E01005246","Total",153,38,15,100,6,1,0,5,147,37,15,95
"2011","Manchester 025A","E01005241","Total",100,22,17,61,7,1,4,2,93,21,13,59
"2011","Manchester 025B","E01005242","Total",189,46,18,125,10,4,0,6,179,42,18,119
"2011","Manchester 025C","E01005244","Total",69,23,4,42,2,0,0,2,67,23,4,40
"2011","Manchester 025D","E01005285","Total",31,6,1,24,0,0,0,0,31,6,1,24
"2011","Manchester 025E","E01005288","Total",35,9,0,26,1,1,0,0,34,8,0,26
"2011","Manchester 026A","E01005280","Total",48,11,2,35,4,0,0,4,44,11,2,31
"2011","Manchester 026B","E01005281","Total",6,2,2,2,1,0,1,0,5,2,1,2
"2011","Manchester 026C","E01005284","Total",10,2,2,6,1,0,1,0,9,2,1,6
"2011","Manchester 026D","E01005286","Total",13,4,3,6,2,0,1,1,11,4,2,5
"2011","Manchester 026E","E01005287","Total",50,8,5,37,4,0,1,3,46,8,4,34
"2011","Manchester 027A","E01005194","Total",95,27,13,55,8,5,2,1,87,22,11,54
"2011","Manchester 027B","E01005199","Total",117,34,26,57,15,6,3,6,102,28,23,51
"2011","Manchester 027C","E01005200","Total",79,29,13,37,12,3,5,4,67,26,8,33
"2011","Manchester 027D","E01005233","Total",99,25,10,64,4,2,0,2,95,23,10,62
"2011","Manchester 027E","E01005234","Total",66,14,10,42,10,4,4,2,56,10,6,40
"2011","Manchester 027F","E01005238","Total",52,11,7,34,4,0,1,3,48,11,6,31
"2011","Manchester 028A","E01005297","Total",83,19,24,40,7,1,2,4,76,18,22,36
"2011","Manchester 028B","E01005298","Total",44,12,8,24,3,0,0,3,41,12,8,21
"2011","Manchester 028C","E01005302","Total",48,22,10,16,3,1,2,0,45,21,8,16
"2011","Manchester 028E","E01033680","Total",29,10,8,11,2,0,1,1,27,10,7,10
"2011","Manchester 028F","E01033686","Total",26,7,7,12,3,0,2,1,23,7,5,11
"2011","Manchester 029A","E01005150","Total",21,6,7,8,4,0,3,1,17,6,4,7
"2011","Manchester 029B","E01005151","Total",19,5,12,2,0,0,0,0,19,5,12,2
"2011","Manchester 029C","E01005152","Total",25,8,14,3,2,0,2,0,23,8,12,3
"2011","Manchester 029D","E01005159","Total",17,6,9,2,2,0,2,0,15,6,7,2
"2011","Manchester 029E","E01005296","Total",17,4,7,6,1,0,1,0,16,4,6,6
"2011","Manchester 029F","E01005299","Total",28,11,5,12,3,1,1,1,25,10,4,11
"2011","Manchester 030A","E01005178","Total",80,23,13,44,1,0,0,1,79,23,13,43
"2011","Manchester 030B","E01005179","Total",50,9,21,20,5,0,3,2,45,9,18,18
"2011","Manchester 030C","E01005180","Total",116,30,25,61,9,1,4,4,107,29,21,57
"2011","Manchester 030D","E01005181","Total",51,15,19,17,4,2,2,0,47,13,17,17
"2011","Manchester 030E","E01005182","Total",72,19,16,37,6,2,1,3,66,17,15,34
"2011","Manchester 030F","E01005183","Total",86,17,16,53,6,1,1,4,80,16,15,49
"2011","Manchester 031A","E01005219","Total",60,21,13,26,6,1,0,5,54,20,13,21
"2011","Manchester 031B","E01005220","Total",54,13,13,28,3,0,1,2,51,13,12,26
"2011","Manchester 031C","E01005221","Total",61,17,17,27,6,2,3,1,55,15,14,26
"2011","Manchester 031D","E01005222","Total",112,34,30,48,4,0,2,2,108,34,28,46
"2011","Manchester 032A","E01005184","Total",21,3,3,15,1,0,1,0,20,3,2,15
"2011","Manchester 032B","E01005185","Total",8,3,1,4,1,0,0,1,7,3,1,3
"2011","Manchester 032C","E01005271","Total",14,1,1,12,0,0,0,0,14,1,1,12
"2011","Manchester 032D","E01005282","Total",43,13,5,25,2,0,1,1,41,13,4,24
"2011","Manchester 032E","E01005283","Total",14,2,3,9,0,0,0,0,14,2,3,9
"2011","Manchester 033A","E01005154","Total",16,6,8,2,2,0,2,0,14,6,6,2
"2011","Manchester 033B","E01005156","Total",29,11,16,2,1,0,1,0,28,11,15,2
"2011","Manchester 033C","E01005158","Total",51,19,12,20,7,3,0,4,44,16,12,16
"2011","Manchester 033D","E01005300","Total",23,9,2,12,1,0,0,1,22,9,2,11
"2011","Manchester 033E","E01005301","Total",15,1,5,9,0,0,0,0,15,1,5,9
"2011","Manchester 034A","E01005118","Total",21,7,4,10,1,0,0,1,20,7,4,9
"2011","Manchester 034B","E01005120","Total",62,17,19,26,3,0,1,2,59,17,18,24
"2011","Manchester 034C","E01005215","Total",67,25,17,25,1,1,0,0,66,24,17,25
"2011","Manchester 034D","E01005216","Total",37,15,14,8,4,0,3,1,33,15,11,7
"2011","Manchester 034E","E01005217","Total",42,16,14,12,4,2,2,0,38,14,12,12
"2011","Manchester 034F","E01005218","Total",14,2,4,8,1,0,0,1,13,2,4,7
"2011","Manchester 035A","E01005270","Total",92,33,16,43,7,2,2,3,85,31,14,40
"2011","Manchester 035B","E01005272","Total",147,39,34,74,9,1,6,2,138,38,28,72
"2011","Manchester 035C","E01005273","Total",30,7,3,20,2,0,1,1,28,7,2,19
"2011","Manchester 035D","E01005278","Total",31,10,8,13,4,0,3,1,27,10,5,12
"2011","Manchester 035E","E01005279","Total",104,35,23,46,8,2,4,2,96,33,19,44
"2011","Manchester 036A","E01005305","Total",23,6,8,9,3,0,3,0,20,6,5,9
"2011","Manchester 036B","E01005309","Total",9,0,2,7,2,0,1,1,7,0,1,6
"2011","Manchester 036C","E01005310","Total",56,19,12,25,2,0,1,1,54,19,11,24
"2011","Manchester 036D","E01005311","Total",27,1,12,14,2,0,1,1,25,1,11,13
"2011","Manchester 036E","E01005312","Total",17,2,7,8,2,0,2,0,15,2,5,8
"2011","Manchester 037A","E01005082","Total",89,26,17,46,5,0,1,4,84,26,16,42
"2011","Manchester 037B","E01005153","Total",46,16,17,13,5,1,4,0,41,15,13,13
"2011","Manchester 037C","E01005155","Total",27,11,12,4,1,0,1,0,26,11,11,4
"2011","Manchester 037D","E01005157","Total",24,8,12,4,2,0,2,0,22,8,10,4
"2011","Manchester 038A","E01005274","Total",66,14,15,37,4,0,1,3,62,14,14,34
"2011","Manchester 038B","E01005275","Total",17,6,4,7,1,0,0,1,16,6,4,6
"2011","Manchester 038C","E01005276","Total",31,2,10,19,3,0,3,0,28,2,7,19
"2011","Manchester 038D","E01005277","Total",16,4,9,3,3,1,2,0,13,3,7,3
"2011","Manchester 039A","E01005076","Total",21,5,6,10,1,0,0,1,20,5,6,9
"2011","Manchester 039C","E01005081","Total",142,42,26,74,11,3,0,8,131,39,26,66
"2011","Manchester 039D","E01005083","Total",11,4,5,2,1,0,0,1,10,4,5,1
"2011","Manchester 039E","E01033670","Total",13,2,4,7,1,0,1,0,12,2,3,7
"2011","Manchester 039F","E01033671","Total",14,4,6,4,0,0,0,0,14,4,6,4
"2011","Manchester 040A","E01005125","Total",87,16,25,46,4,0,2,2,83,16,23,44
"2011","Manchester 040B","E01005304","Total",12,0,5,7,3,0,2,1,9,0,3,6
"2011","Manchester 040C","E01005306","Total",14,3,7,4,2,0,2,0,12,3,5,4
"2011","Manchester 040D","E01005307","Total",7,3,2,2,1,0,1,0,6,3,1,2
"2011","Manchester 040E","E01005308","Total",81,20,18,43,4,0,2,2,77,20,16,41
"2011","Manchester 041A","E01005119","Total",98,21,24,53,1,0,0,1,97,21,24,52
"2011","Manchester 041B","E01005121","Total",99,43,15,41,4,1,0,3,95,42,15,38
"2011","Manchester 041C","E01005122","Total",105,33,16,56,3,1,0,2,102,32,16,54
"2011","Manchester 041D","E01005123","Total",127,24,24,79,13,1,6,6,114,23,18,73
"2011","Manchester 041E","E01005124","Total",128,41,18,69,12,1,0,11,116,40,18,58
"2011","Manchester 042A","E01005077","Total",126,33,25,68,9,0,5,4,117,33,20,64
"2011","Manchester 042B","E01005078","Total",11,4,6,1,0,0,0,0,11,4,6,1
"2011","Manchester 042C","E01005079","Total",59,8,13,38,5,0,2,3,54,8,11,35
"2011","Manchester 042D","E01005084","Total",85,30,22,33,7,1,3,3,78,29,19,30
"2011","Manchester 043A","E01005172","Total",14,3,9,2,4,1,3,0,10,2,6,2
"2011","Manchester 043B","E01005173","Total",17,6,10,1,3,1,2,0,14,5,8,1
"2011","Manchester 043C","E01005174","Total",16,4,10,2,3,0,3,0,13,4,7,2
"2011","Manchester 043D","E01005175","Total",28,8,12,8,1,0,1,0,27,8,11,8
"2011","Manchester 043E","E01005176","Total",23,7,10,6,1,0,1,0,22,7,9,6
"2011","Manchester 043F","E01005177","Total",18,4,10,4,3,0,2,1,15,4,8,3
"2011","Manchester 044A","E01005115","Total",89,28,20,41,7,2,4,1,82,26,16,40
"2011","Manchester 044B","E01005262","Total",97,26,30,41,13,0,9,4,84,26,21,37
"2011","Manchester 044C","E01005264","Total",84,27,22,35,4,0,1,3,80,27,21,32
"2011","Manchester 044D","E01005265","Total",100,32,21,47,6,0,3,3,94,32,18,44
"2011","Manchester 044E","E01005266","Total",118,31,28,59,7,0,3,4,111,31,25,55
"2011","Manchester 045A","E01005126","Total",45,11,19,15,9,1,4,4,36,10,15,11
"2011","Manchester 045B","E01005168","Total",31,14,11,6,2,0,2,0,29,14,9,6
"2011","Manchester 045C","E01005169","Total",12,2,6,4,0,0,0,0,12,2,6,4
"2011","Manchester 045D","E01005170","Total",33,13,9,11,4,0,1,3,29,13,8,8
"2011","Manchester 045E","E01005171","Total",34,15,13,6,4,0,3,1,30,15,10,5
"2011","Manchester 046A","E01005263","Total",49,18,19,12,6,0,6,0,43,18,13,12
"2011","Manchester 046B","E01005267","Total",40,16,11,13,1,0,1,0,39,16,10,13
"2011","Manchester 046C","E01005268","Total",33,13,16,4,2,0,2,0,31,13,14,4
"2011","Manchester 046D","E01005269","Total",19,5,11,3,4,0,4,0,15,5,7,3
"2011","Manchester 047A","E01005069","Total",28,8,12,8,3,1,1,1,25,7,11,7
"2011","Manchester 047B","E01005111","Total",65,22,14,29,6,1,2,3,59,21,12,26
"2011","Manchester 047C","E01005113","Total",80,21,24,35,10,1,5,4,70,20,19,31
"2011","Manchester 047D","E01005114","Total",30,12,10,8,3,0,2,1,27,12,8,7
"2011","Manchester 047E","E01005116","Total",67,22,20,25,3,0,2,1,64,22,18,24
"2011","Manchester 048A","E01005071","Total",91,30,33,28,5,0,4,1,86,30,29,27
"2011","Manchester 048B","E01005072","Total",96,29,23,44,5,0,2,3,91,29,21,41
"2011","Manchester 048C","E01005073","Total",31,6,14,11,3,0,2,1,28,6,12,10
"2011","Manchester 048D","E01005112","Total",88,32,15,41,1,0,0,1,87,32,15,40
"2011","Manchester 048E","E01005117","Total",132,27,35,70,15,2,7,6,117,25,28,64
"2011","Manchester 049A","E01005085","Total",99,27,20,52,4,1,2,1,95,26,18,51
"2011","Manchester 049B","E01005086","Total",114,33,20,61,6,2,2,2,108,31,18,59
"2011","Manchester 049C","E01005089","Total",126,29,26,71,10,0,4,6,116,29,22,65
"2011","Manchester 049D","E01005289","Total",98,29,13,56,6,1,1,4,92,28,12,52
"2011","Manchester 049E","E01005295","Total",81,26,23,32,6,0,4,2,75,26,19,30
"2011","Manchester 050A","E01005087","Total",174,40,22,112,11,0,2,9,163,40,20,103
"2011","Manchester 050B","E01005088","Total",145,42,24,79,14,1,6,7,131,41,18,72
"2011","Manchester 050C","E01005090","Total",105,21,19,65,7,2,0,5,98,19,19,60
"2011","Manchester 050D","E01005091","Total",158,44,25,89,9,1,5,3,149,43,20,86
"2011","Manchester 050E","E01005291","Total",83,20,13,50,3,0,1,2,80,20,12,48
"2011","Manchester 051A","E01005068","Total",111,29,27,55,9,0,2,7,102,29,25,48
"2011","Manchester 051B","E01005070","Total",102,39,16,47,2,1,0,1,100,38,16,46
"2011","Manchester 051C","E01005074","Total",67,26,16,25,3,0,1,2,64,26,15,23
"2011","Manchester 051D","E01005075","Total",59,22,15,22,3,0,0,3,56,22,15,19
"2011","Manchester 051E","E01005319","Total",134,42,22,70,10,1,3,6,124,41,19,64
"2011","Manchester 052A","E01005290","Total",107,28,21,58,10,3,3,4,97,25,18,54
"2011","Manchester 052B","E01005292","Total",109,44,17,48,8,2,2,4,101,42,15,44
"2011","Manchester 052C","E01005293","Total",51,24,17,10,3,0,2,1,48,24,15,9
"2011","Manchester 052D","E01005294","Total",40,10,16,14,3,1,1,1,37,9,15,13
"2011","Manchester 052E","E01005317","Total",82,29,13,40,8,1,3,4,74,28,10,36
"2011","Manchester 053A","E01005313","Total",79,27,7,45,3,1,1,1,76,26,6,44
"2011","Manchester 053B","E01005314","Total",88,35,11,42,6,1,0,5,82,34,11,37
"2011","Manchester 053C","E01005315","Total",85,29,11,45,9,1,4,4,76,28,7,41
"2011","Manchester 053D","E01005316","Total",67,27,20,20,5,1,4,0,62,26,16,20
"2011","Manchester 053E","E01005318","Total",110,39,29,42,6,1,3,2,104,38,26,40
"2011","Manchester 054A","E01005130","Total",97,25,18,54,11,3,4,4,86,22,14,50
"2011","Manchester 054B","E01033651","Total",9,2,3,4,2,0,2,0,7,2,1,4
"2011","Manchester 054C","E01033658","Total",9,4,2,3,1,1,0,0,8,3,2,3
"2011","Manchester 054D","E01033664","Total",3,0,2,1,0,0,0,0,3,0,2,1
"2011","Manchester 054E","E01033667","Total",4,1,2,1,1,0,1,0,3,1,1,1
"2011","Manchester 055A","E01005128","Total",9,5,2,2,2,2,0,0,7,3,2,2
"2011","Manchester 055B","E01033653","Total",7,3,1,3,0,0,0,0,7,3,1,3
"2011","Manchester 055C","E01033654","Total",3,0,2,1,0,0,0,0,3,0,2,1
"2011","Manchester 055D","E01033659","Total",5,3,1,1,0,0,0,0,5,3,1,1
"2011","Manchester 055E","E01033661","Total",2,0,0,2,2,0,0,2,0,0,0,0
"2011","Manchester 056A","E01005143","Total",64,11,6,47,2,0,0,2,62,11,6,45
"2011","Manchester 056B","E01033655","Total",5,3,1,1,1,0,1,0,4,3,0,1
"2011","Manchester 056C","E01033665","Total",12,3,4,5,3,0,1,2,9,3,3,3
"2011","Manchester 056D","E01033676","Total",96,25,8,63,8,1,1,6,88,24,7,57
"2011","Manchester 057A","E01005212","Total",58,16,10,32,11,1,2,8,47,15,8,24
"2011","Manchester 057B","E01033656","Total",5,2,1,2,2,1,0,1,3,1,1,1
"2011","Manchester 057C","E01033662","Total",4,0,3,1,0,0,0,0,4,0,3,1
"2011","Manchester 058A","E01005142","Total",95,26,16,53,10,4,3,3,85,22,13,50
"2011","Manchester 058B","E01005147","Total",150,46,17,87,15,4,3,8,135,42,14,79
"2011","Manchester 058C","E01033674","Total",49,15,17,17,3,0,3,0,46,15,14,17
"2011","Manchester 058D","E01033675","Total",152,38,32,82,16,2,6,8,136,36,26,74
"2011","Manchester 059A","E01005213","Total",104,35,18,51,14,2,2,10,90,33,16,41
"2011","Manchester 059B","E01033660","Total",3,0,0,3,2,0,0,2,1,0,0,1
"2011","Manchester 059C","E01033672","Total",69,27,9,33,2,1,0,1,67,26,9,32
"2011","Manchester 059D","E01033673","Total",1,1,0,0,0,0,0,0,1,1,0,0
"2011","Manchester 060A","E01033677","Total",5,1,3,1,0,0,0,0,5,1,3,1
"2011","Manchester 060B","E01033681","Total",8,0,7,1,3,0,3,0,5,0,4,1
"2011","Manchester 060C","E01033682","Total",1,0,1,0,1,0,1,0,0,0,0,0
"2011","Manchester 060D","E01033683","Total",2,0,0,2,1,0,0,1,1,0,0,1
"2011","Oldham 001A","E01005357","Total",26,12,6,8,3,1,1,1,23,11,5,7
"2011","Oldham 001B","E01005358","Total",72,22,24,26,4,1,2,1,68,21,22,25
"2011","Oldham 001C","E01005359","Total",27,5,18,4,5,0,3,2,22,5,15,2
"2011","Oldham 001D","E01005360","Total",45,16,10,19,1,0,0,1,44,16,10,18
"2011","Oldham 002A","E01005441","Total",78,15,32,31,7,0,3,4,71,15,29,27
"2011","Oldham 002B","E01005442","Total",40,12,21,7,6,1,5,0,34,11,16,7
"2011","Oldham 002C","E01005444","Total",70,16,28,26,11,0,9,2,59,16,19,24
"2011","Oldham 002D","E01005445","Total",71,25,28,18,5,2,3,0,66,23,25,18
"2011","Oldham 003A","E01005361","Total",29,8,15,6,3,0,3,0,26,8,12,6
"2011","Oldham 003B","E01005443","Total",19,10,8,1,2,0,2,0,17,10,6,1
"2011","Oldham 003C","E01005446","Total",53,15,24,14,5,0,5,0,48,15,19,14
"2011","Oldham 003D","E01005447","Total",70,25,20,25,8,0,3,5,62,25,17,20
"2011","Oldham 004A","E01005390","Total",45,13,21,11,8,1,5,2,37,12,16,9
"2011","Oldham 004B","E01005394","Total",36,5,19,12,3,2,1,0,33,3,18,12
"2011","Oldham 004C","E01005395","Total",44,13,19,12,5,2,3,0,39,11,16,12
"2011","Oldham 004D","E01005396","Total",32,8,9,15,3,1,2,0,29,7,7,15
"2011","Oldham 005A","E01005355","Total",61,22,25,14,4,1,3,0,57,21,22,14
"2011","Oldham 005B","E01005356","Total",36,10,19,7,8,0,5,3,28,10,14,4
"2011","Oldham 005C","E01005399","Total",33,10,17,6,8,0,8,0,25,10,9,6
"2011","Oldham 005D","E01005403","Total",56,16,29,11,9,1,6,2,47,15,23,9
"2011","Oldham 006A","E01005410","Total",18,4,11,3,6,0,5,1,12,4,6,2
"2011","Oldham 006B","E01005411","Total",22,6,13,3,7,0,6,1,15,6,7,2
"2011","Oldham 006C","E01005414","Total",15,4,6,5,3,0,2,1,12,4,4,4
"2011","Oldham 006D","E01005415","Total",22,4,7,11,1,0,0,1,21,4,7,10
"2011","Oldham 007C","E01005452","Total",23,12,8,3,2,1,1,0,21,11,7,3
"2011","Oldham 007D","E01005453","Total",28,7,13,8,1,0,0,1,27,7,13,7
"2011","Oldham 007E","E01032558","Total",126,31,30,65,9,1,4,4,117,30,26,61
"2011","Oldham 007F","E01032559","Total",109,37,43,29,9,0,5,4,100,37,38,25
"2011","Oldham 008A","E01005391","Total",40,13,18,9,7,0,5,2,33,13,13,7
"2011","Oldham 008B","E01005392","Total",54,15,11,28,6,0,2,4,48,15,9,24
"2011","Oldham 008C","E01005393","Total",30,10,15,5,4,0,3,1,26,10,12,4
"2011","Oldham 008D","E01005401","Total",38,10,21,7,1,0,1,0,37,10,20,7
"2011","Oldham 009A","E01005397","Total",38,13,13,12,4,1,3,0,34,12,10,12
"2011","Oldham 009B","E01005398","Total",39,14,17,8,6,1,5,0,33,13,12,8
"2011","Oldham 009C","E01005400","Total",68,27,15,26,6,1,2,3,62,26,13,23
"2011","Oldham 009D","E01005402","Total",48,16,22,10,7,2,5,0,41,14,17,10
"2011","Oldham 010A","E01005335","Total",26,6,11,9,4,1,2,1,22,5,9,8
"2011","Oldham 010B","E01005337","Total",55,17,17,21,5,2,2,1,50,15,15,20
"2011","Oldham 010C","E01005339","Total",17,8,7,2,2,0,2,0,15,8,5,2
"2011","Oldham 010D","E01005340","Total",78,32,16,30,8,2,4,2,70,30,12,28
"2011","Oldham 011A","E01005421","Total",122,29,33,60,14,0,8,6,108,29,25,54
"2011","Oldham 011B","E01005422","Total",149,46,23,80,11,2,5,4,138,44,18,76
"2011","Oldham 011E","E01032920","Total",102,33,24,45,11,2,2,7,91,31,22,38
"2011","Oldham 012A","E01005448","Total",101,19,19,63,17,0,5,12,84,19,14,51
"2011","Oldham 012B","E01005449","Total",71,24,12,35,4,0,0,4,67,24,12,31
"2011","Oldham 012C","E01005454","Total",45,17,20,8,2,0,1,1,43,17,19,7
"2011","Oldham 012D","E01005455","Total",50,17,15,18,4,0,4,0,46,17,11,18
"2011","Oldham 012E","E01005456","Total",101,29,24,48,4,0,2,2,97,29,22,46
"2011","Oldham 013A","E01005407","Total",22,7,12,3,7,2,5,0,15,5,7,3
"2011","Oldham 013B","E01005412","Total",35,9,19,7,8,1,7,0,27,8,12,7
"2011","Oldham 013C","E01005416","Total",23,4,13,6,5,1,3,1,18,3,10,5
"2011","Oldham 013D","E01005417","Total",38,11,21,6,3,0,3,0,35,11,18,6
"2011","Oldham 014A","E01005348","Total",67,22,11,34,6,0,3,3,61,22,8,31
"2011","Oldham 014B","E01005350","Total",65,13,12,40,7,2,0,5,58,11,12,35
"2011","Oldham 014C","E01005432","Total",103,26,23,54,6,0,2,4,97,26,21,50
"2011","Oldham 014D","E01005433","Total",117,28,17,72,8,1,4,3,109,27,13,69
"2011","Oldham 015A","E01005329","Total",36,13,18,5,2,1,1,0,34,12,17,5
"2011","Oldham 015B","E01005330","Total",26,5,18,3,1,0,1,0,25,5,17,3
"2011","Oldham 015C","E01005333","Total",11,4,5,2,3,0,2,1,8,4,3,1
"2011","Oldham 015D","E01005336","Total",22,3,15,4,5,1,2,2,17,2,13,2
"2011","Oldham 016A","E01005349","Total",44,5,0,39,7,3,0,4,37,2,0,35
"2011","Oldham 016B","E01005351","Total",30,7,3,20,4,1,1,2,26,6,2,18
"2011","Oldham 016C","E01005352","Total",34,9,4,21,6,0,1,5,28,9,3,16
"2011","Oldham 016D","E01005353","Total",49,5,6,38,11,1,3,7,38,4,3,31
"2011","Oldham 016E","E01005354","Total",44,7,13,24,3,1,2,0,41,6,11,24
"2011","Oldham 017A","E01005327","Total",59,15,24,20,1,0,0,1,58,15,24,19
"2011","Oldham 017B","E01005328","Total",49,15,7,27,5,1,4,0,44,14,3,27
"2011","Oldham 017C","E01005331","Total",58,19,19,20,4,0,3,1,54,19,16,19
"2011","Oldham 017D","E01005334","Total",37,7,24,6,3,0,3,0,34,7,21,6
"2011","Oldham 017E","E01005338","Total",67,14,20,33,7,1,3,3,60,13,17,30
"2011","Oldham 018A","E01005387","Total",42,17,14,11,4,1,1,2,38,16,13,9
"2011","Oldham 018B","E01005388","Total",50,18,16,16,2,0,2,0,48,18,14,16
"2011","Oldham 018C","E01005389","Total",104,34,18,52,14,2,4,8,90,32,14,44
"2011","Oldham 018D","E01005418","Total",31,5,21,5,4,0,4,0,27,5,17,5
"2011","Oldham 019A","E01005428","Total",55,9,10,36,6,0,5,1,49,9,5,35
"2011","Oldham 019B","E01005431","Total",72,22,14,36,7,2,1,4,65,20,13,32
"2011","Oldham 019C","E01005450","Total",71,13,12,46,5,0,2,3,66,13,10,43
"2011","Oldham 019D","E01005451","Total",30,8,9,13,3,1,1,1,27,7,8,12
"2011","Oldham 020C","E01005408","Total",46,14,25,7,7,1,6,0,39,13,19,7
"2011","Oldham 020D","E01005409","Total",33,9,16,8,0,0,0,0,33,9,16,8
"2011","Oldham 020E","E01032922","Total",45,17,13,15,2,0,1,1,43,17,12,14
"2011","Oldham 021A","E01005406","Total",22,4,14,4,2,0,1,1,20,4,13,3
"2011","Oldham 021B","E01005413","Total",25,5,15,5,2,0,2,0,23,5,13,5
"2011","Oldham 021C","E01005419","Total",35,11,19,5,4,1,2,1,31,10,17,4
"2011","Oldham 021D","E01005420","Total",44,22,12,10,5,0,4,1,39,22,8,9
"2011","Oldham 022A","E01005321","Total",52,13,8,31,9,2,2,5,43,11,6,26
"2011","Oldham 022B","E01005326","Total",27,6,2,19,2,2,0,0,25,4,2,19
"2011","Oldham 022C","E01005427","Total",43,5,1,37,2,0,0,2,41,5,1,35
"2011","Oldham 022D","E01005429","Total",50,4,8,38,3,0,2,1,47,4,6,37
"2011","Oldham 022E","E01005430","Total",72,7,9,56,5,0,4,1,67,7,5,55
"2011","Oldham 024A","E01005320","Total",77,20,14,43,6,3,0,3,71,17,14,40
"2011","Oldham 024B","E01005434","Total",45,18,11,16,5,0,3,2,40,18,8,14
"2011","Oldham 024C","E01005437","Total",41,14,5,22,2,0,1,1,39,14,4,21
"2011","Oldham 024D","E01005459","Total",33,6,1,26,5,2,0,3,28,4,1,23
"2011","Oldham 026A","E01005383","Total",94,27,18,49,7,1,4,2,87,26,14,47
"2011","Oldham 026D","E01005386","Total",99,25,16,58,9,0,5,4,90,25,11,54
"2011","Oldham 026E","E01032556","Total",40,15,17,8,3,1,2,0,37,14,15,8
"2011","Oldham 026F","E01032557","Total",140,36,22,82,12,1,3,8,128,35,19,74
"2011","Oldham 027A","E01005342","Total",71,22,17,32,4,0,4,0,67,22,13,32
"2011","Oldham 027B","E01005343","Total",74,29,15,30,2,0,0,2,72,29,15,28
"2011","Oldham 027C","E01005344","Total",96,26,23,47,7,1,3,3,89,25,20,44
"2011","Oldham 027D","E01005381","Total",73,24,17,32,8,2,5,1,65,22,12,31
"2011","Oldham 028A","E01005332","Total",105,34,28,43,10,2,3,5,95,32,25,38
"2011","Oldham 028B","E01005341","Total",61,24,28,9,7,0,5,2,54,24,23,7
"2011","Oldham 028C","E01005345","Total",27,13,8,6,2,0,1,1,25,13,7,5
"2011","Oldham 028D","E01005346","Total",27,11,12,4,6,1,5,0,21,10,7,4
"2011","Oldham 028E","E01005347","Total",52,21,16,15,3,1,2,0,49,20,14,15
"2011","Oldham 029A","E01005322","Total",113,27,19,67,10,2,2,6,103,25,17,61
"2011","Oldham 029B","E01005323","Total",81,26,15,40,11,1,5,5,70,25,10,35
"2011","Oldham 029C","E01005324","Total",131,42,23,66,8,0,3,5,123,42,20,61
"2011","Oldham 029D","E01005325","Total",75,21,14,40,6,1,1,4,69,20,13,36
"2011","Oldham 029E","E01005438","Total",101,22,28,51,14,3,5,6,87,19,23,45
"2011","Oldham 030A","E01005377","Total",94,21,23,50,11,0,5,6,83,21,18,44
"2011","Oldham 030B","E01005379","Total",147,37,32,78,6,0,2,4,141,37,30,74
"2011","Oldham 030C","E01005380","Total",126,38,25,63,10,0,4,6,116,38,21,57
"2011","Oldham 030D","E01005382","Total",69,12,14,43,3,0,3,0,66,12,11,43
"2011","Oldham 030E","E01005439","Total",45,13,15,17,8,0,5,3,37,13,10,14
"2011","Oldham 031A","E01005362","Total",55,23,18,14,6,0,3,3,49,23,15,11
"2011","Oldham 031B","E01005364","Total",33,5,15,13,1,0,0,1,32,5,15,12
"2011","Oldham 031C","E01005368","Total",108,37,35,36,5,3,1,1,103,34,34,35
"2011","Oldham 031D","E01005376","Total",87,27,20,40,8,0,2,6,79,27,18,34
"2011","Oldham 031E","E01005378","Total",74,19,20,35,10,1,4,5,64,18,16,30
"2011","Oldham 032A","E01005363","Total",84,25,30,29,4,1,3,0,80,24,27,29
"2011","Oldham 032B","E01005369","Total",96,29,21,46,7,0,4,3,89,29,17,43
"2011","Oldham 032C","E01005370","Total",68,29,14,25,6,0,1,5,62,29,13,20
"2011","Oldham 032D","E01005371","Total",71,24,19,28,4,1,2,1,67,23,17,27
"2011","Oldham 033A","E01005365","Total",35,12,15,8,6,1,4,1,29,11,11,7
"2011","Oldham 033B","E01005366","Total",71,22,26,23,5,1,3,1,66,21,23,22
"2011","Oldham 033C","E01005367","Total",30,9,13,8,5,1,4,0,25,8,9,8
"2011","Oldham 033D","E01005440","Total",35,10,13,12,8,1,4,3,27,9,9,9
"2011","Oldham 034A","E01005372","Total",64,27,19,18,7,2,3,2,57,25,16,16
"2011","Oldham 034B","E01005373","Total",25,7,14,4,2,0,1,1,23,7,13,3
"2011","Oldham 034C","E01005374","Total",66,22,26,18,10,0,9,1,56,22,17,17
"2011","Oldham 034D","E01005375","Total",39,16,16,7,5,0,4,1,34,16,12,6
"2011","Oldham 035A","E01005435","Total",43,10,13,20,3,2,1,0,40,8,12,20
"2011","Oldham 035B","E01005436","Total",40,14,7,19,2,0,0,2,38,14,7,17
"2011","Oldham 035C","E01005460","Total",92,16,23,53,11,2,4,5,81,14,19,48
"2011","Oldham 035D","E01005461","Total",37,6,4,27,4,0,2,2,33,6,2,25
"2011","Oldham 035E","E01005462","Total",41,11,9,21,4,0,1,3,37,11,8,18
"2011","Oldham 035F","E01005463","Total",35,6,8,21,6,1,1,4,29,5,7,17
"2011","Oldham 035G","E01032921","Total",65,7,9,49,8,2,4,2,57,5,5,47
"2011","Rochdale 001A","E01005518","Total",44,12,13,19,4,0,1,3,40,12,12,16
"2011","Rochdale 001B","E01005520","Total",71,24,25,22,5,0,3,2,66,24,22,20
"2011","Rochdale 001C","E01005522","Total",69,23,25,21,6,1,5,0,63,22,20,21
"2011","Rochdale 001D","E01005523","Total",49,18,18,13,5,0,4,1,44,18,14,12
"2011","Rochdale 002A","E01005519","Total",52,19,20,13,1,1,0,0,51,18,20,13
"2011","Rochdale 002B","E01005594","Total",37,14,13,10,8,2,6,0,29,12,7,10
"2011","Rochdale 002C","E01005597","Total",56,20,24,12,5,3,2,0,51,17,22,12
"2011","Rochdale 002D","E01005598","Total",28,10,11,7,5,0,4,1,23,10,7,6
"2011","Rochdale 003A","E01005516","Total",35,12,19,4,4,1,3,0,31,11,16,4
"2011","Rochdale 003B","E01005517","Total",33,14,12,7,2,0,2,0,31,14,10,7
"2011","Rochdale 003C","E01005521","Total",23,7,13,3,1,0,1,0,22,7,12,3
"2011","Rochdale 003D","E01005596","Total",54,19,21,14,7,0,5,2,47,19,16,12
"2011","Rochdale 004A","E01005578","Total",56,10,13,33,5,0,4,1,51,10,9,32
"2011","Rochdale 004B","E01005579","Total",76,23,11,42,6,2,0,4,70,21,11,38
"2011","Rochdale 004C","E01005586","Total",94,21,18,55,16,5,6,5,78,16,12,50
"2011","Rochdale 004D","E01005593","Total",78,24,16,38,7,1,2,4,71,23,14,34
"2011","Rochdale 004E","E01005595","Total",55,11,20,24,6,1,4,1,49,10,16,23
"2011","Rochdale 005A","E01005489","Total",43,17,4,22,4,0,0,4,39,17,4,18
"2011","Rochdale 005B","E01005490","Total",52,17,13,22,7,2,2,3,45,15,11,19
"2011","Rochdale 005C","E01005491","Total",49,16,16,17,9,2,4,3,40,14,12,14
"2011","Rochdale 005D","E01005493","Total",43,16,22,5,7,1,6,0,36,15,16,5
"2011","Rochdale 005E","E01005494","Total",60,24,17,19,0,0,0,0,60,24,17,19
"2011","Rochdale 005F","E01005495","Total",48,15,12,21,2,0,0,2,46,15,12,19
"2011","Rochdale 006A","E01005488","Total",56,18,28,10,7,0,6,1,49,18,22,9
"2011","Rochdale 006B","E01005492","Total",31,4,19,8,6,1,3,2,25,3,16,6
"2011","Rochdale 006C","E01005499","Total",33,12,13,8,6,2,2,2,27,10,11,6
"2011","Rochdale 006D","E01005571","Total",24,13,10,1,1,0,1,0,23,13,9,1
"2011","Rochdale 007A","E01005570","Total",23,9,12,2,1,0,1,0,22,9,11,2
"2011","Rochdale 007B","E01005572","Total",28,7,16,5,2,0,2,0,26,7,14,5
"2011","Rochdale 007C","E01005573","Total",22,13,7,2,4,1,3,0,18,12,4,2
"2011","Rochdale 007D","E01005574","Total",32,11,15,6,9,2,7,0,23,9,8,6
"2011","Rochdale 007E","E01005587","Total",31,13,15,3,3,1,2,0,28,12,13,3
"2011","Rochdale 007F","E01005588","Total",46,21,10,15,4,0,0,4,42,21,10,11
"2011","Rochdale 008A","E01005580","Total",58,19,10,29,5,2,1,2,53,17,9,27
"2011","Rochdale 008B","E01005581","Total",58,15,15,28,3,1,1,1,55,14,14,27
"2011","Rochdale 008D","E01005583","Total",23,1,5,17,2,0,2,0,21,1,3,17
"2011","Rochdale 008F","E01005585","Total",38,5,9,24,4,0,3,1,34,5,6,23
"2011","Rochdale 008G","E01033258","Total",78,11,9,58,8,1,2,5,70,10,7,53
"2011","Rochdale 009A","E01005496","Total",100,40,21,39,10,3,3,4,90,37,18,35
"2011","Rochdale 009B","E01005589","Total",61,13,29,19,8,0,6,2,53,13,23,17
"2011","Rochdale 009C","E01005590","Total",50,7,17,26,10,2,4,4,40,5,13,22
"2011","Rochdale 009D","E01005591","Total",37,12,18,7,3,0,2,1,34,12,16,6
"2011","Rochdale 009E","E01005592","Total",83,19,15,49,15,2,4,9,68,17,11,40
"2011","Rochdale 010A","E01005472","Total",86,22,16,48,4,0,3,1,82,22,13,47
"2011","Rochdale 010B","E01005473","Total",50,11,9,30,6,2,1,3,44,9,8,27
"2011","Rochdale 010C","E01005482","Total",63,16,11,36,10,3,3,4,53,13,8,32
"2011","Rochdale 010D","E01005483","Total",51,10,7,34,10,1,2,7,41,9,5,27
"2011","Rochdale 010E","E01005484","Total",94,15,10,69,7,2,0,5,87,13,10,64
"2011","Rochdale 010F","E01005486","Total",87,13,18,56,13,1,3,9,74,12,15,47
"2011","Rochdale 010G","E01005487","Total",57,17,11,29,6,2,3,1,51,15,8,28
"2011","Rochdale 011A","E01005474","Total",28,13,5,10,1,1,0,0,27,12,5,10
"2011","Rochdale 011B","E01005575","Total",28,12,11,5,0,0,0,0,28,12,11,5
"2011","Rochdale 011C","E01005576","Total",11,3,6,2,3,0,3,0,8,3,3,2
"2011","Rochdale 011D","E01005577","Total",25,12,10,3,3,1,2,0,22,11,8,3
"2011","Rochdale 012A","E01005469","Total",57,17,19,21,1,0,0,1,56,17,19,20
"2011","Rochdale 012B","E01005563","Total",86,16,13,57,2,0,1,1,84,16,12,56
"2011","Rochdale 012C","E01005565","Total",62,18,8,36,4,0,0,4,58,18,8,32
"2011","Rochdale 012D","E01005566","Total",107,42,25,40,3,1,0,2,104,41,25,38
"2011","Rochdale 012E","E01005568","Total",95,21,7,67,12,2,3,7,83,19,4,60
"2011","Rochdale 012F","E01005569","Total",60,17,10,33,4,0,2,2,56,17,8,31
"2011","Rochdale 013A","E01005556","Total",53,22,20,11,3,0,1,2,50,22,19,9
"2011","Rochdale 013B","E01005559","Total",76,24,16,36,4,0,2,2,72,24,14,34
"2011","Rochdale 013C","E01005560","Total",53,23,16,14,6,1,4,1,47,22,12,13
"2011","Rochdale 013D","E01005567","Total",67,27,17,23,6,2,2,2,61,25,15,21
"2011","Rochdale 014A","E01005555","Total",43,13,23,7,5,1,4,0,38,12,19,7
"2011","Rochdale 014B","E01005557","Total",25,11,11,3,3,0,3,0,22,11,8,3
"2011","Rochdale 014C","E01005558","Total",45,13,14,18,1,0,1,0,44,13,13,18
"2011","Rochdale 014D","E01005561","Total",40,13,19,8,4,0,3,1,36,13,16,7
"2011","Rochdale 014E","E01005562","Total",49,19,23,7,5,0,3,2,44,19,20,5
"2011","Rochdale 015A","E01005470","Total",42,4,5,33,4,0,1,3,38,4,4,30
"2011","Rochdale 015B","E01005471","Total",50,8,11,31,4,3,0,1,46,5,11,30
"2011","Rochdale 015C","E01005475","Total",62,23,14,25,8,1,4,3,54,22,10,22
"2011","Rochdale 015D","E01005485","Total",43,12,4,27,3,0,1,2,40,12,3,25
"2011","Rochdale 015E","E01005564","Total",82,20,6,56,7,3,0,4,75,17,6,52
"2011","Rochdale 016A","E01005464","Total",120,32,15,73,14,4,3,7,106,28,12,66
"2011","Rochdale 016B","E01005465","Total",59,14,13,32,6,0,4,2,53,14,9,30
"2011","Rochdale 016C","E01005466","Total",163,50,29,84,24,9,5,10,139,41,24,74
"2011","Rochdale 016D","E01005467","Total",95,30,12,53,5,1,2,2,90,29,10,51
"2011","Rochdale 016E","E01005468","Total",33,10,14,9,3,0,1,2,30,10,13,7
"2011","Rochdale 017A","E01005476","Total",51,14,24,13,6,1,4,1,45,13,20,12
"2011","Rochdale 017B","E01005477","Total",83,24,20,39,8,3,2,3,75,21,18,36
"2011","Rochdale 017C","E01005478","Total",63,19,14,30,4,0,2,2,59,19,12,28
"2011","Rochdale 017D","E01005479","Total",52,11,16,25,2,1,1,0,50,10,15,25
"2011","Rochdale 017E","E01005480","Total",50,17,10,23,5,2,0,3,45,15,10,20
"2011","Rochdale 017F","E01005481","Total",58,21,19,18,5,0,5,0,53,21,14,18
"2011","Rochdale 018A","E01005497","Total",100,29,25,46,6,0,3,3,94,29,22,43
"2011","Rochdale 018B","E01005501","Total",57,17,12,28,4,1,2,1,53,16,10,27
"2011","Rochdale 018C","E01005502","Total",56,20,17,19,6,2,3,1,50,18,14,18
"2011","Rochdale 018D","E01005504","Total",81,33,18,30,5,0,2,3,76,33,16,27
"2011","Rochdale 018E","E01005505","Total",103,41,24,38,11,3,4,4,92,38,20,34
"2011","Rochdale 018F","E01005509","Total",93,18,19,56,11,0,7,4,82,18,12,52
"2011","Rochdale 019A","E01005510","Total",28,4,17,7,6,0,4,2,22,4,13,5
"2011","Rochdale 019B","E01005511","Total",34,12,10,12,1,0,0,1,33,12,10,11
"2011","Rochdale 019C","E01005512","Total",45,11,15,19,1,0,1,0,44,11,14,19
"2011","Rochdale 019D","E01005513","Total",92,21,17,54,6,1,0,5,86,20,17,49
"2011","Rochdale 019E","E01005514","Total",78,25,13,40,9,0,2,7,69,25,11,33
"2011","Rochdale 019F","E01005515","Total",133,46,21,66,13,2,2,9,120,44,19,57
"2011","Rochdale 020A","E01005498","Total",69,19,15,35,4,0,2,2,65,19,13,33
"2011","Rochdale 020B","E01005500","Total",56,24,22,10,8,4,4,0,48,20,18,10
"2011","Rochdale 020C","E01005503","Total",32,11,19,2,9,0,8,1,23,11,11,1
"2011","Rochdale 020D","E01005506","Total",60,10,29,21,8,2,4,2,52,8,25,19
"2011","Rochdale 020E","E01005507","Total",98,26,37,35,9,0,6,3,89,26,31,32
"2011","Rochdale 020F","E01005508","Total",38,9,19,10,4,1,2,1,34,8,17,9
"2011","Rochdale 021A","E01005524","Total",53,13,20,20,4,1,1,2,49,12,19,18
"2011","Rochdale 021B","E01005525","Total",60,14,14,32,4,2,1,1,56,12,13,31
"2011","Rochdale 021C","E01005526","Total",72,15,22,35,5,2,2,1,67,13,20,34
"2011","Rochdale 021D","E01005528","Total",72,23,12,37,7,0,4,3,65,23,8,34
"2011","Rochdale 021E","E01005536","Total",85,23,19,43,3,2,0,1,82,21,19,42
"2011","Rochdale 021F","E01005543","Total",33,13,15,5,2,0,2,0,31,13,13,5
"2011","Rochdale 022A","E01005527","Total",90,22,18,50,7,1,1,5,83,21,17,45
"2011","Rochdale 022B","E01005529","Total",98,38,15,45,9,2,2,5,89,36,13,40
"2011","Rochdale 022C","E01005551","Total",122,35,16,71,7,1,5,1,115,34,11,70
"2011","Rochdale 022D","E01005552","Total",136,44,18,74,12,4,2,6,124,40,16,68
"2011","Rochdale 022E","E01005553","Total",107,28,21,58,9,2,5,2,98,26,16,56
"2011","Rochdale 022F","E01005554","Total",41,11,18,12,3,0,3,0,38,11,15,12
"2011","Rochdale 023A","E01005534","Total",56,10,19,27,8,0,3,5,48,10,16,22
"2011","Rochdale 023B","E01005535","Total",64,22,19,23,3,0,3,0,61,22,16,23
"2011","Rochdale 023C","E01005537","Total",41,13,23,5,5,1,3,1,36,12,20,4
"2011","Rochdale 023D","E01005538","Total",88,34,16,38,0,0,0,0,88,34,16,38
"2011","Rochdale 023E","E01005540","Total",45,10,26,9,5,1,2,2,40,9,24,7
"2011","Rochdale 023F","E01005541","Total",80,26,23,31,4,0,1,3,76,26,22,28
"2011","Rochdale 023G","E01005542","Total",57,24,10,23,5,3,0,2,52,21,10,21
"2011","Rochdale 024A","E01005533","Total",53,16,22,15,4,0,4,0,49,16,18,15
"2011","Rochdale 024B","E01005539","Total",64,20,15,29,6,0,3,3,58,20,12,26
"2011","Rochdale 024C","E01005546","Total",33,7,7,19,2,0,2,0,31,7,5,19
"2011","Rochdale 024D","E01005547","Total",68,22,18,28,9,1,3,5,59,21,15,23
"2011","Rochdale 024E","E01005548","Total",53,19,18,16,3,0,1,2,50,19,17,14
"2011","Rochdale 025A","E01005530","Total",21,9,11,1,2,1,1,0,19,8,10,1
"2011","Rochdale 025B","E01005531","Total",53,18,19,16,5,0,4,1,48,18,15,15
"2011","Rochdale 025C","E01005532","Total",88,21,18,49,4,0,2,2,84,21,16,47
"2011","Rochdale 025D","E01005544","Total",21,5,9,7,2,0,2,0,19,5,7,7
"2011","Rochdale 025E","E01005545","Total",23,7,9,7,1,0,0,1,22,7,9,6
"2011","Rochdale 025F","E01005549","Total",15,4,7,4,1,0,1,0,14,4,6,4
"2011","Rochdale 025G","E01005550","Total",29,10,12,7,3,0,3,0,26,10,9,7
"2011","Salford 001A","E01005659","Total",85,26,22,37,14,1,7,6,71,25,15,31
"2011","Salford 001B","E01005660","Total",101,26,21,54,14,3,3,8,87,23,18,46
"2011","Salford 001C","E01005663","Total",81,19,22,40,12,1,5,6,69,18,17,34
"2011","Salford 001D","E01005664","Total",119,34,16,69,16,2,6,8,103,32,10,61
"2011","Salford 001E","E01005665","Total",124,21,19,84,13,1,5,7,111,20,14,77
"2011","Salford 002A","E01005703","Total",106,21,20,65,14,2,1,11,92,19,19,54
"2011","Salford 002B","E01005704","Total",83,20,27,36,10,0,7,3,73,20,20,33
"2011","Salford 002C","E01005706","Total",112,35,20,57,7,0,2,5,105,35,18,52
"2011","Salford 002D","E01005708","Total",76,18,27,31,7,0,4,3,69,18,23,28
"2011","Salford 003A","E01005702","Total",98,26,36,36,11,3,5,3,87,23,31,33
"2011","Salford 003B","E01005705","Total",89,27,35,27,7,1,3,3,82,26,32,24
"2011","Salford 003C","E01005707","Total",107,29,28,50,4,0,1,3,103,29,27,47
"2011","Salford 004A","E01005661","Total",113,38,20,55,11,1,4,6,102,37,16,49
"2011","Salford 004B","E01005662","Total",95,23,11,61,6,0,0,6,89,23,11,55
"2011","Salford 004C","E01005709","Total",102,14,24,64,7,1,4,2,95,13,20,62
"2011","Salford 004D","E01005710","Total",48,16,16,16,3,1,2,0,45,15,14,16
"2011","Salford 005A","E01005670","Total",104,37,27,40,5,0,4,1,99,37,23,39
"2011","Salford 005B","E01005672","Total",67,19,23,25,7,0,1,6,60,19,22,19
"2011","Salford 005C","E01005676","Total",20,7,9,4,2,0,2,0,18,7,7,4
"2011","Salford 005D","E01005677","Total",65,18,28,19,10,1,7,2,55,17,21,17
"2011","Salford 006A","E01005686","Total",78,24,27,27,12,1,6,5,66,23,21,22
"2011","Salford 006B","E01005688","Total",88,31,22,35,10,5,3,2,78,26,19,33
"2011","Salford 006C","E01005691","Total",44,11,24,9,2,0,2,0,42,11,22,9
"2011","Salford 006D","E01005692","Total",63,16,14,33,4,0,3,1,59,16,11,32
"2011","Salford 007A","E01005711","Total",39,17,9,13,1,0,1,0,38,17,8,13
"2011","Salford 007B","E01005712","Total",70,22,22,26,6,0,2,4,64,22,20,22
"2011","Salford 007C","E01005713","Total",27,5,17,5,4,0,3,1,23,5,14,4
"2011","Salford 007D","E01005714","Total",66,23,14,29,2,0,2,0,64,23,12,29
"2011","Salford 007E","E01005715","Total",32,7,20,5,6,0,6,0,26,7,14,5
"2011","Salford 007F","E01005718","Total",51,13,25,13,3,0,0,3,48,13,25,10
"2011","Salford 008A","E01005673","Total",59,21,16,22,6,0,2,4,53,21,14,18
"2011","Salford 008B","E01005675","Total",78,24,23,31,6,0,3,3,72,24,20,28
"2011","Salford 008C","E01005678","Total",111,31,29,51,8,0,5,3,103,31,24,48
"2011","Salford 008D","E01005679","Total",136,31,25,80,14,3,2,9,122,28,23,71
"2011","Salford 009A","E01005687","Total",89,15,33,41,8,1,6,1,81,14,27,40
"2011","Salford 009B","E01005689","Total",107,28,15,64,12,2,2,8,95,26,13,56
"2011","Salford 009C","E01005690","Total",43,12,20,11,7,1,6,0,36,11,14,11
"2011","Salford 009D","E01005693","Total",47,13,17,17,5,0,4,1,42,13,13,16
"2011","Salford 010A","E01005646","Total",16,10,4,2,2,1,0,1,14,9,4,1
"2011","Salford 010B","E01005649","Total",18,3,4,11,5,0,3,2,13,3,1,9
"2011","Salford 010C","E01005650","Total",22,3,4,15,4,0,2,2,18,3,2,13
"2011","Salford 010D","E01005651","Total",65,11,18,36,15,4,9,2,50,7,9,34
"2011","Salford 011A","E01005647","Total",20,8,4,8,1,1,0,0,19,7,4,8
"2011","Salford 011B","E01005648","Total",44,17,12,15,7,1,3,3,37,16,9,12
"2011","Salford 011C","E01005652","Total",78,24,19,35,10,2,5,3,68,22,14,32
"2011","Salford 011D","E01005653","Total",118,28,15,75,8,1,1,6,110,27,14,69
"2011","Salford 012A","E01005671","Total",75,19,28,28,8,2,5,1,67,17,23,27
"2011","Salford 012B","E01005674","Total",52,20,15,17,2,1,0,1,50,19,15,16
"2011","Salford 012C","E01005694","Total",66,19,28,19,3,0,3,0,63,19,25,19
"2011","Salford 012D","E01005696","Total",53,19,15,19,6,2,2,2,47,17,13,17
"2011","Salford 012E","E01005698","Total",102,25,21,56,8,1,4,3,94,24,17,53
"2011","Salford 012F","E01005700","Total",67,20,24,23,6,2,3,1,61,18,21,22
"2011","Salford 013A","E01005716","Total",38,12,21,5,8,1,6,1,30,11,15,4
"2011","Salford 013B","E01005717","Total",21,6,14,1,3,0,2,1,18,6,12,0
"2011","Salford 013C","E01005734","Total",47,18,21,8,5,0,2,3,42,18,19,5
"2011","Salford 013D","E01005735","Total",33,11,19,3,3,2,1,0,30,9,18,3
"2011","Salford 013E","E01005736","Total",31,14,10,7,3,1,0,2,28,13,10,5
"2011","Salford 013F","E01005737","Total",22,3,11,8,2,0,0,2,20,3,11,6
"2011","Salford 013G","E01005739","Total",44,15,17,12,2,0,1,1,42,15,16,11
"2011","Salford 014A","E01005695","Total",17,6,6,5,2,1,1,0,15,5,5,5
"2011","Salford 014B","E01005697","Total",37,15,14,8,4,0,4,0,33,15,10,8
"2011","Salford 014C","E01005738","Total",29,8,16,5,4,0,2,2,25,8,14,3
"2011","Salford 014D","E01005740","Total",20,6,12,2,2,0,2,0,18,6,10,2
"2011","Salford 014E","E01005741","Total",21,4,14,3,3,0,2,1,18,4,12,2
"2011","Salford 014F","E01005742","Total",53,20,25,8,2,0,2,0,51,20,23,8
"2011","Salford 015A","E01005625","Total",48,16,21,11,6,1,5,0,42,15,16,11
"2011","Salford 015B","E01005627","Total",27,7,13,7,4,0,3,1,23,7,10,6
"2011","Salford 015C","E01005699","Total",40,19,15,6,3,0,2,1,37,19,13,5
"2011","Salford 015D","E01005701","Total",50,21,14,15,4,0,1,3,46,21,13,12
"2011","Salford 016A","E01005609","Total",87,30,12,45,9,2,2,5,78,28,10,40
"2011","Salford 016B","E01005611","Total",104,33,13,58,4,3,1,0,100,30,12,58
"2011","Salford 016C","E01005612","Total",76,25,7,44,0,0,0,0,76,25,7,44
"2011","Salford 016D","E01005613","Total",122,28,25,69,6,1,3,2,116,27,22,67
"2011","Salford 016E","E01005614","Total",45,20,8,17,11,5,2,4,34,15,6,13
"2011","Salford 016F","E01005615","Total",69,21,14,34,5,0,3,2,64,21,11,32
"2011","Salford 017A","E01005624","Total",107,40,20,47,13,2,6,5,94,38,14,42
"2011","Salford 017B","E01005680","Total",85,23,13,49,4,1,0,3,81,22,13,46
"2011","Salford 017C","E01005683","Total",141,39,18,84,10,2,4,4,131,37,14,80
"2011","Salford 017F","E01032919","Total",143,34,15,94,19,3,5,11,124,31,10,83
"2011","Salford 018A","E01005622","Total",64,23,25,16,3,0,3,0,61,23,22,16
"2011","Salford 018B","E01005623","Total",30,13,10,7,2,1,1,0,28,12,9,7
"2011","Salford 018C","E01005626","Total",26,5,14,7,1,1,0,0,25,4,14,7
"2011","Salford 018D","E01005628","Total",35,16,11,8,5,2,2,1,30,14,9,7
"2011","Salford 019A","E01005725","Total",87,19,16,52,9,0,3,6,78,19,13,46
"2011","Salford 019B","E01005726","Total",74,24,21,29,9,0,7,2,65,24,14,27
"2011","Salford 019C","E01005727","Total",64,21,19,24,11,1,4,6,53,20,15,18
"2011","Salford 019D","E01005728","Total",34,18,12,4,3,1,2,0,31,17,10,4
"2011","Salford 019E","E01005733","Total",73,19,15,39,9,1,3,5,64,18,12,34
"2011","Salford 020A","E01005631","Total",19,4,5,10,2,0,1,1,17,4,4,9
"2011","Salford 020B","E01005632","Total",66,21,17,28,4,1,3,0,62,20,14,28
"2011","Salford 020C","E01005633","Total",62,17,23,22,6,1,3,2,56,16,20,20
"2011","Salford 020D","E01005634","Total",29,11,15,3,4,0,4,0,25,11,11,3
"2011","Salford 020E","E01005635","Total",12,1,6,5,1,0,1,0,11,1,5,5
"2011","Salford 020F","E01005636","Total",22,6,10,6,3,0,3,0,19,6,7,6
"2011","Salford 020G","E01005637","Total",47,18,16,13,7,0,3,4,40,18,13,9
"2011","Salford 021A","E01005629","Total",25,6,10,9,3,0,3,0,22,6,7,9
"2011","Salford 021B","E01005630","Total",76,26,30,20,5,0,3,2,71,26,27,18
"2011","Salford 021C","E01005719","Total",44,9,10,25,3,0,0,3,41,9,10,22
"2011","Salford 021D","E01005720","Total",142,46,26,70,12,2,4,6,130,44,22,64
"2011","Salford 021E","E01005722","Total",114,38,20,56,9,3,0,6,105,35,20,50
"2011","Salford 021F","E01005723","Total",97,31,19,47,10,0,4,6,87,31,15,41
"2011","Salford 021G","E01005724","Total",19,3,13,3,2,0,1,1,17,3,12,2
"2011","Salford 022D","E01005610","Total",82,27,7,48,7,0,1,6,75,27,6,42
"2011","Salford 022E","E01032684","Total",32,9,3,20,3,0,0,3,29,9,3,17
"2011","Salford 022F","E01032687","Total",7,1,3,3,0,0,0,0,7,1,3,3
"2011","Salford 022G","E01032906","Total",29,5,6,18,2,0,0,2,27,5,6,16
"2011","Salford 022H","E01032907","Total",45,17,9,19,3,0,0,3,42,17,9,16
"2011","Salford 022I","E01032909","Total",3,0,0,3,0,0,0,0,3,0,0,3
"2011","Salford 022J","E01032911","Total",21,9,0,12,0,0,0,0,21,9,0,12
"2011","Salford 022K","E01033330","Total",52,15,6,31,4,0,0,4,48,15,6,27
"2011","Salford 023A","E01005654","Total",85,17,14,54,7,1,2,4,78,16,12,50
"2011","Salford 023B","E01005656","Total",112,31,17,64,9,0,5,4,103,31,12,60
"2011","Salford 023C","E01005657","Total",64,19,16,29,3,0,0,3,61,19,16,26
"2011","Salford 023D","E01005721","Total",48,19,17,12,5,0,4,1,43,19,13,11
"2011","Salford 024A","E01005655","Total",63,18,5,40,8,3,3,2,55,15,2,38
"2011","Salford 024B","E01005658","Total",130,37,19,74,13,1,3,9,117,36,16,65
"2011","Salford 024C","E01005681","Total",23,2,5,16,0,0,0,0,23,2,5,16
"2011","Salford 024D","E01005682","Total",68,21,7,40,13,4,1,8,55,17,6,32
"2011","Salford 025A","E01005729","Total",96,29,17,50,13,1,1,11,83,28,16,39
"2011","Salford 025B","E01005730","Total",82,27,28,27,8,0,4,4,74,27,24,23
"2011","Salford 025C","E01005731","Total",105,22,16,67,12,0,1,11,93,22,15,56
"2011","Salford 025D","E01005732","Total",56,9,6,41,13,0,4,9,43,9,2,32
"2011","Salford 026A","E01005599","Total",43,12,10,21,5,2,1,2,38,10,9,19
"2011","Salford 026B","E01005600","Total",90,29,23,38,7,0,4,3,83,29,19,35
"2011","Salford 026C","E01005601","Total",98,35,15,48,5,2,1,2,93,33,14,46
"2011","Salford 026D","E01005602","Total",89,20,24,45,9,2,4,3,80,18,20,42
"2011","Salford 027A","E01005603","Total",109,31,31,47,9,1,4,4,100,30,27,43
"2011","Salford 027B","E01005604","Total",92,39,23,30,7,0,6,1,85,39,17,29
"2011","Salford 027C","E01005605","Total",64,15,16,33,1,0,1,0,63,15,15,33
"2011","Salford 027D","E01005638","Total",100,25,28,47,10,0,0,10,90,25,28,37
"2011","Salford 028B","E01005667","Total",116,34,21,61,2,0,1,1,114,34,20,60
"2011","Salford 028E","E01032685","Total",11,4,3,4,1,0,1,0,10,4,2,4
"2011","Salford 028F","E01032686","Total",4,1,2,1,1,1,0,0,3,0,2,1
"2011","Salford 028G","E01032912","Total",89,33,11,45,5,0,1,4,84,33,10,41
"2011","Salford 028H","E01032914","Total",35,12,7,16,2,0,2,0,33,12,5,16
"2011","Salford 028I","E01032915","Total",125,40,16,69,6,1,0,5,119,39,16,64
"2011","Salford 028J","E01032917","Total",35,10,8,17,0,0,0,0,35,10,8,17
"2011","Salford 029A","E01005639","Total",134,34,25,75,16,3,5,8,118,31,20,67
"2011","Salford 029B","E01005640","Total",112,39,21,52,21,4,7,10,91,35,14,42
"2011","Salford 029C","E01005641","Total",59,16,18,25,4,0,2,2,55,16,16,23
"2011","Salford 029D","E01005642","Total",43,15,17,11,5,1,4,0,38,14,13,11
"2011","Salford 029E","E01005643","Total",37,16,14,7,3,2,1,0,34,14,13,7
"2011","Salford 029F","E01005644","Total",42,10,20,12,6,0,5,1,36,10,15,11
"2011","Salford 029G","E01005645","Total",25,11,10,4,3,0,3,0,22,11,7,4
"2011","Salford 030A","E01005616","Total",54,13,13,28,3,1,0,2,51,12,13,26
"2011","Salford 030B","E01005617","Total",56,26,19,11,1,0,1,0,55,26,18,11
"2011","Salford 030C","E01005618","Total",99,35,25,39,4,2,1,1,95,33,24,38
"2011","Salford 030D","E01005619","Total",65,17,13,35,8,1,4,3,57,16,9,32
"2011","Salford 030E","E01005620","Total",104,36,36,32,7,0,6,1,97,36,30,31
"2011","Salford 030F","E01005621","Total",77,28,22,27,10,3,4,3,67,25,18,24
"2011","Stockport 001A","E01005886","Total",103,34,33,36,12,1,3,8,91,33,30,28
"2011","Stockport 001B","E01005888","Total",68,19,17,32,1,0,1,0,67,19,16,32
"2011","Stockport 001C","E01005889","Total",61,15,17,29,8,0,5,3,53,15,12,26
"2011","Stockport 001D","E01005891","Total",32,11,12,9,4,0,3,1,28,11,9,8
"2011","Stockport 001E","E01005894","Total",63,26,25,12,5,0,4,1,58,26,21,11
"2011","Stockport 002A","E01005887","Total",105,30,20,55,11,0,4,7,94,30,16,48
"2011","Stockport 002B","E01005890","Total",76,25,22,29,7,1,5,1,69,24,17,28
"2011","Stockport 002C","E01005893","Total",84,29,24,31,9,1,5,3,75,28,19,28
"2011","Stockport 002D","E01005896","Total",95,28,37,30,8,1,5,2,87,27,32,28
"2011","Stockport 002E","E01005919","Total",125,46,21,58,6,2,1,3,119,44,20,55
"2011","Stockport 003A","E01005862","Total",32,11,15,6,5,0,5,0,27,11,10,6
"2011","Stockport 003B","E01005892","Total",57,16,19,22,3,1,2,0,54,15,17,22
"2011","Stockport 003C","E01005895","Total",49,17,13,19,5,0,2,3,44,17,11,16
"2011","Stockport 003D","E01005920","Total",27,11,8,8,4,0,2,2,23,11,6,6
"2011","Stockport 003E","E01005921","Total",85,28,27,30,12,0,7,5,73,28,20,25
"2011","Stockport 003F","E01005922","Total",45,15,20,10,0,0,0,0,45,15,20,10
"2011","Stockport 004A","E01005753","Total",124,37,14,73,8,1,3,4,116,36,11,69
"2011","Stockport 004B","E01005754","Total",105,35,10,60,9,0,1,8,96,35,9,52
"2011","Stockport 004C","E01005755","Total",114,35,10,69,8,2,0,6,106,33,10,63
"2011","Stockport 004D","E01005756","Total",135,29,18,88,21,2,6,13,114,27,12,75
"2011","Stockport 005A","E01005745","Total",52,20,10,22,4,1,2,1,48,19,8,21
"2011","Stockport 005B","E01005746","Total",28,9,6,13,2,1,1,0,26,8,5,13
"2011","Stockport 005C","E01005747","Total",30,10,16,4,5,0,5,0,25,10,11,4
"2011","Stockport 005D","E01005748","Total",21,8,10,3,3,1,1,1,18,7,9,2
"2011","Stockport 006A","E01005863","Total",22,7,7,8,1,0,1,0,21,7,6,8
"2011","Stockport 006B","E01005864","Total",22,7,7,8,4,1,3,0,18,6,4,8
"2011","Stockport 006C","E01005866","Total",35,7,17,11,4,0,2,2,31,7,15,9
"2011","Stockport 006D","E01005869","Total",25,4,12,9,4,0,2,2,21,4,10,7
"2011","Stockport 007A","E01005914","Total",55,24,16,15,4,0,1,3,51,24,15,12
"2011","Stockport 007B","E01005915","Total",71,28,14,29,6,0,3,3,65,28,11,26
"2011","Stockport 007C","E01005916","Total",73,24,20,29,6,0,3,3,67,24,17,26
"2011","Stockport 007D","E01005917","Total",107,29,27,51,7,3,3,1,100,26,24,50
"2011","Stockport 008A","E01005859","Total",20,4,12,4,7,1,3,3,13,3,9,1
"2011","Stockport 008B","E01005865","Total",19,7,9,3,3,1,2,0,16,6,7,3
"2011","Stockport 008C","E01005867","Total",20,3,15,2,6,1,4,1,14,2,11,1
"2011","Stockport 008D","E01005868","Total",29,3,14,12,4,0,3,1,25,3,11,11
"2011","Stockport 009A","E01005743","Total",40,7,23,10,4,1,2,1,36,6,21,9
"2011","Stockport 009B","E01005744","Total",42,11,12,19,2,0,2,0,40,11,10,19
"2011","Stockport 009C","E01005749","Total",53,14,23,16,4,0,4,0,49,14,19,16
"2011","Stockport 009D","E01005750","Total",63,21,23,19,3,0,3,0,60,21,20,19
"2011","Stockport 009E","E01005751","Total",68,19,23,26,9,1,6,2,59,18,17,24
"2011","Stockport 010A","E01005897","Total",72,31,15,26,7,0,2,5,65,31,13,21
"2011","Stockport 010B","E01005898","Total",48,16,20,12,6,1,5,0,42,15,15,12
"2011","Stockport 010C","E01005900","Total",55,22,16,17,8,1,3,4,47,21,13,13
"2011","Stockport 010D","E01005903","Total",15,8,6,1,4,0,4,0,11,8,2,1
"2011","Stockport 010E","E01005904","Total",26,10,9,7,2,1,1,0,24,9,8,7
"2011","Stockport 011A","E01005853","Total",77,21,20,36,5,0,2,3,72,21,18,33
"2011","Stockport 011B","E01005856","Total",43,14,17,12,8,0,5,3,35,14,12,9
"2011","Stockport 011C","E01005860","Total",29,10,15,4,1,0,1,0,28,10,14,4
"2011","Stockport 011D","E01005861","Total",35,13,14,8,5,1,4,0,30,12,10,8
"2011","Stockport 012A","E01005752","Total",101,34,28,39,16,3,6,7,85,31,22,32
"2011","Stockport 012B","E01005899","Total",54,21,19,14,7,0,5,2,47,21,14,12
"2011","Stockport 012C","E01005901","Total",20,11,8,1,2,0,2,0,18,11,6,1
"2011","Stockport 012D","E01005902","Total",108,32,29,47,17,0,12,5,91,32,17,42
"2011","Stockport 012E","E01005905","Total",94,33,17,44,8,0,2,6,86,33,15,38
"2011","Stockport 013A","E01005852","Total",32,15,11,6,4,1,2,1,28,14,9,5
"2011","Stockport 013B","E01005854","Total",36,18,16,2,7,0,7,0,29,18,9,2
"2011","Stockport 013C","E01005855","Total",27,10,13,4,5,1,3,1,22,9,10,3
"2011","Stockport 013D","E01005857","Total",26,9,13,4,4,1,3,0,22,8,10,4
"2011","Stockport 013E","E01005858","Total",35,7,20,8,2,0,2,0,33,7,18,8
"2011","Stockport 014A","E01005757","Total",74,20,26,28,4,1,2,1,70,19,24,27
"2011","Stockport 014B","E01005758","Total",79,23,15,41,6,2,3,1,73,21,12,40
"2011","Stockport 014C","E01005766","Total",65,17,20,28,10,0,6,4,55,17,14,24
"2011","Stockport 014D","E01005918","Total",97,21,16,60,16,1,4,11,81,20,12,49
"2011","Stockport 015A","E01005870","Total",79,27,23,29,8,0,7,1,71,27,16,28
"2011","Stockport 015B","E01005871","Total",67,24,19,24,8,0,3,5,59,24,16,19
"2011","Stockport 015C","E01005873","Total",39,18,12,9,6,2,3,1,33,16,9,8
"2011","Stockport 015D","E01005875","Total",55,24,19,12,8,2,4,2,47,22,15,10
"2011","Stockport 016A","E01005764","Total",105,43,27,35,11,3,5,3,94,40,22,32
"2011","Stockport 016B","E01005816","Total",102,32,33,37,5,1,2,2,97,31,31,35
"2011","Stockport 016C","E01005817","Total",55,20,14,21,6,2,4,0,49,18,10,21
"2011","Stockport 016D","E01005822","Total",89,21,23,45,13,1,4,8,76,20,19,37
"2011","Stockport 017A","E01005880","Total",36,18,14,4,4,1,3,0,32,17,11,4
"2011","Stockport 017B","E01005881","Total",16,6,8,2,3,0,3,0,13,6,5,2
"2011","Stockport 017C","E01005883","Total",14,3,9,2,3,0,3,0,11,3,6,2
"2011","Stockport 017D","E01005908","Total",14,3,6,5,5,0,3,2,9,3,3,3
"2011","Stockport 018A","E01005765","Total",48,18,23,7,8,2,5,1,40,16,18,6
"2011","Stockport 018B","E01005818","Total",73,22,14,37,7,2,4,1,66,20,10,36
"2011","Stockport 018C","E01005819","Total",30,8,12,10,7,2,4,1,23,6,8,9
"2011","Stockport 018D","E01005820","Total",48,10,14,24,3,0,2,1,45,10,12,23
"2011","Stockport 018E","E01005821","Total",57,18,24,15,5,0,4,1,52,18,20,14
"2011","Stockport 018F","E01005823","Total",64,25,15,24,8,1,5,2,56,24,10,22
"2011","Stockport 019A","E01005825","Total",37,13,15,9,3,0,2,1,34,13,13,8
"2011","Stockport 019B","E01005872","Total",104,33,35,36,7,1,3,3,97,32,32,33
"2011","Stockport 019C","E01005874","Total",77,18,22,37,10,2,4,4,67,16,18,33
"2011","Stockport 019D","E01005876","Total",66,24,28,14,5,0,4,1,61,24,24,13
"2011","Stockport 019E","E01005877","Total",59,21,19,19,5,1,4,0,54,20,15,19
"2011","Stockport 020A","E01005878","Total",59,18,15,26,5,0,2,3,54,18,13,23
"2011","Stockport 020B","E01005879","Total",40,15,15,10,5,0,3,2,35,15,12,8
"2011","Stockport 020C","E01005882","Total",17,5,9,3,0,0,0,0,17,5,9,3
"2011","Stockport 020D","E01005884","Total",31,10,17,4,1,0,1,0,30,10,16,4
"2011","Stockport 020E","E01005885","Total",33,8,17,8,5,0,3,2,28,8,14,6
"2011","Stockport 021A","E01005832","Total",34,14,12,8,4,0,2,2,30,14,10,6
"2011","Stockport 021B","E01005833","Total",20,10,5,5,1,0,0,1,19,10,5,4
"2011","Stockport 021C","E01005835","Total",24,8,10,6,4,1,3,0,20,7,7,6
"2011","Stockport 021D","E01005837","Total",50,17,20,13,4,1,2,1,46,16,18,12
"2011","Stockport 021E","E01005843","Total",30,12,13,5,6,1,3,2,24,11,10,3
"2011","Stockport 022A","E01005769","Total",48,12,18,18,5,0,3,2,43,12,15,16
"2011","Stockport 022B","E01005778","Total",43,23,15,5,5,2,2,1,38,21,13,4
"2011","Stockport 022C","E01005779","Total",40,15,11,14,2,1,1,0,38,14,10,14
"2011","Stockport 022D","E01005780","Total",45,19,17,9,5,3,2,0,40,16,15,9
"2011","Stockport 022E","E01005781","Total",97,33,23,41,9,1,5,3,88,32,18,38
"2011","Stockport 023A","E01005759","Total",61,20,16,25,4,0,3,1,57,20,13,24
"2011","Stockport 023B","E01005760","Total",99,25,30,44,5,0,3,2,94,25,27,42
"2011","Stockport 023C","E01005797","Total",71,35,17,19,10,1,6,3,61,34,11,16
"2011","Stockport 023D","E01005800","Total",46,17,18,11,6,1,4,1,40,16,14,10
"2011","Stockport 023E","E01005804","Total",46,19,9,18,2,1,1,0,44,18,8,18
"2011","Stockport 024A","E01005824","Total",31,11,13,7,4,0,3,1,27,11,10,6
"2011","Stockport 024B","E01005826","Total",82,29,14,39,11,1,3,7,71,28,11,32
"2011","Stockport 024C","E01005827","Total",13,3,7,3,2,0,1,1,11,3,6,2
"2011","Stockport 024D","E01005828","Total",114,39,26,49,15,3,7,5,99,36,19,44
"2011","Stockport 024E","E01005829","Total",66,22,7,37,5,4,0,1,61,18,7,36
"2011","Stockport 025A","E01005768","Total",19,9,6,4,2,0,1,1,17,9,5,3
"2011","Stockport 025B","E01005770","Total",21,7,12,2,4,1,2,1,17,6,10,1
"2011","Stockport 025C","E01005771","Total",33,12,19,2,8,2,5,1,25,10,14,1
"2011","Stockport 025D","E01005775","Total",20,9,8,3,1,0,1,0,19,9,7,3
"2011","Stockport 026A","E01005761","Total",63,18,14,31,7,1,2,4,56,17,12,27
"2011","Stockport 026B","E01005762","Total",137,46,18,73,7,2,2,3,130,44,16,70
"2011","Stockport 026C","E01005763","Total",97,30,15,52,10,1,2,7,87,29,13,45
"2011","Stockport 026D","E01005799","Total",148,49,23,76,14,2,6,6,134,47,17,70
"2011","Stockport 027A","E01005798","Total",36,13,13,10,4,0,3,1,32,13,10,9
"2011","Stockport 027B","E01005801","Total",62,27,21,14,8,2,3,3,54,25,18,11
"2011","Stockport 027C","E01005802","Total",37,10,21,6,3,1,1,1,34,9,20,5
"2011","Stockport 027D","E01005803","Total",25,10,10,5,3,0,3,0,22,10,7,5
"2011","Stockport 027E","E01005830","Total",56,25,18,13,2,0,1,1,54,25,17,12
"2011","Stockport 027F","E01005831","Total",53,24,16,13,6,2,4,0,47,22,12,13
"2011","Stockport 028A","E01005767","Total",15,6,6,3,3,0,2,1,12,6,4,2
"2011","Stockport 028B","E01005772","Total",20,5,5,10,2,0,2,0,18,5,3,10
"2011","Stockport 028C","E01005773","Total",36,16,13,7,1,1,0,0,35,15,13,7
"2011","Stockport 028D","E01005774","Total",42,18,7,17,2,0,2,0,40,18,5,17
"2011","Stockport 028E","E01005776","Total",20,4,10,6,3,0,2,1,17,4,8,5
"2011","Stockport 029A","E01005909","Total",25,11,9,5,5,0,4,1,20,11,5,4
"2011","Stockport 029B","E01005910","Total",55,17,17,21,5,2,1,2,50,15,16,19
"2011","Stockport 029C","E01005911","Total",26,11,12,3,2,0,2,0,24,11,10,3
"2011","Stockport 029D","E01005912","Total",27,12,11,4,2,0,2,0,25,12,9,4
"2011","Stockport 030A","E01005782","Total",17,6,6,5,2,0,2,0,15,6,4,5
"2011","Stockport 030B","E01005783","Total",33,15,8,10,3,1,2,0,30,14,6,10
"2011","Stockport 030C","E01005784","Total",22,6,11,5,3,2,1,0,19,4,10,5
"2011","Stockport 030D","E01005785","Total",27,8,16,3,4,0,4,0,23,8,12,3
"2011","Stockport 030E","E01005786","Total",18,5,8,5,2,0,2,0,16,5,6,5
"2011","Stockport 031A","E01005834","Total",57,25,13,19,6,0,3,3,51,25,10,16
"2011","Stockport 031B","E01005836","Total",41,16,12,13,5,2,3,0,36,14,9,13
"2011","Stockport 031C","E01005838","Total",88,27,38,23,6,0,5,1,82,27,33,22
"2011","Stockport 031D","E01005840","Total",52,17,16,19,2,1,0,1,50,16,16,18
"2011","Stockport 032A","E01005927","Total",28,10,11,7,4,0,2,2,24,10,9,5
"2011","Stockport 032B","E01005928","Total",82,26,33,23,9,2,5,2,73,24,28,21
"2011","Stockport 032C","E01005929","Total",16,5,7,4,1,0,1,0,15,5,6,4
"2011","Stockport 032D","E01005930","Total",13,4,7,2,0,0,0,0,13,4,7,2
"2011","Stockport 033A","E01005806","Total",20,10,7,3,4,1,3,0,16,9,4,3
"2011","Stockport 033B","E01005813","Total",26,8,14,4,2,0,2,0,24,8,12,4
"2011","Stockport 033C","E01005814","Total",16,12,4,0,2,1,1,0,14,11,3,0
"2011","Stockport 033D","E01005815","Total",39,17,16,6,5,1,4,0,34,16,12,6
"2011","Stockport 034A","E01005777","Total",49,17,15,17,1,0,1,0,48,17,14,17
"2011","Stockport 034B","E01005787","Total",9,0,7,2,3,0,2,1,6,0,5,1
"2011","Stockport 034C","E01005788","Total",35,14,16,5,9,3,5,1,26,11,11,4
"2011","Stockport 034D","E01005790","Total",41,15,18,8,4,0,2,2,37,15,16,6
"2011","Stockport 035A","E01005805","Total",21,5,15,1,5,0,5,0,16,5,10,1
"2011","Stockport 035B","E01005807","Total",21,11,10,0,1,0,1,0,20,11,9,0
"2011","Stockport 035C","E01005839","Total",19,9,5,5,3,0,2,1,16,9,3,4
"2011","Stockport 035D","E01005841","Total",43,19,14,10,8,2,4,2,35,17,10,8
"2011","Stockport 036A","E01005844","Total",24,10,9,5,1,0,0,1,23,10,9,4
"2011","Stockport 036B","E01005845","Total",23,9,8,6,2,0,2,0,21,9,6,6
"2011","Stockport 036C","E01005849","Total",16,1,14,1,1,0,1,0,15,1,13,1
"2011","Stockport 036D","E01005851","Total",25,6,15,4,3,0,3,0,22,6,12,4
"2011","Stockport 037A","E01005808","Total",35,15,13,7,6,0,3,3,29,15,10,4
"2011","Stockport 037B","E01005809","Total",34,12,18,4,5,1,4,0,29,11,14,4
"2011","Stockport 037C","E01005810","Total",38,9,20,9,6,1,4,1,32,8,16,8
"2011","Stockport 037D","E01005811","Total",24,7,12,5,0,0,0,0,24,7,12,5
"2011","Stockport 037E","E01005812","Total",13,2,8,3,3,0,3,0,10,2,5,3
"2011","Stockport 038A","E01005842","Total",28,13,7,8,4,1,2,1,24,12,5,7
"2011","Stockport 038B","E01005906","Total",9,1,6,2,0,0,0,0,9,1,6,2
"2011","Stockport 038C","E01005907","Total",18,6,6,6,3,1,1,1,15,5,5,5
"2011","Stockport 038D","E01005913","Total",20,5,9,6,1,1,0,0,19,4,9,6
"2011","Stockport 039A","E01005789","Total",23,9,11,3,4,0,3,1,19,9,8,2
"2011","Stockport 039B","E01005791","Total",35,16,13,6,3,0,2,1,32,16,11,5
"2011","Stockport 039C","E01005793","Total",34,18,11,5,3,0,3,0,31,18,8,5
"2011","Stockport 039D","E01005795","Total",24,9,12,3,0,0,0,0,24,9,12,3
"2011","Stockport 039E","E01005796","Total",31,14,13,4,4,0,4,0,27,14,9,4
"2011","Stockport 040A","E01005846","Total",18,7,7,4,3,1,2,0,15,6,5,4
"2011","Stockport 040B","E01005847","Total",38,4,26,8,4,1,3,0,34,3,23,8
"2011","Stockport 040C","E01005848","Total",39,6,27,6,6,1,5,0,33,5,22,6
"2011","Stockport 040D","E01005850","Total",56,22,12,22,5,1,2,2,51,21,10,20
"2011","Stockport 041A","E01005792","Total",21,7,13,1,2,0,2,0,19,7,11,1
"2011","Stockport 041B","E01005794","Total",24,11,12,1,3,1,2,0,21,10,10,1
"2011","Stockport 041C","E01005923","Total",17,9,7,1,4,2,2,0,13,7,5,1
"2011","Stockport 041D","E01005931","Total",23,7,11,5,5,1,4,0,18,6,7,5
"2011","Stockport 042A","E01005924","Total",24,7,13,4,3,0,3,0,21,7,10,4
"2011","Stockport 042B","E01005925","Total",18,9,5,4,3,1,1,1,15,8,4,3
"2011","Stockport 042C","E01005926","Total",24,9,11,4,0,0,0,0,24,9,11,4
"2011","Stockport 042D","E01005932","Total",19,7,10,2,0,0,0,0,19,7,10,2
"2011","Tameside 001A","E01006053","Total",40,12,17,11,4,1,3,0,36,11,14,11
"2011","Tameside 001B","E01006054","Total",51,12,17,22,6,0,5,1,45,12,12,21
"2011","Tameside 001C","E01006055","Total",37,14,14,9,7,3,3,1,30,11,11,8
"2011","Tameside 001D","E01006057","Total",52,13,18,21,3,0,2,1,49,13,16,20
"2011","Tameside 001E","E01006058","Total",61,22,18,21,8,0,6,2,53,22,12,19
"2011","Tameside 001F","E01006059","Total",36,12,11,13,2,0,2,0,34,12,9,13
"2011","Tameside 002A","E01005938","Total",50,19,11,20,5,0,3,2,45,19,8,18
"2011","Tameside 002B","E01005939","Total",28,4,14,10,3,0,3,0,25,4,11,10
"2011","Tameside 002C","E01005940","Total",26,13,5,8,0,0,0,0,26,13,5,8
"2011","Tameside 002D","E01005955","Total",39,14,20,5,3,1,2,0,36,13,18,5
"2011","Tameside 003A","E01006056","Total",83,22,20,41,10,1,4,5,73,21,16,36
"2011","Tameside 003B","E01006061","Total",120,34,36,50,18,1,6,11,102,33,30,39
"2011","Tameside 003C","E01006062","Total",42,17,17,8,9,3,4,2,33,14,13,6
"2011","Tameside 003D","E01006063","Total",29,13,8,8,2,1,0,1,27,12,8,7
"2011","Tameside 004A","E01005936","Total",35,16,9,10,3,0,3,0,32,16,6,10
"2011","Tameside 004B","E01005937","Total",97,34,25,38,4,0,4,0,93,34,21,38
"2011","Tameside 004C","E01005945","Total",111,29,27,55,12,1,5,6,99,28,22,49
"2011","Tameside 004D","E01005946","Total",64,19,19,26,3,0,3,0,61,19,16,26
"2011","Tameside 004E","E01005947","Total",84,20,20,44,8,0,4,4,76,20,16,40
"2011","Tameside 005A","E01005954","Total",34,14,12,8,5,0,3,2,29,14,9,6
"2011","Tameside 005B","E01005956","Total",26,10,14,2,1,0,1,0,25,10,13,2
"2011","Tameside 005C","E01005957","Total",39,14,13,12,1,1,0,0,38,13,13,12
"2011","Tameside 005D","E01005958","Total",87,24,26,37,5,1,2,2,82,23,24,35
"2011","Tameside 005E","E01005959","Total",104,22,22,60,9,1,5,3,95,21,17,57
"2011","Tameside 006A","E01005933","Total",91,21,13,57,8,0,2,6,83,21,11,51
"2011","Tameside 006B","E01005934","Total",66,17,18,31,9,1,5,3,57,16,13,28
"2011","Tameside 006C","E01005935","Total",93,23,19,51,11,1,6,4,82,22,13,47
"2011","Tameside 006D","E01005949","Total",52,15,16,21,4,1,2,1,48,14,14,20
"2011","Tameside 006E","E01005960","Total",89,32,20,37,6,2,1,3,83,30,19,34
"2011","Tameside 007A","E01005941","Total",66,15,12,39,9,0,5,4,57,15,7,35
"2011","Tameside 007B","E01005942","Total",53,21,23,9,7,0,7,0,46,21,16,9
"2011","Tameside 007C","E01005943","Total",59,14,24,21,6,0,4,2,53,14,20,19
"2011","Tameside 007D","E01005944","Total",27,13,9,5,2,0,2,0,25,13,7,5
"2011","Tameside 008A","E01006060","Total",79,24,16,39,13,3,4,6,66,21,12,33
"2011","Tameside 008B","E01006064","Total",78,27,16,35,12,4,0,8,66,23,16,27
"2011","Tameside 008C","E01006065","Total",95,28,9,58,7,1,2,4,88,27,7,54
"2011","Tameside 008D","E01006066","Total",63,21,13,29,6,1,4,1,57,20,9,28
"2011","Tameside 009A","E01006067","Total",40,14,18,8,3,0,2,1,37,14,16,7
"2011","Tameside 009B","E01006068","Total",49,11,20,18,12,3,8,1,37,8,12,17
"2011","Tameside 009C","E01006069","Total",114,36,24,54,10,2,2,6,104,34,22,48
"2011","Tameside 009D","E01006073","Total",101,28,27,46,12,0,7,5,89,28,20,41
"2011","Tameside 010A","E01005993","Total",31,9,12,10,5,0,2,3,26,9,10,7
"2011","Tameside 010B","E01005995","Total",27,8,12,7,3,0,1,2,24,8,11,5
"2011","Tameside 010C","E01005996","Total",94,31,29,34,15,0,6,9,79,31,23,25
"2011","Tameside 010D","E01005997","Total",54,15,17,22,4,0,1,3,50,15,16,19
"2011","Tameside 010E","E01006000","Total",56,13,18,25,4,0,3,1,52,13,15,24
"2011","Tameside 011A","E01005994","Total",76,28,28,20,5,0,5,0,71,28,23,20
"2011","Tameside 011B","E01005999","Total",109,28,27,54,13,2,7,4,96,26,20,50
"2011","Tameside 011C","E01006002","Total",46,9,13,24,11,0,6,5,35,9,7,19
"2011","Tameside 011D","E01006004","Total",30,9,10,11,1,1,0,0,29,8,10,11
"2011","Tameside 011E","E01006005","Total",84,30,16,38,6,0,2,4,78,30,14,34
"2011","Tameside 011F","E01006007","Total",72,29,23,20,12,3,6,3,60,26,17,17
"2011","Tameside 012A","E01005998","Total",71,32,16,23,4,1,1,2,67,31,15,21
"2011","Tameside 012B","E01006001","Total",61,18,20,23,9,0,5,4,52,18,15,19
"2011","Tameside 012C","E01006003","Total",55,17,20,18,4,1,2,1,51,16,18,17
"2011","Tameside 012D","E01006006","Total",40,11,12,17,6,1,2,3,34,10,10,14
"2011","Tameside 013A","E01005948","Total",60,19,10,31,4,1,1,2,56,18,9,29
"2011","Tameside 013B","E01005950","Total",69,18,14,37,10,3,3,4,59,15,11,33
"2011","Tameside 013C","E01005951","Total",85,24,19,42,4,0,2,2,81,24,17,40
"2011","Tameside 013D","E01005952","Total",85,13,16,56,9,0,4,5,76,13,12,51
"2011","Tameside 013E","E01005953","Total",86,26,17,43,9,1,5,3,77,25,12,40
"2011","Tameside 014A","E01005961","Total",34,11,12,11,3,1,2,0,31,10,10,11
"2011","Tameside 014B","E01005962","Total",31,7,14,10,4,0,4,0,27,7,10,10
"2011","Tameside 014C","E01005968","Total",25,7,10,8,3,0,3,0,22,7,7,8
"2011","Tameside 014D","E01005969","Total",36,9,18,9,4,0,4,0,32,9,14,9
"2011","Tameside 015A","E01006022","Total",31,11,13,7,2,0,1,1,29,11,12,6
"2011","Tameside 015B","E01006023","Total",71,19,29,23,16,1,10,5,55,18,19,18
"2011","Tameside 015C","E01006070","Total",49,20,20,9,5,2,3,0,44,18,17,9
"2011","Tameside 015D","E01006071","Total",11,4,6,1,3,1,2,0,8,3,4,1
"2011","Tameside 015E","E01006072","Total",35,7,23,5,2,0,2,0,33,7,21,5
"2011","Tameside 016A","E01006009","Total",38,9,14,15,3,1,1,1,35,8,13,14
"2011","Tameside 016B","E01006017","Total",18,7,9,2,7,1,4,2,11,6,5,0
"2011","Tameside 016C","E01006018","Total",18,9,6,3,0,0,0,0,18,9,6,3
"2011","Tameside 016D","E01006021","Total",47,18,20,9,4,0,3,1,43,18,17,8
"2011","Tameside 017A","E01006008","Total",77,20,32,25,9,0,7,2,68,20,25,23
"2011","Tameside 017B","E01006010","Total",77,32,18,27,8,2,4,2,69,30,14,25
"2011","Tameside 017C","E01006012","Total",65,23,20,22,8,1,3,4,57,22,17,18
"2011","Tameside 017D","E01006015","Total",27,8,14,5,2,0,2,0,25,8,12,5
"2011","Tameside 017E","E01006016","Total",73,13,19,41,6,0,3,3,67,13,16,38
"2011","Tameside 018A","E01006011","Total",71,18,22,31,6,0,3,3,65,18,19,28
"2011","Tameside 018B","E01006013","Total",33,13,12,8,2,0,1,1,31,13,11,7
"2011","Tameside 018C","E01006014","Total",73,20,18,35,5,0,2,3,68,20,16,32
"2011","Tameside 018D","E01006019","Total",52,12,17,23,7,0,3,4,45,12,14,19
"2011","Tameside 018E","E01006020","Total",63,15,19,29,4,0,2,2,59,15,17,27
"2011","Tameside 019A","E01005963","Total",37,13,12,12,5,0,3,2,32,13,9,10
"2011","Tameside 019B","E01005964","Total",58,24,17,17,2,0,0,2,56,24,17,15
"2011","Tameside 019C","E01005965","Total",82,22,19,41,8,0,2,6,74,22,17,35
"2011","Tameside 019D","E01005966","Total",68,15,26,27,2,0,1,1,66,15,25,26
"2011","Tameside 019E","E01005967","Total",70,25,20,25,4,0,1,3,66,25,19,22
"2011","Tameside 020A","E01006031","Total",70,28,9,33,7,1,1,5,63,27,8,28
"2011","Tameside 020B","E01006032","Total",64,20,18,26,7,1,4,2,57,19,14,24
"2011","Tameside 020C","E01006033","Total",71,19,16,36,3,0,1,2,68,19,15,34
"2011","Tameside 020D","E01006034","Total",104,32,17,55,7,0,2,5,97,32,15,50
"2011","Tameside 020E","E01006035","Total",73,23,25,25,9,0,6,3,64,23,19,22
"2011","Tameside 020F","E01006036","Total",95,23,24,48,6,0,4,2,89,23,20,46
"2011","Tameside 021A","E01005970","Total",16,7,8,1,4,3,1,0,12,4,7,1
"2011","Tameside 021B","E01005972","Total",106,37,26,43,6,2,2,2,100,35,24,41
"2011","Tameside 021C","E01005974","Total",70,25,15,30,7,0,2,5,63,25,13,25
"2011","Tameside 021D","E01005975","Total",74,23,24,27,7,2,3,2,67,21,21,25
"2011","Tameside 022A","E01006024","Total",38,11,20,7,6,0,3,3,32,11,17,4
"2011","Tameside 022B","E01006026","Total",54,19,24,11,3,0,2,1,51,19,22,10
"2011","Tameside 022C","E01006037","Total",29,15,14,0,1,0,1,0,28,15,13,0
"2011","Tameside 022D","E01006038","Total",47,13,17,17,9,0,7,2,38,13,10,15
"2011","Tameside 023A","E01006047","Total",51,22,11,18,5,1,3,1,46,21,8,17
"2011","Tameside 023B","E01006048","Total",30,17,11,2,1,1,0,0,29,16,11,2
"2011","Tameside 023C","E01006049","Total",48,8,17,23,9,0,4,5,39,8,13,18
"2011","Tameside 023D","E01006051","Total",47,10,18,19,5,0,3,2,42,10,15,17
"2011","Tameside 024A","E01005985","Total",31,7,17,7,3,0,2,1,28,7,15,6
"2011","Tameside 024B","E01005987","Total",34,14,17,3,4,1,2,1,30,13,15,2
"2011","Tameside 024C","E01005988","Total",38,13,19,6,3,0,3,0,35,13,16,6
"2011","Tameside 024D","E01005990","Total",38,8,24,6,2,0,2,0,36,8,22,6
"2011","Tameside 024E","E01005991","Total",42,13,19,10,11,3,5,3,31,10,14,7
"2011","Tameside 025A","E01005971","Total",69,21,20,28,6,0,3,3,63,21,17,25
"2011","Tameside 025B","E01005986","Total",59,26,18,15,4,0,4,0,55,26,14,15
"2011","Tameside 025C","E01005989","Total",23,8,12,3,2,0,2,0,21,8,10,3
"2011","Tameside 025D","E01005992","Total",65,23,17,25,4,1,1,2,61,22,16,23
"2011","Tameside 026A","E01005973","Total",43,15,18,10,8,1,6,1,35,14,12,9
"2011","Tameside 026B","E01005976","Total",57,14,15,28,2,0,0,2,55,14,15,26
"2011","Tameside 026C","E01005977","Total",44,17,21,6,5,1,3,1,39,16,18,5
"2011","Tameside 026D","E01005978","Total",84,25,26,33,9,2,5,2,75,23,21,31
"2011","Tameside 027A","E01006025","Total",88,26,12,50,7,2,2,3,81,24,10,47
"2011","Tameside 027B","E01006027","Total",86,23,11,52,9,0,4,5,77,23,7,47
"2011","Tameside 027C","E01006050","Total",134,30,20,84,15,0,2,13,119,30,18,71
"2011","Tameside 027D","E01006052","Total",63,24,12,27,7,0,3,4,56,24,9,23
"2011","Tameside 028A","E01006028","Total",91,23,22,46,14,0,8,6,77,23,14,40
"2011","Tameside 028B","E01006029","Total",71,33,10,28,3,1,1,1,68,32,9,27
"2011","Tameside 028C","E01006030","Total",82,25,24,33,10,1,6,3,72,24,18,30
"2011","Tameside 028D","E01006039","Total",37,10,11,16,3,1,1,1,34,9,10,15
"2011","Tameside 028E","E01006040","Total",50,17,8,25,7,3,2,2,43,14,6,23
"2011","Tameside 028F","E01006041","Total",63,22,21,20,4,0,1,3,59,22,20,17
"2011","Tameside 029A","E01005979","Total",39,12,9,18,2,0,1,1,37,12,8,17
"2011","Tameside 029B","E01005980","Total",88,35,23,30,8,1,5,2,80,34,18,28
"2011","Tameside 029C","E01005981","Total",74,20,25,29,5,0,4,1,69,20,21,28
"2011","Tameside 029D","E01005982","Total",64,17,15,32,6,0,4,2,58,17,11,30
"2011","Tameside 029E","E01005983","Total",38,8,16,14,5,0,5,0,33,8,11,14
"2011","Tameside 029F","E01005984","Total",95,34,19,42,3,0,1,2,92,34,18,40
"2011","Tameside 030A","E01006042","Total",62,17,28,17,7,0,7,0,55,17,21,17
"2011","Tameside 030B","E01006043","Total",58,25,17,16,4,1,3,0,54,24,14,16
"2011","Tameside 030C","E01006044","Total",27,12,11,4,3,0,2,1,24,12,9,3
"2011","Tameside 030D","E01006045","Total",22,6,12,4,4,0,4,0,18,6,8,4
"2011","Tameside 030E","E01006046","Total",24,9,9,6,1,1,0,0,23,8,9,6
"2011","Trafford 001A","E01006109","Total",70,21,8,41,12,4,3,5,58,17,5,36
"2011","Trafford 001B","E01006110","Total",87,27,26,34,3,0,0,3,84,27,26,31
"2011","Trafford 001C","E01006111","Total",95,35,14,46,4,1,1,2,91,34,13,44
"2011","Trafford 001D","E01006112","Total",67,20,15,32,6,2,1,3,61,18,14,29
"2011","Trafford 001E","E01006185","Total",74,22,12,40,1,1,0,0,73,21,12,40
"2011","Trafford 001F","E01006188","Total",49,16,16,17,8,2,2,4,41,14,14,13
"2011","Trafford 002A","E01006116","Total",52,25,20,7,3,0,3,0,49,25,17,7
"2011","Trafford 002B","E01006117","Total",31,13,10,8,2,0,1,1,29,13,9,7
"2011","Trafford 002C","E01006118","Total",44,17,13,14,1,0,0,1,43,17,13,13
"2011","Trafford 002D","E01006119","Total",27,13,10,4,6,2,4,0,21,11,6,4
"2011","Trafford 002E","E01006121","Total",67,28,25,14,3,0,2,1,64,28,23,13
"2011","Trafford 003A","E01006141","Total",66,26,14,26,4,1,2,1,62,25,12,25
"2011","Trafford 003B","E01006186","Total",95,26,25,44,10,0,2,8,85,26,23,36
"2011","Trafford 003C","E01006187","Total",136,51,44,41,20,3,12,5,116,48,32,36
"2011","Trafford 003D","E01006189","Total",110,39,30,41,11,0,4,7,99,39,26,34
"2011","Trafford 004A","E01006113","Total",30,6,12,12,0,0,0,0,30,6,12,12
"2011","Trafford 004B","E01006114","Total",52,12,12,28,6,2,3,1,46,10,9,27
"2011","Trafford 004C","E01006115","Total",43,12,9,22,1,0,1,0,42,12,8,22
"2011","Trafford 004D","E01006145","Total",75,20,12,43,9,0,3,6,66,20,9,37
"2011","Trafford 004E","E01006146","Total",57,8,20,29,8,1,5,2,49,7,15,27
"2011","Trafford 005A","E01006122","Total",29,11,13,5,3,0,2,1,26,11,11,4
"2011","Trafford 005B","E01006123","Total",51,12,19,20,8,0,4,4,43,12,15,16
"2011","Trafford 005C","E01006124","Total",20,4,13,3,3,0,3,0,17,4,10,3
"2011","Trafford 005D","E01006128","Total",40,12,21,7,4,0,4,0,36,12,17,7
"2011","Trafford 005E","E01006131","Total",31,10,13,8,4,0,3,1,27,10,10,7
"2011","Trafford 006A","E01006155","Total",57,33,12,12,2,1,0,1,55,32,12,11
"2011","Trafford 006B","E01006157","Total",49,18,13,18,6,1,2,3,43,17,11,15
"2011","Trafford 006C","E01006159","Total",121,42,25,54,7,2,1,4,114,40,24,50
"2011","Trafford 006D","E01006182","Total",48,15,24,9,3,0,2,1,45,15,22,8
"2011","Trafford 006E","E01006183","Total",28,6,12,10,1,0,1,0,27,6,11,10
"2011","Trafford 007A","E01006125","Total",42,16,16,10,4,0,3,1,38,16,13,9
"2011","Trafford 007B","E01006126","Total",86,20,25,41,13,0,6,7,73,20,19,34
"2011","Trafford 007C","E01006127","Total",49,12,21,16,5,0,3,2,44,12,18,14
"2011","Trafford 007D","E01006130","Total",33,13,14,6,4,3,1,0,29,10,13,6
"2011","Trafford 007E","E01006132","Total",34,11,18,5,1,1,0,0,33,10,18,5
"2011","Trafford 008A","E01006156","Total",71,23,21,27,7,1,4,2,64,22,17,25
"2011","Trafford 008B","E01006158","Total",85,29,23,33,1,0,0,1,84,29,23,32
"2011","Trafford 008C","E01006179","Total",52,19,14,19,7,2,3,2,45,17,11,17
"2011","Trafford 008D","E01006184","Total",73,22,28,23,6,0,4,2,67,22,24,21
"2011","Trafford 009A","E01006198","Total",47,13,20,14,4,0,3,1,43,13,17,13
"2011","Trafford 009B","E01006199","Total",79,34,22,23,5,0,3,2,74,34,19,21
"2011","Trafford 009C","E01006200","Total",31,7,13,11,2,0,2,0,29,7,11,11
"2011","Trafford 009D","E01006201","Total",42,14,17,11,7,0,5,2,35,14,12,9
"2011","Trafford 009E","E01006202","Total",25,10,8,7,3,0,1,2,22,10,7,5
"2011","Trafford 010A","E01006120","Total",18,8,5,5,3,1,1,1,15,7,4,4
"2011","Trafford 010B","E01006129","Total",50,20,21,9,4,0,4,0,46,20,17,9
"2011","Trafford 010C","E01006133","Total",23,7,14,2,2,1,1,0,21,6,13,2
"2011","Trafford 010D","E01006197","Total",49,24,17,8,4,0,3,1,45,24,14,7
"2011","Trafford 010E","E01006203","Total",27,14,12,1,3,1,2,0,24,13,10,1
"2011","Trafford 011A","E01006142","Total",67,13,25,29,6,1,3,2,61,12,22,27
"2011","Trafford 011B","E01006143","Total",39,11,18,10,8,3,5,0,31,8,13,10
"2011","Trafford 011C","E01006144","Total",90,31,12,47,6,1,1,4,84,30,11,43
"2011","Trafford 011D","E01006180","Total",78,22,31,25,5,0,5,0,73,22,26,25
"2011","Trafford 011E","E01006181","Total",51,15,20,16,11,1,6,4,40,14,14,12
"2011","Trafford 012A","E01006147","Total",20,10,8,2,1,0,1,0,19,10,7,2
"2011","Trafford 012B","E01006149","Total",25,7,10,8,0,0,0,0,25,7,10,8
"2011","Trafford 012C","E01006150","Total",19,6,7,6,4,1,1,2,15,5,6,4
"2011","Trafford 012D","E01006154","Total",28,9,18,1,3,0,3,0,25,9,15,1
"2011","Trafford 012E","E01006165","Total",58,20,23,15,6,2,4,0,52,18,19,15
"2011","Trafford 013A","E01006166","Total",73,23,25,25,6,0,4,2,67,23,21,23
"2011","Trafford 013B","E01006169","Total",38,15,8,15,7,5,1,1,31,10,7,14
"2011","Trafford 013C","E01006170","Total",33,11,12,10,3,0,1,2,30,11,11,8
"2011","Trafford 013D","E01006171","Total",97,41,20,36,7,0,3,4,90,41,17,32
"2011","Trafford 014A","E01006098","Total",19,7,10,2,4,0,4,0,15,7,6,2
"2011","Trafford 014B","E01006099","Total",34,8,16,10,6,0,2,4,28,8,14,6
"2011","Trafford 014C","E01006164","Total",27,15,11,1,3,0,3,0,24,15,8,1
"2011","Trafford 014D","E01006174","Total",25,6,15,4,4,0,3,1,21,6,12,3
"2011","Trafford 014E","E01006178","Total",31,14,14,3,6,2,4,0,25,12,10,3
"2011","Trafford 015A","E01006097","Total",28,9,12,7,6,2,3,1,22,7,9,6
"2011","Trafford 015B","E01006160","Total",31,11,9,11,1,0,1,0,30,11,8,11
"2011","Trafford 015C","E01006161","Total",33,14,11,8,2,0,2,0,31,14,9,8
"2011","Trafford 015D","E01006162","Total",19,9,7,3,7,3,3,1,12,6,4,2
"2011","Trafford 015E","E01006163","Total",55,26,15,14,3,0,1,2,52,26,14,12
"2011","Trafford 016A","E01006148","Total",34,10,13,11,3,0,2,1,31,10,11,10
"2011","Trafford 016B","E01006151","Total",11,5,5,1,2,0,1,1,9,5,4,0
"2011","Trafford 016C","E01006152","Total",16,6,5,5,1,0,1,0,15,6,4,5
"2011","Trafford 016D","E01006153","Total",14,4,8,2,0,0,0,0,14,4,8,2
"2011","Trafford 016E","E01006172","Total",18,5,6,7,3,0,1,2,15,5,5,5
"2011","Trafford 017A","E01006104","Total",61,23,10,28,9,2,1,6,52,21,9,22
"2011","Trafford 017B","E01006105","Total",181,41,33,107,25,2,5,18,156,39,28,89
"2011","Trafford 017C","E01006106","Total",97,31,15,51,5,0,2,3,92,31,13,48
"2011","Trafford 017D","E01006107","Total",68,26,14,28,4,1,2,1,64,25,12,27
"2011","Trafford 017E","E01006108","Total",166,52,20,94,10,0,4,6,156,52,16,88
"2011","Trafford 018A","E01006102","Total",39,15,15,9,3,0,3,0,36,15,12,9
"2011","Trafford 018B","E01006173","Total",21,7,11,3,4,0,2,2,17,7,9,1
"2011","Trafford 018C","E01006175","Total",102,28,17,57,3,1,1,1,99,27,16,56
"2011","Trafford 018D","E01006176","Total",63,15,32,16,6,1,5,0,57,14,27,16
"2011","Trafford 018E","E01006177","Total",93,29,18,46,8,1,1,6,85,28,17,40
"2011","Trafford 019A","E01006091","Total",81,20,41,20,5,1,3,1,76,19,38,19
"2011","Trafford 019B","E01006092","Total",94,40,20,34,6,0,5,1,88,40,15,33
"2011","Trafford 019C","E01006095","Total",35,8,21,6,1,0,1,0,34,8,20,6
"2011","Trafford 019D","E01006167","Total",117,43,22,52,8,0,2,6,109,43,20,46
"2011","Trafford 019E","E01006168","Total",175,48,45,82,14,2,7,5,161,46,38,77
"2011","Trafford 020A","E01006090","Total",42,16,18,8,8,0,7,1,34,16,11,7
"2011","Trafford 020B","E01006094","Total",13,5,5,3,1,0,1,0,12,5,4,3
"2011","Trafford 020C","E01006096","Total",27,10,14,3,3,0,2,1,24,10,12,2
"2011","Trafford 020D","E01006100","Total",28,9,13,6,2,0,1,1,26,9,12,5
"2011","Trafford 020E","E01006103","Total",24,9,11,4,3,0,2,1,21,9,9,3
"2011","Trafford 021A","E01006101","Total",11,2,6,3,1,0,1,0,10,2,5,3
"2011","Trafford 021B","E01006190","Total",20,8,10,2,1,0,0,1,19,8,10,1
"2011","Trafford 021C","E01006195","Total",25,7,15,3,1,0,1,0,24,7,14,3
"2011","Trafford 021D","E01006196","Total",32,17,12,3,3,1,2,0,29,16,10,3
"2011","Trafford 021E","E01006210","Total",29,7,9,13,2,1,1,0,27,6,8,13
"2011","Trafford 022A","E01006204","Total",27,12,9,6,3,0,2,1,24,12,7,5
"2011","Trafford 022B","E01006206","Total",85,25,30,30,8,0,5,3,77,25,25,27
"2011","Trafford 022C","E01006207","Total",83,33,17,33,4,0,2,2,79,33,15,31
"2011","Trafford 022D","E01006208","Total",77,31,21,25,5,2,1,2,72,29,20,23
"2011","Trafford 022E","E01006211","Total",58,22,13,23,1,0,1,0,57,22,12,23
"2011","Trafford 023A","E01006093","Total",32,11,14,7,3,0,1,2,29,11,13,5
"2011","Trafford 023B","E01006191","Total",33,12,17,4,1,0,1,0,32,12,16,4
"2011","Trafford 023C","E01006192","Total",25,9,12,4,2,0,2,0,23,9,10,4
"2011","Trafford 023D","E01006205","Total",20,5,13,2,6,0,6,0,14,5,7,2
"2011","Trafford 023E","E01006209","Total",18,8,6,4,1,0,1,0,17,8,5,4
"2011","Trafford 024A","E01006078","Total",48,12,20,16,4,0,3,1,44,12,17,15
"2011","Trafford 024B","E01006080","Total",34,14,13,7,3,0,1,2,31,14,12,5
"2011","Trafford 024C","E01006089","Total",31,8,14,9,3,0,3,0,28,8,11,9
"2011","Trafford 024D","E01006193","Total",36,10,17,9,4,1,3,0,32,9,14,9
"2011","Trafford 024E","E01006194","Total",83,31,34,18,15,4,10,1,68,27,24,17
"2011","Trafford 025A","E01006074","Total",51,28,12,11,6,2,2,2,45,26,10,9
"2011","Trafford 025B","E01006075","Total",28,4,14,10,2,0,1,1,26,4,13,9
"2011","Trafford 025C","E01006076","Total",35,11,17,7,8,5,2,1,27,6,15,6
"2011","Trafford 025D","E01006079","Total",40,10,20,10,5,0,4,1,35,10,16,9
"2011","Trafford 025E","E01006087","Total",20,13,4,3,1,0,1,0,19,13,3,3
"2011","Trafford 026A","E01006083","Total",11,5,4,2,3,1,2,0,8,4,2,2
"2011","Trafford 026B","E01006084","Total",12,1,6,5,0,0,0,0,12,1,6,5
"2011","Trafford 026C","E01006088","Total",34,13,14,7,1,0,1,0,33,13,13,7
"2011","Trafford 026D","E01006139","Total",33,15,14,4,1,0,1,0,32,15,13,4
"2011","Trafford 026E","E01006140","Total",44,18,20,6,6,1,4,1,38,17,16,5
"2011","Trafford 027A","E01006077","Total",35,14,12,9,7,1,4,2,28,13,8,7
"2011","Trafford 027B","E01006081","Total",9,2,5,2,3,0,3,0,6,2,2,2
"2011","Trafford 027C","E01006082","Total",23,7,9,7,1,0,1,0,22,7,8,7
"2011","Trafford 027D","E01006085","Total",27,12,13,2,5,1,4,0,22,11,9,2
"2011","Trafford 027E","E01006086","Total",47,23,9,15,4,0,3,1,43,23,6,14
"2011","Trafford 028A","E01006134","Total",29,12,9,8,6,1,3,2,23,11,6,6
"2011","Trafford 028B","E01006135","Total",27,11,6,10,2,0,1,1,25,11,5,9
"2011","Trafford 028C","E01006136","Total",14,4,8,2,1,0,1,0,13,4,7,2
"2011","Trafford 028D","E01006137","Total",16,7,7,2,3,1,2,0,13,6,5,2
"2011","Trafford 028E","E01006138","Total",39,9,15,15,3,0,2,1,36,9,13,14
"2011","Wigan 001A","E01006315","Total",21,7,8,6,1,0,0,1,20,7,8,5
"2011","Wigan 001B","E01006316","Total",17,6,7,4,1,0,0,1,16,6,7,3
"2011","Wigan 001C","E01006317","Total",57,24,18,15,7,0,5,2,50,24,13,13
"2011","Wigan 001D","E01006319","Total",48,22,15,11,6,2,3,1,42,20,12,10
"2011","Wigan 002A","E01006229","Total",30,17,6,7,0,0,0,0,30,17,6,7
"2011","Wigan 002B","E01006230","Total",28,12,14,2,4,0,4,0,24,12,10,2
"2011","Wigan 002C","E01006233","Total",22,9,10,3,5,1,4,0,17,8,6,3
"2011","Wigan 002D","E01006237","Total",36,7,19,10,5,0,3,2,31,7,16,8
"2011","Wigan 002E","E01006238","Total",82,44,16,22,7,2,5,0,75,42,11,22
"2011","Wigan 003A","E01006259","Total",28,12,2,14,3,2,0,1,25,10,2,13
"2011","Wigan 003B","E01006312","Total",27,10,9,8,4,1,1,2,23,9,8,6
"2011","Wigan 003C","E01006313","Total",40,13,11,16,2,0,0,2,38,13,11,14
"2011","Wigan 003D","E01006314","Total",23,11,9,3,6,3,3,0,17,8,6,3
"2011","Wigan 003E","E01006318","Total",31,15,7,9,4,0,3,1,27,15,4,8
"2011","Wigan 003F","E01006320","Total",22,10,7,5,4,1,3,0,18,9,4,5
"2011","Wigan 003G","E01006321","Total",39,15,14,10,2,0,2,0,37,15,12,10
"2011","Wigan 004A","E01006231","Total",34,7,19,8,4,0,4,0,30,7,15,8
"2011","Wigan 004B","E01006232","Total",25,9,10,6,2,0,2,0,23,9,8,6
"2011","Wigan 004C","E01006234","Total",22,8,1,13,2,0,0,2,20,8,1,11
"2011","Wigan 004D","E01006235","Total",67,24,19,24,6,0,3,3,61,24,16,21
"2011","Wigan 005A","E01006253","Total",57,21,11,25,7,1,3,3,50,20,8,22
"2011","Wigan 005B","E01006254","Total",121,43,28,50,18,4,8,6,103,39,20,44
"2011","Wigan 005C","E01006255","Total",34,12,15,7,8,1,6,1,26,11,9,6
"2011","Wigan 005D","E01006256","Total",42,13,17,12,4,1,2,1,38,12,15,11
"2011","Wigan 005E","E01006260","Total",69,22,21,26,10,0,5,5,59,22,16,21
"2011","Wigan 006A","E01006370","Total",35,13,8,14,4,0,3,1,31,13,5,13
"2011","Wigan 006B","E01006372","Total",18,4,13,1,3,0,3,0,15,4,10,1
"2011","Wigan 006C","E01006373","Total",28,6,15,7,3,0,3,0,25,6,12,7
"2011","Wigan 006D","E01006374","Total",18,6,10,2,3,0,2,1,15,6,8,1
"2011","Wigan 006E","E01006390","Total",47,19,10,18,6,0,3,3,41,19,7,15
"2011","Wigan 007A","E01006236","Total",25,10,12,3,4,1,3,0,21,9,9,3
"2011","Wigan 007B","E01006388","Total",53,21,14,18,6,2,4,0,47,19,10,18
"2011","Wigan 007C","E01006389","Total",55,15,19,21,5,2,2,1,50,13,17,20
"2011","Wigan 007D","E01006391","Total",26,10,9,7,3,3,0,0,23,7,9,7
"2011","Wigan 008A","E01006257","Total",38,15,11,12,4,0,1,3,34,15,10,9
"2011","Wigan 008B","E01006258","Total",58,21,18,19,10,2,7,1,48,19,11,18
"2011","Wigan 008C","E01006369","Total",71,25,16,30,5,0,4,1,66,25,12,29
"2011","Wigan 008D","E01006371","Total",43,13,20,10,5,0,5,0,38,13,15,10
"2011","Wigan 008E","E01006375","Total",31,8,15,8,6,1,3,2,25,7,12,6
"2011","Wigan 009A","E01006306","Total",52,21,7,24,5,0,2,3,47,21,5,21
"2011","Wigan 009B","E01006307","Total",64,18,14,32,6,0,2,4,58,18,12,28
"2011","Wigan 009C","E01006386","Total",44,11,4,29,10,3,3,4,34,8,1,25
"2011","Wigan 009D","E01006387","Total",47,15,13,19,4,0,4,0,43,15,9,19
"2011","Wigan 009E","E01006392","Total",78,24,9,45,6,0,2,4,72,24,7,41
"2011","Wigan 010A","E01006350","Total",115,35,16,64,19,6,3,10,96,29,13,54
"2011","Wigan 010B","E01006351","Total",173,59,15,99,14,2,3,9,159,57,12,90
"2011","Wigan 010C","E01006357","Total",87,15,8,64,8,0,0,8,79,15,8,56
"2011","Wigan 010D","E01006360","Total",115,25,16,74,14,3,3,8,101,22,13,66
"2011","Wigan 010E","E01006361","Total",93,23,9,61,8,2,3,3,85,21,6,58
"2011","Wigan 011A","E01006356","Total",63,22,10,31,3,0,0,3,60,22,10,28
"2011","Wigan 011B","E01006396","Total",32,10,16,6,3,0,2,1,29,10,14,5
"2011","Wigan 011C","E01006397","Total",36,12,9,15,7,1,4,2,29,11,5,13
"2011","Wigan 011D","E01006398","Total",39,17,5,17,3,1,2,0,36,16,3,17
"2011","Wigan 011E","E01006399","Total",59,20,20,19,8,0,5,3,51,20,15,16
"2011","Wigan 012A","E01006305","Total",94,13,20,61,13,1,3,9,81,12,17,52
"2011","Wigan 012B","E01006308","Total",68,22,14,32,10,0,1,9,58,22,13,23
"2011","Wigan 012C","E01006309","Total",82,17,19,46,17,0,8,9,65,17,11,37
"2011","Wigan 012D","E01006310","Total",87,26,13,48,6,1,4,1,81,25,9,47
"2011","Wigan 012E","E01006311","Total",86,19,19,48,7,0,4,3,79,19,15,45
"2011","Wigan 013A","E01006269","Total",56,15,19,22,11,1,5,5,45,14,14,17
"2011","Wigan 013B","E01006271","Total",44,15,13,16,4,0,2,2,40,15,11,14
"2011","Wigan 013C","E01006272","Total",52,18,15,19,1,0,0,1,51,18,15,18
"2011","Wigan 013D","E01006273","Total",75,24,15,36,4,0,1,3,71,24,14,33
"2011","Wigan 013E","E01006276","Total",72,19,32,21,13,0,11,2,59,19,21,19
"2011","Wigan 014A","E01006353","Total",46,15,15,16,7,0,6,1,39,15,9,15
"2011","Wigan 014B","E01006354","Total",51,11,10,30,4,0,1,3,47,11,9,27
"2011","Wigan 014C","E01006355","Total",47,18,10,19,1,0,0,1,46,18,10,18
"2011","Wigan 014D","E01006358","Total",74,23,21,30,6,2,3,1,68,21,18,29
"2011","Wigan 014E","E01006359","Total",66,19,17,30,11,0,5,6,55,19,12,24
"2011","Wigan 015A","E01006349","Total",57,16,25,16,9,2,5,2,48,14,20,14
"2011","Wigan 015B","E01006352","Total",55,17,12,26,3,0,2,1,52,17,10,25
"2011","Wigan 015C","E01006404","Total",71,26,16,29,10,0,4,6,61,26,12,23
"2011","Wigan 015D","E01006405","Total",60,19,7,34,4,1,1,2,56,18,6,32
"2011","Wigan 015E","E01006411","Total",97,18,15,64,14,0,3,11,83,18,12,53
"2011","Wigan 016A","E01006270","Total",40,8,13,19,4,0,4,0,36,8,9,19
"2011","Wigan 016B","E01006274","Total",77,25,14,38,4,1,2,1,73,24,12,37
"2011","Wigan 016C","E01006275","Total",91,21,18,52,9,2,3,4,82,19,15,48
"2011","Wigan 016D","E01006277","Total",46,16,19,11,9,1,6,2,37,15,13,9
"2011","Wigan 016E","E01006286","Total",23,8,10,5,2,1,0,1,21,7,10,4
"2011","Wigan 017A","E01006239","Total",77,17,21,39,3,1,2,0,74,16,19,39
"2011","Wigan 017B","E01006240","Total",114,39,8,67,16,2,1,13,98,37,7,54
"2011","Wigan 017C","E01006241","Total",112,29,18,65,14,3,5,6,98,26,13,59
"2011","Wigan 017D","E01006287","Total",24,8,13,3,3,0,3,0,21,8,10,3
"2011","Wigan 017E","E01006289","Total",108,39,22,47,5,0,4,1,103,39,18,46
"2011","Wigan 018A","E01006362","Total",29,15,9,5,1,0,0,1,28,15,9,4
"2011","Wigan 018B","E01006363","Total",30,6,19,5,6,2,3,1,24,4,16,4
"2011","Wigan 018C","E01006364","Total",66,27,24,15,5,0,3,2,61,27,21,13
"2011","Wigan 018D","E01006365","Total",62,18,31,13,6,0,6,0,56,18,25,13
"2011","Wigan 018E","E01006366","Total",36,14,12,10,5,0,3,2,31,14,9,8
"2011","Wigan 018F","E01006367","Total",22,10,9,3,3,0,2,1,19,10,7,2
"2011","Wigan 018G","E01006368","Total",50,14,16,20,2,0,2,0,48,14,14,20
"2011","Wigan 019A","E01006278","Total",48,18,15,15,3,1,1,1,45,17,14,14
"2011","Wigan 019B","E01006279","Total",33,10,16,7,3,0,2,1,30,10,14,6
"2011","Wigan 019C","E01006280","Total",46,19,11,16,6,1,1,4,40,18,10,12
"2011","Wigan 019D","E01006281","Total",44,16,18,10,3,0,3,0,41,16,15,10
"2011","Wigan 019E","E01006285","Total",27,11,12,4,1,0,1,0,26,11,11,4
"2011","Wigan 020A","E01006406","Total",24,9,12,3,1,0,1,0,23,9,11,3
"2011","Wigan 020B","E01006407","Total",27,15,8,4,0,0,0,0,27,15,8,4
"2011","Wigan 020C","E01006408","Total",72,26,11,35,4,1,2,1,68,25,9,34
"2011","Wigan 020D","E01006409","Total",23,11,9,3,2,0,2,0,21,11,7,3
"2011","Wigan 020E","E01006410","Total",23,8,14,1,4,0,4,0,19,8,10,1
"2011","Wigan 021A","E01006393","Total",33,9,19,5,1,1,0,0,32,8,19,5
"2011","Wigan 021B","E01006394","Total",28,10,14,4,3,0,2,1,25,10,12,3
"2011","Wigan 021C","E01006395","Total",51,18,31,2,9,1,8,0,42,17,23,2
"2011","Wigan 021D","E01006400","Total",38,16,15,7,2,0,2,0,36,16,13,7
"2011","Wigan 021E","E01006401","Total",19,10,6,3,1,0,1,0,18,10,5,3
"2011","Wigan 021F","E01006402","Total",19,8,9,2,2,0,2,0,17,8,7,2
"2011","Wigan 021G","E01006403","Total",33,14,14,5,3,1,1,1,30,13,13,4
"2011","Wigan 022A","E01006290","Total",32,12,14,6,5,1,1,3,27,11,13,3
"2011","Wigan 022B","E01006291","Total",57,23,16,18,8,3,4,1,49,20,12,17
"2011","Wigan 022C","E01006292","Total",46,11,20,15,6,1,1,4,40,10,19,11
"2011","Wigan 022D","E01006293","Total",65,24,18,23,7,1,0,6,58,23,18,17
"2011","Wigan 023A","E01006242","Total",38,11,15,12,8,2,5,1,30,9,10,11
"2011","Wigan 023B","E01006243","Total",44,17,16,11,2,0,1,1,42,17,15,10
"2011","Wigan 023C","E01006244","Total",70,32,13,25,8,1,3,4,62,31,10,21
"2011","Wigan 023D","E01006245","Total",107,42,44,21,18,4,8,6,89,38,36,15
"2011","Wigan 024A","E01006213","Total",99,26,27,46,13,0,10,3,86,26,17,43
"2011","Wigan 024B","E01006215","Total",89,22,17,50,14,1,3,10,75,21,14,40
"2011","Wigan 024C","E01006217","Total",87,24,21,42,10,3,1,6,77,21,20,36
"2011","Wigan 024D","E01006218","Total",95,31,17,47,2,1,0,1,93,30,17,46
"2011","Wigan 024E","E01006219","Total",45,16,8,21,8,0,4,4,37,16,4,17
"2011","Wigan 025A","E01006288","Total",117,40,12,65,16,2,5,9,101,38,7,56
"2011","Wigan 025B","E01006294","Total",115,32,46,37,13,1,9,3,102,31,37,34
"2011","Wigan 025C","E01006295","Total",70,20,24,26,7,0,5,2,63,20,19,24
"2011","Wigan 025D","E01006377","Total",37,12,17,8,4,0,4,0,33,12,13,8
"2011","Wigan 025E","E01006378","Total",21,6,12,3,4,0,3,1,17,6,9,2
"2011","Wigan 026A","E01006212","Total",32,10,12,10,4,1,2,1,28,9,10,9
"2011","Wigan 026B","E01006214","Total",77,18,19,40,12,0,9,3,65,18,10,37
"2011","Wigan 026C","E01006216","Total",75,27,23,25,5,1,4,0,70,26,19,25
"2011","Wigan 026D","E01006322","Total",65,21,14,30,9,2,4,3,56,19,10,27
"2011","Wigan 026E","E01006329","Total",44,8,11,25,9,0,4,5,35,8,7,20
"2011","Wigan 027A","E01006282","Total",50,16,16,18,4,0,2,2,46,16,14,16
"2011","Wigan 027B","E01006283","Total",95,30,18,47,9,4,2,3,86,26,16,44
"2011","Wigan 027C","E01006284","Total",58,17,13,28,4,0,1,3,54,17,12,25
"2011","Wigan 027D","E01006336","Total",108,23,21,64,9,2,1,6,99,21,20,58
"2011","Wigan 027E","E01006337","Total",45,11,17,17,4,0,2,2,41,11,15,15
"2011","Wigan 028A","E01006376","Total",86,29,25,32,11,0,5,6,75,29,20,26
"2011","Wigan 028B","E01006381","Total",57,22,27,8,8,2,5,1,49,20,22,7
"2011","Wigan 028C","E01006382","Total",27,10,15,2,2,0,2,0,25,10,13,2
"2011","Wigan 028D","E01006383","Total",39,8,19,12,10,2,5,3,29,6,14,9
"2011","Wigan 028E","E01006384","Total",27,7,14,6,3,0,3,0,24,7,11,6
"2011","Wigan 029A","E01006250","Total",28,8,15,5,11,1,8,2,17,7,7,3
"2011","Wigan 029B","E01006251","Total",34,13,18,3,3,0,3,0,31,13,15,3
"2011","Wigan 029C","E01006379","Total",50,18,21,11,6,1,5,0,44,17,16,11
"2011","Wigan 029D","E01006380","Total",77,20,23,34,8,1,6,1,69,19,17,33
"2011","Wigan 029E","E01006385","Total",25,6,15,4,3,1,2,0,22,5,13,4
"2011","Wigan 030A","E01006328","Total",57,20,14,23,4,0,2,2,53,20,12,21
"2011","Wigan 030B","E01006333","Total",75,23,23,29,9,3,3,3,66,20,20,26
"2011","Wigan 030C","E01006334","Total",83,21,17,45,15,1,9,5,68,20,8,40
"2011","Wigan 030D","E01006338","Total",64,15,23,26,11,3,7,1,53,12,16,25
"2011","Wigan 031A","E01006248","Total",68,20,10,38,7,2,4,1,61,18,6,37
"2011","Wigan 031B","E01006249","Total",89,35,15,39,8,0,1,7,81,35,14,32
"2011","Wigan 031C","E01006330","Total",24,12,6,6,5,1,1,3,19,11,5,3
"2011","Wigan 031D","E01006331","Total",30,13,14,3,4,0,3,1,26,13,11,2
"2011","Wigan 031E","E01006332","Total",57,20,25,12,9,1,7,1,48,19,18,11
"2011","Wigan 032A","E01006262","Total",59,16,17,26,11,1,2,8,48,15,15,18
"2011","Wigan 032B","E01006263","Total",16,3,11,2,4,0,3,1,12,3,8,1
"2011","Wigan 032C","E01006266","Total",30,10,16,4,3,0,2,1,27,10,14,3
"2011","Wigan 032D","E01006267","Total",89,32,21,36,5,1,1,3,84,31,20,33
"2011","Wigan 032E","E01006268","Total",62,24,18,20,5,1,3,1,57,23,15,19
"2011","Wigan 033A","E01006323","Total",76,23,13,40,11,3,2,6,65,20,11,34
"2011","Wigan 033B","E01006324","Total",65,20,9,36,7,1,4,2,58,19,5,34
"2011","Wigan 033C","E01006325","Total",61,19,20,22,13,1,8,4,48,18,12,18
"2011","Wigan 033D","E01006326","Total",65,23,22,20,12,0,7,5,53,23,15,15
"2011","Wigan 033E","E01006327","Total",68,13,20,35,7,0,2,5,61,13,18,30
"2011","Wigan 034A","E01006246","Total",64,24,15,25,9,0,4,5,55,24,11,20
"2011","Wigan 034B","E01006247","Total",23,8,13,2,3,0,3,0,20,8,10,2
"2011","Wigan 034C","E01006252","Total",30,11,14,5,0,0,0,0,30,11,14,5
"2011","Wigan 034D","E01006297","Total",110,45,29,36,9,1,3,5,101,44,26,31
"2011","Wigan 034E","E01006335","Total",93,33,32,28,6,0,5,1,87,33,27,27
"2011","Wigan 035A","E01006220","Total",69,14,19,36,8,1,3,4,61,13,16,32
"2011","Wigan 035B","E01006221","Total",59,15,26,18,6,0,5,1,53,15,21,17
"2011","Wigan 035C","E01006222","Total",28,6,20,2,4,0,4,0,24,6,16,2
"2011","Wigan 035D","E01006224","Total",49,16,28,5,4,1,3,0,45,15,25,5
"2011","Wigan 035E","E01006226","Total",53,14,28,11,3,1,2,0,50,13,26,11
"2011","Wigan 036A","E01006223","Total",64,20,27,17,10,0,6,4,54,20,21,13
"2011","Wigan 036B","E01006225","Total",44,15,18,11,4,0,4,0,40,15,14,11
"2011","Wigan 036C","E01006261","Total",47,19,17,11,4,0,3,1,43,19,14,10
"2011","Wigan 036D","E01006264","Total",20,7,11,2,1,0,1,0,19,7,10,2
"2011","Wigan 036E","E01006265","Total",56,21,18,17,8,1,3,4,48,20,15,13
"2011","Wigan 037A","E01006296","Total",114,29,24,61,13,1,3,9,101,28,21,52
"2011","Wigan 037B","E01006298","Total",76,21,20,35,8,3,0,5,68,18,20,30
"2011","Wigan 037C","E01006299","Total",48,11,28,9,6,0,6,0,42,11,22,9
"2011","Wigan 037D","E01006300","Total",13,3,7,3,3,0,2,1,10,3,5,2
"2011","Wigan 037E","E01006301","Total",21,8,10,3,6,0,4,2,15,8,6,1
"2011","Wigan 038A","E01006227","Total",32,16,11,5,2,0,2,0,30,16,9,5
"2011","Wigan 038B","E01006228","Total",77,13,28,36,9,2,6,1,68,11,22,35
"2011","Wigan 038C","E01006342","Total",65,29,17,19,8,1,5,2,57,28,12,17
"2011","Wigan 038D","E01006344","Total",76,25,12,39,3,1,0,2,73,24,12,37
"2011","Wigan 038E","E01006346","Total",80,34,21,25,7,2,5,0,73,32,16,25
"2011","Wigan 039A","E01006339","Total",18,5,10,3,3,0,3,0,15,5,7,3
"2011","Wigan 039B","E01006340","Total",59,24,6,29,7,0,3,4,52,24,3,25
"2011","Wigan 039C","E01006343","Total",41,16,16,9,3,1,2,0,38,15,14,9
"2011","Wigan 039D","E01006345","Total",45,18,17,10,5,0,4,1,40,18,13,9
"2011","Wigan 039E","E01006348","Total",23,7,15,1,5,0,5,0,18,7,10,1
"2011","Wigan 040A","E01006302","Total",40,9,22,9,6,1,4,1,34,8,18,8
"2011","Wigan 040B","E01006303","Total",42,12,28,2,9,1,8,0,33,11,20,2
"2011","Wigan 040C","E01006304","Total",56,21,17,18,5,0,2,3,51,21,15,15
"2011","Wigan 040D","E01006341","Total",68,15,27,26,10,0,9,1,58,15,18,25
"2011","Wigan 040E","E01006347","Total",24,6,15,3,5,0,5,0,19,6,10,3
"2011","Burnley 001A","E01024859","Total",74,30,32,12,9,1,6,2,65,29,26,10
"2011","Burnley 001B","E01024861","Total",29,15,11,3,3,0,3,0,26,15,8,3
"2011","Burnley 001C","E01024862","Total",35,16,9,10,2,0,2,0,33,16,7,10
"2011","Burnley 001D","E01024891","Total",65,23,15,27,3,1,1,1,62,22,14,26
"2011","Burnley 001E","E01024892","Total",38,13,13,12,5,2,2,1,33,11,11,11
"2011","Burnley 001F","E01024894","Total",42,17,13,12,3,0,3,0,39,17,10,12
"2011","Burnley 002A","E01024893","Total",51,20,11,20,4,0,3,1,47,20,8,19
"2011","Burnley 002B","E01024896","Total",29,9,8,12,0,0,0,0,29,9,8,12
"2011","Burnley 002C","E01024897","Total",36,19,9,8,3,1,1,1,33,18,8,7
"2011","Burnley 002D","E01024898","Total",88,21,9,58,10,1,3,6,78,20,6,52
"2011","Burnley 003A","E01024856","Total",64,18,10,36,5,1,2,2,59,17,8,34
"2011","Burnley 003B","E01024875","Total",30,7,3,20,2,0,1,1,28,7,2,19
"2011","Burnley 003C","E01024876","Total",29,8,1,20,3,1,0,2,26,7,1,18
"2011","Burnley 003D","E01024877","Total",42,6,5,31,8,0,5,3,34,6,0,28
"2011","Burnley 003E","E01024878","Total",32,9,4,19,6,2,2,2,26,7,2,17
"2011","Burnley 003F","E01024895","Total",69,18,15,36,8,0,5,3,61,18,10,33
"2011","Burnley 004A","E01024883","Total",66,24,13,29,7,0,4,3,59,24,9,26
"2011","Burnley 004B","E01024884","Total",62,12,20,30,9,3,4,2,53,9,16,28
"2011","Burnley 004C","E01024885","Total",89,30,21,38,5,1,3,1,84,29,18,37
"2011","Burnley 004D","E01024886","Total",75,26,13,36,10,1,6,3,65,25,7,33
"2011","Burnley 004E","E01024889","Total",33,11,7,15,1,1,0,0,32,10,7,15
"2011","Burnley 004F","E01024890","Total",86,27,16,43,9,1,2,6,77,26,14,37
"2011","Burnley 005A","E01024879","Total",71,28,17,26,8,2,3,3,63,26,14,23
"2011","Burnley 005B","E01024880","Total",55,21,15,19,5,0,2,3,50,21,13,16
"2011","Burnley 005C","E01024912","Total",18,8,7,3,2,1,1,0,16,7,6,3
"2011","Burnley 005D","E01024913","Total",37,15,17,5,4,0,4,0,33,15,13,5
"2011","Burnley 005E","E01024914","Total",25,14,10,1,5,3,2,0,20,11,8,1
"2011","Burnley 006A","E01024881","Total",73,22,24,27,7,2,3,2,66,20,21,25
"2011","Burnley 006B","E01024882","Total",82,16,24,42,10,1,9,0,72,15,15,42
"2011","Burnley 006C","E01024902","Total",73,34,21,18,5,1,3,1,68,33,18,17
"2011","Burnley 006D","E01024911","Total",62,18,16,28,8,0,5,3,54,18,11,25
"2011","Burnley 007A","E01024855","Total",67,25,14,28,6,1,4,1,61,24,10,27
"2011","Burnley 007B","E01024857","Total",45,15,10,20,8,1,3,4,37,14,7,16
"2011","Burnley 007C","E01024858","Total",70,20,12,38,6,0,0,6,64,20,12,32
"2011","Burnley 007D","E01024864","Total",70,23,23,24,8,0,5,3,62,23,18,21
"2011","Burnley 008A","E01024863","Total",78,26,17,35,7,0,2,5,71,26,15,30
"2011","Burnley 008B","E01024865","Total",58,24,13,21,3,2,1,0,55,22,12,21
"2011","Burnley 008C","E01024866","Total",61,23,17,21,2,2,0,0,59,21,17,21
"2011","Burnley 008D","E01024867","Total",17,8,7,2,0,0,0,0,17,8,7,2
"2011","Burnley 009A","E01024860","Total",23,8,9,6,3,0,2,1,20,8,7,5
"2011","Burnley 009B","E01024868","Total",34,11,12,11,2,0,2,0,32,11,10,11
"2011","Burnley 009C","E01024869","Total",20,7,8,5,4,0,4,0,16,7,4,5
"2011","Burnley 009D","E01024870","Total",18,3,10,5,1,0,1,0,17,3,9,5
"2011","Burnley 010A","E01024872","Total",100,35,13,52,6,1,2,3,94,34,11,49
"2011","Burnley 010B","E01024899","Total",97,26,18,53,11,2,2,7,86,24,16,46
"2011","Burnley 010C","E01024900","Total",101,31,9,61,4,1,1,2,97,30,8,59
"2011","Burnley 010D","E01024907","Total",53,17,9,27,6,3,0,3,47,14,9,24
"2011","Burnley 010E","E01024908","Total",65,16,10,39,6,0,4,2,59,16,6,37
"2011","Burnley 010F","E01024909","Total",59,12,13,34,6,1,2,3,53,11,11,31
"2011","Burnley 011A","E01024874","Total",11,4,5,2,0,0,0,0,11,4,5,2
"2011","Burnley 011B","E01024887","Total",52,18,14,20,4,2,2,0,48,16,12,20
"2011","Burnley 011C","E01024888","Total",46,17,20,9,11,0,9,2,35,17,11,7
"2011","Burnley 011D","E01024901","Total",54,27,20,7,6,0,6,0,48,27,14,7
"2011","Burnley 014D","E01024871","Total",29,10,11,8,2,1,1,0,27,9,10,8
"2011","Burnley 014E","E01024873","Total",38,17,9,12,4,0,4,0,34,17,5,12
"2011","Burnley 014F","E01024903","Total",75,33,12,30,9,2,1,6,66,31,11,24
"2011","Burnley 014A","E01024904","Total",61,22,13,26,5,0,5,0,56,22,8,26
"2011","Burnley 014G","E01024905","Total",16,6,6,4,3,1,2,0,13,5,4,4
"2011","Burnley 014B","E01024906","Total",85,21,13,51,8,0,5,3,77,21,8,48
"2011","Burnley 014C","E01024910","Total",62,23,6,33,3,0,1,2,59,23,5,31
"2011","Chorley 001A","E01024951","Total",67,18,12,37,10,1,3,6,57,17,9,31
"2011","Chorley 001B","E01024952","Total",34,11,9,14,0,0,0,0,34,11,9,14
"2011","Chorley 001C","E01024953","Total",87,37,12,38,6,1,1,4,81,36,11,34
"2011","Chorley 001D","E01024954","Total",38,9,15,14,7,1,5,1,31,8,10,13
"2011","Chorley 002A","E01024921","Total",38,16,16,6,3,1,2,0,35,15,14,6
"2011","Chorley 002B","E01024978","Total",47,22,18,7,2,0,2,0,45,22,16,7
"2011","Chorley 002C","E01024979","Total",30,11,14,5,4,0,4,0,26,11,10,5
"2011","Chorley 002D","E01024980","Total",30,9,14,7,5,0,4,1,25,9,10,6
"2011","Chorley 003A","E01024946","Total",23,5,10,8,2,0,1,1,21,5,9,7
"2011","Chorley 003B","E01024947","Total",21,7,12,2,1,0,1,0,20,7,11,2
"2011","Chorley 003C","E01024955","Total",35,12,17,6,6,1,5,0,29,11,12,6
"2011","Chorley 003D","E01024956","Total",31,13,13,5,7,1,6,0,24,12,7,5
"2011","Chorley 003E","E01024957","Total",19,2,16,1,3,0,3,0,16,2,13,1
"2011","Chorley 003F","E01024958","Total",47,19,9,19,5,0,3,2,42,19,6,17
"2011","Chorley 004A","E01024948","Total",35,9,18,8,3,2,0,1,32,7,18,7
"2011","Chorley 004B","E01024949","Total",66,17,37,12,12,0,11,1,54,17,26,11
"2011","Chorley 004C","E01024950","Total",16,5,7,4,3,0,2,1,13,5,5,3
"2011","Chorley 004D","E01024977","Total",29,12,13,4,4,0,3,1,25,12,10,3
"2011","Chorley 005A","E01024967","Total",18,6,9,3,3,1,1,1,15,5,8,2
"2011","Chorley 005B","E01024968","Total",45,17,16,12,4,1,1,2,41,16,15,10
"2011","Chorley 005C","E01024969","Total",36,15,15,6,4,3,1,0,32,12,14,6
"2011","Chorley 005D","E01024970","Total",30,13,13,4,8,2,6,0,22,11,7,4
"2011","Chorley 005E","E01024971","Total",35,14,15,6,4,1,3,0,31,13,12,6
"2011","Chorley 005F","E01024972","Total",19,8,8,3,1,0,1,0,18,8,7,3
"2011","Chorley 006A","E01024929","Total",76,28,13,35,12,2,3,7,64,26,10,28
"2011","Chorley 006B","E01024930","Total",62,22,20,20,14,0,7,7,48,22,13,13
"2011","Chorley 006C","E01024931","Total",71,23,24,24,7,1,6,0,64,22,18,24
"2011","Chorley 006D","E01024932","Total",19,6,10,3,2,0,2,0,17,6,8,3
"2011","Chorley 006E","E01024933","Total",51,18,10,23,11,1,6,4,40,17,4,19
"2011","Chorley 006F","E01024937","Total",27,9,12,6,4,1,3,0,23,8,9,6
"2011","Chorley 007A","E01024964","Total",20,8,9,3,4,0,3,1,16,8,6,2
"2011","Chorley 007B","E01024974","Total",44,18,19,7,7,3,2,2,37,15,17,5
"2011","Chorley 007C","E01024975","Total",23,7,9,7,2,1,1,0,21,6,8,7
"2011","Chorley 007D","E01024976","Total",51,26,16,9,6,2,4,0,45,24,12,9
"2011","Chorley 008A","E01024919","Total",112,46,28,38,18,2,8,8,94,44,20,30
"2011","Chorley 008B","E01024920","Total",31,8,15,8,2,0,2,0,29,8,13,8
"2011","Chorley 008C","E01024934","Total",21,8,11,2,4,1,3,0,17,7,8,2
"2011","Chorley 008D","E01024935","Total",19,4,11,4,4,0,4,0,15,4,7,4
"2011","Chorley 009A","E01024925","Total",83,27,16,40,4,0,2,2,79,27,14,38
"2011","Chorley 009B","E01024926","Total",95,32,21,42,9,0,3,6,86,32,18,36
"2011","Chorley 009C","E01024927","Total",58,26,19,13,3,1,2,0,55,25,17,13
"2011","Chorley 009D","E01024928","Total",38,13,15,10,5,0,2,3,33,13,13,7
"2011","Chorley 010A","E01024936","Total",46,17,19,10,9,2,3,4,37,15,16,6
"2011","Chorley 010B","E01024938","Total",35,17,9,9,5,2,1,2,30,15,8,7
"2011","Chorley 010C","E01024939","Total",23,10,9,4,2,0,2,0,21,10,7,4
"2011","Chorley 010D","E01024940","Total",64,21,15,28,9,2,6,1,55,19,9,27
"2011","Chorley 010E","E01024941","Total",65,23,20,22,5,3,0,2,60,20,20,20
"2011","Chorley 011A","E01024923","Total",14,1,8,5,2,0,1,1,12,1,7,4
"2011","Chorley 011B","E01024924","Total",21,8,11,2,5,1,4,0,16,7,7,2
"2011","Chorley 011C","E01024963","Total",47,18,18,11,7,1,5,1,40,17,13,10
"2011","Chorley 011D","E01024965","Total",26,13,12,1,5,2,2,1,21,11,10,0
"2011","Chorley 011E","E01024966","Total",37,14,18,5,7,1,6,0,30,13,12,5
"2011","Chorley 012A","E01024942","Total",73,24,14,35,14,2,6,6,59,22,8,29
"2011","Chorley 012B","E01024943","Total",147,33,47,67,20,1,12,7,127,32,35,60
"2011","Chorley 012C","E01024944","Total",42,13,19,10,5,0,5,0,37,13,14,10
"2011","Chorley 012D","E01024945","Total",119,36,31,52,21,2,8,11,98,34,23,41
"2011","Chorley 013A","E01024922","Total",36,10,14,12,3,0,3,0,33,10,11,12
"2011","Chorley 013B","E01024959","Total",67,19,18,30,14,0,6,8,53,19,12,22
"2011","Chorley 013C","E01024960","Total",53,23,15,15,4,1,2,1,49,22,13,14
"2011","Chorley 013D","E01024961","Total",36,15,11,10,5,1,3,1,31,14,8,9
"2011","Chorley 013E","E01024962","Total",18,8,8,2,3,0,3,0,15,8,5,2
"2011","Chorley 014A","E01024915","Total",75,31,21,23,10,5,3,2,65,26,18,21
"2011","Chorley 014B","E01024916","Total",27,10,13,4,6,1,5,0,21,9,8,4
"2011","Chorley 014C","E01024917","Total",62,27,20,15,10,2,6,2,52,25,14,13
"2011","Chorley 014D","E01024918","Total",27,12,9,6,1,0,0,1,26,12,9,5
"2011","Chorley 014E","E01024973","Total",30,10,14,6,3,0,2,1,27,10,12,5
"2011","Fylde 001A","E01024993","Total",27,13,13,1,0,0,0,0,27,13,13,1
"2011","Fylde 001B","E01025026","Total",21,11,8,2,4,3,1,0,17,8,7,2
"2011","Fylde 001C","E01025027","Total",54,21,18,15,4,0,3,1,50,21,15,14
"2011","Fylde 001D","E01025028","Total",39,16,10,13,6,3,1,2,33,13,9,11
"2011","Fylde 001E","E01025031","Total",10,6,1,3,3,2,1,0,7,4,0,3
"2011","Fylde 002A","E01025007","Total",27,15,11,1,4,0,4,0,23,15,7,1
"2011","Fylde 002B","E01025008","Total",27,10,15,2,3,0,2,1,24,10,13,1
"2011","Fylde 002C","E01025009","Total",42,21,8,13,4,1,1,2,38,20,7,11
"2011","Fylde 002D","E01025011","Total",61,21,22,18,2,0,1,1,59,21,21,17
"2011","Fylde 002E","E01025012","Total",43,15,18,10,4,1,2,1,39,14,16,9
"2011","Fylde 002F","E01025013","Total",98,37,22,39,4,0,2,2,94,37,20,37
"2011","Fylde 002G","E01025019","Total",20,7,11,2,3,0,2,1,17,7,9,1
"2011","Fylde 003A","E01024998","Total",80,26,10,44,12,4,2,6,68,22,8,38
"2011","Fylde 003B","E01025010","Total",24,10,9,5,2,0,1,1,22,10,8,4
"2011","Fylde 003C","E01025014","Total",44,13,21,10,6,0,6,0,38,13,15,10
"2011","Fylde 003D","E01025015","Total",31,7,20,4,2,0,2,0,29,7,18,4
"2011","Fylde 004A","E01025004","Total",43,16,18,9,6,0,5,1,37,16,13,8
"2011","Fylde 004B","E01025006","Total",70,22,16,32,8,1,3,4,62,21,13,28
"2011","Fylde 004C","E01025023","Total",38,20,12,6,3,2,1,0,35,18,11,6
"2011","Fylde 004D","E01025024","Total",38,17,10,11,5,0,2,3,33,17,8,8
"2011","Fylde 004E","E01025025","Total",79,37,14,28,11,0,4,7,68,37,10,21
"2011","Fylde 005A","E01025001","Total",42,13,11,18,5,0,5,0,37,13,6,18
"2011","Fylde 005B","E01025002","Total",69,21,29,19,5,2,3,0,64,19,26,19
"2011","Fylde 005C","E01025005","Total",31,12,6,13,2,0,0,2,29,12,6,11
"2011","Fylde 005D","E01025016","Total",28,15,7,6,5,1,4,0,23,14,3,6
"2011","Fylde 005E","E01025018","Total",30,16,7,7,2,1,1,0,28,15,6,7
"2011","Fylde 006A","E01024984","Total",21,4,10,7,3,0,0,3,18,4,10,4
"2011","Fylde 006B","E01024985","Total",28,7,12,9,5,0,4,1,23,7,8,8
"2011","Fylde 006C","E01024986","Total",21,6,6,9,0,0,0,0,21,6,6,9
"2011","Fylde 006D","E01024987","Total",68,21,24,23,3,0,2,1,65,21,22,22
"2011","Fylde 006E","E01024988","Total",40,9,9,22,4,0,2,2,36,9,7,20
"2011","Fylde 006F","E01024989","Total",50,20,16,14,8,2,4,2,42,18,12,12
"2011","Fylde 006G","E01024996","Total",20,4,6,10,1,0,0,1,19,4,6,9
"2011","Fylde 007A","E01024997","Total",29,9,17,3,6,0,6,0,23,9,11,3
"2011","Fylde 007B","E01024999","Total",46,21,19,6,7,0,6,1,39,21,13,5
"2011","Fylde 007C","E01025000","Total",28,11,14,3,2,0,2,0,26,11,12,3
"2011","Fylde 007D","E01025029","Total",34,9,12,13,7,1,4,2,27,8,8,11
"2011","Fylde 007E","E01025030","Total",106,28,31,47,18,0,9,9,88,28,22,38
"2011","Fylde 008A","E01024981","Total",13,5,5,3,3,2,1,0,10,3,4,3
"2011","Fylde 008B","E01024982","Total",21,5,5,11,10,0,3,7,11,5,2,4
"2011","Fylde 008C","E01024983","Total",45,17,13,15,0,0,0,0,45,17,13,15
"2011","Fylde 008D","E01024994","Total",24,7,9,8,1,0,1,0,23,7,8,8
"2011","Fylde 008E","E01024995","Total",16,6,6,4,3,0,3,0,13,6,3,4
"2011","Fylde 008F","E01025003","Total",33,13,11,9,5,0,3,2,28,13,8,7
"2011","Fylde 008G","E01025017","Total",48,27,12,9,5,2,3,0,43,25,9,9
"2011","Fylde 009A","E01024990","Total",34,10,8,16,0,0,0,0,34,10,8,16
"2011","Fylde 009B","E01024991","Total",20,8,8,4,5,1,3,1,15,7,5,3
"2011","Fylde 009C","E01024992","Total",27,13,0,14,1,1,0,0,26,12,0,14
"2011","Fylde 009D","E01025020","Total",65,27,15,23,2,2,0,0,63,25,15,23
"2011","Fylde 009E","E01025021","Total",26,10,12,4,2,1,1,0,24,9,11,4
"2011","Fylde 009F","E01025022","Total",85,44,29,12,7,2,5,0,78,42,24,12
"2011","Hyndburn 001A","E01025060","Total",87,31,25,31,14,1,9,4,73,30,16,27
"2011","Hyndburn 001B","E01025061","Total",20,9,7,4,3,1,2,0,17,8,5,4
"2011","Hyndburn 001C","E01025062","Total",76,20,17,39,11,1,4,6,65,19,13,33
"2011","Hyndburn 001D","E01025063","Total",50,17,21,12,9,1,7,1,41,16,14,11
"2011","Hyndburn 001E","E01025064","Total",20,11,8,1,1,0,1,0,19,11,7,1
"2011","Hyndburn 001F","E01025065","Total",81,31,26,24,8,1,5,2,73,30,21,22
"2011","Hyndburn 001G","E01025066","Total",53,24,18,11,8,1,4,3,45,23,14,8
"2011","Hyndburn 002A","E01025032","Total",59,21,17,21,6,1,3,2,53,20,14,19
"2011","Hyndburn 002B","E01025033","Total",65,29,28,8,11,2,9,0,54,27,19,8
"2011","Hyndburn 002C","E01025034","Total",60,22,13,25,5,1,1,3,55,21,12,22
"2011","Hyndburn 002D","E01025048","Total",41,15,20,6,8,2,6,0,33,13,14,6
"2011","Hyndburn 002E","E01025049","Total",90,30,25,35,14,3,7,4,76,27,18,31
"2011","Hyndburn 002F","E01025050","Total",55,18,21,16,6,1,5,0,49,17,16,16
"2011","Hyndburn 002G","E01025053","Total",51,19,14,18,5,1,3,1,46,18,11,17
"2011","Hyndburn 003A","E01025070","Total",72,24,15,33,9,2,4,3,63,22,11,30
"2011","Hyndburn 003B","E01025071","Total",42,14,14,14,4,0,3,1,38,14,11,13
"2011","Hyndburn 003C","E01025072","Total",77,21,22,34,14,0,6,8,63,21,16,26
"2011","Hyndburn 003D","E01025073","Total",40,11,13,16,6,0,5,1,34,11,8,15
"2011","Hyndburn 003E","E01025074","Total",17,9,6,2,1,0,1,0,16,9,5,2
"2011","Hyndburn 004A","E01025051","Total",54,13,10,31,10,0,3,7,44,13,7,24
"2011","Hyndburn 004B","E01025052","Total",38,10,16,12,5,0,4,1,33,10,12,11
"2011","Hyndburn 004C","E01025057","Total",54,20,22,12,6,1,3,2,48,19,19,10
"2011","Hyndburn 004D","E01025058","Total",55,23,14,18,4,2,1,1,51,21,13,17
"2011","Hyndburn 004E","E01025059","Total",64,21,15,28,3,1,1,1,61,20,14,27
"2011","Hyndburn 004F","E01025067","Total",97,38,23,36,8,1,2,5,89,37,21,31
"2011","Hyndburn 004G","E01025068","Total",96,30,17,49,4,0,0,4,92,30,17,45
"2011","Hyndburn 004H","E01025069","Total",87,31,21,35,8,1,4,3,79,30,17,32
"2011","Hyndburn 005A","E01025044","Total",58,15,14,29,3,1,2,0,55,14,12,29
"2011","Hyndburn 005B","E01025045","Total",77,19,16,42,7,0,3,4,70,19,13,38
"2011","Hyndburn 005C","E01025046","Total",57,19,10,28,7,2,2,3,50,17,8,25
"2011","Hyndburn 005D","E01025081","Total",42,15,18,9,7,2,5,0,35,13,13,9
"2011","Hyndburn 006A","E01025041","Total",62,19,6,37,5,1,0,4,57,18,6,33
"2011","Hyndburn 006B","E01025042","Total",57,13,5,39,9,3,1,5,48,10,4,34
"2011","Hyndburn 006E","E01025082","Total",128,36,19,73,16,1,3,12,112,35,16,61
"2011","Hyndburn 006F","E01025083","Total",119,31,18,70,19,3,5,11,100,28,13,59
"2011","Hyndburn 006G","E01025084","Total",67,14,11,42,10,1,3,6,57,13,8,36
"2011","Hyndburn 006H","E01033231","Total",85,17,12,56,16,7,2,7,69,10,10,49
"2011","Hyndburn 007A","E01025055","Total",83,24,31,28,15,1,7,7,68,23,24,21
"2011","Hyndburn 007B","E01025075","Total",77,28,32,17,6,1,4,1,71,27,28,16
"2011","Hyndburn 007C","E01025076","Total",57,30,13,14,6,0,2,4,51,30,11,10
"2011","Hyndburn 007D","E01025077","Total",54,20,16,18,11,1,7,3,43,19,9,15
"2011","Hyndburn 007E","E01025078","Total",32,12,12,8,5,0,3,2,27,12,9,6
"2011","Hyndburn 008A","E01025035","Total",32,8,12,12,4,2,2,0,28,6,10,12
"2011","Hyndburn 008B","E01025036","Total",64,12,19,33,13,1,7,5,51,11,12,28
"2011","Hyndburn 008C","E01025037","Total",72,20,18,34,13,1,5,7,59,19,13,27
"2011","Hyndburn 008D","E01025038","Total",34,14,13,7,5,0,5,0,29,14,8,7
"2011","Hyndburn 008E","E01025039","Total",23,8,11,4,0,0,0,0,23,8,11,4
"2011","Hyndburn 008F","E01025040","Total",34,11,13,10,5,1,1,3,29,10,12,7
"2011","Hyndburn 009A","E01025054","Total",40,10,19,11,2,1,1,0,38,9,18,11
"2011","Hyndburn 009B","E01025056","Total",21,7,12,2,4,1,3,0,17,6,9,2
"2011","Hyndburn 009C","E01025079","Total",42,11,21,10,3,0,3,0,39,11,18,10
"2011","Hyndburn 009D","E01025080","Total",46,18,20,8,7,1,4,2,39,17,16,6
"2011","Lancaster 001A","E01025088","Total",24,9,7,8,1,0,1,0,23,9,6,8
"2011","Lancaster 001B","E01025096","Total",41,20,13,8,4,0,2,2,37,20,11,6
"2011","Lancaster 001C","E01025097","Total",63,24,13,26,7,1,3,3,56,23,10,23
"2011","Lancaster 001D","E01025098","Total",27,12,9,6,4,0,4,0,23,12,5,6
"2011","Lancaster 001E","E01025148","Total",25,11,13,1,8,2,6,0,17,9,7,1
"2011","Lancaster 001F","E01025168","Total",39,16,15,8,3,0,3,0,36,16,12,8
"2011","Lancaster 001G","E01025169","Total",27,14,6,7,4,3,1,0,23,11,5,7
"2011","Lancaster 002A","E01025130","Total",39,23,9,7,4,1,3,0,35,22,6,7
"2011","Lancaster 002B","E01025132","Total",17,5,8,4,1,0,1,0,16,5,7,4
"2011","Lancaster 002C","E01025166","Total",21,6,6,9,1,0,1,0,20,6,5,9
"2011","Lancaster 002D","E01025167","Total",10,3,3,4,0,0,0,0,10,3,3,4
"2011","Lancaster 003A","E01025089","Total",26,12,8,6,0,0,0,0,26,12,8,6
"2011","Lancaster 003B","E01025090","Total",27,12,7,8,4,1,3,0,23,11,4,8
"2011","Lancaster 003C","E01025158","Total",16,8,5,3,3,0,2,1,13,8,3,2
"2011","Lancaster 003D","E01025159","Total",21,6,9,6,3,0,1,2,18,6,8,4
"2011","Lancaster 003E","E01025160","Total",17,6,9,2,2,0,2,0,15,6,7,2
"2011","Lancaster 004A","E01025085","Total",34,10,7,17,6,0,3,3,28,10,4,14
"2011","Lancaster 004B","E01025086","Total",17,14,0,3,0,0,0,0,17,14,0,3
"2011","Lancaster 004C","E01025087","Total",23,7,7,9,4,1,1,2,19,6,6,7
"2011","Lancaster 004D","E01025161","Total",18,5,6,7,1,1,0,0,17,4,6,7
"2011","Lancaster 005A","E01025108","Total",29,10,11,8,2,0,2,0,27,10,9,8
"2011","Lancaster 005B","E01025109","Total",16,8,7,1,0,0,0,0,16,8,7,1
"2011","Lancaster 005C","E01025131","Total",28,9,11,8,3,1,2,0,25,8,9,8
"2011","Lancaster 005D","E01025133","Total",31,12,17,2,4,1,2,1,27,11,15,1
"2011","Lancaster 006A","E01025112","Total",71,28,13,30,8,1,2,5,63,27,11,25
"2011","Lancaster 006B","E01025136","Total",117,41,15,61,15,2,3,10,102,39,12,51
"2011","Lancaster 006C","E01025138","Total",68,27,16,25,3,0,1,2,65,27,15,23
"2011","Lancaster 006D","E01025139","Total",83,32,15,36,11,2,2,7,72,30,13,29
"2011","Lancaster 006E","E01025140","Total",34,10,8,16,4,1,0,3,30,9,8,13
"2011","Lancaster 008A","E01025111","Total",86,34,22,30,8,1,3,4,78,33,19,26
"2011","Lancaster 008B","E01025113","Total",42,16,16,10,4,0,4,0,38,16,12,10
"2011","Lancaster 008C","E01025118","Total",44,19,11,14,6,1,4,1,38,18,7,13
"2011","Lancaster 008D","E01025119","Total",47,24,6,17,3,0,2,1,44,24,4,16
"2011","Lancaster 009A","E01025110","Total",68,17,18,33,10,0,5,5,58,17,13,28
"2011","Lancaster 009B","E01025116","Total",39,17,13,9,4,0,4,0,35,17,9,9
"2011","Lancaster 009C","E01025117","Total",84,23,26,35,13,3,6,4,71,20,20,31
"2011","Lancaster 009D","E01025120","Total",66,22,18,26,9,1,5,3,57,21,13,23
"2011","Lancaster 010A","E01025170","Total",66,23,23,20,3,0,3,0,63,23,20,20
"2011","Lancaster 010B","E01025171","Total",106,42,12,52,7,3,2,2,99,39,10,50
"2011","Lancaster 010C","E01025172","Total",72,31,23,18,3,0,1,2,69,31,22,16
"2011","Lancaster 010D","E01025173","Total",80,30,12,38,16,3,6,7,64,27,6,31
"2011","Lancaster 011A","E01025149","Total",79,29,25,25,4,0,2,2,75,29,23,23
"2011","Lancaster 011B","E01025150","Total",52,20,9,23,7,0,2,5,45,20,7,18
"2011","Lancaster 011C","E01025151","Total",80,24,14,42,8,0,3,5,72,24,11,37
"2011","Lancaster 011D","E01025152","Total",81,28,18,35,10,1,5,4,71,27,13,31
"2011","Lancaster 011E","E01025154","Total",89,36,8,45,3,2,1,0,86,34,7,45
"2011","Lancaster 013A","E01025091","Total",52,18,18,16,10,1,5,4,42,17,13,12
"2011","Lancaster 013B","E01025092","Total",68,30,8,30,4,1,0,3,64,29,8,27
"2011","Lancaster 013C","E01025095","Total",36,18,13,5,0,0,0,0,36,18,13,5
"2011","Lancaster 013D","E01025126","Total",35,15,17,3,3,0,3,0,32,15,14,3
"2011","Lancaster 014A","E01025093","Total",38,9,6,23,3,1,1,1,35,8,5,22
"2011","Lancaster 014B","E01025094","Total",42,20,11,11,6,1,3,2,36,19,8,9
"2011","Lancaster 014C","E01025099","Total",44,11,11,22,8,1,3,4,36,10,8,18
"2011","Lancaster 014E","E01033071","Total",14,3,9,2,5,0,5,0,9,3,4,2
"2011","Lancaster 014F","E01033073","Total",12,3,7,2,3,0,2,1,9,3,5,1
"2011","Lancaster 015A","E01025125","Total",29,12,10,7,2,0,1,1,27,12,9,6
"2011","Lancaster 015B","E01025128","Total",36,13,12,11,5,1,3,1,31,12,9,10
"2011","Lancaster 015C","E01025129","Total",21,7,8,6,4,1,3,0,17,6,5,6
"2011","Lancaster 015D","E01025147","Total",40,20,18,2,7,1,5,1,33,19,13,1
"2011","Lancaster 016A","E01025114","Total",23,11,6,6,1,0,1,0,22,11,5,6
"2011","Lancaster 016B","E01025115","Total",73,22,12,39,8,1,2,5,65,21,10,34
"2011","Lancaster 016C","E01025121","Total",61,26,14,21,4,0,2,2,57,26,12,19
"2011","Lancaster 016D","E01025122","Total",29,14,9,6,2,1,1,0,27,13,8,6
"2011","Lancaster 016E","E01025123","Total",68,32,19,17,7,1,5,1,61,31,14,16
"2011","Lancaster 016F","E01025124","Total",90,35,16,39,9,3,3,3,81,32,13,36
"2011","Lancaster 016I","E01033072","Total",57,22,17,18,11,2,8,1,46,20,9,17
"2011","Lancaster 017A","E01025100","Total",52,18,16,18,4,1,2,1,48,17,14,17
"2011","Lancaster 017B","E01025101","Total",65,27,13,25,5,2,2,1,60,25,11,24
"2011","Lancaster 017C","E01025102","Total",22,9,10,3,0,0,0,0,22,9,10,3
"2011","Lancaster 017D","E01025103","Total",21,6,14,1,2,0,2,0,19,6,12,1
"2011","Lancaster 017E","E01025144","Total",43,19,10,14,4,1,2,1,39,18,8,13
"2011","Lancaster 017F","E01025146","Total",27,18,5,4,3,0,3,0,24,18,2,4
"2011","Lancaster 018A","E01025127","Total",19,10,7,2,3,0,2,1,16,10,5,1
"2011","Lancaster 018B","E01025141","Total",28,14,7,7,2,0,1,1,26,14,6,6
"2011","Lancaster 018C","E01025143","Total",57,21,7,29,1,0,0,1,56,21,7,28
"2011","Lancaster 018D","E01025145","Total",73,32,24,17,5,2,2,1,68,30,22,16
"2011","Lancaster 019A","E01025105","Total",14,7,5,2,0,0,0,0,14,7,5,2
"2011","Lancaster 019B","E01025106","Total",57,20,22,15,9,1,7,1,48,19,15,14
"2011","Lancaster 019C","E01025107","Total",22,7,8,7,4,1,1,2,18,6,7,5
"2011","Lancaster 019D","E01025142","Total",19,8,4,7,4,0,2,2,15,8,2,5
"2011","Lancaster 020A","E01025137","Total",42,19,14,9,4,0,3,1,38,19,11,8
"2011","Lancaster 020F","E01025153","Total",36,14,10,12,5,0,4,1,31,14,6,11
"2011","Lancaster 020G","E01025155","Total",27,17,5,5,5,1,3,1,22,16,2,4
"2011","Lancaster 020H","E01025156","Total",115,36,10,69,15,4,1,10,100,32,9,59
"2011","Lancaster 020I","E01025157","Total",47,17,8,22,6,1,2,3,41,16,6,19
"2011","Lancaster 020B","E01025162","Total",16,7,8,1,3,0,3,0,13,7,5,1
"2011","Lancaster 020C","E01025163","Total",19,9,6,4,0,0,0,0,19,9,6,4
"2011","Lancaster 020D","E01025164","Total",36,14,12,10,3,1,2,0,33,13,10,10
"2011","Lancaster 020E","E01025165","Total",40,16,17,7,6,0,5,1,34,16,12,6
"2011","Pendle 001A","E01025191","Total",22,5,10,7,2,0,1,1,20,5,9,6
"2011","Pendle 001B","E01025192","Total",57,22,17,18,4,1,1,2,53,21,16,16
"2011","Pendle 001C","E01025193","Total",38,21,6,11,3,2,0,1,35,19,6,10
"2011","Pendle 001D","E01025194","Total",57,23,16,18,3,1,2,0,54,22,14,18
"2011","Pendle 002A","E01025195","Total",21,13,6,2,3,2,0,1,18,11,6,1
"2011","Pendle 002B","E01025196","Total",55,23,22,10,7,1,6,0,48,22,16,10
"2011","Pendle 002C","E01025197","Total",12,4,5,3,4,0,2,2,8,4,3,1
"2011","Pendle 002D","E01025198","Total",33,14,8,11,2,0,0,2,31,14,8,9
"2011","Pendle 003A","E01025199","Total",42,22,9,11,2,1,1,0,40,21,8,11
"2011","Pendle 003B","E01025200","Total",37,19,7,11,6,3,3,0,31,16,4,11
"2011","Pendle 003C","E01025201","Total",54,25,15,14,7,2,3,2,47,23,12,12
"2011","Pendle 003D","E01025202","Total",34,20,9,5,2,0,2,0,32,20,7,5
"2011","Pendle 004A","E01025205","Total",80,21,18,41,9,2,2,5,71,19,16,36
"2011","Pendle 004B","E01025206","Total",39,11,17,11,2,0,2,0,37,11,15,11
"2011","Pendle 004C","E01025207","Total",48,18,8,22,4,1,2,1,44,17,6,21
"2011","Pendle 004D","E01025208","Total",37,13,8,16,3,0,3,0,34,13,5,16
"2011","Pendle 005A","E01025220","Total",113,33,17,63,16,2,4,10,97,31,13,53
"2011","Pendle 005B","E01025221","Total",72,34,15,23,6,0,2,4,66,34,13,19
"2011","Pendle 005C","E01025222","Total",40,18,9,13,1,0,0,1,39,18,9,12
"2011","Pendle 005D","E01025223","Total",54,15,14,25,6,0,3,3,48,15,11,22
"2011","Pendle 006A","E01025178","Total",38,16,16,6,2,0,2,0,36,16,14,6
"2011","Pendle 006B","E01025179","Total",45,18,13,14,6,0,3,3,39,18,10,11
"2011","Pendle 006C","E01025180","Total",36,16,16,4,7,3,4,0,29,13,12,4
"2011","Pendle 006D","E01025203","Total",13,6,5,2,2,0,2,0,11,6,3,2
"2011","Pendle 007A","E01025226","Total",80,19,17,44,11,0,6,5,69,19,11,39
"2011","Pendle 007B","E01025227","Total",99,26,17,56,16,3,6,7,83,23,11,49
"2011","Pendle 007C","E01025228","Total",54,23,17,14,6,0,5,1,48,23,12,13
"2011","Pendle 008A","E01025174","Total",23,11,9,3,3,0,3,0,20,11,6,3
"2011","Pendle 008B","E01025175","Total",32,13,13,6,3,0,0,3,29,13,13,3
"2011","Pendle 008C","E01025176","Total",68,33,23,12,7,2,2,3,61,31,21,9
"2011","Pendle 008D","E01025177","Total",24,8,9,7,4,0,4,0,20,8,5,7
"2011","Pendle 008E","E01025204","Total",21,7,12,2,4,1,2,1,17,6,10,1
"2011","Pendle 008F","E01025211","Total",22,9,9,4,3,0,2,1,19,9,7,3
"2011","Pendle 009A","E01025181","Total",79,22,13,44,7,0,5,2,72,22,8,42
"2011","Pendle 009B","E01025182","Total",36,13,14,9,4,1,2,1,32,12,12,8
"2011","Pendle 009C","E01025183","Total",52,11,12,29,6,0,2,4,46,11,10,25
"2011","Pendle 009D","E01025184","Total",54,18,1,35,3,2,1,0,51,16,0,35
"2011","Pendle 010A","E01025188","Total",74,18,14,42,6,0,3,3,68,18,11,39
"2011","Pendle 010B","E01025189","Total",77,25,11,41,7,1,5,1,70,24,6,40
"2011","Pendle 010C","E01025210","Total",99,28,34,37,14,2,6,6,85,26,28,31
"2011","Pendle 010D","E01025217","Total",58,14,10,34,4,2,1,1,54,12,9,33
"2011","Pendle 010E","E01025218","Total",29,8,1,20,5,1,1,3,24,7,0,17
"2011","Pendle 010F","E01025219","Total",53,15,9,29,6,1,4,1,47,14,5,28
"2011","Pendle 011A","E01025224","Total",65,24,12,29,9,1,5,3,56,23,7,26
"2011","Pendle 011B","E01025225","Total",44,18,15,11,1,0,0,1,43,18,15,10
"2011","Pendle 011C","E01025229","Total",43,5,7,31,4,1,1,2,39,4,6,29
"2011","Pendle 011D","E01025230","Total",21,4,4,13,0,0,0,0,21,4,4,13
"2011","Pendle 012A","E01025187","Total",27,6,7,14,3,1,2,0,24,5,5,14
"2011","Pendle 012B","E01025190","Total",51,17,17,17,10,3,4,3,41,14,13,14
"2011","Pendle 012C","E01025209","Total",66,24,20,22,7,1,5,1,59,23,15,21
"2011","Pendle 012D","E01025216","Total",59,22,19,18,11,3,7,1,48,19,12,17
"2011","Pendle 013A","E01025185","Total",45,9,10,26,4,0,3,1,41,9,7,25
"2011","Pendle 013B","E01025186","Total",47,14,10,23,3,0,1,2,44,14,9,21
"2011","Pendle 013C","E01025212","Total",16,6,8,2,1,0,1,0,15,6,7,2
"2011","Pendle 013D","E01025213","Total",21,10,4,7,3,1,2,0,18,9,2,7
"2011","Pendle 013E","E01025214","Total",23,6,12,5,3,2,1,0,20,4,11,5
"2011","Pendle 013F","E01025215","Total",47,11,7,29,6,0,2,4,41,11,5,25
"2011","Preston 001A","E01025278","Total",40,11,23,6,10,1,7,2,30,10,16,4
"2011","Preston 001B","E01025279","Total",12,5,6,1,4,2,2,0,8,3,4,1
"2011","Preston 001C","E01025282","Total",17,6,8,3,1,0,1,0,16,6,7,3
"2011","Preston 002A","E01025257","Total",18,3,13,2,3,0,3,0,15,3,10,2
"2011","Preston 002B","E01025277","Total",19,6,9,4,3,0,3,0,16,6,6,4
"2011","Preston 002C","E01025280","Total",31,11,17,3,3,0,3,0,28,11,14,3
"2011","Preston 002D","E01025281","Total",18,5,8,5,3,0,2,1,15,5,6,4
"2011","Preston 003A","E01025256","Total",20,7,11,2,1,0,1,0,19,7,10,2
"2011","Preston 003B","E01025258","Total",19,5,8,6,7,1,4,2,12,4,4,4
"2011","Preston 003C","E01025259","Total",38,22,12,4,5,2,3,0,33,20,9,4
"2011","Preston 003D","E01025299","Total",26,10,12,4,3,1,2,0,23,9,10,4
"2011","Preston 003E","E01025301","Total",31,17,13,1,3,0,3,0,28,17,10,1
"2011","Preston 003F","E01025302","Total",19,8,9,2,2,0,2,0,17,8,7,2
"2011","Preston 004A","E01025253","Total",34,12,20,2,5,0,5,0,29,12,15,2
"2011","Preston 004B","E01025254","Total",19,12,4,3,2,1,0,1,17,11,4,2
"2011","Preston 004C","E01025255","Total",41,14,21,6,2,0,2,0,39,14,19,6
"2011","Preston 004D","E01025300","Total",6,4,1,1,0,0,0,0,6,4,1,1
"2011","Preston 004E","E01025303","Total",31,18,11,2,3,1,2,0,28,17,9,2
"2011","Preston 005A","E01025260","Total",87,33,17,37,13,1,6,6,74,32,11,31
"2011","Preston 005B","E01025262","Total",47,17,17,13,4,0,2,2,43,17,15,11
"2011","Preston 005C","E01025263","Total",92,20,25,47,11,0,4,7,81,20,21,40
"2011","Preston 005D","E01025264","Total",84,32,15,37,6,0,1,5,78,32,14,32
"2011","Preston 006A","E01025239","Total",22,5,8,9,1,0,1,0,21,5,7,9
"2011","Preston 006B","E01025241","Total",27,8,10,9,4,0,3,1,23,8,7,8
"2011","Preston 006C","E01025242","Total",15,8,5,2,1,0,0,1,14,8,5,1
"2011","Preston 006D","E01025243","Total",37,13,14,10,6,1,5,0,31,12,9,10
"2011","Preston 006E","E01025251","Total",38,20,12,6,1,0,1,0,37,20,11,6
"2011","Preston 007A","E01025234","Total",52,14,15,23,6,1,3,2,46,13,12,21
"2011","Preston 007B","E01025235","Total",36,14,6,16,6,1,2,3,30,13,4,13
"2011","Preston 007C","E01025237","Total",80,30,22,28,9,1,6,2,71,29,16,26
"2011","Preston 007D","E01025238","Total",109,31,30,48,15,1,5,9,94,30,25,39
"2011","Preston 007E","E01025245","Total",127,38,25,64,13,1,8,4,114,37,17,60
"2011","Preston 007F","E01025252","Total",37,12,12,13,1,0,0,1,36,12,12,12
"2011","Preston 008A","E01025233","Total",25,8,12,5,5,2,3,0,20,6,9,5
"2011","Preston 008B","E01025240","Total",31,11,12,8,2,0,2,0,29,11,10,8
"2011","Preston 008C","E01025261","Total",25,7,12,6,2,1,0,1,23,6,12,5
"2011","Preston 008D","E01025266","Total",30,12,12,6,5,1,4,0,25,11,8,6
"2011","Preston 008E","E01025309","Total",45,17,15,13,6,0,5,1,39,17,10,12
"2011","Preston 009A","E01025236","Total",97,31,12,54,4,1,2,1,93,30,10,53
"2011","Preston 009B","E01025283","Total",142,33,15,94,22,2,6,14,120,31,9,80
"2011","Preston 009C","E01025284","Total",57,19,10,28,4,0,1,3,53,19,9,25
"2011","Preston 009D","E01025285","Total",52,18,8,26,3,0,1,2,49,18,7,24
"2011","Preston 009E","E01025286","Total",113,32,16,65,17,2,4,11,96,30,12,54
"2011","Preston 009F","E01025287","Total",109,36,19,54,18,1,8,9,91,35,11,45
"2011","Preston 010A","E01025270","Total",38,21,12,5,5,2,3,0,33,19,9,5
"2011","Preston 010B","E01025272","Total",29,12,10,7,3,0,2,1,26,12,8,6
"2011","Preston 010C","E01025273","Total",21,8,9,4,2,0,1,1,19,8,8,3
"2011","Preston 010D","E01025288","Total",57,23,8,26,2,1,1,0,55,22,7,26
"2011","Preston 011A","E01025246","Total",28,6,4,18,3,2,0,1,25,4,4,17
"2011","Preston 011B","E01025274","Total",63,17,13,33,7,1,3,3,56,16,10,30
"2011","Preston 011C","E01025275","Total",65,16,21,28,2,0,1,1,63,16,20,27
"2011","Preston 011D","E01025294","Total",47,14,6,27,9,3,3,3,38,11,3,24
"2011","Preston 012A","E01025276","Total",55,14,17,24,7,1,3,3,48,13,14,21
"2011","Preston 012B","E01025308","Total",94,35,30,29,7,0,4,3,87,35,26,26
"2011","Preston 012C","E01025310","Total",64,20,21,23,4,1,2,1,60,19,19,22
"2011","Preston 012D","E01025311","Total",65,15,28,22,6,0,3,3,59,15,25,19
"2011","Preston 012E","E01025312","Total",78,33,24,21,4,0,3,1,74,33,21,20
"2011","Preston 012F","E01025313","Total",43,17,6,20,4,1,2,1,39,16,4,19
"2011","Preston 012G","E01025314","Total",54,18,9,27,2,0,1,1,52,18,8,26
"2011","Preston 013A","E01025231","Total",16,6,8,2,2,1,1,0,14,5,7,2
"2011","Preston 013B","E01025232","Total",61,21,15,25,11,2,6,3,50,19,9,22
"2011","Preston 013C","E01025265","Total",49,15,19,15,8,2,3,3,41,13,16,12
"2011","Preston 013D","E01025267","Total",47,19,11,17,7,0,3,4,40,19,8,13
"2011","Preston 013E","E01025268","Total",82,26,16,40,11,1,3,7,71,25,13,33
"2011","Preston 013F","E01025269","Total",87,36,16,35,8,1,4,3,79,35,12,32
"2011","Preston 013G","E01025271","Total",60,23,12,25,7,1,5,1,53,22,7,24
"2011","Preston 014A","E01025295","Total",73,21,16,36,5,1,1,3,68,20,15,33
"2011","Preston 014B","E01025296","Total",126,36,13,77,7,1,2,4,119,35,11,73
"2011","Preston 014C","E01025297","Total",124,35,17,72,13,4,4,5,111,31,13,67
"2011","Preston 014D","E01025298","Total",80,19,15,46,9,1,6,2,71,18,9,44
"2011","Preston 015A","E01025244","Total",38,8,10,20,4,1,1,2,34,7,9,18
"2011","Preston 015B","E01025292","Total",46,7,5,34,7,1,1,5,39,6,4,29
"2011","Preston 015C","E01025293","Total",64,19,2,43,9,0,2,7,55,19,0,36
"2011","Preston 016A","E01025247","Total",62,14,9,39,4,0,0,4,58,14,9,35
"2011","Preston 016B","E01025248","Total",107,45,14,48,10,3,2,5,97,42,12,43
"2011","Preston 016C","E01025249","Total",25,11,7,7,4,0,1,3,21,11,6,4
"2011","Preston 016D","E01025250","Total",91,21,17,53,11,1,2,8,80,20,15,45
"2011","Preston 016E","E01025304","Total",27,10,6,11,1,0,1,0,26,10,5,11
"2011","Preston 016F","E01025305","Total",63,17,8,38,5,1,2,2,58,16,6,36
"2011","Preston 017A","E01025289","Total",67,16,19,32,9,2,5,2,58,14,14,30
"2011","Preston 017B","E01025290","Total",45,10,8,27,5,0,1,4,40,10,7,23
"2011","Preston 017C","E01025291","Total",53,18,19,16,7,0,5,2,46,18,14,14
"2011","Preston 017D","E01025306","Total",23,5,11,7,3,0,3,0,20,5,8,7
"2011","Preston 017F","E01033223","Total",1,0,0,1,0,0,0,0,1,0,0,1
"2011","Preston 017G","E01033224","Total",39,12,6,21,4,0,1,3,35,12,5,18
"2011","Preston 017H","E01033226","Total",17,6,1,10,0,0,0,0,17,6,1,10
"2011","Ribble Valley 001A","E01025315","Total",18,7,9,2,1,0,1,0,17,7,8,2
"2011","Ribble Valley 001B","E01025320","Total",13,6,6,1,2,1,1,0,11,5,5,1
"2011","Ribble Valley 001C","E01025331","Total",21,7,11,3,4,1,2,1,17,6,9,2
"2011","Ribble Valley 001D","E01025348","Total",20,7,8,5,2,0,2,0,18,7,6,5
"2011","Ribble Valley 001E","E01025349","Total",14,4,5,5,1,0,0,1,13,4,5,4
"2011","Ribble Valley 002A","E01025334","Total",40,22,10,8,7,6,1,0,33,16,9,8
"2011","Ribble Valley 002B","E01025344","Total",42,14,20,8,6,0,4,2,36,14,16,6
"2011","Ribble Valley 002C","E01025345","Total",32,6,21,5,4,0,4,0,28,6,17,5
"2011","Ribble Valley 002D","E01025346","Total",53,18,21,14,4,0,4,0,49,18,17,14
"2011","Ribble Valley 002E","E01025347","Total",43,15,17,11,5,0,3,2,38,15,14,9
"2011","Ribble Valley 003A","E01025329","Total",31,14,13,4,1,0,1,0,30,14,12,4
"2011","Ribble Valley 003B","E01025330","Total",33,16,10,7,5,1,4,0,28,15,6,7
"2011","Ribble Valley 003C","E01025335","Total",60,24,14,22,7,0,5,2,53,24,9,20
"2011","Ribble Valley 003D","E01025338","Total",46,16,25,5,5,1,4,0,41,15,21,5
"2011","Ribble Valley 003E","E01025339","Total",39,19,13,7,7,4,2,1,32,15,11,6
"2011","Ribble Valley 004A","E01025322","Total",28,10,15,3,5,0,5,0,23,10,10,3
"2011","Ribble Valley 004B","E01025326","Total",36,6,17,13,5,1,3,1,31,5,14,12
"2011","Ribble Valley 004C","E01025327","Total",21,4,14,3,5,0,5,0,16,4,9,3
"2011","Ribble Valley 004D","E01025342","Total",36,9,19,8,3,2,1,0,33,7,18,8
"2011","Ribble Valley 005A","E01025321","Total",24,10,12,2,4,0,3,1,20,10,9,1
"2011","Ribble Valley 005B","E01025340","Total",49,14,18,17,10,2,7,1,39,12,11,16
"2011","Ribble Valley 005C","E01025341","Total",16,7,6,3,3,0,3,0,13,7,3,3
"2011","Ribble Valley 005D","E01025343","Total",42,17,15,10,7,0,6,1,35,17,9,9
"2011","Ribble Valley 005E","E01025354","Total",28,11,13,4,4,2,2,0,24,9,11,4
"2011","Ribble Valley 006A","E01025316","Total",26,6,11,9,4,0,4,0,22,6,7,9
"2011","Ribble Valley 006B","E01025317","Total",62,18,19,25,13,0,8,5,49,18,11,20
"2011","Ribble Valley 006C","E01025325","Total",57,18,20,19,8,0,5,3,49,18,15,16
"2011","Ribble Valley 006D","E01025328","Total",31,11,7,13,1,0,0,1,30,11,7,12
"2011","Ribble Valley 007A","E01025318","Total",30,5,15,10,4,0,0,4,26,5,15,6
"2011","Ribble Valley 007B","E01025319","Total",36,12,17,7,5,1,4,0,31,11,13,7
"2011","Ribble Valley 007C","E01025333","Total",21,7,10,4,3,0,2,1,18,7,8,3
"2011","Ribble Valley 007D","E01025350","Total",20,6,12,2,3,0,3,0,17,6,9,2
"2011","Ribble Valley 007E","E01025351","Total",73,27,36,10,7,0,7,0,66,27,29,10
"2011","Ribble Valley 008A","E01025323","Total",24,6,16,2,7,0,7,0,17,6,9,2
"2011","Ribble Valley 008B","E01025324","Total",36,22,11,3,1,1,0,0,35,21,11,3
"2011","Ribble Valley 008C","E01025332","Total",20,8,8,4,2,0,1,1,18,8,7,3
"2011","Ribble Valley 008D","E01025336","Total",28,7,17,4,4,0,3,1,24,7,14,3
"2011","Ribble Valley 008E","E01025337","Total",23,12,7,4,4,2,2,0,19,10,5,4
"2011","Ribble Valley 008F","E01025352","Total",20,7,10,3,2,0,1,1,18,7,9,2
"2011","Ribble Valley 008G","E01025353","Total",28,8,16,4,1,0,1,0,27,8,15,4
"2011","Rossendale 001A","E01025355","Total",50,13,31,6,10,0,9,1,40,13,22,5
"2011","Rossendale 001B","E01025361","Total",61,25,23,13,6,1,3,2,55,24,20,11
"2011","Rossendale 001C","E01025362","Total",26,10,12,4,5,1,4,0,21,9,8,4
"2011","Rossendale 001D","E01025393","Total",35,18,13,4,5,0,3,2,30,18,10,2
"2011","Rossendale 002A","E01025363","Total",41,12,23,6,6,1,4,1,35,11,19,5
"2011","Rossendale 002B","E01025364","Total",18,5,10,3,2,0,2,0,16,5,8,3
"2011","Rossendale 002C","E01025366","Total",68,24,19,25,17,3,9,5,51,21,10,20
"2011","Rossendale 002D","E01025395","Total",39,22,12,5,4,1,2,1,35,21,10,4
"2011","Rossendale 002E","E01025396","Total",51,15,11,25,2,0,2,0,49,15,9,25
"2011","Rossendale 002F","E01025397","Total",63,19,15,29,7,0,3,4,56,19,12,25
"2011","Rossendale 002G","E01025398","Total",75,19,24,32,13,0,8,5,62,19,16,27
"2011","Rossendale 003A","E01025367","Total",39,14,17,8,3,1,2,0,36,13,15,8
"2011","Rossendale 003B","E01025368","Total",61,21,11,29,10,5,0,5,51,16,11,24
"2011","Rossendale 003C","E01025369","Total",56,20,8,28,4,0,3,1,52,20,5,27
"2011","Rossendale 003D","E01025381","Total",72,27,12,33,7,0,4,3,65,27,8,30
"2011","Rossendale 003E","E01025382","Total",83,22,23,38,15,1,6,8,68,21,17,30
"2011","Rossendale 003F","E01025383","Total",68,21,24,23,7,0,7,0,61,21,17,23
"2011","Rossendale 004A","E01025356","Total",59,17,18,24,16,4,7,5,43,13,11,19
"2011","Rossendale 004C","E01025373","Total",32,15,9,8,3,1,0,2,29,14,9,6
"2011","Rossendale 004D","E01025385","Total",72,18,23,31,2,0,1,1,70,18,22,30
"2011","Rossendale 004F","E01025387","Total",30,6,10,14,8,1,6,1,22,5,4,13
"2011","Rossendale 004G","E01033281","Total",73,23,23,27,10,1,6,3,63,22,17,24
"2011","Rossendale 007A","E01025377","Total",23,10,7,6,3,0,2,1,20,10,5,5
"2011","Rossendale 007B","E01025378","Total",30,11,16,3,5,1,3,1,25,10,13,2
"2011","Rossendale 007C","E01025379","Total",57,23,14,20,6,0,4,2,51,23,10,18
"2011","Rossendale 007D","E01025380","Total",27,12,13,2,1,0,1,0,26,12,12,2
"2011","Rossendale 008A","E01025357","Total",64,26,31,7,6,1,4,1,58,25,27,6
"2011","Rossendale 008B","E01025358","Total",42,17,18,7,5,2,3,0,37,15,15,7
"2011","Rossendale 008C","E01025365","Total",41,9,25,7,1,0,1,0,40,9,24,7
"2011","Rossendale 008D","E01025384","Total",19,5,9,5,3,0,3,0,16,5,6,5
"2011","Rossendale 009A","E01025359","Total",36,16,7,13,3,1,1,1,33,15,6,12
"2011","Rossendale 009B","E01025360","Total",59,15,20,24,9,1,5,3,50,14,15,21
"2011","Rossendale 009C","E01025375","Total",57,19,28,10,6,0,6,0,51,19,22,10
"2011","Rossendale 009D","E01025376","Total",129,38,23,68,14,0,2,12,115,38,21,56
"2011","Rossendale 010F","E01025370","Total",24,6,6,12,1,0,0,1,23,6,6,11
"2011","Rossendale 010A","E01025371","Total",55,20,17,18,5,1,3,1,50,19,14,17
"2011","Rossendale 010B","E01025374","Total",39,12,17,10,2,0,1,1,37,12,16,9
"2011","Rossendale 010G","E01025388","Total",52,17,14,21,6,0,2,4,46,17,12,17
"2011","Rossendale 010H","E01025389","Total",60,19,9,32,5,2,1,2,55,17,8,30
"2011","Rossendale 010I","E01025390","Total",43,8,10,25,5,0,2,3,38,8,8,22
"2011","Rossendale 010C","E01025391","Total",87,25,32,30,6,0,3,3,81,25,29,27
"2011","Rossendale 010D","E01025392","Total",38,13,15,10,5,1,3,1,33,12,12,9
"2011","Rossendale 010E","E01025394","Total",57,22,16,19,7,2,2,3,50,20,14,16
"2011","South Ribble 001A","E01025424","Total",26,9,14,3,4,1,3,0,22,8,11,3
"2011","South Ribble 001B","E01025425","Total",36,15,18,3,4,0,4,0,32,15,14,3
"2011","South Ribble 001C","E01025426","Total",15,6,7,2,3,1,2,0,12,5,5,2
"2011","South Ribble 001D","E01025466","Total",35,12,21,2,4,0,4,0,31,12,17,2
"2011","South Ribble 002A","E01025413","Total",40,15,16,9,4,0,4,0,36,15,12,9
"2011","South Ribble 002B","E01025414","Total",15,5,7,3,2,0,1,1,13,5,6,2
"2011","South Ribble 002C","E01025456","Total",19,4,7,8,3,0,1,2,16,4,6,6
"2011","South Ribble 002D","E01025458","Total",57,20,20,17,6,0,6,0,51,20,14,17
"2011","South Ribble 003A","E01025408","Total",21,7,13,1,1,0,1,0,20,7,12,1
"2011","South Ribble 003B","E01025409","Total",31,10,12,9,4,0,3,1,27,10,9,8
"2011","South Ribble 003C","E01025410","Total",23,9,13,1,6,0,6,0,17,9,7,1
"2011","South Ribble 003D","E01025467","Total",37,17,17,3,3,0,3,0,34,17,14,3
"2011","South Ribble 004A","E01025403","Total",40,15,22,3,7,1,5,1,33,14,17,2
"2011","South Ribble 004B","E01025457","Total",32,13,15,4,5,2,3,0,27,11,12,4
"2011","South Ribble 004C","E01025463","Total",40,19,14,7,4,0,1,3,36,19,13,4
"2011","South Ribble 004D","E01025464","Total",11,4,6,1,2,0,2,0,9,4,4,1
"2011","South Ribble 004E","E01025465","Total",28,16,7,5,4,1,3,0,24,15,4,5
"2011","South Ribble 005A","E01025411","Total",61,22,24,15,6,0,3,3,55,22,21,12
"2011","South Ribble 005B","E01025448","Total",38,12,16,10,8,0,4,4,30,12,12,6
"2011","South Ribble 005C","E01025449","Total",15,5,8,2,3,0,3,0,12,5,5,2
"2011","South Ribble 005D","E01025450","Total",50,17,12,21,7,1,3,3,43,16,9,18
"2011","South Ribble 006A","E01025412","Total",42,16,17,9,9,1,6,2,33,15,11,7
"2011","South Ribble 006B","E01025427","Total",50,15,16,19,10,1,5,4,40,14,11,15
"2011","South Ribble 006C","E01025428","Total",58,22,14,22,7,0,3,4,51,22,11,18
"2011","South Ribble 006D","E01025429","Total",104,33,32,39,15,0,13,2,89,33,19,37
"2011","South Ribble 007A","E01025404","Total",14,8,6,0,0,0,0,0,14,8,6,0
"2011","South Ribble 007B","E01025405","Total",35,10,11,14,5,0,4,1,30,10,7,13
"2011","South Ribble 007C","E01025406","Total",31,12,13,6,5,2,3,0,26,10,10,6
"2011","South Ribble 007D","E01025407","Total",110,40,34,36,16,5,5,6,94,35,29,30
"2011","South Ribble 008A","E01025399","Total",99,31,33,35,10,1,7,2,89,30,26,33
"2011","South Ribble 008B","E01025400","Total",60,18,25,17,4,1,3,0,56,17,22,17
"2011","South Ribble 008C","E01025401","Total",28,13,10,5,5,0,3,2,23,13,7,3
"2011","South Ribble 008D","E01025402","Total",55,20,16,19,6,2,4,0,49,18,12,19
"2011","South Ribble 009A","E01025442","Total",50,20,8,22,5,1,2,2,45,19,6,20
"2011","South Ribble 009B","E01025443","Total",31,8,12,11,3,0,3,0,28,8,9,11
"2011","South Ribble 009C","E01025444","Total",35,8,16,11,8,0,6,2,27,8,10,9
"2011","South Ribble 009D","E01025461","Total",33,12,16,5,6,1,4,1,27,11,12,4
"2011","South Ribble 009E","E01025462","Total",38,11,21,6,5,0,4,1,33,11,17,5
"2011","South Ribble 010A","E01025439","Total",21,11,8,2,2,0,2,0,19,11,6,2
"2011","South Ribble 010B","E01025453","Total",40,13,18,9,7,2,4,1,33,11,14,8
"2011","South Ribble 010C","E01025454","Total",17,3,12,2,2,0,2,0,15,3,10,2
"2011","South Ribble 010D","E01025455","Total",16,5,3,8,1,0,0,1,15,5,3,7
"2011","South Ribble 011A","E01025436","Total",39,15,18,6,6,1,5,0,33,14,13,6
"2011","South Ribble 011B","E01025437","Total",46,18,18,10,6,0,4,2,40,18,14,8
"2011","South Ribble 011C","E01025438","Total",22,5,14,3,4,0,4,0,18,5,10,3
"2011","South Ribble 011D","E01025440","Total",17,8,4,5,3,0,3,0,14,8,1,5
"2011","South Ribble 011E","E01025441","Total",25,11,10,4,3,1,2,0,22,10,8,4
"2011","South Ribble 012A","E01025417","Total",29,8,14,7,1,0,1,0,28,8,13,7
"2011","South Ribble 012B","E01025418","Total",52,17,29,6,8,0,8,0,44,17,21,6
"2011","South Ribble 012C","E01025419","Total",45,17,16,12,5,0,4,1,40,17,12,11
"2011","South Ribble 012D","E01025420","Total",47,15,23,9,8,0,8,0,39,15,15,9
"2011","South Ribble 013A","E01025421","Total",87,30,27,30,11,2,5,4,76,28,22,26
"2011","South Ribble 013B","E01025422","Total",55,21,17,17,9,0,6,3,46,21,11,14
"2011","South Ribble 013C","E01025431","Total",69,31,17,21,5,2,2,1,64,29,15,20
"2011","South Ribble 013D","E01025433","Total",59,22,20,17,6,0,4,2,53,22,16,15
"2011","South Ribble 014A","E01025416","Total",29,3,14,12,8,0,5,3,21,3,9,9
"2011","South Ribble 014B","E01025451","Total",36,9,21,6,4,0,4,0,32,9,17,6
"2011","South Ribble 014C","E01025452","Total",97,39,24,34,11,1,5,5,86,38,19,29
"2011","South Ribble 015A","E01025415","Total",66,25,19,22,12,2,6,4,54,23,13,18
"2011","South Ribble 015B","E01025423","Total",94,36,19,39,9,2,3,4,85,34,16,35
"2011","South Ribble 015C","E01025435","Total",37,12,13,12,6,1,1,4,31,11,12,8
"2011","South Ribble 015D","E01025446","Total",36,12,17,7,7,0,6,1,29,12,11,6
"2011","South Ribble 016A","E01025430","Total",71,27,35,9,6,0,6,0,65,27,29,9
"2011","South Ribble 016C","E01025434","Total",15,4,7,4,3,0,1,2,12,4,6,2
"2011","South Ribble 016D","E01032928","Total",81,31,28,22,4,0,2,2,77,31,26,20
"2011","South Ribble 016E","E01032929","Total",29,11,9,9,4,0,4,0,25,11,5,9
"2011","South Ribble 017A","E01025445","Total",99,31,12,56,12,2,4,6,87,29,8,50
"2011","South Ribble 017B","E01025447","Total",82,27,13,42,7,0,4,3,75,27,9,39
"2011","South Ribble 017C","E01025459","Total",58,20,23,15,14,1,11,2,44,19,12,13
"2011","South Ribble 017D","E01025460","Total",80,23,19,38,12,1,3,8,68,22,16,30
"2011","West Lancashire 001A","E01025496","Total",26,14,6,6,1,0,1,0,25,14,5,6
"2011","West Lancashire 001B","E01025497","Total",32,14,16,2,4,0,4,0,28,14,12,2
"2011","West Lancashire 001C","E01025498","Total",24,12,6,6,1,0,1,0,23,12,5,6
"2011","West Lancashire 001D","E01025530","Total",24,10,13,1,3,0,3,0,21,10,10,1
"2011","West Lancashire 001E","E01025532","Total",27,14,8,5,5,1,2,2,22,13,6,3
"2011","West Lancashire 001F","E01025533","Total",29,13,12,4,5,2,3,0,24,11,9,4
"2011","West Lancashire 002A","E01025507","Total",44,17,15,12,4,0,1,3,40,17,14,9
"2011","West Lancashire 002B","E01025508","Total",32,9,7,16,3,1,1,1,29,8,6,15
"2011","West Lancashire 002C","E01025509","Total",36,17,8,11,1,0,1,0,35,17,7,11
"2011","West Lancashire 002D","E01025513","Total",26,11,9,6,6,0,4,2,20,11,5,4
"2011","West Lancashire 002E","E01025531","Total",16,7,7,2,4,1,3,0,12,6,4,2
"2011","West Lancashire 003A","E01025474","Total",21,8,9,4,1,0,0,1,20,8,9,3
"2011","West Lancashire 003B","E01025495","Total",22,7,11,4,4,0,4,0,18,7,7,4
"2011","West Lancashire 003C","E01025514","Total",33,10,12,11,6,1,3,2,27,9,9,9
"2011","West Lancashire 003D","E01025515","Total",17,9,5,3,0,0,0,0,17,9,5,3
"2011","West Lancashire 004A","E01025483","Total",78,32,18,28,8,1,6,1,70,31,12,27
"2011","West Lancashire 004B","E01025484","Total",35,13,17,5,10,0,10,0,25,13,7,5
"2011","West Lancashire 004C","E01025485","Total",38,18,10,10,5,1,3,1,33,17,7,9
"2011","West Lancashire 004D","E01025486","Total",49,19,18,12,10,0,9,1,39,19,9,11
"2011","West Lancashire 004E","E01025487","Total",44,17,15,12,3,0,3,0,41,17,12,12
"2011","West Lancashire 005A","E01025510","Total",16,5,6,5,3,0,3,0,13,5,3,5
"2011","West Lancashire 005B","E01025511","Total",14,7,3,4,1,0,1,0,13,7,2,4
"2011","West Lancashire 005C","E01025512","Total",38,13,21,4,4,0,4,0,34,13,17,4
"2011","West Lancashire 005D","E01025538","Total",14,6,4,4,2,0,2,0,12,6,2,4
"2011","West Lancashire 005E","E01025539","Total",29,11,12,6,3,0,3,0,26,11,9,6
"2011","West Lancashire 006A","E01025499","Total",31,14,10,7,2,1,1,0,29,13,9,7
"2011","West Lancashire 006B","E01025501","Total",12,4,7,1,2,0,2,0,10,4,5,1
"2011","West Lancashire 006C","E01025502","Total",26,8,12,6,2,0,2,0,24,8,10,6
"2011","West Lancashire 006D","E01025516","Total",35,18,9,8,6,0,4,2,29,18,5,6
"2011","West Lancashire 006E","E01025517","Total",52,22,10,20,4,0,2,2,48,22,8,18
"2011","West Lancashire 006F","E01025519","Total",20,10,8,2,1,0,1,0,19,10,7,2
"2011","West Lancashire 007A","E01025488","Total",26,10,5,11,0,0,0,0,26,10,5,11
"2011","West Lancashire 007B","E01025489","Total",24,9,12,3,2,0,2,0,22,9,10,3
"2011","West Lancashire 007C","E01025490","Total",26,10,9,7,4,4,0,0,22,6,9,7
"2011","West Lancashire 007D","E01025500","Total",38,21,6,11,4,1,1,2,34,20,5,9
"2011","West Lancashire 007E","E01025518","Total",39,19,10,10,3,0,1,2,36,19,9,8
"2011","West Lancashire 008A","E01025479","Total",28,10,10,8,4,0,0,4,24,10,10,4
"2011","West Lancashire 008B","E01025491","Total",17,9,6,2,3,3,0,0,14,6,6,2
"2011","West Lancashire 008C","E01025506","Total",22,8,10,4,4,1,2,1,18,7,8,3
"2011","West Lancashire 009A","E01025468","Total",43,18,19,6,9,0,9,0,34,18,10,6
"2011","West Lancashire 009B","E01025469","Total",45,13,15,17,6,1,3,2,39,12,12,15
"2011","West Lancashire 009C","E01025470","Total",26,9,11,6,3,1,2,0,23,8,9,6
"2011","West Lancashire 009D","E01025522","Total",30,8,7,15,4,0,3,1,26,8,4,14
"2011","West Lancashire 010A","E01025471","Total",99,33,20,46,5,1,1,3,94,32,19,43
"2011","West Lancashire 010B","E01025480","Total",91,24,26,41,9,2,4,3,82,22,22,38
"2011","West Lancashire 010C","E01025481","Total",85,23,13,49,8,1,2,5,77,22,11,44
"2011","West Lancashire 010D","E01025482","Total",103,31,10,62,9,2,0,7,94,29,10,55
"2011","West Lancashire 010E","E01025520","Total",61,22,15,24,10,2,6,2,51,20,9,22
"2011","West Lancashire 010F","E01025521","Total",104,29,25,50,13,0,10,3,91,29,15,47
"2011","West Lancashire 011A","E01025523","Total",76,24,26,26,8,0,4,4,68,24,22,22
"2011","West Lancashire 011B","E01025524","Total",72,23,15,34,7,2,1,4,65,21,14,30
"2011","West Lancashire 011C","E01025525","Total",57,22,16,19,6,1,3,2,51,21,13,17
"2011","West Lancashire 011D","E01025526","Total",58,26,13,19,4,2,2,0,54,24,11,19
"2011","West Lancashire 012A","E01025472","Total",15,3,6,6,1,0,1,0,14,3,5,6
"2011","West Lancashire 012B","E01025473","Total",34,17,8,9,5,2,2,1,29,15,6,8
"2011","West Lancashire 012C","E01025475","Total",23,7,12,4,2,0,2,0,21,7,10,4
"2011","West Lancashire 012D","E01025476","Total",20,8,9,3,4,1,3,0,16,7,6,3
"2011","West Lancashire 012E","E01025477","Total",17,9,5,3,0,0,0,0,17,9,5,3
"2011","West Lancashire 012F","E01025478","Total",17,2,10,5,3,0,3,0,14,2,7,5
"2011","West Lancashire 013A","E01025492","Total",50,13,15,22,1,0,1,0,49,13,14,22
"2011","West Lancashire 013B","E01025527","Total",82,27,15,40,5,0,3,2,77,27,12,38
"2011","West Lancashire 013C","E01025528","Total",162,38,27,97,25,3,8,14,137,35,19,83
"2011","West Lancashire 013D","E01025529","Total",120,40,25,55,17,3,9,5,103,37,16,50
"2011","West Lancashire 014A","E01025493","Total",180,46,29,105,23,0,9,14,157,46,20,91
"2011","West Lancashire 014B","E01025494","Total",106,16,13,77,11,2,5,4,95,14,8,73
"2011","West Lancashire 014C","E01025503","Total",106,35,16,55,8,0,4,4,98,35,12,51
"2011","West Lancashire 014D","E01025504","Total",101,31,15,55,11,2,3,6,90,29,12,49
"2011","West Lancashire 014E","E01025505","Total",79,32,22,25,13,0,7,6,66,32,15,19
"2011","West Lancashire 015A","E01025534","Total",26,11,10,5,3,2,1,0,23,9,9,5
"2011","West Lancashire 015B","E01025535","Total",29,15,3,11,2,0,1,1,27,15,2,10
"2011","West Lancashire 015C","E01025536","Total",60,13,15,32,10,0,4,6,50,13,11,26
"2011","West Lancashire 015D","E01025537","Total",34,8,14,12,5,0,3,2,29,8,11,10
"2011","West Lancashire 015E","E01025540","Total",15,9,2,4,1,0,0,1,14,9,2,3
"2011","Wyre 001A","E01025573","Total",34,17,11,6,3,0,2,1,31,17,9,5
"2011","Wyre 001B","E01025574","Total",83,33,16,34,6,1,4,1,77,32,12,33
"2011","Wyre 001C","E01025581","Total",55,26,12,17,4,1,2,1,51,25,10,16
"2011","Wyre 001D","E01025582","Total",65,25,10,30,6,3,2,1,59,22,8,29
"2011","Wyre 001E","E01025583","Total",59,20,14,25,7,0,3,4,52,20,11,21
"2011","Wyre 001F","E01025584","Total",41,16,10,15,7,2,3,2,34,14,7,13
"2011","Wyre 002A","E01025605","Total",21,9,8,4,3,0,3,0,18,9,5,4
"2011","Wyre 002B","E01025606","Total",79,26,10,43,7,3,1,3,72,23,9,40
"2011","Wyre 002C","E01025607","Total",20,7,9,4,0,0,0,0,20,7,9,4
"2011","Wyre 002D","E01025608","Total",38,20,10,8,2,0,2,0,36,20,8,8
"2011","Wyre 003A","E01025590","Total",102,27,20,55,8,0,3,5,94,27,17,50
"2011","Wyre 003B","E01025591","Total",20,9,6,5,3,0,2,1,17,9,4,4
"2011","Wyre 003C","E01025592","Total",120,19,24,77,8,0,6,2,112,19,18,75
"2011","Wyre 003D","E01025593","Total",15,4,3,8,3,2,1,0,12,2,2,8
"2011","Wyre 004A","E01025563","Total",11,5,4,2,0,0,0,0,11,5,4,2
"2011","Wyre 004B","E01025564","Total",39,19,10,10,1,0,1,0,38,19,9,10
"2011","Wyre 004C","E01025565","Total",15,4,8,3,1,0,1,0,14,4,7,3
"2011","Wyre 004D","E01025586","Total",27,12,9,6,3,2,1,0,24,10,8,6
"2011","Wyre 004E","E01025587","Total",29,13,9,7,6,2,3,1,23,11,6,6
"2011","Wyre 004F","E01025588","Total",14,4,5,5,2,0,1,1,12,4,4,4
"2011","Wyre 004G","E01025589","Total",25,10,11,4,3,1,1,1,22,9,10,3
"2011","Wyre 005A","E01025557","Total",39,10,16,13,3,1,1,1,36,9,15,12
"2011","Wyre 005B","E01025575","Total",65,18,7,40,4,1,0,3,61,17,7,37
"2011","Wyre 005C","E01025578","Total",67,21,14,32,8,1,3,4,59,20,11,28
"2011","Wyre 005D","E01025579","Total",84,23,17,44,10,1,4,5,74,22,13,39
"2011","Wyre 005E","E01025580","Total",20,8,7,5,2,0,1,1,18,8,6,4
"2011","Wyre 006A","E01025547","Total",18,7,9,2,4,1,3,0,14,6,6,2
"2011","Wyre 006B","E01025549","Total",38,16,18,4,2,0,1,1,36,16,17,3
"2011","Wyre 006C","E01025609","Total",36,15,11,10,6,0,4,2,30,15,7,8
"2011","Wyre 007A","E01025548","Total",17,7,8,2,0,0,0,0,17,7,8,2
"2011","Wyre 007B","E01025553","Total",48,16,23,9,7,1,6,0,41,15,17,9
"2011","Wyre 007C","E01025558","Total",16,7,8,1,2,0,2,0,14,7,6,1
"2011","Wyre 007D","E01025559","Total",34,17,10,7,1,0,1,0,33,17,9,7
"2011","Wyre 007E","E01025560","Total",13,9,1,3,1,0,0,1,12,9,1,2
"2011","Wyre 008A","E01025554","Total",30,11,9,10,5,1,3,1,25,10,6,9
"2011","Wyre 008B","E01025556","Total",43,13,8,22,1,0,1,0,42,13,7,22
"2011","Wyre 008C","E01025570","Total",30,8,10,12,8,1,3,4,22,7,7,8
"2011","Wyre 008D","E01025571","Total",70,32,10,28,12,3,4,5,58,29,6,23
"2011","Wyre 008E","E01025572","Total",13,6,4,3,2,0,1,1,11,6,3,2
"2011","Wyre 008F","E01025604","Total",40,17,9,14,7,2,3,2,33,15,6,12
"2011","Wyre 009A","E01025561","Total",14,6,5,3,1,0,1,0,13,6,4,3
"2011","Wyre 009B","E01025562","Total",32,12,15,5,2,1,1,0,30,11,14,5
"2011","Wyre 009C","E01025585","Total",34,10,13,11,7,1,5,1,27,9,8,10
"2011","Wyre 010A","E01025542","Total",32,12,9,11,3,1,1,1,29,11,8,10
"2011","Wyre 010B","E01025555","Total",22,8,6,8,2,0,1,1,20,8,5,7
"2011","Wyre 010C","E01025601","Total",12,7,3,2,1,0,0,1,11,7,3,1
"2011","Wyre 010D","E01025602","Total",47,22,17,8,5,1,4,0,42,21,13,8
"2011","Wyre 010E","E01025603","Total",37,13,11,13,5,0,3,2,32,13,8,11
"2011","Wyre 011A","E01025541","Total",62,30,13,19,8,2,2,4,54,28,11,15
"2011","Wyre 011B","E01025543","Total",75,21,25,29,4,1,2,1,71,20,23,28
"2011","Wyre 011C","E01025544","Total",60,20,17,23,5,1,2,2,55,19,15,21
"2011","Wyre 011D","E01025576","Total",57,22,18,17,3,1,1,1,54,21,17,16
"2011","Wyre 011E","E01025577","Total",49,24,9,16,7,0,5,2,42,24,4,14
"2011","Wyre 012A","E01025550","Total",17,7,9,1,3,0,3,0,14,7,6,1
"2011","Wyre 012B","E01025552","Total",13,7,5,1,0,0,0,0,13,7,5,1
"2011","Wyre 012C","E01025594","Total",35,12,11,12,4,1,0,3,31,11,11,9
"2011","Wyre 012D","E01025595","Total",15,8,3,4,2,1,1,0,13,7,2,4
"2011","Wyre 012E","E01025596","Total",51,15,25,11,9,1,6,2,42,14,19,9
"2011","Wyre 012F","E01025597","Total",34,18,11,5,1,0,1,0,33,18,10,5
"2011","Wyre 013A","E01025545","Total",28,9,14,5,4,0,4,0,24,9,10,5
"2011","Wyre 013B","E01025546","Total",60,22,19,19,5,0,3,2,55,22,16,17
"2011","Wyre 013C","E01025551","Total",23,13,8,2,2,0,2,0,21,13,6,2
"2011","Wyre 013D","E01025567","Total",57,26,19,12,7,2,3,2,50,24,16,10
"2011","Wyre 013E","E01025598","Total",42,19,17,6,5,1,3,1,37,18,14,5
"2011","Wyre 014A","E01025566","Total",18,10,6,2,1,0,1,0,17,10,5,2
"2011","Wyre 014B","E01025568","Total",44,19,14,11,0,0,0,0,44,19,14,11
"2011","Wyre 014C","E01025569","Total",29,18,6,5,3,0,3,0,26,18,3,5
"2011","Wyre 014D","E01025599","Total",17,5,9,3,2,0,2,0,15,5,7,3
"2011","Wyre 014E","E01025600","Total",28,17,8,3,5,0,4,1,23,17,4,2
"2011","Knowsley 001A","E01006448","Total",149,41,17,91,7,1,2,4,142,40,15,87
"2011","Knowsley 001B","E01006492","Total",66,27,9,30,2,0,1,1,64,27,8,29
"2011","Knowsley 001C","E01006493","Total",90,21,8,61,3,0,1,2,87,21,7,59
"2011","Knowsley 001D","E01006494","Total",132,20,8,104,4,0,0,4,128,20,8,100
"2011","Knowsley 001E","E01006495","Total",134,27,26,81,11,2,1,8,123,25,25,73
"2011","Knowsley 002A","E01006454","Total",30,10,7,13,6,1,3,2,24,9,4,11
"2011","Knowsley 002B","E01006456","Total",42,18,11,13,6,2,2,2,36,16,9,11
"2011","Knowsley 002C","E01006457","Total",15,5,6,4,2,0,2,0,13,5,4,4
"2011","Knowsley 002D","E01006458","Total",69,27,8,34,4,0,0,4,65,27,8,30
"2011","Knowsley 002E","E01006490","Total",144,43,55,46,14,0,10,4,130,43,45,42
"2011","Knowsley 002F","E01006491","Total",76,26,25,25,5,0,3,2,71,26,22,23
"2011","Knowsley 003A","E01006415","Total",124,35,30,59,14,1,7,6,110,34,23,53
"2011","Knowsley 003B","E01006417","Total",83,23,9,51,9,1,0,8,74,22,9,43
"2011","Knowsley 003C","E01006436","Total",86,29,8,49,6,0,1,5,80,29,7,44
"2011","Knowsley 003D","E01006437","Total",78,23,8,47,3,0,1,2,75,23,7,45
"2011","Knowsley 003E","E01006447","Total",88,27,16,45,5,2,1,2,83,25,15,43
"2011","Knowsley 004A","E01006455","Total",138,39,19,80,13,2,7,4,125,37,12,76
"2011","Knowsley 004B","E01006506","Total",72,27,13,32,4,2,1,1,68,25,12,31
"2011","Knowsley 004C","E01006507","Total",115,47,14,54,5,1,0,4,110,46,14,50
"2011","Knowsley 004D","E01006508","Total",64,19,19,26,8,1,3,4,56,18,16,22
"2011","Knowsley 004E","E01006509","Total",131,31,18,82,7,0,0,7,124,31,18,75
"2011","Knowsley 004F","E01006510","Total",34,14,10,10,2,0,2,0,32,14,8,10
"2011","Knowsley 005A","E01006416","Total",122,28,26,68,5,0,2,3,117,28,24,65
"2011","Knowsley 005B","E01006418","Total",79,18,10,51,6,2,1,3,73,16,9,48
"2011","Knowsley 005C","E01006434","Total",125,37,18,70,9,2,3,4,116,35,15,66
"2011","Knowsley 005D","E01006435","Total",100,28,15,57,5,0,2,3,95,28,13,54
"2011","Knowsley 005E","E01006438","Total",23,9,3,11,1,0,1,0,22,9,2,11
"2011","Knowsley 005F","E01006439","Total",69,25,10,34,5,1,3,1,64,24,7,33
"2011","Knowsley 005G","E01006446","Total",86,26,12,48,2,1,1,0,84,25,11,48
"2011","Knowsley 006A","E01006412","Total",112,33,16,63,2,0,0,2,110,33,16,61
"2011","Knowsley 006B","E01006413","Total",98,26,15,57,8,0,4,4,90,26,11,53
"2011","Knowsley 006C","E01006414","Total",88,32,18,38,4,0,2,2,84,32,16,36
"2011","Knowsley 006D","E01006441","Total",93,27,28,38,6,0,5,1,87,27,23,37
"2011","Knowsley 007A","E01006460","Total",124,34,16,74,11,1,4,6,113,33,12,68
"2011","Knowsley 007B","E01006461","Total",99,34,18,47,4,1,1,2,95,33,17,45
"2011","Knowsley 007C","E01006463","Total",93,24,22,47,14,0,6,8,79,24,16,39
"2011","Knowsley 007D","E01006464","Total",40,5,17,18,9,0,6,3,31,5,11,15
"2011","Knowsley 007E","E01006466","Total",61,14,20,27,5,0,3,2,56,14,17,25
"2011","Knowsley 008A","E01006453","Total",121,39,19,63,11,0,4,7,110,39,15,56
"2011","Knowsley 008B","E01006467","Total",133,27,18,88,14,1,3,10,119,26,15,78
"2011","Knowsley 008E","E01006470","Total",92,22,22,48,8,0,2,6,84,22,20,42
"2011","Knowsley 008F","E01033228","Total",184,58,21,105,17,2,3,12,167,56,18,93
"2011","Knowsley 009A","E01006459","Total",62,16,20,26,2,0,1,1,60,16,19,25
"2011","Knowsley 009B","E01006462","Total",41,15,14,12,3,2,1,0,38,13,13,12
"2011","Knowsley 009C","E01006496","Total",41,17,10,14,0,0,0,0,41,17,10,14
"2011","Knowsley 009D","E01006498","Total",26,5,16,5,1,0,1,0,25,5,15,5
"2011","Knowsley 009E","E01006499","Total",54,23,10,21,0,0,0,0,54,23,10,21
"2011","Knowsley 010A","E01006440","Total",121,27,19,75,7,0,1,6,114,27,18,69
"2011","Knowsley 010B","E01006442","Total",105,34,9,62,3,0,2,1,102,34,7,61
"2011","Knowsley 010C","E01006443","Total",92,24,14,54,5,1,2,2,87,23,12,52
"2011","Knowsley 010D","E01006444","Total",100,29,11,60,2,1,0,1,98,28,11,59
"2011","Knowsley 010E","E01006445","Total",100,27,9,64,2,1,0,1,98,26,9,63
"2011","Knowsley 011A","E01006465","Total",30,17,10,3,5,0,5,0,25,17,5,3
"2011","Knowsley 011B","E01006482","Total",97,23,18,56,7,2,3,2,90,21,15,54
"2011","Knowsley 011C","E01006483","Total",81,25,15,41,4,1,1,2,77,24,14,39
"2011","Knowsley 011D","E01006484","Total",81,29,17,35,8,1,7,0,73,28,10,35
"2011","Knowsley 012A","E01006449","Total",58,23,11,24,10,1,6,3,48,22,5,21
"2011","Knowsley 012B","E01006450","Total",118,34,16,68,6,2,1,3,112,32,15,65
"2011","Knowsley 012C","E01006451","Total",80,22,17,41,6,1,3,2,74,21,14,39
"2011","Knowsley 012D","E01006452","Total",71,28,13,30,3,0,1,2,68,28,12,28
"2011","Knowsley 013A","E01006497","Total",31,9,11,11,5,0,3,2,26,9,8,9
"2011","Knowsley 013B","E01006500","Total",44,11,9,24,3,0,1,2,41,11,8,22
"2011","Knowsley 013C","E01006501","Total",80,39,18,23,2,0,1,1,78,39,17,22
"2011","Knowsley 013D","E01006504","Total",80,17,13,50,9,0,0,9,71,17,13,41
"2011","Knowsley 013E","E01006505","Total",106,30,19,57,7,0,3,4,99,30,16,53
"2011","Knowsley 014A","E01006472","Total",28,8,9,11,6,0,3,3,22,8,6,8
"2011","Knowsley 014B","E01006485","Total",59,27,19,13,3,0,3,0,56,27,16,13
"2011","Knowsley 014C","E01006486","Total",23,15,5,3,1,0,1,0,22,15,4,3
"2011","Knowsley 014D","E01006487","Total",40,16,12,12,1,0,1,0,39,16,11,12
"2011","Knowsley 014E","E01006488","Total",32,17,7,8,2,0,1,1,30,17,6,7
"2011","Knowsley 014F","E01006489","Total",44,17,13,14,8,2,3,3,36,15,10,11
"2011","Knowsley 015A","E01006477","Total",75,31,16,28,4,1,2,1,71,30,14,27
"2011","Knowsley 015B","E01006478","Total",80,29,12,39,6,0,2,4,74,29,10,35
"2011","Knowsley 015C","E01006479","Total",81,30,20,31,4,0,4,0,77,30,16,31
"2011","Knowsley 015D","E01006480","Total",85,16,11,58,5,0,0,5,80,16,11,53
"2011","Knowsley 015E","E01006481","Total",57,23,12,22,4,0,2,2,53,23,10,20
"2011","Knowsley 016A","E01006471","Total",41,17,11,13,4,0,2,2,37,17,9,11
"2011","Knowsley 016B","E01006473","Total",30,11,13,6,0,0,0,0,30,11,13,6
"2011","Knowsley 016C","E01006474","Total",23,9,7,7,1,0,0,1,22,9,7,6
"2011","Knowsley 016D","E01006475","Total",18,4,9,5,0,0,0,0,18,4,9,5
"2011","Knowsley 016E","E01006476","Total",18,7,9,2,4,1,3,0,14,6,6,2
"2011","Knowsley 017A","E01006420","Total",55,23,20,12,6,0,6,0,49,23,14,12
"2011","Knowsley 017B","E01006424","Total",42,18,9,15,7,1,3,3,35,17,6,12
"2011","Knowsley 017C","E01006502","Total",47,18,13,16,3,0,1,2,44,18,12,14
"2011","Knowsley 017D","E01006503","Total",17,9,6,2,3,1,2,0,14,8,4,2
"2011","Knowsley 018A","E01006421","Total",33,13,11,9,5,1,4,0,28,12,7,9
"2011","Knowsley 018B","E01006425","Total",42,17,13,12,3,0,0,3,39,17,13,9
"2011","Knowsley 018C","E01006430","Total",77,29,17,31,6,0,2,4,71,29,15,27
"2011","Knowsley 018D","E01006433","Total",57,22,13,22,3,0,1,2,54,22,12,20
"2011","Knowsley 019A","E01006419","Total",57,24,19,14,7,3,4,0,50,21,15,14
"2011","Knowsley 019B","E01006422","Total",29,8,8,13,3,0,3,0,26,8,5,13
"2011","Knowsley 019C","E01006423","Total",33,5,16,12,3,0,1,2,30,5,15,10
"2011","Knowsley 019D","E01006427","Total",33,15,13,5,3,0,3,0,30,15,10,5
"2011","Knowsley 020A","E01006426","Total",82,24,16,42,1,0,1,0,81,24,15,42
"2011","Knowsley 020B","E01006428","Total",77,23,16,38,1,0,0,1,76,23,16,37
"2011","Knowsley 020C","E01006429","Total",91,26,14,51,3,0,1,2,88,26,13,49
"2011","Knowsley 020D","E01006431","Total",76,18,33,25,8,2,6,0,68,16,27,25
"2011","Knowsley 020E","E01006432","Total",96,35,18,43,8,2,4,2,88,33,14,41
"2011","Liverpool 001A","E01006651","Total",60,26,20,14,5,0,5,0,55,26,15,14
"2011","Liverpool 001B","E01006653","Total",71,19,15,37,2,0,0,2,69,19,15,35
"2011","Liverpool 001C","E01006655","Total",74,31,21,22,4,2,1,1,70,29,20,21
"2011","Liverpool 001D","E01006658","Total",95,46,13,36,3,2,1,0,92,44,12,36
"2011","Liverpool 001E","E01006660","Total",57,21,11,25,6,0,2,4,51,21,9,21
"2011","Liverpool 002A","E01006652","Total",71,30,15,26,6,3,3,0,65,27,12,26
"2011","Liverpool 002B","E01006656","Total",80,24,23,33,3,0,2,1,77,24,21,32
"2011","Liverpool 002C","E01006657","Total",70,19,15,36,2,1,1,0,68,18,14,36
"2011","Liverpool 002D","E01006780","Total",61,18,21,22,8,0,5,3,53,18,16,19
"2011","Liverpool 002E","E01006783","Total",83,28,21,34,4,1,2,1,79,27,19,33
"2011","Liverpool 003A","E01006781","Total",44,23,11,10,2,1,0,1,42,22,11,9
"2011","Liverpool 003B","E01006782","Total",75,23,33,19,3,0,3,0,72,23,30,19
"2011","Liverpool 003C","E01006784","Total",49,22,10,17,4,1,3,0,45,21,7,17
"2011","Liverpool 003D","E01006785","Total",86,19,26,41,13,0,7,6,73,19,19,35
"2011","Liverpool 003E","E01006786","Total",55,21,18,16,2,0,2,0,53,21,16,16
"2011","Liverpool 004A","E01006661","Total",99,31,15,53,1,0,1,0,98,31,14,53
"2011","Liverpool 004B","E01006662","Total",87,31,12,44,5,1,1,3,82,30,11,41
"2011","Liverpool 004C","E01006663","Total",66,28,13,25,1,0,1,0,65,28,12,25
"2011","Liverpool 004D","E01006664","Total",123,34,23,66,15,0,5,10,108,34,18,56
"2011","Liverpool 004E","E01006669","Total",47,18,17,12,3,0,1,2,44,18,16,10
"2011","Liverpool 005A","E01006654","Total",60,17,21,22,7,3,3,1,53,14,18,21
"2011","Liverpool 005B","E01006659","Total",69,20,12,37,9,0,3,6,60,20,9,31
"2011","Liverpool 005C","E01006734","Total",151,47,17,87,18,6,3,9,133,41,14,78
"2011","Liverpool 005D","E01006735","Total",93,30,11,52,7,0,4,3,86,30,7,49
"2011","Liverpool 005E","E01006736","Total",95,26,15,54,3,0,2,1,92,26,13,53
"2011","Liverpool 005F","E01006737","Total",87,25,16,46,3,0,1,2,84,25,15,44
"2011","Liverpool 006A","E01006787","Total",72,22,18,32,16,2,5,9,56,20,13,23
"2011","Liverpool 006B","E01006788","Total",98,29,24,45,10,2,3,5,88,27,21,40
"2011","Liverpool 006C","E01006790","Total",148,57,18,73,4,0,2,2,144,57,16,71
"2011","Liverpool 006D","E01006791","Total",91,31,14,46,5,0,2,3,86,31,12,43
"2011","Liverpool 007A","E01006665","Total",61,32,15,14,4,1,3,0,57,31,12,14
"2011","Liverpool 007B","E01006666","Total",44,19,17,8,4,0,2,2,40,19,15,6
"2011","Liverpool 007C","E01006667","Total",69,25,17,27,2,0,2,0,67,25,15,27
"2011","Liverpool 007D","E01006668","Total",63,31,16,16,7,1,4,2,56,30,12,14
"2011","Liverpool 007E","E01006670","Total",71,27,23,21,11,2,4,5,60,25,19,16
"2011","Liverpool 008A","E01006607","Total",113,35,17,61,8,1,6,1,105,34,11,60
"2011","Liverpool 008B","E01006612","Total",92,30,13,49,3,0,1,2,89,30,12,47
"2011","Liverpool 008C","E01006729","Total",130,49,20,61,8,1,4,3,122,48,16,58
"2011","Liverpool 008F","E01032510","Total",76,33,17,26,1,0,0,1,75,33,17,25
"2011","Liverpool 008G","E01032511","Total",71,15,13,43,7,0,4,3,64,15,9,40
"2011","Liverpool 009A","E01006608","Total",67,23,16,28,5,0,3,2,62,23,13,26
"2011","Liverpool 009B","E01006609","Total",74,21,9,44,5,2,1,2,69,19,8,42
"2011","Liverpool 009C","E01006610","Total",114,28,19,67,3,0,1,2,111,28,18,65
"2011","Liverpool 009D","E01006613","Total",55,18,9,28,1,0,0,1,54,18,9,27
"2011","Liverpool 009E","E01006705","Total",91,31,13,47,8,2,3,3,83,29,10,44
"2011","Liverpool 010A","E01006598","Total",106,24,24,58,5,0,2,3,101,24,22,55
"2011","Liverpool 010B","E01006599","Total",118,32,17,69,7,0,3,4,111,32,14,65
"2011","Liverpool 010E","E01006672","Total",138,33,20,85,8,1,1,6,130,32,19,79
"2011","Liverpool 010F","E01033759","Total",77,20,16,41,5,0,3,2,72,20,13,39
"2011","Liverpool 011A","E01006600","Total",76,28,13,35,6,1,1,4,70,27,12,31
"2011","Liverpool 011B","E01006603","Total",69,24,14,31,5,1,1,3,64,23,13,28
"2011","Liverpool 011C","E01006730","Total",88,31,14,43,6,1,2,3,82,30,12,40
"2011","Liverpool 011D","E01006731","Total",70,15,7,48,5,0,0,5,65,15,7,43
"2011","Liverpool 011E","E01006732","Total",150,47,20,83,3,0,1,2,147,47,19,81
"2011","Liverpool 012A","E01006611","Total",112,34,16,62,9,0,2,7,103,34,14,55
"2011","Liverpool 012B","E01006614","Total",86,20,7,59,8,0,2,6,78,20,5,53
"2011","Liverpool 012C","E01006615","Total",124,39,21,64,12,0,1,11,112,39,20,53
"2011","Liverpool 012D","E01006698","Total",123,33,24,66,5,2,1,2,118,31,23,64
"2011","Liverpool 012E","E01006700","Total",87,22,13,52,10,1,3,6,77,21,10,46
"2011","Liverpool 013A","E01006623","Total",26,10,11,5,3,0,3,0,23,10,8,5
"2011","Liverpool 013B","E01006624","Total",71,25,17,29,2,0,1,1,69,25,16,28
"2011","Liverpool 013C","E01006627","Total",40,18,11,11,2,0,2,0,38,18,9,11
"2011","Liverpool 013D","E01006671","Total",53,16,12,25,6,1,4,1,47,15,8,24
"2011","Liverpool 014A","E01006699","Total",142,43,23,76,6,0,1,5,136,43,22,71
"2011","Liverpool 014B","E01006701","Total",74,28,11,35,4,1,1,2,70,27,10,33
"2011","Liverpool 014C","E01006702","Total",130,39,14,77,12,4,1,7,118,35,13,70
"2011","Liverpool 014D","E01006703","Total",83,21,19,43,6,1,1,4,77,20,18,39
"2011","Liverpool 014E","E01006778","Total",160,53,22,85,8,1,2,5,152,52,20,80
"2011","Liverpool 015A","E01006541","Total",83,27,19,37,5,0,2,3,78,27,17,34
"2011","Liverpool 015B","E01006543","Total",35,15,9,11,0,0,0,0,35,15,9,11
"2011","Liverpool 015C","E01006544","Total",130,39,11,80,10,3,3,4,120,36,8,76
"2011","Liverpool 015D","E01006616","Total",58,18,14,26,7,2,5,0,51,16,9,26
"2011","Liverpool 015E","E01006762","Total",107,34,19,54,10,3,5,2,97,31,14,52
"2011","Liverpool 016A","E01006604","Total",65,30,9,26,4,0,2,2,61,30,7,24
"2011","Liverpool 016B","E01006605","Total",73,23,15,35,4,0,0,4,69,23,15,31
"2011","Liverpool 016C","E01006618","Total",53,18,7,28,3,1,0,2,50,17,7,26
"2011","Liverpool 016D","E01006625","Total",55,19,24,12,4,0,3,1,51,19,21,11
"2011","Liverpool 016E","E01006626","Total",27,8,11,8,4,1,2,1,23,7,9,7
"2011","Liverpool 017A","E01006637","Total",155,44,19,92,6,1,1,4,149,43,18,88
"2011","Liverpool 017B","E01006638","Total",103,30,17,56,4,0,3,1,99,30,14,55
"2011","Liverpool 017C","E01006639","Total",86,26,22,38,3,1,1,1,83,25,21,37
"2011","Liverpool 017D","E01006644","Total",119,41,24,54,11,2,3,6,108,39,21,48
"2011","Liverpool 017E","E01006645","Total",115,34,11,70,9,2,0,7,106,32,11,63
"2011","Liverpool 018A","E01006542","Total",71,26,10,35,8,0,0,8,63,26,10,27
"2011","Liverpool 018B","E01006558","Total",99,26,12,61,9,1,3,5,90,25,9,56
"2011","Liverpool 018E","E01006562","Total",134,30,16,88,13,3,1,9,121,27,15,79
"2011","Liverpool 018F","E01033747","Total",72,15,9,48,3,1,0,2,69,14,9,46
"2011","Liverpool 019A","E01006545","Total",117,41,20,56,6,4,2,0,111,37,18,56
"2011","Liverpool 019B","E01006546","Total",94,24,25,45,9,0,7,2,85,24,18,43
"2011","Liverpool 019C","E01006547","Total",97,28,15,54,9,1,5,3,88,27,10,51
"2011","Liverpool 019D","E01006548","Total",141,37,22,82,12,0,6,6,129,37,16,76
"2011","Liverpool 019E","E01006766","Total",99,38,14,47,15,5,2,8,84,33,12,39
"2011","Liverpool 019F","E01006767","Total",112,39,22,51,5,0,2,3,107,39,20,48
"2011","Liverpool 020A","E01006606","Total",88,26,19,43,6,0,4,2,82,26,15,41
"2011","Liverpool 020B","E01006761","Total",85,34,16,35,5,3,1,1,80,31,15,34
"2011","Liverpool 020C","E01006763","Total",97,36,14,47,8,2,2,4,89,34,12,43
"2011","Liverpool 020D","E01006764","Total",88,25,16,47,5,2,3,0,83,23,13,47
"2011","Liverpool 020E","E01006765","Total",90,24,26,40,6,1,3,2,84,23,23,38
"2011","Liverpool 020F","E01006768","Total",37,9,13,15,6,2,3,1,31,7,10,14
"2011","Liverpool 021A","E01006617","Total",55,24,21,10,2,1,1,0,53,23,20,10
"2011","Liverpool 021B","E01006619","Total",52,22,10,20,4,0,1,3,48,22,9,17
"2011","Liverpool 021C","E01006620","Total",34,12,8,14,3,0,0,3,31,12,8,11
"2011","Liverpool 021D","E01006621","Total",21,9,4,8,0,0,0,0,21,9,4,8
"2011","Liverpool 021E","E01006622","Total",25,4,15,6,3,0,3,0,22,4,12,6
"2011","Liverpool 021F","E01006640","Total",56,31,7,18,2,0,1,1,54,31,6,17
"2011","Liverpool 022B","E01006776","Total",83,32,15,36,4,2,0,2,79,30,15,34
"2011","Liverpool 022D","E01006779","Total",168,42,21,105,10,0,0,10,158,42,21,95
"2011","Liverpool 022E","E01033764","Total",138,37,18,83,15,3,2,10,123,34,16,73
"2011","Liverpool 023A","E01006560","Total",119,50,11,58,6,1,0,5,113,49,11,53
"2011","Liverpool 023B","E01006564","Total",70,28,6,36,4,1,0,3,66,27,6,33
"2011","Liverpool 023C","E01006646","Total",100,34,12,54,14,3,2,9,86,31,10,45
"2011","Liverpool 023D","E01006648","Total",105,32,14,59,6,0,2,4,99,32,12,55
"2011","Liverpool 024A","E01006540","Total",119,37,12,70,14,3,2,9,105,34,10,61
"2011","Liverpool 024B","E01006563","Total",123,27,16,80,9,0,0,9,114,27,16,71
"2011","Liverpool 024C","E01006647","Total",136,32,11,93,5,0,0,5,131,32,11,88
"2011","Liverpool 024D","E01006693","Total",48,15,10,23,2,0,1,1,46,15,9,22
"2011","Liverpool 025A","E01006572","Total",96,33,8,55,2,0,0,2,94,33,8,53
"2011","Liverpool 025B","E01006574","Total",77,24,11,42,8,0,2,6,69,24,9,36
"2011","Liverpool 025C","E01006641","Total",73,29,22,22,2,0,1,1,71,29,21,21
"2011","Liverpool 025D","E01006642","Total",105,33,19,53,3,0,2,1,102,33,17,52
"2011","Liverpool 025E","E01006643","Total",141,45,26,70,4,0,1,3,137,45,25,67
"2011","Liverpool 026A","E01006567","Total",65,26,12,27,8,2,3,3,57,24,9,24
"2011","Liverpool 026B","E01006568","Total",71,26,21,24,8,1,6,1,63,25,15,23
"2011","Liverpool 026C","E01006570","Total",56,10,23,23,9,0,6,3,47,10,17,20
"2011","Liverpool 026D","E01006571","Total",72,24,10,38,1,0,1,0,71,24,9,38
"2011","Liverpool 027A","E01006711","Total",88,33,12,43,6,2,1,3,82,31,11,40
"2011","Liverpool 027D","E01006717","Total",57,21,18,18,4,1,2,1,53,20,16,17
"2011","Liverpool 027E","E01006718","Total",59,19,18,22,3,0,3,0,56,19,15,22
"2011","Liverpool 027F","E01006719","Total",83,27,14,42,3,1,1,1,80,26,13,41
"2011","Liverpool 027G","E01032508","Total",105,21,21,63,10,1,5,4,95,20,16,59
"2011","Liverpool 027H","E01032509","Total",106,36,15,55,8,0,1,7,98,36,14,48
"2011","Liverpool 028A","E01006690","Total",81,24,16,41,4,0,2,2,77,24,14,39
"2011","Liverpool 028B","E01006692","Total",110,27,23,60,16,1,9,6,94,26,14,54
"2011","Liverpool 028C","E01006695","Total",82,14,13,55,9,0,1,8,73,14,12,47
"2011","Liverpool 028D","E01006759","Total",51,18,14,19,9,3,1,5,42,15,13,14
"2011","Liverpool 028E","E01006760","Total",50,14,12,24,12,0,1,11,38,14,11,13
"2011","Liverpool 029A","E01006565","Total",55,23,13,19,2,0,2,0,53,23,11,19
"2011","Liverpool 029B","E01006569","Total",44,14,7,23,6,0,2,4,38,14,5,19
"2011","Liverpool 029C","E01006573","Total",99,33,17,49,8,1,3,4,91,32,14,45
"2011","Liverpool 029D","E01006712","Total",70,26,11,33,7,1,4,2,63,25,7,31
"2011","Liverpool 029E","E01006713","Total",67,26,21,20,5,1,3,1,62,25,18,19
"2011","Liverpool 030A","E01006691","Total",95,16,15,64,9,0,5,4,86,16,10,60
"2011","Liverpool 030B","E01006694","Total",134,28,29,77,8,1,5,2,126,27,24,75
"2011","Liverpool 030C","E01006696","Total",100,23,16,61,8,0,2,6,92,23,14,55
"2011","Liverpool 030D","E01006697","Total",113,15,17,81,6,0,3,3,107,15,14,78
"2011","Liverpool 030E","E01006746","Total",68,17,7,44,3,2,0,1,65,15,7,43
"2011","Liverpool 031A","E01006512","Total",39,10,6,23,7,0,0,7,32,10,6,16
"2011","Liverpool 031B","E01006747","Total",38,14,3,21,3,0,2,1,35,14,1,20
"2011","Liverpool 031C","E01006748","Total",61,26,11,24,2,0,0,2,59,26,11,22
"2011","Liverpool 031F","E01006751","Total",112,36,10,66,11,0,4,7,101,36,6,59
"2011","Liverpool 031G","E01033763","Total",45,10,6,29,2,0,0,2,43,10,6,27
"2011","Liverpool 032A","E01006566","Total",34,10,10,14,2,1,0,1,32,9,10,13
"2011","Liverpool 032B","E01006585","Total",69,17,18,34,3,0,2,1,66,17,16,33
"2011","Liverpool 032C","E01006586","Total",71,24,22,25,10,2,5,3,61,22,17,22
"2011","Liverpool 032D","E01006587","Total",42,10,14,18,7,1,5,1,35,9,9,17
"2011","Liverpool 032E","E01006716","Total",115,41,23,51,15,1,7,7,100,40,16,44
"2011","Liverpool 034A","E01006575","Total",42,10,11,21,0,0,0,0,42,10,11,21
"2011","Liverpool 034B","E01006576","Total",41,13,13,15,1,0,0,1,40,13,13,14
"2011","Liverpool 034C","E01006577","Total",31,15,12,4,1,0,0,1,30,15,12,3
"2011","Liverpool 034D","E01006579","Total",27,9,14,4,3,0,3,0,24,9,11,4
"2011","Liverpool 034E","E01006584","Total",40,14,12,14,5,1,0,4,35,13,12,10
"2011","Liverpool 035A","E01006720","Total",115,23,15,77,13,5,1,7,102,18,14,70
"2011","Liverpool 035B","E01006725","Total",82,23,16,43,11,6,2,3,71,17,14,40
"2011","Liverpool 035C","E01006726","Total",77,19,12,46,10,2,3,5,67,17,9,41
"2011","Liverpool 035D","E01006727","Total",68,27,18,23,11,7,2,2,57,20,16,21
"2011","Liverpool 035E","E01006728","Total",128,41,11,76,3,0,2,1,125,41,9,75
"2011","Liverpool 035F","E01006752","Total",50,12,8,30,9,1,1,7,41,11,7,23
"2011","Liverpool 036A","E01006578","Total",35,11,14,10,2,0,0,2,33,11,14,8
"2011","Liverpool 036B","E01006580","Total",18,12,3,3,0,0,0,0,18,12,3,3
"2011","Liverpool 036C","E01006581","Total",22,7,12,3,1,0,1,0,21,7,11,3
"2011","Liverpool 036D","E01006773","Total",39,17,17,5,6,0,4,2,33,17,13,3
"2011","Liverpool 036E","E01006774","Total",37,13,10,14,2,0,1,1,35,13,9,13
"2011","Liverpool 037A","E01006514","Total",31,8,7,16,5,0,3,2,26,8,4,14
"2011","Liverpool 037B","E01006515","Total",60,17,8,35,4,0,0,4,56,17,8,31
"2011","Liverpool 037D","E01006673","Total",127,26,20,81,10,2,1,7,117,24,19,74
"2011","Liverpool 037E","E01033757","Total",21,7,7,7,2,0,1,1,19,7,6,6
"2011","Liverpool 037F","E01033768","Total",37,10,8,19,4,2,2,0,33,8,6,19
"2011","Liverpool 038A","E01006550","Total",20,6,5,9,4,2,1,1,16,4,4,8
"2011","Liverpool 038B","E01006557","Total",34,7,10,17,4,1,2,1,30,6,8,16
"2011","Liverpool 038C","E01006721","Total",140,43,17,80,10,7,1,2,130,36,16,78
"2011","Liverpool 038D","E01006722","Total",45,17,8,20,4,0,1,3,41,17,7,17
"2011","Liverpool 038E","E01006723","Total",44,14,8,22,7,2,2,3,37,12,6,19
"2011","Liverpool 038F","E01006724","Total",24,7,6,11,4,1,2,1,20,6,4,10
"2011","Liverpool 039A","E01006552","Total",151,32,22,97,30,5,5,20,121,27,17,77
"2011","Liverpool 039B","E01006556","Total",141,32,24,85,18,3,7,8,123,29,17,77
"2011","Liverpool 039C","E01006674","Total",116,23,13,80,10,0,0,10,106,23,13,70
"2011","Liverpool 039D","E01006679","Total",144,26,12,106,15,2,0,13,129,24,12,93
"2011","Liverpool 040A","E01006709","Total",65,18,19,28,8,0,3,5,57,18,16,23
"2011","Liverpool 040B","E01006769","Total",76,18,21,37,9,0,6,3,67,18,15,34
"2011","Liverpool 040C","E01006770","Total",61,23,13,25,4,0,3,1,57,23,10,24
"2011","Liverpool 040D","E01006771","Total",99,38,10,51,1,0,0,1,98,38,10,50
"2011","Liverpool 040E","E01006772","Total",41,18,11,12,5,2,3,0,36,16,8,12
"2011","Liverpool 040F","E01006775","Total",68,26,9,33,4,0,0,4,64,26,9,29
"2011","Liverpool 041A","E01006582","Total",26,13,10,3,2,0,2,0,24,13,8,3
"2011","Liverpool 041B","E01006589","Total",32,17,13,2,4,2,2,0,28,15,11,2
"2011","Liverpool 041C","E01006591","Total",43,17,14,12,4,1,2,1,39,16,12,11
"2011","Liverpool 041D","E01006592","Total",15,1,10,4,1,0,1,0,14,1,9,4
"2011","Liverpool 041E","E01006597","Total",28,9,10,9,2,0,1,1,26,9,9,8
"2011","Liverpool 042A","E01006553","Total",40,19,9,12,8,3,3,2,32,16,6,10
"2011","Liverpool 042C","E01006588","Total",21,6,6,9,1,1,0,0,20,5,6,9
"2011","Liverpool 042D","E01006590","Total",39,13,14,12,9,1,5,3,30,12,9,9
"2011","Liverpool 042E","E01006593","Total",46,21,16,9,3,0,2,1,43,21,14,8
"2011","Liverpool 042F","E01033749","Total",11,3,2,6,1,1,0,0,10,2,2,6
"2011","Liverpool 042G","E01033766","Total",33,13,10,10,2,0,2,0,31,13,8,10
"2011","Liverpool 043A","E01006520","Total",20,4,6,10,1,0,1,0,19,4,5,10
"2011","Liverpool 043B","E01006549","Total",32,8,13,11,5,3,2,0,27,5,11,11
"2011","Liverpool 043C","E01006675","Total",46,14,8,24,6,1,0,5,40,13,8,19
"2011","Liverpool 043D","E01006677","Total",97,34,6,57,12,9,0,3,85,25,6,54
"2011","Liverpool 044A","E01006518","Total",104,33,18,53,4,0,1,3,100,33,17,50
"2011","Liverpool 044B","E01006630","Total",123,37,16,70,1,0,0,1,122,37,16,69
"2011","Liverpool 044C","E01006632","Total",131,23,30,78,15,2,9,4,116,21,21,74
"2011","Liverpool 044D","E01006676","Total",147,39,25,83,19,4,1,14,128,35,24,69
"2011","Liverpool 044E","E01006678","Total",119,36,13,70,22,5,0,17,97,31,13,53
"2011","Liverpool 045A","E01006706","Total",97,33,13,51,12,4,1,7,85,29,12,44
"2011","Liverpool 045B","E01006707","Total",86,25,14,47,5,1,1,3,81,24,13,44
"2011","Liverpool 045C","E01006708","Total",82,30,11,41,3,0,0,3,79,30,11,38
"2011","Liverpool 045D","E01006710","Total",101,35,25,41,8,1,4,3,93,34,21,38
"2011","Liverpool 046A","E01006792","Total",19,7,9,3,4,1,3,0,15,6,6,3
"2011","Liverpool 046B","E01006794","Total",42,13,13,16,3,1,1,1,39,12,12,15
"2011","Liverpool 046C","E01006800","Total",20,7,9,4,5,1,4,0,15,6,5,4
"2011","Liverpool 046D","E01006801","Total",17,6,7,4,2,0,1,1,15,6,6,3
"2011","Liverpool 047A","E01006532","Total",19,5,10,4,3,1,2,0,16,4,8,4
"2011","Liverpool 047B","E01006539","Total",15,7,5,3,3,1,0,2,12,6,5,1
"2011","Liverpool 047C","E01006583","Total",12,6,3,3,1,0,1,0,11,6,2,3
"2011","Liverpool 047D","E01006594","Total",11,5,4,2,2,1,1,0,9,4,3,2
"2011","Liverpool 047E","E01006796","Total",9,4,2,3,3,0,2,1,6,4,0,2
"2011","Liverpool 048A","E01006522","Total",57,8,7,42,4,2,2,0,53,6,5,42
"2011","Liverpool 048B","E01006524","Total",24,4,14,6,1,0,0,1,23,4,14,5
"2011","Liverpool 048C","E01006526","Total",34,15,9,10,2,0,2,0,32,15,7,10
"2011","Liverpool 048D","E01006529","Total",21,7,8,6,2,0,1,1,19,7,7,5
"2011","Liverpool 048E","E01006551","Total",23,2,7,14,3,0,1,2,20,2,6,12
"2011","Liverpool 048F","E01006554","Total",22,5,8,9,6,0,3,3,16,5,5,6
"2011","Liverpool 049A","E01006525","Total",14,3,7,4,5,1,2,2,9,2,5,2
"2011","Liverpool 049B","E01006595","Total",54,19,16,19,5,0,3,2,49,19,13,17
"2011","Liverpool 049C","E01006596","Total",23,10,7,6,3,0,3,0,20,10,4,6
"2011","Liverpool 049D","E01006689","Total",35,15,13,7,1,0,1,0,34,15,12,7
"2011","Liverpool 050B","E01006633","Total",103,34,15,54,2,0,2,0,101,34,13,54
"2011","Liverpool 050F","E01032505","Total",57,18,16,23,1,0,1,0,56,18,15,23
"2011","Liverpool 050G","E01032506","Total",56,17,11,28,5,0,2,3,51,17,9,25
"2011","Liverpool 050H","E01032507","Total",48,10,16,22,2,2,0,0,46,8,16,22
"2011","Liverpool 050I","E01033748","Total",31,6,7,18,2,1,0,1,29,5,7,17
"2011","Liverpool 050J","E01033767","Total",105,31,14,60,8,1,3,4,97,30,11,56
"2011","Liverpool 051A","E01006793","Total",56,19,9,28,3,0,0,3,53,19,9,25
"2011","Liverpool 051B","E01006795","Total",27,9,12,6,4,0,3,1,23,9,9,5
"2011","Liverpool 051C","E01006797","Total",64,15,15,34,8,1,2,5,56,14,13,29
"2011","Liverpool 051D","E01006798","Total",28,6,11,11,2,0,2,0,26,6,9,11
"2011","Liverpool 051E","E01006799","Total",46,21,7,18,6,0,3,3,40,21,4,15
"2011","Liverpool 052A","E01006521","Total",48,11,18,19,4,2,2,0,44,9,16,19
"2011","Liverpool 052B","E01006523","Total",39,7,11,21,4,2,1,1,35,5,10,20
"2011","Liverpool 052C","E01006528","Total",35,14,9,12,2,0,2,0,33,14,7,12
"2011","Liverpool 052D","E01006628","Total",44,12,16,16,4,0,1,3,40,12,15,13
"2011","Liverpool 052E","E01006629","Total",37,10,10,17,5,0,0,5,32,10,10,12
"2011","Liverpool 053A","E01006527","Total",42,24,8,10,0,0,0,0,42,24,8,10
"2011","Liverpool 053B","E01006680","Total",34,17,12,5,2,0,2,0,32,17,10,5
"2011","Liverpool 053C","E01006682","Total",23,8,11,4,1,0,1,0,22,8,10,4
"2011","Liverpool 053D","E01006683","Total",21,11,8,2,2,0,2,0,19,11,6,2
"2011","Liverpool 053E","E01006686","Total",23,9,9,5,0,0,0,0,23,9,9,5
"2011","Liverpool 054A","E01006534","Total",61,14,18,29,4,0,1,3,57,14,17,26
"2011","Liverpool 054B","E01006535","Total",57,21,20,16,3,1,2,0,54,20,18,16
"2011","Liverpool 054C","E01006536","Total",88,27,26,35,4,0,0,4,84,27,26,31
"2011","Liverpool 054D","E01006681","Total",51,18,10,23,5,0,1,4,46,18,9,19
"2011","Liverpool 055A","E01006530","Total",28,12,8,8,4,1,2,1,24,11,6,7
"2011","Liverpool 055B","E01006531","Total",21,7,9,5,0,0,0,0,21,7,9,5
"2011","Liverpool 055C","E01006533","Total",26,7,8,11,1,0,1,0,25,7,7,11
"2011","Liverpool 055D","E01006537","Total",108,46,21,41,4,1,0,3,104,45,21,38
"2011","Liverpool 055E","E01006538","Total",36,12,15,9,4,0,3,1,32,12,12,8
"2011","Liverpool 056A","E01006519","Total",22,6,15,1,1,0,1,0,21,6,14,1
"2011","Liverpool 056B","E01006684","Total",65,20,29,16,12,6,6,0,53,14,23,16
"2011","Liverpool 056C","E01006685","Total",26,4,12,10,8,1,4,3,18,3,8,7
"2011","Liverpool 056D","E01006687","Total",38,13,13,12,4,0,3,1,34,13,10,11
"2011","Liverpool 056E","E01006688","Total",37,16,10,11,1,0,0,1,36,16,10,10
"2011","Liverpool 057A","E01006740","Total",94,29,5,60,8,1,2,5,86,28,3,55
"2011","Liverpool 057B","E01006742","Total",51,19,10,22,3,0,1,2,48,19,9,20
"2011","Liverpool 057C","E01006744","Total",87,31,19,37,1,0,1,0,86,31,18,37
"2011","Liverpool 057D","E01006745","Total",132,49,15,68,12,3,1,8,120,46,14,60
"2011","Liverpool 058A","E01006738","Total",111,34,12,65,3,0,0,3,108,34,12,62
"2011","Liverpool 058B","E01006739","Total",128,39,17,72,8,1,1,6,120,38,16,66
"2011","Liverpool 058C","E01006741","Total",106,34,15,57,8,1,2,5,98,33,13,52
"2011","Liverpool 058D","E01006743","Total",125,38,32,55,11,3,3,5,114,35,29,50
"2011","Liverpool 059A","E01006753","Total",126,33,19,74,7,2,3,2,119,31,16,72
"2011","Liverpool 059B","E01006754","Total",121,38,14,69,11,0,1,10,110,38,13,59
"2011","Liverpool 059C","E01006755","Total",140,33,13,94,9,2,2,5,131,31,11,89
"2011","Liverpool 059D","E01006756","Total",170,52,27,91,16,7,3,6,154,45,24,85
"2011","Liverpool 059E","E01006757","Total",119,37,11,71,10,4,2,4,109,33,9,67
"2011","Liverpool 059F","E01006758","Total",124,33,21,70,10,1,5,4,114,32,16,66
"2011","Liverpool 060A","E01006513","Total",18,6,5,7,3,2,1,0,15,4,4,7
"2011","Liverpool 060B","E01033758","Total",17,8,4,5,0,0,0,0,17,8,4,5
"2011","Liverpool 060C","E01033760","Total",9,3,3,3,3,2,1,0,6,1,2,3
"2011","Liverpool 060D","E01033761","Total",8,4,2,2,1,0,0,1,7,4,2,1
"2011","Liverpool 060E","E01033762","Total",5,4,0,1,0,0,0,0,5,4,0,1
"2011","Liverpool 061A","E01033750","Total",17,6,6,5,4,1,1,2,13,5,5,3
"2011","Liverpool 061B","E01033754","Total",27,10,4,13,3,1,1,1,24,9,3,12
"2011","Liverpool 061C","E01033756","Total",6,2,1,3,1,0,1,0,5,2,0,3
"2011","Liverpool 061D","E01033765","Total",94,28,10,56,5,0,3,2,89,28,7,54
"2011","Liverpool 062A","E01033751","Total",37,11,4,22,3,0,1,2,34,11,3,20
"2011","Liverpool 062B","E01033752","Total",3,3,0,0,0,0,0,0,3,3,0,0
"2011","Liverpool 062C","E01033753","Total",2,1,1,0,1,1,0,0,1,0,1,0
"2011","Liverpool 062D","E01033755","Total",5,2,2,1,0,0,0,0,5,2,2,1
"2011","Sefton 001A","E01006946","Total",36,16,10,10,2,0,2,0,34,16,8,10
"2011","Sefton 001B","E01007028","Total",48,23,11,14,3,0,2,1,45,23,9,13
"2011","Sefton 001C","E01007029","Total",20,9,8,3,1,1,0,0,19,8,8,3
"2011","Sefton 001D","E01007030","Total",67,25,14,28,5,0,1,4,62,25,13,24
"2011","Sefton 001E","E01007036","Total",29,15,12,2,2,0,2,0,27,15,10,2
"2011","Sefton 002A","E01006947","Total",29,11,9,9,1,1,0,0,28,10,9,9
"2011","Sefton 002B","E01007031","Total",48,24,14,10,2,0,2,0,46,24,12,10
"2011","Sefton 002C","E01007032","Total",26,12,8,6,2,1,1,0,24,11,7,6
"2011","Sefton 002D","E01007033","Total",46,16,20,10,3,0,3,0,43,16,17,10
"2011","Sefton 002E","E01007035","Total",30,8,13,9,5,0,2,3,25,8,11,6
"2011","Sefton 003A","E01006944","Total",28,9,4,15,7,2,2,3,21,7,2,12
"2011","Sefton 003B","E01006948","Total",51,21,16,14,8,1,4,3,43,20,12,11
"2011","Sefton 003C","E01006949","Total",16,8,4,4,2,0,2,0,14,8,2,4
"2011","Sefton 003D","E01006951","Total",30,10,12,8,3,0,2,1,27,10,10,7
"2011","Sefton 003E","E01007034","Total",23,13,6,4,0,0,0,0,23,13,6,4
"2011","Sefton 004A","E01006945","Total",28,9,8,11,0,0,0,0,28,9,8,11
"2011","Sefton 004B","E01006950","Total",30,7,10,13,3,0,3,0,27,7,7,13
"2011","Sefton 004C","E01006968","Total",54,17,10,27,10,2,4,4,44,15,6,23
"2011","Sefton 004D","E01006969","Total",70,34,17,19,14,4,5,5,56,30,12,14
"2011","Sefton 004F","E01033094","Total",30,18,3,9,2,0,2,0,28,18,1,9
"2011","Sefton 004G","E01033097","Total",29,12,6,11,4,0,2,2,25,12,4,9
"2011","Sefton 005A","E01007055","Total",90,23,22,45,15,2,6,7,75,21,16,38
"2011","Sefton 005B","E01007056","Total",65,31,19,15,1,0,0,1,64,31,19,14
"2011","Sefton 005C","E01007057","Total",89,40,19,30,8,3,3,2,81,37,16,28
"2011","Sefton 005D","E01007062","Total",40,22,11,7,2,1,1,0,38,21,10,7
"2011","Sefton 005E","E01007063","Total",60,23,17,20,6,2,1,3,54,21,16,17
"2011","Sefton 006A","E01007058","Total",62,17,21,24,13,1,11,1,49,16,10,23
"2011","Sefton 006B","E01007059","Total",55,20,17,18,4,0,4,0,51,20,13,18
"2011","Sefton 006C","E01007060","Total",63,29,11,23,6,1,2,3,57,28,9,20
"2011","Sefton 006D","E01007061","Total",67,32,19,16,12,3,8,1,55,29,11,15
"2011","Sefton 006E","E01007064","Total",28,15,6,7,2,0,1,1,26,15,5,6
"2011","Sefton 007A","E01006934","Total",53,25,12,16,11,2,6,3,42,23,6,13
"2011","Sefton 007B","E01006970","Total",56,18,17,21,4,1,2,1,52,17,15,20
"2011","Sefton 007C","E01006994","Total",82,28,18,36,8,2,4,2,74,26,14,34
"2011","Sefton 007D","E01006996","Total",34,11,5,18,5,2,0,3,29,9,5,15
"2011","Sefton 007E","E01006998","Total",91,42,15,34,8,3,4,1,83,39,11,33
"2011","Sefton 008A","E01006995","Total",29,15,9,5,3,1,2,0,26,14,7,5
"2011","Sefton 008B","E01006997","Total",58,28,13,17,5,0,3,2,53,28,10,15
"2011","Sefton 008C","E01006999","Total",61,25,19,17,3,0,1,2,58,25,18,15
"2011","Sefton 008D","E01007000","Total",56,25,12,19,2,1,1,0,54,24,11,19
"2011","Sefton 008E","E01007001","Total",86,42,21,23,7,0,6,1,79,42,15,22
"2011","Sefton 008F","E01007002","Total",32,9,10,13,2,0,0,2,30,9,10,11
"2011","Sefton 009A","E01006928","Total",27,10,8,9,3,0,3,0,24,10,5,9
"2011","Sefton 009B","E01006935","Total",35,15,13,7,7,1,6,0,28,14,7,7
"2011","Sefton 009C","E01006971","Total",22,5,12,5,5,0,3,2,17,5,9,3
"2011","Sefton 009D","E01006972","Total",22,6,9,7,3,0,2,1,19,6,7,6
"2011","Sefton 009E","E01006973","Total",28,8,10,10,5,0,3,2,23,8,7,8
"2011","Sefton 009F","E01006974","Total",21,11,5,5,3,1,1,1,18,10,4,4
"2011","Sefton 010A","E01006929","Total",45,20,11,14,3,0,3,0,42,20,8,14
"2011","Sefton 010B","E01006930","Total",57,24,14,19,3,0,3,0,54,24,11,19
"2011","Sefton 010C","E01006931","Total",44,28,5,11,2,2,0,0,42,26,5,11
"2011","Sefton 010D","E01006932","Total",24,10,10,4,4,0,2,2,20,10,8,2
"2011","Sefton 010E","E01006933","Total",54,20,14,20,8,0,5,3,46,20,9,17
"2011","Sefton 011A","E01006920","Total",59,27,14,18,6,2,1,3,53,25,13,15
"2011","Sefton 011B","E01006924","Total",74,21,22,31,11,3,6,2,63,18,16,29
"2011","Sefton 011C","E01006925","Total",64,21,17,26,10,1,2,7,54,20,15,19
"2011","Sefton 011D","E01006927","Total",47,25,1,21,2,0,0,2,45,25,1,19
"2011","Sefton 012A","E01006921","Total",8,4,2,2,0,0,0,0,8,4,2,2
"2011","Sefton 012B","E01006922","Total",13,6,4,3,1,0,0,1,12,6,4,2
"2011","Sefton 012C","E01006923","Total",15,4,7,4,2,0,1,1,13,4,6,3
"2011","Sefton 012D","E01006926","Total",14,2,5,7,0,0,0,0,14,2,5,7
"2011","Sefton 013A","E01006985","Total",25,12,9,4,3,0,3,0,22,12,6,4
"2011","Sefton 013B","E01006986","Total",12,3,6,3,5,2,3,0,7,1,3,3
"2011","Sefton 013C","E01006987","Total",19,4,8,7,2,0,2,0,17,4,6,7
"2011","Sefton 013D","E01006989","Total",13,4,4,5,5,2,2,1,8,2,2,4
"2011","Sefton 013E","E01006990","Total",18,11,6,1,2,1,1,0,16,10,5,1
"2011","Sefton 014A","E01006988","Total",32,14,8,10,1,0,1,0,31,14,7,10
"2011","Sefton 014B","E01007079","Total",28,13,6,9,2,0,1,1,26,13,5,8
"2011","Sefton 014C","E01007080","Total",37,16,12,9,2,1,1,0,35,15,11,9
"2011","Sefton 014D","E01007081","Total",18,9,8,1,1,0,1,0,17,9,7,1
"2011","Sefton 015A","E01006991","Total",19,7,7,5,3,2,0,1,16,5,7,4
"2011","Sefton 015B","E01006992","Total",16,9,5,2,2,0,2,0,14,9,3,2
"2011","Sefton 015C","E01006993","Total",18,9,7,2,1,0,1,0,17,9,6,2
"2011","Sefton 015D","E01007078","Total",20,4,12,4,2,0,2,0,18,4,10,4
"2011","Sefton 016A","E01007075","Total",40,20,12,8,2,0,1,1,38,20,11,7
"2011","Sefton 016B","E01007076","Total",26,12,10,4,2,0,1,1,24,12,9,3
"2011","Sefton 016C","E01007077","Total",29,16,7,6,1,0,1,0,28,16,6,6
"2011","Sefton 016D","E01007082","Total",47,23,15,9,5,0,5,0,42,23,10,9
"2011","Sefton 017A","E01007067","Total",21,10,4,7,3,1,2,0,18,9,2,7
"2011","Sefton 017B","E01007068","Total",25,11,12,2,3,1,2,0,22,10,10,2
"2011","Sefton 017C","E01007069","Total",47,20,14,13,5,1,2,2,42,19,12,11
"2011","Sefton 017D","E01007070","Total",17,7,6,4,1,0,1,0,16,7,5,4
"2011","Sefton 017E","E01007101","Total",18,9,6,3,0,0,0,0,18,9,6,3
"2011","Sefton 018C","E01007095","Total",26,10,12,4,1,0,1,0,25,10,11,4
"2011","Sefton 018D","E01007096","Total",23,10,9,4,1,0,1,0,22,10,8,4
"2011","Sefton 018E","E01007100","Total",33,13,15,5,2,0,2,0,31,13,13,5
"2011","Sefton 018F","E01033096","Total",56,34,13,9,2,0,2,0,54,34,11,9
"2011","Sefton 019A","E01007074","Total",52,20,16,16,5,0,2,3,47,20,14,13
"2011","Sefton 019B","E01007097","Total",33,9,16,8,4,1,3,0,29,8,13,8
"2011","Sefton 019C","E01007098","Total",22,8,7,7,2,0,1,1,20,8,6,6
"2011","Sefton 019D","E01007099","Total",19,5,9,5,4,0,3,1,15,5,6,4
"2011","Sefton 020A","E01007065","Total",35,16,10,9,2,0,1,1,33,16,9,8
"2011","Sefton 020B","E01007066","Total",39,13,9,17,2,0,0,2,37,13,9,15
"2011","Sefton 020C","E01007071","Total",10,1,4,5,1,0,1,0,9,1,3,5
"2011","Sefton 020D","E01007072","Total",13,2,7,4,2,0,1,1,11,2,6,3
"2011","Sefton 020E","E01007073","Total",15,6,8,1,0,0,0,0,15,6,8,1
"2011","Sefton 021A","E01007020","Total",67,33,20,14,7,2,3,2,60,31,17,12
"2011","Sefton 021B","E01007022","Total",30,10,11,9,4,1,3,0,26,9,8,9
"2011","Sefton 021C","E01007023","Total",16,10,6,0,2,1,1,0,14,9,5,0
"2011","Sefton 021D","E01007027","Total",28,8,15,5,8,3,5,0,20,5,10,5
"2011","Sefton 021E","E01007037","Total",23,10,6,7,3,0,1,2,20,10,5,5
"2011","Sefton 021F","E01007038","Total",39,11,10,18,5,1,2,2,34,10,8,16
"2011","Sefton 022A","E01006936","Total",16,5,4,7,2,0,2,0,14,5,2,7
"2011","Sefton 022B","E01006937","Total",17,6,9,2,5,0,5,0,12,6,4,2
"2011","Sefton 022C","E01006938","Total",12,4,2,6,2,0,1,1,10,4,1,5
"2011","Sefton 022D","E01006939","Total",52,18,19,15,6,0,6,0,46,18,13,15
"2011","Sefton 022E","E01006940","Total",20,5,12,3,2,0,2,0,18,5,10,3
"2011","Sefton 022F","E01006943","Total",13,3,8,2,2,0,1,1,11,3,7,1
"2011","Sefton 023A","E01007083","Total",43,18,11,14,2,0,2,0,41,18,9,14
"2011","Sefton 023B","E01007085","Total",95,25,14,56,2,0,0,2,93,25,14,54
"2011","Sefton 023C","E01007086","Total",73,29,11,33,6,0,2,4,67,29,9,29
"2011","Sefton 023D","E01007091","Total",41,14,13,14,2,0,0,2,39,14,13,12
"2011","Sefton 023E","E01007092","Total",44,16,5,23,2,0,0,2,42,16,5,21
"2011","Sefton 024A","E01006979","Total",94,21,9,64,19,0,4,15,75,21,5,49
"2011","Sefton 024B","E01006980","Total",125,42,23,60,17,2,7,8,108,40,16,52
"2011","Sefton 024C","E01007024","Total",61,25,11,25,3,0,1,2,58,25,10,23
"2011","Sefton 024D","E01007026","Total",54,10,13,31,6,1,3,2,48,9,10,29
"2011","Sefton 024E","E01007089","Total",88,26,16,46,4,1,1,2,84,25,15,44
"2011","Sefton 025A","E01007021","Total",14,7,5,2,1,1,0,0,13,6,5,2
"2011","Sefton 025B","E01007025","Total",21,9,6,6,3,0,1,2,18,9,5,4
"2011","Sefton 025C","E01007105","Total",67,20,33,14,5,0,3,2,62,20,30,12
"2011","Sefton 025D","E01007106","Total",44,15,21,8,3,0,3,0,41,15,18,8
"2011","Sefton 025E","E01007107","Total",20,9,6,5,3,2,0,1,17,7,6,4
"2011","Sefton 025F","E01007108","Total",47,15,23,9,4,1,2,1,43,14,21,8
"2011","Sefton 026A","E01007039","Total",48,20,12,16,3,0,2,1,45,20,10,15
"2011","Sefton 026B","E01007040","Total",55,21,19,15,3,1,1,1,52,20,18,14
"2011","Sefton 026C","E01007042","Total",35,13,12,10,2,1,0,1,33,12,12,9
"2011","Sefton 026D","E01007044","Total",18,8,7,3,2,0,2,0,16,8,5,3
"2011","Sefton 026E","E01007045","Total",27,9,8,10,3,1,1,1,24,8,7,9
"2011","Sefton 027A","E01007041","Total",32,7,11,14,1,0,0,1,31,7,11,13
"2011","Sefton 027B","E01007043","Total",20,4,9,7,3,0,3,0,17,4,6,7
"2011","Sefton 027C","E01007046","Total",58,21,18,19,5,0,5,0,53,21,13,19
"2011","Sefton 027D","E01007053","Total",48,20,19,9,1,0,0,1,47,20,19,8
"2011","Sefton 027E","E01007084","Total",32,13,16,3,2,0,2,0,30,13,14,3
"2011","Sefton 028A","E01006941","Total",48,10,21,17,3,0,2,1,45,10,19,16
"2011","Sefton 028B","E01006942","Total",58,22,18,18,7,1,5,1,51,21,13,17
"2011","Sefton 028C","E01006954","Total",38,12,13,13,4,1,2,1,34,11,11,12
"2011","Sefton 028D","E01007104","Total",26,11,6,9,7,1,3,3,19,10,3,6
"2011","Sefton 028E","E01007109","Total",67,26,22,19,4,1,3,0,63,25,19,19
"2011","Sefton 029A","E01007048","Total",117,31,31,55,6,0,3,3,111,31,28,52
"2011","Sefton 029B","E01007054","Total",55,14,7,34,6,1,1,4,49,13,6,30
"2011","Sefton 029C","E01007087","Total",77,30,8,39,2,0,1,1,75,30,7,38
"2011","Sefton 029D","E01007088","Total",69,27,19,23,6,1,4,1,63,26,15,22
"2011","Sefton 029E","E01007090","Total",68,28,7,33,5,1,2,2,63,27,5,31
"2011","Sefton 030A","E01006955","Total",61,19,27,15,4,0,4,0,57,19,23,15
"2011","Sefton 030B","E01006956","Total",58,16,20,22,5,0,4,1,53,16,16,21
"2011","Sefton 030C","E01006958","Total",56,28,14,14,6,0,3,3,50,28,11,11
"2011","Sefton 030D","E01007102","Total",45,15,17,13,2,1,1,0,43,14,16,13
"2011","Sefton 030E","E01007103","Total",23,9,10,4,2,0,2,0,21,9,8,4
"2011","Sefton 031A","E01006978","Total",29,9,12,8,3,0,3,0,26,9,9,8
"2011","Sefton 031B","E01006981","Total",83,24,19,40,10,0,5,5,73,24,14,35
"2011","Sefton 031C","E01006982","Total",52,24,11,17,7,1,4,2,45,23,7,15
"2011","Sefton 031D","E01006983","Total",72,28,20,24,5,0,2,3,67,28,18,21
"2011","Sefton 031E","E01006984","Total",130,35,19,76,7,0,3,4,123,35,16,72
"2011","Sefton 032A","E01006952","Total",70,28,15,27,6,1,2,3,64,27,13,24
"2011","Sefton 032B","E01006953","Total",79,31,13,35,10,0,3,7,69,31,10,28
"2011","Sefton 032C","E01006957","Total",59,16,13,30,3,1,0,2,56,15,13,28
"2011","Sefton 032D","E01006959","Total",45,14,12,19,1,0,0,1,44,14,12,18
"2011","Sefton 032E","E01006977","Total",70,30,15,25,5,1,3,1,65,29,12,24
"2011","Sefton 033A","E01006976","Total",56,22,25,9,8,1,7,0,48,21,18,9
"2011","Sefton 033B","E01007014","Total",34,18,9,7,7,4,2,1,27,14,7,6
"2011","Sefton 033E","E01007047","Total",56,19,17,20,4,1,0,3,52,18,17,17
"2011","Sefton 033F","E01033095","Total",55,28,10,17,3,2,1,0,52,26,9,17
"2011","Sefton 034A","E01007004","Total",100,27,19,54,9,1,0,8,91,26,19,46
"2011","Sefton 034B","E01007005","Total",119,30,6,83,10,0,2,8,109,30,4,75
"2011","Sefton 034C","E01007011","Total",98,35,18,45,4,2,2,0,94,33,16,45
"2011","Sefton 034D","E01007016","Total",123,34,16,73,7,2,2,3,116,32,14,70
"2011","Sefton 034E","E01007017","Total",112,44,22,46,6,2,0,4,106,42,22,42
"2011","Sefton 035A","E01007019","Total",116,35,14,67,8,1,3,4,108,34,11,63
"2011","Sefton 035B","E01007049","Total",48,17,14,17,4,0,4,0,44,17,10,17
"2011","Sefton 035C","E01007050","Total",24,7,5,12,3,0,1,2,21,7,4,10
"2011","Sefton 035D","E01007051","Total",69,20,10,39,4,0,0,4,65,20,10,35
"2011","Sefton 035E","E01007052","Total",85,19,16,50,9,0,2,7,76,19,14,43
"2011","Sefton 036A","E01006964","Total",87,29,20,38,6,0,4,2,81,29,16,36
"2011","Sefton 036B","E01007003","Total",104,30,10,64,17,6,3,8,87,24,7,56
"2011","Sefton 036C","E01007006","Total",96,26,19,51,7,0,3,4,89,26,16,47
"2011","Sefton 036D","E01007012","Total",77,31,12,34,2,0,1,1,75,31,11,33
"2011","Sefton 036E","E01007013","Total",96,38,13,45,6,0,3,3,90,38,10,42
"2011","Sefton 037A","E01006967","Total",66,16,10,40,6,1,2,3,60,15,8,37
"2011","Sefton 037B","E01007007","Total",85,28,9,48,9,1,0,8,76,27,9,40
"2011","Sefton 037C","E01007008","Total",100,32,10,58,7,0,0,7,93,32,10,51
"2011","Sefton 037D","E01007009","Total",42,14,4,24,4,2,2,0,38,12,2,24
"2011","Sefton 037E","E01007010","Total",91,35,9,47,9,0,2,7,82,35,7,40
"2011","Sefton 038A","E01006960","Total",26,15,3,8,1,0,1,0,25,15,2,8
"2011","Sefton 038B","E01006961","Total",79,26,10,43,6,2,0,4,73,24,10,39
"2011","Sefton 038C","E01006962","Total",54,20,14,20,4,1,3,0,50,19,11,20
"2011","Sefton 038D","E01006963","Total",112,25,20,67,19,3,9,7,93,22,11,60
"2011","Sefton 038E","E01006965","Total",83,17,14,52,9,0,3,6,74,17,11,46
"2011","Sefton 038F","E01006966","Total",66,25,14,27,2,0,2,0,64,25,12,27
"2011","St. Helens 001A","E01006882","Total",14,6,7,1,2,0,2,0,12,6,5,1
"2011","St. Helens 001B","E01006883","Total",28,6,16,6,5,1,3,1,23,5,13,5
"2011","St. Helens 001C","E01006884","Total",24,8,10,6,2,2,0,0,22,6,10,6
"2011","St. Helens 001D","E01006885","Total",15,8,6,1,2,1,1,0,13,7,5,1
"2011","St. Helens 001E","E01006886","Total",19,7,12,0,1,0,1,0,18,7,11,0
"2011","St. Helens 001F","E01006887","Total",63,19,24,20,15,0,5,10,48,19,19,10
"2011","St. Helens 002A","E01006802","Total",34,9,12,13,4,1,2,1,30,8,10,12
"2011","St. Helens 002B","E01006804","Total",36,11,10,15,2,0,0,2,34,11,10,13
"2011","St. Helens 002C","E01006806","Total",20,4,10,6,3,0,3,0,17,4,7,6
"2011","St. Helens 002D","E01006807","Total",16,8,6,2,1,0,1,0,15,8,5,2
"2011","St. Helens 003A","E01006803","Total",23,5,15,3,5,0,5,0,18,5,10,3
"2011","St. Helens 003B","E01006805","Total",48,21,11,16,6,1,2,3,42,20,9,13
"2011","St. Helens 003C","E01006808","Total",29,7,15,7,6,0,3,3,23,7,12,4
"2011","St. Helens 003D","E01006809","Total",29,11,12,6,2,0,1,1,27,11,11,5
"2011","St. Helens 004A","E01006849","Total",81,23,15,43,8,0,6,2,73,23,9,41
"2011","St. Helens 004B","E01006850","Total",75,20,11,44,9,1,2,6,66,19,9,38
"2011","St. Helens 004C","E01006851","Total",41,7,19,15,6,1,2,3,35,6,17,12
"2011","St. Helens 004D","E01006852","Total",20,7,5,8,2,0,1,1,18,7,4,7
"2011","St. Helens 004E","E01006853","Total",25,11,11,3,5,0,4,1,20,11,7,2
"2011","St. Helens 004F","E01006854","Total",56,24,14,18,4,1,1,2,52,23,13,16
"2011","St. Helens 004G","E01006855","Total",63,15,17,31,9,0,5,4,54,15,12,27
"2011","St. Helens 005A","E01006836","Total",47,15,13,19,3,0,2,1,44,15,11,18
"2011","St. Helens 005B","E01006839","Total",26,11,8,7,3,0,3,0,23,11,5,7
"2011","St. Helens 005C","E01006840","Total",37,9,16,12,0,0,0,0,37,9,16,12
"2011","St. Helens 005D","E01006842","Total",94,29,17,48,10,0,2,8,84,29,15,40
"2011","St. Helens 006A","E01006837","Total",49,16,19,14,8,2,4,2,41,14,15,12
"2011","St. Helens 006B","E01006838","Total",40,5,22,13,6,0,5,1,34,5,17,12
"2011","St. Helens 006C","E01006841","Total",29,11,12,6,4,0,2,2,25,11,10,4
"2011","St. Helens 006D","E01006843","Total",55,24,9,22,1,0,1,0,54,24,8,22
"2011","St. Helens 007A","E01006914","Total",15,2,11,2,2,0,2,0,13,2,9,2
"2011","St. Helens 007B","E01006915","Total",50,17,14,19,6,0,2,4,44,17,12,15
"2011","St. Helens 007C","E01006916","Total",47,15,13,19,4,0,1,3,43,15,12,16
"2011","St. Helens 007D","E01006917","Total",34,12,17,5,3,0,3,0,31,12,14,5
"2011","St. Helens 007E","E01006918","Total",39,16,13,10,7,0,3,4,32,16,10,6
"2011","St. Helens 007F","E01006919","Total",116,26,25,65,10,1,4,5,106,25,21,60
"2011","St. Helens 008A","E01006810","Total",20,7,13,0,3,1,2,0,17,6,11,0
"2011","St. Helens 008B","E01006811","Total",40,15,13,12,4,1,1,2,36,14,12,10
"2011","St. Helens 008C","E01006812","Total",110,35,21,54,7,1,3,3,103,34,18,51
"2011","St. Helens 008D","E01006813","Total",59,27,9,23,1,0,1,0,58,27,8,23
"2011","St. Helens 008E","E01006814","Total",29,8,11,10,3,0,1,2,26,8,10,8
"2011","St. Helens 008F","E01006815","Total",56,20,14,22,6,2,2,2,50,18,12,20
"2011","St. Helens 008G","E01006818","Total",32,13,12,7,0,0,0,0,32,13,12,7
"2011","St. Helens 009A","E01006822","Total",33,10,16,7,5,1,3,1,28,9,13,6
"2011","St. Helens 009B","E01006823","Total",12,3,7,2,4,0,3,1,8,3,4,1
"2011","St. Helens 009C","E01006824","Total",19,10,6,3,3,1,2,0,16,9,4,3
"2011","St. Helens 009D","E01006825","Total",21,7,11,3,2,0,2,0,19,7,9,3
"2011","St. Helens 010A","E01006866","Total",83,25,13,45,7,1,2,4,76,24,11,41
"2011","St. Helens 010B","E01006867","Total",50,17,20,13,6,0,6,0,44,17,14,13
"2011","St. Helens 010C","E01006868","Total",65,20,16,29,13,3,3,7,52,17,13,22
"2011","St. Helens 010D","E01006869","Total",64,17,17,30,10,3,3,4,54,14,14,26
"2011","St. Helens 011A","E01006819","Total",50,15,9,26,9,1,2,6,41,14,7,20
"2011","St. Helens 011B","E01006820","Total",98,22,11,65,14,1,4,9,84,21,7,56
"2011","St. Helens 011C","E01006821","Total",95,26,11,58,3,0,0,3,92,26,11,55
"2011","St. Helens 011D","E01006871","Total",102,26,18,58,12,1,8,3,90,25,10,55
"2011","St. Helens 012A","E01006832","Total",70,24,18,28,8,3,4,1,62,21,14,27
"2011","St. Helens 012B","E01006834","Total",76,17,13,46,6,0,1,5,70,17,12,41
"2011","St. Helens 012C","E01006877","Total",54,13,13,28,8,1,3,4,46,12,10,24
"2011","St. Helens 012D","E01006880","Total",91,34,15,42,8,1,3,4,83,33,12,38
"2011","St. Helens 012E","E01006881","Total",71,25,5,41,13,2,0,11,58,23,5,30
"2011","St. Helens 013A","E01006863","Total",85,30,20,35,9,0,5,4,76,30,15,31
"2011","St. Helens 013B","E01006864","Total",50,16,20,14,3,0,3,0,47,16,17,14
"2011","St. Helens 013C","E01006865","Total",102,30,22,50,8,1,6,1,94,29,16,49
"2011","St. Helens 014A","E01006845","Total",69,21,20,28,7,3,4,0,62,18,16,28
"2011","St. Helens 014B","E01006870","Total",53,18,10,25,5,0,2,3,48,18,8,22
"2011","St. Helens 014C","E01006872","Total",62,18,10,34,11,2,4,5,51,16,6,29
"2011","St. Helens 014D","E01006873","Total",91,23,11,57,7,1,1,5,84,22,10,52
"2011","St. Helens 014E","E01006874","Total",102,21,9,72,13,2,5,6,89,19,4,66
"2011","St. Helens 015A","E01006856","Total",32,11,13,8,3,1,2,0,29,10,11,8
"2011","St. Helens 015B","E01006857","Total",27,10,10,7,0,0,0,0,27,10,10,7
"2011","St. Helens 015C","E01006858","Total",90,26,26,38,10,2,4,4,80,24,22,34
"2011","St. Helens 015D","E01006859","Total",20,5,11,4,3,1,2,0,17,4,9,4
"2011","St. Helens 015E","E01006860","Total",53,17,18,18,9,0,4,5,44,17,14,13
"2011","St. Helens 015F","E01006861","Total",115,29,20,66,16,1,4,11,99,28,16,55
"2011","St. Helens 015G","E01006862","Total",51,17,7,27,3,0,1,2,48,17,6,25
"2011","St. Helens 016A","E01006831","Total",59,17,20,22,2,0,2,0,57,17,18,22
"2011","St. Helens 016B","E01006833","Total",66,22,22,22,9,0,7,2,57,22,15,20
"2011","St. Helens 016C","E01006835","Total",41,17,11,13,10,3,5,2,31,14,6,11
"2011","St. Helens 016D","E01006876","Total",64,15,18,31,3,0,2,1,61,15,16,30
"2011","St. Helens 016E","E01006878","Total",54,21,14,19,5,0,2,3,49,21,12,16
"2011","St. Helens 016F","E01006879","Total",73,18,15,40,10,0,2,8,63,18,13,32
"2011","St. Helens 016G","E01006904","Total",80,24,23,33,17,2,9,6,63,22,14,27
"2011","St. Helens 017A","E01006816","Total",109,30,22,57,11,1,6,4,98,29,16,53
"2011","St. Helens 017B","E01006817","Total",79,22,11,46,10,1,3,6,69,21,8,40
"2011","St. Helens 017C","E01006875","Total",79,16,10,53,5,2,0,3,74,14,10,50
"2011","St. Helens 017D","E01006899","Total",91,17,23,51,15,0,5,10,76,17,18,41
"2011","St. Helens 018A","E01006826","Total",36,12,10,14,4,0,2,2,32,12,8,12
"2011","St. Helens 018B","E01006827","Total",37,12,19,6,6,0,6,0,31,12,13,6
"2011","St. Helens 018C","E01006828","Total",30,12,8,10,2,0,2,0,28,12,6,10
"2011","St. Helens 018D","E01006829","Total",16,7,8,1,1,0,1,0,15,7,7,1
"2011","St. Helens 019A","E01006830","Total",78,30,10,38,6,0,4,2,72,30,6,36
"2011","St. Helens 019C","E01006903","Total",68,24,15,29,9,1,5,3,59,23,10,26
"2011","St. Helens 019D","E01006905","Total",78,22,12,44,11,2,5,4,67,20,7,40
"2011","St. Helens 019E","E01006906","Total",66,19,14,33,8,0,2,6,58,19,12,27
"2011","St. Helens 019F","E01006907","Total",64,25,13,26,2,0,1,1,62,25,12,25
"2011","St. Helens 019G","E01006912","Total",102,17,16,69,6,1,3,2,96,16,13,67
"2011","St. Helens 019H","E01006913","Total",75,18,16,41,6,0,3,3,69,18,13,38
"2011","St. Helens 019I","E01032904","Total",38,17,13,8,6,0,4,2,32,17,9,6
"2011","St. Helens 019J","E01032905","Total",26,6,11,9,1,0,0,1,25,6,11,8
"2011","St. Helens 020A","E01006844","Total",95,31,15,49,3,0,1,2,92,31,14,47
"2011","St. Helens 020B","E01006846","Total",31,15,8,8,3,0,1,2,28,15,7,6
"2011","St. Helens 020C","E01006847","Total",112,31,10,71,12,0,1,11,100,31,9,60
"2011","St. Helens 020D","E01006848","Total",34,14,7,13,2,0,1,1,32,14,6,12
"2011","St. Helens 020E","E01006896","Total",23,8,7,8,4,1,2,1,19,7,5,7
"2011","St. Helens 020F","E01006897","Total",36,11,15,10,7,0,5,2,29,11,10,8
"2011","St. Helens 020G","E01006901","Total",49,20,14,15,3,0,2,1,46,20,12,14
"2011","St. Helens 021A","E01006890","Total",60,19,28,13,5,0,4,1,55,19,24,12
"2011","St. Helens 021B","E01006892","Total",21,7,9,5,4,0,4,0,17,7,5,5
"2011","St. Helens 021C","E01006893","Total",49,16,15,18,6,0,4,2,43,16,11,16
"2011","St. Helens 021D","E01006894","Total",17,7,3,7,1,0,1,0,16,7,2,7
"2011","St. Helens 022A","E01006898","Total",67,26,13,28,7,1,2,4,60,25,11,24
"2011","St. Helens 022B","E01006900","Total",79,25,25,29,5,0,2,3,74,25,23,26
"2011","St. Helens 022C","E01006908","Total",83,16,11,56,9,0,4,5,74,16,7,51
"2011","St. Helens 022D","E01006909","Total",115,33,9,73,7,0,0,7,108,33,9,66
"2011","St. Helens 022E","E01006910","Total",98,35,19,44,8,1,5,2,90,34,14,42
"2011","St. Helens 022F","E01006911","Total",21,10,8,3,1,0,1,0,20,10,7,3
"2011","St. Helens 023A","E01006888","Total",10,1,4,5,0,0,0,0,10,1,4,5
"2011","St. Helens 023B","E01006889","Total",33,10,16,7,3,0,3,0,30,10,13,7
"2011","St. Helens 023C","E01006891","Total",24,10,9,5,1,0,1,0,23,10,8,5
"2011","St. Helens 023D","E01006895","Total",13,7,3,3,1,0,1,0,12,7,2,3
"2011","Wirral 001A","E01007229","Total",85,26,26,33,10,1,7,2,75,25,19,31
"2011","Wirral 001B","E01007230","Total",52,14,18,20,9,1,4,4,43,13,14,16
"2011","Wirral 001C","E01007231","Total",42,19,12,11,1,0,1,0,41,19,11,11
"2011","Wirral 001D","E01007237","Total",52,14,8,30,0,0,0,0,52,14,8,30
"2011","Wirral 001E","E01007238","Total",82,20,23,39,9,0,5,4,73,20,18,35
"2011","Wirral 002A","E01007218","Total",93,31,18,44,8,0,4,4,85,31,14,40
"2011","Wirral 002B","E01007232","Total",50,12,13,25,5,0,3,2,45,12,10,23
"2011","Wirral 002C","E01007233","Total",73,28,19,26,8,3,2,3,65,25,17,23
"2011","Wirral 002D","E01007234","Total",71,26,18,27,7,3,3,1,64,23,15,26
"2011","Wirral 002E","E01007236","Total",61,27,12,22,2,0,2,0,59,27,10,22
"2011","Wirral 003A","E01007307","Total",36,15,8,13,4,1,2,1,32,14,6,12
"2011","Wirral 003B","E01007308","Total",32,12,12,8,4,2,1,1,28,10,11,7
"2011","Wirral 003C","E01007312","Total",41,10,12,19,3,0,2,1,38,10,10,18
"2011","Wirral 003D","E01007313","Total",57,22,16,19,6,1,4,1,51,21,12,18
"2011","Wirral 003E","E01007315","Total",48,23,13,12,2,1,1,0,46,22,12,12
"2011","Wirral 004A","E01007211","Total",29,6,15,8,9,0,7,2,20,6,8,6
"2011","Wirral 004B","E01007235","Total",57,24,18,15,9,1,5,3,48,23,13,12
"2011","Wirral 004C","E01007310","Total",27,8,10,9,3,1,2,0,24,7,8,9
"2011","Wirral 004D","E01007311","Total",13,6,4,3,0,0,0,0,13,6,4,3
"2011","Wirral 004E","E01007314","Total",67,25,24,18,8,1,4,3,59,24,20,15
"2011","Wirral 004F","E01007316","Total",40,16,13,11,4,1,3,0,36,15,10,11
"2011","Wirral 005A","E01007215","Total",89,19,22,48,13,2,4,7,76,17,18,41
"2011","Wirral 005B","E01007216","Total",99,30,20,49,11,1,1,9,88,29,19,40
"2011","Wirral 005C","E01007219","Total",62,19,22,21,2,1,1,0,60,18,21,21
"2011","Wirral 005D","E01007220","Total",96,27,15,54,9,2,3,4,87,25,12,50
"2011","Wirral 005E","E01007275","Total",93,28,15,50,7,0,3,4,86,28,12,46
"2011","Wirral 006A","E01007203","Total",53,19,18,16,3,0,2,1,50,19,16,15
"2011","Wirral 006B","E01007205","Total",59,24,11,24,4,0,2,2,55,24,9,22
"2011","Wirral 006C","E01007210","Total",122,35,26,61,11,0,5,6,111,35,21,55
"2011","Wirral 006D","E01007309","Total",22,6,10,6,4,0,4,0,18,6,6,6
"2011","Wirral 007A","E01007212","Total",32,7,12,13,7,0,4,3,25,7,8,10
"2011","Wirral 007B","E01007213","Total",42,22,11,9,3,0,2,1,39,22,9,8
"2011","Wirral 007C","E01007214","Total",67,25,14,28,4,1,2,1,63,24,12,27
"2011","Wirral 007D","E01007217","Total",100,30,19,51,4,1,1,2,96,29,18,49
"2011","Wirral 007E","E01007276","Total",80,26,17,37,7,2,2,3,73,24,15,34
"2011","Wirral 008A","E01007272","Total",95,28,12,55,9,1,2,6,86,27,10,49
"2011","Wirral 008B","E01007273","Total",134,41,17,76,12,2,2,8,122,39,15,68
"2011","Wirral 008C","E01007274","Total",143,32,14,97,12,3,1,8,131,29,13,89
"2011","Wirral 008D","E01007277","Total",112,30,18,64,9,0,3,6,103,30,15,58
"2011","Wirral 008E","E01007278","Total",107,37,15,55,4,0,3,1,103,37,12,54
"2011","Wirral 009A","E01007204","Total",174,47,15,112,13,1,3,9,161,46,12,103
"2011","Wirral 009B","E01007206","Total",79,35,18,26,4,1,1,2,75,34,17,24
"2011","Wirral 009C","E01007207","Total",90,27,11,52,5,0,3,2,85,27,8,50
"2011","Wirral 009D","E01007209","Total",49,11,13,25,3,0,1,2,46,11,12,23
"2011","Wirral 010C","E01007269","Total",146,51,12,83,8,2,2,4,138,49,10,79
"2011","Wirral 010D","E01007270","Total",129,45,19,65,5,1,0,4,124,44,19,61
"2011","Wirral 010E","E01007271","Total",121,42,21,58,12,1,4,7,109,41,17,51
"2011","Wirral 010F","E01032903","Total",202,55,20,127,15,1,6,8,187,54,14,119
"2011","Wirral 011A","E01007120","Total",107,38,21,48,11,1,6,4,96,37,15,44
"2011","Wirral 011B","E01007121","Total",113,30,19,64,9,0,2,7,104,30,17,57
"2011","Wirral 011C","E01007122","Total",142,25,14,103,13,0,5,8,129,25,9,95
"2011","Wirral 011D","E01007123","Total",211,60,21,130,11,2,3,6,200,58,18,124
"2011","Wirral 011E","E01007124","Total",148,57,11,80,6,1,1,4,142,56,10,76
"2011","Wirral 012A","E01007208","Total",72,26,15,31,5,1,1,3,67,25,14,28
"2011","Wirral 012B","E01007221","Total",53,17,19,17,7,2,5,0,46,15,14,17
"2011","Wirral 012C","E01007225","Total",37,17,11,9,6,1,3,2,31,16,8,7
"2011","Wirral 012D","E01007227","Total",74,25,13,36,5,0,3,2,69,25,10,34
"2011","Wirral 012E","E01007228","Total",53,15,9,29,8,2,4,2,45,13,5,27
"2011","Wirral 013A","E01007195","Total",39,17,13,9,8,1,4,3,31,16,9,6
"2011","Wirral 013B","E01007199","Total",12,5,4,3,1,0,0,1,11,5,4,2
"2011","Wirral 013C","E01007222","Total",68,32,29,7,10,0,10,0,58,32,19,7
"2011","Wirral 013D","E01007223","Total",40,15,12,13,7,2,3,2,33,13,9,11
"2011","Wirral 014A","E01007193","Total",32,8,11,13,6,0,4,2,26,8,7,11
"2011","Wirral 014B","E01007194","Total",42,11,18,13,5,0,5,0,37,11,13,13
"2011","Wirral 014C","E01007200","Total",19,5,10,4,4,1,2,1,15,4,8,3
"2011","Wirral 014D","E01007201","Total",41,15,14,12,4,0,0,4,37,15,14,8
"2011","Wirral 014E","E01007202","Total",62,25,24,13,6,3,1,2,56,22,23,11
"2011","Wirral 015A","E01007125","Total",117,41,19,57,9,1,2,6,108,40,17,51
"2011","Wirral 015B","E01007156","Total",33,15,7,11,1,0,0,1,32,15,7,10
"2011","Wirral 015C","E01007157","Total",52,16,14,22,9,1,6,2,43,15,8,20
"2011","Wirral 015D","E01007158","Total",38,22,11,5,4,1,3,0,34,21,8,5
"2011","Wirral 015E","E01007159","Total",40,15,16,9,7,1,4,2,33,14,12,7
"2011","Wirral 016A","E01007126","Total",111,25,16,70,15,0,3,12,96,25,13,58
"2011","Wirral 016B","E01007127","Total",160,38,14,108,10,0,1,9,150,38,13,99
"2011","Wirral 016C","E01007128","Total",97,25,11,61,9,0,3,6,88,25,8,55
"2011","Wirral 016D","E01007129","Total",115,30,17,68,8,1,3,4,107,29,14,64
"2011","Wirral 016E","E01007133","Total",68,18,2,48,5,0,0,5,63,18,2,43
"2011","Wirral 017A","E01007224","Total",33,12,15,6,10,3,6,1,23,9,9,5
"2011","Wirral 017B","E01007226","Total",47,13,22,12,6,0,6,0,41,13,16,12
"2011","Wirral 017C","E01007265","Total",37,20,7,10,1,0,1,0,36,20,6,10
"2011","Wirral 017D","E01007299","Total",45,16,22,7,4,0,4,0,41,16,18,7
"2011","Wirral 017E","E01007306","Total",49,17,19,13,7,1,4,2,42,16,15,11
"2011","Wirral 018A","E01007297","Total",66,18,14,34,6,0,1,5,60,18,13,29
"2011","Wirral 018B","E01007298","Total",17,7,8,2,2,0,1,1,15,7,7,1
"2011","Wirral 018C","E01007301","Total",52,19,16,17,3,0,3,0,49,19,13,17
"2011","Wirral 018D","E01007302","Total",55,18,11,26,4,1,0,3,51,17,11,23
"2011","Wirral 018E","E01007305","Total",40,13,17,10,3,0,3,0,37,13,14,10
"2011","Wirral 019A","E01007119","Total",102,37,9,56,9,0,3,6,93,37,6,50
"2011","Wirral 019B","E01007161","Total",34,17,6,11,2,0,2,0,32,17,4,11
"2011","Wirral 019C","E01007162","Total",116,35,15,66,11,3,0,8,105,32,15,58
"2011","Wirral 019D","E01007300","Total",113,40,17,56,5,0,4,1,108,40,13,55
"2011","Wirral 020A","E01007155","Total",50,15,16,19,5,1,3,1,45,14,13,18
"2011","Wirral 020B","E01007160","Total",50,21,11,18,6,1,3,2,44,20,8,16
"2011","Wirral 020C","E01007240","Total",43,18,13,12,7,1,2,4,36,17,11,8
"2011","Wirral 020D","E01007241","Total",19,11,7,1,3,0,3,0,16,11,4,1
"2011","Wirral 020E","E01007242","Total",34,12,12,10,7,0,7,0,27,12,5,10
"2011","Wirral 021A","E01007130","Total",111,39,21,51,9,3,2,4,102,36,19,47
"2011","Wirral 021B","E01007131","Total",138,34,26,78,8,0,3,5,130,34,23,73
"2011","Wirral 021C","E01007179","Total",96,17,20,59,9,2,3,4,87,15,17,55
"2011","Wirral 021D","E01007291","Total",135,34,18,83,14,2,5,7,121,32,13,76
"2011","Wirral 021E","E01007292","Total",137,37,20,80,13,3,3,7,124,34,17,73
"2011","Wirral 021F","E01007294","Total",144,50,25,69,8,0,3,5,136,50,22,64
"2011","Wirral 022A","E01007180","Total",46,10,15,21,3,0,2,1,43,10,13,20
"2011","Wirral 022B","E01007181","Total",67,26,12,29,2,1,0,1,65,25,12,28
"2011","Wirral 022C","E01007239","Total",99,23,21,55,13,0,9,4,86,23,12,51
"2011","Wirral 022D","E01007243","Total",44,19,12,13,3,0,2,1,41,19,10,12
"2011","Wirral 022E","E01007244","Total",148,50,34,64,15,2,7,6,133,48,27,58
"2011","Wirral 023A","E01007259","Total",20,6,11,3,2,0,2,0,18,6,9,3
"2011","Wirral 023B","E01007261","Total",21,7,8,6,3,0,1,2,18,7,7,4
"2011","Wirral 023C","E01007264","Total",30,11,16,3,4,0,4,0,26,11,12,3
"2011","Wirral 023D","E01007266","Total",22,8,9,5,4,1,1,2,18,7,8,3
"2011","Wirral 023E","E01007267","Total",36,21,11,4,1,1,0,0,35,20,11,4
"2011","Wirral 023F","E01007268","Total",24,6,8,10,3,1,1,1,21,5,7,9
"2011","Wirral 024A","E01007163","Total",70,20,23,27,6,1,3,2,64,19,20,25
"2011","Wirral 024B","E01007245","Total",31,12,10,9,3,0,3,0,28,12,7,9
"2011","Wirral 024C","E01007246","Total",34,16,13,5,1,0,1,0,33,16,12,5
"2011","Wirral 024D","E01007247","Total",44,23,14,7,1,1,0,0,43,22,14,7
"2011","Wirral 024E","E01007252","Total",34,12,8,14,1,0,1,0,33,12,7,14
"2011","Wirral 025A","E01007249","Total",79,27,9,43,4,0,1,3,75,27,8,40
"2011","Wirral 025B","E01007251","Total",22,8,8,6,3,0,3,0,19,8,5,6
"2011","Wirral 025C","E01007257","Total",79,27,13,39,4,0,0,4,75,27,13,35
"2011","Wirral 025D","E01007303","Total",79,28,10,41,3,0,1,2,76,28,9,39
"2011","Wirral 025E","E01007304","Total",125,39,19,67,9,2,4,3,116,37,15,64
"2011","Wirral 026A","E01007196","Total",36,18,11,7,3,0,3,0,33,18,8,7
"2011","Wirral 026B","E01007197","Total",31,13,9,9,2,1,1,0,29,12,8,9
"2011","Wirral 026C","E01007198","Total",48,18,18,12,4,0,3,1,44,18,15,11
"2011","Wirral 026D","E01007263","Total",49,11,14,24,6,0,1,5,43,11,13,19
"2011","Wirral 026E","E01007282","Total",49,27,10,12,4,1,0,3,45,26,10,9
"2011","Wirral 027A","E01007175","Total",104,30,19,55,8,1,4,3,96,29,15,52
"2011","Wirral 027B","E01007290","Total",119,46,14,59,5,3,1,1,114,43,13,58
"2011","Wirral 027C","E01007293","Total",140,42,7,91,8,2,2,4,132,40,5,87
"2011","Wirral 027D","E01007295","Total",93,28,10,55,9,0,0,9,84,28,10,46
"2011","Wirral 027E","E01007296","Total",137,33,31,73,13,0,5,8,124,33,26,65
"2011","Wirral 028A","E01007258","Total",32,10,11,11,2,0,2,0,30,10,9,11
"2011","Wirral 028B","E01007260","Total",33,10,16,7,7,0,7,0,26,10,9,7
"2011","Wirral 028C","E01007262","Total",23,8,12,3,4,2,1,1,19,6,11,2
"2011","Wirral 028D","E01007281","Total",10,4,5,1,3,0,3,0,7,4,2,1
"2011","Wirral 028E","E01007283","Total",18,6,9,3,7,2,4,1,11,4,5,2
"2011","Wirral 029A","E01007173","Total",38,14,12,12,8,0,7,1,30,14,5,11
"2011","Wirral 029B","E01007174","Total",63,29,15,19,3,0,3,0,60,29,12,19
"2011","Wirral 029C","E01007176","Total",73,26,15,32,4,0,0,4,69,26,15,28
"2011","Wirral 029D","E01007177","Total",69,30,20,19,7,0,5,2,62,30,15,17
"2011","Wirral 029E","E01007178","Total",49,17,13,19,3,0,2,1,46,17,11,18
"2011","Wirral 030A","E01007248","Total",19,6,9,4,7,0,6,1,12,6,3,3
"2011","Wirral 030B","E01007250","Total",24,12,6,6,0,0,0,0,24,12,6,6
"2011","Wirral 030C","E01007253","Total",64,22,12,30,4,0,3,1,60,22,9,29
"2011","Wirral 030D","E01007254","Total",19,8,7,4,3,0,2,1,16,8,5,3
"2011","Wirral 031A","E01007115","Total",56,22,11,23,0,0,0,0,56,22,11,23
"2011","Wirral 031B","E01007138","Total",96,32,15,49,12,2,6,4,84,30,9,45
"2011","Wirral 031C","E01007139","Total",74,28,17,29,3,1,0,2,71,27,17,27
"2011","Wirral 031D","E01007141","Total",70,27,15,28,4,0,1,3,66,27,14,25
"2011","Wirral 031E","E01007289","Total",164,41,16,107,15,5,3,7,149,36,13,100
"2011","Wirral 032A","E01007111","Total",37,17,7,13,1,0,1,0,36,17,6,13
"2011","Wirral 032B","E01007112","Total",54,13,19,22,5,1,3,1,49,12,16,21
"2011","Wirral 032C","E01007113","Total",21,4,14,3,2,0,2,0,19,4,12,3
"2011","Wirral 032D","E01007114","Total",97,38,21,38,3,0,1,2,94,38,20,36
"2011","Wirral 032E","E01007116","Total",43,18,10,15,5,1,2,2,38,17,8,13
"2011","Wirral 033A","E01007280","Total",44,19,17,8,6,2,4,0,38,17,13,8
"2011","Wirral 033B","E01007284","Total",14,6,6,2,2,0,1,1,12,6,5,1
"2011","Wirral 033C","E01007285","Total",39,19,9,11,3,0,3,0,36,19,6,11
"2011","Wirral 033D","E01007287","Total",38,21,9,8,3,0,3,0,35,21,6,8
"2011","Wirral 034A","E01007183","Total",17,7,8,2,2,0,2,0,15,7,6,2
"2011","Wirral 034B","E01007255","Total",26,10,6,10,1,0,1,0,25,10,5,10
"2011","Wirral 034C","E01007256","Total",26,6,11,9,2,0,2,0,24,6,9,9
"2011","Wirral 034D","E01007279","Total",55,17,21,17,11,1,8,2,44,16,13,15
"2011","Wirral 034E","E01007286","Total",49,21,16,12,7,0,3,4,42,21,13,8
"2011","Wirral 035A","E01007110","Total",41,15,11,15,4,0,1,3,37,15,10,12
"2011","Wirral 035B","E01007117","Total",58,25,25,8,9,0,8,1,49,25,17,7
"2011","Wirral 035C","E01007118","Total",70,22,20,28,4,0,2,2,66,22,18,26
"2011","Wirral 035D","E01007151","Total",42,12,19,11,7,0,6,1,35,12,13,10
"2011","Wirral 035E","E01007154","Total",28,13,12,3,2,0,2,0,26,13,10,3
"2011","Wirral 036A","E01007140","Total",82,31,26,25,10,1,6,3,72,30,20,22
"2011","Wirral 036B","E01007142","Total",27,9,13,5,3,1,2,0,24,8,11,5
"2011","Wirral 036C","E01007143","Total",88,45,19,24,7,0,3,4,81,45,16,20
"2011","Wirral 036D","E01007152","Total",50,18,17,15,4,1,3,0,46,17,14,15
"2011","Wirral 036E","E01007153","Total",40,15,12,13,0,0,0,0,40,15,12,13
"2011","Wirral 037A","E01007182","Total",17,7,4,6,2,0,2,0,15,7,2,6
"2011","Wirral 037B","E01007184","Total",28,9,12,7,3,0,2,1,25,9,10,6
"2011","Wirral 037C","E01007185","Total",60,24,23,13,8,2,3,3,52,22,20,10
"2011","Wirral 037D","E01007192","Total",15,6,4,5,4,0,3,1,11,6,1,4
"2011","Wirral 037E","E01007288","Total",60,19,23,18,6,0,6,0,54,19,17,18
"2011","Wirral 038A","E01007144","Total",12,4,4,4,3,2,1,0,9,2,3,4
"2011","Wirral 038B","E01007145","Total",14,4,5,5,2,0,1,1,12,4,4,4
"2011","Wirral 038C","E01007146","Total",27,11,11,5,3,0,2,1,24,11,9,4
"2011","Wirral 038D","E01007147","Total",26,11,10,5,2,1,1,0,24,10,9,5
"2011","Wirral 038E","E01007148","Total",10,5,4,1,0,0,0,0,10,5,4,1
"2011","Wirral 039A","E01007135","Total",34,10,14,10,9,0,6,3,25,10,8,7
"2011","Wirral 039B","E01007136","Total",97,31,32,34,7,0,6,1,90,31,26,33
"2011","Wirral 039C","E01007137","Total",66,25,19,22,3,0,2,1,63,25,17,21
"2011","Wirral 039D","E01007170","Total",25,9,10,6,1,0,1,0,24,9,9,6
"2011","Wirral 040A","E01007186","Total",29,11,16,2,1,0,1,0,28,11,15,2
"2011","Wirral 040B","E01007187","Total",10,3,5,2,0,0,0,0,10,3,5,2
"2011","Wirral 040C","E01007188","Total",18,8,7,3,3,1,1,1,15,7,6,2
"2011","Wirral 040D","E01007189","Total",16,5,7,4,2,0,2,0,14,5,5,4
"2011","Wirral 040E","E01007190","Total",17,7,9,1,6,1,5,0,11,6,4,1
"2011","Wirral 040F","E01007191","Total",10,2,5,3,2,0,2,0,8,2,3,3
"2011","Wirral 041A","E01007149","Total",16,6,6,4,2,0,1,1,14,6,5,3
"2011","Wirral 041B","E01007150","Total",25,14,5,6,1,1,0,0,24,13,5,6
"2011","Wirral 041C","E01007165","Total",24,9,8,7,1,1,0,0,23,8,8,7
"2011","Wirral 041D","E01007171","Total",19,10,7,2,2,0,2,0,17,10,5,2
"2011","Wirral 041E","E01007172","Total",19,7,9,3,2,0,2,0,17,7,7,3
"2011","Wirral 042A","E01007164","Total",42,16,11,15,8,1,4,3,34,15,7,12
"2011","Wirral 042B","E01007166","Total",29,11,11,7,4,0,4,0,25,11,7,7
"2011","Wirral 042C","E01007167","Total",61,17,20,24,4,0,2,2,57,17,18,22
"2011","Wirral 042D","E01007168","Total",66,23,15,28,6,0,4,2,60,23,11,26
"2011","Wirral 042E","E01007169","Total",64,23,23,18,7,0,3,4,57,23,20,14
"2011","East Riding of Yorkshire 001A","E01012933","Total",11,5,5,1,2,0,2,0,9,5,3,1
"2011","East Riding of Yorkshire 001B","E01012934","Total",37,12,14,11,8,1,7,0,29,11,7,11
"2011","East Riding of Yorkshire 001C","E01012938","Total",57,17,15,25,8,0,6,2,49,17,9,23
"2011","East Riding of Yorkshire 001D","E01012939","Total",28,16,6,6,2,1,1,0,26,15,5,6
"2011","East Riding of Yorkshire 001E","E01012940","Total",25,12,10,3,4,0,4,0,21,12,6,3
"2011","East Riding of Yorkshire 001F","E01012941","Total",17,9,3,5,2,0,1,1,15,9,2,4
"2011","East Riding of Yorkshire 002A","E01012929","Total",91,28,22,41,8,0,6,2,83,28,16,39
"2011","East Riding of Yorkshire 002B","E01012930","Total",39,15,11,13,1,0,0,1,38,15,11,12
"2011","East Riding of Yorkshire 002C","E01012935","Total",12,5,5,2,1,0,1,0,11,5,4,2
"2011","East Riding of Yorkshire 002D","E01012937","Total",33,11,8,14,4,0,3,1,29,11,5,13
"2011","East Riding of Yorkshire 002E","E01012942","Total",15,6,6,3,2,0,2,0,13,6,4,3
"2011","East Riding of Yorkshire 003A","E01012928","Total",89,29,10,50,9,1,4,4,80,28,6,46
"2011","East Riding of Yorkshire 003B","E01012931","Total",74,26,15,33,9,2,4,3,65,24,11,30
"2011","East Riding of Yorkshire 003C","E01012932","Total",95,18,23,54,8,0,5,3,87,18,18,51
"2011","East Riding of Yorkshire 003D","E01012946","Total",96,29,7,60,5,1,0,4,91,28,7,56
"2011","East Riding of Yorkshire 003E","E01012949","Total",42,12,8,22,3,1,2,0,39,11,6,22
"2011","East Riding of Yorkshire 004A","E01012936","Total",14,6,3,5,2,1,1,0,12,5,2,5
"2011","East Riding of Yorkshire 004B","E01012943","Total",55,25,10,20,4,1,2,1,51,24,8,19
"2011","East Riding of Yorkshire 004C","E01012945","Total",66,24,8,34,9,1,3,5,57,23,5,29
"2011","East Riding of Yorkshire 004D","E01012952","Total",49,19,12,18,12,2,5,5,37,17,7,13
"2011","East Riding of Yorkshire 005A","E01012944","Total",48,9,6,33,11,2,5,4,37,7,1,29
"2011","East Riding of Yorkshire 005B","E01012947","Total",41,15,11,15,6,2,3,1,35,13,8,14
"2011","East Riding of Yorkshire 005C","E01012948","Total",45,10,10,25,14,1,7,6,31,9,3,19
"2011","East Riding of Yorkshire 005D","E01012951","Total",27,8,2,17,3,1,0,2,24,7,2,15
"2011","East Riding of Yorkshire 006A","E01012950","Total",20,7,10,3,5,0,5,0,15,7,5,3
"2011","East Riding of Yorkshire 006B","E01012990","Total",24,15,3,6,3,3,0,0,21,12,3,6
"2011","East Riding of Yorkshire 006C","E01012991","Total",31,14,10,7,2,0,2,0,29,14,8,7
"2011","East Riding of Yorkshire 006D","E01012992","Total",28,10,7,11,8,2,4,2,20,8,3,9
"2011","East Riding of Yorkshire 008A","E01012978","Total",21,8,12,1,2,0,2,0,19,8,10,1
"2011","East Riding of Yorkshire 008B","E01012981","Total",16,4,6,6,2,1,1,0,14,3,5,6
"2011","East Riding of Yorkshire 008C","E01012983","Total",30,12,10,8,3,0,3,0,27,12,7,8
"2011","East Riding of Yorkshire 008D","E01012989","Total",26,16,5,5,2,1,1,0,24,15,4,5
"2011","East Riding of Yorkshire 008E","E01013125","Total",24,11,10,3,1,0,1,0,23,11,9,3
"2011","East Riding of Yorkshire 009A","E01013057","Total",22,12,7,3,1,0,1,0,21,12,6,3
"2011","East Riding of Yorkshire 009B","E01013059","Total",23,11,10,2,2,0,2,0,21,11,8,2
"2011","East Riding of Yorkshire 009C","E01013060","Total",29,16,9,4,3,0,2,1,26,16,7,3
"2011","East Riding of Yorkshire 009D","E01013061","Total",28,15,9,4,0,0,0,0,28,15,9,4
"2011","East Riding of Yorkshire 009E","E01013126","Total",27,9,12,6,4,2,1,1,23,7,11,5
"2011","East Riding of Yorkshire 010A","E01012986","Total",19,9,5,5,3,1,2,0,16,8,3,5
"2011","East Riding of Yorkshire 010B","E01012987","Total",21,13,4,4,1,1,0,0,20,12,4,4
"2011","East Riding of Yorkshire 010C","E01012988","Total",31,11,12,8,4,0,3,1,27,11,9,7
"2011","East Riding of Yorkshire 010D","E01013048","Total",37,11,13,13,1,0,1,0,36,11,12,13
"2011","East Riding of Yorkshire 011A","E01013052","Total",28,10,15,3,4,1,1,2,24,9,14,1
"2011","East Riding of Yorkshire 011B","E01013053","Total",13,4,6,3,0,0,0,0,13,4,6,3
"2011","East Riding of Yorkshire 011C","E01013054","Total",47,14,20,13,10,0,8,2,37,14,12,11
"2011","East Riding of Yorkshire 011D","E01013055","Total",51,14,22,15,6,0,3,3,45,14,19,12
"2011","East Riding of Yorkshire 011E","E01013056","Total",55,11,25,19,6,0,6,0,49,11,19,19
"2011","East Riding of Yorkshire 011F","E01013058","Total",25,9,9,7,4,0,4,0,21,9,5,7
"2011","East Riding of Yorkshire 011G","E01013119","Total",21,6,9,6,2,0,1,1,19,6,8,5
"2011","East Riding of Yorkshire 012A","E01013046","Total",27,7,7,13,2,0,2,0,25,7,5,13
"2011","East Riding of Yorkshire 012B","E01013047","Total",34,11,11,12,3,0,1,2,31,11,10,10
"2011","East Riding of Yorkshire 012C","E01013049","Total",47,21,15,11,7,2,5,0,40,19,10,11
"2011","East Riding of Yorkshire 012D","E01013050","Total",36,13,13,10,4,0,2,2,32,13,11,8
"2011","East Riding of Yorkshire 012E","E01013051","Total",74,22,18,34,4,0,2,2,70,22,16,32
"2011","East Riding of Yorkshire 013A","E01012922","Total",29,17,9,3,4,1,2,1,25,16,7,2
"2011","East Riding of Yorkshire 013B","E01012923","Total",31,10,17,4,4,0,4,0,27,10,13,4
"2011","East Riding of Yorkshire 013C","E01012925","Total",22,13,6,3,4,1,2,1,18,12,4,2
"2011","East Riding of Yorkshire 013D","E01012927","Total",19,6,11,2,2,0,2,0,17,6,9,2
"2011","East Riding of Yorkshire 014A","E01012924","Total",30,12,11,7,6,0,5,1,24,12,6,6
"2011","East Riding of Yorkshire 014B","E01012926","Total",37,13,12,12,6,0,2,4,31,13,10,8
"2011","East Riding of Yorkshire 014C","E01013027","Total",31,15,7,9,4,1,2,1,27,14,5,8
"2011","East Riding of Yorkshire 014D","E01013034","Total",23,7,11,5,4,0,4,0,19,7,7,5
"2011","East Riding of Yorkshire 015A","E01013120","Total",31,10,11,10,4,0,3,1,27,10,8,9
"2011","East Riding of Yorkshire 015B","E01013121","Total",43,12,25,6,10,0,8,2,33,12,17,4
"2011","East Riding of Yorkshire 015C","E01013123","Total",35,14,11,10,3,0,1,2,32,14,10,8
"2011","East Riding of Yorkshire 015D","E01013124","Total",78,32,24,22,8,0,6,2,70,32,18,20
"2011","East Riding of Yorkshire 016A","E01013064","Total",28,10,12,6,5,0,5,0,23,10,7,6
"2011","East Riding of Yorkshire 016B","E01013065","Total",24,7,10,7,3,0,3,0,21,7,7,7
"2011","East Riding of Yorkshire 016C","E01013066","Total",34,13,16,5,3,1,2,0,31,12,14,5
"2011","East Riding of Yorkshire 016D","E01013067","Total",21,13,7,1,2,0,2,0,19,13,5,1
"2011","East Riding of Yorkshire 016E","E01013068","Total",16,10,4,2,1,0,1,0,15,10,3,2
"2011","East Riding of Yorkshire 016F","E01013070","Total",24,9,12,3,6,0,5,1,18,9,7,2
"2011","East Riding of Yorkshire 017A","E01013038","Total",83,30,12,41,9,1,1,7,74,29,11,34
"2011","East Riding of Yorkshire 017B","E01013045","Total",101,34,25,42,15,3,6,6,86,31,19,36
"2011","East Riding of Yorkshire 017C","E01013069","Total",50,26,12,12,3,0,3,0,47,26,9,12
"2011","East Riding of Yorkshire 017D","E01013071","Total",66,20,20,26,9,1,7,1,57,19,13,25
"2011","East Riding of Yorkshire 018A","E01013022","Total",16,8,4,4,1,0,0,1,15,8,4,3
"2011","East Riding of Yorkshire 018B","E01013023","Total",12,6,4,2,0,0,0,0,12,6,4,2
"2011","East Riding of Yorkshire 018C","E01013024","Total",51,26,14,11,8,1,6,1,43,25,8,10
"2011","East Riding of Yorkshire 018D","E01013122","Total",16,7,3,6,1,0,0,1,15,7,3,5
"2011","East Riding of Yorkshire 018E","E01013127","Total",20,10,5,5,3,1,2,0,17,9,3,5
"2011","East Riding of Yorkshire 019A","E01013036","Total",76,27,32,17,8,0,6,2,68,27,26,15
"2011","East Riding of Yorkshire 019B","E01013037","Total",42,15,21,6,7,1,5,1,35,14,16,5
"2011","East Riding of Yorkshire 019C","E01013040","Total",71,25,29,17,11,1,8,2,60,24,21,15
"2011","East Riding of Yorkshire 019D","E01013041","Total",34,11,15,8,11,2,9,0,23,9,6,8
"2011","East Riding of Yorkshire 019E","E01013062","Total",47,12,19,16,6,0,5,1,41,12,14,15
"2011","East Riding of Yorkshire 019F","E01013063","Total",35,15,14,6,4,0,2,2,31,15,12,4
"2011","East Riding of Yorkshire 020A","E01012919","Total",24,13,11,0,3,1,2,0,21,12,9,0
"2011","East Riding of Yorkshire 020B","E01012921","Total",24,10,13,1,2,0,1,1,22,10,12,0
"2011","East Riding of Yorkshire 020C","E01013039","Total",28,11,10,7,7,0,4,3,21,11,6,4
"2011","East Riding of Yorkshire 020D","E01013042","Total",39,13,21,5,3,0,3,0,36,13,18,5
"2011","East Riding of Yorkshire 020E","E01013043","Total",51,25,18,8,7,0,7,0,44,25,11,8
"2011","East Riding of Yorkshire 020F","E01013044","Total",31,12,15,4,4,1,3,0,27,11,12,4
"2011","East Riding of Yorkshire 021A","E01013029","Total",30,15,6,9,5,1,1,3,25,14,5,6
"2011","East Riding of Yorkshire 021B","E01013030","Total",15,5,8,2,4,1,3,0,11,4,5,2
"2011","East Riding of Yorkshire 021C","E01013031","Total",25,11,10,4,7,2,3,2,18,9,7,2
"2011","East Riding of Yorkshire 021D","E01013032","Total",20,14,5,1,0,0,0,0,20,14,5,1
"2011","East Riding of Yorkshire 021E","E01013035","Total",13,9,3,1,1,0,1,0,12,9,2,1
"2011","East Riding of Yorkshire 022A","E01012954","Total",21,7,5,9,1,0,1,0,20,7,4,9
"2011","East Riding of Yorkshire 022B","E01012956","Total",20,7,10,3,2,0,2,0,18,7,8,3
"2011","East Riding of Yorkshire 022C","E01012958","Total",11,8,2,1,3,0,2,1,8,8,0,0
"2011","East Riding of Yorkshire 022D","E01012961","Total",33,13,12,8,3,0,1,2,30,13,11,6
"2011","East Riding of Yorkshire 022E","E01012966","Total",11,6,4,1,1,0,1,0,10,6,3,1
"2011","East Riding of Yorkshire 023A","E01012953","Total",13,5,7,1,2,0,2,0,11,5,5,1
"2011","East Riding of Yorkshire 023B","E01012955","Total",29,10,11,8,4,0,4,0,25,10,7,8
"2011","East Riding of Yorkshire 023C","E01012959","Total",31,12,13,6,6,0,5,1,25,12,8,5
"2011","East Riding of Yorkshire 023D","E01012962","Total",7,2,2,3,2,1,1,0,5,1,1,3
"2011","East Riding of Yorkshire 023E","E01012964","Total",69,25,24,20,7,0,7,0,62,25,17,20
"2011","East Riding of Yorkshire 024A","E01012920","Total",24,7,7,10,5,2,1,2,19,5,6,8
"2011","East Riding of Yorkshire 024B","E01012965","Total",11,2,7,2,3,0,3,0,8,2,4,2
"2011","East Riding of Yorkshire 024C","E01012967","Total",22,6,12,4,4,0,2,2,18,6,10,2
"2011","East Riding of Yorkshire 024D","E01012968","Total",16,3,9,4,2,0,1,1,14,3,8,3
"2011","East Riding of Yorkshire 024E","E01012969","Total",26,10,12,4,1,1,0,0,25,9,12,4
"2011","East Riding of Yorkshire 025A","E01012957","Total",40,14,23,3,5,2,2,1,35,12,21,2
"2011","East Riding of Yorkshire 025B","E01012960","Total",32,12,15,5,2,1,1,0,30,11,14,5
"2011","East Riding of Yorkshire 025C","E01012963","Total",65,22,10,33,9,0,1,8,56,22,9,25
"2011","East Riding of Yorkshire 025D","E01013112","Total",17,11,4,2,2,1,1,0,15,10,3,2
"2011","East Riding of Yorkshire 026A","E01013018","Total",52,22,14,16,2,1,1,0,50,21,13,16
"2011","East Riding of Yorkshire 026B","E01013019","Total",27,11,11,5,5,1,3,1,22,10,8,4
"2011","East Riding of Yorkshire 026C","E01013021","Total",14,3,5,6,0,0,0,0,14,3,5,6
"2011","East Riding of Yorkshire 026D","E01013025","Total",16,7,5,4,0,0,0,0,16,7,5,4
"2011","East Riding of Yorkshire 026E","E01013026","Total",24,12,6,6,2,0,2,0,22,12,4,6
"2011","East Riding of Yorkshire 027A","E01013105","Total",55,15,17,23,6,0,5,1,49,15,12,22
"2011","East Riding of Yorkshire 027B","E01013110","Total",33,9,19,5,6,0,6,0,27,9,13,5
"2011","East Riding of Yorkshire 027C","E01013111","Total",29,14,10,5,6,0,4,2,23,14,6,3
"2011","East Riding of Yorkshire 027D","E01013115","Total",41,14,18,9,3,1,2,0,38,13,16,9
"2011","East Riding of Yorkshire 027E","E01013117","Total",15,7,7,1,2,1,1,0,13,6,6,1
"2011","East Riding of Yorkshire 028A","E01013108","Total",13,8,5,0,3,0,3,0,10,8,2,0
"2011","East Riding of Yorkshire 028B","E01013113","Total",28,9,17,2,1,0,1,0,27,9,16,2
"2011","East Riding of Yorkshire 028C","E01013114","Total",16,4,10,2,7,1,6,0,9,3,4,2
"2011","East Riding of Yorkshire 028D","E01013116","Total",11,2,5,4,3,0,3,0,8,2,2,4
"2011","East Riding of Yorkshire 028E","E01013118","Total",17,8,7,2,2,1,1,0,15,7,6,2
"2011","East Riding of Yorkshire 029A","E01013094","Total",21,8,7,6,1,0,1,0,20,8,6,6
"2011","East Riding of Yorkshire 029B","E01013095","Total",41,20,14,7,5,1,4,0,36,19,10,7
"2011","East Riding of Yorkshire 029C","E01013096","Total",47,18,14,15,5,0,4,1,42,18,10,14
"2011","East Riding of Yorkshire 029D","E01013097","Total",54,21,23,10,6,2,4,0,48,19,19,10
"2011","East Riding of Yorkshire 029E","E01013102","Total",25,12,8,5,4,2,1,1,21,10,7,4
"2011","East Riding of Yorkshire 031A","E01013028","Total",20,9,10,1,3,0,3,0,17,9,7,1
"2011","East Riding of Yorkshire 031B","E01013078","Total",22,6,8,8,3,0,2,1,19,6,6,7
"2011","East Riding of Yorkshire 031C","E01013081","Total",21,10,4,7,2,1,0,1,19,9,4,6
"2011","East Riding of Yorkshire 031D","E01013082","Total",35,21,7,7,1,1,0,0,34,20,7,7
"2011","East Riding of Yorkshire 031E","E01013085","Total",43,18,15,10,8,2,6,0,35,16,9,10
"2011","East Riding of Yorkshire 032A","E01012970","Total",13,7,6,0,1,0,1,0,12,7,5,0
"2011","East Riding of Yorkshire 032C","E01012972","Total",27,8,16,3,3,0,3,0,24,8,13,3
"2011","East Riding of Yorkshire 032D","E01012973","Total",65,29,34,2,8,1,7,0,57,28,27,2
"2011","East Riding of Yorkshire 032E","E01012974","Total",39,13,21,5,7,0,6,1,32,13,15,4
"2011","East Riding of Yorkshire 032F","E01013092","Total",34,14,18,2,11,0,9,2,23,14,9,0
"2011","East Riding of Yorkshire 032G","E01033495","Total",48,17,26,5,7,0,6,1,41,17,20,4
"2011","East Riding of Yorkshire 032H","E01033496","Total",29,10,12,7,2,0,2,0,27,10,10,7
"2011","East Riding of Yorkshire 033A","E01013033","Total",33,14,11,8,3,1,1,1,30,13,10,7
"2011","East Riding of Yorkshire 033B","E01013098","Total",59,26,21,12,4,1,3,0,55,25,18,12
"2011","East Riding of Yorkshire 033C","E01013099","Total",56,17,13,26,9,1,3,5,47,16,10,21
"2011","East Riding of Yorkshire 033D","E01013100","Total",27,16,7,4,6,2,2,2,21,14,5,2
"2011","East Riding of Yorkshire 033E","E01013101","Total",29,18,6,5,2,1,1,0,27,17,5,5
"2011","East Riding of Yorkshire 034A","E01013008","Total",57,26,19,12,6,2,4,0,51,24,15,12
"2011","East Riding of Yorkshire 034B","E01013009","Total",44,13,14,17,5,0,4,1,39,13,10,16
"2011","East Riding of Yorkshire 034C","E01013013","Total",51,24,14,13,4,0,4,0,47,24,10,13
"2011","East Riding of Yorkshire 034D","E01013014","Total",52,17,18,17,7,1,4,2,45,16,14,15
"2011","East Riding of Yorkshire 034E","E01013107","Total",62,28,18,16,9,2,3,4,53,26,15,12
"2011","East Riding of Yorkshire 035A","E01013088","Total",19,7,7,5,1,0,1,0,18,7,6,5
"2011","East Riding of Yorkshire 035B","E01013089","Total",33,14,17,2,2,0,2,0,31,14,15,2
"2011","East Riding of Yorkshire 035C","E01013090","Total",23,9,10,4,4,1,1,2,19,8,9,2
"2011","East Riding of Yorkshire 035D","E01013091","Total",32,12,14,6,3,0,2,1,29,12,12,5
"2011","East Riding of Yorkshire 035E","E01013093","Total",24,9,10,5,4,0,2,2,20,9,8,3
"2011","East Riding of Yorkshire 036A","E01013005","Total",11,3,7,1,3,0,3,0,8,3,4,1
"2011","East Riding of Yorkshire 036B","E01013007","Total",41,15,15,11,4,0,2,2,37,15,13,9
"2011","East Riding of Yorkshire 036C","E01013011","Total",32,17,8,7,0,0,0,0,32,17,8,7
"2011","East Riding of Yorkshire 036D","E01013012","Total",11,3,7,1,2,0,2,0,9,3,5,1
"2011","East Riding of Yorkshire 037A","E01012996","Total",25,9,13,3,6,0,6,0,19,9,7,3
"2011","East Riding of Yorkshire 037B","E01012998","Total",50,23,17,10,3,0,2,1,47,23,15,9
"2011","East Riding of Yorkshire 037C","E01013015","Total",26,8,10,8,2,0,2,0,24,8,8,8
"2011","East Riding of Yorkshire 037D","E01013016","Total",12,4,7,1,2,0,2,0,10,4,5,1
"2011","East Riding of Yorkshire 038A","E01013003","Total",25,9,6,10,4,1,2,1,21,8,4,9
"2011","East Riding of Yorkshire 038B","E01013017","Total",37,16,8,13,2,0,1,1,35,16,7,12
"2011","East Riding of Yorkshire 038C","E01013020","Total",27,14,7,6,1,0,1,0,26,14,6,6
"2011","East Riding of Yorkshire 038D","E01013076","Total",28,11,7,10,4,0,1,3,24,11,6,7
"2011","East Riding of Yorkshire 039A","E01013079","Total",16,10,4,2,3,2,1,0,13,8,3,2
"2011","East Riding of Yorkshire 039B","E01013080","Total",84,24,23,37,13,0,6,7,71,24,17,30
"2011","East Riding of Yorkshire 039C","E01013083","Total",53,24,6,23,6,2,1,3,47,22,5,20
"2011","East Riding of Yorkshire 039D","E01013084","Total",73,22,12,39,12,1,4,7,61,21,8,32
"2011","East Riding of Yorkshire 039E","E01013086","Total",39,11,11,17,2,0,2,0,37,11,9,17
"2011","East Riding of Yorkshire 039F","E01013087","Total",24,7,4,13,1,0,0,1,23,7,4,12
"2011","East Riding of Yorkshire 040A","E01012993","Total",15,8,5,2,1,0,1,0,14,8,4,2
"2011","East Riding of Yorkshire 040B","E01012997","Total",67,23,17,27,8,1,3,4,59,22,14,23
"2011","East Riding of Yorkshire 040C","E01012999","Total",80,22,14,44,10,2,6,2,70,20,8,42
"2011","East Riding of Yorkshire 040D","E01013001","Total",51,29,11,11,3,1,2,0,48,28,9,11
"2011","East Riding of Yorkshire 040E","E01013074","Total",28,13,9,6,2,0,0,2,26,13,9,4
"2011","East Riding of Yorkshire 041A","E01012994","Total",48,19,13,16,8,0,4,4,40,19,9,12
"2011","East Riding of Yorkshire 041B","E01012995","Total",108,47,27,34,5,0,3,2,103,47,24,32
"2011","East Riding of Yorkshire 041C","E01013000","Total",89,20,30,39,15,1,9,5,74,19,21,34
"2011","East Riding of Yorkshire 041D","E01013002","Total",89,29,18,42,10,0,4,6,79,29,14,36
"2011","East Riding of Yorkshire 041E","E01013004","Total",87,32,18,37,8,2,4,2,79,30,14,35
"2011","East Riding of Yorkshire 042A","E01013072","Total",39,13,17,9,5,1,3,1,34,12,14,8
"2011","East Riding of Yorkshire 042B","E01013073","Total",33,10,16,7,6,0,5,1,27,10,11,6
"2011","East Riding of Yorkshire 042C","E01013075","Total",23,10,9,4,2,0,2,0,21,10,7,4
"2011","East Riding of Yorkshire 042D","E01013077","Total",35,10,18,7,6,0,6,0,29,10,12,7
"2011","East Riding of Yorkshire 043A","E01013006","Total",59,24,16,19,5,2,0,3,54,22,16,16
"2011","East Riding of Yorkshire 043B","E01013010","Total",41,23,10,8,8,2,4,2,33,21,6,6
"2011","East Riding of Yorkshire 043C","E01013103","Total",21,11,6,4,1,0,1,0,20,11,5,4
"2011","East Riding of Yorkshire 043D","E01013104","Total",26,10,10,6,0,0,0,0,26,10,10,6
"2011","East Riding of Yorkshire 043E","E01013106","Total",42,14,13,15,2,0,1,1,40,14,12,14
"2011","East Riding of Yorkshire 043F","E01032596","Total",34,19,8,7,4,0,3,1,30,19,5,6
"2011","East Riding of Yorkshire 044A","E01012975","Total",25,11,8,6,1,0,0,1,24,11,8,5
"2011","East Riding of Yorkshire 044B","E01012977","Total",56,23,20,13,8,1,6,1,48,22,14,12
"2011","East Riding of Yorkshire 044C","E01012984","Total",26,13,8,5,1,0,1,0,25,13,7,5
"2011","East Riding of Yorkshire 044D","E01012985","Total",35,14,8,13,3,1,1,1,32,13,7,12
"2011","East Riding of Yorkshire 045A","E01012976","Total",56,21,13,22,5,0,2,3,51,21,11,19
"2011","East Riding of Yorkshire 045B","E01012979","Total",34,15,9,10,4,0,2,2,30,15,7,8
"2011","East Riding of Yorkshire 045C","E01012980","Total",69,32,16,21,6,0,3,3,63,32,13,18
"2011","East Riding of Yorkshire 045D","E01012982","Total",44,12,21,11,7,0,6,1,37,12,15,10
"2011","Kingston upon Hull 001A","E01012779","Total",93,23,9,61,7,0,3,4,86,23,6,57
"2011","Kingston upon Hull 001B","E01012780","Total",113,30,13,70,8,2,4,2,105,28,9,68
"2011","Kingston upon Hull 001C","E01012781","Total",72,24,4,44,3,0,0,3,69,24,4,41
"2011","Kingston upon Hull 001E","E01012832","Total",41,16,4,21,4,0,2,2,37,16,2,19
"2011","Kingston upon Hull 001F","E01033105","Total",30,13,11,6,3,1,2,0,27,12,9,6
"2011","Kingston upon Hull 001G","E01033106","Total",26,10,13,3,3,1,1,1,23,9,12,2
"2011","Kingston upon Hull 001H","E01033107","Total",27,11,10,6,5,1,4,0,22,10,6,6
"2011","Kingston upon Hull 001I","E01033108","Total",42,15,18,9,1,0,1,0,41,15,17,9
"2011","Kingston upon Hull 002A","E01012782","Total",101,31,11,59,7,0,3,4,94,31,8,55
"2011","Kingston upon Hull 002B","E01012785","Total",107,33,15,59,9,0,5,4,98,33,10,55
"2011","Kingston upon Hull 002C","E01012786","Total",45,19,5,21,4,1,1,2,41,18,4,19
"2011","Kingston upon Hull 002D","E01012787","Total",116,32,13,71,7,0,3,4,109,32,10,67
"2011","Kingston upon Hull 002E","E01012788","Total",97,35,11,51,6,1,2,3,91,34,9,48
"2011","Kingston upon Hull 002F","E01012789","Total",88,33,10,45,6,0,2,4,82,33,8,41
"2011","Kingston upon Hull 003A","E01012875","Total",109,26,14,69,6,1,4,1,103,25,10,68
"2011","Kingston upon Hull 003B","E01012876","Total",127,24,5,98,7,0,2,5,120,24,3,93
"2011","Kingston upon Hull 003C","E01012877","Total",99,28,11,60,6,2,1,3,93,26,10,57
"2011","Kingston upon Hull 003D","E01012878","Total",114,31,11,72,10,0,4,6,104,31,7,66
"2011","Kingston upon Hull 003E","E01012879","Total",124,31,6,87,11,1,3,7,113,30,3,80
"2011","Kingston upon Hull 004A","E01012778","Total",101,31,8,62,4,0,2,2,97,31,6,60
"2011","Kingston upon Hull 004B","E01012783","Total",84,23,14,47,3,0,1,2,81,23,13,45
"2011","Kingston upon Hull 004C","E01012784","Total",110,39,20,51,10,2,3,5,100,37,17,46
"2011","Kingston upon Hull 004D","E01012790","Total",62,24,16,22,5,2,2,1,57,22,14,21
"2011","Kingston upon Hull 004E","E01012906","Total",129,48,15,66,5,0,2,3,124,48,13,63
"2011","Kingston upon Hull 004F","E01012908","Total",62,19,14,29,7,0,3,4,55,19,11,25
"2011","Kingston upon Hull 005A","E01012764","Total",15,3,8,4,4,0,3,1,11,3,5,3
"2011","Kingston upon Hull 005B","E01012765","Total",38,21,9,8,3,0,1,2,35,21,8,6
"2011","Kingston upon Hull 005C","E01012768","Total",33,12,13,8,8,0,7,1,25,12,6,7
"2011","Kingston upon Hull 005D","E01012769","Total",20,9,6,5,3,2,1,0,17,7,5,5
"2011","Kingston upon Hull 006A","E01012829","Total",22,8,11,3,0,0,0,0,22,8,11,3
"2011","Kingston upon Hull 006B","E01012830","Total",33,16,12,5,2,0,2,0,31,16,10,5
"2011","Kingston upon Hull 006C","E01012905","Total",77,26,9,42,5,0,1,4,72,26,8,38
"2011","Kingston upon Hull 006D","E01012910","Total",43,23,10,10,7,1,4,2,36,22,6,8
"2011","Kingston upon Hull 006E","E01012912","Total",42,18,13,11,5,1,4,0,37,17,9,11
"2011","Kingston upon Hull 007A","E01012822","Total",35,13,10,12,4,0,2,2,31,13,8,10
"2011","Kingston upon Hull 007B","E01012904","Total",40,9,11,20,2,0,0,2,38,9,11,18
"2011","Kingston upon Hull 007C","E01012907","Total",60,21,12,27,7,1,2,4,53,20,10,23
"2011","Kingston upon Hull 007D","E01012909","Total",28,14,11,3,7,2,4,1,21,12,7,2
"2011","Kingston upon Hull 007E","E01012911","Total",33,21,9,3,0,0,0,0,33,21,9,3
"2011","Kingston upon Hull 008A","E01012873","Total",143,37,16,90,12,1,5,6,131,36,11,84
"2011","Kingston upon Hull 008B","E01012874","Total",99,27,8,64,10,2,2,6,89,25,6,58
"2011","Kingston upon Hull 008C","E01012880","Total",129,32,14,83,8,1,3,4,121,31,11,79
"2011","Kingston upon Hull 008D","E01012881","Total",108,28,19,61,16,1,6,9,92,27,13,52
"2011","Kingston upon Hull 008E","E01012915","Total",79,17,13,49,6,0,2,4,73,17,11,45
"2011","Kingston upon Hull 008F","E01012917","Total",67,13,4,50,6,0,1,5,61,13,3,45
"2011","Kingston upon Hull 008G","E01012918","Total",102,29,18,55,7,1,2,4,95,28,16,51
"2011","Kingston upon Hull 009A","E01012833","Total",90,35,11,44,5,2,0,3,85,33,11,41
"2011","Kingston upon Hull 009B","E01012835","Total",17,6,7,4,1,0,1,0,16,6,6,4
"2011","Kingston upon Hull 009C","E01012836","Total",56,18,8,30,6,0,1,5,50,18,7,25
"2011","Kingston upon Hull 009D","E01012839","Total",38,10,11,17,4,1,3,0,34,9,8,17
"2011","Kingston upon Hull 009E","E01012840","Total",87,20,16,51,4,1,0,3,83,19,16,48
"2011","Kingston upon Hull 010A","E01012824","Total",45,17,10,18,7,0,5,2,38,17,5,16
"2011","Kingston upon Hull 010B","E01012825","Total",27,12,5,10,4,0,2,2,23,12,3,8
"2011","Kingston upon Hull 010C","E01012834","Total",110,33,18,59,9,0,2,7,101,33,16,52
"2011","Kingston upon Hull 010D","E01012837","Total",72,29,8,35,1,1,0,0,71,28,8,35
"2011","Kingston upon Hull 010E","E01012838","Total",107,29,11,67,6,0,1,5,101,29,10,62
"2011","Kingston upon Hull 011A","E01012821","Total",32,12,10,10,1,0,1,0,31,12,9,10
"2011","Kingston upon Hull 011B","E01012823","Total",83,23,9,51,7,0,1,6,76,23,8,45
"2011","Kingston upon Hull 011C","E01012826","Total",61,23,16,22,3,0,2,1,58,23,14,21
"2011","Kingston upon Hull 011D","E01012827","Total",26,7,8,11,4,1,3,0,22,6,5,11
"2011","Kingston upon Hull 011E","E01012828","Total",42,22,10,10,2,0,1,1,40,22,9,9
"2011","Kingston upon Hull 012A","E01012766","Total",26,9,12,5,3,0,2,1,23,9,10,4
"2011","Kingston upon Hull 012B","E01012767","Total",15,10,5,0,0,0,0,0,15,10,5,0
"2011","Kingston upon Hull 012C","E01012914","Total",9,1,1,7,0,0,0,0,9,1,1,7
"2011","Kingston upon Hull 012D","E01012916","Total",29,13,5,11,2,0,2,0,27,13,3,11
"2011","Kingston upon Hull 013A","E01012812","Total",23,11,9,3,3,0,3,0,20,11,6,3
"2011","Kingston upon Hull 013B","E01012813","Total",37,17,10,10,2,0,0,2,35,17,10,8
"2011","Kingston upon Hull 013C","E01012814","Total",32,14,12,6,3,0,3,0,29,14,9,6
"2011","Kingston upon Hull 013D","E01012815","Total",44,20,16,8,3,0,2,1,41,20,14,7
"2011","Kingston upon Hull 013E","E01012818","Total",32,20,9,3,3,1,2,0,29,19,7,3
"2011","Kingston upon Hull 014A","E01012791","Total",27,13,11,3,2,0,2,0,25,13,9,3
"2011","Kingston upon Hull 014B","E01012792","Total",32,14,11,7,4,0,3,1,28,14,8,6
"2011","Kingston upon Hull 014C","E01012793","Total",17,7,5,5,2,1,1,0,15,6,4,5
"2011","Kingston upon Hull 014D","E01012794","Total",45,23,14,8,6,0,5,1,39,23,9,7
"2011","Kingston upon Hull 014E","E01012913","Total",112,37,23,52,13,0,4,9,99,37,19,43
"2011","Kingston upon Hull 015A","E01012761","Total",41,11,6,24,6,1,3,2,35,10,3,22
"2011","Kingston upon Hull 015B","E01012868","Total",19,6,1,12,5,1,1,3,14,5,0,9
"2011","Kingston upon Hull 015C","E01012869","Total",33,9,8,16,0,0,0,0,33,9,8,16
"2011","Kingston upon Hull 015D","E01012871","Total",61,16,13,32,2,0,1,1,59,16,12,31
"2011","Kingston upon Hull 015E","E01012872","Total",25,8,5,12,0,0,0,0,25,8,5,12
"2011","Kingston upon Hull 016A","E01012804","Total",28,7,11,10,2,0,0,2,26,7,11,8
"2011","Kingston upon Hull 016B","E01012806","Total",66,18,12,36,5,0,2,3,61,18,10,33
"2011","Kingston upon Hull 016C","E01012807","Total",21,7,6,8,3,1,1,1,18,6,5,7
"2011","Kingston upon Hull 016D","E01012817","Total",54,21,15,18,5,0,3,2,49,21,12,16
"2011","Kingston upon Hull 016E","E01012819","Total",53,19,14,20,5,1,4,0,48,18,10,20
"2011","Kingston upon Hull 017A","E01012841","Total",138,32,11,95,7,0,2,5,131,32,9,90
"2011","Kingston upon Hull 017B","E01012844","Total",90,24,4,62,8,0,3,5,82,24,1,57
"2011","Kingston upon Hull 017C","E01012849","Total",81,29,10,42,8,0,4,4,73,29,6,38
"2011","Kingston upon Hull 017D","E01012895","Total",107,22,11,74,10,1,1,8,97,21,10,66
"2011","Kingston upon Hull 017E","E01012897","Total",129,25,11,93,12,1,1,10,117,24,10,83
"2011","Kingston upon Hull 017F","E01012898","Total",43,15,8,20,5,0,3,2,38,15,5,18
"2011","Kingston upon Hull 018A","E01012758","Total",27,10,14,3,4,0,4,0,23,10,10,3
"2011","Kingston upon Hull 018B","E01012762","Total",47,21,14,12,5,3,2,0,42,18,12,12
"2011","Kingston upon Hull 018C","E01012763","Total",38,13,6,19,3,1,0,2,35,12,6,17
"2011","Kingston upon Hull 018D","E01012866","Total",59,23,9,27,0,0,0,0,59,23,9,27
"2011","Kingston upon Hull 018E","E01012870","Total",36,16,3,17,1,0,0,1,35,16,3,16
"2011","Kingston upon Hull 019A","E01012774","Total",53,20,12,21,7,1,3,3,46,19,9,18
"2011","Kingston upon Hull 019B","E01012795","Total",81,36,14,31,9,2,5,2,72,34,9,29
"2011","Kingston upon Hull 019C","E01012797","Total",43,20,8,15,4,0,2,2,39,20,6,13
"2011","Kingston upon Hull 019D","E01012798","Total",72,28,16,28,7,1,2,4,65,27,14,24
"2011","Kingston upon Hull 019E","E01012801","Total",52,21,19,12,6,3,2,1,46,18,17,11
"2011","Kingston upon Hull 020A","E01012816","Total",36,15,9,12,4,0,3,1,32,15,6,11
"2011","Kingston upon Hull 020B","E01012848","Total",28,6,7,15,4,1,1,2,24,5,6,13
"2011","Kingston upon Hull 020C","E01012894","Total",75,24,9,42,4,1,0,3,71,23,9,39
"2011","Kingston upon Hull 020D","E01012896","Total",69,30,20,19,4,0,3,1,65,30,17,18
"2011","Kingston upon Hull 020E","E01012901","Total",34,14,13,7,5,1,4,0,29,13,9,7
"2011","Kingston upon Hull 021A","E01012842","Total",92,30,15,47,6,1,2,3,86,29,13,44
"2011","Kingston upon Hull 021B","E01012843","Total",97,18,10,69,8,0,4,4,89,18,6,65
"2011","Kingston upon Hull 021C","E01012845","Total",104,26,13,65,11,0,4,7,93,26,9,58
"2011","Kingston upon Hull 021D","E01012846","Total",74,20,8,46,7,0,3,4,67,20,5,42
"2011","Kingston upon Hull 021E","E01012847","Total",94,29,8,57,10,2,1,7,84,27,7,50
"2011","Kingston upon Hull 022A","E01012820","Total",48,18,16,14,3,0,1,2,45,18,15,12
"2011","Kingston upon Hull 022B","E01012899","Total",50,24,10,16,3,1,1,1,47,23,9,15
"2011","Kingston upon Hull 022C","E01012900","Total",85,29,11,45,7,2,3,2,78,27,8,43
"2011","Kingston upon Hull 022D","E01012902","Total",37,19,8,10,2,1,1,0,35,18,7,10
"2011","Kingston upon Hull 022E","E01012903","Total",70,25,14,31,4,1,2,1,66,24,12,30
"2011","Kingston upon Hull 023A","E01012796","Total",34,15,10,9,5,0,5,0,29,15,5,9
"2011","Kingston upon Hull 023B","E01012799","Total",55,17,18,20,7,0,5,2,48,17,13,18
"2011","Kingston upon Hull 023C","E01012800","Total",55,17,15,23,7,1,2,4,48,16,13,19
"2011","Kingston upon Hull 023D","E01012802","Total",43,17,11,15,2,0,0,2,41,17,11,13
"2011","Kingston upon Hull 023E","E01012803","Total",66,29,18,19,7,1,5,1,59,28,13,18
"2011","Kingston upon Hull 024A","E01012850","Total",67,21,8,38,8,2,1,5,59,19,7,33
"2011","Kingston upon Hull 024B","E01012852","Total",72,18,8,46,5,0,2,3,67,18,6,43
"2011","Kingston upon Hull 024C","E01012856","Total",76,17,7,52,6,2,1,3,70,15,6,49
"2011","Kingston upon Hull 024D","E01012857","Total",66,11,10,45,7,1,4,2,59,10,6,43
"2011","Kingston upon Hull 024E","E01012867","Total",72,14,14,44,7,2,1,4,65,12,13,40
"2011","Kingston upon Hull 025A","E01012756","Total",49,16,19,14,2,0,2,0,47,16,17,14
"2011","Kingston upon Hull 025B","E01012757","Total",51,14,18,19,7,0,6,1,44,14,12,18
"2011","Kingston upon Hull 025C","E01012759","Total",58,28,16,14,8,1,5,2,50,27,11,12
"2011","Kingston upon Hull 025D","E01012760","Total",56,17,11,28,3,0,2,1,53,17,9,27
"2011","Kingston upon Hull 025E","E01012862","Total",47,15,7,25,2,0,0,2,45,15,7,23
"2011","Kingston upon Hull 026A","E01012805","Total",60,18,12,30,6,2,2,2,54,16,10,28
"2011","Kingston upon Hull 026B","E01012808","Total",67,19,11,37,5,0,3,2,62,19,8,35
"2011","Kingston upon Hull 026C","E01012809","Total",93,25,18,50,12,4,3,5,81,21,15,45
"2011","Kingston upon Hull 026D","E01012810","Total",37,15,17,5,3,1,2,0,34,14,15,5
"2011","Kingston upon Hull 026E","E01012811","Total",45,19,17,9,3,0,3,0,42,19,14,9
"2011","Kingston upon Hull 027A","E01012773","Total",56,22,16,18,7,1,3,3,49,21,13,15
"2011","Kingston upon Hull 027B","E01012776","Total",53,20,15,18,5,2,3,0,48,18,12,18
"2011","Kingston upon Hull 027C","E01012863","Total",64,21,7,36,8,3,1,4,56,18,6,32
"2011","Kingston upon Hull 027D","E01012864","Total",73,26,18,29,9,2,4,3,64,24,14,26
"2011","Kingston upon Hull 027E","E01012865","Total",46,18,8,20,6,2,4,0,40,16,4,20
"2011","Kingston upon Hull 028A","E01012770","Total",34,14,15,5,3,0,3,0,31,14,12,5
"2011","Kingston upon Hull 028B","E01012771","Total",36,14,16,6,2,0,2,0,34,14,14,6
"2011","Kingston upon Hull 028C","E01012772","Total",29,9,14,6,8,1,5,2,21,8,9,4
"2011","Kingston upon Hull 028D","E01012775","Total",55,18,12,25,3,0,2,1,52,18,10,24
"2011","Kingston upon Hull 028E","E01012777","Total",36,14,7,15,4,1,2,1,32,13,5,14
"2011","Kingston upon Hull 029A","E01012851","Total",59,13,14,32,6,1,2,3,53,12,12,29
"2011","Kingston upon Hull 029C","E01012854","Total",74,10,17,47,16,0,6,10,58,10,11,37
"2011","Kingston upon Hull 029D","E01012855","Total",61,11,13,37,5,2,1,2,56,9,12,35
"2011","Kingston upon Hull 029E","E01033104","Total",7,1,4,2,0,0,0,0,7,1,4,2
"2011","Kingston upon Hull 029F","E01033109","Total",36,5,4,27,11,2,4,5,25,3,0,22
"2011","Kingston upon Hull 030A","E01012859","Total",86,28,11,47,8,1,2,5,78,27,9,42
"2011","Kingston upon Hull 030B","E01012889","Total",57,15,10,32,3,1,1,1,54,14,9,31
"2011","Kingston upon Hull 030C","E01012891","Total",78,12,19,47,12,2,4,6,66,10,15,41
"2011","Kingston upon Hull 030D","E01012892","Total",84,27,15,42,9,0,5,4,75,27,10,38
"2011","Kingston upon Hull 030E","E01012893","Total",94,24,12,58,5,1,2,2,89,23,10,56
"2011","Kingston upon Hull 031A","E01012858","Total",90,34,12,44,2,0,2,0,88,34,10,44
"2011","Kingston upon Hull 031B","E01012860","Total",72,30,18,24,2,0,0,2,70,30,18,22
"2011","Kingston upon Hull 031D","E01012886","Total",68,19,12,37,5,1,2,2,63,18,10,35
"2011","Kingston upon Hull 031E","E01012888","Total",79,22,10,47,4,1,2,1,75,21,8,46
"2011","Kingston upon Hull 031G","E01033110","Total",64,17,6,41,8,2,2,4,56,15,4,37
"2011","Kingston upon Hull 033A","E01012882","Total",40,17,13,10,2,0,2,0,38,17,11,10
"2011","Kingston upon Hull 033B","E01012883","Total",24,15,7,2,3,1,2,0,21,14,5,2
"2011","Kingston upon Hull 033C","E01012884","Total",99,41,18,40,9,0,3,6,90,41,15,34
"2011","Kingston upon Hull 033D","E01012887","Total",89,33,17,39,9,0,5,4,80,33,12,35
"2011","Kingston upon Hull 033E","E01032595","Total",82,41,13,28,6,1,3,2,76,40,10,26
"2011","North East Lincolnshire 001A","E01013174","Total",129,31,12,86,5,0,1,4,124,31,11,82
"2011","North East Lincolnshire 001B","E01013175","Total",20,9,2,9,1,1,0,0,19,8,2,9
"2011","North East Lincolnshire 001C","E01013176","Total",36,15,10,11,4,2,2,0,32,13,8,11
"2011","North East Lincolnshire 001D","E01013177","Total",83,29,11,43,6,0,1,5,77,29,10,38
"2011","North East Lincolnshire 001E","E01013178","Total",36,19,7,10,3,2,0,1,33,17,7,9
"2011","North East Lincolnshire 001F","E01013179","Total",41,21,5,15,4,0,3,1,37,21,2,14
"2011","North East Lincolnshire 001G","E01013180","Total",31,6,17,8,4,0,4,0,27,6,13,8
"2011","North East Lincolnshire 002A","E01013136","Total",93,17,19,57,16,0,5,11,77,17,14,46
"2011","North East Lincolnshire 002B","E01013137","Total",65,17,5,43,13,1,2,10,52,16,3,33
"2011","North East Lincolnshire 002C","E01013139","Total",78,14,9,55,8,0,5,3,70,14,4,52
"2011","North East Lincolnshire 002D","E01013142","Total",117,44,13,60,10,3,3,4,107,41,10,56
"2011","North East Lincolnshire 003A","E01013218","Total",89,26,14,49,12,3,4,5,77,23,10,44
"2011","North East Lincolnshire 003B","E01013219","Total",96,36,5,55,5,1,2,2,91,35,3,53
"2011","North East Lincolnshire 003C","E01013220","Total",112,35,10,67,7,2,3,2,105,33,7,65
"2011","North East Lincolnshire 003D","E01013221","Total",87,33,10,44,10,2,3,5,77,31,7,39
"2011","North East Lincolnshire 003E","E01013222","Total",93,27,17,49,8,1,4,3,85,26,13,46
"2011","North East Lincolnshire 004A","E01013144","Total",86,24,10,52,10,4,4,2,76,20,6,50
"2011","North East Lincolnshire 004B","E01013145","Total",21,10,5,6,4,0,2,2,17,10,3,4
"2011","North East Lincolnshire 004C","E01013146","Total",66,20,15,31,10,2,7,1,56,18,8,30
"2011","North East Lincolnshire 004D","E01013148","Total",25,11,7,7,3,0,3,0,22,11,4,7
"2011","North East Lincolnshire 005A","E01013195","Total",86,35,14,37,5,2,2,1,81,33,12,36
"2011","North East Lincolnshire 005B","E01013196","Total",90,25,7,58,3,1,0,2,87,24,7,56
"2011","North East Lincolnshire 005C","E01013201","Total",104,25,17,62,10,2,3,5,94,23,14,57
"2011","North East Lincolnshire 005D","E01013202","Total",89,34,10,45,11,3,5,3,78,31,5,42
"2011","North East Lincolnshire 005E","E01013203","Total",93,22,11,60,10,3,2,5,83,19,9,55
"2011","North East Lincolnshire 006A","E01013138","Total",106,21,6,79,10,1,2,7,96,20,4,72
"2011","North East Lincolnshire 006B","E01013140","Total",100,34,16,50,8,1,6,1,92,33,10,49
"2011","North East Lincolnshire 006C","E01013141","Total",101,33,14,54,10,0,5,5,91,33,9,49
"2011","North East Lincolnshire 006D","E01013143","Total",89,39,12,38,3,0,3,0,86,39,9,38
"2011","North East Lincolnshire 007A","E01013173","Total",29,11,13,5,2,0,1,1,27,11,12,4
"2011","North East Lincolnshire 007B","E01013223","Total",48,21,16,11,3,0,3,0,45,21,13,11
"2011","North East Lincolnshire 007C","E01013224","Total",45,21,18,6,7,0,7,0,38,21,11,6
"2011","North East Lincolnshire 007D","E01013226","Total",29,14,10,5,3,0,3,0,26,14,7,5
"2011","North East Lincolnshire 008A","E01013187","Total",29,8,7,14,3,1,1,1,26,7,6,13
"2011","North East Lincolnshire 008B","E01013188","Total",29,10,10,9,1,0,1,0,28,10,9,9
"2011","North East Lincolnshire 008C","E01013231","Total",95,45,18,32,4,0,2,2,91,45,16,30
"2011","North East Lincolnshire 008D","E01013233","Total",56,28,10,18,5,0,4,1,51,28,6,17
"2011","North East Lincolnshire 009A","E01013147","Total",75,18,15,42,5,1,1,3,70,17,14,39
"2011","North East Lincolnshire 009D","E01013234","Total",46,23,7,16,2,1,0,1,44,22,7,15
"2011","North East Lincolnshire 009E","E01033414","Total",73,28,16,29,10,0,8,2,63,28,8,27
"2011","North East Lincolnshire 010A","E01013128","Total",74,30,9,35,9,4,2,3,65,26,7,32
"2011","North East Lincolnshire 010B","E01013198","Total",59,29,14,16,2,0,2,0,57,29,12,16
"2011","North East Lincolnshire 010C","E01013199","Total",80,21,14,45,3,0,1,2,77,21,13,43
"2011","North East Lincolnshire 010D","E01013200","Total",38,24,10,4,2,0,2,0,36,24,8,4
"2011","North East Lincolnshire 011A","E01013159","Total",90,29,12,49,7,0,6,1,83,29,6,48
"2011","North East Lincolnshire 011B","E01013161","Total",88,25,19,44,9,0,4,5,79,25,15,39
"2011","North East Lincolnshire 011C","E01013162","Total",62,30,8,24,6,2,2,2,56,28,6,22
"2011","North East Lincolnshire 011D","E01013165","Total",69,21,9,39,10,2,1,7,59,19,8,32
"2011","North East Lincolnshire 012A","E01013158","Total",53,27,12,14,3,1,2,0,50,26,10,14
"2011","North East Lincolnshire 012B","E01013160","Total",36,17,9,10,5,1,3,1,31,16,6,9
"2011","North East Lincolnshire 012C","E01013163","Total",19,8,6,5,4,0,3,1,15,8,3,4
"2011","North East Lincolnshire 012D","E01013164","Total",89,42,16,31,4,0,4,0,85,42,12,31
"2011","North East Lincolnshire 012E","E01013197","Total",47,17,12,18,8,0,5,3,39,17,7,15
"2011","North East Lincolnshire 013A","E01013149","Total",25,11,6,8,2,1,1,0,23,10,5,8
"2011","North East Lincolnshire 013B","E01013150","Total",25,9,5,11,2,0,0,2,23,9,5,9
"2011","North East Lincolnshire 013C","E01013227","Total",51,18,9,24,3,0,2,1,48,18,7,23
"2011","North East Lincolnshire 013D","E01013228","Total",47,21,11,15,6,0,5,1,41,21,6,14
"2011","North East Lincolnshire 013E","E01013229","Total",92,34,12,46,5,0,0,5,87,34,12,41
"2011","North East Lincolnshire 014A","E01013131","Total",83,29,10,44,6,1,2,3,77,28,8,41
"2011","North East Lincolnshire 014B","E01013132","Total",37,17,7,13,1,0,0,1,36,17,7,12
"2011","North East Lincolnshire 014C","E01013133","Total",77,34,13,30,0,0,0,0,77,34,13,30
"2011","North East Lincolnshire 014D","E01013134","Total",51,20,7,24,4,1,2,1,47,19,5,23
"2011","North East Lincolnshire 015A","E01013206","Total",68,18,14,36,3,1,0,2,65,17,14,34
"2011","North East Lincolnshire 015B","E01013207","Total",42,16,5,21,5,2,0,3,37,14,5,18
"2011","North East Lincolnshire 015C","E01013211","Total",47,20,13,14,4,0,4,0,43,20,9,14
"2011","North East Lincolnshire 015D","E01013212","Total",117,24,15,78,8,1,1,6,109,23,14,72
"2011","North East Lincolnshire 016A","E01013181","Total",101,37,11,53,13,5,2,6,88,32,9,47
"2011","North East Lincolnshire 016B","E01013182","Total",13,6,7,0,4,0,4,0,9,6,3,0
"2011","North East Lincolnshire 016C","E01013183","Total",44,19,15,10,2,1,1,0,42,18,14,10
"2011","North East Lincolnshire 016D","E01013184","Total",42,9,12,21,2,1,0,1,40,8,12,20
"2011","North East Lincolnshire 016E","E01013185","Total",40,16,10,14,1,0,1,0,39,16,9,14
"2011","North East Lincolnshire 016F","E01013186","Total",23,9,11,3,2,0,2,0,21,9,9,3
"2011","North East Lincolnshire 017A","E01013129","Total",65,26,14,25,6,1,4,1,59,25,10,24
"2011","North East Lincolnshire 017B","E01013151","Total",14,7,5,2,2,0,2,0,12,7,3,2
"2011","North East Lincolnshire 017C","E01013152","Total",21,12,8,1,1,0,1,0,20,12,7,1
"2011","North East Lincolnshire 017D","E01013155","Total",20,5,8,7,2,0,2,0,18,5,6,7
"2011","North East Lincolnshire 018A","E01013130","Total",52,18,8,26,5,1,1,3,47,17,7,23
"2011","North East Lincolnshire 018B","E01013135","Total",29,14,2,13,1,0,0,1,28,14,2,12
"2011","North East Lincolnshire 018C","E01013154","Total",24,11,5,8,4,2,2,0,20,9,3,8
"2011","North East Lincolnshire 018D","E01013156","Total",21,9,3,9,2,1,0,1,19,8,3,8
"2011","North East Lincolnshire 019A","E01013204","Total",64,16,16,32,6,1,4,1,58,15,12,31
"2011","North East Lincolnshire 019B","E01013205","Total",116,32,8,76,8,3,0,5,108,29,8,71
"2011","North East Lincolnshire 019C","E01013208","Total",132,31,13,88,6,1,1,4,126,30,12,84
"2011","North East Lincolnshire 019D","E01013209","Total",104,33,4,67,4,0,1,3,100,33,3,64
"2011","North East Lincolnshire 019E","E01013210","Total",125,28,12,85,5,1,0,4,120,27,12,81
"2011","North East Lincolnshire 020A","E01013153","Total",19,11,2,6,1,0,0,1,18,11,2,5
"2011","North East Lincolnshire 020B","E01013157","Total",52,30,18,4,4,0,3,1,48,30,15,3
"2011","North East Lincolnshire 020C","E01013166","Total",29,10,15,4,4,0,4,0,25,10,11,4
"2011","North East Lincolnshire 020D","E01013167","Total",14,4,6,4,3,0,2,1,11,4,4,3
"2011","North East Lincolnshire 020E","E01013169","Total",18,7,7,4,1,0,1,0,17,7,6,4
"2011","North East Lincolnshire 021A","E01013189","Total",25,12,6,7,0,0,0,0,25,12,6,7
"2011","North East Lincolnshire 021B","E01013190","Total",74,43,18,13,4,1,2,1,70,42,16,12
"2011","North East Lincolnshire 021C","E01013191","Total",27,12,12,3,4,1,3,0,23,11,9,3
"2011","North East Lincolnshire 021D","E01013192","Total",51,24,10,17,4,0,1,3,47,24,9,14
"2011","North East Lincolnshire 021E","E01013194","Total",24,12,2,10,1,0,0,1,23,12,2,9
"2011","North East Lincolnshire 022A","E01013168","Total",11,5,5,1,2,0,2,0,9,5,3,1
"2011","North East Lincolnshire 022B","E01013170","Total",40,20,7,13,6,1,1,4,34,19,6,9
"2011","North East Lincolnshire 022C","E01013171","Total",26,12,10,4,5,0,5,0,21,12,5,4
"2011","North East Lincolnshire 022D","E01013172","Total",26,10,11,5,4,0,4,0,22,10,7,5
"2011","North East Lincolnshire 022E","E01013193","Total",22,12,7,3,1,0,1,0,21,12,6,3
"2011","North East Lincolnshire 023A","E01013213","Total",40,21,10,9,4,0,3,1,36,21,7,8
"2011","North East Lincolnshire 023B","E01013214","Total",21,7,9,5,3,1,2,0,18,6,7,5
"2011","North East Lincolnshire 023C","E01013215","Total",11,6,5,0,0,0,0,0,11,6,5,0
"2011","North East Lincolnshire 023D","E01013216","Total",31,15,13,3,3,0,2,1,28,15,11,2
"2011","North East Lincolnshire 023E","E01013217","Total",22,10,10,2,2,0,2,0,20,10,8,2
"2011","North East Lincolnshire 023F","E01013225","Total",20,7,8,5,1,0,1,0,19,7,7,5
"2011","North Lincolnshire 001A","E01013254","Total",74,23,16,35,8,0,2,6,66,23,14,29
"2011","North Lincolnshire 001B","E01013255","Total",45,15,12,18,7,0,4,3,38,15,8,15
"2011","North Lincolnshire 001C","E01013256","Total",75,21,23,31,9,0,8,1,66,21,15,30
"2011","North Lincolnshire 001D","E01013257","Total",30,11,14,5,2,0,2,0,28,11,12,5
"2011","North Lincolnshire 001E","E01013258","Total",66,29,14,23,10,0,6,4,56,29,8,19
"2011","North Lincolnshire 001F","E01013259","Total",74,24,9,41,3,1,2,0,71,23,7,41
"2011","North Lincolnshire 002A","E01013303","Total",30,13,8,9,6,1,5,0,24,12,3,9
"2011","North Lincolnshire 002B","E01013304","Total",33,16,11,6,0,0,0,0,33,16,11,6
"2011","North Lincolnshire 002C","E01013305","Total",21,9,5,7,1,0,1,0,20,9,4,7
"2011","North Lincolnshire 002D","E01013307","Total",43,18,11,14,4,0,3,1,39,18,8,13
"2011","North Lincolnshire 003A","E01013288","Total",42,21,15,6,5,1,4,0,37,20,11,6
"2011","North Lincolnshire 003B","E01013291","Total",68,28,8,32,5,0,1,4,63,28,7,28
"2011","North Lincolnshire 003C","E01013292","Total",48,15,20,13,8,1,5,2,40,14,15,11
"2011","North Lincolnshire 003D","E01013294","Total",35,16,7,12,2,1,1,0,33,15,6,12
"2011","North Lincolnshire 004A","E01013270","Total",51,18,16,17,4,0,1,3,47,18,15,14
"2011","North Lincolnshire 004B","E01013306","Total",28,9,8,11,5,1,3,1,23,8,5,10
"2011","North Lincolnshire 004C","E01013308","Total",41,18,9,14,3,0,2,1,38,18,7,13
"2011","North Lincolnshire 004D","E01013309","Total",24,10,7,7,0,0,0,0,24,10,7,7
"2011","North Lincolnshire 005A","E01013286","Total",60,29,13,18,3,1,2,0,57,28,11,18
"2011","North Lincolnshire 005B","E01013287","Total",19,9,6,4,2,0,2,0,17,9,4,4
"2011","North Lincolnshire 005C","E01013289","Total",28,18,10,0,6,1,5,0,22,17,5,0
"2011","North Lincolnshire 005D","E01013290","Total",26,8,7,11,1,0,0,1,25,8,7,10
"2011","North Lincolnshire 005E","E01013293","Total",13,8,2,3,0,0,0,0,13,8,2,3
"2011","North Lincolnshire 006A","E01013245","Total",56,18,14,24,9,3,4,2,47,15,10,22
"2011","North Lincolnshire 006B","E01013246","Total",32,9,7,16,8,1,6,1,24,8,1,15
"2011","North Lincolnshire 006C","E01013247","Total",34,19,8,7,1,0,1,0,33,19,7,7
"2011","North Lincolnshire 006D","E01013248","Total",38,11,20,7,8,0,8,0,30,11,12,7
"2011","North Lincolnshire 006E","E01013249","Total",61,20,21,20,7,0,6,1,54,20,15,19
"2011","North Lincolnshire 007A","E01013297","Total",35,13,15,7,10,0,8,2,25,13,7,5
"2011","North Lincolnshire 007B","E01013300","Total",59,24,8,27,7,3,2,2,52,21,6,25
"2011","North Lincolnshire 007C","E01013302","Total",29,16,4,9,2,1,0,1,27,15,4,8
"2011","North Lincolnshire 007D","E01013331","Total",49,11,11,27,9,1,4,4,40,10,7,23
"2011","North Lincolnshire 008A","E01013296","Total",74,25,14,35,4,1,1,2,70,24,13,33
"2011","North Lincolnshire 008B","E01013298","Total",74,19,15,40,9,1,0,8,65,18,15,32
"2011","North Lincolnshire 008C","E01013299","Total",87,21,16,50,7,1,2,4,80,20,14,46
"2011","North Lincolnshire 008D","E01013330","Total",65,19,13,33,7,1,5,1,58,18,8,32
"2011","North Lincolnshire 008E","E01013332","Total",48,16,10,22,4,0,2,2,44,16,8,20
"2011","North Lincolnshire 009A","E01013295","Total",29,11,8,10,3,0,3,0,26,11,5,10
"2011","North Lincolnshire 009B","E01013301","Total",39,13,8,18,4,0,3,1,35,13,5,17
"2011","North Lincolnshire 009C","E01013333","Total",24,11,7,6,3,0,3,0,21,11,4,6
"2011","North Lincolnshire 009D","E01013334","Total",39,19,7,13,5,2,3,0,34,17,4,13
"2011","North Lincolnshire 010A","E01013310","Total",62,25,9,28,6,2,2,2,56,23,7,26
"2011","North Lincolnshire 010B","E01013312","Total",122,48,13,61,10,2,4,4,112,46,9,57
"2011","North Lincolnshire 010C","E01013313","Total",51,27,13,11,6,1,5,0,45,26,8,11
"2011","North Lincolnshire 010D","E01013314","Total",43,17,14,12,4,0,4,0,39,17,10,12
"2011","North Lincolnshire 011A","E01013267","Total",17,7,3,7,4,2,2,0,13,5,1,7
"2011","North Lincolnshire 011B","E01013268","Total",38,10,9,19,3,0,3,0,35,10,6,19
"2011","North Lincolnshire 011C","E01013269","Total",20,8,5,7,3,1,2,0,17,7,3,7
"2011","North Lincolnshire 011D","E01013271","Total",73,34,14,25,5,0,4,1,68,34,10,24
"2011","North Lincolnshire 011E","E01013272","Total",47,18,15,14,5,2,3,0,42,16,12,14
"2011","North Lincolnshire 011F","E01013273","Total",24,6,11,7,0,0,0,0,24,6,11,7
"2011","North Lincolnshire 012A","E01013279","Total",92,30,11,51,10,0,6,4,82,30,5,47
"2011","North Lincolnshire 012B","E01013285","Total",22,9,10,3,7,1,4,2,15,8,6,1
"2011","North Lincolnshire 012C","E01013316","Total",23,10,9,4,2,0,1,1,21,10,8,3
"2011","North Lincolnshire 012D","E01013321","Total",32,14,11,7,1,0,0,1,31,14,11,6
"2011","North Lincolnshire 013A","E01013274","Total",44,21,12,11,7,0,4,3,37,21,8,8
"2011","North Lincolnshire 013B","E01013275","Total",37,21,10,6,2,1,1,0,35,20,9,6
"2011","North Lincolnshire 013C","E01013276","Total",49,17,12,20,4,0,2,2,45,17,10,18
"2011","North Lincolnshire 013D","E01013277","Total",35,16,14,5,5,0,5,0,30,16,9,5
"2011","North Lincolnshire 014A","E01013315","Total",32,9,3,20,1,0,0,1,31,9,3,19
"2011","North Lincolnshire 014B","E01013317","Total",38,16,12,10,1,0,0,1,37,16,12,9
"2011","North Lincolnshire 014C","E01013318","Total",32,11,12,9,5,1,3,1,27,10,9,8
"2011","North Lincolnshire 014D","E01013319","Total",113,32,24,57,9,0,6,3,104,32,18,54
"2011","North Lincolnshire 015A","E01013238","Total",48,20,16,12,0,0,0,0,48,20,16,12
"2011","North Lincolnshire 015B","E01013240","Total",84,25,21,38,8,0,4,4,76,25,17,34
"2011","North Lincolnshire 015C","E01013311","Total",114,38,12,64,11,1,4,6,103,37,8,58
"2011","North Lincolnshire 015D","E01013320","Total",46,25,7,14,3,1,2,0,43,24,5,14
"2011","North Lincolnshire 016A","E01013278","Total",91,26,14,51,10,1,6,3,81,25,8,48
"2011","North Lincolnshire 016B","E01013280","Total",34,12,10,12,6,2,3,1,28,10,7,11
"2011","North Lincolnshire 016C","E01013281","Total",75,26,16,33,6,0,3,3,69,26,13,30
"2011","North Lincolnshire 016D","E01013283","Total",75,25,8,42,3,0,0,3,72,25,8,39
"2011","North Lincolnshire 017A","E01013236","Total",32,16,7,9,3,1,2,0,29,15,5,9
"2011","North Lincolnshire 017B","E01013239","Total",47,16,14,17,5,0,5,0,42,16,9,17
"2011","North Lincolnshire 017C","E01013282","Total",64,20,11,33,3,0,0,3,61,20,11,30
"2011","North Lincolnshire 017D","E01013284","Total",72,30,10,32,5,2,2,1,67,28,8,31
"2011","North Lincolnshire 018B","E01013237","Total",97,39,10,48,2,0,2,0,95,39,8,48
"2011","North Lincolnshire 018C","E01013261","Total",26,13,9,4,1,0,1,0,25,13,8,4
"2011","North Lincolnshire 018D","E01013262","Total",18,7,8,3,2,0,1,1,16,7,7,2
"2011","North Lincolnshire 018E","E01013263","Total",19,6,8,5,3,0,3,0,16,6,5,5
"2011","North Lincolnshire 018F","E01033296","Total",28,10,7,11,1,0,0,1,27,10,7,10
"2011","North Lincolnshire 018G","E01033297","Total",67,29,27,11,1,0,1,0,66,29,26,11
"2011","North Lincolnshire 019A","E01013260","Total",25,13,10,2,3,0,2,1,22,13,8,1
"2011","North Lincolnshire 019B","E01013264","Total",52,24,16,12,7,1,5,1,45,23,11,11
"2011","North Lincolnshire 019C","E01013265","Total",20,10,10,0,1,0,1,0,19,10,9,0
"2011","North Lincolnshire 019D","E01013266","Total",40,24,9,7,1,0,1,0,39,24,8,7
"2011","North Lincolnshire 020A","E01013241","Total",25,9,9,7,1,0,0,1,24,9,9,6
"2011","North Lincolnshire 020B","E01013242","Total",25,9,10,6,3,0,3,0,22,9,7,6
"2011","North Lincolnshire 020C","E01013243","Total",55,21,16,18,0,0,0,0,55,21,16,18
"2011","North Lincolnshire 020D","E01013244","Total",57,26,14,17,1,0,1,0,56,26,13,17
"2011","North Lincolnshire 021A","E01013324","Total",8,5,2,1,0,0,0,0,8,5,2,1
"2011","North Lincolnshire 021B","E01013326","Total",29,9,9,11,3,0,0,3,26,9,9,8
"2011","North Lincolnshire 021C","E01013327","Total",21,7,4,10,2,0,1,1,19,7,3,9
"2011","North Lincolnshire 021D","E01013328","Total",32,15,8,9,4,0,3,1,28,15,5,8
"2011","North Lincolnshire 022A","E01013322","Total",56,28,13,15,2,0,2,0,54,28,11,15
"2011","North Lincolnshire 022B","E01013323","Total",44,20,8,16,3,0,1,2,41,20,7,14
"2011","North Lincolnshire 022C","E01013325","Total",19,7,7,5,1,0,1,0,18,7,6,5
"2011","North Lincolnshire 022D","E01013329","Total",33,6,10,17,3,1,0,2,30,5,10,15
"2011","North Lincolnshire 023A","E01013250","Total",30,13,8,9,0,0,0,0,30,13,8,9
"2011","North Lincolnshire 023B","E01013251","Total",17,5,7,5,2,0,1,1,15,5,6,4
"2011","North Lincolnshire 023C","E01013252","Total",33,15,13,5,2,0,2,0,31,15,11,5
"2011","North Lincolnshire 023D","E01013253","Total",34,11,13,10,6,0,5,1,28,11,8,9
"2011","York 001A","E01013436","Total",23,8,13,2,1,0,1,0,22,8,12,2
"2011","York 001B","E01013438","Total",58,28,17,13,7,2,5,0,51,26,12,13
"2011","York 001C","E01013439","Total",19,7,12,0,4,0,4,0,15,7,8,0
"2011","York 001D","E01013440","Total",35,16,10,9,3,1,2,0,32,15,8,9
"2011","York 002A","E01013370","Total",33,16,14,3,0,0,0,0,33,16,14,3
"2011","York 002B","E01013373","Total",29,15,9,5,1,0,0,1,28,15,9,4
"2011","York 002C","E01013375","Total",18,10,5,3,1,0,0,1,17,10,5,2
"2011","York 002D","E01013376","Total",19,9,7,3,3,0,3,0,16,9,4,3
"2011","York 003A","E01013371","Total",20,11,7,2,0,0,0,0,20,11,7,2
"2011","York 003B","E01013372","Total",24,10,14,0,4,0,4,0,20,10,10,0
"2011","York 003C","E01013374","Total",27,11,15,1,2,0,2,0,25,11,13,1
"2011","York 003D","E01013377","Total",24,13,8,3,1,0,1,0,23,13,7,3
"2011","York 004A","E01013404","Total",49,20,18,11,6,1,3,2,43,19,15,9
"2011","York 004B","E01013407","Total",25,12,8,5,1,0,1,0,24,12,7,5
"2011","York 004C","E01013408","Total",19,7,9,3,2,0,2,0,17,7,7,3
"2011","York 004D","E01013410","Total",68,31,11,26,9,4,2,3,59,27,9,23
"2011","York 005A","E01013405","Total",24,14,7,3,1,0,1,0,23,14,6,3
"2011","York 005B","E01013406","Total",63,33,17,13,3,0,3,0,60,33,14,13
"2011","York 005C","E01013409","Total",36,17,13,6,3,0,2,1,33,17,11,5
"2011","York 005D","E01013411","Total",26,12,12,2,6,4,2,0,20,8,10,2
"2011","York 006A","E01013428","Total",53,28,7,18,2,0,1,1,51,28,6,17
"2011","York 006B","E01013429","Total",62,27,23,12,4,1,3,0,58,26,20,12
"2011","York 006C","E01013430","Total",32,18,10,4,1,0,1,0,31,18,9,4
"2011","York 006D","E01013431","Total",50,21,20,9,4,0,4,0,46,21,16,9
"2011","York 006E","E01013435","Total",29,10,13,6,5,0,3,2,24,10,10,4
"2011","York 007A","E01013344","Total",18,2,13,3,3,0,3,0,15,2,10,3
"2011","York 007B","E01013346","Total",28,4,12,12,2,0,0,2,26,4,12,10
"2011","York 007C","E01013432","Total",58,25,22,11,6,1,5,0,52,24,17,11
"2011","York 007D","E01013433","Total",21,12,9,0,5,1,4,0,16,11,5,0
"2011","York 007E","E01013434","Total",25,9,8,8,4,0,3,1,21,9,5,7
"2011","York 008A","E01013379","Total",23,11,6,6,3,1,2,0,20,10,4,6
"2011","York 008B","E01013380","Total",31,21,9,1,4,1,3,0,27,20,6,1
"2011","York 008C","E01013385","Total",65,26,17,22,6,0,3,3,59,26,14,19
"2011","York 008D","E01013387","Total",16,10,6,0,1,1,0,0,15,9,6,0
"2011","York 008E","E01013388","Total",10,6,2,2,1,0,0,1,9,6,2,1
"2011","York 008F","E01013389","Total",21,8,8,5,3,0,2,1,18,8,6,4
"2011","York 008G","E01013437","Total",26,12,10,4,4,0,3,1,22,12,7,3
"2011","York 009A","E01013343","Total",39,10,22,7,6,0,5,1,33,10,17,6
"2011","York 009B","E01013345","Total",36,12,12,12,2,1,1,0,34,11,11,12
"2011","York 009C","E01013347","Total",79,28,21,30,7,2,5,0,72,26,16,30
"2011","York 009D","E01013349","Total",77,28,10,39,4,0,0,4,73,28,10,35
"2011","York 009E","E01013350","Total",56,15,15,26,4,1,1,2,52,14,14,24
"2011","York 010A","E01013348","Total",53,18,21,14,13,7,5,1,40,11,16,13
"2011","York 010B","E01013368","Total",50,16,22,12,7,3,2,2,43,13,20,10
"2011","York 010C","E01013382","Total",65,23,10,32,6,0,4,2,59,23,6,30
"2011","York 010D","E01013383","Total",89,42,18,29,21,16,3,2,68,26,15,27
"2011","York 010E","E01013386","Total",80,35,16,29,12,4,4,4,68,31,12,25
"2011","York 011A","E01013421","Total",18,8,6,4,0,0,0,0,18,8,6,4
"2011","York 011B","E01013422","Total",32,15,11,6,4,0,4,0,28,15,7,6
"2011","York 011C","E01013426","Total",18,6,7,5,2,0,2,0,16,6,5,5
"2011","York 011D","E01013427","Total",13,3,4,6,2,0,2,0,11,3,2,6
"2011","York 012A","E01013335","Total",74,26,16,32,7,1,3,3,67,25,13,29
"2011","York 012B","E01013336","Total",23,7,8,8,4,0,2,2,19,7,6,6
"2011","York 012C","E01013337","Total",23,9,8,6,7,1,3,3,16,8,5,3
"2011","York 012D","E01013338","Total",75,24,24,27,6,0,4,2,69,24,20,25
"2011","York 012E","E01013339","Total",22,7,10,5,4,0,3,1,18,7,7,4
"2011","York 012F","E01013392","Total",25,13,8,4,6,1,4,1,19,12,4,3
"2011","York 013A","E01013366","Total",36,19,11,6,4,1,2,1,32,18,9,5
"2011","York 013C","E01013369","Total",29,8,5,16,5,0,3,2,24,8,2,14
"2011","York 013E","E01013416","Total",81,25,18,38,6,1,2,3,75,24,16,35
"2011","York 013F","E01033067","Total",44,8,8,28,7,1,3,3,37,7,5,25
"2011","York 013G","E01033068","Total",26,4,12,10,3,0,3,0,23,4,9,10
"2011","York 013H","E01033069","Total",22,6,5,11,1,0,1,0,21,6,4,11
"2011","York 013I","E01033070","Total",10,5,3,2,1,1,0,0,9,4,3,2
"2011","York 014A","E01013381","Total",31,17,6,8,1,0,1,0,30,17,5,8
"2011","York 014B","E01013402","Total",13,6,7,0,3,0,3,0,10,6,4,0
"2011","York 014C","E01013419","Total",27,10,11,6,3,0,2,1,24,10,9,5
"2011","York 014D","E01013420","Total",35,23,11,1,2,0,2,0,33,23,9,1
"2011","York 015A","E01013384","Total",53,22,12,19,2,0,1,1,51,22,11,18
"2011","York 015B","E01013398","Total",43,21,10,12,3,1,1,1,40,20,9,11
"2011","York 015C","E01013399","Total",110,35,20,55,10,4,5,1,100,31,15,54
"2011","York 015D","E01013400","Total",50,24,11,15,6,3,2,1,44,21,9,14
"2011","York 015E","E01013401","Total",44,11,12,21,4,1,3,0,40,10,9,21
"2011","York 015F","E01013403","Total",22,11,7,4,1,0,0,1,21,11,7,3
"2011","York 016A","E01013393","Total",61,35,13,13,7,2,5,0,54,33,8,13
"2011","York 016B","E01013394","Total",68,23,13,32,5,0,4,1,63,23,9,31
"2011","York 016C","E01013395","Total",25,9,9,7,2,0,2,0,23,9,7,7
"2011","York 016D","E01013396","Total",38,19,8,11,1,0,0,1,37,19,8,10
"2011","York 016E","E01013441","Total",42,13,15,14,2,0,1,1,40,13,14,13
"2011","York 016F","E01013445","Total",70,22,16,32,8,0,4,4,62,22,12,28
"2011","York 017A","E01013390","Total",61,22,23,16,2,0,1,1,59,22,22,15
"2011","York 017B","E01013391","Total",61,20,23,18,7,0,5,2,54,20,18,16
"2011","York 017C","E01013397","Total",39,20,13,6,9,4,4,1,30,16,9,5
"2011","York 017D","E01013413","Total",32,12,14,6,2,0,2,0,30,12,12,6
"2011","York 017E","E01013417","Total",25,8,13,4,0,0,0,0,25,8,13,4
"2011","York 018A","E01013442","Total",53,19,14,20,3,1,2,0,50,18,12,20
"2011","York 018B","E01013443","Total",87,26,15,46,11,4,3,4,76,22,12,42
"2011","York 018C","E01013444","Total",91,34,11,46,9,3,2,4,82,31,9,42
"2011","York 018D","E01013446","Total",67,29,13,25,10,2,3,5,57,27,10,20
"2011","York 018E","E01013447","Total",75,33,12,30,6,0,4,2,69,33,8,28
"2011","York 018F","E01013448","Total",66,24,11,31,10,1,5,4,56,23,6,27
"2011","York 019A","E01013360","Total",32,8,21,3,2,0,2,0,30,8,19,3
"2011","York 019B","E01013361","Total",79,28,38,13,33,11,22,0,46,17,16,13
"2011","York 019C","E01013362","Total",37,14,15,8,0,0,0,0,37,14,15,8
"2011","York 019D","E01013363","Total",42,12,18,12,5,1,2,2,37,11,16,10
"2011","York 019E","E01013364","Total",43,10,20,13,12,3,7,2,31,7,13,11
"2011","York 019F","E01013418","Total",53,18,22,13,8,1,7,0,45,17,15,13
"2011","York 020A","E01013351","Total",28,14,9,5,4,0,4,0,24,14,5,5
"2011","York 020B","E01013352","Total",27,11,11,5,4,0,4,0,23,11,7,5
"2011","York 020C","E01013451","Total",22,6,10,6,2,0,2,0,20,6,8,6
"2011","York 020D","E01013452","Total",26,12,12,2,2,0,2,0,24,12,10,2
"2011","York 021A","E01013357","Total",30,7,15,8,7,1,4,2,23,6,11,6
"2011","York 021B","E01013358","Total",27,13,12,2,1,0,1,0,26,13,11,2
"2011","York 021C","E01013412","Total",63,31,18,14,6,2,4,0,57,29,14,14
"2011","York 021D","E01013414","Total",58,29,17,12,7,1,4,2,51,28,13,10
"2011","York 022A","E01013353","Total",47,20,10,17,3,1,2,0,44,19,8,17
"2011","York 022B","E01013354","Total",21,13,6,2,2,0,2,0,19,13,4,2
"2011","York 022C","E01013355","Total",16,6,9,1,1,0,1,0,15,6,8,1
"2011","York 022D","E01013356","Total",36,16,12,8,8,1,4,3,28,15,8,5
"2011","York 022E","E01013359","Total",48,18,12,18,3,0,2,1,45,18,10,17
"2011","York 022F","E01013449","Total",71,28,16,27,6,0,6,0,65,28,10,27
"2011","York 023A","E01013365","Total",58,24,22,12,10,2,6,2,48,22,16,10
"2011","York 023B","E01013378","Total",22,4,4,14,8,0,0,8,14,4,4,6
"2011","York 023C","E01013450","Total",18,6,4,8,3,1,1,1,15,5,3,7
"2011","York 024A","E01013340","Total",24,8,13,3,7,1,5,1,17,7,8,2
"2011","York 024B","E01013341","Total",31,14,15,2,1,0,1,0,30,14,14,2
"2011","York 024C","E01013342","Total",22,12,9,1,7,2,5,0,15,10,4,1
"2011","York 024D","E01013423","Total",16,5,7,4,4,0,2,2,12,5,5,2
"2011","York 024E","E01013424","Total",27,15,10,2,1,0,1,0,26,15,9,2
"2011","York 024F","E01013425","Total",51,21,23,7,4,0,4,0,47,21,19,7
"2011","Craven 001A","E01027558","Total",28,11,10,7,7,1,4,2,21,10,6,5
"2011","Craven 001B","E01027559","Total",54,24,11,19,10,3,3,4,44,21,8,15
"2011","Craven 001C","E01027569","Total",19,8,10,1,4,0,4,0,15,8,6,1
"2011","Craven 001D","E01027570","Total",52,25,13,14,9,1,4,4,43,24,9,10
"2011","Craven 002A","E01027562","Total",15,4,8,3,5,1,4,0,10,3,4,3
"2011","Craven 002B","E01027567","Total",23,11,6,6,5,0,2,3,18,11,4,3
"2011","Craven 002C","E01027585","Total",18,8,5,5,1,0,1,0,17,8,4,5
"2011","Craven 003A","E01027568","Total",37,13,18,6,4,0,4,0,33,13,14,6
"2011","Craven 003B","E01027571","Total",32,10,16,6,6,0,6,0,26,10,10,6
"2011","Craven 003C","E01027572","Total",54,22,24,8,10,0,8,2,44,22,16,6
"2011","Craven 003D","E01027573","Total",22,14,5,3,3,0,2,1,19,14,3,2
"2011","Craven 004A","E01027557","Total",14,4,7,3,4,0,3,1,10,4,4,2
"2011","Craven 004B","E01027561","Total",34,15,10,9,7,1,4,2,27,14,6,7
"2011","Craven 004C","E01027576","Total",17,7,7,3,2,0,1,1,15,7,6,2
"2011","Craven 005A","E01027574","Total",18,8,8,2,2,1,0,1,16,7,8,1
"2011","Craven 005B","E01027575","Total",48,18,19,11,3,1,1,1,45,17,18,10
"2011","Craven 005C","E01027577","Total",56,31,15,10,7,0,5,2,49,31,10,8
"2011","Craven 005D","E01027579","Total",62,21,10,31,6,2,1,3,56,19,9,28
"2011","Craven 006A","E01027578","Total",71,25,32,14,6,0,5,1,65,25,27,13
"2011","Craven 006B","E01027580","Total",55,25,9,21,2,1,0,1,53,24,9,20
"2011","Craven 006C","E01027581","Total",84,30,28,26,6,3,3,0,78,27,25,26
"2011","Craven 006D","E01027582","Total",42,16,20,6,8,1,6,1,34,15,14,5
"2011","Craven 007A","E01027556","Total",23,12,9,2,2,0,2,0,21,12,7,2
"2011","Craven 007B","E01027560","Total",66,21,27,18,17,1,15,1,49,20,12,17
"2011","Craven 007C","E01027563","Total",27,11,11,5,4,0,2,2,23,11,9,3
"2011","Craven 007D","E01027586","Total",31,14,13,4,2,0,2,0,29,14,11,4
"2011","Craven 008A","E01027555","Total",39,17,18,4,8,2,6,0,31,15,12,4
"2011","Craven 008B","E01027564","Total",36,13,13,10,6,2,3,1,30,11,10,9
"2011","Craven 008C","E01027565","Total",46,28,16,2,7,2,5,0,39,26,11,2
"2011","Craven 008D","E01027566","Total",37,17,13,7,5,1,3,1,32,16,10,6
"2011","Craven 008E","E01027583","Total",61,25,24,12,6,1,5,0,55,24,19,12
"2011","Craven 008F","E01027584","Total",38,20,14,4,4,1,3,0,34,19,11,4
"2011","Hambleton 001A","E01027591","Total",23,6,13,4,2,0,2,0,21,6,11,4
"2011","Hambleton 001B","E01027597","Total",21,14,4,3,2,1,1,0,19,13,3,3
"2011","Hambleton 001C","E01027599","Total",66,32,13,21,8,2,4,2,58,30,9,19
"2011","Hambleton 001D","E01027623","Total",26,12,8,6,2,2,0,0,24,10,8,6
"2011","Hambleton 001E","E01027625","Total",64,23,11,30,3,0,1,2,61,23,10,28
"2011","Hambleton 002A","E01027598","Total",20,5,8,7,4,1,3,0,16,4,5,7
"2011","Hambleton 002B","E01027618","Total",33,17,11,5,3,0,2,1,30,17,9,4
"2011","Hambleton 002C","E01027624","Total",26,9,9,8,5,0,5,0,21,9,4,8
"2011","Hambleton 002D","E01027626","Total",24,4,11,9,6,1,4,1,18,3,7,8
"2011","Hambleton 002E","E01027627","Total",12,5,3,4,1,1,0,0,11,4,3,4
"2011","Hambleton 003A","E01027590","Total",45,21,11,13,6,0,3,3,39,21,8,10
"2011","Hambleton 003B","E01027592","Total",17,9,6,2,4,0,3,1,13,9,3,1
"2011","Hambleton 003C","E01027613","Total",22,7,13,2,3,0,3,0,19,7,10,2
"2011","Hambleton 003D","E01027617","Total",12,5,5,2,0,0,0,0,12,5,5,2
"2011","Hambleton 004A","E01027605","Total",46,19,21,6,5,0,5,0,41,19,16,6
"2011","Hambleton 004B","E01027606","Total",28,10,12,6,2,0,1,1,26,10,11,5
"2011","Hambleton 004C","E01027608","Total",68,26,26,16,10,2,7,1,58,24,19,15
"2011","Hambleton 004D","E01027609","Total",76,34,17,25,4,0,3,1,72,34,14,24
"2011","Hambleton 004E","E01027610","Total",55,21,17,17,0,0,0,0,55,21,17,17
"2011","Hambleton 004F","E01027611","Total",26,9,14,3,4,1,3,0,22,8,11,3
"2011","Hambleton 004G","E01027612","Total",71,22,14,35,6,0,2,4,65,22,12,31
"2011","Hambleton 004H","E01027616","Total",52,25,12,15,3,0,1,2,49,25,11,13
"2011","Hambleton 005A","E01027603","Total",26,12,5,9,2,2,0,0,24,10,5,9
"2011","Hambleton 005B","E01027604","Total",20,7,10,3,5,0,4,1,15,7,6,2
"2011","Hambleton 005C","E01027607","Total",13,7,4,2,3,1,2,0,10,6,2,2
"2011","Hambleton 005D","E01027614","Total",13,4,6,3,1,0,1,0,12,4,5,3
"2011","Hambleton 005E","E01027615","Total",14,5,8,1,2,0,2,0,12,5,6,1
"2011","Hambleton 006A","E01027587","Total",31,18,8,5,3,0,2,1,28,18,6,4
"2011","Hambleton 006B","E01027588","Total",42,19,20,3,4,0,3,1,38,19,17,2
"2011","Hambleton 006C","E01027589","Total",35,11,20,4,4,0,4,0,31,11,16,4
"2011","Hambleton 006D","E01027593","Total",15,9,5,1,4,2,2,0,11,7,3,1
"2011","Hambleton 007B","E01027628","Total",26,15,9,2,3,0,3,0,23,15,6,2
"2011","Hambleton 007C","E01027633","Total",23,5,12,6,2,1,1,0,21,4,11,6
"2011","Hambleton 007D","E01033065","Total",20,10,6,4,0,0,0,0,20,10,6,4
"2011","Hambleton 007E","E01033066","Total",17,3,14,0,0,0,0,0,17,3,14,0
"2011","Hambleton 008A","E01027620","Total",54,27,13,14,2,0,1,1,52,27,12,13
"2011","Hambleton 008B","E01027630","Total",41,18,11,12,5,0,3,2,36,18,8,10
"2011","Hambleton 008C","E01027631","Total",26,11,11,4,3,0,2,1,23,11,9,3
"2011","Hambleton 008D","E01027632","Total",23,8,12,3,3,0,3,0,20,8,9,3
"2011","Hambleton 008E","E01027637","Total",30,11,16,3,5,0,5,0,25,11,11,3
"2011","Hambleton 009A","E01027621","Total",46,18,11,17,2,0,2,0,44,18,9,17
"2011","Hambleton 009B","E01027629","Total",56,24,12,20,3,0,3,0,53,24,9,20
"2011","Hambleton 009C","E01027635","Total",38,12,16,10,8,2,5,1,30,10,11,9
"2011","Hambleton 009D","E01027636","Total",23,8,7,8,3,1,1,1,20,7,6,7
"2011","Hambleton 010A","E01027594","Total",47,23,15,9,5,1,4,0,42,22,11,9
"2011","Hambleton 010B","E01027595","Total",48,16,22,10,3,0,2,1,45,16,20,9
"2011","Hambleton 010C","E01027596","Total",19,8,9,2,3,1,2,0,16,7,7,2
"2011","Hambleton 010D","E01027601","Total",37,20,14,3,3,0,3,0,34,20,11,3
"2011","Hambleton 010E","E01027622","Total",24,8,10,6,6,0,5,1,18,8,5,5
"2011","Hambleton 011A","E01027600","Total",33,16,10,7,6,2,1,3,27,14,9,4
"2011","Hambleton 011B","E01027619","Total",45,18,15,12,4,0,3,1,41,18,12,11
"2011","Hambleton 011C","E01027634","Total",35,16,10,9,3,1,0,2,32,15,10,7
"2011","Harrogate 001A","E01027666","Total",34,19,10,5,7,1,4,2,27,18,6,3
"2011","Harrogate 001B","E01027667","Total",18,11,4,3,2,1,1,0,16,10,3,3
"2011","Harrogate 001C","E01027685","Total",23,9,7,7,2,0,2,0,21,9,5,7
"2011","Harrogate 001D","E01027686","Total",23,12,6,5,4,2,2,0,19,10,4,5
"2011","Harrogate 002A","E01027712","Total",31,10,15,6,5,0,5,0,26,10,10,6
"2011","Harrogate 002B","E01027713","Total",42,13,17,12,2,0,2,0,40,13,15,12
"2011","Harrogate 002C","E01027714","Total",38,13,15,10,4,0,4,0,34,13,11,10
"2011","Harrogate 002D","E01027715","Total",12,8,4,0,2,1,1,0,10,7,3,0
"2011","Harrogate 003A","E01027643","Total",22,6,9,7,5,0,3,2,17,6,6,5
"2011","Harrogate 003B","E01027688","Total",24,11,8,5,5,1,2,2,19,10,6,3
"2011","Harrogate 003C","E01027736","Total",28,15,9,4,4,0,2,2,24,15,7,2
"2011","Harrogate 003D","E01027737","Total",24,9,11,4,8,2,3,3,16,7,8,1
"2011","Harrogate 004A","E01027705","Total",53,25,22,6,6,1,5,0,47,24,17,6
"2011","Harrogate 004B","E01027706","Total",75,26,31,18,9,0,6,3,66,26,25,15
"2011","Harrogate 004C","E01027707","Total",64,29,18,17,4,1,2,1,60,28,16,16
"2011","Harrogate 004D","E01027708","Total",25,17,5,3,1,1,0,0,24,16,5,3
"2011","Harrogate 004E","E01027709","Total",8,4,2,2,1,0,1,0,7,4,1,2
"2011","Harrogate 004F","E01027710","Total",47,20,10,17,3,0,2,1,44,20,8,16
"2011","Harrogate 004G","E01027711","Total",48,20,16,12,3,1,2,0,45,19,14,12
"2011","Harrogate 005A","E01027644","Total",33,12,13,8,3,0,2,1,30,12,11,7
"2011","Harrogate 005B","E01027645","Total",40,14,16,10,8,1,6,1,32,13,10,9
"2011","Harrogate 005C","E01027647","Total",16,6,8,2,5,0,5,0,11,6,3,2
"2011","Harrogate 005D","E01027687","Total",21,7,8,6,3,0,2,1,18,7,6,5
"2011","Harrogate 006A","E01027681","Total",29,16,6,7,4,0,3,1,25,16,3,6
"2011","Harrogate 006B","E01027693","Total",27,12,13,2,4,3,0,1,23,9,13,1
"2011","Harrogate 006C","E01027701","Total",27,9,13,5,6,0,6,0,21,9,7,5
"2011","Harrogate 006D","E01027702","Total",29,10,12,7,4,1,1,2,25,9,11,5
"2011","Harrogate 007A","E01027642","Total",19,13,3,3,2,0,1,1,17,13,2,2
"2011","Harrogate 007B","E01027646","Total",27,7,14,6,1,0,1,0,26,7,13,6
"2011","Harrogate 007C","E01027674","Total",16,9,5,2,1,0,1,0,15,9,4,2
"2011","Harrogate 007D","E01027675","Total",41,17,14,10,3,0,2,1,38,17,12,9
"2011","Harrogate 008A","E01027641","Total",18,8,9,1,4,2,2,0,14,6,7,1
"2011","Harrogate 008B","E01027664","Total",41,21,13,7,9,3,6,0,32,18,7,7
"2011","Harrogate 008C","E01027665","Total",16,7,7,2,4,1,2,1,12,6,5,1
"2011","Harrogate 008D","E01027722","Total",44,20,21,3,12,2,9,1,32,18,12,2
"2011","Harrogate 009A","E01027668","Total",55,30,13,12,5,0,4,1,50,30,9,11
"2011","Harrogate 009B","E01027669","Total",55,19,23,13,11,2,4,5,44,17,19,8
"2011","Harrogate 009C","E01027673","Total",67,25,29,13,15,1,10,4,52,24,19,9
"2011","Harrogate 009D","E01027676","Total",65,31,14,20,8,2,3,3,57,29,11,17
"2011","Harrogate 010A","E01027638","Total",21,9,8,4,5,1,4,0,16,8,4,4
"2011","Harrogate 010B","E01027639","Total",32,16,11,5,7,3,3,1,25,13,8,4
"2011","Harrogate 010C","E01027640","Total",51,19,24,8,9,2,7,0,42,17,17,8
"2011","Harrogate 010D","E01027690","Total",31,16,12,3,5,1,4,0,26,15,8,3
"2011","Harrogate 010E","E01027738","Total",56,22,21,13,8,2,5,1,48,20,16,12
"2011","Harrogate 010F","E01027739","Total",24,10,10,4,3,1,2,0,21,9,8,4
"2011","Harrogate 010G","E01027741","Total",42,21,13,8,4,0,4,0,38,21,9,8
"2011","Harrogate 011A","E01027689","Total",55,27,17,11,3,1,1,1,52,26,16,10
"2011","Harrogate 011B","E01027691","Total",53,22,18,13,2,0,1,1,51,22,17,12
"2011","Harrogate 011C","E01027720","Total",49,14,19,16,7,1,5,1,42,13,14,15
"2011","Harrogate 011D","E01027721","Total",40,12,22,6,4,0,3,1,36,12,19,5
"2011","Harrogate 011E","E01027723","Total",71,25,19,27,5,0,2,3,66,25,17,24
"2011","Harrogate 012A","E01027670","Total",54,20,21,13,4,0,4,0,50,20,17,13
"2011","Harrogate 012B","E01027671","Total",20,9,9,2,3,1,1,1,17,8,8,1
"2011","Harrogate 012C","E01027672","Total",29,11,13,5,5,0,5,0,24,11,8,5
"2011","Harrogate 012D","E01027704","Total",11,4,5,2,2,0,2,0,9,4,3,2
"2011","Harrogate 013A","E01027649","Total",60,15,24,21,6,0,4,2,54,15,20,19
"2011","Harrogate 013B","E01027651","Total",73,27,21,25,11,2,5,4,62,25,16,21
"2011","Harrogate 013C","E01027657","Total",53,19,23,11,9,3,4,2,44,16,19,9
"2011","Harrogate 013D","E01027658","Total",79,28,18,33,7,0,4,3,72,28,14,30
"2011","Harrogate 013E","E01027692","Total",36,14,12,10,6,0,3,3,30,14,9,7
"2011","Harrogate 013F","E01027740","Total",41,14,13,14,6,1,2,3,35,13,11,11
"2011","Harrogate 014A","E01027648","Total",54,23,13,18,7,0,3,4,47,23,10,14
"2011","Harrogate 014B","E01027650","Total",41,10,16,15,6,1,3,2,35,9,13,13
"2011","Harrogate 014C","E01027726","Total",68,26,28,14,11,0,7,4,57,26,21,10
"2011","Harrogate 014D","E01027727","Total",44,11,20,13,5,1,4,0,39,10,16,13
"2011","Harrogate 014E","E01027728","Total",30,12,15,3,4,0,4,0,26,12,11,3
"2011","Harrogate 014F","E01027729","Total",93,44,27,22,10,1,7,2,83,43,20,20
"2011","Harrogate 015A","E01027652","Total",49,13,24,12,4,0,4,0,45,13,20,12
"2011","Harrogate 015B","E01027655","Total",9,1,6,2,2,0,2,0,7,1,4,2
"2011","Harrogate 015C","E01027659","Total",56,16,27,13,8,0,5,3,48,16,22,10
"2011","Harrogate 015D","E01027677","Total",18,9,8,1,1,1,0,0,17,8,8,1
"2011","Harrogate 015E","E01027678","Total",43,11,18,14,7,0,3,4,36,11,15,10
"2011","Harrogate 015F","E01027680","Total",44,14,26,4,10,0,10,0,34,14,16,4
"2011","Harrogate 016A","E01027683","Total",23,5,13,5,3,0,3,0,20,5,10,5
"2011","Harrogate 016B","E01027684","Total",24,6,9,9,4,0,4,0,20,6,5,9
"2011","Harrogate 016C","E01027695","Total",33,13,15,5,5,0,5,0,28,13,10,5
"2011","Harrogate 016D","E01027696","Total",18,8,6,4,4,0,3,1,14,8,3,3
"2011","Harrogate 016E","E01027703","Total",36,18,10,8,2,0,2,0,34,18,8,8
"2011","Harrogate 017A","E01027660","Total",16,7,6,3,1,0,1,0,15,7,5,3
"2011","Harrogate 017B","E01027661","Total",41,19,9,13,5,1,2,2,36,18,7,11
"2011","Harrogate 017C","E01027662","Total",11,7,3,1,1,0,1,0,10,7,2,1
"2011","Harrogate 017D","E01027663","Total",21,10,5,6,1,0,0,1,20,10,5,5
"2011","Harrogate 017E","E01027697","Total",35,18,9,8,2,0,2,0,33,18,7,8
"2011","Harrogate 017F","E01027733","Total",19,9,7,3,1,0,1,0,18,9,6,3
"2011","Harrogate 018A","E01027682","Total",20,6,12,2,4,0,4,0,16,6,8,2
"2011","Harrogate 018B","E01027694","Total",16,4,10,2,6,2,4,0,10,2,6,2
"2011","Harrogate 018C","E01027734","Total",11,4,4,3,2,0,2,0,9,4,2,3
"2011","Harrogate 018D","E01027735","Total",22,7,10,5,11,2,6,3,11,5,4,2
"2011","Harrogate 019A","E01027656","Total",35,13,17,5,11,0,9,2,24,13,8,3
"2011","Harrogate 019B","E01027679","Total",40,23,12,5,9,4,4,1,31,19,8,4
"2011","Harrogate 019C","E01027730","Total",44,13,18,13,3,0,2,1,41,13,16,12
"2011","Harrogate 019D","E01027731","Total",50,21,23,6,2,0,2,0,48,21,21,6
"2011","Harrogate 019E","E01027732","Total",20,10,10,0,2,1,1,0,18,9,9,0
"2011","Harrogate 020A","E01027653","Total",43,23,11,9,3,1,1,1,40,22,10,8
"2011","Harrogate 020B","E01027654","Total",20,6,11,3,1,1,0,0,19,5,11,3
"2011","Harrogate 020C","E01027698","Total",35,16,14,5,1,0,1,0,34,16,13,5
"2011","Harrogate 020D","E01027716","Total",17,5,7,5,2,1,1,0,15,4,6,5
"2011","Harrogate 020E","E01027717","Total",22,8,10,4,1,1,0,0,21,7,10,4
"2011","Harrogate 020F","E01027718","Total",68,30,26,12,8,0,6,2,60,30,20,10
"2011","Harrogate 020G","E01027719","Total",37,20,12,5,4,0,3,1,33,20,9,4
"2011","Harrogate 021A","E01027699","Total",10,4,2,4,0,0,0,0,10,4,2,4
"2011","Harrogate 021B","E01027700","Total",21,10,6,5,0,0,0,0,21,10,6,5
"2011","Harrogate 021C","E01027724","Total",25,15,6,4,2,0,2,0,23,15,4,4
"2011","Harrogate 021D","E01027725","Total",25,10,12,3,7,0,6,1,18,10,6,2
"2011","Richmondshire 001A","E01027743","Total",16,8,5,3,2,0,2,0,14,8,3,3
"2011","Richmondshire 001B","E01027751","Total",27,11,11,5,4,1,2,1,23,10,9,4
"2011","Richmondshire 001C","E01027752","Total",13,7,5,1,1,0,0,1,12,7,5,0
"2011","Richmondshire 001D","E01027759","Total",27,8,11,8,8,0,6,2,19,8,5,6
"2011","Richmondshire 001E","E01027761","Total",20,9,7,4,5,2,2,1,15,7,5,3
"2011","Richmondshire 001F","E01027762","Total",16,9,4,3,2,2,0,0,14,7,4,3
"2011","Richmondshire 002A","E01027765","Total",61,21,18,22,8,0,5,3,53,21,13,19
"2011","Richmondshire 002B","E01027766","Total",33,11,18,4,0,0,0,0,33,11,18,4
"2011","Richmondshire 002C","E01027767","Total",41,21,12,8,3,0,2,1,38,21,10,7
"2011","Richmondshire 002D","E01027768","Total",28,10,11,7,1,0,1,0,27,10,10,7
"2011","Richmondshire 002E","E01027769","Total",62,16,20,26,11,0,8,3,51,16,12,23
"2011","Richmondshire 002F","E01027770","Total",76,22,26,28,16,1,9,6,60,21,17,22
"2011","Richmondshire 003A","E01027745","Total",36,11,12,13,4,1,1,2,32,10,11,11
"2011","Richmondshire 003B","E01027746","Total",36,12,10,14,4,0,3,1,32,12,7,13
"2011","Richmondshire 003C","E01027747","Total",41,15,14,12,8,1,4,3,33,14,10,9
"2011","Richmondshire 003D","E01027748","Total",31,12,13,6,1,1,0,0,30,11,13,6
"2011","Richmondshire 004A","E01027749","Total",136,53,28,55,15,6,4,5,121,47,24,50
"2011","Richmondshire 004B","E01027750","Total",97,35,36,26,7,3,3,1,90,32,33,25
"2011","Richmondshire 004C","E01027754","Total",24,8,10,6,6,0,4,2,18,8,6,4
"2011","Richmondshire 004E","E01027771","Total",24,5,16,3,5,1,4,0,19,4,12,3
"2011","Richmondshire 004F","E01027772","Total",32,14,12,6,0,0,0,0,32,14,12,6
"2011","Richmondshire 004G","E01033183","Total",16,4,8,4,5,1,2,2,11,3,6,2
"2011","Richmondshire 004H","E01033184","Total",58,20,26,12,8,1,6,1,50,19,20,11
"2011","Richmondshire 005A","E01027742","Total",10,4,4,2,1,0,1,0,9,4,3,2
"2011","Richmondshire 005B","E01027753","Total",21,11,8,2,7,1,6,0,14,10,2,2
"2011","Richmondshire 005C","E01027763","Total",9,4,4,1,1,0,1,0,8,4,3,1
"2011","Richmondshire 005D","E01027764","Total",14,6,4,4,3,0,2,1,11,6,2,3
"2011","Richmondshire 005E","E01027773","Total",8,3,4,1,2,0,2,0,6,3,2,1
"2011","Richmondshire 006A","E01027744","Total",17,4,9,4,3,0,3,0,14,4,6,4
"2011","Richmondshire 006B","E01027756","Total",53,20,14,19,2,0,1,1,51,20,13,18
"2011","Richmondshire 006D","E01027758","Total",18,8,6,4,2,0,1,1,16,8,5,3
"2011","Richmondshire 006E","E01027760","Total",17,7,7,3,1,0,1,0,16,7,6,3
"2011","Richmondshire 006F","E01033185","Total",26,12,6,8,4,1,1,2,22,11,5,6
"2011","Richmondshire 006G","E01033186","Total",20,12,4,4,4,1,3,0,16,11,1,4
"2011","Ryedale 001A","E01027776","Total",20,4,9,7,2,0,2,0,18,4,7,7
"2011","Ryedale 001B","E01027777","Total",20,10,5,5,2,0,2,0,18,10,3,5
"2011","Ryedale 001C","E01027783","Total",30,17,9,4,5,1,3,1,25,16,6,3
"2011","Ryedale 001D","E01027784","Total",45,17,14,14,10,2,6,2,35,15,8,12
"2011","Ryedale 002A","E01027792","Total",37,23,12,2,5,1,4,0,32,22,8,2
"2011","Ryedale 002B","E01027793","Total",40,21,5,14,3,0,1,2,37,21,4,12
"2011","Ryedale 002C","E01027794","Total",44,26,8,10,2,1,1,0,42,25,7,10
"2011","Ryedale 002D","E01027795","Total",47,28,11,8,2,1,1,0,45,27,10,8
"2011","Ryedale 002E","E01027801","Total",23,10,8,5,5,2,3,0,18,8,5,5
"2011","Ryedale 002F","E01027802","Total",23,12,5,6,5,3,2,0,18,9,3,6
"2011","Ryedale 003A","E01027775","Total",13,5,7,1,1,0,1,0,12,5,6,1
"2011","Ryedale 003B","E01027780","Total",26,11,11,4,4,0,3,1,22,11,8,3
"2011","Ryedale 003C","E01027781","Total",31,20,7,4,6,5,1,0,25,15,6,4
"2011","Ryedale 003D","E01027800","Total",21,13,5,3,3,2,1,0,18,11,4,3
"2011","Ryedale 004A","E01027779","Total",22,11,6,5,3,1,2,0,19,10,4,5
"2011","Ryedale 004B","E01027796","Total",28,11,10,7,3,0,2,1,25,11,8,6
"2011","Ryedale 004C","E01027798","Total",58,24,16,18,5,0,5,0,53,24,11,18
"2011","Ryedale 004D","E01027803","Total",33,9,11,13,8,1,4,3,25,8,7,10
"2011","Ryedale 007A","E01027774","Total",41,14,20,7,7,0,7,0,34,14,13,7
"2011","Ryedale 007B","E01027778","Total",38,20,12,6,7,0,6,1,31,20,6,5
"2011","Ryedale 007C","E01027782","Total",39,14,22,3,11,0,11,0,28,14,11,3
"2011","Ryedale 007D","E01027797","Total",20,6,9,5,2,0,0,2,18,6,9,3
"2011","Ryedale 007E","E01027799","Total",34,15,11,8,1,0,1,0,33,15,10,8
"2011","Ryedale 008A","E01027785","Total",45,13,22,10,7,0,6,1,38,13,16,9
"2011","Ryedale 008B","E01027786","Total",17,6,5,6,2,0,1,1,15,6,4,5
"2011","Ryedale 008C","E01027787","Total",48,23,15,10,4,2,2,0,44,21,13,10
"2011","Ryedale 008D","E01027788","Total",19,11,5,3,3,1,1,1,16,10,4,2
"2011","Ryedale 008E","E01027789","Total",83,27,14,42,4,0,1,3,79,27,13,39
"2011","Ryedale 008F","E01027790","Total",51,25,17,9,4,1,3,0,47,24,14,9
"2011","Ryedale 008G","E01027791","Total",14,7,5,2,2,0,2,0,12,7,3,2
"2011","Scarborough 001A","E01027837","Total",54,27,4,23,3,0,2,1,51,27,2,22
"2011","Scarborough 001B","E01027839","Total",34,17,7,10,1,0,1,0,33,17,6,10
"2011","Scarborough 001C","E01027869","Total",21,5,5,11,2,0,1,1,19,5,4,10
"2011","Scarborough 001D","E01027870","Total",55,21,11,23,22,3,6,13,33,18,5,10
"2011","Scarborough 001E","E01027871","Total",33,16,9,8,3,0,2,1,30,16,7,7
"2011","Scarborough 002A","E01027813","Total",21,9,4,8,2,0,2,0,19,9,2,8
"2011","Scarborough 002B","E01027822","Total",20,7,8,5,0,0,0,0,20,7,8,5
"2011","Scarborough 002C","E01027840","Total",53,22,8,23,7,1,4,2,46,21,4,21
"2011","Scarborough 002D","E01027841","Total",17,8,5,4,3,0,1,2,14,8,4,2
"2011","Scarborough 003A","E01027838","Total",23,13,6,4,2,0,2,0,21,13,4,4
"2011","Scarborough 003B","E01027864","Total",60,29,9,22,5,1,4,0,55,28,5,22
"2011","Scarborough 003C","E01027865","Total",71,26,18,27,20,7,10,3,51,19,8,24
"2011","Scarborough 003D","E01027866","Total",36,18,4,14,0,0,0,0,36,18,4,14
"2011","Scarborough 004A","E01027821","Total",16,6,3,7,2,0,0,2,14,6,3,5
"2011","Scarborough 004B","E01027823","Total",25,14,2,9,7,5,1,1,18,9,1,8
"2011","Scarborough 004C","E01027831","Total",17,11,2,4,2,0,2,0,15,11,0,4
"2011","Scarborough 004D","E01027832","Total",15,4,4,7,3,1,2,0,12,3,2,7
"2011","Scarborough 004E","E01027836","Total",47,20,15,12,7,1,4,2,40,19,11,10
"2011","Scarborough 004F","E01027857","Total",19,7,5,7,1,0,1,0,18,7,4,7
"2011","Scarborough 005A","E01027842","Total",44,23,9,12,3,0,2,1,41,23,7,11
"2011","Scarborough 005B","E01027843","Total",44,18,12,14,0,0,0,0,44,18,12,14
"2011","Scarborough 005C","E01027844","Total",23,13,8,2,2,1,1,0,21,12,7,2
"2011","Scarborough 005D","E01027845","Total",36,18,9,9,4,1,3,0,32,17,6,9
"2011","Scarborough 005E","E01027855","Total",13,4,6,3,0,0,0,0,13,4,6,3
"2011","Scarborough 005F","E01027856","Total",7,3,2,2,1,0,1,0,6,3,1,2
"2011","Scarborough 006A","E01027805","Total",56,20,10,26,6,5,0,1,50,15,10,25
"2011","Scarborough 006B","E01027806","Total",71,28,5,38,6,0,0,6,65,28,5,32
"2011","Scarborough 006C","E01027846","Total",73,34,14,25,9,3,3,3,64,31,11,22
"2011","Scarborough 006D","E01027847","Total",70,24,11,35,7,2,3,2,63,22,8,33
"2011","Scarborough 006E","E01027848","Total",24,10,7,7,6,2,3,1,18,8,4,6
"2011","Scarborough 007A","E01027849","Total",20,9,3,8,3,0,1,2,17,9,2,6
"2011","Scarborough 007B","E01027850","Total",44,14,11,19,6,0,3,3,38,14,8,16
"2011","Scarborough 007C","E01027872","Total",68,24,13,31,4,0,3,1,64,24,10,30
"2011","Scarborough 007D","E01027874","Total",124,39,8,77,6,0,2,4,118,39,6,73
"2011","Scarborough 008A","E01027810","Total",81,39,18,24,9,1,4,4,72,38,14,20
"2011","Scarborough 008B","E01027811","Total",111,48,34,29,4,1,2,1,107,47,32,28
"2011","Scarborough 008C","E01027812","Total",119,44,25,50,19,1,10,8,100,43,15,42
"2011","Scarborough 008D","E01027851","Total",38,16,16,6,3,0,3,0,35,16,13,6
"2011","Scarborough 008E","E01027862","Total",61,19,18,24,6,0,4,2,55,19,14,22
"2011","Scarborough 009A","E01027824","Total",23,10,4,9,4,3,1,0,19,7,3,9
"2011","Scarborough 009B","E01027825","Total",85,33,18,34,5,1,3,1,80,32,15,33
"2011","Scarborough 009C","E01027826","Total",67,20,20,27,6,1,4,1,61,19,16,26
"2011","Scarborough 009D","E01027861","Total",57,20,15,22,5,0,3,2,52,20,12,20
"2011","Scarborough 009E","E01027863","Total",20,10,7,3,6,2,4,0,14,8,3,3
"2011","Scarborough 009F","E01027873","Total",24,15,7,2,4,1,3,0,20,14,4,2
"2011","Scarborough 010A","E01027804","Total",67,28,12,27,17,6,6,5,50,22,6,22
"2011","Scarborough 010B","E01027852","Total",38,11,15,12,12,1,8,3,26,10,7,9
"2011","Scarborough 010C","E01027853","Total",31,9,8,14,5,0,1,4,26,9,7,10
"2011","Scarborough 010D","E01027854","Total",32,19,4,9,12,8,3,1,20,11,1,8
"2011","Scarborough 010E","E01027868","Total",29,7,11,11,3,1,1,1,26,6,10,10
"2011","Scarborough 011A","E01027807","Total",24,11,5,8,1,0,0,1,23,11,5,7
"2011","Scarborough 011B","E01027808","Total",31,16,5,10,4,0,3,1,27,16,2,9
"2011","Scarborough 011C","E01027809","Total",14,6,6,2,3,2,0,1,11,4,6,1
"2011","Scarborough 011D","E01027818","Total",55,27,9,19,2,1,1,0,53,26,8,19
"2011","Scarborough 011E","E01027867","Total",11,6,3,2,1,0,0,1,10,6,3,1
"2011","Scarborough 012A","E01027817","Total",81,24,11,46,5,0,1,4,76,24,10,42
"2011","Scarborough 012B","E01027819","Total",91,22,11,58,8,0,2,6,83,22,9,52
"2011","Scarborough 012C","E01027820","Total",85,26,11,48,6,3,1,2,79,23,10,46
"2011","Scarborough 012D","E01027858","Total",17,7,9,1,2,0,2,0,15,7,7,1
"2011","Scarborough 012E","E01027860","Total",34,17,7,10,1,0,1,0,33,17,6,10
"2011","Scarborough 013A","E01027814","Total",26,11,8,7,5,0,4,1,21,11,4,6
"2011","Scarborough 013B","E01027815","Total",19,11,4,4,1,0,1,0,18,11,3,4
"2011","Scarborough 013C","E01027816","Total",33,9,17,7,5,0,4,1,28,9,13,6
"2011","Scarborough 013D","E01027859","Total",30,16,10,4,4,0,2,2,26,16,8,2
"2011","Scarborough 014A","E01027827","Total",30,10,8,12,4,0,4,0,26,10,4,12
"2011","Scarborough 014B","E01027828","Total",28,11,4,13,4,0,2,2,24,11,2,11
"2011","Scarborough 014C","E01027829","Total",24,9,7,8,3,0,2,1,21,9,5,7
"2011","Scarborough 014D","E01027830","Total",61,29,12,20,5,1,2,2,56,28,10,18
"2011","Scarborough 014E","E01027833","Total",25,13,5,7,2,0,2,0,23,13,3,7
"2011","Scarborough 014F","E01027834","Total",36,14,11,11,7,2,5,0,29,12,6,11
"2011","Scarborough 014G","E01027835","Total",38,14,11,13,3,0,2,1,35,14,9,12
"2011","Selby 001A","E01027918","Total",30,9,12,9,7,1,6,0,23,8,6,9
"2011","Selby 001B","E01027919","Total",21,10,8,3,2,0,2,0,19,10,6,3
"2011","Selby 001C","E01027920","Total",25,13,8,4,3,0,2,1,22,13,6,3
"2011","Selby 001D","E01027921","Total",34,14,9,11,4,3,0,1,30,11,9,10
"2011","Selby 001E","E01027922","Total",18,8,6,4,2,0,2,0,16,8,4,4
"2011","Selby 002A","E01027875","Total",16,3,7,6,3,0,3,0,13,3,4,6
"2011","Selby 002B","E01027886","Total",17,4,9,4,8,2,5,1,9,2,4,3
"2011","Selby 002C","E01027887","Total",18,8,6,4,5,0,4,1,13,8,2,3
"2011","Selby 002D","E01027888","Total",26,9,11,6,0,0,0,0,26,9,11,6
"2011","Selby 002E","E01027904","Total",36,9,19,8,4,0,2,2,32,9,17,6
"2011","Selby 003A","E01027876","Total",34,16,11,7,4,0,4,0,30,16,7,7
"2011","Selby 003B","E01027877","Total",15,8,3,4,0,0,0,0,15,8,3,4
"2011","Selby 003C","E01027900","Total",40,24,10,6,4,2,1,1,36,22,9,5
"2011","Selby 003D","E01027901","Total",14,7,6,1,0,0,0,0,14,7,6,1
"2011","Selby 003E","E01027902","Total",30,15,5,10,2,0,0,2,28,15,5,8
"2011","Selby 003F","E01027903","Total",9,7,1,1,0,0,0,0,9,7,1,1
"2011","Selby 004A","E01027898","Total",37,8,21,8,5,1,3,1,32,7,18,7
"2011","Selby 004B","E01027914","Total",22,11,8,3,2,0,2,0,20,11,6,3
"2011","Selby 004C","E01027915","Total",26,8,9,9,3,1,1,1,23,7,8,8
"2011","Selby 004D","E01027916","Total",57,23,14,20,4,1,3,0,53,22,11,20
"2011","Selby 004E","E01027917","Total",48,22,19,7,7,1,5,1,41,21,14,6
"2011","Selby 005A","E01027878","Total",46,20,6,20,0,0,0,0,46,20,6,20
"2011","Selby 005B","E01027905","Total",58,19,16,23,4,1,2,1,54,18,14,22
"2011","Selby 005C","E01027907","Total",78,34,9,35,5,0,2,3,73,34,7,32
"2011","Selby 005D","E01027908","Total",57,21,11,25,4,1,2,1,53,20,9,24
"2011","Selby 005E","E01027909","Total",81,27,27,27,22,3,15,4,59,24,12,23
"2011","Selby 005F","E01027910","Total",121,49,20,52,6,0,4,2,115,49,16,50
"2011","Selby 006A","E01027881","Total",30,14,4,12,2,1,0,1,28,13,4,11
"2011","Selby 006B","E01027906","Total",48,9,11,28,3,1,2,0,45,8,9,28
"2011","Selby 006C","E01027911","Total",24,9,9,6,3,0,1,2,21,9,8,4
"2011","Selby 006D","E01027912","Total",5,3,2,0,1,0,1,0,4,3,1,0
"2011","Selby 006E","E01027913","Total",17,9,6,2,3,1,2,0,14,8,4,2
"2011","Selby 007A","E01027879","Total",20,8,7,5,3,0,2,1,17,8,5,4
"2011","Selby 007B","E01027880","Total",19,8,8,3,1,0,1,0,18,8,7,3
"2011","Selby 007C","E01027882","Total",23,9,6,8,1,0,1,0,22,9,5,8
"2011","Selby 007D","E01027894","Total",34,17,8,9,1,1,0,0,33,16,8,9
"2011","Selby 007E","E01027895","Total",26,8,10,8,4,0,3,1,22,8,7,7
"2011","Selby 008A","E01027883","Total",22,5,8,9,3,0,3,0,19,5,5,9
"2011","Selby 008B","E01027884","Total",45,16,13,16,7,0,5,2,38,16,8,14
"2011","Selby 008C","E01027885","Total",31,8,17,6,1,0,1,0,30,8,16,6
"2011","Selby 008D","E01027896","Total",42,16,17,9,7,1,5,1,35,15,12,8
"2011","Selby 008E","E01027897","Total",25,10,10,5,1,0,1,0,24,10,9,5
"2011","Selby 009A","E01027891","Total",29,16,7,6,1,0,1,0,28,16,6,6
"2011","Selby 009B","E01027892","Total",49,23,13,13,8,2,6,0,41,21,7,13
"2011","Selby 009C","E01027893","Total",18,5,10,3,2,1,0,1,16,4,10,2
"2011","Selby 009D","E01027899","Total",43,14,23,6,12,0,12,0,31,14,11,6
"2011","Selby 010A","E01027889","Total",57,17,24,16,14,1,12,1,43,16,12,15
"2011","Selby 010B","E01027890","Total",22,13,6,3,4,0,4,0,18,13,2,3
"2011","Selby 010C","E01027923","Total",39,11,14,14,4,0,3,1,35,11,11,13
"2011","Selby 010D","E01027924","Total",37,11,19,7,7,2,5,0,30,9,14,7
"2011","Barnsley 001A","E01007434","Total",64,23,15,26,7,0,2,5,57,23,13,21
"2011","Barnsley 001B","E01007435","Total",47,18,15,14,9,2,5,2,38,16,10,12
"2011","Barnsley 001C","E01007438","Total",43,15,15,13,4,0,4,0,39,15,11,13
"2011","Barnsley 001D","E01007439","Total",21,7,6,8,2,0,1,1,19,7,5,7
"2011","Barnsley 002A","E01007433","Total",73,23,17,33,12,2,4,6,61,21,13,27
"2011","Barnsley 002B","E01007436","Total",38,9,13,16,5,3,2,0,33,6,11,16
"2011","Barnsley 002C","E01007437","Total",51,21,12,18,8,4,2,2,43,17,10,16
"2011","Barnsley 002D","E01007440","Total",70,22,16,32,9,1,5,3,61,21,11,29
"2011","Barnsley 003A","E01007329","Total",46,20,11,15,8,2,4,2,38,18,7,13
"2011","Barnsley 003B","E01007331","Total",52,18,14,20,10,1,6,3,42,17,8,17
"2011","Barnsley 003C","E01007342","Total",56,18,14,24,4,1,2,1,52,17,12,23
"2011","Barnsley 003D","E01007343","Total",43,10,12,21,5,0,2,3,38,10,10,18
"2011","Barnsley 004A","E01007356","Total",28,8,8,12,8,1,2,5,20,7,6,7
"2011","Barnsley 004B","E01007357","Total",58,20,15,23,4,1,3,0,54,19,12,23
"2011","Barnsley 004C","E01007361","Total",52,17,20,15,9,0,6,3,43,17,14,12
"2011","Barnsley 004D","E01007362","Total",22,7,11,4,3,0,3,0,19,7,8,4
"2011","Barnsley 004E","E01007363","Total",50,18,4,28,4,0,2,2,46,18,2,26
"2011","Barnsley 005A","E01007355","Total",35,13,13,9,11,3,6,2,24,10,7,7
"2011","Barnsley 005B","E01007358","Total",54,19,14,21,5,0,3,2,49,19,11,19
"2011","Barnsley 005C","E01007359","Total",46,18,13,15,1,0,1,0,45,18,12,15
"2011","Barnsley 005D","E01007360","Total",39,15,12,12,4,0,2,2,35,15,10,10
"2011","Barnsley 005E","E01007386","Total",29,9,11,9,4,0,1,3,25,9,10,6
"2011","Barnsley 006A","E01007328","Total",80,16,22,42,14,0,5,9,66,16,17,33
"2011","Barnsley 006B","E01007330","Total",58,24,14,20,6,1,3,2,52,23,11,18
"2011","Barnsley 006C","E01007332","Total",101,35,24,42,11,0,6,5,90,35,18,37
"2011","Barnsley 006D","E01007333","Total",76,23,20,33,8,1,2,5,68,22,18,28
"2011","Barnsley 007A","E01007323","Total",73,17,16,40,10,2,3,5,63,15,13,35
"2011","Barnsley 007B","E01007324","Total",73,19,11,43,12,3,4,5,61,16,7,38
"2011","Barnsley 007C","E01007325","Total",124,34,15,75,15,0,7,8,109,34,8,67
"2011","Barnsley 007D","E01007326","Total",55,20,16,19,4,0,3,1,51,20,13,18
"2011","Barnsley 007E","E01007327","Total",46,13,10,23,6,0,3,3,40,13,7,20
"2011","Barnsley 007F","E01007411","Total",71,20,12,39,9,2,5,2,62,18,7,37
"2011","Barnsley 008A","E01007341","Total",71,19,11,41,12,2,4,6,59,17,7,35
"2011","Barnsley 008B","E01007345","Total",75,24,24,27,9,1,6,2,66,23,18,25
"2011","Barnsley 008C","E01007346","Total",77,28,21,28,10,3,4,3,67,25,17,25
"2011","Barnsley 008D","E01007347","Total",41,12,18,11,8,0,6,2,33,12,12,9
"2011","Barnsley 009A","E01007334","Total",21,13,5,3,3,1,2,0,18,12,3,3
"2011","Barnsley 009B","E01007335","Total",29,10,8,11,6,0,4,2,23,10,4,9
"2011","Barnsley 009C","E01007400","Total",44,23,8,13,6,1,3,2,38,22,5,11
"2011","Barnsley 009D","E01007404","Total",19,3,9,7,0,0,0,0,19,3,9,7
"2011","Barnsley 009E","E01007406","Total",68,24,10,34,4,0,2,2,64,24,8,32
"2011","Barnsley 010C","E01007408","Total",42,15,12,15,9,1,5,3,33,14,7,12
"2011","Barnsley 010D","E01007409","Total",27,9,13,5,2,0,1,1,25,9,12,4
"2011","Barnsley 010E","E01007410","Total",69,24,20,25,6,2,2,2,63,22,18,23
"2011","Barnsley 010G","E01032550","Total",116,44,19,53,11,1,5,5,105,43,14,48
"2011","Barnsley 010H","E01032551","Total",72,19,31,22,14,2,10,2,58,17,21,20
"2011","Barnsley 011A","E01007344","Total",73,29,13,31,6,1,3,2,67,28,10,29
"2011","Barnsley 011B","E01007402","Total",83,27,11,45,14,0,2,12,69,27,9,33
"2011","Barnsley 011C","E01007403","Total",71,18,10,43,7,0,2,5,64,18,8,38
"2011","Barnsley 011D","E01007405","Total",36,13,2,21,1,0,0,1,35,13,2,20
"2011","Barnsley 012A","E01007379","Total",34,12,11,11,8,1,5,2,26,11,6,9
"2011","Barnsley 012B","E01007380","Total",34,16,13,5,12,3,7,2,22,13,6,3
"2011","Barnsley 012C","E01007381","Total",30,3,19,8,5,0,4,1,25,3,15,7
"2011","Barnsley 012D","E01007387","Total",34,10,15,9,8,0,6,2,26,10,9,7
"2011","Barnsley 012E","E01007442","Total",15,6,7,2,1,0,0,1,14,6,7,1
"2011","Barnsley 012F","E01007444","Total",44,20,15,9,5,0,4,1,39,20,11,8
"2011","Barnsley 012G","E01007446","Total",31,14,11,6,2,1,1,0,29,13,10,6
"2011","Barnsley 013A","E01007336","Total",56,12,16,28,6,0,3,3,50,12,13,25
"2011","Barnsley 013B","E01007340","Total",72,28,15,29,5,2,2,1,67,26,13,28
"2011","Barnsley 013C","E01007415","Total",32,10,9,13,3,1,1,1,29,9,8,12
"2011","Barnsley 013D","E01007417","Total",94,31,21,42,10,2,4,4,84,29,17,38
"2011","Barnsley 013E","E01007441","Total",85,32,23,30,7,1,4,2,78,31,19,28
"2011","Barnsley 013F","E01007443","Total",89,25,15,49,16,3,4,9,73,22,11,40
"2011","Barnsley 013G","E01007445","Total",45,17,18,10,2,1,1,0,43,16,17,10
"2011","Barnsley 014A","E01007372","Total",74,16,9,49,6,1,2,3,68,15,7,46
"2011","Barnsley 014B","E01007373","Total",83,28,10,45,8,2,4,2,75,26,6,43
"2011","Barnsley 014C","E01007374","Total",53,23,12,18,5,2,3,0,48,21,9,18
"2011","Barnsley 014D","E01007375","Total",39,14,9,16,2,0,1,1,37,14,8,15
"2011","Barnsley 014E","E01007377","Total",53,10,8,35,8,1,5,2,45,9,3,33
"2011","Barnsley 014F","E01007378","Total",88,30,11,47,5,2,0,3,83,28,11,44
"2011","Barnsley 015A","E01007319","Total",24,13,7,4,4,0,4,0,20,13,3,4
"2011","Barnsley 015B","E01007321","Total",25,9,12,4,3,0,3,0,22,9,9,4
"2011","Barnsley 015C","E01007322","Total",85,33,21,31,7,1,4,2,78,32,17,29
"2011","Barnsley 015D","E01007337","Total",71,24,19,28,9,2,5,2,62,22,14,26
"2011","Barnsley 016A","E01007418","Total",23,12,6,5,1,0,1,0,22,12,5,5
"2011","Barnsley 016B","E01007419","Total",32,12,15,5,6,2,2,2,26,10,13,3
"2011","Barnsley 016C","E01007420","Total",27,14,10,3,4,0,4,0,23,14,6,3
"2011","Barnsley 016D","E01007425","Total",13,4,9,0,4,0,4,0,9,4,5,0
"2011","Barnsley 017A","E01007338","Total",50,17,7,26,9,0,2,7,41,17,5,19
"2011","Barnsley 017B","E01007339","Total",65,19,11,35,6,1,1,4,59,18,10,31
"2011","Barnsley 017C","E01007413","Total",91,20,11,60,3,0,1,2,88,20,10,58
"2011","Barnsley 017D","E01007414","Total",87,27,16,44,8,0,4,4,79,27,12,40
"2011","Barnsley 018A","E01007317","Total",69,15,3,51,6,0,2,4,63,15,1,47
"2011","Barnsley 018B","E01007318","Total",77,18,21,38,14,2,5,7,63,16,16,31
"2011","Barnsley 018C","E01007320","Total",84,28,9,47,11,0,5,6,73,28,4,41
"2011","Barnsley 018D","E01007416","Total",52,12,3,37,5,0,1,4,47,12,2,33
"2011","Barnsley 019A","E01007382","Total",43,15,13,15,8,3,4,1,35,12,9,14
"2011","Barnsley 019B","E01007383","Total",29,14,10,5,2,1,0,1,27,13,10,4
"2011","Barnsley 019C","E01007384","Total",40,16,13,11,3,0,3,0,37,16,10,11
"2011","Barnsley 019D","E01007385","Total",37,17,7,13,2,0,1,1,35,17,6,12
"2011","Barnsley 020A","E01007348","Total",47,15,4,28,2,0,0,2,45,15,4,26
"2011","Barnsley 020B","E01007349","Total",58,18,13,27,5,2,2,1,53,16,11,26
"2011","Barnsley 020C","E01007350","Total",20,8,6,6,4,0,3,1,16,8,3,5
"2011","Barnsley 020D","E01007351","Total",44,9,15,20,2,0,0,2,42,9,15,18
"2011","Barnsley 020E","E01007352","Total",76,27,18,31,7,0,2,5,69,27,16,26
"2011","Barnsley 020F","E01007353","Total",62,25,14,23,4,0,4,0,58,25,10,23
"2011","Barnsley 020G","E01007354","Total",54,19,8,27,2,0,1,1,52,19,7,26
"2011","Barnsley 021A","E01007458","Total",48,22,8,18,1,0,1,0,47,22,7,18
"2011","Barnsley 021B","E01007459","Total",34,14,5,15,5,2,1,2,29,12,4,13
"2011","Barnsley 021C","E01007460","Total",35,14,7,14,1,0,1,0,34,14,6,14
"2011","Barnsley 021D","E01007461","Total",74,21,15,38,8,2,0,6,66,19,15,32
"2011","Barnsley 021E","E01007462","Total",74,15,11,48,8,0,2,6,66,15,9,42
"2011","Barnsley 021F","E01007463","Total",101,25,10,66,9,3,2,4,92,22,8,62
"2011","Barnsley 022A","E01007369","Total",76,19,16,41,10,1,4,5,66,18,12,36
"2011","Barnsley 022B","E01007370","Total",71,21,9,41,7,1,4,2,64,20,5,39
"2011","Barnsley 022C","E01007371","Total",82,35,9,38,12,2,2,8,70,33,7,30
"2011","Barnsley 022D","E01007376","Total",56,12,8,36,7,1,3,3,49,11,5,33
"2011","Barnsley 023A","E01007447","Total",44,17,4,23,6,0,1,5,38,17,3,18
"2011","Barnsley 023B","E01007448","Total",80,18,20,42,7,1,5,1,73,17,15,41
"2011","Barnsley 023C","E01007449","Total",63,22,12,29,7,0,2,5,56,22,10,24
"2011","Barnsley 023D","E01007450","Total",44,12,11,21,7,0,6,1,37,12,5,20
"2011","Barnsley 024A","E01007427","Total",30,16,11,3,3,1,2,0,27,15,9,3
"2011","Barnsley 024B","E01007428","Total",36,10,19,7,8,1,6,1,28,9,13,6
"2011","Barnsley 024C","E01007429","Total",40,20,11,9,3,1,1,1,37,19,10,8
"2011","Barnsley 024D","E01007430","Total",60,24,29,7,12,2,9,1,48,22,20,6
"2011","Barnsley 024E","E01007431","Total",33,12,10,11,3,1,1,1,30,11,9,10
"2011","Barnsley 024F","E01007432","Total",39,18,12,9,5,2,3,0,34,16,9,9
"2011","Barnsley 025A","E01007364","Total",48,20,8,20,6,0,1,5,42,20,7,15
"2011","Barnsley 025B","E01007365","Total",57,16,14,27,3,1,1,1,54,15,13,26
"2011","Barnsley 025C","E01007366","Total",46,20,11,15,9,3,4,2,37,17,7,13
"2011","Barnsley 025D","E01007367","Total",57,15,13,29,7,0,5,2,50,15,8,27
"2011","Barnsley 025E","E01007368","Total",65,23,18,24,8,1,5,2,57,22,13,22
"2011","Barnsley 026A","E01007451","Total",73,19,17,37,7,0,3,4,66,19,14,33
"2011","Barnsley 026B","E01007452","Total",49,24,10,15,6,2,2,2,43,22,8,13
"2011","Barnsley 026C","E01007453","Total",75,22,9,44,6,0,0,6,69,22,9,38
"2011","Barnsley 026E","E01007455","Total",23,7,7,9,2,1,1,0,21,6,6,9
"2011","Barnsley 026F","E01032924","Total",37,8,14,15,4,0,3,1,33,8,11,14
"2011","Barnsley 026G","E01032925","Total",60,27,10,23,7,2,4,1,53,25,6,22
"2011","Barnsley 027A","E01007421","Total",11,6,4,1,1,0,1,0,10,6,3,1
"2011","Barnsley 027B","E01007422","Total",27,11,11,5,2,0,1,1,25,11,10,4
"2011","Barnsley 027C","E01007423","Total",29,13,7,9,1,1,0,0,28,12,7,9
"2011","Barnsley 027D","E01007426","Total",31,13,10,8,4,0,4,0,27,13,6,8
"2011","Barnsley 028A","E01007396","Total",63,27,17,19,5,0,3,2,58,27,14,17
"2011","Barnsley 028B","E01007397","Total",44,18,13,13,3,1,2,0,41,17,11,13
"2011","Barnsley 028C","E01007398","Total",31,13,10,8,4,0,4,0,27,13,6,8
"2011","Barnsley 028D","E01007399","Total",62,24,21,17,11,2,6,3,51,22,15,14
"2011","Barnsley 028E","E01007424","Total",37,13,15,9,5,1,3,1,32,12,12,8
"2011","Barnsley 029A","E01007388","Total",47,22,15,10,4,0,2,2,43,22,13,8
"2011","Barnsley 029B","E01007393","Total",65,22,14,29,6,1,4,1,59,21,10,28
"2011","Barnsley 029C","E01007394","Total",46,13,3,30,4,1,0,3,42,12,3,27
"2011","Barnsley 029D","E01007456","Total",51,18,21,12,7,0,5,2,44,18,16,10
"2011","Barnsley 029E","E01007457","Total",64,26,9,29,4,1,0,3,60,25,9,26
"2011","Barnsley 030A","E01007389","Total",17,8,7,2,4,0,3,1,13,8,4,1
"2011","Barnsley 030B","E01007390","Total",45,21,9,15,6,2,1,3,39,19,8,12
"2011","Barnsley 030C","E01007391","Total",64,20,15,29,11,0,5,6,53,20,10,23
"2011","Barnsley 030D","E01007392","Total",55,20,9,26,9,1,5,3,46,19,4,23
"2011","Barnsley 030E","E01007395","Total",88,34,14,40,6,0,5,1,82,34,9,39
"2011","Doncaster 001A","E01007632","Total",53,14,16,23,5,0,2,3,48,14,14,20
"2011","Doncaster 001B","E01007633","Total",49,17,4,28,3,0,1,2,46,17,3,26
"2011","Doncaster 001C","E01007634","Total",64,16,8,40,6,0,3,3,58,16,5,37
"2011","Doncaster 001D","E01007635","Total",43,9,9,25,4,1,1,2,39,8,8,23
"2011","Doncaster 002A","E01007487","Total",56,25,13,18,7,2,4,1,49,23,9,17
"2011","Doncaster 002B","E01007488","Total",31,8,7,16,5,1,3,1,26,7,4,15
"2011","Doncaster 002C","E01007489","Total",53,23,12,18,4,1,2,1,49,22,10,17
"2011","Doncaster 002D","E01007490","Total",31,13,5,13,1,0,1,0,30,13,4,13
"2011","Doncaster 002E","E01007491","Total",98,34,14,50,10,0,5,5,88,34,9,45
"2011","Doncaster 002F","E01007492","Total",56,20,14,22,4,0,3,1,52,20,11,21
"2011","Doncaster 002G","E01007493","Total",36,11,18,7,3,0,3,0,33,11,15,7
"2011","Doncaster 003A","E01007636","Total",72,14,18,40,2,0,0,2,70,14,18,38
"2011","Doncaster 003B","E01007637","Total",63,25,13,25,3,1,2,0,60,24,11,25
"2011","Doncaster 003C","E01007638","Total",69,26,12,31,3,1,1,1,66,25,11,30
"2011","Doncaster 003D","E01007639","Total",60,22,23,15,5,2,3,0,55,20,20,15
"2011","Doncaster 003E","E01007640","Total",25,10,8,7,3,0,1,2,22,10,7,5
"2011","Doncaster 003F","E01007641","Total",35,15,6,14,3,0,3,0,32,15,3,14
"2011","Doncaster 003G","E01007642","Total",64,27,9,28,5,2,3,0,59,25,6,28
"2011","Doncaster 004A","E01007625","Total",31,12,11,8,9,1,7,1,22,11,4,7
"2011","Doncaster 004B","E01007626","Total",43,14,7,22,8,0,3,5,35,14,4,17
"2011","Doncaster 004C","E01007627","Total",71,23,12,36,5,1,2,2,66,22,10,34
"2011","Doncaster 004D","E01007628","Total",70,23,10,37,8,0,2,6,62,23,8,31
"2011","Doncaster 004E","E01007629","Total",88,22,10,56,7,2,3,2,81,20,7,54
"2011","Doncaster 005A","E01007468","Total",15,11,4,0,1,1,0,0,14,10,4,0
"2011","Doncaster 005B","E01007469","Total",39,18,6,15,4,0,1,3,35,18,5,12
"2011","Doncaster 005C","E01007470","Total",61,22,18,21,6,1,3,2,55,21,15,19
"2011","Doncaster 005D","E01007472","Total",67,20,13,34,12,1,2,9,55,19,11,25
"2011","Doncaster 005E","E01007473","Total",77,23,21,33,9,0,4,5,68,23,17,28
"2011","Doncaster 005F","E01007474","Total",71,16,7,48,3,0,1,2,68,16,6,46
"2011","Doncaster 006A","E01007554","Total",32,11,12,9,3,0,3,0,29,11,9,9
"2011","Doncaster 006B","E01007555","Total",56,15,8,33,3,0,1,2,53,15,7,31
"2011","Doncaster 006C","E01007556","Total",62,17,10,35,4,0,1,3,58,17,9,32
"2011","Doncaster 006D","E01007561","Total",26,16,6,4,4,2,2,0,22,14,4,4
"2011","Doncaster 006E","E01007562","Total",38,13,8,17,4,0,1,3,34,13,7,14
"2011","Doncaster 006F","E01007563","Total",69,18,9,42,7,2,2,3,62,16,7,39
"2011","Doncaster 007A","E01007621","Total",35,20,12,3,5,1,3,1,30,19,9,2
"2011","Doncaster 007B","E01007622","Total",25,7,10,8,3,1,2,0,22,6,8,8
"2011","Doncaster 007C","E01007623","Total",36,13,14,9,1,0,1,0,35,13,13,9
"2011","Doncaster 007D","E01007624","Total",46,22,17,7,4,0,4,0,42,22,13,7
"2011","Doncaster 007E","E01007630","Total",32,13,10,9,5,2,3,0,27,11,7,9
"2011","Doncaster 007F","E01007631","Total",12,5,4,3,1,0,0,1,11,5,4,2
"2011","Doncaster 008A","E01007553","Total",33,19,10,4,0,0,0,0,33,19,10,4
"2011","Doncaster 008B","E01007557","Total",17,7,5,5,1,1,0,0,16,6,5,5
"2011","Doncaster 008C","E01007558","Total",31,7,16,8,6,0,6,0,25,7,10,8
"2011","Doncaster 008D","E01007559","Total",16,7,5,4,3,1,2,0,13,6,3,4
"2011","Doncaster 008E","E01007560","Total",40,12,10,18,5,2,2,1,35,10,8,17
"2011","Doncaster 009A","E01007464","Total",77,26,15,36,6,1,2,3,71,25,13,33
"2011","Doncaster 009B","E01007465","Total",68,30,15,23,7,3,2,2,61,27,13,21
"2011","Doncaster 009C","E01007466","Total",101,27,17,57,9,1,3,5,92,26,14,52
"2011","Doncaster 009D","E01007467","Total",51,16,10,25,5,0,1,4,46,16,9,21
"2011","Doncaster 009E","E01007471","Total",28,9,14,5,5,0,5,0,23,9,9,5
"2011","Doncaster 009F","E01007504","Total",51,18,12,21,5,0,4,1,46,18,8,20
"2011","Doncaster 009G","E01007507","Total",69,16,10,43,11,0,4,7,58,16,6,36
"2011","Doncaster 010A","E01007506","Total",67,32,7,28,0,0,0,0,67,32,7,28
"2011","Doncaster 010B","E01007508","Total",92,25,18,49,4,0,3,1,88,25,15,48
"2011","Doncaster 010C","E01007509","Total",99,16,20,63,8,2,3,3,91,14,17,60
"2011","Doncaster 010D","E01007510","Total",67,23,16,28,1,0,1,0,66,23,15,28
"2011","Doncaster 010E","E01007511","Total",66,28,7,31,3,0,2,1,63,28,5,30
"2011","Doncaster 011A","E01007475","Total",35,15,15,5,3,0,3,0,32,15,12,5
"2011","Doncaster 011B","E01007476","Total",32,9,14,9,4,0,4,0,28,9,10,9
"2011","Doncaster 011C","E01007477","Total",27,13,8,6,1,0,1,0,26,13,7,6
"2011","Doncaster 011D","E01007478","Total",36,20,6,10,0,0,0,0,36,20,6,10
"2011","Doncaster 012A","E01007512","Total",58,25,17,16,13,4,6,3,45,21,11,13
"2011","Doncaster 012B","E01007513","Total",48,19,9,20,1,0,0,1,47,19,9,19
"2011","Doncaster 012C","E01007515","Total",51,19,14,18,6,1,2,3,45,18,12,15
"2011","Doncaster 012D","E01007518","Total",32,12,12,8,3,0,1,2,29,12,11,6
"2011","Doncaster 012E","E01007519","Total",52,20,12,20,3,1,2,0,49,19,10,20
"2011","Doncaster 013A","E01007505","Total",42,17,11,14,5,0,4,1,37,17,7,13
"2011","Doncaster 013B","E01007514","Total",61,16,12,33,3,0,0,3,58,16,12,30
"2011","Doncaster 013C","E01007516","Total",39,16,11,12,4,2,1,1,35,14,10,11
"2011","Doncaster 013D","E01007517","Total",81,19,17,45,3,0,2,1,78,19,15,44
"2011","Doncaster 014A","E01007479","Total",47,18,9,20,6,3,2,1,41,15,7,19
"2011","Doncaster 014B","E01007480","Total",56,18,14,24,1,0,1,0,55,18,13,24
"2011","Doncaster 014D","E01007482","Total",33,9,8,16,3,0,0,3,30,9,8,13
"2011","Doncaster 014E","E01033259","Total",47,21,19,7,6,1,3,2,41,20,16,5
"2011","Doncaster 014F","E01033260","Total",64,35,15,14,3,1,2,0,61,34,13,14
"2011","Doncaster 015A","E01007570","Total",24,11,9,4,1,0,1,0,23,11,8,4
"2011","Doncaster 015B","E01007650","Total",22,10,9,3,3,1,2,0,19,9,7,3
"2011","Doncaster 015C","E01007651","Total",98,27,17,54,4,0,2,2,94,27,15,52
"2011","Doncaster 015D","E01007652","Total",79,23,13,43,5,0,1,4,74,23,12,39
"2011","Doncaster 015E","E01007653","Total",52,23,14,15,5,1,3,1,47,22,11,14
"2011","Doncaster 015F","E01007656","Total",57,14,10,33,7,1,3,3,50,13,7,30
"2011","Doncaster 016A","E01007581","Total",40,17,18,5,5,1,4,0,35,16,14,5
"2011","Doncaster 016B","E01007582","Total",44,21,13,10,5,1,2,2,39,20,11,8
"2011","Doncaster 016C","E01007588","Total",54,22,18,14,7,0,7,0,47,22,11,14
"2011","Doncaster 016D","E01007589","Total",25,12,10,3,3,0,3,0,22,12,7,3
"2011","Doncaster 017A","E01007483","Total",23,9,7,7,3,0,2,1,20,9,5,6
"2011","Doncaster 017B","E01007484","Total",30,9,10,11,1,0,1,0,29,9,9,11
"2011","Doncaster 017C","E01007485","Total",29,10,14,5,2,0,2,0,27,10,12,5
"2011","Doncaster 017D","E01007486","Total",13,4,1,8,1,0,0,1,12,4,1,7
"2011","Doncaster 018A","E01007564","Total",68,26,14,28,4,0,4,0,64,26,10,28
"2011","Doncaster 018B","E01007565","Total",25,9,10,6,3,0,1,2,22,9,9,4
"2011","Doncaster 018C","E01007566","Total",64,24,12,28,6,5,0,1,58,19,12,27
"2011","Doncaster 018D","E01007567","Total",48,18,15,15,3,1,2,0,45,17,13,15
"2011","Doncaster 018E","E01007568","Total",96,30,14,52,3,0,2,1,93,30,12,51
"2011","Doncaster 018F","E01007569","Total",62,23,16,23,7,1,3,3,55,22,13,20
"2011","Doncaster 019A","E01007644","Total",42,15,20,7,7,0,7,0,35,15,13,7
"2011","Doncaster 019B","E01007646","Total",30,9,13,8,2,1,1,0,28,8,12,8
"2011","Doncaster 019C","E01007647","Total",36,15,13,8,1,0,1,0,35,15,12,8
"2011","Doncaster 019D","E01007648","Total",55,15,13,27,7,2,2,3,48,13,11,24
"2011","Doncaster 019E","E01007649","Total",43,15,19,9,5,1,4,0,38,14,15,9
"2011","Doncaster 019F","E01007654","Total",43,17,10,16,1,0,1,0,42,17,9,16
"2011","Doncaster 020A","E01007583","Total",17,5,8,4,0,0,0,0,17,5,8,4
"2011","Doncaster 020B","E01007586","Total",21,7,8,6,2,0,2,0,19,7,6,6
"2011","Doncaster 020C","E01007587","Total",23,9,4,10,3,1,1,1,20,8,3,9
"2011","Doncaster 020D","E01007620","Total",24,9,9,6,4,2,2,0,20,7,7,6
"2011","Doncaster 021A","E01007584","Total",41,13,19,9,1,0,1,0,40,13,18,9
"2011","Doncaster 021B","E01007585","Total",43,15,21,7,4,0,3,1,39,15,18,6
"2011","Doncaster 021C","E01007617","Total",28,7,18,3,3,0,3,0,25,7,15,3
"2011","Doncaster 021D","E01007618","Total",30,11,13,6,1,0,1,0,29,11,12,6
"2011","Doncaster 021E","E01007619","Total",31,12,13,6,4,1,3,0,27,11,10,6
"2011","Doncaster 022A","E01007529","Total",76,22,12,42,8,0,6,2,68,22,6,40
"2011","Doncaster 022B","E01007530","Total",45,13,6,26,2,1,1,0,43,12,5,26
"2011","Doncaster 022C","E01007531","Total",60,17,11,32,3,0,3,0,57,17,8,32
"2011","Doncaster 022D","E01007643","Total",92,21,17,54,5,1,1,3,87,20,16,51
"2011","Doncaster 022E","E01007645","Total",66,14,17,35,9,0,1,8,57,14,16,27
"2011","Doncaster 022F","E01007655","Total",82,32,13,37,7,2,3,2,75,30,10,35
"2011","Doncaster 023A","E01007494","Total",63,21,18,24,2,2,0,0,61,19,18,24
"2011","Doncaster 023B","E01007532","Total",63,16,4,43,11,0,2,9,52,16,2,34
"2011","Doncaster 023C","E01007533","Total",31,8,9,14,2,0,1,1,29,8,8,13
"2011","Doncaster 023D","E01007535","Total",65,14,12,39,2,0,1,1,63,14,11,38
"2011","Doncaster 024A","E01007522","Total",48,10,14,24,5,0,2,3,43,10,12,21
"2011","Doncaster 024B","E01007525","Total",54,21,15,18,5,0,3,2,49,21,12,16
"2011","Doncaster 024C","E01007528","Total",44,18,7,19,5,0,4,1,39,18,3,18
"2011","Doncaster 024D","E01007604","Total",28,10,10,8,1,0,1,0,27,10,9,8
"2011","Doncaster 025A","E01007521","Total",28,10,8,10,1,0,1,0,27,10,7,10
"2011","Doncaster 025B","E01007523","Total",15,4,7,4,1,0,0,1,14,4,7,3
"2011","Doncaster 025C","E01007524","Total",21,5,11,5,4,0,3,1,17,5,8,4
"2011","Doncaster 025D","E01007526","Total",23,10,8,5,2,0,2,0,21,10,6,5
"2011","Doncaster 025E","E01007607","Total",59,18,7,34,1,0,0,1,58,18,7,33
"2011","Doncaster 026A","E01007599","Total",39,17,17,5,3,1,2,0,36,16,15,5
"2011","Doncaster 026B","E01007600","Total",23,9,11,3,0,0,0,0,23,9,11,3
"2011","Doncaster 026C","E01007601","Total",24,10,11,3,1,0,1,0,23,10,10,3
"2011","Doncaster 026D","E01007602","Total",32,13,15,4,4,0,3,1,28,13,12,3
"2011","Doncaster 026E","E01007603","Total",36,21,9,6,3,1,2,0,33,20,7,6
"2011","Doncaster 027A","E01007520","Total",13,4,6,3,1,0,1,0,12,4,5,3
"2011","Doncaster 027B","E01007527","Total",52,15,25,12,2,0,2,0,50,15,23,12
"2011","Doncaster 027C","E01007605","Total",26,10,13,3,5,1,4,0,21,9,9,3
"2011","Doncaster 027D","E01007606","Total",13,3,4,6,5,1,3,1,8,2,1,5
"2011","Doncaster 028A","E01007495","Total",89,29,14,46,4,0,2,2,85,29,12,44
"2011","Doncaster 028B","E01007500","Total",64,31,12,21,3,1,2,0,61,30,10,21
"2011","Doncaster 028C","E01007502","Total",49,25,17,7,4,0,4,0,45,25,13,7
"2011","Doncaster 028D","E01007534","Total",103,31,13,59,5,1,4,0,98,30,9,59
"2011","Doncaster 029A","E01007496","Total",91,26,14,51,3,1,2,0,88,25,12,51
"2011","Doncaster 029B","E01007497","Total",74,24,8,42,5,3,2,0,69,21,6,42
"2011","Doncaster 029C","E01007498","Total",57,19,9,29,4,1,3,0,53,18,6,29
"2011","Doncaster 029D","E01007499","Total",61,17,10,34,4,0,1,3,57,17,9,31
"2011","Doncaster 029E","E01007501","Total",23,6,8,9,3,1,2,0,20,5,6,9
"2011","Doncaster 029F","E01007503","Total",25,8,9,8,6,0,5,1,19,8,4,7
"2011","Doncaster 030A","E01007575","Total",68,20,8,40,8,2,1,5,60,18,7,35
"2011","Doncaster 030B","E01007578","Total",58,23,9,26,5,0,1,4,53,23,8,22
"2011","Doncaster 030C","E01007579","Total",46,21,11,14,3,0,3,0,43,21,8,14
"2011","Doncaster 030D","E01007580","Total",31,12,4,15,3,1,0,2,28,11,4,13
"2011","Doncaster 031A","E01007571","Total",49,13,13,23,6,1,1,4,43,12,12,19
"2011","Doncaster 031B","E01007572","Total",46,11,11,24,3,0,2,1,43,11,9,23
"2011","Doncaster 031C","E01007573","Total",75,27,12,36,6,1,2,3,69,26,10,33
"2011","Doncaster 031D","E01007574","Total",61,20,11,30,5,0,3,2,56,20,8,28
"2011","Doncaster 031E","E01007576","Total",41,14,8,19,1,1,0,0,40,13,8,19
"2011","Doncaster 031F","E01007577","Total",73,19,11,43,6,2,3,1,67,17,8,42
"2011","Doncaster 032A","E01007536","Total",60,24,15,21,4,1,1,2,56,23,14,19
"2011","Doncaster 032B","E01007542","Total",70,27,14,29,6,1,3,2,64,26,11,27
"2011","Doncaster 032C","E01007543","Total",55,13,10,32,4,1,1,2,51,12,9,30
"2011","Doncaster 032D","E01007544","Total",87,31,9,47,5,0,0,5,82,31,9,42
"2011","Doncaster 033A","E01007546","Total",67,21,11,35,7,0,0,7,60,21,11,28
"2011","Doncaster 033B","E01007551","Total",38,15,12,11,2,0,2,0,36,15,10,11
"2011","Doncaster 033C","E01007552","Total",28,13,10,5,4,1,3,0,24,12,7,5
"2011","Doncaster 033D","E01007613","Total",10,3,6,1,3,1,2,0,7,2,4,1
"2011","Doncaster 034A","E01007545","Total",51,14,13,24,11,1,2,8,40,13,11,16
"2011","Doncaster 034B","E01007547","Total",69,24,15,30,6,0,3,3,63,24,12,27
"2011","Doncaster 034C","E01007548","Total",69,25,17,27,3,1,2,0,66,24,15,27
"2011","Doncaster 034D","E01007549","Total",45,15,15,15,2,0,1,1,43,15,14,14
"2011","Doncaster 034E","E01007550","Total",61,27,17,17,5,0,5,0,56,27,12,17
"2011","Doncaster 035A","E01007537","Total",52,23,12,17,6,1,4,1,46,22,8,16
"2011","Doncaster 035B","E01007538","Total",48,20,8,20,4,0,3,1,44,20,5,19
"2011","Doncaster 035C","E01007539","Total",53,24,11,18,2,0,0,2,51,24,11,16
"2011","Doncaster 035D","E01007540","Total",54,18,8,28,6,0,4,2,48,18,4,26
"2011","Doncaster 035E","E01007541","Total",42,17,11,14,1,0,1,0,41,17,10,14
"2011","Doncaster 036A","E01007591","Total",40,13,11,16,3,1,2,0,37,12,9,16
"2011","Doncaster 036B","E01007594","Total",51,17,22,12,5,0,3,2,46,17,19,10
"2011","Doncaster 036C","E01007596","Total",19,2,12,5,1,0,1,0,18,2,11,5
"2011","Doncaster 036D","E01007598","Total",24,13,5,6,2,0,2,0,22,13,3,6
"2011","Doncaster 037A","E01007590","Total",49,17,11,21,5,1,2,2,44,16,9,19
"2011","Doncaster 037B","E01007592","Total",69,23,12,34,7,1,5,1,62,22,7,33
"2011","Doncaster 037C","E01007593","Total",53,17,11,25,7,1,3,3,46,16,8,22
"2011","Doncaster 037D","E01007595","Total",49,20,6,23,2,0,1,1,47,20,5,22
"2011","Doncaster 037E","E01007597","Total",94,25,18,51,6,0,1,5,88,25,17,46
"2011","Doncaster 038A","E01007608","Total",97,36,31,30,15,2,9,4,82,34,22,26
"2011","Doncaster 038B","E01007609","Total",46,21,12,13,3,0,3,0,43,21,9,13
"2011","Doncaster 038C","E01007610","Total",26,8,12,6,3,2,1,0,23,6,11,6
"2011","Doncaster 039A","E01007611","Total",34,16,11,7,3,0,2,1,31,16,9,6
"2011","Doncaster 039B","E01007612","Total",20,9,6,5,1,0,1,0,19,9,5,5
"2011","Doncaster 039C","E01007614","Total",22,6,10,6,3,0,2,1,19,6,8,5
"2011","Doncaster 039D","E01007615","Total",23,7,8,8,1,0,1,0,22,7,7,8
"2011","Doncaster 039E","E01007616","Total",20,8,6,6,1,0,1,0,19,8,5,6
"2011","Rotherham 001A","E01007693","Total",65,23,20,22,7,0,5,2,58,23,15,20
"2011","Rotherham 001B","E01007694","Total",67,22,13,32,8,0,5,3,59,22,8,29
"2011","Rotherham 001C","E01007695","Total",71,24,26,21,12,0,10,2,59,24,16,19
"2011","Rotherham 001D","E01007697","Total",60,21,16,23,5,1,3,1,55,20,13,22
"2011","Rotherham 001E","E01007698","Total",47,22,12,13,4,0,4,0,43,22,8,13
"2011","Rotherham 002A","E01007816","Total",41,15,2,24,1,0,0,1,40,15,2,23
"2011","Rotherham 002B","E01007817","Total",36,15,6,15,3,0,0,3,33,15,6,12
"2011","Rotherham 002C","E01007819","Total",20,10,4,6,1,0,0,1,19,10,4,5
"2011","Rotherham 002D","E01007820","Total",85,23,21,41,16,1,7,8,69,22,14,33
"2011","Rotherham 002E","E01007821","Total",49,22,11,16,5,0,5,0,44,22,6,16
"2011","Rotherham 002F","E01007822","Total",74,25,12,37,3,1,1,1,71,24,11,36
"2011","Rotherham 003A","E01007796","Total",66,28,10,28,5,2,1,2,61,26,9,26
"2011","Rotherham 003B","E01007797","Total",49,22,15,12,8,2,5,1,41,20,10,11
"2011","Rotherham 003C","E01007798","Total",21,13,5,3,2,0,1,1,19,13,4,2
"2011","Rotherham 003D","E01007799","Total",33,15,5,13,1,0,1,0,32,15,4,13
"2011","Rotherham 003E","E01007800","Total",43,17,9,17,4,0,3,1,39,17,6,16
"2011","Rotherham 003F","E01007818","Total",22,5,8,9,0,0,0,0,22,5,8,9
"2011","Rotherham 004A","E01007777","Total",50,15,10,25,6,0,2,4,44,15,8,21
"2011","Rotherham 004B","E01007793","Total",37,16,6,15,5,2,1,2,32,14,5,13
"2011","Rotherham 004C","E01007794","Total",72,21,9,42,6,2,1,3,66,19,8,39
"2011","Rotherham 004D","E01007795","Total",21,9,9,3,6,3,3,0,15,6,6,3
"2011","Rotherham 005A","E01007778","Total",33,14,10,9,4,0,3,1,29,14,7,8
"2011","Rotherham 005B","E01007779","Total",37,13,10,14,3,0,1,2,34,13,9,12
"2011","Rotherham 005C","E01007780","Total",23,6,7,10,5,0,3,2,18,6,4,8
"2011","Rotherham 005D","E01007781","Total",63,25,13,25,9,2,4,3,54,23,9,22
"2011","Rotherham 005E","E01007782","Total",73,27,17,29,11,1,6,4,62,26,11,25
"2011","Rotherham 006A","E01007771","Total",40,18,11,11,8,1,7,0,32,17,4,11
"2011","Rotherham 006B","E01007772","Total",47,16,12,19,4,1,2,1,43,15,10,18
"2011","Rotherham 006C","E01007773","Total",61,25,8,28,1,0,1,0,60,25,7,28
"2011","Rotherham 006D","E01007774","Total",81,36,11,34,7,0,3,4,74,36,8,30
"2011","Rotherham 007A","E01007696","Total",19,10,7,2,2,0,2,0,17,10,5,2
"2011","Rotherham 007B","E01007801","Total",38,18,15,5,0,0,0,0,38,18,15,5
"2011","Rotherham 007C","E01007802","Total",22,7,12,3,6,0,5,1,16,7,7,2
"2011","Rotherham 007D","E01007803","Total",46,24,13,9,3,1,1,1,43,23,12,8
"2011","Rotherham 007E","E01007808","Total",16,7,8,1,2,0,2,0,14,7,6,1
"2011","Rotherham 008A","E01007775","Total",87,22,7,58,11,0,2,9,76,22,5,49
"2011","Rotherham 008B","E01007776","Total",49,24,6,19,5,2,1,2,44,22,5,17
"2011","Rotherham 008C","E01007783","Total",44,14,5,25,6,0,1,5,38,14,4,20
"2011","Rotherham 008D","E01007784","Total",81,28,17,36,14,2,6,6,67,26,11,30
"2011","Rotherham 009A","E01007728","Total",29,16,4,9,3,2,0,1,26,14,4,8
"2011","Rotherham 009B","E01007729","Total",41,12,12,17,7,0,3,4,34,12,9,13
"2011","Rotherham 009C","E01007730","Total",47,16,15,16,6,1,4,1,41,15,11,15
"2011","Rotherham 009D","E01007731","Total",31,11,8,12,5,1,2,2,26,10,6,10
"2011","Rotherham 009E","E01007732","Total",30,12,8,10,6,0,4,2,24,12,4,8
"2011","Rotherham 009F","E01007733","Total",41,15,12,14,6,0,3,3,35,15,9,11
"2011","Rotherham 010A","E01007719","Total",52,22,5,25,3,0,1,2,49,22,4,23
"2011","Rotherham 010B","E01007720","Total",43,13,10,20,4,1,1,2,39,12,9,18
"2011","Rotherham 010C","E01007721","Total",88,24,9,55,6,1,1,4,82,23,8,51
"2011","Rotherham 010D","E01007727","Total",58,14,13,31,9,1,5,3,49,13,8,28
"2011","Rotherham 011A","E01007740","Total",59,28,4,27,2,0,0,2,57,28,4,25
"2011","Rotherham 011B","E01007804","Total",49,18,11,20,4,0,3,1,45,18,8,19
"2011","Rotherham 011C","E01007805","Total",46,20,4,22,3,2,1,0,43,18,3,22
"2011","Rotherham 011D","E01007806","Total",73,23,17,33,11,1,4,6,62,22,13,27
"2011","Rotherham 011E","E01007807","Total",59,20,9,30,3,1,0,2,56,19,9,28
"2011","Rotherham 012A","E01007681","Total",20,7,7,6,1,0,1,0,19,7,6,6
"2011","Rotherham 012B","E01007691","Total",28,14,10,4,7,1,5,1,21,13,5,3
"2011","Rotherham 012C","E01007692","Total",29,15,7,7,6,1,4,1,23,14,3,6
"2011","Rotherham 012E","E01032926","Total",64,21,31,12,8,0,7,1,56,21,24,11
"2011","Rotherham 012F","E01032927","Total",60,19,23,18,8,0,6,2,52,19,17,16
"2011","Rotherham 013A","E01007723","Total",65,20,13,32,8,1,5,2,57,19,8,30
"2011","Rotherham 013B","E01007735","Total",92,23,11,58,9,0,1,8,83,23,10,50
"2011","Rotherham 013C","E01007737","Total",114,36,11,67,10,0,0,10,104,36,11,57
"2011","Rotherham 013D","E01007738","Total",94,16,12,66,15,2,6,7,79,14,6,59
"2011","Rotherham 013E","E01007739","Total",46,12,8,26,3,0,1,2,43,12,7,24
"2011","Rotherham 014A","E01007736","Total",96,20,10,66,9,1,4,4,87,19,6,62
"2011","Rotherham 014B","E01007765","Total",57,17,12,28,5,1,2,2,52,16,10,26
"2011","Rotherham 014C","E01007766","Total",70,32,12,26,4,0,2,2,66,32,10,24
"2011","Rotherham 014D","E01007768","Total",50,6,9,35,4,0,2,2,46,6,7,33
"2011","Rotherham 014E","E01007770","Total",67,17,11,39,3,0,0,3,64,17,11,36
"2011","Rotherham 015A","E01007741","Total",23,11,12,0,2,0,2,0,21,11,10,0
"2011","Rotherham 015B","E01007742","Total",59,19,18,22,4,0,3,1,55,19,15,21
"2011","Rotherham 015C","E01007743","Total",21,11,6,4,0,0,0,0,21,11,6,4
"2011","Rotherham 015D","E01007744","Total",52,19,14,19,5,2,2,1,47,17,12,18
"2011","Rotherham 015E","E01007745","Total",67,21,11,35,9,1,5,3,58,20,6,32
"2011","Rotherham 015F","E01007746","Total",42,20,10,12,6,2,3,1,36,18,7,11
"2011","Rotherham 016A","E01007715","Total",98,19,11,68,19,2,7,10,79,17,4,58
"2011","Rotherham 016B","E01007716","Total",51,13,10,28,9,1,4,4,42,12,6,24
"2011","Rotherham 016C","E01007717","Total",79,30,12,37,9,0,4,5,70,30,8,32
"2011","Rotherham 016D","E01007718","Total",75,25,10,40,6,0,3,3,69,25,7,37
"2011","Rotherham 017A","E01007677","Total",60,10,10,40,8,0,2,6,52,10,8,34
"2011","Rotherham 017B","E01007714","Total",46,11,5,30,6,1,2,3,40,10,3,27
"2011","Rotherham 017C","E01007767","Total",51,14,14,23,5,0,2,3,46,14,12,20
"2011","Rotherham 017D","E01007769","Total",50,13,9,28,6,1,5,0,44,12,4,28
"2011","Rotherham 018A","E01007685","Total",31,9,11,11,8,1,6,1,23,8,5,10
"2011","Rotherham 018B","E01007754","Total",28,8,12,8,2,0,1,1,26,8,11,7
"2011","Rotherham 018C","E01007755","Total",30,17,7,6,4,3,1,0,26,14,6,6
"2011","Rotherham 018D","E01007756","Total",25,14,10,1,3,1,2,0,22,13,8,1
"2011","Rotherham 018E","E01007761","Total",67,30,16,21,10,2,3,5,57,28,13,16
"2011","Rotherham 018F","E01007762","Total",34,14,7,13,3,1,2,0,31,13,5,13
"2011","Rotherham 019A","E01007682","Total",46,16,14,16,5,0,3,2,41,16,11,14
"2011","Rotherham 019B","E01007683","Total",26,12,8,6,2,0,2,0,24,12,6,6
"2011","Rotherham 019C","E01007686","Total",18,6,8,4,7,1,5,1,11,5,3,3
"2011","Rotherham 019D","E01007688","Total",43,14,15,14,7,0,5,2,36,14,10,12
"2011","Rotherham 019E","E01007725","Total",26,8,8,10,2,0,1,1,24,8,7,9
"2011","Rotherham 019F","E01007726","Total",85,28,9,48,3,1,1,1,82,27,8,47
"2011","Rotherham 020A","E01007757","Total",36,17,9,10,4,0,3,1,32,17,6,9
"2011","Rotherham 020B","E01007758","Total",51,15,17,19,7,3,2,2,44,12,15,17
"2011","Rotherham 020C","E01007759","Total",57,25,9,23,5,0,4,1,52,25,5,22
"2011","Rotherham 020D","E01007760","Total",112,35,16,61,13,1,3,9,99,34,13,52
"2011","Rotherham 020E","E01007763","Total",70,22,12,36,7,0,3,4,63,22,9,32
"2011","Rotherham 020F","E01007764","Total",109,23,16,70,9,1,5,3,100,22,11,67
"2011","Rotherham 021A","E01007708","Total",74,32,15,27,2,1,0,1,72,31,15,26
"2011","Rotherham 021B","E01007709","Total",21,11,6,4,0,0,0,0,21,11,6,4
"2011","Rotherham 021C","E01007710","Total",14,10,2,2,1,1,0,0,13,9,2,2
"2011","Rotherham 021D","E01007711","Total",29,14,9,6,6,1,4,1,23,13,5,5
"2011","Rotherham 021E","E01007724","Total",31,15,10,6,5,2,2,1,26,13,8,5
"2011","Rotherham 021F","E01007734","Total",83,29,18,36,3,0,0,3,80,29,18,33
"2011","Rotherham 022A","E01007684","Total",56,30,14,12,6,1,5,0,50,29,9,12
"2011","Rotherham 022B","E01007687","Total",32,15,8,9,8,3,3,2,24,12,5,7
"2011","Rotherham 022C","E01007689","Total",34,8,20,6,8,0,5,3,26,8,15,3
"2011","Rotherham 022D","E01007690","Total",17,9,4,4,3,0,3,0,14,9,1,4
"2011","Rotherham 023A","E01007675","Total",33,8,12,13,2,0,2,0,31,8,10,13
"2011","Rotherham 023B","E01007678","Total",23,6,8,9,7,3,3,1,16,3,5,8
"2011","Rotherham 023C","E01007679","Total",36,8,15,13,3,0,2,1,33,8,13,12
"2011","Rotherham 023D","E01007680","Total",44,9,13,22,5,0,3,2,39,9,10,20
"2011","Rotherham 023E","E01007712","Total",16,4,5,7,2,0,2,0,14,4,3,7
"2011","Rotherham 023F","E01007713","Total",20,5,7,8,5,0,2,3,15,5,5,5
"2011","Rotherham 024A","E01007811","Total",21,9,9,3,4,0,4,0,17,9,5,3
"2011","Rotherham 024B","E01007812","Total",42,12,9,21,4,0,1,3,38,12,8,18
"2011","Rotherham 024C","E01007813","Total",34,10,13,11,7,0,6,1,27,10,7,10
"2011","Rotherham 024D","E01007814","Total",12,4,6,2,1,1,0,0,11,3,6,2
"2011","Rotherham 025A","E01007676","Total",55,18,7,30,8,0,2,6,47,18,5,24
"2011","Rotherham 025B","E01007702","Total",73,24,17,32,5,1,2,2,68,23,15,30
"2011","Rotherham 025C","E01007703","Total",26,11,10,5,3,2,0,1,23,9,10,4
"2011","Rotherham 025D","E01007704","Total",33,15,9,9,3,0,1,2,30,15,8,7
"2011","Rotherham 025E","E01007705","Total",31,14,9,8,9,3,5,1,22,11,4,7
"2011","Rotherham 025F","E01007707","Total",23,9,9,5,0,0,0,0,23,9,9,5
"2011","Rotherham 026A","E01007666","Total",25,10,8,7,0,0,0,0,25,10,8,7
"2011","Rotherham 026B","E01007809","Total",60,14,14,32,13,0,6,7,47,14,8,25
"2011","Rotherham 026C","E01007810","Total",52,22,14,16,11,2,7,2,41,20,7,14
"2011","Rotherham 026D","E01007815","Total",63,17,9,37,4,2,2,0,59,15,7,37
"2011","Rotherham 027A","E01007665","Total",31,14,12,5,3,1,2,0,28,13,10,5
"2011","Rotherham 027B","E01007699","Total",46,15,9,22,13,3,4,6,33,12,5,16
"2011","Rotherham 027C","E01007700","Total",56,24,15,17,2,0,2,0,54,24,13,17
"2011","Rotherham 027D","E01007701","Total",56,15,13,28,9,2,6,1,47,13,7,27
"2011","Rotherham 027E","E01007706","Total",38,11,10,17,4,1,1,2,34,10,9,15
"2011","Rotherham 028A","E01007787","Total",71,21,26,24,6,0,5,1,65,21,21,23
"2011","Rotherham 028B","E01007788","Total",40,9,14,17,4,0,3,1,36,9,11,16
"2011","Rotherham 028C","E01007789","Total",58,21,15,22,4,1,2,1,54,20,13,21
"2011","Rotherham 028D","E01007792","Total",23,11,9,3,5,0,4,1,18,11,5,2
"2011","Rotherham 029A","E01007657","Total",36,15,9,12,5,1,4,0,31,14,5,12
"2011","Rotherham 029B","E01007659","Total",25,10,9,6,4,1,3,0,21,9,6,6
"2011","Rotherham 029C","E01007785","Total",44,14,13,17,7,2,5,0,37,12,8,17
"2011","Rotherham 029D","E01007786","Total",31,12,9,10,3,0,1,2,28,12,8,8
"2011","Rotherham 029E","E01007790","Total",86,19,14,53,10,3,3,4,76,16,11,49
"2011","Rotherham 029F","E01007791","Total",52,22,9,21,5,1,3,1,47,21,6,20
"2011","Rotherham 030A","E01007667","Total",61,29,15,17,4,0,3,1,57,29,12,16
"2011","Rotherham 030B","E01007668","Total",69,25,11,33,7,1,2,4,62,24,9,29
"2011","Rotherham 030C","E01007669","Total",22,10,6,6,4,0,3,1,18,10,3,5
"2011","Rotherham 030D","E01007670","Total",18,7,8,3,3,0,3,0,15,7,5,3
"2011","Rotherham 030E","E01007672","Total",36,15,13,8,3,0,3,0,33,15,10,8
"2011","Rotherham 030F","E01007673","Total",80,27,10,43,5,2,2,1,75,25,8,42
"2011","Rotherham 031A","E01007671","Total",65,24,21,20,5,1,4,0,60,23,17,20
"2011","Rotherham 031B","E01007674","Total",27,10,12,5,2,0,2,0,25,10,10,5
"2011","Rotherham 031C","E01007747","Total",39,14,9,16,7,1,1,5,32,13,8,11
"2011","Rotherham 031D","E01007750","Total",30,7,12,11,4,0,4,0,26,7,8,11
"2011","Rotherham 032A","E01007658","Total",33,13,10,10,4,0,4,0,29,13,6,10
"2011","Rotherham 032B","E01007660","Total",14,8,4,2,0,0,0,0,14,8,4,2
"2011","Rotherham 032C","E01007661","Total",32,7,14,11,4,0,4,0,28,7,10,11
"2011","Rotherham 032D","E01007662","Total",42,19,2,21,0,0,0,0,42,19,2,21
"2011","Rotherham 032E","E01007663","Total",25,9,11,5,3,0,3,0,22,9,8,5
"2011","Rotherham 032F","E01007664","Total",32,14,10,8,4,2,2,0,28,12,8,8
"2011","Rotherham 033A","E01007748","Total",29,10,9,10,4,1,1,2,25,9,8,8
"2011","Rotherham 033B","E01007749","Total",37,14,12,11,9,2,4,3,28,12,8,8
"2011","Rotherham 033C","E01007751","Total",60,22,13,25,5,1,2,2,55,21,11,23
"2011","Rotherham 033D","E01007752","Total",14,5,7,2,2,0,2,0,12,5,5,2
"2011","Rotherham 033E","E01007753","Total",36,14,14,8,5,1,4,0,31,13,10,8
"2011","Sheffield 001A","E01008144","Total",44,20,6,18,5,1,2,2,39,19,4,16
"2011","Sheffield 001B","E01008145","Total",44,17,16,11,5,0,4,1,39,17,12,10
"2011","Sheffield 001C","E01008148","Total",49,17,16,16,2,1,1,0,47,16,15,16
"2011","Sheffield 001D","E01008149","Total",40,17,19,4,6,0,5,1,34,17,14,3
"2011","Sheffield 001E","E01008150","Total",49,19,14,16,5,0,4,1,44,19,10,15
"2011","Sheffield 002A","E01008142","Total",53,25,11,17,5,1,2,2,48,24,9,15
"2011","Sheffield 002B","E01008143","Total",48,15,16,17,2,0,1,1,46,15,15,16
"2011","Sheffield 002C","E01008146","Total",14,4,8,2,2,1,0,1,12,3,8,1
"2011","Sheffield 002D","E01008147","Total",19,6,13,0,4,0,4,0,15,6,9,0
"2011","Sheffield 003A","E01007888","Total",22,12,6,4,2,0,2,0,20,12,4,4
"2011","Sheffield 003B","E01007892","Total",77,23,14,40,1,0,1,0,76,23,13,40
"2011","Sheffield 003C","E01007893","Total",16,10,4,2,2,0,2,0,14,10,2,2
"2011","Sheffield 003D","E01007898","Total",29,16,11,2,3,1,2,0,26,15,9,2
"2011","Sheffield 003E","E01007899","Total",19,11,5,3,1,0,1,0,18,11,4,3
"2011","Sheffield 003F","E01007900","Total",78,28,21,29,5,0,4,1,73,28,17,28
"2011","Sheffield 003G","E01007901","Total",68,25,16,27,8,3,2,3,60,22,14,24
"2011","Sheffield 004A","E01007887","Total",31,10,11,10,2,0,2,0,29,10,9,10
"2011","Sheffield 004B","E01007889","Total",39,17,16,6,0,0,0,0,39,17,16,6
"2011","Sheffield 004C","E01007890","Total",16,7,6,3,3,1,2,0,13,6,4,3
"2011","Sheffield 004D","E01007891","Total",28,8,18,2,4,1,2,1,24,7,16,1
"2011","Sheffield 004E","E01007894","Total",41,20,12,9,4,0,4,0,37,20,8,9
"2011","Sheffield 004F","E01007895","Total",44,17,12,15,3,0,2,1,41,17,10,14
"2011","Sheffield 004G","E01007896","Total",20,4,10,6,2,0,2,0,18,4,8,6
"2011","Sheffield 005A","E01007897","Total",24,15,6,3,0,0,0,0,24,15,6,3
"2011","Sheffield 005B","E01008134","Total",19,3,11,5,3,0,3,0,16,3,8,5
"2011","Sheffield 005C","E01008135","Total",36,9,17,10,7,1,5,1,29,8,12,9
"2011","Sheffield 005D","E01008137","Total",13,4,7,2,3,0,3,0,10,4,4,2
"2011","Sheffield 005E","E01008141","Total",20,9,8,3,2,0,2,0,18,9,6,3
"2011","Sheffield 006A","E01008053","Total",39,7,15,17,3,1,1,1,36,6,14,16
"2011","Sheffield 006B","E01008056","Total",58,25,5,28,5,1,0,4,53,24,5,24
"2011","Sheffield 006C","E01008058","Total",26,14,7,5,1,0,1,0,25,14,6,5
"2011","Sheffield 006D","E01008138","Total",21,9,7,5,2,0,1,1,19,9,6,4
"2011","Sheffield 006E","E01008139","Total",42,16,14,12,3,0,2,1,39,16,12,11
"2011","Sheffield 007A","E01007856","Total",72,21,16,35,8,4,2,2,64,17,14,33
"2011","Sheffield 007B","E01008054","Total",104,27,21,56,7,0,3,4,97,27,18,52
"2011","Sheffield 007C","E01008055","Total",109,34,22,53,11,1,3,7,98,33,19,46
"2011","Sheffield 007D","E01008057","Total",97,28,20,49,7,1,3,3,90,27,17,46
"2011","Sheffield 008A","E01008126","Total",19,7,7,5,2,1,0,1,17,6,7,4
"2011","Sheffield 008C","E01008128","Total",15,7,6,2,2,0,2,0,13,7,4,2
"2011","Sheffield 008D","E01008136","Total",35,9,11,15,5,0,3,2,30,9,8,13
"2011","Sheffield 008E","E01008140","Total",70,25,30,15,9,0,6,3,61,25,24,12
"2011","Sheffield 008F","E01033275","Total",51,10,26,15,6,0,4,2,45,10,22,13
"2011","Sheffield 008G","E01033280","Total",32,8,19,5,7,2,5,0,25,6,14,5
"2011","Sheffield 009A","E01008085","Total",67,22,10,35,5,2,1,2,62,20,9,33
"2011","Sheffield 009B","E01008086","Total",73,21,13,39,6,0,4,2,67,21,9,37
"2011","Sheffield 009C","E01008116","Total",86,27,14,45,3,0,1,2,83,27,13,43
"2011","Sheffield 009D","E01008117","Total",52,19,0,33,1,0,0,1,51,19,0,32
"2011","Sheffield 009E","E01008118","Total",61,14,14,33,4,0,1,3,57,14,13,30
"2011","Sheffield 009F","E01008119","Total",86,30,16,40,13,0,8,5,73,30,8,35
"2011","Sheffield 009G","E01008125","Total",38,9,5,24,3,0,1,2,35,9,4,22
"2011","Sheffield 010A","E01007849","Total",130,41,32,57,6,3,2,1,124,38,30,56
"2011","Sheffield 010B","E01007857","Total",108,33,16,59,8,0,5,3,100,33,11,56
"2011","Sheffield 010C","E01008059","Total",80,17,15,48,9,0,2,7,71,17,13,41
"2011","Sheffield 010D","E01008060","Total",96,40,16,40,4,0,0,4,92,40,16,36
"2011","Sheffield 011A","E01008061","Total",75,21,9,45,10,2,4,4,65,19,5,41
"2011","Sheffield 011B","E01008063","Total",25,5,2,18,4,0,0,4,21,5,2,14
"2011","Sheffield 011E","E01033277","Total",138,32,20,86,10,2,6,2,128,30,14,84
"2011","Sheffield 012A","E01008087","Total",32,12,11,9,2,1,0,1,30,11,11,8
"2011","Sheffield 012B","E01008088","Total",40,19,10,11,4,0,4,0,36,19,6,11
"2011","Sheffield 012C","E01008090","Total",110,28,17,65,7,0,3,4,103,28,14,61
"2011","Sheffield 012D","E01008092","Total",71,28,10,33,5,0,1,4,66,28,9,29
"2011","Sheffield 012E","E01008122","Total",89,20,12,57,8,0,4,4,81,20,8,53
"2011","Sheffield 012F","E01008124","Total",110,27,16,67,10,0,4,6,100,27,12,61
"2011","Sheffield 013A","E01007848","Total",115,37,23,55,13,1,6,6,102,36,17,49
"2011","Sheffield 013B","E01007851","Total",74,19,12,43,4,0,2,2,70,19,10,41
"2011","Sheffield 013C","E01007947","Total",48,13,7,28,5,0,0,5,43,13,7,23
"2011","Sheffield 013D","E01007948","Total",81,26,6,49,5,1,1,3,76,25,5,46
"2011","Sheffield 013E","E01008062","Total",62,24,6,32,4,0,1,3,58,24,5,29
"2011","Sheffield 014A","E01007847","Total",48,13,3,32,2,0,0,2,46,13,3,30
"2011","Sheffield 014B","E01007850","Total",58,16,12,30,7,2,2,3,51,14,10,27
"2011","Sheffield 014C","E01007852","Total",50,20,18,12,5,0,5,0,45,20,13,12
"2011","Sheffield 014D","E01007853","Total",40,11,12,17,1,0,0,1,39,11,12,16
"2011","Sheffield 014E","E01007854","Total",111,26,22,63,14,2,5,7,97,24,17,56
"2011","Sheffield 014F","E01007855","Total",105,31,21,53,11,3,4,4,94,28,17,49
"2011","Sheffield 015A","E01007941","Total",70,21,15,34,6,0,3,3,64,21,12,31
"2011","Sheffield 015B","E01007945","Total",110,38,10,62,7,2,2,3,103,36,8,59
"2011","Sheffield 015C","E01007946","Total",109,27,8,74,8,1,1,6,101,26,7,68
"2011","Sheffield 015D","E01007950","Total",123,50,16,57,9,1,5,3,114,49,11,54
"2011","Sheffield 015E","E01008123","Total",83,27,13,43,8,0,3,5,75,27,10,38
"2011","Sheffield 016A","E01007987","Total",35,8,16,11,10,0,6,4,25,8,10,7
"2011","Sheffield 016B","E01007988","Total",35,18,14,3,6,2,4,0,29,16,10,3
"2011","Sheffield 016C","E01007989","Total",30,13,12,5,4,0,4,0,26,13,8,5
"2011","Sheffield 016D","E01007991","Total",100,42,23,35,12,3,4,5,88,39,19,30
"2011","Sheffield 017A","E01007995","Total",59,17,23,19,3,0,2,1,56,17,21,18
"2011","Sheffield 017B","E01008089","Total",79,32,12,35,12,1,4,7,67,31,8,28
"2011","Sheffield 017C","E01008091","Total",47,12,16,19,4,0,4,0,43,12,12,19
"2011","Sheffield 017D","E01008093","Total",41,20,11,10,5,1,4,0,36,19,7,10
"2011","Sheffield 018A","E01007903","Total",29,13,3,13,3,0,0,3,26,13,3,10
"2011","Sheffield 018B","E01007904","Total",71,16,18,37,12,2,8,2,59,14,10,35
"2011","Sheffield 018C","E01007913","Total",59,19,3,37,3,0,0,3,56,19,3,34
"2011","Sheffield 018D","E01007914","Total",49,16,6,27,5,1,2,2,44,15,4,25
"2011","Sheffield 019A","E01007870","Total",56,12,14,30,6,1,1,4,50,11,13,26
"2011","Sheffield 019B","E01007871","Total",59,15,9,35,4,0,1,3,55,15,8,32
"2011","Sheffield 019C","E01007943","Total",122,38,12,72,8,0,0,8,114,38,12,64
"2011","Sheffield 019D","E01008094","Total",51,13,6,32,3,0,2,1,48,13,4,31
"2011","Sheffield 020A","E01007869","Total",60,12,12,36,7,1,2,4,53,11,10,32
"2011","Sheffield 020B","E01007872","Total",44,12,9,23,4,0,2,2,40,12,7,21
"2011","Sheffield 020C","E01007873","Total",64,17,15,32,15,2,6,7,49,15,9,25
"2011","Sheffield 020D","E01007942","Total",58,21,6,31,6,0,3,3,52,21,3,28
"2011","Sheffield 020E","E01007949","Total",51,8,9,34,5,2,0,3,46,6,9,31
"2011","Sheffield 021A","E01007990","Total",42,15,15,12,3,0,1,2,39,15,14,10
"2011","Sheffield 021B","E01007992","Total",33,12,13,8,2,1,0,1,31,11,13,7
"2011","Sheffield 021C","E01007993","Total",52,22,9,21,4,1,2,1,48,21,7,20
"2011","Sheffield 021D","E01007994","Total",43,12,22,9,5,0,3,2,38,12,19,7
"2011","Sheffield 021E","E01007996","Total",48,17,21,10,0,0,0,0,48,17,21,10
"2011","Sheffield 022A","E01007874","Total",103,22,13,68,19,1,3,15,84,21,10,53
"2011","Sheffield 022B","E01007875","Total",107,23,15,69,27,4,7,16,80,19,8,53
"2011","Sheffield 022D","E01007877","Total",45,9,7,29,4,1,2,1,41,8,5,28
"2011","Sheffield 022E","E01007940","Total",99,23,10,66,9,4,2,3,90,19,8,63
"2011","Sheffield 022F","E01007944","Total",60,14,11,35,12,1,5,6,48,13,6,29
"2011","Sheffield 022G","E01033269","Total",112,27,9,76,17,2,1,14,95,25,8,62
"2011","Sheffield 022H","E01033270","Total",47,6,9,32,9,0,4,5,38,6,5,27
"2011","Sheffield 023A","E01008129","Total",35,16,14,5,5,2,3,0,30,14,11,5
"2011","Sheffield 023B","E01008130","Total",27,13,8,6,3,0,1,2,24,13,7,4
"2011","Sheffield 023C","E01008131","Total",32,15,12,5,4,0,2,2,28,15,10,3
"2011","Sheffield 023D","E01008132","Total",20,13,5,2,1,0,1,0,19,13,4,2
"2011","Sheffield 023E","E01008133","Total",21,8,8,5,3,0,3,0,18,8,5,5
"2011","Sheffield 024A","E01008151","Total",29,8,14,7,1,0,1,0,28,8,13,7
"2011","Sheffield 024B","E01008153","Total",35,12,8,15,4,0,4,0,31,12,4,15
"2011","Sheffield 024C","E01008154","Total",33,11,11,11,2,0,2,0,31,11,9,11
"2011","Sheffield 024D","E01008155","Total",44,15,10,19,1,0,1,0,43,15,9,19
"2011","Sheffield 024E","E01008156","Total",21,9,6,6,2,0,2,0,19,9,4,6
"2011","Sheffield 024F","E01008160","Total",31,14,7,10,1,0,0,1,30,14,7,9
"2011","Sheffield 025A","E01007997","Total",46,12,14,20,5,0,4,1,41,12,10,19
"2011","Sheffield 025B","E01007998","Total",46,21,11,14,3,1,1,1,43,20,10,13
"2011","Sheffield 025C","E01008152","Total",29,12,7,10,3,1,2,0,26,11,5,10
"2011","Sheffield 025D","E01008158","Total",69,20,19,30,9,2,5,2,60,18,14,28
"2011","Sheffield 026A","E01008065","Total",83,30,11,42,13,1,3,9,70,29,8,33
"2011","Sheffield 026B","E01008068","Total",67,18,13,36,6,2,4,0,61,16,9,36
"2011","Sheffield 026C","E01008072","Total",66,35,7,24,7,1,3,3,59,34,4,21
"2011","Sheffield 026D","E01008157","Total",57,24,13,20,4,0,1,3,53,24,12,17
"2011","Sheffield 026E","E01008161","Total",46,24,8,14,3,1,1,1,43,23,7,13
"2011","Sheffield 027A","E01007883","Total",60,18,9,33,13,3,5,5,47,15,4,28
"2011","Sheffield 027B","E01007902","Total",72,25,9,38,7,0,4,3,65,25,5,35
"2011","Sheffield 027C","E01007905","Total",60,9,7,44,11,4,3,4,49,5,4,40
"2011","Sheffield 027D","E01007906","Total",56,11,11,34,7,0,2,5,49,11,9,29
"2011","Sheffield 028A","E01008064","Total",24,5,13,6,2,0,2,0,22,5,11,6
"2011","Sheffield 028B","E01008066","Total",2,0,1,1,0,0,0,0,2,0,1,1
"2011","Sheffield 028C","E01008069","Total",17,7,6,4,0,0,0,0,17,7,6,4
"2011","Sheffield 028D","E01008074","Total",21,11,6,4,1,1,0,0,20,10,6,4
"2011","Sheffield 029A","E01007951","Total",36,9,19,8,4,0,4,0,32,9,15,8
"2011","Sheffield 029B","E01007960","Total",38,20,11,7,1,0,0,1,37,20,11,6
"2011","Sheffield 029C","E01007962","Total",15,4,7,4,1,0,1,0,14,4,6,4
"2011","Sheffield 029D","E01008159","Total",37,15,13,9,5,0,4,1,32,15,9,8
"2011","Sheffield 030A","E01007866","Total",9,4,3,2,2,0,1,1,7,4,2,1
"2011","Sheffield 030B","E01007867","Total",9,2,3,4,1,0,1,0,8,2,2,4
"2011","Sheffield 030C","E01007868","Total",7,1,4,2,1,0,1,0,6,1,3,2
"2011","Sheffield 030D","E01008067","Total",10,1,4,5,0,0,0,0,10,1,4,5
"2011","Sheffield 030E","E01008073","Total",22,11,8,3,1,0,1,0,21,11,7,3
"2011","Sheffield 032A","E01007907","Total",41,12,19,10,6,1,4,1,35,11,15,9
"2011","Sheffield 032B","E01007908","Total",32,11,15,6,7,0,7,0,25,11,8,6
"2011","Sheffield 032C","E01007909","Total",54,23,13,18,6,1,3,2,48,22,10,16
"2011","Sheffield 032D","E01007911","Total",27,11,10,6,2,0,2,0,25,11,8,6
"2011","Sheffield 032E","E01008014","Total",50,18,17,15,9,7,2,0,41,11,15,15
"2011","Sheffield 032F","E01008016","Total",50,21,9,20,3,1,2,0,47,20,7,20
"2011","Sheffield 033A","E01007952","Total",19,6,8,5,2,0,1,1,17,6,7,4
"2011","Sheffield 033B","E01007953","Total",18,8,6,4,2,0,1,1,16,8,5,3
"2011","Sheffield 033C","E01007954","Total",22,15,6,1,1,0,1,0,21,15,5,1
"2011","Sheffield 033D","E01007961","Total",25,14,9,2,6,2,4,0,19,12,5,2
"2011","Sheffield 036A","E01007859","Total",8,2,3,3,0,0,0,0,8,2,3,3
"2011","Sheffield 036B","E01007860","Total",5,1,1,3,0,0,0,0,5,1,1,3
"2011","Sheffield 036C","E01007863","Total",17,4,12,1,4,2,2,0,13,2,10,1
"2011","Sheffield 036D","E01007864","Total",7,4,2,1,3,0,2,1,4,4,0,0
"2011","Sheffield 036E","E01008104","Total",27,6,4,17,4,0,1,3,23,6,3,14
"2011","Sheffield 037A","E01007910","Total",80,23,17,40,6,1,4,1,74,22,13,39
"2011","Sheffield 037B","E01007912","Total",33,15,11,7,5,0,5,0,28,15,6,7
"2011","Sheffield 037C","E01007971","Total",53,19,15,19,3,0,2,1,50,19,13,18
"2011","Sheffield 037D","E01007973","Total",27,8,11,8,5,1,2,2,22,7,9,6
"2011","Sheffield 038A","E01007858","Total",28,12,12,4,6,0,5,1,22,12,7,3
"2011","Sheffield 038B","E01007861","Total",21,10,8,3,0,0,0,0,21,10,8,3
"2011","Sheffield 038C","E01007862","Total",14,6,0,8,3,1,0,2,11,5,0,6
"2011","Sheffield 038D","E01007865","Total",45,19,19,7,9,3,5,1,36,16,14,6
"2011","Sheffield 039A","E01008011","Total",117,35,10,72,4,2,0,2,113,33,10,70
"2011","Sheffield 039B","E01008012","Total",142,49,14,79,13,3,4,6,129,46,10,73
"2011","Sheffield 039C","E01008013","Total",66,19,13,34,6,0,2,4,60,19,11,30
"2011","Sheffield 039D","E01008015","Total",67,24,12,31,9,1,1,7,58,23,11,24
"2011","Sheffield 039E","E01008017","Total",76,25,6,45,8,0,0,8,68,25,6,37
"2011","Sheffield 039F","E01008018","Total",69,26,11,32,7,0,1,6,62,26,10,26
"2011","Sheffield 040A","E01008105","Total",30,6,9,15,3,0,2,1,27,6,7,14
"2011","Sheffield 040C","E01008107","Total",72,9,22,41,12,0,4,8,60,9,18,33
"2011","Sheffield 040D","E01008111","Total",13,4,9,0,4,0,4,0,9,4,5,0
"2011","Sheffield 040E","E01033271","Total",54,8,13,33,11,1,3,7,43,7,10,26
"2011","Sheffield 040F","E01033272","Total",26,6,4,16,6,2,1,3,20,4,3,13
"2011","Sheffield 041A","E01007955","Total",11,5,4,2,0,0,0,0,11,5,4,2
"2011","Sheffield 041B","E01007956","Total",39,13,22,4,10,2,8,0,29,11,14,4
"2011","Sheffield 041C","E01007957","Total",17,8,8,1,2,1,0,1,15,7,8,0
"2011","Sheffield 041D","E01007958","Total",17,5,7,5,0,0,0,0,17,5,7,5
"2011","Sheffield 041E","E01007959","Total",19,8,8,3,1,0,1,0,18,8,7,3
"2011","Sheffield 042A","E01008108","Total",38,14,8,16,5,3,2,0,33,11,6,16
"2011","Sheffield 042B","E01008109","Total",38,12,11,15,1,0,1,0,37,12,10,15
"2011","Sheffield 042D","E01008112","Total",34,20,2,12,3,2,0,1,31,18,2,11
"2011","Sheffield 042E","E01008113","Total",22,6,5,11,4,1,3,0,18,5,2,11
"2011","Sheffield 042F","E01033273","Total",30,8,5,17,2,0,1,1,28,8,4,16
"2011","Sheffield 042G","E01033274","Total",13,0,11,2,0,0,0,0,13,0,11,2
"2011","Sheffield 043A","E01008095","Total",57,13,9,35,5,0,1,4,52,13,8,31
"2011","Sheffield 043B","E01008096","Total",117,41,23,53,5,0,3,2,112,41,20,51
"2011","Sheffield 043C","E01008097","Total",99,23,17,59,6,0,2,4,93,23,15,55
"2011","Sheffield 043D","E01008101","Total",67,24,15,28,8,0,4,4,59,24,11,24
"2011","Sheffield 044A","E01007965","Total",77,31,11,35,5,2,0,3,72,29,11,32
"2011","Sheffield 044B","E01007969","Total",33,14,12,7,3,0,2,1,30,14,10,6
"2011","Sheffield 044C","E01007972","Total",26,12,8,6,3,0,1,2,23,12,7,4
"2011","Sheffield 044D","E01007974","Total",39,17,10,12,3,0,3,0,36,17,7,12
"2011","Sheffield 045A","E01007963","Total",36,17,9,10,4,1,1,2,32,16,8,8
"2011","Sheffield 045B","E01007967","Total",61,25,9,27,6,0,3,3,55,25,6,24
"2011","Sheffield 045C","E01007999","Total",26,7,13,6,3,0,2,1,23,7,11,5
"2011","Sheffield 045D","E01008008","Total",76,34,6,36,11,0,3,8,65,34,3,28
"2011","Sheffield 045E","E01008009","Total",142,41,21,80,7,1,3,3,135,40,18,77
"2011","Sheffield 046A","E01008043","Total",17,4,7,6,1,0,1,0,16,4,6,6
"2011","Sheffield 046B","E01008044","Total",20,8,7,5,0,0,0,0,20,8,7,5
"2011","Sheffield 046C","E01008047","Total",22,10,10,2,3,0,3,0,19,10,7,2
"2011","Sheffield 046D","E01008048","Total",20,7,11,2,8,1,7,0,12,6,4,2
"2011","Sheffield 046E","E01008050","Total",31,17,10,4,6,2,2,2,25,15,8,2
"2011","Sheffield 047A","E01007931","Total",19,6,7,6,2,1,1,0,17,5,6,6
"2011","Sheffield 047B","E01007934","Total",28,14,11,3,4,0,3,1,24,14,8,2
"2011","Sheffield 047C","E01007935","Total",30,8,15,7,2,0,1,1,28,8,14,6
"2011","Sheffield 047D","E01007936","Total",53,17,31,5,8,1,6,1,45,16,25,4
"2011","Sheffield 047E","E01007937","Total",33,12,18,3,4,1,3,0,29,11,15,3
"2011","Sheffield 047F","E01007938","Total",22,9,9,4,1,0,1,0,21,9,8,4
"2011","Sheffield 048A","E01008098","Total",118,40,16,62,8,1,3,4,110,39,13,58
"2011","Sheffield 048B","E01008100","Total",98,29,16,53,7,1,0,6,91,28,16,47
"2011","Sheffield 048C","E01008102","Total",64,17,14,33,5,1,2,2,59,16,12,31
"2011","Sheffield 048D","E01008103","Total",114,33,21,60,7,1,4,2,107,32,17,58
"2011","Sheffield 049A","E01007964","Total",48,25,14,9,6,0,4,2,42,25,10,7
"2011","Sheffield 049B","E01007966","Total",47,25,10,12,6,1,2,3,41,24,8,9
"2011","Sheffield 049C","E01007968","Total",67,27,9,31,3,0,1,2,64,27,8,29
"2011","Sheffield 049D","E01007970","Total",52,12,12,28,8,1,3,4,44,11,9,24
"2011","Sheffield 050A","E01008042","Total",30,5,15,10,4,0,4,0,26,5,11,10
"2011","Sheffield 050B","E01008045","Total",22,6,10,6,3,0,3,0,19,6,7,6
"2011","Sheffield 050C","E01008046","Total",47,21,12,14,4,0,3,1,43,21,9,13
"2011","Sheffield 050D","E01008049","Total",15,6,8,1,4,2,2,0,11,4,6,1
"2011","Sheffield 050E","E01008051","Total",20,5,8,7,4,0,3,1,16,5,5,6
"2011","Sheffield 050F","E01008052","Total",24,9,9,6,4,0,1,3,20,9,8,3
"2011","Sheffield 051A","E01007975","Total",54,18,10,26,9,2,3,4,45,16,7,22
"2011","Sheffield 051B","E01007976","Total",37,11,9,17,5,2,2,1,32,9,7,16
"2011","Sheffield 051C","E01007977","Total",58,16,9,33,3,0,1,2,55,16,8,31
"2011","Sheffield 051D","E01007979","Total",128,29,10,89,8,0,3,5,120,29,7,84
"2011","Sheffield 051E","E01008099","Total",54,26,11,17,3,1,2,0,51,25,9,17
"2011","Sheffield 052A","E01008000","Total",43,23,9,11,3,1,1,1,40,22,8,10
"2011","Sheffield 052B","E01008001","Total",63,15,24,24,6,1,5,0,57,14,19,24
"2011","Sheffield 052C","E01008004","Total",54,14,16,24,4,0,3,1,50,14,13,23
"2011","Sheffield 052D","E01008005","Total",35,18,9,8,2,1,1,0,33,17,8,8
"2011","Sheffield 052E","E01008010","Total",74,26,7,41,7,0,1,6,67,26,6,35
"2011","Sheffield 053A","E01007978","Total",73,30,15,28,6,0,3,3,67,30,12,25
"2011","Sheffield 053B","E01007980","Total",53,20,20,13,6,1,3,2,47,19,17,11
"2011","Sheffield 053C","E01007981","Total",27,8,12,7,5,0,3,2,22,8,9,5
"2011","Sheffield 053D","E01007983","Total",43,18,17,8,5,0,4,1,38,18,13,7
"2011","Sheffield 053E","E01007985","Total",41,17,15,9,4,0,4,0,37,17,11,9
"2011","Sheffield 054A","E01007982","Total",93,34,18,41,9,4,2,3,84,30,16,38
"2011","Sheffield 054B","E01008002","Total",25,8,6,11,6,1,2,3,19,7,4,8
"2011","Sheffield 054C","E01008003","Total",19,11,4,4,1,0,0,1,18,11,4,3
"2011","Sheffield 054D","E01008006","Total",26,11,12,3,2,0,2,0,24,11,10,3
"2011","Sheffield 055A","E01007927","Total",19,13,5,1,0,0,0,0,19,13,5,1
"2011","Sheffield 055B","E01007928","Total",17,8,7,2,1,0,0,1,16,8,7,1
"2011","Sheffield 055C","E01007929","Total",21,11,9,1,2,0,2,0,19,11,7,1
"2011","Sheffield 055D","E01007930","Total",14,3,9,2,5,0,4,1,9,3,5,1
"2011","Sheffield 055E","E01007932","Total",31,11,13,7,5,1,4,0,26,10,9,7
"2011","Sheffield 055F","E01007939","Total",26,9,13,4,4,1,3,0,22,8,10,4
"2011","Sheffield 056A","E01008028","Total",52,17,16,19,2,0,2,0,50,17,14,19
"2011","Sheffield 056B","E01008029","Total",65,34,15,16,9,1,3,5,56,33,12,11
"2011","Sheffield 056C","E01008032","Total",43,11,10,22,3,0,3,0,40,11,7,22
"2011","Sheffield 056D","E01008034","Total",57,19,16,22,8,0,5,3,49,19,11,19
"2011","Sheffield 059A","E01007828","Total",64,21,21,22,6,1,3,2,58,20,18,20
"2011","Sheffield 059B","E01007829","Total",59,19,25,15,4,1,2,1,55,18,23,14
"2011","Sheffield 059C","E01007831","Total",47,19,17,11,6,4,2,0,41,15,15,11
"2011","Sheffield 059D","E01007832","Total",48,23,15,10,6,1,2,3,42,22,13,7
"2011","Sheffield 059E","E01007986","Total",45,20,16,9,5,0,5,0,40,20,11,9
"2011","Sheffield 060A","E01008007","Total",49,13,13,23,4,0,2,2,45,13,11,21
"2011","Sheffield 060B","E01008075","Total",98,22,17,59,10,0,4,6,88,22,13,53
"2011","Sheffield 060C","E01008076","Total",60,18,7,35,5,1,2,2,55,17,5,33
"2011","Sheffield 060D","E01008077","Total",58,19,12,27,5,0,2,3,53,19,10,24
"2011","Sheffield 061A","E01008031","Total",31,11,8,12,3,0,3,0,28,11,5,12
"2011","Sheffield 061B","E01008033","Total",19,8,9,2,6,1,5,0,13,7,4,2
"2011","Sheffield 061C","E01008038","Total",23,9,6,8,3,0,2,1,20,9,4,7
"2011","Sheffield 061D","E01008040","Total",55,19,15,21,6,0,5,1,49,19,10,20
"2011","Sheffield 062A","E01007835","Total",25,7,8,10,1,0,0,1,24,7,8,9
"2011","Sheffield 062B","E01007836","Total",21,9,6,6,0,0,0,0,21,9,6,6
"2011","Sheffield 062C","E01007843","Total",75,27,22,26,7,0,5,2,68,27,17,24
"2011","Sheffield 062D","E01007846","Total",39,11,18,10,4,0,3,1,35,11,15,9
"2011","Sheffield 063A","E01008030","Total",26,9,12,5,3,1,2,0,23,8,10,5
"2011","Sheffield 063B","E01008035","Total",12,2,9,1,2,0,2,0,10,2,7,1
"2011","Sheffield 063C","E01008036","Total",32,11,17,4,3,0,3,0,29,11,14,4
"2011","Sheffield 063D","E01008041","Total",39,21,8,10,7,2,5,0,32,19,3,10
"2011","Sheffield 064A","E01007827","Total",23,15,4,4,4,2,2,0,19,13,2,4
"2011","Sheffield 064B","E01007830","Total",26,11,10,5,5,2,2,1,21,9,8,4
"2011","Sheffield 064C","E01007833","Total",21,5,12,4,2,0,1,1,19,5,11,3
"2011","Sheffield 064D","E01007984","Total",23,14,8,1,2,0,2,0,21,14,6,1
"2011","Sheffield 064E","E01008078","Total",20,10,6,4,2,1,1,0,18,9,5,4
"2011","Sheffield 064F","E01008079","Total",19,8,7,4,3,1,2,0,16,7,5,4
"2011","Sheffield 065A","E01008019","Total",67,25,20,22,6,1,5,0,61,24,15,22
"2011","Sheffield 065B","E01008020","Total",28,15,6,7,4,0,2,2,24,15,4,5
"2011","Sheffield 065C","E01008022","Total",85,25,7,53,4,1,2,1,81,24,5,52
"2011","Sheffield 065D","E01008027","Total",58,24,10,24,4,0,1,3,54,24,9,21
"2011","Sheffield 065E","E01008037","Total",58,12,11,35,5,0,2,3,53,12,9,32
"2011","Sheffield 065F","E01008039","Total",19,8,5,6,1,1,0,0,18,7,5,6
"2011","Sheffield 066A","E01007824","Total",15,3,7,5,2,0,1,1,13,3,6,4
"2011","Sheffield 066B","E01007825","Total",14,4,10,0,4,0,4,0,10,4,6,0
"2011","Sheffield 066C","E01007826","Total",17,10,6,1,1,0,1,0,16,10,5,1
"2011","Sheffield 066D","E01007834","Total",31,15,9,7,3,0,1,2,28,15,8,5
"2011","Sheffield 068A","E01007920","Total",13,4,6,3,3,0,3,0,10,4,3,3
"2011","Sheffield 068B","E01007921","Total",30,18,9,3,2,0,2,0,28,18,7,3
"2011","Sheffield 068C","E01007923","Total",28,15,8,5,3,1,1,1,25,14,7,4
"2011","Sheffield 068D","E01007925","Total",34,18,10,6,5,1,3,1,29,17,7,5
"2011","Sheffield 068E","E01007926","Total",21,12,7,2,4,1,3,0,17,11,4,2
"2011","Sheffield 068F","E01007933","Total",20,8,11,1,4,0,4,0,16,8,7,1
"2011","Sheffield 069A","E01007823","Total",46,13,17,16,3,1,2,0,43,12,15,16
"2011","Sheffield 069B","E01007916","Total",89,16,16,57,4,0,2,2,85,16,14,55
"2011","Sheffield 069C","E01007919","Total",109,42,16,51,11,3,4,4,98,39,12,47
"2011","Sheffield 069D","E01008080","Total",33,10,13,10,5,1,4,0,28,9,9,10
"2011","Sheffield 070A","E01008081","Total",67,26,20,21,8,0,6,2,59,26,14,19
"2011","Sheffield 070B","E01008082","Total",80,29,17,34,8,2,3,3,72,27,14,31
"2011","Sheffield 070C","E01008083","Total",79,27,17,35,4,0,2,2,75,27,15,33
"2011","Sheffield 070D","E01008084","Total",124,39,14,71,8,0,2,6,116,39,12,65
"2011","Sheffield 071A","E01007915","Total",12,7,4,1,2,0,2,0,10,7,2,1
"2011","Sheffield 071B","E01007917","Total",26,11,5,10,3,2,0,1,23,9,5,9
"2011","Sheffield 071C","E01007918","Total",29,10,6,13,1,0,1,0,28,10,5,13
"2011","Sheffield 071D","E01007922","Total",15,6,9,0,1,0,1,0,14,6,8,0
"2011","Sheffield 071E","E01007924","Total",45,19,15,11,7,2,3,2,38,17,12,9
"2011","Sheffield 072A","E01008021","Total",18,6,9,3,6,0,6,0,12,6,3,3
"2011","Sheffield 072B","E01008023","Total",47,22,15,10,1,1,0,0,46,21,15,10
"2011","Sheffield 072C","E01008024","Total",46,15,19,12,8,0,6,2,38,15,13,10
"2011","Sheffield 072D","E01008025","Total",52,12,22,18,4,0,3,1,48,12,19,17
"2011","Sheffield 072E","E01032585","Total",10,4,4,2,1,0,1,0,9,4,3,2
"2011","Sheffield 073A","E01033261","Total",1,0,0,1,0,0,0,0,1,0,0,1
"2011","Sheffield 073B","E01033262","Total",8,3,5,0,2,0,2,0,6,3,3,0
"2011","Sheffield 073C","E01033263","Total",23,5,3,15,0,0,0,0,23,5,3,15
"2011","Sheffield 073D","E01033264","Total",9,3,4,2,1,1,0,0,8,2,4,2
"2011","Sheffield 073E","E01033276","Total",5,1,1,3,0,0,0,0,5,1,1,3
"2011","Sheffield 074A","E01008114","Total",79,20,12,47,10,2,2,6,69,18,10,41
"2011","Sheffield 074B","E01008115","Total",31,8,8,15,4,1,2,1,27,7,6,14
"2011","Sheffield 074C","E01033265","Total",7,3,1,3,3,0,1,2,4,3,0,1
"2011","Sheffield 074D","E01033266","Total",13,3,3,7,2,0,1,1,11,3,2,6
"2011","Sheffield 074E","E01033267","Total",2,0,0,2,0,0,0,0,2,0,0,2
"2011","Sheffield 075A","E01007878","Total",73,24,9,40,3,0,1,2,70,24,8,38
"2011","Sheffield 075B","E01007879","Total",26,7,8,11,1,0,1,0,25,7,7,11
"2011","Sheffield 075C","E01007881","Total",73,26,13,34,9,1,4,4,64,25,9,30
"2011","Sheffield 075D","E01007882","Total",27,7,11,9,4,0,2,2,23,7,9,7
"2011","Sheffield 075E","E01007885","Total",82,24,20,38,3,2,0,1,79,22,20,37
"2011","Sheffield 075F","E01007886","Total",137,54,16,67,11,5,1,5,126,49,15,62
"2011","Sheffield 075G","E01033268","Total",182,35,118,29,132,19,105,8,50,16,13,21
"2011","Sheffield 076A","E01007838","Total",38,22,8,8,3,2,1,0,35,20,7,8
"2011","Sheffield 076B","E01007839","Total",45,28,7,10,2,0,0,2,43,28,7,8
"2011","Sheffield 076C","E01007841","Total",38,18,11,9,4,2,2,0,34,16,9,9
"2011","Sheffield 076D","E01007842","Total",60,26,17,17,4,1,2,1,56,25,15,16
"2011","Sheffield 076E","E01033278","Total",110,46,19,45,10,1,3,6,100,45,16,39
"2011","Sheffield 076F","E01033279","Total",78,22,18,38,5,0,1,4,73,22,17,34
"2011","Bradford 001A","E01010646","Total",16,9,6,1,3,0,3,0,13,9,3,1
"2011","Bradford 001B","E01010647","Total",30,18,10,2,1,0,1,0,29,18,9,2
"2011","Bradford 001C","E01010648","Total",24,9,12,3,6,1,5,0,18,8,7,3
"2011","Bradford 001D","E01010692","Total",20,1,15,4,3,0,2,1,17,1,13,3
"2011","Bradford 002A","E01010691","Total",14,6,6,2,1,0,1,0,13,6,5,2
"2011","Bradford 002B","E01010693","Total",12,6,6,0,4,0,4,0,8,6,2,0
"2011","Bradford 002C","E01010694","Total",24,13,10,1,5,2,3,0,19,11,7,1
"2011","Bradford 002D","E01010695","Total",49,19,21,9,9,1,6,2,40,18,15,7
"2011","Bradford 002E","E01010696","Total",14,8,4,2,2,1,1,0,12,7,3,2
"2011","Bradford 002F","E01010697","Total",19,8,6,5,0,0,0,0,19,8,6,5
"2011","Bradford 002G","E01010698","Total",46,19,18,9,5,0,4,1,41,19,14,8
"2011","Bradford 002H","E01010699","Total",65,33,18,14,7,1,4,2,58,32,14,12
"2011","Bradford 003A","E01010767","Total",28,12,8,8,3,0,1,2,25,12,7,6
"2011","Bradford 003B","E01010768","Total",24,10,10,4,1,0,1,0,23,10,9,4
"2011","Bradford 003C","E01010769","Total",32,18,11,3,2,0,2,0,30,18,9,3
"2011","Bradford 003D","E01010771","Total",11,2,9,0,2,0,2,0,9,2,7,0
"2011","Bradford 004A","E01010638","Total",33,15,15,3,4,0,4,0,29,15,11,3
"2011","Bradford 004B","E01010639","Total",40,20,15,5,3,0,3,0,37,20,12,5
"2011","Bradford 004C","E01010640","Total",54,19,17,18,8,0,5,3,46,19,12,15
"2011","Bradford 004D","E01010641","Total",28,13,8,7,1,0,0,1,27,13,8,6
"2011","Bradford 004E","E01010642","Total",23,8,11,4,5,1,4,0,18,7,7,4
"2011","Bradford 004F","E01010643","Total",43,16,18,9,4,2,2,0,39,14,16,9
"2011","Bradford 004G","E01010644","Total",39,10,20,9,3,1,2,0,36,9,18,9
"2011","Bradford 004H","E01010645","Total",19,7,11,1,3,0,3,0,16,7,8,1
"2011","Bradford 005A","E01010770","Total",16,7,7,2,3,0,2,1,13,7,5,1
"2011","Bradford 005B","E01010772","Total",10,3,6,1,1,0,1,0,9,3,5,1
"2011","Bradford 005C","E01010773","Total",18,6,7,5,3,0,2,1,15,6,5,4
"2011","Bradford 005D","E01010774","Total",22,6,10,6,2,0,2,0,20,6,8,6
"2011","Bradford 006A","E01010706","Total",24,6,15,3,5,0,5,0,19,6,10,3
"2011","Bradford 006B","E01010707","Total",25,10,10,5,5,0,5,0,20,10,5,5
"2011","Bradford 006C","E01010708","Total",33,12,4,17,4,0,1,3,29,12,3,14
"2011","Bradford 006D","E01010709","Total",48,15,21,12,6,0,4,2,42,15,17,10
"2011","Bradford 007A","E01010719","Total",38,8,6,24,2,0,0,2,36,8,6,22
"2011","Bradford 007B","E01010727","Total",19,10,9,0,3,1,2,0,16,9,7,0
"2011","Bradford 007C","E01010728","Total",39,8,9,22,3,0,2,1,36,8,7,21
"2011","Bradford 007D","E01010729","Total",9,1,3,5,1,0,0,1,8,1,3,4
"2011","Bradford 008A","E01010700","Total",49,9,7,33,3,0,1,2,46,9,6,31
"2011","Bradford 008B","E01010701","Total",24,3,3,18,2,0,1,1,22,3,2,17
"2011","Bradford 008C","E01010702","Total",23,5,4,14,1,0,1,0,22,5,3,14
"2011","Bradford 008D","E01010703","Total",49,17,5,27,2,1,1,0,47,16,4,27
"2011","Bradford 008E","E01010704","Total",51,22,11,18,3,0,2,1,48,22,9,17
"2011","Bradford 008F","E01010705","Total",40,25,9,6,0,0,0,0,40,25,9,6
"2011","Bradford 008G","E01010710","Total",56,8,14,34,11,3,2,6,45,5,12,28
"2011","Bradford 009A","E01010712","Total",53,12,12,29,6,2,1,3,47,10,11,26
"2011","Bradford 009B","E01010720","Total",80,25,13,42,5,2,2,1,75,23,11,41
"2011","Bradford 009C","E01010721","Total",61,15,10,36,6,1,2,3,55,14,8,33
"2011","Bradford 009D","E01010723","Total",44,10,6,28,7,1,3,3,37,9,3,25
"2011","Bradford 009E","E01010724","Total",75,24,15,36,3,0,3,0,72,24,12,36
"2011","Bradford 009F","E01010725","Total",63,26,12,25,1,0,0,1,62,26,12,24
"2011","Bradford 010A","E01010579","Total",16,6,9,1,2,0,2,0,14,6,7,1
"2011","Bradford 010B","E01010580","Total",40,18,16,6,0,0,0,0,40,18,16,6
"2011","Bradford 010C","E01010764","Total",15,8,6,1,2,1,1,0,13,7,5,1
"2011","Bradford 010D","E01010765","Total",60,27,17,16,8,3,3,2,52,24,14,14
"2011","Bradford 010E","E01010766","Total",16,6,8,2,2,0,2,0,14,6,6,2
"2011","Bradford 011A","E01010711","Total",29,4,4,21,4,0,2,2,25,4,2,19
"2011","Bradford 011B","E01010713","Total",79,25,19,35,4,1,1,2,75,24,18,33
"2011","Bradford 011C","E01010714","Total",52,14,13,25,3,1,1,1,49,13,12,24
"2011","Bradford 011D","E01010716","Total",76,32,12,32,7,1,4,2,69,31,8,30
"2011","Bradford 012A","E01010715","Total",47,15,10,22,6,1,2,3,41,14,8,19
"2011","Bradford 012B","E01010717","Total",74,25,19,30,8,0,7,1,66,25,12,29
"2011","Bradford 012C","E01010718","Total",75,30,11,34,3,0,0,3,72,30,11,31
"2011","Bradford 012D","E01010726","Total",25,12,9,4,1,0,1,0,24,12,8,4
"2011","Bradford 012E","E01010859","Total",26,8,9,9,1,0,0,1,25,8,9,8
"2011","Bradford 013A","E01010573","Total",26,10,10,6,5,1,3,1,21,9,7,5
"2011","Bradford 013B","E01010574","Total",20,10,9,1,1,0,1,0,19,10,8,1
"2011","Bradford 013C","E01010575","Total",22,10,10,2,3,0,2,1,19,10,8,1
"2011","Bradford 013D","E01010577","Total",27,8,12,7,6,0,4,2,21,8,8,5
"2011","Bradford 014A","E01010722","Total",86,25,8,53,6,1,0,5,80,24,8,48
"2011","Bradford 014B","E01010860","Total",21,7,8,6,1,0,1,0,20,7,7,6
"2011","Bradford 014C","E01010862","Total",46,19,18,9,7,1,5,1,39,18,13,8
"2011","Bradford 014D","E01010863","Total",32,16,12,4,4,0,4,0,28,16,8,4
"2011","Bradford 015A","E01010578","Total",41,16,20,5,5,0,4,1,36,16,16,4
"2011","Bradford 015B","E01010581","Total",57,16,21,20,6,0,3,3,51,16,18,17
"2011","Bradford 015C","E01010582","Total",42,15,17,10,5,1,3,1,37,14,14,9
"2011","Bradford 015D","E01010584","Total",72,29,14,29,7,1,2,4,65,28,12,25
"2011","Bradford 015E","E01010585","Total",59,16,27,16,6,0,3,3,53,16,24,13
"2011","Bradford 016A","E01010568","Total",50,21,16,13,3,0,1,2,47,21,15,11
"2011","Bradford 016B","E01010569","Total",44,18,12,14,3,1,1,1,41,17,11,13
"2011","Bradford 016C","E01010571","Total",53,19,12,22,4,3,0,1,49,16,12,21
"2011","Bradford 016D","E01010572","Total",28,9,12,7,2,0,2,0,26,9,10,7
"2011","Bradford 016E","E01010576","Total",18,7,8,3,2,0,2,0,16,7,6,3
"2011","Bradford 017A","E01010683","Total",31,9,16,6,3,0,3,0,28,9,13,6
"2011","Bradford 017B","E01010684","Total",42,19,14,9,3,0,3,0,39,19,11,9
"2011","Bradford 017C","E01010685","Total",29,12,13,4,2,0,2,0,27,12,11,4
"2011","Bradford 017D","E01010686","Total",28,13,9,6,0,0,0,0,28,13,9,6
"2011","Bradford 018A","E01010570","Total",10,3,5,2,1,0,1,0,9,3,4,2
"2011","Bradford 018B","E01010583","Total",71,16,17,38,5,0,1,4,66,16,16,34
"2011","Bradford 018C","E01010784","Total",48,15,14,19,2,0,1,1,46,15,13,18
"2011","Bradford 018D","E01010785","Total",30,11,10,9,1,0,1,0,29,11,9,9
"2011","Bradford 018E","E01010786","Total",15,4,6,5,0,0,0,0,15,4,6,5
"2011","Bradford 018F","E01010790","Total",22,8,11,3,0,0,0,0,22,8,11,3
"2011","Bradford 019A","E01010680","Total",76,22,18,36,3,0,1,2,73,22,17,34
"2011","Bradford 019B","E01010681","Total",14,4,4,6,3,0,2,1,11,4,2,5
"2011","Bradford 019C","E01010682","Total",63,28,11,24,3,1,0,2,60,27,11,22
"2011","Bradford 019D","E01010687","Total",22,10,9,3,1,0,1,0,21,10,8,3
"2011","Bradford 019E","E01010688","Total",54,23,24,7,3,1,1,1,51,22,23,6
"2011","Bradford 019F","E01010689","Total",59,24,24,11,4,0,4,0,55,24,20,11
"2011","Bradford 019G","E01010690","Total",47,14,22,11,3,0,3,0,44,14,19,11
"2011","Bradford 020B","E01010782","Total",71,18,24,29,7,0,4,3,64,18,20,26
"2011","Bradford 020C","E01010787","Total",25,10,12,3,3,0,3,0,22,10,9,3
"2011","Bradford 020D","E01010788","Total",24,9,7,8,0,0,0,0,24,9,7,8
"2011","Bradford 020E","E01033689","Total",44,15,15,14,9,1,8,0,35,14,7,14
"2011","Bradford 020F","E01033694","Total",23,10,5,8,4,1,1,2,19,9,4,6
"2011","Bradford 021A","E01010776","Total",54,24,11,19,6,1,4,1,48,23,7,18
"2011","Bradford 021B","E01010777","Total",79,22,12,45,5,0,3,2,74,22,9,43
"2011","Bradford 021C","E01010779","Total",64,18,9,37,5,0,0,5,59,18,9,32
"2011","Bradford 021D","E01010781","Total",67,31,11,25,4,1,1,2,63,30,10,23
"2011","Bradford 021E","E01010783","Total",53,23,15,15,3,1,2,0,50,22,13,15
"2011","Bradford 022A","E01010586","Total",30,11,13,6,7,0,6,1,23,11,7,5
"2011","Bradford 022B","E01010587","Total",42,14,23,5,7,1,5,1,35,13,18,4
"2011","Bradford 022C","E01010588","Total",38,23,10,5,4,1,2,1,34,22,8,4
"2011","Bradford 022D","E01010589","Total",31,13,17,1,2,1,1,0,29,12,16,1
"2011","Bradford 022E","E01010591","Total",42,20,9,13,5,0,2,3,37,20,7,10
"2011","Bradford 022F","E01010593","Total",73,30,22,21,8,1,3,4,65,29,19,17
"2011","Bradford 022G","E01010596","Total",20,6,11,3,3,0,3,0,17,6,8,3
"2011","Bradford 023A","E01010854","Total",60,16,27,17,4,0,4,0,56,16,23,17
"2011","Bradford 023B","E01010855","Total",35,11,17,7,5,3,2,0,30,8,15,7
"2011","Bradford 023C","E01010856","Total",44,14,11,19,2,1,1,0,42,13,10,19
"2011","Bradford 023D","E01010857","Total",31,9,9,13,2,0,2,0,29,9,7,13
"2011","Bradford 023E","E01010858","Total",41,13,14,14,7,2,4,1,34,11,10,13
"2011","Bradford 023F","E01010861","Total",33,14,9,10,4,1,2,1,29,13,7,9
"2011","Bradford 024A","E01010603","Total",36,14,10,12,1,0,0,1,35,14,10,11
"2011","Bradford 024B","E01010604","Total",24,11,9,4,3,1,2,0,21,10,7,4
"2011","Bradford 024C","E01010605","Total",63,24,15,24,3,1,1,1,60,23,14,23
"2011","Bradford 024D","E01010775","Total",34,16,7,11,2,0,1,1,32,16,6,10
"2011","Bradford 024E","E01010778","Total",76,35,13,28,2,0,2,0,74,35,11,28
"2011","Bradford 025A","E01010789","Total",33,12,7,14,1,0,0,1,32,12,7,13
"2011","Bradford 025B","E01010791","Total",19,8,6,5,1,0,0,1,18,8,6,4
"2011","Bradford 025C","E01010792","Total",39,12,8,19,5,4,1,0,34,8,7,19
"2011","Bradford 025D","E01010793","Total",36,9,8,19,3,0,2,1,33,9,6,18
"2011","Bradford 026A","E01010652","Total",37,13,10,14,6,1,4,1,31,12,6,13
"2011","Bradford 026B","E01010653","Total",106,40,25,41,2,0,1,1,104,40,24,40
"2011","Bradford 026C","E01010655","Total",103,35,17,51,3,0,0,3,100,35,17,48
"2011","Bradford 026D","E01010656","Total",29,19,7,3,0,0,0,0,29,19,7,3
"2011","Bradford 026E","E01010657","Total",58,30,14,14,3,2,0,1,55,28,14,13
"2011","Bradford 027A","E01010649","Total",61,23,12,26,5,1,2,2,56,22,10,24
"2011","Bradford 027B","E01010650","Total",127,30,12,85,9,0,3,6,118,30,9,79
"2011","Bradford 027C","E01010654","Total",82,27,10,45,6,1,0,5,76,26,10,40
"2011","Bradford 027D","E01010826","Total",67,13,12,42,4,0,1,3,63,13,11,39
"2011","Bradford 028A","E01010597","Total",47,17,9,21,3,0,2,1,44,17,7,20
"2011","Bradford 028B","E01010598","Total",42,18,16,8,3,1,2,0,39,17,14,8
"2011","Bradford 028C","E01010599","Total",39,16,8,15,2,0,2,0,37,16,6,15
"2011","Bradford 028D","E01010600","Total",49,11,11,27,5,0,5,0,44,11,6,27
"2011","Bradford 028E","E01010602","Total",40,17,12,11,3,2,1,0,37,15,11,11
"2011","Bradford 029A","E01010670","Total",42,13,13,16,4,0,3,1,38,13,10,15
"2011","Bradford 029B","E01010671","Total",27,9,4,14,2,1,0,1,25,8,4,13
"2011","Bradford 029C","E01010673","Total",35,11,8,16,4,2,0,2,31,9,8,14
"2011","Bradford 029D","E01010675","Total",24,6,6,12,3,1,0,2,21,5,6,10
"2011","Bradford 030A","E01010669","Total",56,15,8,33,3,0,2,1,53,15,6,32
"2011","Bradford 030B","E01010674","Total",57,18,8,31,9,3,3,3,48,15,5,28
"2011","Bradford 030C","E01010677","Total",88,24,6,58,8,0,3,5,80,24,3,53
"2011","Bradford 030D","E01010805","Total",16,9,2,5,4,4,0,0,12,5,2,5
"2011","Bradford 031A","E01010590","Total",44,15,14,15,1,0,1,0,43,15,13,15
"2011","Bradford 031B","E01010592","Total",35,14,10,11,4,0,2,2,31,14,8,9
"2011","Bradford 031C","E01010594","Total",31,15,7,9,1,0,1,0,30,15,6,9
"2011","Bradford 031D","E01010595","Total",76,25,20,31,8,1,6,1,68,24,14,30
"2011","Bradford 032A","E01010601","Total",53,15,20,18,4,0,3,1,49,15,17,17
"2011","Bradford 032B","E01010651","Total",38,14,17,7,3,1,2,0,35,13,15,7
"2011","Bradford 032C","E01010825","Total",50,24,13,13,1,1,0,0,49,23,13,13
"2011","Bradford 032D","E01010827","Total",33,15,5,13,2,0,1,1,31,15,4,12
"2011","Bradford 033A","E01010804","Total",26,2,7,17,1,0,1,0,25,2,6,17
"2011","Bradford 033B","E01010806","Total",20,5,2,13,1,0,0,1,19,5,2,12
"2011","Bradford 033C","E01010807","Total",38,11,1,26,0,0,0,0,38,11,1,26
"2011","Bradford 033D","E01010808","Total",34,7,2,25,2,0,0,2,32,7,2,23
"2011","Bradford 033E","E01010809","Total",26,4,2,20,2,1,0,1,24,3,2,19
"2011","Bradford 034A","E01010676","Total",40,4,8,28,3,0,2,1,37,4,6,27
"2011","Bradford 034B","E01010679","Total",22,5,5,12,3,0,2,1,19,5,3,11
"2011","Bradford 034C","E01010824","Total",21,2,4,15,3,0,1,2,18,2,3,13
"2011","Bradford 034D","E01010840","Total",26,6,1,19,1,0,1,0,25,6,0,19
"2011","Bradford 034E","E01010841","Total",19,2,4,13,1,1,0,0,18,1,4,13
"2011","Bradford 035A","E01010828","Total",64,19,17,28,5,2,2,1,59,17,15,27
"2011","Bradford 035B","E01010829","Total",37,8,6,23,5,0,3,2,32,8,3,21
"2011","Bradford 035C","E01010830","Total",62,23,10,29,2,0,0,2,60,23,10,27
"2011","Bradford 035D","E01010831","Total",55,16,10,29,3,0,3,0,52,16,7,29
"2011","Bradford 035E","E01010832","Total",41,8,8,25,4,1,2,1,37,7,6,24
"2011","Bradford 036A","E01010672","Total",22,8,11,3,2,0,2,0,20,8,9,3
"2011","Bradford 036B","E01010678","Total",23,13,6,4,1,0,1,0,22,13,5,4
"2011","Bradford 036C","E01010799","Total",59,21,13,25,6,2,2,2,53,19,11,23
"2011","Bradford 036D","E01010800","Total",163,42,24,97,19,3,4,12,144,39,20,85
"2011","Bradford 036E","E01010801","Total",40,12,7,21,4,1,1,2,36,11,6,19
"2011","Bradford 036F","E01010802","Total",91,28,14,49,4,0,3,1,87,28,11,48
"2011","Bradford 037A","E01010803","Total",25,5,7,13,5,1,3,1,20,4,4,12
"2011","Bradford 037B","E01010810","Total",37,7,8,22,5,0,1,4,32,7,7,18
"2011","Bradford 037C","E01010811","Total",38,6,5,27,3,0,2,1,35,6,3,26
"2011","Bradford 037D","E01010813","Total",36,7,6,23,3,0,0,3,33,7,6,20
"2011","Bradford 038A","E01010618","Total",40,6,5,29,5,1,2,2,35,5,3,27
"2011","Bradford 038B","E01010619","Total",45,17,3,25,1,1,0,0,44,16,3,25
"2011","Bradford 038C","E01010625","Total",76,18,10,48,7,1,1,5,69,17,9,43
"2011","Bradford 038D","E01010626","Total",47,15,4,28,1,1,0,0,46,14,4,28
"2011","Bradford 038E","E01010627","Total",62,20,15,27,4,0,3,1,58,20,12,26
"2011","Bradford 039A","E01010606","Total",51,14,2,35,4,3,0,1,47,11,2,34
"2011","Bradford 039B","E01010607","Total",72,14,4,54,10,0,1,9,62,14,3,45
"2011","Bradford 039C","E01010617","Total",57,13,2,42,1,1,0,0,56,12,2,42
"2011","Bradford 039E","E01010842","Total",51,12,7,32,5,1,0,4,46,11,7,28
"2011","Bradford 039G","E01033690","Total",13,3,7,3,1,0,0,1,12,3,7,2
"2011","Bradford 039H","E01033691","Total",28,3,2,23,4,1,0,3,24,2,2,20
"2011","Bradford 039I","E01033692","Total",23,6,4,13,2,0,0,2,21,6,4,11
"2011","Bradford 039J","E01033693","Total",40,5,5,30,3,1,0,2,37,4,5,28
"2011","Bradford 040A","E01010628","Total",48,18,9,21,0,0,0,0,48,18,9,21
"2011","Bradford 040B","E01010629","Total",45,13,9,23,1,0,0,1,44,13,9,22
"2011","Bradford 040C","E01010630","Total",52,10,24,18,10,0,9,1,42,10,15,17
"2011","Bradford 040D","E01010631","Total",75,18,13,44,4,0,1,3,71,18,12,41
"2011","Bradford 040E","E01010632","Total",91,19,22,50,9,2,3,4,82,17,19,46
"2011","Bradford 041A","E01010658","Total",44,14,3,27,3,0,2,1,41,14,1,26
"2011","Bradford 041B","E01010812","Total",42,10,9,23,4,0,3,1,38,10,6,22
"2011","Bradford 041C","E01010833","Total",38,8,4,26,7,0,4,3,31,8,0,23
"2011","Bradford 041D","E01010843","Total",34,7,0,27,1,1,0,0,33,6,0,27
"2011","Bradford 042A","E01010620","Total",53,12,10,31,4,0,2,2,49,12,8,29
"2011","Bradford 042B","E01010621","Total",39,6,5,28,1,0,1,0,38,6,4,28
"2011","Bradford 042C","E01010622","Total",73,14,4,55,8,2,1,5,65,12,3,50
"2011","Bradford 042D","E01010623","Total",51,8,6,37,6,0,2,4,45,8,4,33
"2011","Bradford 042E","E01010624","Total",51,14,0,37,3,1,0,2,48,13,0,35
"2011","Bradford 043A","E01010794","Total",63,23,12,28,2,0,2,0,61,23,10,28
"2011","Bradford 043B","E01010795","Total",39,14,12,13,3,0,3,0,36,14,9,13
"2011","Bradford 043C","E01010796","Total",48,14,16,18,4,0,2,2,44,14,14,16
"2011","Bradford 043D","E01010797","Total",25,14,9,2,1,0,1,0,24,14,8,2
"2011","Bradford 043E","E01010798","Total",61,17,16,28,4,0,3,1,57,17,13,27
"2011","Bradford 044A","E01010834","Total",8,2,0,6,0,0,0,0,8,2,0,6
"2011","Bradford 044B","E01010835","Total",26,2,5,19,3,0,3,0,23,2,2,19
"2011","Bradford 044C","E01010836","Total",11,1,5,5,4,0,3,1,7,1,2,4
"2011","Bradford 044D","E01010837","Total",23,1,3,19,2,1,0,1,21,0,3,18
"2011","Bradford 044E","E01010838","Total",32,1,1,30,4,1,0,3,28,0,1,27
"2011","Bradford 044F","E01010839","Total",31,9,4,18,5,0,3,2,26,9,1,16
"2011","Bradford 045A","E01010608","Total",60,13,6,41,6,1,3,2,54,12,3,39
"2011","Bradford 045B","E01010613","Total",73,21,6,46,5,3,1,1,68,18,5,45
"2011","Bradford 045C","E01010730","Total",77,17,16,44,26,4,10,12,51,13,6,32
"2011","Bradford 045D","E01010734","Total",82,25,8,49,8,1,1,6,74,24,7,43
"2011","Bradford 046A","E01010609","Total",67,18,12,37,2,0,1,1,65,18,11,36
"2011","Bradford 046B","E01010610","Total",121,26,16,79,10,0,1,9,111,26,15,70
"2011","Bradford 046C","E01010611","Total",95,26,12,57,9,0,1,8,86,26,11,49
"2011","Bradford 046D","E01010614","Total",80,32,15,33,7,0,5,2,73,32,10,31
"2011","Bradford 047A","E01010633","Total",46,17,11,18,3,0,0,3,43,17,11,15
"2011","Bradford 047B","E01010634","Total",35,15,12,8,3,1,1,1,32,14,11,7
"2011","Bradford 047C","E01010635","Total",83,24,20,39,11,0,3,8,72,24,17,31
"2011","Bradford 047D","E01010636","Total",37,12,18,7,4,1,3,0,33,11,15,7
"2011","Bradford 047E","E01010637","Total",59,22,18,19,7,1,6,0,52,21,12,19
"2011","Bradford 048A","E01010731","Total",27,2,9,16,7,1,2,4,20,1,7,12
"2011","Bradford 048B","E01010732","Total",68,8,14,46,9,3,5,1,59,5,9,45
"2011","Bradford 048C","E01010733","Total",72,11,13,48,8,1,4,3,64,10,9,45
"2011","Bradford 048D","E01010736","Total",72,11,20,41,9,0,4,5,63,11,16,36
"2011","Bradford 048E","E01010737","Total",39,8,9,22,4,0,0,4,35,8,9,18
"2011","Bradford 049A","E01010659","Total",90,13,13,64,6,1,3,2,84,12,10,62
"2011","Bradford 049D","E01010662","Total",35,14,7,14,4,1,2,1,31,13,5,13
"2011","Bradford 049E","E01010664","Total",29,8,9,12,5,1,3,1,24,7,6,11
"2011","Bradford 049G","E01010761","Total",50,20,13,17,5,0,2,3,45,20,11,14
"2011","Bradford 049H","E01033695","Total",72,32,17,23,7,2,4,1,65,30,13,22
"2011","Bradford 049I","E01033696","Total",56,22,20,14,6,1,3,2,50,21,17,12
"2011","Bradford 049J","E01033697","Total",53,9,10,34,2,0,2,0,51,9,8,34
"2011","Bradford 050A","E01010663","Total",61,16,10,35,4,0,3,1,57,16,7,34
"2011","Bradford 050B","E01010665","Total",50,19,10,21,2,0,0,2,48,19,10,19
"2011","Bradford 050C","E01010666","Total",84,13,14,57,9,3,3,3,75,10,11,54
"2011","Bradford 050D","E01010667","Total",59,17,10,32,5,0,2,3,54,17,8,29
"2011","Bradford 051A","E01010735","Total",87,19,7,61,5,2,0,3,82,17,7,58
"2011","Bradford 051B","E01010738","Total",55,12,6,37,5,0,1,4,50,12,5,33
"2011","Bradford 051C","E01010739","Total",108,18,16,74,7,3,2,2,101,15,14,72
"2011","Bradford 051D","E01010740","Total",42,3,4,35,2,0,0,2,40,3,4,33
"2011","Bradford 051E","E01010744","Total",34,9,4,21,1,0,1,0,33,9,3,21
"2011","Bradford 052A","E01010612","Total",105,21,13,71,5,0,4,1,100,21,9,70
"2011","Bradford 052B","E01010819","Total",136,30,13,93,8,0,3,5,128,30,10,88
"2011","Bradford 052C","E01010820","Total",94,22,7,65,11,1,0,10,83,21,7,55
"2011","Bradford 052D","E01010821","Total",166,30,29,107,27,0,8,19,139,30,21,88
"2011","Bradford 052E","E01010822","Total",86,14,18,54,9,0,2,7,77,14,16,47
"2011","Bradford 053A","E01010615","Total",61,23,13,25,4,1,3,0,57,22,10,25
"2011","Bradford 053B","E01010616","Total",66,10,11,45,1,0,1,0,65,10,10,45
"2011","Bradford 053C","E01010742","Total",53,14,6,33,5,1,1,3,48,13,5,30
"2011","Bradford 053D","E01010743","Total",52,15,12,25,2,0,1,1,50,15,11,24
"2011","Bradford 054A","E01010847","Total",64,28,15,21,1,0,1,0,63,28,14,21
"2011","Bradford 054B","E01010848","Total",53,16,21,16,2,0,2,0,51,16,19,16
"2011","Bradford 054C","E01010852","Total",66,26,16,24,4,0,2,2,62,26,14,22
"2011","Bradford 054D","E01010853","Total",39,19,8,12,3,0,2,1,36,19,6,11
"2011","Bradford 055A","E01010668","Total",26,8,5,13,2,1,1,0,24,7,4,13
"2011","Bradford 055B","E01010755","Total",143,42,30,71,11,1,1,9,132,41,29,62
"2011","Bradford 055C","E01010762","Total",65,29,9,27,3,1,0,2,62,28,9,25
"2011","Bradford 055D","E01010763","Total",41,18,10,13,3,0,1,2,38,18,9,11
"2011","Bradford 055E","E01010846","Total",81,28,31,22,8,0,6,2,73,28,25,20
"2011","Bradford 056A","E01010745","Total",90,19,10,61,6,1,0,5,84,18,10,56
"2011","Bradford 056B","E01010747","Total",46,9,14,23,2,1,1,0,44,8,13,23
"2011","Bradford 056C","E01010748","Total",101,33,15,53,4,0,0,4,97,33,15,49
"2011","Bradford 056D","E01010749","Total",53,13,11,29,2,0,1,1,51,13,10,28
"2011","Bradford 057A","E01010814","Total",75,34,16,25,6,1,3,2,69,33,13,23
"2011","Bradford 057B","E01010815","Total",106,37,23,46,3,0,3,0,103,37,20,46
"2011","Bradford 057C","E01010816","Total",54,24,14,16,5,0,4,1,49,24,10,15
"2011","Bradford 057D","E01010817","Total",153,53,28,72,3,0,0,3,150,53,28,69
"2011","Bradford 057E","E01010818","Total",58,20,16,22,1,0,1,0,57,20,15,22
"2011","Bradford 058A","E01010752","Total",65,19,12,34,5,0,1,4,60,19,11,30
"2011","Bradford 058B","E01010753","Total",29,9,14,6,5,0,4,1,24,9,10,5
"2011","Bradford 058C","E01010754","Total",48,22,16,10,3,0,2,1,45,22,14,9
"2011","Bradford 058D","E01010756","Total",52,23,12,17,1,0,1,0,51,23,11,17
"2011","Bradford 058E","E01010758","Total",26,13,9,4,3,0,2,1,23,13,7,3
"2011","Bradford 058F","E01010759","Total",63,21,20,22,7,4,3,0,56,17,17,22
"2011","Bradford 058G","E01010760","Total",36,18,13,5,4,0,3,1,32,18,10,4
"2011","Bradford 059A","E01010741","Total",50,20,14,16,3,2,0,1,47,18,14,15
"2011","Bradford 059B","E01010845","Total",100,17,26,57,15,2,6,7,85,15,20,50
"2011","Bradford 059C","E01010849","Total",25,11,9,5,2,0,2,0,23,11,7,5
"2011","Bradford 059D","E01010850","Total",99,28,12,59,5,0,0,5,94,28,12,54
"2011","Bradford 059E","E01010851","Total",47,19,15,13,2,0,2,0,45,19,13,13
"2011","Bradford 059F","E01010864","Total",69,19,13,37,8,0,3,5,61,19,10,32
"2011","Bradford 059G","E01010867","Total",85,32,19,34,4,0,3,1,81,32,16,33
"2011","Bradford 059H","E01010874","Total",64,25,10,29,5,2,3,0,59,23,7,29
"2011","Bradford 060A","E01010746","Total",38,15,12,11,0,0,0,0,38,15,12,11
"2011","Bradford 060B","E01010750","Total",48,18,13,17,6,2,4,0,42,16,9,17
"2011","Bradford 060C","E01010751","Total",47,17,12,18,0,0,0,0,47,17,12,18
"2011","Bradford 060D","E01010865","Total",60,27,20,13,5,0,4,1,55,27,16,12
"2011","Bradford 060E","E01010866","Total",49,15,19,15,10,0,8,2,39,15,11,13
"2011","Bradford 061A","E01010868","Total",66,14,9,43,4,0,1,3,62,14,8,40
"2011","Bradford 061B","E01010869","Total",74,23,18,33,1,0,1,0,73,23,17,33
"2011","Bradford 061C","E01010870","Total",37,16,16,5,5,0,5,0,32,16,11,5
"2011","Bradford 061D","E01010871","Total",81,28,25,28,9,1,5,3,72,27,20,25
"2011","Bradford 061E","E01010872","Total",74,25,13,36,5,2,1,2,69,23,12,34
"2011","Bradford 061F","E01010873","Total",23,8,6,9,1,0,1,0,22,8,5,9
"2011","Calderdale 001A","E01010911","Total",44,21,12,11,3,0,3,0,41,21,9,11
"2011","Calderdale 001B","E01010912","Total",70,36,12,22,8,2,3,3,62,34,9,19
"2011","Calderdale 001C","E01010913","Total",25,11,11,3,2,0,2,0,23,11,9,3
"2011","Calderdale 001D","E01010915","Total",41,23,10,8,5,0,5,0,36,23,5,8
"2011","Calderdale 002A","E01010914","Total",100,41,29,30,13,1,9,3,87,40,20,27
"2011","Calderdale 002B","E01010924","Total",59,12,13,34,15,3,5,7,44,9,8,27
"2011","Calderdale 002C","E01010925","Total",65,17,12,36,5,2,1,2,60,15,11,34
"2011","Calderdale 002D","E01010926","Total",101,36,5,60,8,1,3,4,93,35,2,56
"2011","Calderdale 003A","E01010931","Total",27,7,13,7,1,0,1,0,26,7,12,7
"2011","Calderdale 003B","E01010932","Total",30,12,9,9,3,0,3,0,27,12,6,9
"2011","Calderdale 003C","E01010933","Total",48,24,15,9,0,0,0,0,48,24,15,9
"2011","Calderdale 003D","E01010935","Total",36,19,15,2,5,3,2,0,31,16,13,2
"2011","Calderdale 003E","E01010936","Total",40,16,19,5,5,0,4,1,35,16,15,4
"2011","Calderdale 003F","E01010937","Total",35,15,14,6,4,1,3,0,31,14,11,6
"2011","Calderdale 004A","E01010881","Total",72,39,16,17,9,4,2,3,63,35,14,14
"2011","Calderdale 004B","E01010882","Total",33,10,13,10,5,1,2,2,28,9,11,8
"2011","Calderdale 004C","E01010883","Total",20,7,9,4,5,2,3,0,15,5,6,4
"2011","Calderdale 004D","E01010887","Total",34,16,9,9,6,2,3,1,28,14,6,8
"2011","Calderdale 004E","E01010888","Total",65,28,21,16,10,3,7,0,55,25,14,16
"2011","Calderdale 004F","E01010923","Total",77,36,24,17,11,3,6,2,66,33,18,15
"2011","Calderdale 005A","E01010916","Total",72,31,9,32,6,1,1,4,66,30,8,28
"2011","Calderdale 005B","E01010939","Total",35,13,15,7,6,0,5,1,29,13,10,6
"2011","Calderdale 005C","E01010941","Total",72,21,18,33,5,0,2,3,67,21,16,30
"2011","Calderdale 005D","E01010942","Total",73,33,19,21,10,2,5,3,63,31,14,18
"2011","Calderdale 005E","E01010944","Total",91,30,17,44,8,0,5,3,83,30,12,41
"2011","Calderdale 006A","E01010938","Total",104,42,13,49,7,2,2,3,97,40,11,46
"2011","Calderdale 006B","E01010940","Total",61,23,17,21,4,0,3,1,57,23,14,20
"2011","Calderdale 006C","E01010943","Total",95,27,20,48,2,1,1,0,93,26,19,48
"2011","Calderdale 006D","E01010961","Total",63,26,15,22,10,2,4,4,53,24,11,18
"2011","Calderdale 007A","E01010917","Total",38,14,11,13,5,1,3,1,33,13,8,12
"2011","Calderdale 007B","E01010918","Total",41,7,15,19,6,0,4,2,35,7,11,17
"2011","Calderdale 007C","E01010919","Total",51,15,18,18,5,1,2,2,46,14,16,16
"2011","Calderdale 007D","E01010920","Total",32,12,14,6,10,0,8,2,22,12,6,4
"2011","Calderdale 007E","E01010921","Total",55,18,18,19,6,1,3,2,49,17,15,17
"2011","Calderdale 008A","E01010934","Total",53,16,19,18,8,1,4,3,45,15,15,15
"2011","Calderdale 008D","E01010967","Total",76,20,17,39,8,0,6,2,68,20,11,37
"2011","Calderdale 008E","E01010994","Total",24,5,12,7,4,0,4,0,20,5,8,7
"2011","Calderdale 008F","E01032923","Total",104,43,26,35,8,0,6,2,96,43,20,33
"2011","Calderdale 009A","E01010927","Total",30,7,19,4,6,0,5,1,24,7,14,3
"2011","Calderdale 009B","E01010928","Total",96,25,17,54,6,0,1,5,90,25,16,49
"2011","Calderdale 009C","E01010997","Total",28,10,11,7,9,1,8,0,19,9,3,7
"2011","Calderdale 009D","E01010999","Total",25,15,7,3,0,0,0,0,25,15,7,3
"2011","Calderdale 010A","E01010929","Total",92,28,20,44,6,0,6,0,86,28,14,44
"2011","Calderdale 010B","E01010930","Total",105,26,26,53,8,2,4,2,97,24,22,51
"2011","Calderdale 010C","E01010998","Total",58,17,20,21,6,0,5,1,52,17,15,20
"2011","Calderdale 010D","E01011000","Total",48,11,9,28,4,1,3,0,44,10,6,28
"2011","Calderdale 011A","E01010904","Total",39,10,22,7,6,0,5,1,33,10,17,6
"2011","Calderdale 011B","E01010906","Total",22,5,16,1,5,0,5,0,17,5,11,1
"2011","Calderdale 011C","E01010907","Total",28,10,12,6,3,1,2,0,25,9,10,6
"2011","Calderdale 011D","E01010909","Total",60,18,31,11,5,0,4,1,55,18,27,10
"2011","Calderdale 012A","E01010960","Total",51,16,9,26,10,4,4,2,41,12,5,24
"2011","Calderdale 012B","E01010964","Total",53,10,4,39,8,4,1,3,45,6,3,36
"2011","Calderdale 012C","E01010965","Total",25,5,4,16,3,2,0,1,22,3,4,15
"2011","Calderdale 012D","E01010966","Total",46,10,5,31,11,3,4,4,35,7,1,27
"2011","Calderdale 012E","E01010995","Total",30,9,4,17,5,0,1,4,25,9,3,13
"2011","Calderdale 013A","E01010982","Total",31,14,8,9,4,3,0,1,27,11,8,8
"2011","Calderdale 013B","E01010983","Total",55,15,11,29,4,0,2,2,51,15,9,27
"2011","Calderdale 013C","E01010985","Total",39,16,12,11,8,3,4,1,31,13,8,10
"2011","Calderdale 013D","E01010986","Total",85,26,20,39,5,1,1,3,80,25,19,36
"2011","Calderdale 013E","E01010987","Total",68,21,31,16,7,1,5,1,61,20,26,15
"2011","Calderdale 013F","E01010988","Total",54,13,11,30,6,2,2,2,48,11,9,28
"2011","Calderdale 014A","E01010996","Total",44,9,9,26,3,2,0,1,41,7,9,25
"2011","Calderdale 014B","E01011001","Total",45,11,7,27,5,2,1,2,40,9,6,25
"2011","Calderdale 014C","E01011002","Total",50,12,11,27,7,0,5,2,43,12,6,25
"2011","Calderdale 014D","E01011003","Total",62,12,12,38,9,0,4,5,53,12,8,33
"2011","Calderdale 015A","E01010878","Total",68,26,25,17,8,1,7,0,60,25,18,17
"2011","Calderdale 015B","E01010879","Total",26,6,16,4,3,0,3,0,23,6,13,4
"2011","Calderdale 015C","E01010905","Total",36,15,14,7,2,0,2,0,34,15,12,7
"2011","Calderdale 015D","E01010908","Total",58,17,27,14,10,3,7,0,48,14,20,14
"2011","Calderdale 015E","E01010910","Total",35,11,12,12,1,0,1,0,34,11,11,12
"2011","Calderdale 016A","E01010969","Total",47,23,15,9,4,3,1,0,43,20,14,9
"2011","Calderdale 016B","E01010970","Total",42,13,17,12,7,0,6,1,35,13,11,11
"2011","Calderdale 016C","E01010974","Total",46,13,14,19,11,3,5,3,35,10,9,16
"2011","Calderdale 016D","E01010977","Total",43,17,16,10,6,1,3,2,37,16,13,8
"2011","Calderdale 017A","E01010975","Total",36,16,12,8,3,1,1,1,33,15,11,7
"2011","Calderdale 017B","E01010976","Total",30,16,7,7,4,2,1,1,26,14,6,6
"2011","Calderdale 017C","E01010978","Total",65,24,18,23,9,0,7,2,56,24,11,21
"2011","Calderdale 017D","E01010979","Total",56,19,16,21,13,2,5,6,43,17,11,15
"2011","Calderdale 017E","E01010980","Total",69,31,17,21,7,1,2,4,62,30,15,17
"2011","Calderdale 017F","E01010981","Total",69,21,17,31,9,2,6,1,60,19,11,30
"2011","Calderdale 018A","E01010989","Total",34,11,10,13,4,0,1,3,30,11,9,10
"2011","Calderdale 018B","E01010990","Total",55,16,21,18,4,0,4,0,51,16,17,18
"2011","Calderdale 018C","E01010991","Total",44,18,17,9,3,1,2,0,41,17,15,9
"2011","Calderdale 018D","E01010992","Total",65,27,23,15,14,2,11,1,51,25,12,14
"2011","Calderdale 018E","E01010993","Total",80,29,23,28,10,0,5,5,70,29,18,23
"2011","Calderdale 019A","E01010875","Total",25,9,12,4,4,1,3,0,21,8,9,4
"2011","Calderdale 019B","E01010876","Total",35,14,17,4,5,1,4,0,30,13,13,4
"2011","Calderdale 019C","E01010877","Total",43,18,9,16,1,0,0,1,42,18,9,15
"2011","Calderdale 019D","E01010880","Total",75,21,20,34,8,0,4,4,67,21,16,30
"2011","Calderdale 019E","E01010949","Total",68,23,18,27,8,0,6,2,60,23,12,25
"2011","Calderdale 020A","E01010922","Total",68,26,25,17,10,3,4,3,58,23,21,14
"2011","Calderdale 020B","E01010956","Total",35,11,17,7,3,0,3,0,32,11,14,7
"2011","Calderdale 020C","E01010958","Total",52,12,14,26,2,0,1,1,50,12,13,25
"2011","Calderdale 020D","E01010959","Total",82,24,29,29,16,5,9,2,66,19,20,27
"2011","Calderdale 021A","E01010968","Total",36,16,13,7,3,0,3,0,33,16,10,7
"2011","Calderdale 021B","E01010971","Total",47,15,26,6,4,1,2,1,43,14,24,5
"2011","Calderdale 021C","E01010972","Total",31,12,11,8,2,0,2,0,29,12,9,8
"2011","Calderdale 021D","E01010973","Total",41,11,23,7,4,0,4,0,37,11,19,7
"2011","Calderdale 022A","E01010884","Total",52,21,12,19,4,2,2,0,48,19,10,19
"2011","Calderdale 022B","E01010885","Total",38,17,13,8,5,1,4,0,33,16,9,8
"2011","Calderdale 022C","E01010886","Total",25,12,6,7,4,1,1,2,21,11,5,5
"2011","Calderdale 022D","E01010984","Total",51,19,12,20,6,1,3,2,45,18,9,18
"2011","Calderdale 023A","E01010946","Total",14,2,9,3,4,0,4,0,10,2,5,3
"2011","Calderdale 023B","E01010947","Total",30,11,12,7,5,0,5,0,25,11,7,7
"2011","Calderdale 023C","E01010950","Total",56,24,14,18,8,0,4,4,48,24,10,14
"2011","Calderdale 023D","E01010951","Total",61,24,14,23,6,1,2,3,55,23,12,20
"2011","Calderdale 024A","E01010891","Total",85,31,23,31,14,2,11,1,71,29,12,30
"2011","Calderdale 024B","E01010892","Total",59,26,18,15,3,0,3,0,56,26,15,15
"2011","Calderdale 024C","E01010895","Total",59,22,15,22,4,0,3,1,55,22,12,21
"2011","Calderdale 024D","E01010945","Total",48,12,14,22,3,0,1,2,45,12,13,20
"2011","Calderdale 024E","E01010948","Total",26,12,12,2,6,1,4,1,20,11,8,1
"2011","Calderdale 025A","E01010889","Total",75,14,14,47,5,0,4,1,70,14,10,46
"2011","Calderdale 025B","E01010890","Total",67,30,15,22,8,0,4,4,59,30,11,18
"2011","Calderdale 025C","E01010893","Total",41,18,14,9,2,0,2,0,39,18,12,9
"2011","Calderdale 025D","E01010894","Total",83,27,17,39,8,0,2,6,75,27,15,33
"2011","Calderdale 025E","E01010901","Total",34,19,9,6,3,1,2,0,31,18,7,6
"2011","Calderdale 025F","E01010903","Total",51,18,18,15,4,0,4,0,47,18,14,15
"2011","Calderdale 026A","E01010896","Total",20,6,12,2,0,0,0,0,20,6,12,2
"2011","Calderdale 026B","E01010897","Total",30,12,11,7,2,0,2,0,28,12,9,7
"2011","Calderdale 026C","E01010898","Total",52,20,17,15,6,1,5,0,46,19,12,15
"2011","Calderdale 026D","E01010899","Total",46,16,15,15,6,2,4,0,40,14,11,15
"2011","Calderdale 026E","E01010900","Total",26,10,9,7,1,0,1,0,25,10,8,7
"2011","Calderdale 026F","E01010902","Total",84,30,30,24,8,0,4,4,76,30,26,20
"2011","Calderdale 027A","E01010952","Total",40,15,18,7,2,0,2,0,38,15,16,7
"2011","Calderdale 027B","E01010953","Total",34,15,10,9,2,0,1,1,32,15,9,8
"2011","Calderdale 027C","E01010954","Total",57,26,23,8,8,1,7,0,49,25,16,8
"2011","Calderdale 027D","E01010955","Total",33,10,15,8,5,0,2,3,28,10,13,5
"2011","Calderdale 027E","E01010957","Total",20,7,9,4,2,0,1,1,18,7,8,3
"2011","Kirklees 001A","E01011051","Total",43,21,14,8,1,0,0,1,42,21,14,7
"2011","Kirklees 001B","E01011055","Total",25,8,12,5,6,0,6,0,19,8,6,5
"2011","Kirklees 001C","E01011056","Total",37,13,18,6,4,1,3,0,33,12,15,6
"2011","Kirklees 001D","E01011057","Total",34,13,13,8,7,1,6,0,27,12,7,8
"2011","Kirklees 001E","E01011058","Total",36,10,13,13,3,1,2,0,33,9,11,13
"2011","Kirklees 002A","E01011048","Total",46,19,13,14,4,0,4,0,42,19,9,14
"2011","Kirklees 002B","E01011049","Total",57,14,15,28,10,2,6,2,47,12,9,26
"2011","Kirklees 002C","E01011050","Total",26,11,10,5,5,1,4,0,21,10,6,5
"2011","Kirklees 002D","E01011052","Total",60,24,16,20,10,3,2,5,50,21,14,15
"2011","Kirklees 002E","E01011053","Total",26,12,12,2,2,0,2,0,24,12,10,2
"2011","Kirklees 002F","E01011059","Total",110,37,15,58,7,0,5,2,103,37,10,56
"2011","Kirklees 003A","E01011062","Total",57,19,23,15,8,1,4,3,49,18,19,12
"2011","Kirklees 003B","E01011064","Total",67,20,11,36,4,1,0,3,63,19,11,33
"2011","Kirklees 003C","E01011068","Total",33,15,15,3,3,0,3,0,30,15,12,3
"2011","Kirklees 003D","E01011069","Total",23,6,11,6,4,0,2,2,19,6,9,4
"2011","Kirklees 004A","E01011241","Total",33,17,11,5,4,2,2,0,29,15,9,5
"2011","Kirklees 004B","E01011242","Total",52,23,10,19,1,0,1,0,51,23,9,19
"2011","Kirklees 004C","E01011243","Total",38,16,15,7,8,2,4,2,30,14,11,5
"2011","Kirklees 004D","E01011244","Total",76,33,24,19,7,0,6,1,69,33,18,18
"2011","Kirklees 005A","E01011060","Total",32,10,12,10,4,1,1,2,28,9,11,8
"2011","Kirklees 005B","E01011061","Total",64,23,23,18,8,4,4,0,56,19,19,18
"2011","Kirklees 005C","E01011063","Total",58,23,24,11,2,0,2,0,56,23,22,11
"2011","Kirklees 005D","E01011065","Total",63,22,18,23,5,0,4,1,58,22,14,22
"2011","Kirklees 005E","E01011066","Total",28,7,15,6,4,0,4,0,24,7,11,6
"2011","Kirklees 006A","E01011027","Total",47,15,9,23,4,0,0,4,43,15,9,19
"2011","Kirklees 006B","E01011028","Total",66,21,19,26,8,0,5,3,58,21,14,23
"2011","Kirklees 006C","E01011030","Total",91,36,12,43,0,0,0,0,91,36,12,43
"2011","Kirklees 006D","E01011031","Total",26,9,11,6,3,0,3,0,23,9,8,6
"2011","Kirklees 006E","E01011054","Total",19,7,11,1,3,1,2,0,16,6,9,1
"2011","Kirklees 007A","E01011013","Total",18,9,3,6,3,2,1,0,15,7,2,6
"2011","Kirklees 007B","E01011014","Total",43,12,12,19,3,0,1,2,40,12,11,17
"2011","Kirklees 007C","E01011023","Total",28,11,8,9,3,1,2,0,25,10,6,9
"2011","Kirklees 007D","E01011024","Total",49,11,4,34,5,0,0,5,44,11,4,29
"2011","Kirklees 008A","E01011067","Total",40,15,11,14,5,1,3,1,35,14,8,13
"2011","Kirklees 008B","E01011247","Total",38,14,17,7,3,0,3,0,35,14,14,7
"2011","Kirklees 008C","E01011249","Total",65,14,12,39,3,0,1,2,62,14,11,37
"2011","Kirklees 008D","E01011251","Total",88,26,25,37,5,0,4,1,83,26,21,36
"2011","Kirklees 009A","E01011245","Total",44,18,10,16,7,1,3,3,37,17,7,13
"2011","Kirklees 009B","E01011246","Total",76,22,18,36,8,0,4,4,68,22,14,32
"2011","Kirklees 009C","E01011248","Total",33,16,10,7,0,0,0,0,33,16,10,7
"2011","Kirklees 009D","E01011250","Total",55,17,13,25,5,0,2,3,50,17,11,22
"2011","Kirklees 010A","E01011015","Total",30,8,3,19,6,0,1,5,24,8,2,14
"2011","Kirklees 010B","E01011029","Total",50,8,11,31,12,1,4,7,38,7,7,24
"2011","Kirklees 010C","E01011032","Total",62,23,5,34,3,1,1,1,59,22,4,33
"2011","Kirklees 010D","E01011034","Total",40,10,7,23,5,1,3,1,35,9,4,22
"2011","Kirklees 011A","E01011157","Total",36,15,9,12,2,1,1,0,34,14,8,12
"2011","Kirklees 011B","E01011161","Total",32,10,15,7,2,0,2,0,30,10,13,7
"2011","Kirklees 011C","E01011163","Total",68,20,11,37,3,1,2,0,65,19,9,37
"2011","Kirklees 011D","E01011164","Total",38,16,15,7,6,0,4,2,32,16,11,5
"2011","Kirklees 011E","E01011165","Total",37,9,12,16,5,0,4,1,32,9,8,15
"2011","Kirklees 011F","E01011166","Total",43,15,13,15,6,2,3,1,37,13,10,14
"2011","Kirklees 011G","E01011167","Total",71,17,25,29,9,0,7,2,62,17,18,27
"2011","Kirklees 012A","E01011033","Total",44,11,13,20,4,2,1,1,40,9,12,19
"2011","Kirklees 012B","E01011035","Total",30,8,6,16,6,3,3,0,24,5,3,16
"2011","Kirklees 012C","E01011036","Total",66,19,5,42,7,1,2,4,59,18,3,38
"2011","Kirklees 012D","E01011037","Total",66,25,16,25,9,1,6,2,57,24,10,23
"2011","Kirklees 013A","E01011016","Total",20,7,4,9,5,1,0,4,15,6,4,5
"2011","Kirklees 013B","E01011017","Total",24,8,1,15,2,1,1,0,22,7,0,15
"2011","Kirklees 013C","E01011018","Total",27,6,2,19,2,1,0,1,25,5,2,18
"2011","Kirklees 013D","E01011019","Total",22,9,6,7,2,0,1,1,20,9,5,6
"2011","Kirklees 013E","E01011020","Total",37,3,5,29,4,0,1,3,33,3,4,26
"2011","Kirklees 014A","E01011021","Total",31,14,10,7,1,0,1,0,30,14,9,7
"2011","Kirklees 014B","E01011022","Total",30,13,9,8,0,0,0,0,30,13,9,8
"2011","Kirklees 014C","E01011126","Total",56,20,13,23,5,1,2,2,51,19,11,21
"2011","Kirklees 014D","E01011127","Total",27,11,3,13,2,1,1,0,25,10,2,13
"2011","Kirklees 015A","E01011156","Total",26,10,8,8,3,1,1,1,23,9,7,7
"2011","Kirklees 015B","E01011158","Total",52,17,21,14,6,0,5,1,46,17,16,13
"2011","Kirklees 015C","E01011159","Total",33,13,16,4,1,0,1,0,32,13,15,4
"2011","Kirklees 015D","E01011160","Total",32,14,11,7,5,0,5,0,27,14,6,7
"2011","Kirklees 015E","E01011162","Total",33,7,20,6,5,0,4,1,28,7,16,5
"2011","Kirklees 016A","E01011025","Total",92,26,12,54,14,5,5,4,78,21,7,50
"2011","Kirklees 016B","E01011026","Total",23,5,9,9,1,0,1,0,22,5,8,9
"2011","Kirklees 016C","E01011136","Total",70,19,10,41,9,1,3,5,61,18,7,36
"2011","Kirklees 016D","E01011137","Total",70,23,15,32,4,0,3,1,66,23,12,31
"2011","Kirklees 017A","E01011128","Total",55,8,13,34,6,0,4,2,49,8,9,32
"2011","Kirklees 017B","E01011130","Total",55,16,9,30,6,1,1,4,49,15,8,26
"2011","Kirklees 017E","E01033542","Total",47,15,12,20,6,1,4,1,41,14,8,19
"2011","Kirklees 018A","E01011121","Total",68,21,11,36,5,2,1,2,63,19,10,34
"2011","Kirklees 018B","E01011122","Total",98,28,16,54,5,0,1,4,93,28,15,50
"2011","Kirklees 018C","E01011123","Total",44,15,12,17,8,0,5,3,36,15,7,14
"2011","Kirklees 018D","E01011124","Total",63,26,18,19,5,2,2,1,58,24,16,18
"2011","Kirklees 018E","E01011125","Total",74,30,17,27,6,1,3,2,68,29,14,25
"2011","Kirklees 018F","E01011129","Total",47,16,10,21,2,1,1,0,45,15,9,21
"2011","Kirklees 019A","E01011138","Total",85,17,13,55,10,0,4,6,75,17,9,49
"2011","Kirklees 019B","E01011139","Total",26,7,4,15,2,0,2,0,24,7,2,15
"2011","Kirklees 019C","E01011140","Total",79,24,11,44,7,0,5,2,72,24,6,42
"2011","Kirklees 019D","E01011141","Total",32,11,4,17,2,1,0,1,30,10,4,16
"2011","Kirklees 020A","E01011132","Total",19,5,11,3,3,1,2,0,16,4,9,3
"2011","Kirklees 020B","E01011142","Total",30,14,9,7,1,0,1,0,29,14,8,7
"2011","Kirklees 020C","E01011217","Total",33,11,15,7,5,0,3,2,28,11,12,5
"2011","Kirklees 020D","E01011218","Total",48,21,13,14,5,0,4,1,43,21,9,13
"2011","Kirklees 021A","E01011216","Total",21,8,10,3,2,0,2,0,19,8,8,3
"2011","Kirklees 021B","E01011219","Total",28,13,8,7,2,0,1,1,26,13,7,6
"2011","Kirklees 021C","E01011220","Total",88,29,12,47,6,0,2,4,82,29,10,43
"2011","Kirklees 021D","E01011221","Total",46,16,19,11,5,1,3,1,41,15,16,10
"2011","Kirklees 022A","E01011046","Total",17,5,7,5,3,2,0,1,14,3,7,4
"2011","Kirklees 022B","E01011100","Total",70,25,19,26,7,0,4,3,63,25,15,23
"2011","Kirklees 022C","E01011102","Total",26,8,9,9,2,0,2,0,24,8,7,9
"2011","Kirklees 022D","E01011108","Total",44,21,12,11,9,0,7,2,35,21,5,9
"2011","Kirklees 023A","E01011133","Total",48,9,7,32,6,2,1,3,42,7,6,29
"2011","Kirklees 023B","E01011134","Total",83,15,12,56,6,0,3,3,77,15,9,53
"2011","Kirklees 023C","E01011143","Total",49,14,8,27,4,0,2,2,45,14,6,25
"2011","Kirklees 023D","E01011144","Total",47,12,7,28,7,2,3,2,40,10,4,26
"2011","Kirklees 023E","E01011260","Total",36,14,8,14,1,0,0,1,35,14,8,13
"2011","Kirklees 024A","E01011257","Total",10,0,2,8,0,0,0,0,10,0,2,8
"2011","Kirklees 024B","E01011258","Total",22,2,2,18,5,0,2,3,17,2,0,15
"2011","Kirklees 024C","E01011259","Total",49,7,6,36,4,0,3,1,45,7,3,35
"2011","Kirklees 024D","E01011261","Total",33,9,5,19,3,0,2,1,30,9,3,18
"2011","Kirklees 024E","E01011262","Total",52,17,3,32,6,1,0,5,46,16,3,27
"2011","Kirklees 024F","E01011263","Total",41,19,6,16,3,2,1,0,38,17,5,16
"2011","Kirklees 025A","E01011101","Total",183,44,36,103,22,1,5,16,161,43,31,87
"2011","Kirklees 025B","E01011103","Total",99,37,18,44,5,0,1,4,94,37,17,40
"2011","Kirklees 025C","E01011104","Total",99,36,31,32,14,2,7,5,85,34,24,27
"2011","Kirklees 025D","E01011105","Total",143,55,23,65,11,3,3,5,132,52,20,60
"2011","Kirklees 026A","E01011212","Total",51,18,12,21,3,0,2,1,48,18,10,20
"2011","Kirklees 026B","E01011213","Total",26,10,13,3,4,0,3,1,22,10,10,2
"2011","Kirklees 026C","E01011214","Total",44,16,12,16,4,0,3,1,40,16,9,15
"2011","Kirklees 026D","E01011215","Total",48,20,20,8,7,1,5,1,41,19,15,7
"2011","Kirklees 027A","E01011039","Total",29,8,6,15,2,0,0,2,27,8,6,13
"2011","Kirklees 027B","E01011042","Total",32,15,9,8,3,2,0,1,29,13,9,7
"2011","Kirklees 027C","E01011047","Total",20,7,10,3,2,1,1,0,18,6,9,3
"2011","Kirklees 027D","E01011210","Total",51,13,16,22,1,0,1,0,50,13,15,22
"2011","Kirklees 028A","E01011252","Total",23,9,12,2,8,1,7,0,15,8,5,2
"2011","Kirklees 028B","E01011253","Total",53,21,7,25,2,1,1,0,51,20,6,25
"2011","Kirklees 028C","E01011254","Total",11,5,2,4,3,1,2,0,8,4,0,4
"2011","Kirklees 028D","E01011255","Total",87,22,16,49,5,1,3,1,82,21,13,48
"2011","Kirklees 028E","E01011256","Total",43,16,12,15,3,0,3,0,40,16,9,15
"2011","Kirklees 029A","E01011038","Total",120,23,19,78,13,2,1,10,107,21,18,68
"2011","Kirklees 029B","E01011041","Total",71,28,16,27,12,2,5,5,59,26,11,22
"2011","Kirklees 029C","E01011106","Total",135,36,33,66,11,4,1,6,124,32,32,60
"2011","Kirklees 029D","E01011107","Total",88,19,12,57,7,1,4,2,81,18,8,55
"2011","Kirklees 030A","E01011201","Total",55,24,17,14,4,1,3,0,51,23,14,14
"2011","Kirklees 030B","E01011203","Total",50,20,21,9,5,1,3,1,45,19,18,8
"2011","Kirklees 030C","E01011209","Total",23,13,7,3,2,1,1,0,21,12,6,3
"2011","Kirklees 030D","E01011211","Total",23,7,7,9,0,0,0,0,23,7,7,9
"2011","Kirklees 031A","E01011040","Total",51,19,12,20,7,1,3,3,44,18,9,17
"2011","Kirklees 031B","E01011043","Total",64,17,15,32,2,0,0,2,62,17,15,30
"2011","Kirklees 031C","E01011044","Total",42,13,6,23,0,0,0,0,42,13,6,23
"2011","Kirklees 031D","E01011045","Total",51,12,9,30,10,4,0,6,41,8,9,24
"2011","Kirklees 032A","E01011089","Total",53,26,9,18,2,0,0,2,51,26,9,16
"2011","Kirklees 032B","E01011091","Total",33,14,16,3,6,0,6,0,27,14,10,3
"2011","Kirklees 032C","E01011092","Total",12,5,5,2,2,0,1,1,10,5,4,1
"2011","Kirklees 032D","E01011200","Total",58,17,27,14,5,0,4,1,53,17,23,13
"2011","Kirklees 033A","E01011204","Total",13,4,8,1,1,1,0,0,12,3,8,1
"2011","Kirklees 033B","E01011206","Total",56,23,23,10,9,0,8,1,47,23,15,9
"2011","Kirklees 033C","E01011208","Total",65,23,18,24,7,2,3,2,58,21,15,22
"2011","Kirklees 033D","E01011240","Total",56,29,12,15,0,0,0,0,56,29,12,15
"2011","Kirklees 034A","E01011231","Total",47,18,15,14,10,1,5,4,37,17,10,10
"2011","Kirklees 034B","E01011236","Total",24,7,10,7,4,2,2,0,20,5,8,7
"2011","Kirklees 034C","E01011238","Total",28,8,13,7,2,0,1,1,26,8,12,6
"2011","Kirklees 034D","E01011239","Total",27,10,6,11,3,2,1,0,24,8,5,11
"2011","Kirklees 035A","E01011093","Total",114,34,19,61,2,0,2,0,112,34,17,61
"2011","Kirklees 035B","E01011094","Total",115,38,21,56,3,0,2,1,112,38,19,55
"2011","Kirklees 035C","E01011096","Total",48,15,4,29,1,0,1,0,47,15,3,29
"2011","Kirklees 035D","E01011098","Total",46,17,10,19,4,1,2,1,42,16,8,18
"2011","Kirklees 036A","E01011146","Total",34,11,16,7,3,1,2,0,31,10,14,7
"2011","Kirklees 036B","E01011151","Total",29,14,10,5,3,0,3,0,26,14,7,5
"2011","Kirklees 036C","E01011202","Total",42,21,11,10,4,1,2,1,38,20,9,9
"2011","Kirklees 036D","E01011205","Total",35,15,15,5,4,1,3,0,31,14,12,5
"2011","Kirklees 037A","E01011090","Total",59,26,14,19,6,1,4,1,53,25,10,18
"2011","Kirklees 037B","E01011095","Total",40,14,11,15,3,0,1,2,37,14,10,13
"2011","Kirklees 037C","E01011097","Total",48,21,12,15,1,0,1,0,47,21,11,15
"2011","Kirklees 037D","E01011099","Total",53,23,20,10,3,0,3,0,50,23,17,10
"2011","Kirklees 038A","E01011150","Total",55,15,21,19,4,0,1,3,51,15,20,16
"2011","Kirklees 038B","E01011155","Total",43,18,17,8,4,1,2,1,39,17,15,7
"2011","Kirklees 038C","E01011207","Total",39,13,17,9,5,0,5,0,34,13,12,9
"2011","Kirklees 038D","E01011234","Total",86,34,24,28,13,2,9,2,73,32,15,26
"2011","Kirklees 039A","E01011232","Total",35,11,10,14,1,1,0,0,34,10,10,14
"2011","Kirklees 039B","E01011233","Total",34,11,10,13,4,1,3,0,30,10,7,13
"2011","Kirklees 039C","E01011235","Total",41,12,9,20,9,0,6,3,32,12,3,17
"2011","Kirklees 039D","E01011237","Total",85,34,5,46,8,3,1,4,77,31,4,42
"2011","Kirklees 040A","E01011004","Total",70,26,10,34,3,0,1,2,67,26,9,32
"2011","Kirklees 040B","E01011006","Total",49,25,11,13,8,2,4,2,41,23,7,11
"2011","Kirklees 040C","E01011008","Total",49,13,21,15,10,0,9,1,39,13,12,14
"2011","Kirklees 040D","E01011012","Total",76,26,19,31,8,0,3,5,68,26,16,26
"2011","Kirklees 041A","E01011145","Total",41,15,14,12,2,0,0,2,39,15,14,10
"2011","Kirklees 041B","E01011147","Total",54,21,17,16,4,1,3,0,50,20,14,16
"2011","Kirklees 041C","E01011148","Total",101,33,28,40,7,3,2,2,94,30,26,38
"2011","Kirklees 041D","E01011152","Total",56,23,21,12,12,4,8,0,44,19,13,12
"2011","Kirklees 042A","E01011007","Total",44,16,10,18,4,0,0,4,40,16,10,14
"2011","Kirklees 042B","E01011223","Total",118,32,23,63,10,1,4,5,108,31,19,58
"2011","Kirklees 042C","E01011225","Total",95,38,12,45,4,0,2,2,91,38,10,43
"2011","Kirklees 042D","E01011229","Total",26,5,7,14,5,0,0,5,21,5,7,9
"2011","Kirklees 043A","E01011080","Total",82,19,12,51,8,0,2,6,74,19,10,45
"2011","Kirklees 043B","E01011081","Total",51,12,10,29,6,0,0,6,45,12,10,23
"2011","Kirklees 043C","E01011082","Total",42,10,6,26,4,1,1,2,38,9,5,24
"2011","Kirklees 043D","E01011230","Total",49,10,6,33,10,1,2,7,39,9,4,26
"2011","Kirklees 044A","E01011005","Total",30,15,8,7,4,0,2,2,26,15,6,5
"2011","Kirklees 044B","E01011009","Total",53,22,14,17,5,0,4,1,48,22,10,16
"2011","Kirklees 044C","E01011010","Total",88,25,18,45,5,0,2,3,83,25,16,42
"2011","Kirklees 044D","E01011011","Total",22,7,12,3,3,0,3,0,19,7,9,3
"2011","Kirklees 045A","E01011077","Total",55,17,19,19,4,0,3,1,51,17,16,18
"2011","Kirklees 045B","E01011149","Total",74,27,20,27,2,1,1,0,72,26,19,27
"2011","Kirklees 045C","E01011153","Total",56,21,12,23,5,3,1,1,51,18,11,22
"2011","Kirklees 045D","E01011154","Total",82,27,19,36,6,0,3,3,76,27,16,33
"2011","Kirklees 046A","E01011191","Total",36,16,10,10,4,2,2,0,32,14,8,10
"2011","Kirklees 046B","E01011192","Total",44,14,17,13,10,0,9,1,34,14,8,12
"2011","Kirklees 046C","E01011193","Total",53,16,14,23,10,3,3,4,43,13,11,19
"2011","Kirklees 046D","E01011194","Total",16,10,6,0,2,0,2,0,14,10,4,0
"2011","Kirklees 047A","E01011079","Total",75,13,16,46,11,3,0,8,64,10,16,38
"2011","Kirklees 047B","E01011083","Total",35,14,13,8,3,0,3,0,32,14,10,8
"2011","Kirklees 047C","E01011084","Total",116,26,14,76,11,2,2,7,105,24,12,69
"2011","Kirklees 047D","E01011085","Total",56,26,9,21,1,0,1,0,55,26,8,21
"2011","Kirklees 048A","E01011224","Total",79,23,17,39,8,0,7,1,71,23,10,38
"2011","Kirklees 048B","E01011226","Total",36,11,8,17,4,0,2,2,32,11,6,15
"2011","Kirklees 048C","E01011227","Total",88,32,13,43,13,0,3,10,75,32,10,33
"2011","Kirklees 048D","E01011228","Total",29,12,7,10,6,0,5,1,23,12,2,9
"2011","Kirklees 049A","E01011071","Total",48,16,18,14,6,1,4,1,42,15,14,13
"2011","Kirklees 049B","E01011072","Total",45,18,13,14,4,2,2,0,41,16,11,14
"2011","Kirklees 049C","E01011073","Total",60,25,14,21,4,0,2,2,56,25,12,19
"2011","Kirklees 049D","E01011078","Total",54,18,14,22,4,0,2,2,50,18,12,20
"2011","Kirklees 050A","E01011086","Total",18,3,10,5,4,1,3,0,14,2,7,5
"2011","Kirklees 050B","E01011087","Total",55,23,5,27,9,1,1,7,46,22,4,20
"2011","Kirklees 050C","E01011088","Total",26,11,12,3,5,0,5,0,21,11,7,3
"2011","Kirklees 050D","E01011222","Total",61,29,15,17,5,0,4,1,56,29,11,16
"2011","Kirklees 051A","E01011190","Total",28,13,11,4,1,1,0,0,27,12,11,4
"2011","Kirklees 051B","E01011195","Total",12,6,3,3,2,0,2,0,10,6,1,3
"2011","Kirklees 051C","E01011196","Total",26,10,10,6,3,1,1,1,23,9,9,5
"2011","Kirklees 051D","E01011197","Total",47,19,19,9,4,0,4,0,43,19,15,9
"2011","Kirklees 052A","E01011070","Total",39,9,14,16,6,0,4,2,33,9,10,14
"2011","Kirklees 052B","E01011074","Total",45,14,17,14,4,0,4,0,41,14,13,14
"2011","Kirklees 052C","E01011075","Total",31,15,7,9,4,1,1,2,27,14,6,7
"2011","Kirklees 052D","E01011076","Total",44,16,12,16,11,3,5,3,33,13,7,13
"2011","Kirklees 053A","E01011169","Total",15,4,9,2,4,0,4,0,11,4,5,2
"2011","Kirklees 053B","E01011170","Total",29,12,11,6,7,2,4,1,22,10,7,5
"2011","Kirklees 053C","E01011171","Total",34,12,14,8,7,0,6,1,27,12,8,7
"2011","Kirklees 053D","E01011172","Total",35,18,7,10,2,1,1,0,33,17,6,10
"2011","Kirklees 053E","E01011173","Total",18,9,6,3,1,0,1,0,17,9,5,3
"2011","Kirklees 053F","E01011176","Total",24,12,5,7,5,3,1,1,19,9,4,6
"2011","Kirklees 054A","E01011109","Total",48,21,15,12,6,1,4,1,42,20,11,11
"2011","Kirklees 054B","E01011113","Total",24,10,10,4,8,1,5,2,16,9,5,2
"2011","Kirklees 054C","E01011114","Total",43,14,16,13,5,0,2,3,38,14,14,10
"2011","Kirklees 054D","E01011119","Total",30,12,10,8,3,0,3,0,27,12,7,8
"2011","Kirklees 055A","E01011168","Total",28,14,9,5,4,0,3,1,24,14,6,4
"2011","Kirklees 055B","E01011174","Total",26,11,9,6,3,0,1,2,23,11,8,4
"2011","Kirklees 055C","E01011175","Total",80,24,17,39,7,0,6,1,73,24,11,38
"2011","Kirklees 055D","E01011177","Total",36,15,11,10,2,0,1,1,34,15,10,9
"2011","Kirklees 055E","E01011178","Total",50,22,17,11,4,1,3,0,46,21,14,11
"2011","Kirklees 056A","E01011118","Total",29,9,11,9,1,1,0,0,28,8,11,9
"2011","Kirklees 056B","E01011120","Total",24,6,15,3,4,0,4,0,20,6,11,3
"2011","Kirklees 056C","E01011198","Total",29,13,12,4,7,0,6,1,22,13,6,3
"2011","Kirklees 056D","E01011199","Total",44,13,19,12,4,0,4,0,40,13,15,12
"2011","Kirklees 057A","E01011110","Total",26,7,9,10,11,2,5,4,15,5,4,6
"2011","Kirklees 057B","E01011111","Total",44,20,16,8,6,0,5,1,38,20,11,7
"2011","Kirklees 057C","E01011112","Total",42,13,13,16,3,1,1,1,39,12,12,15
"2011","Kirklees 057D","E01011115","Total",30,7,14,9,6,1,4,1,24,6,10,8
"2011","Kirklees 057E","E01011116","Total",38,15,17,6,5,0,4,1,33,15,13,5
"2011","Kirklees 057F","E01011117","Total",29,11,11,7,7,2,3,2,22,9,8,5
"2011","Kirklees 058A","E01011180","Total",43,11,19,13,9,2,6,1,34,9,13,12
"2011","Kirklees 058B","E01011182","Total",34,18,8,8,5,1,3,1,29,17,5,7
"2011","Kirklees 058C","E01011186","Total",31,9,14,8,9,0,7,2,22,9,7,6
"2011","Kirklees 058D","E01011188","Total",47,12,13,22,5,1,2,2,42,11,11,20
"2011","Kirklees 059A","E01011179","Total",40,16,15,9,3,0,1,2,37,16,14,7
"2011","Kirklees 059B","E01011181","Total",43,11,20,12,8,1,4,3,35,10,16,9
"2011","Kirklees 059C","E01011183","Total",32,14,14,4,1,0,1,0,31,14,13,4
"2011","Kirklees 059D","E01011184","Total",63,26,15,22,3,1,2,0,60,25,13,22
"2011","Kirklees 059E","E01011185","Total",44,14,17,13,6,0,6,0,38,14,11,13
"2011","Kirklees 059F","E01011187","Total",47,17,15,15,5,0,4,1,42,17,11,14
"2011","Kirklees 059G","E01011189","Total",25,9,13,3,3,1,2,0,22,8,11,3
"2011","Leeds 001A","E01011698","Total",39,18,15,6,2,0,2,0,37,18,13,6
"2011","Leeds 001B","E01011699","Total",15,7,4,4,2,0,2,0,13,7,2,4
"2011","Leeds 001C","E01011701","Total",26,6,15,5,6,2,4,0,20,4,11,5
"2011","Leeds 001D","E01011702","Total",11,3,3,5,3,0,2,1,8,3,1,4
"2011","Leeds 001E","E01011703","Total",6,1,4,1,0,0,0,0,6,1,4,1
"2011","Leeds 002A","E01011697","Total",29,12,11,6,3,1,2,0,26,11,9,6
"2011","Leeds 002B","E01011700","Total",15,8,5,2,0,0,0,0,15,8,5,2
"2011","Leeds 002C","E01011704","Total",50,22,20,8,8,0,5,3,42,22,15,5
"2011","Leeds 002D","E01011705","Total",57,20,12,25,4,0,3,1,53,20,9,24
"2011","Leeds 003A","E01011581","Total",38,19,9,10,2,0,2,0,36,19,7,10
"2011","Leeds 003B","E01011582","Total",51,18,12,21,3,2,1,0,48,16,11,21
"2011","Leeds 003C","E01011583","Total",45,22,8,15,2,0,1,1,43,22,7,14
"2011","Leeds 003D","E01011584","Total",40,20,9,11,2,0,1,1,38,20,8,10
"2011","Leeds 004A","E01011569","Total",34,15,11,8,2,0,2,0,32,15,9,8
"2011","Leeds 004B","E01011571","Total",40,17,13,10,5,2,3,0,35,15,10,10
"2011","Leeds 004C","E01011572","Total",41,22,14,5,3,1,2,0,38,21,12,5
"2011","Leeds 004D","E01011573","Total",30,18,8,4,2,0,2,0,28,18,6,4
"2011","Leeds 004E","E01011574","Total",25,11,9,5,0,0,0,0,25,11,9,5
"2011","Leeds 005A","E01011707","Total",23,9,8,6,5,1,1,3,18,8,7,3
"2011","Leeds 005B","E01011709","Total",10,3,5,2,1,0,0,1,9,3,5,1
"2011","Leeds 005C","E01011710","Total",27,7,11,9,3,0,2,1,24,7,9,8
"2011","Leeds 005D","E01011711","Total",27,10,12,5,1,0,0,1,26,10,12,4
"2011","Leeds 005E","E01011712","Total",28,7,14,7,3,0,2,1,25,7,12,6
"2011","Leeds 006A","E01011561","Total",23,10,8,5,1,0,1,0,22,10,7,5
"2011","Leeds 006B","E01011696","Total",16,7,4,5,4,0,3,1,12,7,1,4
"2011","Leeds 006C","E01011706","Total",22,8,9,5,4,0,3,1,18,8,6,4
"2011","Leeds 006D","E01011708","Total",28,6,17,5,4,0,3,1,24,6,14,4
"2011","Leeds 006E","E01011713","Total",32,10,12,10,3,0,3,0,29,10,9,10
"2011","Leeds 007A","E01011570","Total",41,16,18,7,5,0,3,2,36,16,15,5
"2011","Leeds 007C","E01011576","Total",11,2,5,4,2,0,2,0,9,2,3,4
"2011","Leeds 007E","E01032503","Total",20,6,9,5,5,0,5,0,15,6,4,5
"2011","Leeds 007F","E01032504","Total",20,8,10,2,3,2,1,0,17,6,9,2
"2011","Leeds 008A","E01011266","Total",32,15,11,6,2,0,1,1,30,15,10,5
"2011","Leeds 008B","E01011270","Total",13,3,4,6,2,0,1,1,11,3,3,5
"2011","Leeds 008C","E01011279","Total",29,12,11,6,3,0,3,0,26,12,8,6
"2011","Leeds 008D","E01011280","Total",39,17,18,4,7,1,6,0,32,16,12,4
"2011","Leeds 009A","E01011265","Total",31,11,14,6,7,0,7,0,24,11,7,6
"2011","Leeds 009B","E01011267","Total",44,20,9,15,2,0,1,1,42,20,8,14
"2011","Leeds 009C","E01011271","Total",48,18,22,8,9,0,8,1,39,18,14,7
"2011","Leeds 009D","E01011272","Total",29,14,14,1,4,0,4,0,25,14,10,1
"2011","Leeds 010A","E01011268","Total",58,21,12,25,5,0,4,1,53,21,8,24
"2011","Leeds 010B","E01011273","Total",36,8,13,15,6,0,2,4,30,8,11,11
"2011","Leeds 010C","E01011274","Total",59,24,10,25,6,1,2,3,53,23,8,22
"2011","Leeds 010D","E01011275","Total",45,25,9,11,2,1,1,0,43,24,8,11
"2011","Leeds 011A","E01011264","Total",31,15,8,8,2,0,2,0,29,15,6,8
"2011","Leeds 011B","E01011269","Total",47,21,14,12,6,0,6,0,41,21,8,12
"2011","Leeds 011C","E01011276","Total",39,16,7,16,4,2,2,0,35,14,5,16
"2011","Leeds 011D","E01011578","Total",37,20,12,5,0,0,0,0,37,20,12,5
"2011","Leeds 012A","E01011554","Total",25,6,14,5,8,0,6,2,17,6,8,3
"2011","Leeds 012B","E01011562","Total",24,11,11,2,4,0,4,0,20,11,7,2
"2011","Leeds 012C","E01011563","Total",12,7,3,2,3,1,1,1,9,6,2,1
"2011","Leeds 012D","E01011564","Total",19,4,10,5,2,0,2,0,17,4,8,5
"2011","Leeds 012E","E01011567","Total",30,11,14,5,3,0,2,1,27,11,12,4
"2011","Leeds 013A","E01011376","Total",15,5,6,4,3,0,2,1,12,5,4,3
"2011","Leeds 013B","E01011377","Total",13,6,5,2,2,0,2,0,11,6,3,2
"2011","Leeds 013C","E01011378","Total",56,21,9,26,7,3,2,2,49,18,7,24
"2011","Leeds 013D","E01011382","Total",31,13,16,2,3,0,3,0,28,13,13,2
"2011","Leeds 014A","E01011277","Total",43,15,20,8,3,0,3,0,40,15,17,8
"2011","Leeds 014B","E01011278","Total",41,14,16,11,5,0,3,2,36,14,13,9
"2011","Leeds 014C","E01011579","Total",37,17,12,8,5,0,3,2,32,17,9,6
"2011","Leeds 014D","E01011580","Total",17,8,8,1,0,0,0,0,17,8,8,1
"2011","Leeds 015A","E01011556","Total",44,17,16,11,5,1,1,3,39,16,15,8
"2011","Leeds 015B","E01011557","Total",21,9,8,4,0,0,0,0,21,9,8,4
"2011","Leeds 015C","E01011565","Total",32,12,13,7,3,1,1,1,29,11,12,6
"2011","Leeds 015D","E01011566","Total",35,12,12,11,3,0,1,2,32,12,11,9
"2011","Leeds 015E","E01011568","Total",32,12,18,2,2,0,2,0,30,12,16,2
"2011","Leeds 016A","E01011380","Total",21,6,7,8,2,0,2,0,19,6,5,8
"2011","Leeds 016B","E01011381","Total",25,10,9,6,4,2,2,0,21,8,7,6
"2011","Leeds 016C","E01011385","Total",18,3,9,6,2,0,2,0,16,3,7,6
"2011","Leeds 016D","E01011386","Total",17,6,8,3,2,0,2,0,15,6,6,3
"2011","Leeds 017A","E01011379","Total",61,21,18,22,6,0,3,3,55,21,15,19
"2011","Leeds 017B","E01011384","Total",37,18,7,12,4,0,1,3,33,18,6,9
"2011","Leeds 017E","E01032501","Total",27,12,10,5,3,0,3,0,24,12,7,5
"2011","Leeds 017F","E01032502","Total",120,39,22,59,9,2,1,6,111,37,21,53
"2011","Leeds 018A","E01011555","Total",19,7,6,6,1,0,1,0,18,7,5,6
"2011","Leeds 018B","E01011558","Total",100,36,26,38,12,3,3,6,88,33,23,32
"2011","Leeds 018C","E01011559","Total",85,29,20,36,8,0,4,4,77,29,16,32
"2011","Leeds 018D","E01011560","Total",108,34,20,54,11,1,3,7,97,33,17,47
"2011","Leeds 019A","E01011383","Total",31,9,12,10,6,0,6,0,25,9,6,10
"2011","Leeds 019B","E01011388","Total",26,8,12,6,1,0,1,0,25,8,11,6
"2011","Leeds 019C","E01011684","Total",34,11,12,11,1,1,0,0,33,10,12,11
"2011","Leeds 019D","E01011695","Total",108,29,25,54,6,0,2,4,102,29,23,50
"2011","Leeds 020A","E01011650","Total",18,8,4,6,0,0,0,0,18,8,4,6
"2011","Leeds 020B","E01011651","Total",43,18,8,17,2,0,0,2,41,18,8,15
"2011","Leeds 020C","E01011653","Total",23,12,7,4,1,0,1,0,22,12,6,4
"2011","Leeds 020D","E01011655","Total",19,5,10,4,3,0,3,0,16,5,7,4
"2011","Leeds 021A","E01011455","Total",17,5,11,1,2,0,2,0,15,5,9,1
"2011","Leeds 021B","E01011456","Total",22,4,12,6,2,0,2,0,20,4,10,6
"2011","Leeds 021C","E01011459","Total",29,7,13,9,7,0,6,1,22,7,7,8
"2011","Leeds 021D","E01011461","Total",18,9,6,3,1,1,0,0,17,8,6,3
"2011","Leeds 022A","E01011311","Total",15,6,4,5,0,0,0,0,15,6,4,5
"2011","Leeds 022B","E01011649","Total",28,9,15,4,3,1,2,0,25,8,13,4
"2011","Leeds 022C","E01011715","Total",28,8,16,4,4,0,4,0,24,8,12,4
"2011","Leeds 022D","E01011719","Total",27,18,7,2,3,0,3,0,24,18,4,2
"2011","Leeds 023A","E01011509","Total",16,5,8,3,1,0,1,0,15,5,7,3
"2011","Leeds 023B","E01011511","Total",18,5,5,8,1,0,1,0,17,5,4,8
"2011","Leeds 023C","E01011512","Total",32,12,13,7,5,1,3,1,27,11,10,6
"2011","Leeds 023D","E01011515","Total",26,10,10,6,2,0,2,0,24,10,8,6
"2011","Leeds 023E","E01011516","Total",28,13,14,1,4,1,3,0,24,12,11,1
"2011","Leeds 024A","E01011508","Total",18,5,10,3,1,1,0,0,17,4,10,3
"2011","Leeds 024B","E01011517","Total",64,25,20,19,3,0,2,1,61,25,18,18
"2011","Leeds 024C","E01011652","Total",26,10,12,4,2,0,2,0,24,10,10,4
"2011","Leeds 024D","E01011654","Total",16,7,8,1,2,0,2,0,14,7,6,1
"2011","Leeds 025A","E01011505","Total",44,15,14,15,6,0,4,2,38,15,10,13
"2011","Leeds 025B","E01011506","Total",16,4,6,6,1,0,1,0,15,4,5,6
"2011","Leeds 025C","E01011507","Total",31,10,17,4,2,0,2,0,29,10,15,4
"2011","Leeds 025D","E01011510","Total",72,25,21,26,6,0,4,2,66,25,17,24
"2011","Leeds 025E","E01011514","Total",24,7,9,8,2,0,1,1,22,7,8,7
"2011","Leeds 027A","E01011452","Total",16,7,7,2,1,0,1,0,15,7,6,2
"2011","Leeds 027B","E01011454","Total",28,10,15,3,4,0,4,0,24,10,11,3
"2011","Leeds 027C","E01011457","Total",18,6,8,4,1,1,0,0,17,5,8,4
"2011","Leeds 027D","E01011458","Total",16,10,6,0,3,1,2,0,13,9,4,0
"2011","Leeds 027E","E01011465","Total",34,10,13,11,2,0,1,1,32,10,12,10
"2011","Leeds 028A","E01011453","Total",25,13,11,1,2,0,2,0,23,13,9,1
"2011","Leeds 028B","E01011460","Total",42,17,10,15,1,0,0,1,41,17,10,14
"2011","Leeds 028C","E01011462","Total",55,19,15,21,4,0,3,1,51,19,12,20
"2011","Leeds 028D","E01011463","Total",63,17,24,22,8,1,4,3,55,16,20,19
"2011","Leeds 028E","E01011464","Total",31,16,11,4,2,0,2,0,29,16,9,4
"2011","Leeds 029A","E01011714","Total",48,22,15,11,7,1,5,1,41,21,10,10
"2011","Leeds 029B","E01011716","Total",27,6,6,15,2,0,0,2,25,6,6,13
"2011","Leeds 029C","E01011717","Total",73,35,16,22,8,4,4,0,65,31,12,22
"2011","Leeds 029D","E01011718","Total",61,28,15,18,3,1,2,0,58,27,13,18
"2011","Leeds 029E","E01011720","Total",53,24,7,22,5,3,2,0,48,21,5,22
"2011","Leeds 030A","E01011296","Total",27,10,13,4,2,1,1,0,25,9,12,4
"2011","Leeds 030B","E01011297","Total",29,12,9,8,5,0,4,1,24,12,5,7
"2011","Leeds 030C","E01011309","Total",34,11,14,9,5,0,4,1,29,11,10,8
"2011","Leeds 030D","E01011310","Total",22,7,12,3,4,1,3,0,18,6,9,3
"2011","Leeds 031A","E01011513","Total",66,29,28,9,6,1,5,0,60,28,23,9
"2011","Leeds 031B","E01011688","Total",56,14,11,31,2,0,2,0,54,14,9,31
"2011","Leeds 031C","E01011689","Total",31,13,8,10,2,0,1,1,29,13,7,9
"2011","Leeds 031D","E01011691","Total",91,33,23,35,4,1,1,2,87,32,22,33
"2011","Leeds 032A","E01011504","Total",90,32,20,38,12,3,5,4,78,29,15,34
"2011","Leeds 032B","E01011641","Total",20,8,9,3,0,0,0,0,20,8,9,3
"2011","Leeds 032C","E01011642","Total",30,6,17,7,3,0,3,0,27,6,14,7
"2011","Leeds 032D","E01011645","Total",30,11,7,12,5,3,2,0,25,8,5,12
"2011","Leeds 033A","E01011484","Total",93,28,25,40,9,1,3,5,84,27,22,35
"2011","Leeds 033B","E01011485","Total",69,26,11,32,9,2,0,7,60,24,11,25
"2011","Leeds 033E","E01011686","Total",81,25,14,42,7,1,2,4,74,24,12,38
"2011","Leeds 033F","E01032493","Total",28,8,15,5,3,0,3,0,25,8,12,5
"2011","Leeds 033G","E01032494","Total",106,33,27,46,11,0,7,4,95,33,20,42
"2011","Leeds 034A","E01011350","Total",26,9,14,3,5,1,3,1,21,8,11,2
"2011","Leeds 034B","E01011351","Total",28,12,13,3,1,1,0,0,27,11,13,3
"2011","Leeds 034C","E01011352","Total",29,10,5,14,3,0,1,2,26,10,4,12
"2011","Leeds 034D","E01011353","Total",41,23,13,5,3,0,3,0,38,23,10,5
"2011","Leeds 035A","E01011656","Total",118,39,22,57,11,4,2,5,107,35,20,52
"2011","Leeds 035B","E01011657","Total",79,31,15,33,5,2,3,0,74,29,12,33
"2011","Leeds 035C","E01011659","Total",59,27,14,18,2,0,2,0,57,27,12,18
"2011","Leeds 035D","E01011661","Total",68,26,10,32,9,1,6,2,59,25,4,30
"2011","Leeds 037A","E01011643","Total",27,6,17,4,3,1,2,0,24,5,15,4
"2011","Leeds 037B","E01011644","Total",35,14,10,11,3,0,2,1,32,14,8,10
"2011","Leeds 037C","E01011646","Total",43,19,16,8,6,1,4,1,37,18,12,7
"2011","Leeds 037D","E01011647","Total",36,8,7,21,3,0,2,1,33,8,5,20
"2011","Leeds 037E","E01011648","Total",39,11,14,14,5,2,2,1,34,9,12,13
"2011","Leeds 038A","E01011354","Total",118,35,18,65,6,0,3,3,112,35,15,62
"2011","Leeds 038B","E01011355","Total",85,39,18,28,6,0,1,5,79,39,17,23
"2011","Leeds 038C","E01011357","Total",144,52,28,64,11,4,6,1,133,48,22,63
"2011","Leeds 038D","E01011450","Total",45,14,10,21,0,0,0,0,45,14,10,21
"2011","Leeds 039A","E01011588","Total",42,14,20,8,6,0,5,1,36,14,15,7
"2011","Leeds 039B","E01011589","Total",32,15,15,2,3,0,2,1,29,15,13,1
"2011","Leeds 039C","E01011590","Total",34,19,8,7,5,1,3,1,29,18,5,6
"2011","Leeds 039D","E01011592","Total",12,6,2,4,3,0,1,2,9,6,1,2
"2011","Leeds 039E","E01011593","Total",44,25,16,3,1,0,0,1,43,25,16,2
"2011","Leeds 040A","E01011421","Total",59,26,9,24,3,0,2,1,56,26,7,23
"2011","Leeds 040B","E01011425","Total",39,15,19,5,7,0,6,1,32,15,13,4
"2011","Leeds 040C","E01011658","Total",120,33,25,62,11,2,2,7,109,31,23,55
"2011","Leeds 040D","E01011660","Total",73,24,18,31,6,2,4,0,67,22,14,31
"2011","Leeds 040E","E01011662","Total",89,25,20,44,13,3,5,5,76,22,15,39
"2011","Leeds 041A","E01011721","Total",93,38,19,36,3,1,1,1,90,37,18,35
"2011","Leeds 041B","E01011722","Total",90,33,21,36,6,1,3,2,84,32,18,34
"2011","Leeds 041C","E01011723","Total",106,41,22,43,6,2,3,1,100,39,19,42
"2011","Leeds 041D","E01011724","Total",97,32,20,45,7,0,5,2,90,32,15,43
"2011","Leeds 042A","E01011356","Total",62,20,17,25,10,0,5,5,52,20,12,20
"2011","Leeds 042B","E01011358","Total",85,23,23,39,3,0,1,2,82,23,22,37
"2011","Leeds 042C","E01011359","Total",69,24,15,30,5,1,4,0,64,23,11,30
"2011","Leeds 042D","E01011360","Total",121,36,32,53,15,3,4,8,106,33,28,45
"2011","Leeds 042E","E01011361","Total",161,50,39,72,11,4,3,4,150,46,36,68
"2011","Leeds 044A","E01011435","Total",3,0,3,0,2,0,2,0,1,0,1,0
"2011","Leeds 044D","E01011440","Total",5,2,1,2,2,0,0,2,3,2,1,0
"2011","Leeds 044E","E01011441","Total",10,3,3,4,3,0,2,1,7,3,1,3
"2011","Leeds 044F","E01032945","Total",5,0,4,1,0,0,0,0,5,0,4,1
"2011","Leeds 045A","E01011477","Total",66,27,12,27,5,2,1,2,61,25,11,25
"2011","Leeds 045B","E01011480","Total",15,4,8,3,4,0,3,1,11,4,5,2
"2011","Leeds 045C","E01011488","Total",48,13,11,24,5,0,2,3,43,13,9,21
"2011","Leeds 045D","E01011489","Total",54,17,8,29,1,0,1,0,53,17,7,29
"2011","Leeds 046A","E01011324","Total",85,21,6,58,3,0,2,1,82,21,4,57
"2011","Leeds 046B","E01011325","Total",56,21,13,22,8,2,4,2,48,19,9,20
"2011","Leeds 046C","E01011326","Total",77,29,16,32,10,1,6,3,67,28,10,29
"2011","Leeds 046D","E01011332","Total",65,27,12,26,4,1,2,1,61,26,10,25
"2011","Leeds 047A","E01011423","Total",94,37,12,45,8,4,3,1,86,33,9,44
"2011","Leeds 047B","E01011424","Total",92,27,17,48,6,1,2,3,86,26,15,45
"2011","Leeds 047C","E01011427","Total",109,36,19,54,6,1,1,4,103,35,18,50
"2011","Leeds 047D","E01011431","Total",156,47,30,79,17,1,3,13,139,46,27,66
"2011","Leeds 048A","E01011422","Total",41,13,1,27,4,0,0,4,37,13,1,23
"2011","Leeds 048B","E01011426","Total",47,12,8,27,4,1,3,0,43,11,5,27
"2011","Leeds 048C","E01011428","Total",50,17,5,28,2,1,0,1,48,16,5,27
"2011","Leeds 048D","E01011429","Total",79,20,12,47,5,1,2,2,74,19,10,45
"2011","Leeds 050A","E01011663","Total",101,29,13,59,8,0,4,4,93,29,9,55
"2011","Leeds 050B","E01011664","Total",63,21,9,33,5,0,3,2,58,21,6,31
"2011","Leeds 050C","E01011665","Total",60,21,14,25,14,1,6,7,46,20,8,18
"2011","Leeds 050D","E01011667","Total",160,35,17,108,10,0,3,7,150,35,14,101
"2011","Leeds 051A","E01011323","Total",30,15,7,8,1,0,0,1,29,15,7,7
"2011","Leeds 051B","E01011329","Total",37,14,19,4,3,0,3,0,34,14,16,4
"2011","Leeds 051C","E01011330","Total",49,19,13,17,2,0,2,0,47,19,11,17
"2011","Leeds 051D","E01011333","Total",52,20,15,17,9,1,5,3,43,19,10,14
"2011","Leeds 052A","E01011327","Total",61,31,11,19,3,0,1,2,58,31,10,17
"2011","Leeds 052B","E01011328","Total",75,25,25,25,12,1,11,0,63,24,14,25
"2011","Leeds 052C","E01011335","Total",75,26,21,28,8,0,4,4,67,26,17,24
"2011","Leeds 052D","E01011591","Total",33,15,12,6,3,0,2,1,30,15,10,5
"2011","Leeds 053A","E01011430","Total",51,16,4,31,2,1,0,1,49,15,4,30
"2011","Leeds 053B","E01011432","Total",82,24,9,49,4,1,2,1,78,23,7,48
"2011","Leeds 053C","E01011433","Total",128,27,15,86,10,2,6,2,118,25,9,84
"2011","Leeds 053D","E01011434","Total",91,24,13,54,14,1,5,8,77,23,8,46
"2011","Leeds 054A","E01011445","Total",4,2,1,1,0,0,0,0,4,2,1,1
"2011","Leeds 054B","E01011446","Total",7,1,0,6,0,0,0,0,7,1,0,6
"2011","Leeds 054C","E01011447","Total",10,1,0,9,1,0,0,1,9,1,0,8
"2011","Leeds 054D","E01011448","Total",30,8,5,17,8,0,4,4,22,8,1,13
"2011","Leeds 054E","E01011449","Total",36,9,5,22,2,1,0,1,34,8,5,21
"2011","Leeds 055A","E01011670","Total",92,25,16,51,0,0,0,0,92,25,16,51
"2011","Leeds 055B","E01011671","Total",136,43,24,69,8,2,2,4,128,41,22,65
"2011","Leeds 055F","E01033002","Total",31,7,10,14,1,0,1,0,30,7,9,14
"2011","Leeds 055G","E01033003","Total",45,7,13,25,4,0,3,1,41,7,10,24
"2011","Leeds 055H","E01033005","Total",60,13,5,42,9,0,1,8,51,13,4,34
"2011","Leeds 056A","E01011478","Total",39,14,9,16,5,2,1,2,34,12,8,14
"2011","Leeds 056B","E01011479","Total",20,9,3,8,1,0,0,1,19,9,3,7
"2011","Leeds 056C","E01011481","Total",33,17,3,13,7,6,0,1,26,11,3,12
"2011","Leeds 056D","E01011482","Total",46,14,12,20,3,0,2,1,43,14,10,19
"2011","Leeds 056E","E01011483","Total",51,19,7,25,10,5,5,0,41,14,2,25
"2011","Leeds 057A","E01011406","Total",25,11,8,6,3,0,1,2,22,11,7,4
"2011","Leeds 057B","E01011407","Total",58,33,12,13,3,2,1,0,55,31,11,13
"2011","Leeds 057C","E01011408","Total",23,13,7,3,3,3,0,0,20,10,7,3
"2011","Leeds 057D","E01011409","Total",33,16,8,9,3,0,3,0,30,16,5,9
"2011","Leeds 057E","E01011410","Total",23,10,11,2,4,0,3,1,19,10,8,1
"2011","Leeds 057F","E01011412","Total",18,4,13,1,5,0,5,0,13,4,8,1
"2011","Leeds 058A","E01011331","Total",40,17,12,11,2,0,2,0,38,17,10,11
"2011","Leeds 058B","E01011334","Total",42,14,11,17,4,1,2,1,38,13,9,16
"2011","Leeds 058C","E01011336","Total",56,28,9,19,2,1,1,0,54,27,8,19
"2011","Leeds 058D","E01011337","Total",101,34,12,55,4,0,1,3,97,34,11,52
"2011","Leeds 059A","E01011281","Total",83,25,10,48,8,0,2,6,75,25,8,42
"2011","Leeds 059B","E01011282","Total",62,20,23,19,4,0,1,3,58,20,22,16
"2011","Leeds 059C","E01011283","Total",82,22,9,51,10,3,2,5,72,19,7,46
"2011","Leeds 059D","E01011286","Total",28,12,8,8,4,0,3,1,24,12,5,7
"2011","Leeds 059E","E01011295","Total",71,36,11,24,4,0,1,3,67,36,10,21
"2011","Leeds 060A","E01011339","Total",79,31,12,36,4,0,0,4,75,31,12,32
"2011","Leeds 060B","E01011340","Total",110,29,24,57,8,0,4,4,102,29,20,53
"2011","Leeds 060C","E01011342","Total",102,28,10,64,4,0,1,3,98,28,9,61
"2011","Leeds 060D","E01011346","Total",110,33,15,62,12,0,3,9,98,33,12,53
"2011","Leeds 061A","E01011341","Total",68,28,9,31,6,2,2,2,62,26,7,29
"2011","Leeds 061B","E01011343","Total",58,16,23,19,6,1,5,0,52,15,18,19
"2011","Leeds 061C","E01011345","Total",87,31,9,47,7,1,2,4,80,30,7,43
"2011","Leeds 061D","E01011666","Total",34,15,14,5,1,0,1,0,33,15,13,5
"2011","Leeds 062A","E01011585","Total",52,20,14,18,3,0,2,1,49,20,12,17
"2011","Leeds 062B","E01011587","Total",46,13,28,5,6,1,5,0,40,12,23,5
"2011","Leeds 062C","E01011594","Total",72,31,23,18,10,1,7,2,62,30,16,16
"2011","Leeds 062D","E01011596","Total",33,16,11,6,1,0,1,0,32,16,10,6
"2011","Leeds 062E","E01011598","Total",35,12,15,8,0,0,0,0,35,12,15,8
"2011","Leeds 063B","E01011678","Total",17,4,6,7,2,0,1,1,15,4,5,6
"2011","Leeds 063D","E01011681","Total",59,14,5,40,7,1,1,5,52,13,4,35
"2011","Leeds 063E","E01033006","Total",25,3,6,16,1,0,0,1,24,3,6,15
"2011","Leeds 064A","E01011338","Total",101,26,19,56,11,0,5,6,90,26,14,50
"2011","Leeds 064B","E01011673","Total",105,13,27,65,14,0,3,11,91,13,24,54
"2011","Leeds 064D","E01011677","Total",77,19,19,39,15,4,9,2,62,15,10,37
"2011","Leeds 064E","E01033031","Total",20,1,5,14,6,0,2,4,14,1,3,10
"2011","Leeds 064F","E01033035","Total",70,13,8,49,14,2,3,9,56,11,5,40
"2011","Leeds 065A","E01011344","Total",138,33,20,85,8,1,2,5,130,32,18,80
"2011","Leeds 065B","E01011347","Total",153,32,22,99,15,2,4,9,138,30,18,90
"2011","Leeds 065C","E01011348","Total",116,27,21,68,12,2,4,6,104,25,17,62
"2011","Leeds 065D","E01011349","Total",72,27,12,33,5,0,2,3,67,27,10,30
"2011","Leeds 066A","E01011586","Total",31,13,3,15,1,0,1,0,30,13,2,15
"2011","Leeds 066B","E01011595","Total",19,4,6,9,2,0,2,0,17,4,4,9
"2011","Leeds 066C","E01011597","Total",43,11,12,20,3,0,1,2,40,11,11,18
"2011","Leeds 066D","E01011599","Total",31,17,6,8,2,0,2,0,29,17,4,8
"2011","Leeds 067B","E01011287","Total",39,14,14,11,6,0,6,0,33,14,8,11
"2011","Leeds 067G","E01032499","Total",19,6,9,4,5,1,4,0,14,5,5,4
"2011","Leeds 067H","E01032500","Total",43,13,7,23,7,0,3,4,36,13,4,19
"2011","Leeds 067I","E01032606","Total",78,27,17,34,8,1,2,5,70,26,15,29
"2011","Leeds 067J","E01032607","Total",40,8,9,23,4,1,2,1,36,7,7,22
"2011","Leeds 067K","E01032608","Total",39,14,8,17,4,1,0,3,35,13,8,14
"2011","Leeds 068A","E01011608","Total",52,21,12,19,4,1,2,1,48,20,10,18
"2011","Leeds 068B","E01011609","Total",55,14,11,30,6,0,0,6,49,14,11,24
"2011","Leeds 068C","E01011610","Total",25,15,7,3,2,0,2,0,23,15,5,3
"2011","Leeds 068D","E01011611","Total",85,30,17,38,8,0,3,5,77,30,14,33
"2011","Leeds 068E","E01011614","Total",37,18,11,8,1,1,0,0,36,17,11,8
"2011","Leeds 069A","E01011413","Total",34,12,15,7,4,0,4,0,30,12,11,7
"2011","Leeds 069B","E01011415","Total",40,14,17,9,1,0,0,1,39,14,17,8
"2011","Leeds 069C","E01011416","Total",48,16,24,8,5,0,5,0,43,16,19,8
"2011","Leeds 069D","E01011417","Total",25,11,6,8,3,0,1,2,22,11,5,6
"2011","Leeds 069E","E01011420","Total",12,5,5,2,2,1,1,0,10,4,4,2
"2011","Leeds 070A","E01011615","Total",72,27,20,25,6,2,1,3,66,25,19,22
"2011","Leeds 070B","E01011617","Total",110,42,17,51,7,1,3,3,103,41,14,48
"2011","Leeds 070C","E01011618","Total",112,33,19,60,8,1,4,3,104,32,15,57
"2011","Leeds 070D","E01011621","Total",91,37,15,39,5,0,1,4,86,37,14,35
"2011","Leeds 071A","E01011284","Total",95,26,15,54,8,1,4,3,87,25,11,51
"2011","Leeds 071B","E01011292","Total",82,24,15,43,5,0,3,2,77,24,12,41
"2011","Leeds 071C","E01011293","Total",74,22,15,37,7,2,0,5,67,20,15,32
"2011","Leeds 071D","E01011294","Total",63,18,8,37,3,0,0,3,60,18,8,34
"2011","Leeds 071E","E01011363","Total",115,43,14,58,14,3,2,9,101,40,12,49
"2011","Leeds 072A","E01011616","Total",92,33,20,39,8,0,6,2,84,33,14,37
"2011","Leeds 072B","E01011620","Total",102,29,22,51,8,1,3,4,94,28,19,47
"2011","Leeds 072C","E01011622","Total",158,46,23,89,19,3,3,13,139,43,20,76
"2011","Leeds 072D","E01011624","Total",125,34,21,70,6,0,2,4,119,34,19,66
"2011","Leeds 073A","E01011411","Total",37,14,14,9,1,0,0,1,36,14,14,8
"2011","Leeds 073B","E01011414","Total",20,6,10,4,3,0,3,0,17,6,7,4
"2011","Leeds 073C","E01011418","Total",36,14,17,5,1,0,0,1,35,14,17,4
"2011","Leeds 073D","E01011419","Total",13,5,5,3,1,0,0,1,12,5,5,2
"2011","Leeds 074A","E01011396","Total",56,21,18,17,4,2,0,2,52,19,18,15
"2011","Leeds 074B","E01011399","Total",53,19,16,18,5,1,3,1,48,18,13,17
"2011","Leeds 074C","E01011400","Total",36,16,15,5,2,0,2,0,34,16,13,5
"2011","Leeds 074D","E01011403","Total",17,10,3,4,1,0,1,0,16,10,2,4
"2011","Leeds 075B","E01011623","Total",123,37,16,70,14,4,1,9,109,33,15,61
"2011","Leeds 075C","E01011625","Total",93,15,22,56,14,0,6,8,79,15,16,48
"2011","Leeds 075D","E01011626","Total",90,22,11,57,9,1,1,7,81,21,10,50
"2011","Leeds 075E","E01033021","Total",58,30,7,21,2,1,0,1,56,29,7,20
"2011","Leeds 075F","E01033033","Total",18,6,3,9,3,0,1,2,15,6,2,7
"2011","Leeds 075G","E01033034","Total",2,0,2,0,1,0,1,0,1,0,1,0
"2011","Leeds 076A","E01011602","Total",26,12,10,4,3,1,2,0,23,11,8,4
"2011","Leeds 076B","E01011603","Total",25,13,7,5,2,0,1,1,23,13,6,4
"2011","Leeds 076C","E01011605","Total",25,11,11,3,1,0,1,0,24,11,10,3
"2011","Leeds 076D","E01011606","Total",49,24,14,11,4,1,3,0,45,23,11,11
"2011","Leeds 076E","E01011613","Total",67,30,13,24,5,0,3,2,62,30,10,22
"2011","Leeds 077A","E01011397","Total",47,25,17,5,2,0,2,0,45,25,15,5
"2011","Leeds 077B","E01011398","Total",30,15,11,4,5,2,3,0,25,13,8,4
"2011","Leeds 077C","E01011401","Total",26,7,16,3,5,0,4,1,21,7,12,2
"2011","Leeds 077D","E01011404","Total",30,13,13,4,3,2,1,0,27,11,12,4
"2011","Leeds 077E","E01011405","Total",20,8,7,5,2,0,2,0,18,8,5,5
"2011","Leeds 078A","E01011725","Total",110,30,16,64,13,2,4,7,97,28,12,57
"2011","Leeds 078B","E01011729","Total",72,26,15,31,2,0,2,0,70,26,13,31
"2011","Leeds 078C","E01011730","Total",103,34,24,45,10,2,3,5,93,32,21,40
"2011","Leeds 078D","E01011735","Total",92,29,17,46,5,1,2,2,87,28,15,44
"2011","Leeds 079A","E01011600","Total",28,10,14,4,2,1,0,1,26,9,14,3
"2011","Leeds 079B","E01011601","Total",52,17,13,22,5,1,2,2,47,16,11,20
"2011","Leeds 079C","E01011604","Total",28,10,12,6,4,1,2,1,24,9,10,5
"2011","Leeds 079D","E01011607","Total",59,26,22,11,7,0,6,1,52,26,16,10
"2011","Leeds 079E","E01011612","Total",23,8,5,10,4,0,4,0,19,8,1,10
"2011","Leeds 080A","E01011726","Total",77,31,13,33,6,0,3,3,71,31,10,30
"2011","Leeds 080B","E01011727","Total",45,17,10,18,8,1,4,3,37,16,6,15
"2011","Leeds 080C","E01011728","Total",40,20,11,9,4,1,3,0,36,19,8,9
"2011","Leeds 080D","E01011739","Total",78,33,14,31,8,1,4,3,70,32,10,28
"2011","Leeds 081A","E01011362","Total",78,29,24,25,8,1,4,3,70,28,20,22
"2011","Leeds 081B","E01011731","Total",29,12,11,6,1,0,0,1,28,12,11,5
"2011","Leeds 081C","E01011732","Total",40,17,13,10,6,1,4,1,34,16,9,9
"2011","Leeds 081D","E01011733","Total",39,20,12,7,2,2,0,0,37,18,12,7
"2011","Leeds 082A","E01011366","Total",91,29,19,43,9,2,4,3,82,27,15,40
"2011","Leeds 082C","E01011368","Total",61,11,6,44,5,1,1,3,56,10,5,41
"2011","Leeds 082D","E01011370","Total",41,10,9,22,6,1,3,2,35,9,6,20
"2011","Leeds 082E","E01033013","Total",36,10,9,17,4,1,2,1,32,9,7,16
"2011","Leeds 082F","E01033032","Total",19,4,5,10,4,1,2,1,15,3,3,9
"2011","Leeds 083A","E01011734","Total",68,16,26,26,5,0,2,3,63,16,24,23
"2011","Leeds 083B","E01011736","Total",40,17,11,12,1,0,1,0,39,17,10,12
"2011","Leeds 083C","E01011737","Total",101,21,21,59,10,1,4,5,91,20,17,54
"2011","Leeds 083D","E01011738","Total",33,17,10,6,2,1,1,0,31,16,9,6
"2011","Leeds 085A","E01011364","Total",84,28,18,38,10,2,5,3,74,26,13,35
"2011","Leeds 085B","E01011371","Total",58,15,10,33,3,0,2,1,55,15,8,32
"2011","Leeds 085C","E01011373","Total",83,23,14,46,12,2,4,6,71,21,10,40
"2011","Leeds 085D","E01011374","Total",62,20,7,35,6,2,2,2,56,18,5,33
"2011","Leeds 086A","E01011312","Total",78,14,10,54,8,0,4,4,70,14,6,50
"2011","Leeds 086B","E01011316","Total",83,27,11,45,13,3,5,5,70,24,6,40
"2011","Leeds 086C","E01011372","Total",55,6,5,44,6,0,2,4,49,6,3,40
"2011","Leeds 086D","E01011375","Total",73,15,8,50,11,1,1,9,62,14,7,41
"2011","Leeds 087A","E01011390","Total",58,15,18,25,14,0,9,5,44,15,9,20
"2011","Leeds 087B","E01011391","Total",35,14,12,9,7,1,5,1,28,13,7,8
"2011","Leeds 087C","E01011392","Total",40,15,11,14,2,0,1,1,38,15,10,13
"2011","Leeds 087D","E01011402","Total",25,13,4,8,3,1,1,1,22,12,3,7
"2011","Leeds 088A","E01011298","Total",64,24,14,26,4,0,1,3,60,24,13,23
"2011","Leeds 088B","E01011299","Total",65,24,28,13,11,0,9,2,54,24,19,11
"2011","Leeds 088C","E01011302","Total",15,6,5,4,4,1,2,1,11,5,3,3
"2011","Leeds 088D","E01011303","Total",35,15,8,12,2,0,1,1,33,15,7,11
"2011","Leeds 089A","E01011300","Total",68,30,16,22,5,0,2,3,63,30,14,19
"2011","Leeds 089B","E01011301","Total",29,8,11,10,4,1,2,1,25,7,9,9
"2011","Leeds 089C","E01011304","Total",51,15,20,16,6,1,4,1,45,14,16,15
"2011","Leeds 089D","E01011305","Total",36,14,15,7,2,0,1,1,34,14,14,6
"2011","Leeds 089E","E01011306","Total",27,16,8,3,2,0,2,0,25,16,6,3
"2011","Leeds 090A","E01011315","Total",42,7,12,23,5,2,2,1,37,5,10,22
"2011","Leeds 090B","E01011317","Total",95,26,19,50,6,1,1,4,89,25,18,46
"2011","Leeds 090C","E01011318","Total",109,27,22,60,10,0,4,6,99,27,18,54
"2011","Leeds 090D","E01011321","Total",99,24,17,58,6,2,1,3,93,22,16,55
"2011","Leeds 090E","E01011369","Total",67,28,15,24,4,0,3,1,63,28,12,23
"2011","Leeds 091A","E01011313","Total",69,23,12,34,9,0,4,5,60,23,8,29
"2011","Leeds 091B","E01011314","Total",55,15,14,26,7,0,3,4,48,15,11,22
"2011","Leeds 091C","E01011319","Total",41,9,12,20,5,0,2,3,36,9,10,17
"2011","Leeds 091D","E01011320","Total",56,21,10,25,4,0,2,2,52,21,8,23
"2011","Leeds 091E","E01011322","Total",65,16,22,27,3,0,3,0,62,16,19,27
"2011","Leeds 092A","E01011471","Total",100,30,12,58,7,2,2,3,93,28,10,55
"2011","Leeds 092B","E01011472","Total",97,29,15,53,2,0,2,0,95,29,13,53
"2011","Leeds 092C","E01011473","Total",122,32,17,73,14,1,2,11,108,31,15,62
"2011","Leeds 092D","E01011474","Total",94,22,22,50,6,2,1,3,88,20,21,47
"2011","Leeds 093A","E01011518","Total",81,40,23,18,9,1,7,1,72,39,16,17
"2011","Leeds 093B","E01011524","Total",33,17,9,7,2,1,1,0,31,16,8,7
"2011","Leeds 093C","E01011526","Total",23,10,10,3,1,0,1,0,22,10,9,3
"2011","Leeds 093D","E01011531","Total",21,9,8,4,1,0,1,0,20,9,7,4
"2011","Leeds 094A","E01011466","Total",69,18,15,36,7,1,2,4,62,17,13,32
"2011","Leeds 094B","E01011469","Total",35,10,9,16,3,0,1,2,32,10,8,14
"2011","Leeds 094C","E01011475","Total",109,33,13,63,8,0,3,5,101,33,10,58
"2011","Leeds 094D","E01011476","Total",89,34,18,37,8,2,2,4,81,32,16,33
"2011","Leeds 095A","E01011519","Total",57,12,20,25,2,0,1,1,55,12,19,24
"2011","Leeds 095B","E01011522","Total",28,12,14,2,3,0,2,1,25,12,12,1
"2011","Leeds 095C","E01011525","Total",46,19,16,11,6,0,4,2,40,19,12,9
"2011","Leeds 095D","E01011528","Total",35,14,16,5,4,0,4,0,31,14,12,5
"2011","Leeds 095E","E01011532","Total",71,24,25,22,8,1,3,4,63,23,22,18
"2011","Leeds 096A","E01011520","Total",30,16,10,4,5,1,3,1,25,15,7,3
"2011","Leeds 096B","E01011521","Total",50,21,14,15,4,0,3,1,46,21,11,14
"2011","Leeds 096C","E01011523","Total",42,16,12,14,7,3,3,1,35,13,9,13
"2011","Leeds 096D","E01011527","Total",44,13,21,10,7,0,6,1,37,13,15,9
"2011","Leeds 096E","E01011529","Total",67,18,21,28,3,0,3,0,64,18,18,28
"2011","Leeds 097B","E01011635","Total",39,9,20,10,3,0,3,0,36,9,17,10
"2011","Leeds 097C","E01011637","Total",54,24,19,11,5,0,4,1,49,24,15,10
"2011","Leeds 097D","E01011638","Total",29,14,9,6,1,0,1,0,28,14,8,6
"2011","Leeds 097F","E01032487","Total",50,16,13,21,8,0,5,3,42,16,8,18
"2011","Leeds 097G","E01032488","Total",32,12,10,10,2,1,0,1,30,11,10,9
"2011","Leeds 098A","E01011627","Total",60,23,18,19,4,0,3,1,56,23,15,18
"2011","Leeds 098B","E01011628","Total",32,6,22,4,4,0,3,1,28,6,19,3
"2011","Leeds 098C","E01011629","Total",57,19,22,16,4,0,3,1,53,19,19,15
"2011","Leeds 098D","E01011632","Total",72,28,15,29,4,2,0,2,68,26,15,27
"2011","Leeds 098E","E01011633","Total",28,13,9,6,2,0,1,1,26,13,8,5
"2011","Leeds 099A","E01011490","Total",77,29,21,27,5,1,3,1,72,28,18,26
"2011","Leeds 099C","E01011502","Total",69,16,22,31,1,0,1,0,68,16,21,31
"2011","Leeds 099E","E01032497","Total",112,36,13,63,8,0,3,5,104,36,10,58
"2011","Leeds 099F","E01032498","Total",42,18,9,15,3,0,3,0,39,18,6,15
"2011","Leeds 100A","E01011496","Total",43,20,17,6,6,0,6,0,37,20,11,6
"2011","Leeds 100B","E01011630","Total",64,24,29,11,10,0,10,0,54,24,19,11
"2011","Leeds 100C","E01011634","Total",43,11,11,21,3,0,2,1,40,11,9,20
"2011","Leeds 100D","E01011636","Total",34,16,11,7,6,0,4,2,28,16,7,5
"2011","Leeds 100E","E01011639","Total",69,27,17,25,9,0,4,5,60,27,13,20
"2011","Leeds 101A","E01011491","Total",93,30,19,44,6,0,2,4,87,30,17,40
"2011","Leeds 101B","E01011492","Total",98,24,11,63,9,0,2,7,89,24,9,56
"2011","Leeds 101C","E01011493","Total",100,39,20,41,4,0,3,1,96,39,17,40
"2011","Leeds 101D","E01011494","Total",87,30,18,39,4,1,2,1,83,29,16,38
"2011","Leeds 101E","E01011497","Total",104,21,21,62,9,0,5,4,95,21,16,58
"2011","Leeds 102B","E01011540","Total",71,28,17,26,7,1,4,2,64,27,13,24
"2011","Leeds 102F","E01032489","Total",58,23,15,20,5,1,3,1,53,22,12,19
"2011","Leeds 102G","E01032490","Total",35,23,6,6,0,0,0,0,35,23,6,6
"2011","Leeds 102H","E01032491","Total",36,15,16,5,0,0,0,0,36,15,16,5
"2011","Leeds 102I","E01032492","Total",107,39,23,45,6,1,3,2,101,38,20,43
"2011","Leeds 103A","E01011307","Total",55,14,16,25,2,0,0,2,53,14,16,23
"2011","Leeds 103B","E01011308","Total",48,24,12,12,5,0,4,1,43,24,8,11
"2011","Leeds 103C","E01011393","Total",33,6,17,10,5,0,5,0,28,6,12,10
"2011","Leeds 103D","E01011394","Total",24,10,10,4,3,1,2,0,21,9,8,4
"2011","Leeds 103E","E01011395","Total",41,19,5,17,6,2,2,2,35,17,3,15
"2011","Leeds 104A","E01011533","Total",44,16,10,18,9,0,5,4,35,16,5,14
"2011","Leeds 104B","E01011541","Total",41,14,14,13,5,0,4,1,36,14,10,12
"2011","Leeds 104C","E01011545","Total",48,16,12,20,2,1,1,0,46,15,11,20
"2011","Leeds 104D","E01011547","Total",67,26,18,23,5,0,1,4,62,26,17,19
"2011","Leeds 105C","E01011499","Total",90,35,26,29,7,0,6,1,83,35,20,28
"2011","Leeds 105D","E01011500","Total",46,22,14,10,4,0,3,1,42,22,11,9
"2011","Leeds 105E","E01032495","Total",102,33,28,41,7,2,4,1,95,31,24,40
"2011","Leeds 105F","E01032496","Total",64,29,26,9,7,0,7,0,57,29,19,9
"2011","Leeds 106A","E01011530","Total",23,11,7,5,3,0,1,2,20,11,6,3
"2011","Leeds 106B","E01011534","Total",47,21,13,13,5,0,3,2,42,21,10,11
"2011","Leeds 106C","E01011546","Total",66,25,23,18,5,1,1,3,61,24,22,15
"2011","Leeds 106D","E01011548","Total",33,16,8,9,5,2,2,1,28,14,6,8
"2011","Leeds 106E","E01011550","Total",41,13,23,5,8,0,7,1,33,13,16,4
"2011","Leeds 107A","E01011537","Total",47,11,22,14,5,0,4,1,42,11,18,13
"2011","Leeds 107B","E01011538","Total",54,25,15,14,4,1,2,1,50,24,13,13
"2011","Leeds 107C","E01011551","Total",54,22,16,16,3,0,3,0,51,22,13,16
"2011","Leeds 107D","E01011552","Total",62,25,17,20,3,2,0,1,59,23,17,19
"2011","Leeds 108A","E01011535","Total",34,14,14,6,2,1,1,0,32,13,13,6
"2011","Leeds 108B","E01011536","Total",42,17,13,12,5,0,5,0,37,17,8,12
"2011","Leeds 108C","E01011549","Total",22,6,11,5,1,0,1,0,21,6,10,5
"2011","Leeds 108D","E01011553","Total",44,17,17,10,3,0,3,0,41,17,14,10
"2011","Leeds 109A","E01011685","Total",14,5,6,3,1,0,1,0,13,5,5,3
"2011","Leeds 109B","E01011687","Total",24,11,9,4,3,1,1,1,21,10,8,3
"2011","Leeds 109C","E01011690","Total",15,7,6,2,3,2,1,0,12,5,5,2
"2011","Leeds 109D","E01011692","Total",23,6,12,5,4,1,3,0,19,5,9,5
"2011","Leeds 109E","E01011693","Total",26,6,11,9,1,0,1,0,25,6,10,9
"2011","Leeds 109F","E01011694","Total",15,4,7,4,2,0,2,0,13,4,5,4
"2011","Leeds 109G","E01032876","Total",13,5,5,3,2,0,1,1,11,5,4,2
"2011","Leeds 110A","E01011442","Total",8,3,3,2,1,0,1,0,7,3,2,2
"2011","Leeds 110B","E01011443","Total",8,4,1,3,0,0,0,0,8,4,1,3
"2011","Leeds 110C","E01011444","Total",9,0,2,7,3,0,1,2,6,0,1,5
"2011","Leeds 110D","E01011451","Total",12,3,7,2,1,0,1,0,11,3,6,2
"2011","Leeds 110E","E01011668","Total",30,13,2,15,3,1,1,1,27,12,1,14
"2011","Leeds 110F","E01011669","Total",25,8,5,12,2,0,1,1,23,8,4,11
"2011","Leeds 110G","E01032946","Total",14,6,6,2,3,0,3,0,11,6,3,2
"2011","Leeds 111A","E01033008","Total",3,2,1,0,1,1,0,0,2,1,1,0
"2011","Leeds 111B","E01033010","Total",0,0,0,0,0,0,0,0,0,0,0,0
"2011","Leeds 111C","E01033011","Total",7,2,5,0,1,0,1,0,6,2,4,0
"2011","Leeds 111D","E01033015","Total",4,2,2,0,1,0,1,0,3,2,1,0
"2011","Leeds 111E","E01033016","Total",1,0,1,0,0,0,0,0,1,0,1,0
"2011","Leeds 112A","E01011467","Total",73,24,12,37,6,2,0,4,67,22,12,33
"2011","Leeds 112B","E01011468","Total",90,33,16,41,5,1,1,3,85,32,15,38
"2011","Leeds 112C","E01011470","Total",53,17,10,26,5,2,1,2,48,15,9,24
"2011","Leeds 112D","E01033018","Total",6,2,2,2,2,0,1,1,4,2,1,1
"2011","Leeds 112E","E01033019","Total",8,3,1,4,0,0,0,0,8,3,1,4
"2011","Wakefield 001A","E01011740","Total",99,34,19,46,5,0,4,1,94,34,15,45
"2011","Wakefield 001B","E01011741","Total",41,15,11,15,6,0,3,3,35,15,8,12
"2011","Wakefield 001C","E01011742","Total",66,19,11,36,9,1,3,5,57,18,8,31
"2011","Wakefield 001D","E01011745","Total",116,25,9,82,6,1,0,5,110,24,9,77
"2011","Wakefield 001E","E01011746","Total",85,17,11,57,5,2,3,0,80,15,8,57
"2011","Wakefield 002A","E01011752","Total",62,33,14,15,4,0,4,0,58,33,10,15
"2011","Wakefield 002B","E01011753","Total",34,17,11,6,4,0,4,0,30,17,7,6
"2011","Wakefield 002C","E01011756","Total",51,16,16,19,4,2,2,0,47,14,14,19
"2011","Wakefield 002D","E01011760","Total",62,29,17,16,6,2,2,2,56,27,15,14
"2011","Wakefield 002E","E01011762","Total",58,21,21,16,5,1,3,1,53,20,18,15
"2011","Wakefield 003A","E01011743","Total",13,4,7,2,3,0,1,2,10,4,6,0
"2011","Wakefield 003B","E01011744","Total",34,18,11,5,2,0,2,0,32,18,9,5
"2011","Wakefield 003C","E01011747","Total",82,23,22,37,9,1,5,3,73,22,17,34
"2011","Wakefield 003D","E01011750","Total",73,22,10,41,11,1,1,9,62,21,9,32
"2011","Wakefield 003E","E01011754","Total",48,15,8,25,5,0,2,3,43,15,6,22
"2011","Wakefield 004A","E01011757","Total",70,28,16,26,7,1,4,2,63,27,12,24
"2011","Wakefield 004B","E01011759","Total",82,32,17,33,5,0,2,3,77,32,15,30
"2011","Wakefield 004C","E01011761","Total",33,14,11,8,4,2,1,1,29,12,10,7
"2011","Wakefield 004D","E01011763","Total",48,13,11,24,7,2,3,2,41,11,8,22
"2011","Wakefield 004E","E01011764","Total",54,16,10,28,8,0,2,6,46,16,8,22
"2011","Wakefield 005A","E01011748","Total",44,21,14,9,5,1,3,1,39,20,11,8
"2011","Wakefield 005B","E01011749","Total",82,23,17,42,9,3,5,1,73,20,12,41
"2011","Wakefield 005C","E01011751","Total",26,8,13,5,6,3,2,1,20,5,11,4
"2011","Wakefield 005D","E01011755","Total",27,8,15,4,5,2,3,0,22,6,12,4
"2011","Wakefield 006A","E01011873","Total",31,14,10,7,4,0,2,2,27,14,8,5
"2011","Wakefield 006B","E01011877","Total",36,12,20,4,4,0,3,1,32,12,17,3
"2011","Wakefield 006C","E01011894","Total",32,14,12,6,2,0,2,0,30,14,10,6
"2011","Wakefield 006D","E01011895","Total",38,10,13,15,5,0,3,2,33,10,10,13
"2011","Wakefield 007A","E01011875","Total",49,15,15,19,6,0,4,2,43,15,11,17
"2011","Wakefield 007B","E01011876","Total",50,18,15,17,5,1,3,1,45,17,12,16
"2011","Wakefield 007C","E01011878","Total",40,10,14,16,7,0,6,1,33,10,8,15
"2011","Wakefield 007D","E01011880","Total",31,12,11,8,5,1,3,1,26,11,8,7
"2011","Wakefield 008A","E01011881","Total",51,22,14,15,6,0,6,0,45,22,8,15
"2011","Wakefield 008B","E01011887","Total",27,11,12,4,5,3,2,0,22,8,10,4
"2011","Wakefield 008C","E01011893","Total",24,8,13,3,1,0,1,0,23,8,12,3
"2011","Wakefield 008D","E01011896","Total",47,22,12,13,4,0,4,0,43,22,8,13
"2011","Wakefield 008E","E01011897","Total",58,12,18,28,6,0,4,2,52,12,14,26
"2011","Wakefield 009A","E01011874","Total",16,6,7,3,3,0,2,1,13,6,5,2
"2011","Wakefield 009B","E01011879","Total",41,19,15,7,7,0,7,0,34,19,8,7
"2011","Wakefield 009C","E01011882","Total",18,9,4,5,2,0,1,1,16,9,3,4
"2011","Wakefield 009D","E01011883","Total",29,12,14,3,3,1,1,1,26,11,13,2
"2011","Wakefield 010A","E01011805","Total",44,19,5,20,1,0,1,0,43,19,4,20
"2011","Wakefield 010B","E01011807","Total",43,20,7,16,2,0,2,0,41,20,5,16
"2011","Wakefield 010C","E01011808","Total",53,17,12,24,8,1,2,5,45,16,10,19
"2011","Wakefield 010D","E01011810","Total",46,25,7,14,5,1,2,2,41,24,5,12
"2011","Wakefield 011A","E01011803","Total",69,22,13,34,5,0,4,1,64,22,9,33
"2011","Wakefield 011B","E01011804","Total",62,27,16,19,4,0,3,1,58,27,13,18
"2011","Wakefield 011C","E01011806","Total",48,15,11,22,4,0,2,2,44,15,9,20
"2011","Wakefield 011D","E01011809","Total",39,16,13,10,2,1,1,0,37,15,12,10
"2011","Wakefield 011E","E01011811","Total",99,31,12,56,13,2,5,6,86,29,7,50
"2011","Wakefield 012A","E01011835","Total",33,9,12,12,8,3,3,2,25,6,9,10
"2011","Wakefield 012B","E01011836","Total",51,16,14,21,10,1,4,5,41,15,10,16
"2011","Wakefield 012C","E01011839","Total",70,23,21,26,8,1,5,2,62,22,16,24
"2011","Wakefield 012D","E01011843","Total",76,33,10,33,10,2,3,5,66,31,7,28
"2011","Wakefield 012E","E01011844","Total",50,20,23,7,3,0,3,0,47,20,20,7
"2011","Wakefield 013A","E01011758","Total",59,17,20,22,9,0,6,3,50,17,14,19
"2011","Wakefield 013B","E01011812","Total",59,18,31,10,9,0,9,0,50,18,22,10
"2011","Wakefield 013C","E01011820","Total",41,14,18,9,8,3,4,1,33,11,14,8
"2011","Wakefield 013D","E01011821","Total",35,17,11,7,0,0,0,0,35,17,11,7
"2011","Wakefield 014A","E01011885","Total",34,19,10,5,2,0,2,0,32,19,8,5
"2011","Wakefield 014B","E01011886","Total",37,13,13,11,8,1,4,3,29,12,9,8
"2011","Wakefield 014C","E01011888","Total",17,5,10,2,7,0,6,1,10,5,4,1
"2011","Wakefield 014D","E01011890","Total",29,15,9,5,3,0,2,1,26,15,7,4
"2011","Wakefield 014E","E01011891","Total",48,16,22,10,7,1,5,1,41,15,17,9
"2011","Wakefield 015A","E01011834","Total",66,24,15,27,5,0,3,2,61,24,12,25
"2011","Wakefield 015B","E01011837","Total",47,13,12,22,3,0,0,3,44,13,12,19
"2011","Wakefield 015C","E01011838","Total",63,14,20,29,9,1,4,4,54,13,16,25
"2011","Wakefield 015D","E01011841","Total",29,16,7,6,0,0,0,0,29,16,7,6
"2011","Wakefield 015E","E01011842","Total",77,32,7,38,4,2,1,1,73,30,6,37
"2011","Wakefield 016A","E01011813","Total",76,34,15,27,6,3,2,1,70,31,13,26
"2011","Wakefield 016B","E01011814","Total",64,26,14,24,5,2,3,0,59,24,11,24
"2011","Wakefield 016C","E01011815","Total",57,9,16,32,6,1,4,1,51,8,12,31
"2011","Wakefield 016D","E01011816","Total",59,22,11,26,2,0,2,0,57,22,9,26
"2011","Wakefield 016E","E01011819","Total",43,16,15,12,6,1,5,0,37,15,10,12
"2011","Wakefield 016F","E01011822","Total",80,28,18,34,5,1,3,1,75,27,15,33
"2011","Wakefield 017A","E01011884","Total",61,27,20,14,9,3,6,0,52,24,14,14
"2011","Wakefield 017B","E01011912","Total",24,6,9,9,7,3,2,2,17,3,7,7
"2011","Wakefield 017C","E01011913","Total",32,11,6,15,5,1,3,1,27,10,3,14
"2011","Wakefield 017D","E01011916","Total",30,7,13,10,6,2,2,2,24,5,11,8
"2011","Wakefield 018A","E01011840","Total",55,25,7,23,4,0,3,1,51,25,4,22
"2011","Wakefield 018B","E01011850","Total",89,28,15,46,10,0,4,6,79,28,11,40
"2011","Wakefield 018C","E01011852","Total",97,36,5,56,10,2,2,6,87,34,3,50
"2011","Wakefield 018D","E01011853","Total",54,21,13,20,5,0,5,0,49,21,8,20
"2011","Wakefield 019A","E01011920","Total",40,15,12,13,6,1,4,1,34,14,8,12
"2011","Wakefield 019B","E01011923","Total",35,15,14,6,8,1,7,0,27,14,7,6
"2011","Wakefield 019C","E01011924","Total",38,15,10,13,7,1,4,2,31,14,6,11
"2011","Wakefield 019D","E01011925","Total",96,24,20,52,17,3,8,6,79,21,12,46
"2011","Wakefield 020A","E01011909","Total",36,15,8,13,8,0,3,5,28,15,5,8
"2011","Wakefield 020B","E01011910","Total",37,9,5,23,6,0,2,4,31,9,3,19
"2011","Wakefield 020C","E01011911","Total",100,24,23,53,7,0,4,3,93,24,19,50
"2011","Wakefield 020D","E01011914","Total",80,32,12,36,10,2,4,4,70,30,8,32
"2011","Wakefield 020E","E01011915","Total",59,21,8,30,6,2,1,3,53,19,7,27
"2011","Wakefield 021A","E01011823","Total",34,13,13,8,4,1,2,1,30,12,11,7
"2011","Wakefield 021B","E01011824","Total",75,29,16,30,8,1,2,5,67,28,14,25
"2011","Wakefield 021C","E01011825","Total",66,24,27,15,8,0,6,2,58,24,21,13
"2011","Wakefield 021D","E01011826","Total",34,9,13,12,5,0,4,1,29,9,9,11
"2011","Wakefield 021E","E01011827","Total",28,9,13,6,8,0,8,0,20,9,5,6
"2011","Wakefield 021F","E01011828","Total",50,15,15,20,5,1,0,4,45,14,15,16
"2011","Wakefield 022A","E01011889","Total",40,17,19,4,8,0,6,2,32,17,13,2
"2011","Wakefield 022B","E01011892","Total",65,29,19,17,3,0,1,2,62,29,18,15
"2011","Wakefield 022C","E01011919","Total",69,27,18,24,8,3,5,0,61,24,13,24
"2011","Wakefield 022D","E01011921","Total",42,13,12,17,3,0,1,2,39,13,11,15
"2011","Wakefield 022E","E01011926","Total",68,17,15,36,9,2,5,2,59,15,10,34
"2011","Wakefield 022F","E01011927","Total",59,22,10,27,2,0,1,1,57,22,9,26
"2011","Wakefield 023A","E01011845","Total",12,5,4,3,2,0,2,0,10,5,2,3
"2011","Wakefield 023B","E01011846","Total",37,17,11,9,5,0,3,2,32,17,8,7
"2011","Wakefield 023C","E01011847","Total",25,7,9,9,3,0,3,0,22,7,6,9
"2011","Wakefield 023D","E01011848","Total",29,16,4,9,3,0,0,3,26,16,4,6
"2011","Wakefield 023E","E01011851","Total",40,15,9,16,6,2,2,2,34,13,7,14
"2011","Wakefield 024A","E01011775","Total",60,21,21,18,1,0,1,0,59,21,20,18
"2011","Wakefield 024B","E01011776","Total",67,25,15,27,9,2,7,0,58,23,8,27
"2011","Wakefield 024C","E01011777","Total",41,19,12,10,7,3,4,0,34,16,8,10
"2011","Wakefield 024D","E01011778","Total",61,17,20,24,3,1,2,0,58,16,18,24
"2011","Wakefield 024E","E01011817","Total",64,25,14,25,3,2,0,1,61,23,14,24
"2011","Wakefield 024F","E01011818","Total",43,16,10,17,1,1,0,0,42,15,10,17
"2011","Wakefield 025A","E01011829","Total",40,15,17,8,5,0,5,0,35,15,12,8
"2011","Wakefield 025B","E01011830","Total",18,7,8,3,2,0,2,0,16,7,6,3
"2011","Wakefield 025C","E01011831","Total",67,25,20,22,13,1,8,4,54,24,12,18
"2011","Wakefield 025D","E01011832","Total",44,18,10,16,3,0,2,1,41,18,8,15
"2011","Wakefield 025E","E01011833","Total",31,14,11,6,1,0,1,0,30,14,10,6
"2011","Wakefield 026A","E01011899","Total",97,27,14,56,6,2,0,4,91,25,14,52
"2011","Wakefield 026B","E01011900","Total",51,20,6,25,2,0,1,1,49,20,5,24
"2011","Wakefield 026C","E01011901","Total",122,31,14,77,17,0,3,14,105,31,11,63
"2011","Wakefield 026D","E01011904","Total",89,24,10,55,9,0,2,7,80,24,8,48
"2011","Wakefield 026E","E01011918","Total",84,27,13,44,11,4,2,5,73,23,11,39
"2011","Wakefield 026F","E01011922","Total",57,20,11,26,7,0,3,4,50,20,8,22
"2011","Wakefield 027A","E01011779","Total",62,25,12,25,2,1,1,0,60,24,11,25
"2011","Wakefield 027B","E01011780","Total",103,35,16,52,11,1,3,7,92,34,13,45
"2011","Wakefield 027C","E01011781","Total",82,31,17,34,7,0,5,2,75,31,12,32
"2011","Wakefield 027D","E01011782","Total",35,16,6,13,3,0,1,2,32,16,5,11
"2011","Wakefield 027E","E01011783","Total",42,8,7,27,3,0,1,2,39,8,6,25
"2011","Wakefield 028A","E01011902","Total",35,8,12,15,3,0,3,0,32,8,9,15
"2011","Wakefield 028B","E01011903","Total",28,11,11,6,0,0,0,0,28,11,11,6
"2011","Wakefield 028C","E01011905","Total",21,5,13,3,1,0,0,1,20,5,13,2
"2011","Wakefield 028D","E01011907","Total",40,13,13,14,6,0,5,1,34,13,8,13
"2011","Wakefield 029A","E01011793","Total",35,15,13,7,4,1,3,0,31,14,10,7
"2011","Wakefield 029B","E01011794","Total",46,15,14,17,10,0,5,5,36,15,9,12
"2011","Wakefield 029C","E01011795","Total",41,19,11,11,2,0,1,1,39,19,10,10
"2011","Wakefield 029D","E01011796","Total",37,18,9,10,1,1,0,0,36,17,9,10
"2011","Wakefield 029E","E01011799","Total",65,25,19,21,5,0,2,3,60,25,17,18
"2011","Wakefield 029F","E01011800","Total",47,18,20,9,10,2,4,4,37,16,16,5
"2011","Wakefield 030A","E01011898","Total",52,12,15,25,5,0,3,2,47,12,12,23
"2011","Wakefield 030B","E01011906","Total",119,27,33,59,27,1,14,12,92,26,19,47
"2011","Wakefield 030C","E01011908","Total",66,19,20,27,7,3,3,1,59,16,17,26
"2011","Wakefield 030D","E01011917","Total",55,13,6,36,3,0,0,3,52,13,6,33
"2011","Wakefield 030E","E01011944","Total",54,11,12,31,2,1,0,1,52,10,12,30
"2011","Wakefield 031A","E01011797","Total",42,16,22,4,6,1,3,2,36,15,19,2
"2011","Wakefield 031B","E01011798","Total",38,13,18,7,9,0,9,0,29,13,9,7
"2011","Wakefield 031C","E01011801","Total",73,23,27,23,10,0,6,4,63,23,21,19
"2011","Wakefield 031D","E01011802","Total",45,21,18,6,5,1,4,0,40,20,14,6
"2011","Wakefield 032A","E01011765","Total",44,18,14,12,2,0,1,1,42,18,13,11
"2011","Wakefield 032B","E01011766","Total",61,18,24,19,13,3,6,4,48,15,18,15
"2011","Wakefield 032C","E01011773","Total",19,8,7,4,5,3,2,0,14,5,5,4
"2011","Wakefield 032D","E01011774","Total",32,10,11,11,4,1,3,0,28,9,8,11
"2011","Wakefield 033A","E01011939","Total",19,6,9,4,0,0,0,0,19,6,9,4
"2011","Wakefield 033B","E01011945","Total",24,7,7,10,4,1,3,0,20,6,4,10
"2011","Wakefield 033C","E01011947","Total",16,3,10,3,6,0,5,1,10,3,5,2
"2011","Wakefield 033D","E01011948","Total",15,5,9,1,4,0,4,0,11,5,5,1
"2011","Wakefield 034A","E01011767","Total",22,7,9,6,4,1,3,0,18,6,6,6
"2011","Wakefield 034B","E01011768","Total",35,12,12,11,3,1,1,1,32,11,11,10
"2011","Wakefield 034C","E01011769","Total",50,15,20,15,6,0,6,0,44,15,14,15
"2011","Wakefield 034D","E01011770","Total",59,22,23,14,9,0,9,0,50,22,14,14
"2011","Wakefield 034E","E01011849","Total",15,3,8,4,2,0,2,0,13,3,6,4
"2011","Wakefield 034F","E01011857","Total",25,6,10,9,3,0,1,2,22,6,9,7
"2011","Wakefield 035A","E01011928","Total",38,14,11,13,2,0,2,0,36,14,9,13
"2011","Wakefield 035B","E01011931","Total",36,13,11,12,5,0,5,0,31,13,6,12
"2011","Wakefield 035C","E01011932","Total",35,9,15,11,7,0,7,0,28,9,8,11
"2011","Wakefield 035D","E01011938","Total",21,6,10,5,3,1,2,0,18,5,8,5
"2011","Wakefield 036A","E01011929","Total",24,8,10,6,0,0,0,0,24,8,10,6
"2011","Wakefield 036B","E01011930","Total",31,16,5,10,0,0,0,0,31,16,5,10
"2011","Wakefield 036C","E01011933","Total",48,21,10,17,5,2,2,1,43,19,8,16
"2011","Wakefield 036D","E01011937","Total",18,11,2,5,2,0,1,1,16,11,1,4
"2011","Wakefield 037A","E01011934","Total",21,6,10,5,3,0,3,0,18,6,7,5
"2011","Wakefield 037B","E01011936","Total",51,22,13,16,7,2,2,3,44,20,11,13
"2011","Wakefield 037C","E01011940","Total",76,23,21,32,10,0,6,4,66,23,15,28
"2011","Wakefield 037D","E01011943","Total",98,42,19,37,10,4,3,3,88,38,16,34
"2011","Wakefield 038A","E01011935","Total",29,12,10,7,7,1,6,0,22,11,4,7
"2011","Wakefield 038B","E01011941","Total",31,14,6,11,5,0,4,1,26,14,2,10
"2011","Wakefield 038C","E01011942","Total",21,7,6,8,5,3,0,2,16,4,6,6
"2011","Wakefield 038D","E01011946","Total",35,16,11,8,5,1,3,1,30,15,8,7
"2011","Wakefield 039A","E01011785","Total",65,21,9,35,5,0,2,3,60,21,7,32
"2011","Wakefield 039B","E01011789","Total",48,13,9,26,8,1,1,6,40,12,8,20
"2011","Wakefield 039C","E01011791","Total",65,19,12,34,6,1,4,1,59,18,8,33
"2011","Wakefield 039D","E01011792","Total",81,12,3,66,4,0,1,3,77,12,2,63
"2011","Wakefield 040A","E01011771","Total",50,16,14,20,2,0,2,0,48,16,12,20
"2011","Wakefield 040B","E01011772","Total",43,8,9,26,4,0,3,1,39,8,6,25
"2011","Wakefield 040C","E01011784","Total",75,22,14,39,7,1,4,2,68,21,10,37
"2011","Wakefield 040D","E01011786","Total",70,18,19,33,4,1,3,0,66,17,16,33
"2011","Wakefield 041A","E01011854","Total",50,14,11,25,4,0,2,2,46,14,9,23
"2011","Wakefield 041B","E01011855","Total",51,20,16,15,8,3,3,2,43,17,13,13
"2011","Wakefield 041C","E01011856","Total",53,18,6,29,12,5,4,3,41,13,2,26
"2011","Wakefield 041D","E01011858","Total",42,17,12,13,5,0,3,2,37,17,9,11
"2011","Wakefield 042A","E01011787","Total",48,18,14,16,5,0,2,3,43,18,12,13
"2011","Wakefield 042B","E01011788","Total",29,21,4,4,3,3,0,0,26,18,4,4
"2011","Wakefield 042C","E01011790","Total",61,24,16,21,8,1,1,6,53,23,15,15
"2011","Wakefield 042D","E01011865","Total",69,28,16,25,6,0,3,3,63,28,13,22
"2011","Wakefield 042E","E01011867","Total",62,25,13,24,4,0,3,1,58,25,10,23
"2011","Wakefield 043A","E01011859","Total",64,22,15,27,11,2,6,3,53,20,9,24
"2011","Wakefield 043B","E01011869","Total",70,26,16,28,5,0,2,3,65,26,14,25
"2011","Wakefield 043C","E01011870","Total",18,7,7,4,2,0,2,0,16,7,5,4
"2011","Wakefield 043D","E01011871","Total",46,17,12,17,8,0,4,4,38,17,8,13
"2011","Wakefield 044A","E01011860","Total",34,7,13,14,4,1,3,0,30,6,10,14
"2011","Wakefield 044B","E01011861","Total",69,28,18,23,5,1,1,3,64,27,17,20
"2011","Wakefield 044C","E01011862","Total",61,20,15,26,3,1,1,1,58,19,14,25
"2011","Wakefield 044D","E01011863","Total",70,20,10,40,8,0,1,7,62,20,9,33
"2011","Wakefield 045A","E01011864","Total",60,18,6,36,9,0,5,4,51,18,1,32
"2011","Wakefield 045B","E01011866","Total",49,15,8,26,7,1,3,3,42,14,5,23
"2011","Wakefield 045C","E01011868","Total",73,21,20,32,8,2,4,2,65,19,16,30
"2011","Wakefield 045D","E01011872","Total",76,27,15,34,7,1,3,3,69,26,12,31
"2011","Derby 001A","E01013461","Total",20,11,5,4,5,0,4,1,15,11,1,3
"2011","Derby 001B","E01013462","Total",24,8,9,7,5,2,1,2,19,6,8,5
"2011","Derby 001C","E01013463","Total",31,12,14,5,7,1,6,0,24,11,8,5
"2011","Derby 001D","E01013464","Total",24,7,10,7,1,0,1,0,23,7,9,7
"2011","Derby 002A","E01013465","Total",24,8,9,7,3,0,3,0,21,8,6,7
"2011","Derby 002B","E01013466","Total",17,7,9,1,1,0,1,0,16,7,8,1
"2011","Derby 002C","E01013467","Total",27,14,9,4,2,2,0,0,25,12,9,4
"2011","Derby 002D","E01013468","Total",17,4,8,5,2,0,2,0,15,4,6,5
"2011","Derby 002E","E01013469","Total",7,1,4,2,0,0,0,0,7,1,4,2
"2011","Derby 003A","E01013574","Total",20,9,9,2,5,1,4,0,15,8,5,2
"2011","Derby 003B","E01013575","Total",21,10,9,2,3,2,1,0,18,8,8,2
"2011","Derby 003C","E01013576","Total",26,11,10,5,3,0,3,0,23,11,7,5
"2011","Derby 003D","E01013577","Total",27,11,11,5,5,0,5,0,22,11,6,5
"2011","Derby 003E","E01013578","Total",29,11,15,3,2,1,1,0,27,10,14,3
"2011","Derby 003F","E01013579","Total",38,16,15,7,1,0,1,0,37,16,14,7
"2011","Derby 003G","E01013580","Total",44,15,21,8,5,1,4,0,39,14,17,8
"2011","Derby 004A","E01013530","Total",67,25,23,19,7,1,6,0,60,24,17,19
"2011","Derby 004B","E01013531","Total",54,19,13,22,1,0,1,0,53,19,12,22
"2011","Derby 004C","E01013532","Total",71,25,7,39,6,2,2,2,65,23,5,37
"2011","Derby 004D","E01013581","Total",115,51,19,45,13,2,5,6,102,49,14,39
"2011","Derby 005A","E01013526","Total",29,5,20,4,4,0,4,0,25,5,16,4
"2011","Derby 005B","E01013527","Total",21,10,6,5,6,4,1,1,15,6,5,4
"2011","Derby 005C","E01013528","Total",24,10,7,7,2,0,1,1,22,10,6,6
"2011","Derby 005D","E01013529","Total",62,18,26,18,5,0,4,1,57,18,22,17
"2011","Derby 006A","E01013505","Total",35,12,14,9,5,0,4,1,30,12,10,8
"2011","Derby 006B","E01013506","Total",45,13,13,19,9,1,5,3,36,12,8,16
"2011","Derby 006C","E01013513","Total",62,22,15,25,6,1,4,1,56,21,11,24
"2011","Derby 006D","E01013534","Total",47,19,15,13,4,0,3,1,43,19,12,12
"2011","Derby 006E","E01013582","Total",66,31,17,18,3,2,1,0,63,29,16,18
"2011","Derby 007A","E01013533","Total",115,32,9,74,9,1,2,6,106,31,7,68
"2011","Derby 007B","E01013535","Total",140,48,18,74,8,1,2,5,132,47,16,69
"2011","Derby 007C","E01013536","Total",110,36,17,57,11,1,4,6,99,35,13,51
"2011","Derby 007D","E01013537","Total",51,15,9,27,4,2,2,0,47,13,7,27
"2011","Derby 007E","E01013538","Total",67,22,19,26,5,0,4,1,62,22,15,25
"2011","Derby 008A","E01013522","Total",82,34,10,38,3,1,2,0,79,33,8,38
"2011","Derby 008B","E01013523","Total",37,12,10,15,6,1,1,4,31,11,9,11
"2011","Derby 008C","E01013524","Total",26,10,4,12,3,0,1,2,23,10,3,10
"2011","Derby 008D","E01013525","Total",62,22,14,26,7,0,2,5,55,22,12,21
"2011","Derby 009A","E01013548","Total",56,18,15,23,8,1,4,3,48,17,11,20
"2011","Derby 009B","E01013549","Total",62,22,19,21,6,1,4,1,56,21,15,20
"2011","Derby 009C","E01013552","Total",79,27,16,36,4,0,0,4,75,27,16,32
"2011","Derby 009D","E01013553","Total",69,26,11,32,7,2,4,1,62,24,7,31
"2011","Derby 009E","E01013555","Total",51,17,15,19,2,0,2,0,49,17,13,19
"2011","Derby 010A","E01013592","Total",30,9,9,12,3,0,2,1,27,9,7,11
"2011","Derby 010B","E01013594","Total",17,8,4,5,7,3,3,1,10,5,1,4
"2011","Derby 010C","E01013596","Total",30,11,13,6,3,0,3,0,27,11,10,6
"2011","Derby 010D","E01013599","Total",26,10,12,4,5,0,5,0,21,10,7,4
"2011","Derby 011A","E01013547","Total",52,7,21,24,8,1,5,2,44,6,16,22
"2011","Derby 011B","E01013550","Total",56,13,10,33,5,2,2,1,51,11,8,32
"2011","Derby 011C","E01013551","Total",46,13,7,26,3,1,0,2,43,12,7,24
"2011","Derby 011D","E01013554","Total",75,22,16,37,8,0,2,6,67,22,14,31
"2011","Derby 012A","E01013507","Total",37,7,15,15,8,0,6,2,29,7,9,13
"2011","Derby 012B","E01013508","Total",58,20,13,25,5,0,4,1,53,20,9,24
"2011","Derby 012C","E01013509","Total",55,22,15,18,2,1,0,1,53,21,15,17
"2011","Derby 012D","E01013510","Total",76,28,13,35,2,0,1,1,74,28,12,34
"2011","Derby 012E","E01013511","Total",27,9,13,5,1,0,1,0,26,9,12,5
"2011","Derby 012F","E01013512","Total",75,23,14,38,12,1,5,6,63,22,9,32
"2011","Derby 013A","E01013453","Total",82,40,7,35,8,3,2,3,74,37,5,32
"2011","Derby 013B","E01013454","Total",63,12,17,34,3,0,1,2,60,12,16,32
"2011","Derby 013C","E01013456","Total",101,26,18,57,10,4,5,1,91,22,13,56
"2011","Derby 013D","E01013457","Total",74,27,12,35,5,3,1,1,69,24,11,34
"2011","Derby 013E","E01013460","Total",75,20,16,39,7,5,1,1,68,15,15,38
"2011","Derby 013F","E01013479","Total",47,14,17,16,8,3,3,2,39,11,14,14
"2011","Derby 014A","E01013593","Total",24,12,10,2,3,0,3,0,21,12,7,2
"2011","Derby 014B","E01013595","Total",85,31,26,28,6,0,5,1,79,31,21,27
"2011","Derby 014C","E01013597","Total",54,21,15,18,6,3,2,1,48,18,13,17
"2011","Derby 014D","E01013598","Total",63,22,21,20,5,0,2,3,58,22,19,17
"2011","Derby 015A","E01013556","Total",38,17,12,9,2,0,2,0,36,17,10,9
"2011","Derby 015B","E01013557","Total",13,3,9,1,3,1,2,0,10,2,7,1
"2011","Derby 015C","E01013558","Total",63,21,19,23,2,0,2,0,61,21,17,23
"2011","Derby 015D","E01013559","Total",28,12,10,6,5,1,3,1,23,11,7,5
"2011","Derby 015E","E01013564","Total",28,12,13,3,4,0,2,2,24,12,11,1
"2011","Derby 016A","E01013480","Total",48,13,14,21,5,0,2,3,43,13,12,18
"2011","Derby 016B","E01013483","Total",55,16,9,30,5,1,1,3,50,15,8,27
"2011","Derby 016C","E01013485","Total",73,24,12,37,7,3,3,1,66,21,9,36
"2011","Derby 016D","E01013565","Total",56,12,9,35,5,2,0,3,51,10,9,32
"2011","Derby 016E","E01013566","Total",62,19,11,32,19,8,6,5,43,11,5,27
"2011","Derby 017A","E01013455","Total",68,21,19,28,7,0,3,4,61,21,16,24
"2011","Derby 017B","E01013458","Total",17,2,5,10,1,0,0,1,16,2,5,9
"2011","Derby 017C","E01013542","Total",27,8,8,11,4,0,4,0,23,8,4,11
"2011","Derby 017D","E01013546","Total",26,14,9,3,3,1,2,0,23,13,7,3
"2011","Derby 018A","E01013481","Total",67,16,10,41,4,1,0,3,63,15,10,38
"2011","Derby 018C","E01013484","Total",84,16,9,59,8,0,1,7,76,16,8,52
"2011","Derby 018D","E01013486","Total",55,10,8,37,4,0,1,3,51,10,7,34
"2011","Derby 018E","E01013487","Total",90,23,11,56,4,3,1,0,86,20,10,56
"2011","Derby 018F","E01033166","Total",22,5,2,15,8,2,0,6,14,3,2,9
"2011","Derby 018G","E01033167","Total",33,3,6,24,8,0,4,4,25,3,2,20
"2011","Derby 019A","E01013540","Total",37,15,18,4,1,0,1,0,36,15,17,4
"2011","Derby 019B","E01013560","Total",25,8,13,4,2,0,2,0,23,8,11,4
"2011","Derby 019C","E01013561","Total",17,9,8,0,1,0,1,0,16,9,7,0
"2011","Derby 019D","E01013562","Total",22,7,12,3,3,1,1,1,19,6,11,2
"2011","Derby 019E","E01013563","Total",23,7,9,7,2,0,2,0,21,7,7,7
"2011","Derby 020A","E01013459","Total",51,16,12,23,3,1,0,2,48,15,12,21
"2011","Derby 020B","E01013567","Total",72,21,12,39,5,2,1,2,67,19,11,37
"2011","Derby 020C","E01013568","Total",99,29,10,60,16,1,2,13,83,28,8,47
"2011","Derby 020D","E01013569","Total",48,11,11,26,2,0,0,2,46,11,11,24
"2011","Derby 021A","E01013539","Total",36,13,18,5,7,1,5,1,29,12,13,4
"2011","Derby 021B","E01013541","Total",108,27,43,38,6,0,4,2,102,27,39,36
"2011","Derby 021C","E01013543","Total",33,8,19,6,9,2,5,2,24,6,14,4
"2011","Derby 021D","E01013544","Total",26,10,12,4,4,0,3,1,22,10,9,3
"2011","Derby 021E","E01013545","Total",55,12,19,24,10,1,8,1,45,11,11,23
"2011","Derby 022A","E01013488","Total",27,10,12,5,2,0,2,0,25,10,10,5
"2011","Derby 022B","E01013489","Total",24,13,5,6,1,0,1,0,23,13,4,6
"2011","Derby 022C","E01013490","Total",37,15,15,7,6,1,5,0,31,14,10,7
"2011","Derby 022D","E01013491","Total",28,6,12,10,5,0,4,1,23,6,8,9
"2011","Derby 023A","E01013570","Total",82,19,10,53,3,0,1,2,79,19,9,51
"2011","Derby 023B","E01013571","Total",103,33,19,51,6,1,0,5,97,32,19,46
"2011","Derby 023C","E01013572","Total",32,6,12,14,2,0,1,1,30,6,11,13
"2011","Derby 023D","E01013573","Total",134,48,25,61,14,3,4,7,120,45,21,54
"2011","Derby 024A","E01013470","Total",42,13,9,20,2,0,0,2,40,13,9,18
"2011","Derby 024B","E01013474","Total",42,18,8,16,0,0,0,0,42,18,8,16
"2011","Derby 024C","E01013476","Total",32,7,12,13,5,0,5,0,27,7,7,13
"2011","Derby 024E","E01033171","Total",50,11,14,25,7,2,3,2,43,9,11,23
"2011","Derby 024F","E01033172","Total",69,14,17,38,2,1,1,0,67,13,16,38
"2011","Derby 025A","E01013471","Total",96,29,20,47,14,2,11,1,82,27,9,46
"2011","Derby 025B","E01013473","Total",86,28,22,36,9,1,6,2,77,27,16,34
"2011","Derby 025C","E01013475","Total",91,29,11,51,4,1,0,3,87,28,11,48
"2011","Derby 025D","E01013477","Total",62,19,13,30,3,0,2,1,59,19,11,29
"2011","Derby 025E","E01013502","Total",63,24,13,26,2,1,0,1,61,23,13,25
"2011","Derby 025F","E01013503","Total",55,16,11,28,3,1,0,2,52,15,11,26
"2011","Derby 026A","E01013472","Total",136,25,27,84,15,2,10,3,121,23,17,81
"2011","Derby 026B","E01013497","Total",101,34,21,46,6,2,2,2,95,32,19,44
"2011","Derby 026C","E01013504","Total",99,34,16,49,7,0,4,3,92,34,12,46
"2011","Derby 026D","E01013583","Total",87,23,17,47,6,1,1,4,81,22,16,43
"2011","Derby 026E","E01013590","Total",118,32,15,71,12,6,4,2,106,26,11,69
"2011","Derby 026F","E01013591","Total",144,34,21,89,9,3,1,5,135,31,20,84
"2011","Derby 027A","E01013492","Total",22,5,7,10,3,0,3,0,19,5,4,10
"2011","Derby 027B","E01013493","Total",46,17,18,11,7,1,6,0,39,16,12,11
"2011","Derby 027C","E01013494","Total",105,41,26,38,3,2,0,1,102,39,26,37
"2011","Derby 027D","E01013495","Total",54,20,21,13,4,0,3,1,50,20,18,12
"2011","Derby 028A","E01013496","Total",108,36,20,52,14,2,4,8,94,34,16,44
"2011","Derby 028B","E01013498","Total",39,16,14,9,3,1,0,2,36,15,14,7
"2011","Derby 028C","E01013499","Total",35,10,8,17,5,0,3,2,30,10,5,15
"2011","Derby 028D","E01013500","Total",46,11,16,19,5,1,3,1,41,10,13,18
"2011","Derby 028E","E01013501","Total",21,8,6,7,4,1,3,0,17,7,3,7
"2011","Derby 029A","E01013584","Total",131,49,15,67,15,2,6,7,116,47,9,60
"2011","Derby 029B","E01013585","Total",80,33,16,31,4,1,1,2,76,32,15,29
"2011","Derby 029C","E01013586","Total",146,62,27,57,10,1,4,5,136,61,23,52
"2011","Derby 029D","E01013587","Total",52,18,14,20,4,0,2,2,48,18,12,18
"2011","Derby 029E","E01013588","Total",56,19,12,25,5,1,2,2,51,18,10,23
"2011","Derby 029F","E01013589","Total",26,10,9,7,5,1,3,1,21,9,6,6
"2011","Derby 030B","E01013517","Total",29,14,9,6,5,1,4,0,24,13,5,6
"2011","Derby 030C","E01013518","Total",29,11,9,9,3,2,0,1,26,9,9,8
"2011","Derby 030D","E01013521","Total",40,12,10,18,5,0,2,3,35,12,8,15
"2011","Derby 030E","E01033168","Total",35,11,12,12,2,0,2,0,33,11,10,12
"2011","Derby 030F","E01033169","Total",49,20,24,5,6,1,4,1,43,19,20,4
"2011","Derby 030G","E01033170","Total",38,19,16,3,3,1,2,0,35,18,14,3
"2011","Derby 031A","E01013514","Total",49,14,26,9,2,0,2,0,47,14,24,9
"2011","Derby 031B","E01013515","Total",68,30,25,13,3,0,3,0,65,30,22,13
"2011","Derby 031C","E01013519","Total",103,27,36,40,8,0,8,0,95,27,28,40
"2011","Derby 031D","E01013520","Total",27,14,9,4,3,0,2,1,24,14,7,3
"2011","Leicester 001A","E01013615","Total",35,13,17,5,2,0,2,0,33,13,15,5
"2011","Leicester 001B","E01013616","Total",92,30,28,34,11,3,8,0,81,27,20,34
"2011","Leicester 001C","E01013618","Total",64,26,10,28,5,1,1,3,59,25,9,25
"2011","Leicester 001D","E01013619","Total",110,23,22,65,15,1,7,7,95,22,15,58
"2011","Leicester 002A","E01013733","Total",58,25,17,16,9,2,7,0,49,23,10,16
"2011","Leicester 002B","E01013734","Total",12,8,1,3,1,1,0,0,11,7,1,3
"2011","Leicester 002C","E01013735","Total",12,2,3,7,2,0,0,2,10,2,3,5
"2011","Leicester 002D","E01013736","Total",33,18,9,6,2,1,1,0,31,17,8,6
"2011","Leicester 002E","E01013737","Total",22,7,8,7,5,1,3,1,17,6,5,6
"2011","Leicester 003A","E01013600","Total",131,24,21,86,11,1,3,7,120,23,18,79
"2011","Leicester 003B","E01013601","Total",69,25,7,37,4,0,1,3,65,25,6,34
"2011","Leicester 003C","E01013602","Total",108,37,9,62,9,5,1,3,99,32,8,59
"2011","Leicester 003D","E01013603","Total",115,38,12,65,10,0,3,7,105,38,9,58
"2011","Leicester 003E","E01013604","Total",95,30,13,52,8,0,4,4,87,30,9,48
"2011","Leicester 003F","E01013605","Total",77,27,14,36,10,2,3,5,67,25,11,31
"2011","Leicester 004A","E01013617","Total",72,23,20,29,8,2,5,1,64,21,15,28
"2011","Leicester 004B","E01013620","Total",148,35,17,96,10,1,2,7,138,34,15,89
"2011","Leicester 004C","E01013621","Total",124,28,21,75,11,3,2,6,113,25,19,69
"2011","Leicester 004D","E01013622","Total",104,24,18,62,8,1,4,3,96,23,14,59
"2011","Leicester 004E","E01013623","Total",59,17,13,29,6,1,3,2,53,16,10,27
"2011","Leicester 005A","E01013732","Total",57,22,10,25,5,2,1,2,52,20,9,23
"2011","Leicester 005B","E01013739","Total",39,8,12,19,12,1,2,9,27,7,10,10
"2011","Leicester 005C","E01013740","Total",18,7,2,9,0,0,0,0,18,7,2,9
"2011","Leicester 005D","E01013741","Total",25,17,2,6,3,3,0,0,22,14,2,6
"2011","Leicester 006A","E01013625","Total",38,15,9,14,4,2,2,0,34,13,7,14
"2011","Leicester 006B","E01013628","Total",50,17,6,27,4,3,0,1,46,14,6,26
"2011","Leicester 006C","E01013715","Total",16,5,3,8,0,0,0,0,16,5,3,8
"2011","Leicester 006D","E01013716","Total",28,10,1,17,3,2,0,1,25,8,1,16
"2011","Leicester 006E","E01013738","Total",22,8,5,9,2,1,1,0,20,7,4,9
"2011","Leicester 007A","E01013624","Total",45,14,5,26,3,0,1,2,42,14,4,24
"2011","Leicester 007B","E01013626","Total",37,13,3,21,1,1,0,0,36,12,3,21
"2011","Leicester 007C","E01013627","Total",7,4,1,2,0,0,0,0,7,4,1,2
"2011","Leicester 007D","E01013629","Total",39,10,4,25,3,0,0,3,36,10,4,22
"2011","Leicester 007E","E01013630","Total",48,8,15,25,2,0,1,1,46,8,14,24
"2011","Leicester 008A","E01013606","Total",41,15,12,14,4,0,3,1,37,15,9,13
"2011","Leicester 008B","E01013607","Total",50,10,13,27,3,0,3,0,47,10,10,27
"2011","Leicester 008C","E01013680","Total",52,21,15,16,7,3,4,0,45,18,11,16
"2011","Leicester 008D","E01013685","Total",36,10,19,7,1,0,1,0,35,10,18,7
"2011","Leicester 008E","E01013686","Total",33,14,13,6,0,0,0,0,33,14,13,6
"2011","Leicester 009A","E01013696","Total",79,25,10,44,4,0,2,2,75,25,8,42
"2011","Leicester 009B","E01013697","Total",58,16,17,25,5,1,3,1,53,15,14,24
"2011","Leicester 009C","E01013699","Total",27,9,7,11,5,1,1,3,22,8,6,8
"2011","Leicester 009E","E01032862","Total",89,31,24,34,10,4,3,3,79,27,21,31
"2011","Leicester 009F","E01032863","Total",55,17,13,25,7,2,3,2,48,15,10,23
"2011","Leicester 009G","E01032865","Total",48,9,16,23,4,1,2,1,44,8,14,22
"2011","Leicester 010A","E01013713","Total",25,12,2,11,3,3,0,0,22,9,2,11
"2011","Leicester 010B","E01013714","Total",23,7,5,11,3,1,1,1,20,6,4,10
"2011","Leicester 010C","E01013717","Total",57,14,11,32,3,0,2,1,54,14,9,31
"2011","Leicester 010D","E01013718","Total",34,12,3,19,1,0,0,1,33,12,3,18
"2011","Leicester 010E","E01013719","Total",20,9,2,9,1,1,0,0,19,8,2,9
"2011","Leicester 010F","E01013720","Total",43,17,8,18,1,0,0,1,42,17,8,17
"2011","Leicester 011A","E01013651","Total",78,24,15,39,9,3,3,3,69,21,12,36
"2011","Leicester 011B","E01013652","Total",91,23,14,54,9,2,3,4,82,21,11,50
"2011","Leicester 011C","E01013653","Total",94,32,14,48,5,2,0,3,89,30,14,45
"2011","Leicester 011D","E01013655","Total",70,34,5,31,4,1,0,3,66,33,5,28
"2011","Leicester 012A","E01013721","Total",51,14,11,26,3,1,1,1,48,13,10,25
"2011","Leicester 012B","E01013723","Total",82,22,9,51,7,0,2,5,75,22,7,46
"2011","Leicester 012C","E01013725","Total",91,23,15,53,10,0,6,4,81,23,9,49
"2011","Leicester 012D","E01013726","Total",152,40,15,97,16,2,5,9,136,38,10,88
"2011","Leicester 012E","E01013728","Total",92,40,8,44,6,3,0,3,86,37,8,41
"2011","Leicester 013A","E01013694","Total",96,36,21,39,6,0,2,4,90,36,19,35
"2011","Leicester 013B","E01013700","Total",38,11,11,16,4,1,2,1,34,10,9,15
"2011","Leicester 013C","E01013770","Total",30,13,6,11,1,0,0,1,29,13,6,10
"2011","Leicester 013D","E01013771","Total",30,7,11,12,6,0,3,3,24,7,8,9
"2011","Leicester 013E","E01013773","Total",36,13,14,9,2,0,1,1,34,13,13,8
"2011","Leicester 016A","E01013681","Total",95,32,23,40,14,1,9,4,81,31,14,36
"2011","Leicester 016B","E01013682","Total",108,18,29,61,8,0,4,4,100,18,25,57
"2011","Leicester 016C","E01013683","Total",90,23,16,51,4,0,2,2,86,23,14,49
"2011","Leicester 016D","E01013684","Total",90,23,18,49,9,1,2,6,81,22,16,43
"2011","Leicester 017A","E01013654","Total",95,27,14,54,10,2,3,5,85,25,11,49
"2011","Leicester 017B","E01013656","Total",27,10,5,12,3,0,1,2,24,10,4,10
"2011","Leicester 017C","E01013657","Total",39,15,6,18,10,3,3,4,29,12,3,14
"2011","Leicester 017D","E01013658","Total",37,11,7,19,6,3,2,1,31,8,5,18
"2011","Leicester 017E","E01013659","Total",27,8,3,16,0,0,0,0,27,8,3,16
"2011","Leicester 017F","E01013743","Total",23,8,2,13,2,1,1,0,21,7,1,13
"2011","Leicester 017G","E01013745","Total",18,4,3,11,3,0,3,0,15,4,0,11
"2011","Leicester 018A","E01013742","Total",23,6,3,14,3,1,0,2,20,5,3,12
"2011","Leicester 018B","E01013744","Total",23,6,2,15,6,0,1,5,17,6,1,10
"2011","Leicester 018C","E01013746","Total",37,10,5,22,6,3,2,1,31,7,3,21
"2011","Leicester 018D","E01013748","Total",33,6,4,23,0,0,0,0,33,6,4,23
"2011","Leicester 018E","E01013754","Total",89,18,10,61,11,2,4,5,78,16,6,56
"2011","Leicester 018F","E01013755","Total",122,30,9,83,13,2,1,10,109,28,8,73
"2011","Leicester 019A","E01013660","Total",64,16,12,36,7,2,3,2,57,14,9,34
"2011","Leicester 019B","E01013661","Total",92,34,14,44,2,1,0,1,90,33,14,43
"2011","Leicester 019C","E01013664","Total",94,27,18,49,2,0,0,2,92,27,18,47
"2011","Leicester 019D","E01013665","Total",40,12,4,24,5,2,2,1,35,10,2,23
"2011","Leicester 019E","E01013667","Total",50,16,12,22,5,0,4,1,45,16,8,21
"2011","Leicester 019F","E01013668","Total",43,12,19,12,2,1,1,0,41,11,18,12
"2011","Leicester 020A","E01013729","Total",43,13,12,18,6,0,4,2,37,13,8,16
"2011","Leicester 020B","E01013780","Total",28,11,11,6,3,0,2,1,25,11,9,5
"2011","Leicester 020C","E01013783","Total",27,8,13,6,2,0,2,0,25,8,11,6
"2011","Leicester 020D","E01013785","Total",16,5,9,2,3,0,3,0,13,5,6,2
"2011","Leicester 020E","E01013786","Total",41,16,10,15,1,0,1,0,40,16,9,15
"2011","Leicester 021A","E01013662","Total",22,5,7,10,3,1,1,1,19,4,6,9
"2011","Leicester 021B","E01013663","Total",31,17,5,9,3,2,0,1,28,15,5,8
"2011","Leicester 021C","E01013747","Total",38,6,10,22,5,1,1,3,33,5,9,19
"2011","Leicester 021D","E01013749","Total",21,8,5,8,3,0,0,3,18,8,5,5
"2011","Leicester 021E","E01013750","Total",12,3,1,8,0,0,0,0,12,3,1,8
"2011","Leicester 021F","E01013758","Total",20,4,6,10,3,1,2,0,17,3,4,10
"2011","Leicester 022A","E01013751","Total",28,12,1,15,3,1,0,2,25,11,1,13
"2011","Leicester 022B","E01013752","Total",16,6,1,9,3,3,0,0,13,3,1,9
"2011","Leicester 022C","E01013753","Total",38,9,4,25,5,0,1,4,33,9,3,21
"2011","Leicester 022D","E01013760","Total",25,6,4,15,1,0,1,0,24,6,3,15
"2011","Leicester 022E","E01013761","Total",77,19,9,49,11,3,4,4,66,16,5,45
"2011","Leicester 022F","E01013762","Total",36,5,2,29,2,1,0,1,34,4,2,28
"2011","Leicester 023A","E01013774","Total",53,14,14,25,6,1,3,2,47,13,11,23
"2011","Leicester 023B","E01013776","Total",36,15,7,14,3,2,1,0,33,13,6,14
"2011","Leicester 023C","E01013778","Total",67,17,12,38,3,1,0,2,64,16,12,36
"2011","Leicester 023D","E01013779","Total",42,18,6,18,3,1,2,0,39,17,4,18
"2011","Leicester 023E","E01013781","Total",37,10,14,13,3,2,1,0,34,8,13,13
"2011","Leicester 023F","E01013782","Total",32,11,8,13,2,0,1,1,30,11,7,12
"2011","Leicester 023G","E01013784","Total",15,6,2,7,2,0,1,1,13,6,1,6
"2011","Leicester 025A","E01013666","Total",19,4,9,6,2,0,1,1,17,4,8,5
"2011","Leicester 025B","E01013669","Total",12,4,3,5,0,0,0,0,12,4,3,5
"2011","Leicester 025C","E01013670","Total",28,11,6,11,1,0,0,1,27,11,6,10
"2011","Leicester 025D","E01013671","Total",44,20,10,14,8,3,4,1,36,17,6,13
"2011","Leicester 025E","E01013672","Total",13,3,0,10,1,0,0,1,12,3,0,9
"2011","Leicester 026A","E01013631","Total",79,26,15,38,3,0,2,1,76,26,13,37
"2011","Leicester 026B","E01013632","Total",120,36,17,67,17,4,2,11,103,32,15,56
"2011","Leicester 026C","E01013638","Total",138,40,18,80,21,2,5,14,117,38,13,66
"2011","Leicester 026D","E01013640","Total",143,41,21,81,12,1,4,7,131,40,17,74
"2011","Leicester 027A","E01013756","Total",46,14,7,25,1,1,0,0,45,13,7,25
"2011","Leicester 027B","E01013757","Total",17,5,5,7,4,0,4,0,13,5,1,7
"2011","Leicester 027C","E01013759","Total",18,6,6,6,0,0,0,0,18,6,6,6
"2011","Leicester 027D","E01013763","Total",52,21,4,27,3,1,0,2,49,20,4,25
"2011","Leicester 027E","E01013764","Total",26,8,1,17,1,0,0,1,25,8,1,16
"2011","Leicester 027F","E01013765","Total",26,7,7,12,6,3,1,2,20,4,6,10
"2011","Leicester 027G","E01013766","Total",19,6,3,10,1,0,1,0,18,6,2,10
"2011","Leicester 028A","E01013633","Total",92,25,15,52,9,0,4,5,83,25,11,47
"2011","Leicester 028B","E01013634","Total",64,28,8,28,6,2,1,3,58,26,7,25
"2011","Leicester 028C","E01013637","Total",96,25,16,55,13,3,6,4,83,22,10,51
"2011","Leicester 028D","E01013639","Total",88,27,14,47,4,1,2,1,84,26,12,46
"2011","Leicester 028E","E01013641","Total",49,15,14,20,10,1,3,6,39,14,11,14
"2011","Leicester 029A","E01013635","Total",25,7,7,11,5,0,2,3,20,7,5,8
"2011","Leicester 029B","E01013636","Total",15,2,10,3,1,0,0,1,14,2,10,2
"2011","Leicester 029C","E01013775","Total",63,20,15,28,6,4,1,1,57,16,14,27
"2011","Leicester 029D","E01013777","Total",57,10,15,32,6,2,2,2,51,8,13,30
"2011","Leicester 030A","E01013642","Total",23,7,7,9,3,1,1,1,20,6,6,8
"2011","Leicester 030B","E01013643","Total",22,6,10,6,0,0,0,0,22,6,10,6
"2011","Leicester 030C","E01013649","Total",8,3,5,0,0,0,0,0,8,3,5,0
"2011","Leicester 030D","E01013650","Total",35,13,17,5,4,2,1,1,31,11,16,4
"2011","Leicester 030E","E01013702","Total",35,7,22,6,7,1,6,0,28,6,16,6
"2011","Leicester 030F","E01013710","Total",17,4,5,8,3,1,1,1,14,3,4,7
"2011","Leicester 030G","E01013711","Total",15,7,5,3,3,1,2,0,12,6,3,3
"2011","Leicester 031A","E01013613","Total",83,24,23,36,0,0,0,0,83,24,23,36
"2011","Leicester 031B","E01013614","Total",68,32,15,21,5,1,3,1,63,31,12,20
"2011","Leicester 031C","E01013687","Total",77,22,24,31,8,0,4,4,69,22,20,27
"2011","Leicester 031D","E01013688","Total",48,18,13,17,3,0,2,1,45,18,11,16
"2011","Leicester 032A","E01013703","Total",22,7,9,6,2,1,1,0,20,6,8,6
"2011","Leicester 032B","E01013704","Total",24,8,13,3,2,1,1,0,22,7,12,3
"2011","Leicester 032C","E01013706","Total",24,11,9,4,9,3,5,1,15,8,4,3
"2011","Leicester 032D","E01013707","Total",32,11,15,6,1,0,1,0,31,11,14,6
"2011","Leicester 032E","E01013712","Total",12,3,7,2,0,0,0,0,12,3,7,2
"2011","Leicester 034A","E01013608","Total",37,13,9,15,0,0,0,0,37,13,9,15
"2011","Leicester 034B","E01013609","Total",34,9,11,14,9,1,5,3,25,8,6,11
"2011","Leicester 034C","E01013610","Total",66,20,19,27,10,1,7,2,56,19,12,25
"2011","Leicester 034D","E01013611","Total",50,21,14,15,3,0,2,1,47,21,12,14
"2011","Leicester 034E","E01013612","Total",38,15,7,16,2,0,1,1,36,15,6,15
"2011","Leicester 035A","E01013678","Total",78,24,15,39,10,1,3,6,68,23,12,33
"2011","Leicester 035B","E01013679","Total",100,31,9,60,4,1,0,3,96,30,9,57
"2011","Leicester 035C","E01013691","Total",119,28,12,79,12,0,2,10,107,28,10,69
"2011","Leicester 035D","E01013692","Total",101,21,16,64,7,2,1,4,94,19,15,60
"2011","Leicester 035E","E01013693","Total",108,22,17,69,10,0,1,9,98,22,16,60
"2011","Leicester 036A","E01013673","Total",75,27,11,37,6,3,2,1,69,24,9,36
"2011","Leicester 036B","E01013674","Total",89,31,13,45,7,0,4,3,82,31,9,42
"2011","Leicester 036C","E01013675","Total",87,32,13,42,5,0,1,4,82,32,12,38
"2011","Leicester 036D","E01013676","Total",132,49,25,58,11,2,3,6,121,47,22,52
"2011","Leicester 036E","E01013677","Total",91,36,14,41,6,0,3,3,85,36,11,38
"2011","Leicester 037A","E01013695","Total",108,29,24,55,12,2,5,5,96,27,19,50
"2011","Leicester 037B","E01013698","Total",68,15,19,34,5,0,5,0,63,15,14,34
"2011","Leicester 037C","E01013767","Total",42,15,4,23,2,0,2,0,40,15,2,23
"2011","Leicester 037D","E01013768","Total",51,12,10,29,5,1,3,1,46,11,7,28
"2011","Leicester 037E","E01013772","Total",86,21,17,48,7,0,4,3,79,21,13,45
"2011","Leicester 037F","E01032597","Total",83,35,10,38,4,1,1,2,79,34,9,36
"2011","Leicester 038A","E01013689","Total",26,9,8,9,2,1,1,0,24,8,7,9
"2011","Leicester 038B","E01013690","Total",55,12,13,30,7,0,2,5,48,12,11,25
"2011","Leicester 038C","E01013705","Total",42,12,7,23,0,0,0,0,42,12,7,23
"2011","Leicester 038D","E01013709","Total",19,4,7,8,2,0,2,0,17,4,5,8
"2011","Leicester 038E","E01032599","Total",32,17,9,6,3,1,1,1,29,16,8,5
"2011","Leicester 039A","E01013722","Total",84,20,18,46,5,0,2,3,79,20,16,43
"2011","Leicester 039B","E01013727","Total",69,25,11,33,8,0,5,3,61,25,6,30
"2011","Leicester 039C","E01013730","Total",131,33,18,80,17,1,2,14,114,32,16,66
"2011","Leicester 039D","E01013731","Total",109,31,17,61,7,0,2,5,102,31,15,56
"2011","Leicester 039E","E01032602","Total",91,23,12,56,6,1,2,3,85,22,10,53
"2011","Leicester 040A","E01013646","Total",15,2,2,11,4,1,0,3,11,1,2,8
"2011","Leicester 040B","E01013647","Total",35,10,6,19,5,0,1,4,30,10,5,15
"2011","Leicester 040C","E01013648","Total",66,15,5,46,7,1,2,4,59,14,3,42
"2011","Leicester 040D","E01032875","Total",13,3,1,9,3,1,1,1,10,2,0,8
"2011","Leicester 041A","E01032867","Total",12,3,4,5,2,0,0,2,10,3,4,3
"2011","Leicester 041B","E01032868","Total",12,1,3,8,0,0,0,0,12,1,3,8
"2011","Leicester 041C","E01032872","Total",2,0,1,1,1,0,1,0,1,0,0,1
"2011","Leicester 041D","E01032873","Total",3,2,1,0,2,2,0,0,1,0,1,0
"2011","Nottingham 001A","E01013887","Total",32,14,7,11,5,1,2,2,27,13,5,9
"2011","Nottingham 001B","E01013892","Total",23,10,9,4,3,1,2,0,20,9,7,4
"2011","Nottingham 001C","E01013893","Total",122,43,23,56,6,2,1,3,116,41,22,53
"2011","Nottingham 001D","E01013894","Total",42,16,12,14,3,1,1,1,39,15,11,13
"2011","Nottingham 002A","E01013879","Total",99,22,16,61,6,0,1,5,93,22,15,56
"2011","Nottingham 002B","E01013880","Total",97,36,11,50,8,1,0,7,89,35,11,43
"2011","Nottingham 002C","E01013881","Total",105,26,10,69,7,2,0,5,98,24,10,64
"2011","Nottingham 002D","E01013882","Total",94,29,13,52,10,1,3,6,84,28,10,46
"2011","Nottingham 002E","E01013885","Total",115,27,23,65,8,0,2,6,107,27,21,59
"2011","Nottingham 004A","E01013886","Total",59,20,15,24,5,0,4,1,54,20,11,23
"2011","Nottingham 004B","E01013888","Total",50,11,20,19,2,0,1,1,48,11,19,18
"2011","Nottingham 004C","E01013889","Total",50,16,8,26,1,0,0,1,49,16,8,25
"2011","Nottingham 004D","E01013890","Total",69,28,21,20,6,0,4,2,63,28,17,18
"2011","Nottingham 004E","E01013891","Total",91,32,18,41,3,0,0,3,88,32,18,38
"2011","Nottingham 005A","E01013875","Total",32,16,10,6,5,1,3,1,27,15,7,5
"2011","Nottingham 005B","E01013876","Total",102,34,23,45,9,0,3,6,93,34,20,39
"2011","Nottingham 005C","E01013877","Total",139,32,17,90,8,2,2,4,131,30,15,86
"2011","Nottingham 005D","E01013878","Total",100,44,11,45,15,8,2,5,85,36,9,40
"2011","Nottingham 005E","E01013883","Total",92,37,20,35,3,0,3,0,89,37,17,35
"2011","Nottingham 005F","E01013884","Total",108,37,27,44,13,2,6,5,95,35,21,39
"2011","Nottingham 006A","E01013853","Total",42,12,11,19,0,0,0,0,42,12,11,19
"2011","Nottingham 006B","E01013854","Total",84,23,17,44,5,0,1,4,79,23,16,40
"2011","Nottingham 006C","E01013855","Total",154,46,19,89,22,5,8,9,132,41,11,80
"2011","Nottingham 006D","E01013856","Total",87,36,14,37,3,0,2,1,84,36,12,36
"2011","Nottingham 006F","E01033397","Total",101,25,22,54,7,1,4,2,94,24,18,52
"2011","Nottingham 006G","E01033398","Total",51,8,12,31,4,0,2,2,47,8,10,29
"2011","Nottingham 007A","E01013963","Total",111,36,26,49,18,1,11,6,93,35,15,43
"2011","Nottingham 007B","E01013964","Total",74,19,22,33,10,1,2,7,64,18,20,26
"2011","Nottingham 007C","E01013965","Total",74,25,21,28,10,1,4,5,64,24,17,23
"2011","Nottingham 007D","E01013966","Total",83,24,22,37,9,0,1,8,74,24,21,29
"2011","Nottingham 007E","E01013967","Total",30,9,11,10,4,0,3,1,26,9,8,9
"2011","Nottingham 008A","E01013827","Total",107,30,32,45,6,0,4,2,101,30,28,43
"2011","Nottingham 008B","E01013828","Total",75,21,23,31,8,0,3,5,67,21,20,26
"2011","Nottingham 008C","E01013834","Total",122,44,26,52,5,2,2,1,117,42,24,51
"2011","Nottingham 008D","E01013835","Total",110,45,22,43,4,1,2,1,106,44,20,42
"2011","Nottingham 008E","E01013836","Total",128,35,32,61,14,1,10,3,114,34,22,58
"2011","Nottingham 009A","E01013829","Total",82,24,29,29,4,0,3,1,78,24,26,28
"2011","Nottingham 009B","E01013830","Total",66,21,18,27,5,1,2,2,61,20,16,25
"2011","Nottingham 009C","E01013831","Total",35,15,7,13,2,0,2,0,33,15,5,13
"2011","Nottingham 009D","E01013832","Total",71,28,14,29,4,0,3,1,67,28,11,28
"2011","Nottingham 009E","E01013833","Total",98,33,25,40,11,4,2,5,87,29,23,35
"2011","Nottingham 010A","E01013935","Total",28,14,6,8,1,0,0,1,27,14,6,7
"2011","Nottingham 010B","E01013968","Total",14,5,4,5,3,0,2,1,11,5,2,4
"2011","Nottingham 010C","E01013969","Total",41,12,17,12,6,1,4,1,35,11,13,11
"2011","Nottingham 010D","E01013970","Total",37,15,14,8,3,0,3,0,34,15,11,8
"2011","Nottingham 010E","E01013971","Total",32,12,12,8,6,0,4,2,26,12,8,6
"2011","Nottingham 011A","E01013817","Total",178,47,19,112,8,0,2,6,170,47,17,106
"2011","Nottingham 011B","E01013818","Total",146,40,13,93,6,0,1,5,140,40,12,88
"2011","Nottingham 011C","E01013822","Total",166,46,20,100,11,2,5,4,155,44,15,96
"2011","Nottingham 011D","E01013825","Total",129,51,22,56,11,1,4,6,118,50,18,50
"2011","Nottingham 011E","E01013826","Total",210,71,34,105,24,2,15,7,186,69,19,98
"2011","Nottingham 012A","E01013837","Total",41,11,16,14,3,1,1,1,38,10,15,13
"2011","Nottingham 012B","E01013838","Total",41,17,10,14,1,0,0,1,40,17,10,13
"2011","Nottingham 012C","E01013839","Total",98,29,20,49,13,2,7,4,85,27,13,45
"2011","Nottingham 012D","E01013840","Total",75,24,30,21,11,2,6,3,64,22,24,18
"2011","Nottingham 012E","E01013841","Total",88,35,17,36,8,3,4,1,80,32,13,35
"2011","Nottingham 013A","E01013819","Total",117,34,15,68,8,1,1,6,109,33,14,62
"2011","Nottingham 013B","E01013820","Total",173,46,22,105,12,1,4,7,161,45,18,98
"2011","Nottingham 013C","E01013821","Total",151,42,17,92,10,1,5,4,141,41,12,88
"2011","Nottingham 013D","E01013823","Total",130,40,29,61,12,0,5,7,118,40,24,54
"2011","Nottingham 013E","E01013824","Total",143,35,19,89,15,1,4,10,128,34,15,79
"2011","Nottingham 014A","E01013864","Total",151,42,22,87,8,2,3,3,143,40,19,84
"2011","Nottingham 014B","E01013865","Total",79,27,11,41,8,3,4,1,71,24,7,40
"2011","Nottingham 014C","E01013866","Total",54,20,6,28,5,0,2,3,49,20,4,25
"2011","Nottingham 014D","E01013867","Total",121,30,23,68,12,1,4,7,109,29,19,61
"2011","Nottingham 015A","E01013937","Total",41,14,14,13,5,1,4,0,36,13,10,13
"2011","Nottingham 015B","E01013938","Total",16,7,6,3,2,1,1,0,14,6,5,3
"2011","Nottingham 015C","E01013941","Total",24,9,10,5,2,1,1,0,22,8,9,5
"2011","Nottingham 015D","E01013943","Total",39,9,9,21,2,0,0,2,37,9,9,19
"2011","Nottingham 015E","E01013972","Total",47,19,17,11,5,1,4,0,42,18,13,11
"2011","Nottingham 016A","E01013936","Total",103,34,38,31,8,2,5,1,95,32,33,30
"2011","Nottingham 016B","E01013939","Total",47,13,10,24,4,0,3,1,43,13,7,23
"2011","Nottingham 016C","E01013940","Total",127,37,18,72,21,1,2,18,106,36,16,54
"2011","Nottingham 016D","E01013942","Total",131,47,30,54,14,2,7,5,117,45,23,49
"2011","Nottingham 017A","E01013843","Total",18,5,6,7,0,0,0,0,18,5,6,7
"2011","Nottingham 017B","E01013844","Total",41,13,7,21,7,5,1,1,34,8,6,20
"2011","Nottingham 017C","E01013845","Total",38,10,7,21,5,0,2,3,33,10,5,18
"2011","Nottingham 017D","E01013847","Total",24,7,4,13,5,3,2,0,19,4,2,13
"2011","Nottingham 018A","E01013810","Total",59,15,11,33,4,0,3,1,55,15,8,32
"2011","Nottingham 018B","E01013811","Total",43,16,5,22,2,0,1,1,41,16,4,21
"2011","Nottingham 018C","E01013812","Total",76,20,16,40,8,0,4,4,68,20,12,36
"2011","Nottingham 018D","E01013842","Total",77,15,16,46,10,4,5,1,67,11,11,45
"2011","Nottingham 018E","E01013846","Total",27,7,3,17,2,0,1,1,25,7,2,16
"2011","Nottingham 019A","E01013930","Total",63,19,17,27,4,0,2,2,59,19,15,25
"2011","Nottingham 019B","E01013931","Total",15,10,1,4,0,0,0,0,15,10,1,4
"2011","Nottingham 019C","E01013932","Total",31,9,9,13,5,1,4,0,26,8,5,13
"2011","Nottingham 019D","E01013933","Total",126,40,28,58,11,0,4,7,115,40,24,51
"2011","Nottingham 019E","E01013934","Total",35,14,11,10,4,2,1,1,31,12,10,9
"2011","Nottingham 020A","E01013859","Total",27,10,6,11,6,1,2,3,21,9,4,8
"2011","Nottingham 020B","E01013861","Total",54,15,8,31,3,1,0,2,51,14,8,29
"2011","Nottingham 020C","E01013868","Total",69,21,14,34,4,0,4,0,65,21,10,34
"2011","Nottingham 020D","E01013929","Total",65,19,14,32,3,0,0,3,62,19,14,29
"2011","Nottingham 021A","E01013954","Total",91,30,11,50,9,1,1,7,82,29,10,43
"2011","Nottingham 021B","E01013959","Total",130,46,16,68,14,5,2,7,116,41,14,61
"2011","Nottingham 021C","E01013960","Total",105,33,20,52,13,3,5,5,92,30,15,47
"2011","Nottingham 021D","E01013962","Total",115,45,18,52,13,5,4,4,102,40,14,48
"2011","Nottingham 022A","E01013813","Total",43,16,3,24,6,1,0,5,37,15,3,19
"2011","Nottingham 022B","E01013814","Total",22,7,5,10,6,4,1,1,16,3,4,9
"2011","Nottingham 022C","E01013815","Total",27,9,5,13,6,0,4,2,21,9,1,11
"2011","Nottingham 022D","E01013816","Total",30,5,9,16,3,0,2,1,27,5,7,15
"2011","Nottingham 023C","E01013958","Total",128,30,16,82,14,0,3,11,114,30,13,71
"2011","Nottingham 023D","E01013961","Total",72,17,15,40,3,0,0,3,69,17,15,37
"2011","Nottingham 023E","E01033399","Total",37,10,5,22,3,0,0,3,34,10,5,19
"2011","Nottingham 023F","E01033401","Total",24,10,4,10,0,0,0,0,24,10,4,10
"2011","Nottingham 023G","E01033405","Total",18,4,4,10,2,0,2,0,16,4,2,10
"2011","Nottingham 023H","E01033409","Total",8,3,2,3,3,0,2,1,5,3,0,2
"2011","Nottingham 023I","E01033411","Total",54,20,9,25,6,2,2,2,48,18,7,23
"2011","Nottingham 024A","E01013913","Total",46,18,14,14,2,0,1,1,44,18,13,13
"2011","Nottingham 024B","E01013914","Total",36,20,5,11,0,0,0,0,36,20,5,11
"2011","Nottingham 024C","E01013915","Total",45,11,11,23,3,0,2,1,42,11,9,22
"2011","Nottingham 024D","E01013916","Total",108,37,16,55,8,0,4,4,100,37,12,51
"2011","Nottingham 024E","E01013917","Total",102,40,19,43,8,1,4,3,94,39,15,40
"2011","Nottingham 025A","E01013858","Total",69,24,13,32,4,2,1,1,65,22,12,31
"2011","Nottingham 025B","E01013860","Total",60,16,17,27,5,0,2,3,55,16,15,24
"2011","Nottingham 025C","E01013862","Total",108,46,22,40,15,6,2,7,93,40,20,33
"2011","Nottingham 025D","E01013863","Total",57,14,20,23,13,4,8,1,44,10,12,22
"2011","Nottingham 026A","E01013944","Total",33,13,10,10,2,1,0,1,31,12,10,9
"2011","Nottingham 026B","E01013945","Total",62,19,9,34,17,4,3,10,45,15,6,24
"2011","Nottingham 026D","E01013947","Total",54,14,12,28,7,1,3,3,47,13,9,25
"2011","Nottingham 026E","E01013948","Total",54,16,4,34,3,0,0,3,51,16,4,31
"2011","Nottingham 026F","E01013953","Total",12,0,3,9,0,0,0,0,12,0,3,9
"2011","Nottingham 026G","E01033395","Total",23,6,0,17,8,0,0,8,15,6,0,9
"2011","Nottingham 026H","E01033396","Total",51,21,4,26,8,0,0,8,43,21,4,18
"2011","Nottingham 027A","E01013977","Total",28,10,14,4,5,2,3,0,23,8,11,4
"2011","Nottingham 027B","E01013978","Total",43,20,13,10,4,1,2,1,39,19,11,9
"2011","Nottingham 027C","E01013979","Total",25,7,9,9,0,0,0,0,25,7,9,9
"2011","Nottingham 027D","E01013981","Total",26,6,14,6,4,0,4,0,22,6,10,6
"2011","Nottingham 028E","E01032520","Total",10,2,8,0,3,0,3,0,7,2,5,0
"2011","Nottingham 028F","E01032522","Total",12,2,5,5,5,0,3,2,7,2,2,3
"2011","Nottingham 028G","E01033404","Total",20,2,6,12,2,1,1,0,18,1,5,12
"2011","Nottingham 029A","E01013918","Total",68,14,19,35,2,0,0,2,66,14,19,33
"2011","Nottingham 029B","E01013919","Total",71,22,9,40,6,0,1,5,65,22,8,35
"2011","Nottingham 029C","E01013920","Total",86,21,14,51,14,2,2,10,72,19,12,41
"2011","Nottingham 029D","E01013921","Total",107,18,14,75,12,3,4,5,95,15,10,70
"2011","Nottingham 029E","E01013957","Total",103,30,23,50,5,3,1,1,98,27,22,49
"2011","Nottingham 030A","E01013980","Total",26,11,9,6,5,0,4,1,21,11,5,5
"2011","Nottingham 030B","E01013982","Total",20,8,8,4,4,0,4,0,16,8,4,4
"2011","Nottingham 030C","E01013983","Total",67,21,14,32,15,0,3,12,52,21,11,20
"2011","Nottingham 030D","E01013984","Total",17,4,9,4,3,1,2,0,14,3,7,4
"2011","Nottingham 030E","E01013985","Total",21,10,5,6,2,0,2,0,19,10,3,6
"2011","Nottingham 031C","E01013924","Total",13,5,2,6,2,0,0,2,11,5,2,4
"2011","Nottingham 031E","E01013926","Total",32,13,7,12,5,2,2,1,27,11,5,11
"2011","Nottingham 031G","E01013928","Total",15,4,2,9,2,1,0,1,13,3,2,8
"2011","Nottingham 031H","E01033408","Total",25,11,6,8,3,0,3,0,22,11,3,8
"2011","Nottingham 031I","E01033410","Total",9,3,2,4,1,1,0,0,8,2,2,4
"2011","Nottingham 032A","E01013973","Total",42,18,5,19,4,1,0,3,38,17,5,16
"2011","Nottingham 032B","E01013974","Total",15,4,6,5,2,0,1,1,13,4,5,4
"2011","Nottingham 032C","E01013975","Total",11,4,5,2,0,0,0,0,11,4,5,2
"2011","Nottingham 032D","E01013976","Total",92,28,19,45,4,2,1,1,88,26,18,44
"2011","Nottingham 034A","E01013895","Total",22,7,8,7,3,0,3,0,19,7,5,7
"2011","Nottingham 034B","E01013896","Total",59,20,12,27,6,1,3,2,53,19,9,25
"2011","Nottingham 034C","E01013901","Total",28,10,13,5,4,0,3,1,24,10,10,4
"2011","Nottingham 034D","E01013902","Total",22,11,6,5,0,0,0,0,22,11,6,5
"2011","Nottingham 035A","E01013897","Total",60,22,12,26,7,2,4,1,53,20,8,25
"2011","Nottingham 035B","E01013898","Total",30,9,6,15,8,2,4,2,22,7,2,13
"2011","Nottingham 035C","E01013899","Total",58,21,12,25,3,0,0,3,55,21,12,22
"2011","Nottingham 035D","E01013900","Total",56,21,15,20,4,1,2,1,52,20,13,19
"2011","Nottingham 035E","E01013903","Total",28,13,7,8,4,0,2,2,24,13,5,6
"2011","Nottingham 035F","E01013907","Total",60,31,5,24,4,0,1,3,56,31,4,21
"2011","Nottingham 036A","E01013905","Total",59,19,11,29,5,1,4,0,54,18,7,29
"2011","Nottingham 036B","E01013908","Total",72,20,12,40,3,0,1,2,69,20,11,38
"2011","Nottingham 036C","E01013909","Total",87,30,14,43,6,0,4,2,81,30,10,41
"2011","Nottingham 036D","E01013912","Total",32,14,10,8,5,0,3,2,27,14,7,6
"2011","Nottingham 037A","E01013904","Total",62,31,9,22,5,3,2,0,57,28,7,22
"2011","Nottingham 037B","E01013906","Total",66,25,15,26,3,0,3,0,63,25,12,26
"2011","Nottingham 037C","E01013910","Total",63,22,12,29,10,2,3,5,53,20,9,24
"2011","Nottingham 037D","E01013911","Total",60,26,19,15,5,0,5,0,55,26,14,15
"2011","Nottingham 038A","E01013849","Total",116,45,15,56,3,0,1,2,113,45,14,54
"2011","Nottingham 038B","E01013850","Total",64,18,22,24,9,0,8,1,55,18,14,23
"2011","Nottingham 038C","E01013851","Total",135,35,25,75,6,0,0,6,129,35,25,69
"2011","Nottingham 038D","E01013852","Total",68,19,19,30,10,2,3,5,58,17,16,25
"2011","Nottingham 038E","E01032621","Total",57,18,12,27,6,2,1,3,51,16,11,24
"2011","Nottingham 039A","E01013874","Total",42,12,8,22,3,2,0,1,39,10,8,21
"2011","Nottingham 039B","E01033400","Total",58,13,13,32,4,0,2,2,54,13,11,30
"2011","Nottingham 039C","E01033402","Total",1,1,0,0,0,0,0,0,1,1,0,0
"2011","Nottingham 039D","E01033403","Total",16,3,5,8,1,0,1,0,15,3,4,8
"2011","Nottingham 039E","E01033406","Total",2,0,0,2,0,0,0,0,2,0,0,2
"2011","Nottingham 039F","E01033407","Total",6,3,1,2,0,0,0,0,6,3,1,2
"2011","Nottingham 040A","E01013870","Total",93,28,13,52,11,2,4,5,82,26,9,47
"2011","Nottingham 040B","E01013871","Total",84,35,12,37,7,2,2,3,77,33,10,34
"2011","Nottingham 040C","E01013872","Total",77,32,12,33,6,3,1,2,71,29,11,31
"2011","Nottingham 040D","E01013873","Total",74,26,13,35,8,0,4,4,66,26,9,31
"2011","Rutland 001A","E01013788","Total",38,16,13,9,3,0,2,1,35,16,11,8
"2011","Rutland 001B","E01013789","Total",24,12,8,4,7,4,3,0,17,8,5,4
"2011","Rutland 001C","E01013790","Total",14,7,5,2,4,1,3,0,10,6,2,2
"2011","Rutland 001D","E01013796","Total",21,5,12,4,6,2,2,2,15,3,10,2
"2011","Rutland 002A","E01013793","Total",26,11,9,6,6,1,5,0,20,10,4,6
"2011","Rutland 002B","E01013800","Total",37,13,19,5,5,0,5,0,32,13,14,5
"2011","Rutland 002C","E01013801","Total",49,18,13,18,13,0,6,7,36,18,7,11
"2011","Rutland 002D","E01013809","Total",19,6,6,7,3,1,2,0,16,5,4,7
"2011","Rutland 003A","E01013798","Total",41,14,19,8,7,0,6,1,34,14,13,7
"2011","Rutland 003B","E01013799","Total",52,22,15,15,14,7,5,2,38,15,10,13
"2011","Rutland 003C","E01013802","Total",44,12,15,17,12,4,2,6,32,8,13,11
"2011","Rutland 003D","E01013803","Total",51,19,20,12,11,1,8,2,40,18,12,10
"2011","Rutland 004A","E01013791","Total",22,8,8,6,2,0,2,0,20,8,6,6
"2011","Rutland 004B","E01013792","Total",24,10,9,5,4,0,4,0,20,10,5,5
"2011","Rutland 004C","E01013797","Total",25,10,13,2,3,0,3,0,22,10,10,2
"2011","Rutland 004D","E01013804","Total",37,21,12,4,5,1,4,0,32,20,8,4
"2011","Rutland 004E","E01013805","Total",28,13,9,6,7,1,6,0,21,12,3,6
"2011","Rutland 005A","E01013787","Total",23,10,10,3,3,1,2,0,20,9,8,3
"2011","Rutland 005B","E01013794","Total",17,10,6,1,4,2,1,1,13,8,5,0
"2011","Rutland 005C","E01013795","Total",14,7,5,2,0,0,0,0,14,7,5,2
"2011","Rutland 005D","E01013806","Total",26,6,14,6,4,0,3,1,22,6,11,5
"2011","Rutland 005E","E01013807","Total",39,18,9,12,2,0,2,0,37,18,7,12
"2011","Rutland 005F","E01013808","Total",42,17,13,12,5,1,4,0,37,16,9,12
"2011","Amber Valley 001A","E01019400","Total",60,15,11,34,4,0,3,1,56,15,8,33
"2011","Amber Valley 001B","E01019401","Total",47,19,14,14,5,0,3,2,42,19,11,12
"2011","Amber Valley 001C","E01019402","Total",41,11,13,17,4,1,2,1,37,10,11,16
"2011","Amber Valley 001D","E01019404","Total",36,12,9,15,1,0,1,0,35,12,8,15
"2011","Amber Valley 002A","E01019406","Total",27,13,8,6,1,0,1,0,26,13,7,6
"2011","Amber Valley 002B","E01019423","Total",12,5,3,4,1,0,0,1,11,5,3,3
"2011","Amber Valley 002C","E01019424","Total",15,4,7,4,3,1,2,0,12,3,5,4
"2011","Amber Valley 002D","E01019477","Total",42,16,13,13,8,0,5,3,34,16,8,10
"2011","Amber Valley 003A","E01019403","Total",50,25,4,21,2,1,0,1,48,24,4,20
"2011","Amber Valley 003B","E01019444","Total",85,19,12,54,13,2,4,7,72,17,8,47
"2011","Amber Valley 003C","E01019468","Total",45,11,13,21,7,0,4,3,38,11,9,18
"2011","Amber Valley 003D","E01019469","Total",85,13,8,64,8,1,0,7,77,12,8,57
"2011","Amber Valley 003E","E01019471","Total",58,10,10,38,4,0,1,3,54,10,9,35
"2011","Amber Valley 004A","E01019443","Total",30,9,14,7,8,1,6,1,22,8,8,6
"2011","Amber Valley 004B","E01019470","Total",47,17,16,14,6,0,6,0,41,17,10,14
"2011","Amber Valley 004C","E01019473","Total",20,11,8,1,6,0,6,0,14,11,2,1
"2011","Amber Valley 004D","E01019474","Total",14,8,3,3,2,1,0,1,12,7,3,2
"2011","Amber Valley 004E","E01019475","Total",26,7,8,11,3,0,3,0,23,7,5,11
"2011","Amber Valley 004F","E01019476","Total",8,5,3,0,1,0,1,0,7,5,2,0
"2011","Amber Valley 005A","E01019420","Total",40,17,11,12,3,1,1,1,37,16,10,11
"2011","Amber Valley 005B","E01019442","Total",29,4,10,15,3,0,1,2,26,4,9,13
"2011","Amber Valley 005C","E01019445","Total",36,12,11,13,1,1,0,0,35,11,11,13
"2011","Amber Valley 005D","E01019455","Total",43,20,10,13,3,0,2,1,40,20,8,12
"2011","Amber Valley 005E","E01019456","Total",47,12,15,20,8,0,5,3,39,12,10,17
"2011","Amber Valley 005F","E01019457","Total",32,10,15,7,8,1,7,0,24,9,8,7
"2011","Amber Valley 006A","E01019429","Total",20,11,4,5,3,0,1,2,17,11,3,3
"2011","Amber Valley 006B","E01019454","Total",17,7,4,6,1,0,1,0,16,7,3,6
"2011","Amber Valley 006C","E01019460","Total",34,10,11,13,3,0,2,1,31,10,9,12
"2011","Amber Valley 006D","E01019461","Total",24,9,8,7,2,0,1,1,22,9,7,6
"2011","Amber Valley 006E","E01019462","Total",14,5,5,4,3,0,2,1,11,5,3,3
"2011","Amber Valley 007A","E01019405","Total",6,2,3,1,1,0,1,0,5,2,2,1
"2011","Amber Valley 007B","E01019414","Total",14,8,4,2,0,0,0,0,14,8,4,2
"2011","Amber Valley 007C","E01019428","Total",36,18,13,5,5,1,3,1,31,17,10,4
"2011","Amber Valley 007D","E01019430","Total",34,11,11,12,9,3,4,2,25,8,7,10
"2011","Amber Valley 008A","E01019421","Total",41,16,12,13,2,0,0,2,39,16,12,11
"2011","Amber Valley 008B","E01019422","Total",27,12,7,8,3,0,1,2,24,12,6,6
"2011","Amber Valley 008C","E01019432","Total",48,12,11,25,4,0,3,1,44,12,8,24
"2011","Amber Valley 008D","E01019458","Total",57,19,14,24,6,2,2,2,51,17,12,22
"2011","Amber Valley 008E","E01019459","Total",55,13,18,24,10,1,6,3,45,12,12,21
"2011","Amber Valley 008F","E01019463","Total",83,20,16,47,10,0,3,7,73,20,13,40
"2011","Amber Valley 009A","E01019408","Total",48,20,15,13,6,0,5,1,42,20,10,12
"2011","Amber Valley 009B","E01019409","Total",34,17,8,9,7,1,2,4,27,16,6,5
"2011","Amber Valley 009C","E01019412","Total",28,12,11,5,6,0,4,2,22,12,7,3
"2011","Amber Valley 009D","E01019413","Total",46,21,14,11,7,1,4,2,39,20,10,9
"2011","Amber Valley 009E","E01019416","Total",14,7,3,4,2,2,0,0,12,5,3,4
"2011","Amber Valley 010A","E01019407","Total",50,22,14,14,8,2,6,0,42,20,8,14
"2011","Amber Valley 010B","E01019415","Total",43,11,14,18,9,1,3,5,34,10,11,13
"2011","Amber Valley 010C","E01019417","Total",73,27,15,31,15,3,5,7,58,24,10,24
"2011","Amber Valley 010D","E01019419","Total",45,19,10,16,2,1,1,0,43,18,9,16
"2011","Amber Valley 011A","E01019410","Total",34,14,11,9,2,0,2,0,32,14,9,9
"2011","Amber Valley 011B","E01019411","Total",41,10,18,13,6,2,3,1,35,8,15,12
"2011","Amber Valley 011C","E01019418","Total",45,19,12,14,2,0,1,1,43,19,11,13
"2011","Amber Valley 011D","E01019447","Total",21,12,5,4,4,0,2,2,17,12,3,2
"2011","Amber Valley 011E","E01019449","Total",40,23,12,5,5,1,3,1,35,22,9,4
"2011","Amber Valley 012A","E01019431","Total",43,13,11,19,7,1,4,2,36,12,7,17
"2011","Amber Valley 012B","E01019433","Total",62,27,15,20,4,0,2,2,58,27,13,18
"2011","Amber Valley 012C","E01019438","Total",51,13,15,23,7,0,4,3,44,13,11,20
"2011","Amber Valley 012D","E01019451","Total",49,6,16,27,8,1,6,1,41,5,10,26
"2011","Amber Valley 012E","E01019464","Total",30,14,11,5,7,2,4,1,23,12,7,4
"2011","Amber Valley 013A","E01019434","Total",36,11,8,17,3,1,1,1,33,10,7,16
"2011","Amber Valley 013B","E01019435","Total",43,17,14,12,2,0,1,1,41,17,13,11
"2011","Amber Valley 013C","E01019436","Total",29,14,4,11,4,2,1,1,25,12,3,10
"2011","Amber Valley 013D","E01019439","Total",26,7,11,8,1,0,1,0,25,7,10,8
"2011","Amber Valley 013E","E01019440","Total",29,8,7,14,2,0,0,2,27,8,7,12
"2011","Amber Valley 015A","E01019446","Total",18,7,5,6,1,0,1,0,17,7,4,6
"2011","Amber Valley 015B","E01019448","Total",19,12,6,1,1,1,0,0,18,11,6,1
"2011","Amber Valley 015C","E01019450","Total",55,18,14,23,9,1,5,3,46,17,9,20
"2011","Amber Valley 015D","E01019465","Total",19,6,5,8,2,0,1,1,17,6,4,7
"2011","Amber Valley 015E","E01019467","Total",17,10,6,1,3,1,2,0,14,9,4,1
"2011","Amber Valley 016A","E01019425","Total",28,16,9,3,0,0,0,0,28,16,9,3
"2011","Amber Valley 016B","E01019426","Total",35,15,11,9,2,0,1,1,33,15,10,8
"2011","Amber Valley 016C","E01019427","Total",39,12,17,10,5,2,3,0,34,10,14,10
"2011","Amber Valley 016D","E01019472","Total",26,8,7,11,5,1,2,2,21,7,5,9
"2011","Amber Valley 017A","E01019437","Total",35,16,8,11,4,1,2,1,31,15,6,10
"2011","Amber Valley 017B","E01019441","Total",76,27,13,36,7,1,2,4,69,26,11,32
"2011","Amber Valley 017C","E01019452","Total",70,19,4,47,4,0,0,4,66,19,4,43
"2011","Amber Valley 017D","E01019453","Total",108,30,32,46,12,0,9,3,96,30,23,43
"2011","Amber Valley 017E","E01032613","Total",19,6,7,6,2,1,0,1,17,5,7,5
"2011","Bolsover 001A","E01019478","Total",37,19,11,7,3,1,0,2,34,18,11,5
"2011","Bolsover 001B","E01019479","Total",27,8,8,11,4,1,3,0,23,7,5,11
"2011","Bolsover 001C","E01019491","Total",69,18,17,34,5,0,3,2,64,18,14,32
"2011","Bolsover 001D","E01019493","Total",38,15,18,5,3,0,3,0,35,15,15,5
"2011","Bolsover 001E","E01019494","Total",43,16,9,18,4,1,2,1,39,15,7,17
"2011","Bolsover 002A","E01019492","Total",58,21,10,27,7,3,2,2,51,18,8,25
"2011","Bolsover 002B","E01019495","Total",42,14,10,18,7,1,4,2,35,13,6,16
"2011","Bolsover 002C","E01019524","Total",26,8,12,6,4,1,3,0,22,7,9,6
"2011","Bolsover 002D","E01019525","Total",44,13,12,19,9,1,4,4,35,12,8,15
"2011","Bolsover 003A","E01019496","Total",45,18,14,13,3,1,1,1,42,17,13,12
"2011","Bolsover 003B","E01019497","Total",41,8,9,24,8,0,3,5,33,8,6,19
"2011","Bolsover 003C","E01019498","Total",101,30,17,54,11,3,2,6,90,27,15,48
"2011","Bolsover 003D","E01019523","Total",44,17,7,20,5,0,2,3,39,17,5,17
"2011","Bolsover 004A","E01019483","Total",100,34,15,51,12,0,5,7,88,34,10,44
"2011","Bolsover 004B","E01019484","Total",53,13,12,28,9,1,4,4,44,12,8,24
"2011","Bolsover 004C","E01019485","Total",25,15,4,6,2,0,0,2,23,15,4,4
"2011","Bolsover 004D","E01019488","Total",78,19,19,40,13,2,6,5,65,17,13,35
"2011","Bolsover 005A","E01019486","Total",24,9,11,4,2,2,0,0,22,7,11,4
"2011","Bolsover 005B","E01019487","Total",56,16,16,24,7,0,2,5,49,16,14,19
"2011","Bolsover 005C","E01019489","Total",21,6,10,5,5,0,5,0,16,6,5,5
"2011","Bolsover 005D","E01019490","Total",26,10,9,7,4,1,3,0,22,9,6,7
"2011","Bolsover 005E","E01019502","Total",27,8,9,10,3,0,2,1,24,8,7,9
"2011","Bolsover 005F","E01019504","Total",26,5,10,11,3,0,2,1,23,5,8,10
"2011","Bolsover 006A","E01019508","Total",56,18,12,26,8,1,4,3,48,17,8,23
"2011","Bolsover 006B","E01019509","Total",69,24,10,35,14,3,1,10,55,21,9,25
"2011","Bolsover 006C","E01019510","Total",29,11,4,14,5,1,1,3,24,10,3,11
"2011","Bolsover 006D","E01019512","Total",66,21,16,29,7,0,4,3,59,21,12,26
"2011","Bolsover 007A","E01019503","Total",50,13,18,19,7,1,4,2,43,12,14,17
"2011","Bolsover 007B","E01019505","Total",44,10,9,25,3,0,1,2,41,10,8,23
"2011","Bolsover 007C","E01019506","Total",34,6,7,21,4,0,1,3,30,6,6,18
"2011","Bolsover 007D","E01019507","Total",51,10,14,27,3,0,0,3,48,10,14,24
"2011","Bolsover 007E","E01019511","Total",74,20,20,34,9,2,4,3,65,18,16,31
"2011","Bolsover 008A","E01019480","Total",36,11,12,13,6,0,5,1,30,11,7,12
"2011","Bolsover 008B","E01019482","Total",26,8,6,12,3,0,2,1,23,8,4,11
"2011","Bolsover 008C","E01019520","Total",44,13,13,18,4,0,2,2,40,13,11,16
"2011","Bolsover 008D","E01019521","Total",38,13,15,10,7,2,4,1,31,11,11,9
"2011","Bolsover 008E","E01019522","Total",51,15,9,27,2,0,0,2,49,15,9,25
"2011","Bolsover 009A","E01019481","Total",46,16,11,19,4,0,4,0,42,16,7,19
"2011","Bolsover 009B","E01019514","Total",45,16,16,13,5,1,3,1,40,15,13,12
"2011","Bolsover 009C","E01019515","Total",52,17,13,22,8,0,4,4,44,17,9,18
"2011","Bolsover 009D","E01019516","Total",43,16,4,23,3,0,1,2,40,16,3,21
"2011","Bolsover 009E","E01019519","Total",70,27,15,28,7,1,4,2,63,26,11,26
"2011","Bolsover 010A","E01019499","Total",40,10,10,20,6,1,3,2,34,9,7,18
"2011","Bolsover 010B","E01019500","Total",54,14,10,30,3,0,1,2,51,14,9,28
"2011","Bolsover 010C","E01019501","Total",28,11,10,7,5,0,5,0,23,11,5,7
"2011","Bolsover 010D","E01019513","Total",31,7,14,10,7,0,6,1,24,7,8,9
"2011","Bolsover 010E","E01019517","Total",37,14,17,6,6,0,5,1,31,14,12,5
"2011","Bolsover 010F","E01019518","Total",29,11,16,2,6,1,5,0,23,10,11,2
"2011","Chesterfield 001A","E01019526","Total",47,22,6,19,2,0,2,0,45,22,4,19
"2011","Chesterfield 001B","E01019528","Total",34,15,10,9,6,0,4,2,28,15,6,7
"2011","Chesterfield 001C","E01019572","Total",62,24,15,23,2,0,1,1,60,24,14,22
"2011","Chesterfield 001D","E01019573","Total",37,16,8,13,5,0,4,1,32,16,4,12
"2011","Chesterfield 001E","E01019574","Total",34,16,7,11,2,0,1,1,32,16,6,10
"2011","Chesterfield 002A","E01019563","Total",74,21,11,42,7,0,3,4,67,21,8,38
"2011","Chesterfield 002B","E01019564","Total",30,10,8,12,5,1,2,2,25,9,6,10
"2011","Chesterfield 002C","E01019565","Total",66,20,13,33,7,0,0,7,59,20,13,26
"2011","Chesterfield 002D","E01019566","Total",75,24,14,37,10,0,4,6,65,24,10,31
"2011","Chesterfield 002E","E01019568","Total",87,28,8,51,7,1,2,4,80,27,6,47
"2011","Chesterfield 003A","E01019527","Total",69,14,15,40,10,0,4,6,59,14,11,34
"2011","Chesterfield 003B","E01019529","Total",29,9,9,11,7,1,5,1,22,8,4,10
"2011","Chesterfield 003C","E01019530","Total",62,17,10,35,11,2,1,8,51,15,9,27
"2011","Chesterfield 003D","E01019531","Total",59,33,11,15,8,0,2,6,51,33,9,9
"2011","Chesterfield 003E","E01019553","Total",42,19,12,11,5,1,3,1,37,18,9,10
"2011","Chesterfield 004A","E01019541","Total",53,20,13,20,2,0,1,1,51,20,12,19
"2011","Chesterfield 004B","E01019542","Total",73,24,15,34,5,1,3,1,68,23,12,33
"2011","Chesterfield 004C","E01019543","Total",73,31,17,25,6,0,3,3,67,31,14,22
"2011","Chesterfield 004D","E01019544","Total",55,28,11,16,8,4,3,1,47,24,8,15
"2011","Chesterfield 004E","E01019571","Total",92,31,18,43,9,1,5,3,83,30,13,40
"2011","Chesterfield 005A","E01019532","Total",46,14,14,18,4,0,2,2,42,14,12,16
"2011","Chesterfield 005B","E01019533","Total",24,11,11,2,1,0,1,0,23,11,10,2
"2011","Chesterfield 005C","E01019534","Total",19,6,7,6,1,1,0,0,18,5,7,6
"2011","Chesterfield 005D","E01019535","Total",35,13,14,8,8,1,7,0,27,12,7,8
"2011","Chesterfield 005E","E01019536","Total",76,34,12,30,10,0,6,4,66,34,6,26
"2011","Chesterfield 006A","E01019549","Total",45,13,11,21,9,2,3,4,36,11,8,17
"2011","Chesterfield 006B","E01019550","Total",44,22,11,11,6,0,3,3,38,22,8,8
"2011","Chesterfield 006C","E01019551","Total",23,9,8,6,1,0,1,0,22,9,7,6
"2011","Chesterfield 006D","E01019552","Total",39,19,10,10,2,0,2,0,37,19,8,10
"2011","Chesterfield 006E","E01019567","Total",78,30,15,33,8,1,5,2,70,29,10,31
"2011","Chesterfield 007A","E01019537","Total",21,3,11,7,4,0,3,1,17,3,8,6
"2011","Chesterfield 007B","E01019569","Total",42,17,11,14,6,1,3,2,36,16,8,12
"2011","Chesterfield 007C","E01019570","Total",29,9,5,15,5,0,3,2,24,9,2,13
"2011","Chesterfield 007D","E01019580","Total",57,24,6,27,6,1,2,3,51,23,4,24
"2011","Chesterfield 007E","E01019581","Total",46,16,10,20,7,1,2,4,39,15,8,16
"2011","Chesterfield 008A","E01019557","Total",33,13,14,6,5,0,4,1,28,13,10,5
"2011","Chesterfield 008B","E01019558","Total",21,4,12,5,3,0,3,0,18,4,9,5
"2011","Chesterfield 008C","E01019559","Total",20,8,10,2,4,0,4,0,16,8,6,2
"2011","Chesterfield 008D","E01019560","Total",59,21,17,21,13,1,6,6,46,20,11,15
"2011","Chesterfield 008E","E01019561","Total",59,20,14,25,8,1,5,2,51,19,9,23
"2011","Chesterfield 008F","E01019562","Total",45,19,12,14,3,0,2,1,42,19,10,13
"2011","Chesterfield 009A","E01019539","Total",24,6,10,8,4,1,2,1,20,5,8,7
"2011","Chesterfield 009B","E01019540","Total",35,15,15,5,6,1,4,1,29,14,11,4
"2011","Chesterfield 009C","E01019555","Total",56,20,13,23,9,2,4,3,47,18,9,20
"2011","Chesterfield 009D","E01019590","Total",20,9,9,2,3,0,3,0,17,9,6,2
"2011","Chesterfield 009E","E01019591","Total",42,15,20,7,7,0,5,2,35,15,15,5
"2011","Chesterfield 010A","E01019538","Total",41,13,14,14,8,0,5,3,33,13,9,11
"2011","Chesterfield 010B","E01019554","Total",73,34,21,18,5,1,3,1,68,33,18,17
"2011","Chesterfield 010C","E01019556","Total",72,26,12,34,7,0,3,4,65,26,9,30
"2011","Chesterfield 010D","E01019579","Total",69,21,14,34,10,2,6,2,59,19,8,32
"2011","Chesterfield 010F","E01033387","Total",37,12,12,13,9,0,5,4,28,12,7,9
"2011","Chesterfield 010G","E01033388","Total",62,26,13,23,4,1,2,1,58,25,11,22
"2011","Chesterfield 011A","E01019586","Total",20,11,6,3,4,3,0,1,16,8,6,2
"2011","Chesterfield 011B","E01019587","Total",24,8,13,3,4,0,4,0,20,8,9,3
"2011","Chesterfield 011C","E01019588","Total",18,7,9,2,2,1,1,0,16,6,8,2
"2011","Chesterfield 011D","E01019589","Total",27,12,11,4,2,0,2,0,25,12,9,4
"2011","Chesterfield 011E","E01019592","Total",23,12,9,2,2,0,2,0,21,12,7,2
"2011","Chesterfield 011F","E01019593","Total",14,4,7,3,4,1,3,0,10,3,4,3
"2011","Chesterfield 012A","E01019545","Total",25,9,7,9,3,0,2,1,22,9,5,8
"2011","Chesterfield 012B","E01019546","Total",33,15,10,8,3,0,3,0,30,15,7,8
"2011","Chesterfield 012C","E01019547","Total",81,28,19,34,8,0,3,5,73,28,16,29
"2011","Chesterfield 012D","E01019548","Total",56,28,17,11,5,2,2,1,51,26,15,10
"2011","Chesterfield 012E","E01019582","Total",31,15,3,13,3,0,1,2,28,15,2,11
"2011","Chesterfield 012F","E01019583","Total",47,21,17,9,6,0,5,1,41,21,12,8
"2011","Chesterfield 012G","E01019585","Total",55,21,12,22,10,2,4,4,45,19,8,18
"2011","Chesterfield 013A","E01019575","Total",111,37,16,58,11,3,3,5,100,34,13,53
"2011","Chesterfield 013B","E01019576","Total",43,13,4,26,7,3,1,3,36,10,3,23
"2011","Chesterfield 013C","E01019577","Total",36,11,8,17,8,2,3,3,28,9,5,14
"2011","Chesterfield 013D","E01019578","Total",90,32,8,50,9,3,3,3,81,29,5,47
"2011","Derbyshire Dales 001A","E01019602","Total",40,17,13,10,6,0,6,0,34,17,7,10
"2011","Derbyshire Dales 001B","E01019614","Total",15,0,9,6,8,0,6,2,7,0,3,4
"2011","Derbyshire Dales 001C","E01019615","Total",36,17,13,6,6,1,4,1,30,16,9,5
"2011","Derbyshire Dales 001D","E01019631","Total",35,22,8,5,2,1,0,1,33,21,8,4
"2011","Derbyshire Dales 002A","E01019600","Total",25,8,13,4,8,5,3,0,17,3,10,4
"2011","Derbyshire Dales 002B","E01019604","Total",24,10,10,4,6,1,3,2,18,9,7,2
"2011","Derbyshire Dales 002C","E01019606","Total",21,12,6,3,3,2,1,0,18,10,5,3
"2011","Derbyshire Dales 002D","E01019618","Total",19,8,9,2,4,1,3,0,15,7,6,2
"2011","Derbyshire Dales 003A","E01019599","Total",19,5,9,5,1,0,1,0,18,5,8,5
"2011","Derbyshire Dales 003B","E01019601","Total",31,11,11,9,5,0,4,1,26,11,7,8
"2011","Derbyshire Dales 003C","E01019613","Total",21,11,5,5,2,0,2,0,19,11,3,5
"2011","Derbyshire Dales 003D","E01019617","Total",18,4,10,4,7,0,7,0,11,4,3,4
"2011","Derbyshire Dales 004A","E01019608","Total",56,33,9,14,5,1,3,1,51,32,6,13
"2011","Derbyshire Dales 004B","E01019610","Total",33,17,11,5,8,3,5,0,25,14,6,5
"2011","Derbyshire Dales 004C","E01019630","Total",47,27,11,9,5,1,4,0,42,26,7,9
"2011","Derbyshire Dales 005A","E01019609","Total",30,13,8,9,3,0,2,1,27,13,6,8
"2011","Derbyshire Dales 005B","E01019621","Total",21,4,9,8,3,0,1,2,18,4,8,6
"2011","Derbyshire Dales 005C","E01019622","Total",33,15,13,5,3,0,3,0,30,15,10,5
"2011","Derbyshire Dales 005D","E01019624","Total",28,10,16,2,5,1,4,0,23,9,12,2
"2011","Derbyshire Dales 005E","E01019627","Total",20,6,8,6,9,1,6,2,11,5,2,4
"2011","Derbyshire Dales 005F","E01019628","Total",29,9,10,10,5,1,3,1,24,8,7,9
"2011","Derbyshire Dales 006A","E01019619","Total",30,11,8,11,7,0,4,3,23,11,4,8
"2011","Derbyshire Dales 006B","E01019620","Total",25,9,10,6,11,2,7,2,14,7,3,4
"2011","Derbyshire Dales 006C","E01019623","Total",34,12,11,11,1,0,0,1,33,12,11,10
"2011","Derbyshire Dales 006D","E01019625","Total",67,25,12,30,6,1,2,3,61,24,10,27
"2011","Derbyshire Dales 006E","E01019626","Total",24,10,11,3,6,1,5,0,18,9,6,3
"2011","Derbyshire Dales 006F","E01019632","Total",21,7,9,5,3,0,3,0,18,7,6,5
"2011","Derbyshire Dales 007A","E01019633","Total",53,19,11,23,11,3,3,5,42,16,8,18
"2011","Derbyshire Dales 007B","E01019634","Total",28,13,11,4,4,0,2,2,24,13,9,2
"2011","Derbyshire Dales 007C","E01019635","Total",20,10,6,4,1,0,1,0,19,10,5,4
"2011","Derbyshire Dales 007D","E01019636","Total",31,14,9,8,7,1,4,2,24,13,5,6
"2011","Derbyshire Dales 008A","E01019595","Total",43,14,21,8,10,0,10,0,33,14,11,8
"2011","Derbyshire Dales 008B","E01019605","Total",26,10,8,8,2,0,1,1,24,10,7,7
"2011","Derbyshire Dales 008C","E01019611","Total",14,10,1,3,1,0,0,1,13,10,1,2
"2011","Derbyshire Dales 008D","E01019616","Total",33,13,11,9,8,0,6,2,25,13,5,7
"2011","Derbyshire Dales 009A","E01019594","Total",70,25,14,31,5,0,3,2,65,25,11,29
"2011","Derbyshire Dales 009B","E01019596","Total",27,15,5,7,4,0,4,0,23,15,1,7
"2011","Derbyshire Dales 009C","E01019597","Total",41,23,8,10,0,0,0,0,41,23,8,10
"2011","Derbyshire Dales 009D","E01019598","Total",68,16,22,30,6,0,3,3,62,16,19,27
"2011","Derbyshire Dales 010A","E01019603","Total",29,10,7,12,4,0,2,2,25,10,5,10
"2011","Derbyshire Dales 010B","E01019607","Total",23,12,9,2,2,1,1,0,21,11,8,2
"2011","Derbyshire Dales 010C","E01019612","Total",34,20,9,5,8,2,6,0,26,18,3,5
"2011","Derbyshire Dales 010D","E01019629","Total",28,9,9,10,5,1,3,1,23,8,6,9
"2011","Erewash 001A","E01019644","Total",49,14,6,29,9,1,4,4,40,13,2,25
"2011","Erewash 001B","E01019646","Total",99,28,24,47,11,1,3,7,88,27,21,40
"2011","Erewash 001C","E01019663","Total",92,20,15,57,7,0,1,6,85,20,14,51
"2011","Erewash 001D","E01019664","Total",62,20,5,37,5,1,0,4,57,19,5,33
"2011","Erewash 001E","E01019665","Total",48,15,10,23,12,0,5,7,36,15,5,16
"2011","Erewash 003A","E01019657","Total",74,22,18,34,9,0,7,2,65,22,11,32
"2011","Erewash 003B","E01019660","Total",45,20,10,15,5,0,4,1,40,20,6,14
"2011","Erewash 003C","E01019661","Total",50,14,13,23,11,0,5,6,39,14,8,17
"2011","Erewash 003D","E01019662","Total",64,15,11,38,4,0,1,3,60,15,10,35
"2011","Erewash 003E","E01019672","Total",61,20,15,26,9,1,4,4,52,19,11,22
"2011","Erewash 003F","E01019690","Total",47,15,11,21,10,3,3,4,37,12,8,17
"2011","Erewash 004A","E01019670","Total",36,14,13,9,3,0,3,0,33,14,10,9
"2011","Erewash 004B","E01019671","Total",22,13,9,0,4,1,3,0,18,12,6,0
"2011","Erewash 004C","E01019701","Total",42,11,16,15,6,0,6,0,36,11,10,15
"2011","Erewash 005A","E01019673","Total",14,4,4,6,3,0,1,2,11,4,3,4
"2011","Erewash 005B","E01019702","Total",29,16,8,5,3,1,2,0,26,15,6,5
"2011","Erewash 005C","E01019703","Total",28,7,15,6,4,0,4,0,24,7,11,6
"2011","Erewash 005D","E01019704","Total",13,9,2,2,2,1,1,0,11,8,1,2
"2011","Erewash 006A","E01019658","Total",68,20,20,28,9,1,2,6,59,19,18,22
"2011","Erewash 006B","E01019659","Total",41,20,12,9,6,1,4,1,35,19,8,8
"2011","Erewash 006C","E01019674","Total",33,11,15,7,8,2,6,0,25,9,9,7
"2011","Erewash 006D","E01019688","Total",61,15,15,31,5,1,4,0,56,14,11,31
"2011","Erewash 006E","E01019689","Total",46,19,17,10,3,0,2,1,43,19,15,9
"2011","Erewash 007A","E01019666","Total",68,26,8,34,8,2,4,2,60,24,4,32
"2011","Erewash 007B","E01019667","Total",70,22,12,36,5,0,4,1,65,22,8,35
"2011","Erewash 007C","E01019668","Total",53,15,9,29,6,1,4,1,47,14,5,28
"2011","Erewash 007D","E01019669","Total",23,9,4,10,4,0,2,2,19,9,2,8
"2011","Erewash 008A","E01019656","Total",8,1,4,3,2,0,1,1,6,1,3,2
"2011","Erewash 008B","E01019691","Total",42,17,12,13,5,2,2,1,37,15,10,12
"2011","Erewash 008C","E01019692","Total",72,25,10,37,4,0,1,3,68,25,9,34
"2011","Erewash 008D","E01019693","Total",99,28,32,39,10,0,7,3,89,28,25,36
"2011","Erewash 008E","E01019694","Total",20,6,11,3,1,0,1,0,19,6,10,3
"2011","Erewash 008F","E01019696","Total",17,4,7,6,3,1,1,1,14,3,6,5
"2011","Erewash 009A","E01019683","Total",28,14,7,7,3,1,1,1,25,13,6,6
"2011","Erewash 009B","E01019684","Total",33,15,10,8,5,1,2,2,28,14,8,6
"2011","Erewash 009C","E01019685","Total",17,9,3,5,1,1,0,0,16,8,3,5
"2011","Erewash 009D","E01019686","Total",24,8,14,2,3,0,3,0,21,8,11,2
"2011","Erewash 009E","E01019687","Total",60,28,13,19,7,1,3,3,53,27,10,16
"2011","Erewash 010A","E01019648","Total",44,14,19,11,3,1,2,0,41,13,17,11
"2011","Erewash 010B","E01019649","Total",69,22,26,21,6,3,3,0,63,19,23,21
"2011","Erewash 010C","E01019650","Total",80,26,11,43,5,0,2,3,75,26,9,40
"2011","Erewash 010D","E01019651","Total",38,13,7,18,1,0,0,1,37,13,7,17
"2011","Erewash 010E","E01019695","Total",43,12,18,13,8,2,4,2,35,10,14,11
"2011","Erewash 011A","E01019641","Total",14,5,9,0,1,0,1,0,13,5,8,0
"2011","Erewash 011B","E01019652","Total",49,17,16,16,5,1,3,1,44,16,13,15
"2011","Erewash 011C","E01019653","Total",21,5,9,7,4,0,3,1,17,5,6,6
"2011","Erewash 011D","E01019707","Total",50,16,22,12,8,1,6,1,42,15,16,11
"2011","Erewash 011E","E01019708","Total",35,16,16,3,8,1,7,0,27,15,9,3
"2011","Erewash 012A","E01019647","Total",112,32,28,52,14,1,8,5,98,31,20,47
"2011","Erewash 012B","E01019675","Total",74,26,16,32,4,0,3,1,70,26,13,31
"2011","Erewash 012C","E01019679","Total",60,15,13,32,6,0,2,4,54,15,11,28
"2011","Erewash 012D","E01019682","Total",78,28,20,30,8,0,7,1,70,28,13,29
"2011","Erewash 013A","E01019642","Total",35,16,12,7,3,0,1,2,32,16,11,5
"2011","Erewash 013B","E01019643","Total",25,7,11,7,7,0,5,2,18,7,6,5
"2011","Erewash 013C","E01019654","Total",41,13,17,11,7,1,5,1,34,12,12,10
"2011","Erewash 013D","E01019655","Total",67,23,26,18,8,1,7,0,59,22,19,18
"2011","Erewash 014A","E01019676","Total",65,23,24,18,7,0,4,3,58,23,20,15
"2011","Erewash 014B","E01019677","Total",28,11,10,7,2,0,1,1,26,11,9,6
"2011","Erewash 014C","E01019678","Total",49,23,17,9,8,1,4,3,41,22,13,6
"2011","Erewash 014D","E01019680","Total",43,12,14,17,4,0,3,1,39,12,11,16
"2011","Erewash 014E","E01019681","Total",30,17,7,6,4,1,3,0,26,16,4,6
"2011","Erewash 014F","E01019698","Total",34,13,13,8,1,1,0,0,33,12,13,8
"2011","Erewash 015A","E01019697","Total",46,15,12,19,2,0,2,0,44,15,10,19
"2011","Erewash 015B","E01019699","Total",77,25,13,39,6,1,2,3,71,24,11,36
"2011","Erewash 015C","E01019700","Total",56,18,21,17,4,0,3,1,52,18,18,16
"2011","Erewash 015D","E01019705","Total",59,25,19,15,6,1,5,0,53,24,14,15
"2011","Erewash 015E","E01019706","Total",22,8,8,6,2,0,1,1,20,8,7,5
"2011","Erewash 015F","E01019709","Total",70,21,18,31,10,2,6,2,60,19,12,29
"2011","Erewash 016A","E01019638","Total",21,9,9,3,6,0,6,0,15,9,3,3
"2011","Erewash 016B","E01019639","Total",40,21,8,11,4,1,3,0,36,20,5,11
"2011","Erewash 016C","E01019640","Total",30,6,16,8,2,0,2,0,28,6,14,8
"2011","Erewash 016D","E01019645","Total",36,15,10,11,6,1,2,3,30,14,8,8
"2011","Erewash 016E","E01032614","Total",27,10,11,6,6,1,5,0,21,9,6,6
"2011","High Peak 001A","E01019733","Total",59,25,16,18,5,2,1,2,54,23,15,16
"2011","High Peak 001B","E01019752","Total",63,20,22,21,3,0,3,0,60,20,19,21
"2011","High Peak 001C","E01019753","Total",43,14,15,14,6,0,2,4,37,14,13,10
"2011","High Peak 001D","E01019763","Total",69,20,26,23,11,1,7,3,58,19,19,20
"2011","High Peak 002A","E01019728","Total",79,22,18,39,2,0,0,2,77,22,18,37
"2011","High Peak 002B","E01019729","Total",86,20,13,53,8,1,1,6,78,19,12,47
"2011","High Peak 002C","E01019730","Total",103,38,33,32,11,2,6,3,92,36,27,29
"2011","High Peak 002D","E01019731","Total",26,4,15,7,2,0,1,1,24,4,14,6
"2011","High Peak 002E","E01019732","Total",38,8,15,15,5,0,5,0,33,8,10,15
"2011","High Peak 003A","E01019738","Total",57,28,20,9,7,3,3,1,50,25,17,8
"2011","High Peak 003B","E01019739","Total",56,15,23,18,8,1,3,4,48,14,20,14
"2011","High Peak 003C","E01019740","Total",33,11,12,10,5,0,3,2,28,11,9,8
"2011","High Peak 003D","E01019750","Total",45,13,9,23,5,0,1,4,40,13,8,19
"2011","High Peak 003E","E01019751","Total",38,10,18,10,7,0,5,2,31,10,13,8
"2011","High Peak 003F","E01019768","Total",81,25,16,40,9,1,2,6,72,24,14,34
"2011","High Peak 004A","E01019727","Total",16,7,6,3,2,1,1,0,14,6,5,3
"2011","High Peak 004B","E01019749","Total",23,8,11,4,3,0,3,0,20,8,8,4
"2011","High Peak 004C","E01019754","Total",22,11,6,5,3,1,1,1,19,10,5,4
"2011","High Peak 004D","E01019756","Total",40,12,24,4,12,2,10,0,28,10,14,4
"2011","High Peak 004E","E01019757","Total",32,15,12,5,2,2,0,0,30,13,12,5
"2011","High Peak 004F","E01019758","Total",25,5,13,7,2,1,0,1,23,4,13,6
"2011","High Peak 005A","E01019746","Total",28,5,10,13,4,0,2,2,24,5,8,11
"2011","High Peak 005B","E01019747","Total",25,11,10,4,4,0,3,1,21,11,7,3
"2011","High Peak 005C","E01019748","Total",35,12,12,11,6,1,3,2,29,11,9,9
"2011","High Peak 005D","E01019755","Total",30,12,16,2,6,0,6,0,24,12,10,2
"2011","High Peak 005E","E01019766","Total",28,7,8,13,4,0,3,1,24,7,5,12
"2011","High Peak 006A","E01019711","Total",36,15,10,11,0,0,0,0,36,15,10,11
"2011","High Peak 006B","E01019734","Total",43,13,21,9,10,3,7,0,33,10,14,9
"2011","High Peak 006C","E01019743","Total",66,24,16,26,8,0,3,5,58,24,13,21
"2011","High Peak 006D","E01019744","Total",37,13,10,14,3,1,2,0,34,12,8,14
"2011","High Peak 006E","E01019745","Total",43,17,12,14,4,1,2,1,39,16,10,13
"2011","High Peak 008A","E01019712","Total",24,11,8,5,5,0,4,1,19,11,4,4
"2011","High Peak 008B","E01019713","Total",11,5,4,2,2,0,2,0,9,5,2,2
"2011","High Peak 008C","E01019764","Total",27,16,6,5,4,1,3,0,23,15,3,5
"2011","High Peak 008D","E01019765","Total",56,27,15,14,6,1,4,1,50,26,11,13
"2011","High Peak 008E","E01019767","Total",39,15,9,15,2,0,1,1,37,15,8,14
"2011","High Peak 010A","E01019710","Total",48,12,19,17,10,0,7,3,38,12,12,14
"2011","High Peak 010B","E01019715","Total",54,13,12,29,7,2,2,3,47,11,10,26
"2011","High Peak 010C","E01019717","Total",37,14,12,11,4,1,2,1,33,13,10,10
"2011","High Peak 010D","E01019722","Total",41,21,11,9,9,2,5,2,32,19,6,7
"2011","High Peak 010E","E01019723","Total",25,6,11,8,6,1,4,1,19,5,7,7
"2011","High Peak 011A","E01019716","Total",34,15,13,6,11,1,7,3,23,14,6,3
"2011","High Peak 011B","E01019724","Total",51,21,11,19,8,0,2,6,43,21,9,13
"2011","High Peak 011C","E01019759","Total",70,25,17,28,4,1,1,2,66,24,16,26
"2011","High Peak 011D","E01019760","Total",48,15,17,16,9,0,5,4,39,15,12,12
"2011","High Peak 011E","E01019761","Total",93,28,13,52,6,0,5,1,87,28,8,51
"2011","High Peak 012A","E01019714","Total",64,23,25,16,10,0,9,1,54,23,16,15
"2011","High Peak 012B","E01019725","Total",33,20,7,6,6,2,3,1,27,18,4,5
"2011","High Peak 012C","E01019726","Total",40,15,12,13,9,1,4,4,31,14,8,9
"2011","High Peak 012D","E01019762","Total",14,4,8,2,4,0,3,1,10,4,5,1
"2011","High Peak 013E","E01019718","Total",62,26,23,13,6,1,5,0,56,25,18,13
"2011","High Peak 013F","E01019719","Total",54,16,16,22,3,0,2,1,51,16,14,21
"2011","High Peak 013G","E01019720","Total",26,16,5,5,3,1,2,0,23,15,3,5
"2011","High Peak 013H","E01019721","Total",24,9,11,4,3,0,3,0,21,9,8,4
"2011","High Peak 013A","E01019735","Total",20,7,8,5,5,2,3,0,15,5,5,5
"2011","High Peak 013B","E01019736","Total",14,6,5,3,1,0,1,0,13,6,4,3
"2011","High Peak 013C","E01019737","Total",26,13,8,5,4,1,2,1,22,12,6,4
"2011","High Peak 013I","E01019741","Total",21,13,3,5,2,0,1,1,19,13,2,4
"2011","High Peak 013D","E01019742","Total",28,10,11,7,8,1,5,2,20,9,6,5
"2011","North East Derbyshire 001A","E01019801","Total",23,11,7,5,5,1,3,1,18,10,4,4
"2011","North East Derbyshire 001B","E01019802","Total",23,8,7,8,4,1,3,0,19,7,4,8
"2011","North East Derbyshire 001C","E01019803","Total",45,14,9,22,3,0,1,2,42,14,8,20
"2011","North East Derbyshire 001D","E01019804","Total",29,12,13,4,4,0,3,1,25,12,10,3
"2011","North East Derbyshire 001E","E01019805","Total",36,13,16,7,5,0,4,1,31,13,12,6
"2011","North East Derbyshire 001F","E01019806","Total",35,18,12,5,3,0,2,1,32,18,10,4
"2011","North East Derbyshire 001G","E01019807","Total",64,20,14,30,4,2,1,1,60,18,13,29
"2011","North East Derbyshire 002A","E01019778","Total",22,7,7,8,8,1,4,3,14,6,3,5
"2011","North East Derbyshire 002B","E01019779","Total",20,10,7,3,3,0,3,0,17,10,4,3
"2011","North East Derbyshire 002C","E01019790","Total",34,15,12,7,6,0,6,0,28,15,6,7
"2011","North East Derbyshire 002D","E01019816","Total",23,5,10,8,3,1,1,1,20,4,9,7
"2011","North East Derbyshire 004A","E01019780","Total",58,32,16,10,4,1,3,0,54,31,13,10
"2011","North East Derbyshire 004B","E01019781","Total",24,8,10,6,5,0,4,1,19,8,6,5
"2011","North East Derbyshire 004C","E01019782","Total",29,12,12,5,5,1,4,0,24,11,8,5
"2011","North East Derbyshire 004D","E01019786","Total",55,27,17,11,6,1,4,1,49,26,13,10
"2011","North East Derbyshire 004E","E01019827","Total",47,14,14,19,4,0,3,1,43,14,11,18
"2011","North East Derbyshire 005A","E01019770","Total",25,9,11,5,3,0,3,0,22,9,8,5
"2011","North East Derbyshire 005B","E01019787","Total",30,17,9,4,3,0,2,1,27,17,7,3
"2011","North East Derbyshire 005C","E01019788","Total",19,3,14,2,8,0,7,1,11,3,7,1
"2011","North East Derbyshire 005D","E01019794","Total",7,3,1,3,0,0,0,0,7,3,1,3
"2011","North East Derbyshire 006A","E01019783","Total",29,10,15,4,4,2,2,0,25,8,13,4
"2011","North East Derbyshire 006B","E01019784","Total",14,6,7,1,0,0,0,0,14,6,7,1
"2011","North East Derbyshire 006C","E01019785","Total",21,8,8,5,2,0,2,0,19,8,6,5
"2011","North East Derbyshire 006D","E01019793","Total",16,7,5,4,1,0,1,0,15,7,4,4
"2011","North East Derbyshire 006E","E01019795","Total",53,16,24,13,4,0,3,1,49,16,21,12
"2011","North East Derbyshire 007A","E01019798","Total",14,2,7,5,4,0,3,1,10,2,4,4
"2011","North East Derbyshire 007B","E01019821","Total",26,9,8,9,4,0,2,2,22,9,6,7
"2011","North East Derbyshire 007C","E01019822","Total",17,7,5,5,1,0,1,0,16,7,4,5
"2011","North East Derbyshire 007D","E01019823","Total",34,18,7,9,5,2,1,2,29,16,6,7
"2011","North East Derbyshire 008A","E01019771","Total",27,13,9,5,1,0,1,0,26,13,8,5
"2011","North East Derbyshire 008B","E01019772","Total",25,6,14,5,4,1,3,0,21,5,11,5
"2011","North East Derbyshire 008C","E01019828","Total",12,5,6,1,3,2,1,0,9,3,5,1
"2011","North East Derbyshire 008D","E01019829","Total",19,10,8,1,1,0,1,0,18,10,7,1
"2011","North East Derbyshire 009A","E01019796","Total",46,18,7,21,4,1,2,1,42,17,5,20
"2011","North East Derbyshire 009B","E01019797","Total",40,17,6,17,6,1,2,3,34,16,4,14
"2011","North East Derbyshire 009C","E01019799","Total",88,30,10,48,7,0,1,6,81,30,9,42
"2011","North East Derbyshire 009D","E01019800","Total",56,21,19,16,7,0,5,2,49,21,14,14
"2011","North East Derbyshire 009E","E01019808","Total",73,17,13,43,4,0,1,3,69,17,12,40
"2011","North East Derbyshire 009F","E01019826","Total",45,17,10,18,5,1,3,1,40,16,7,17
"2011","North East Derbyshire 010A","E01019769","Total",22,10,8,4,6,0,5,1,16,10,3,3
"2011","North East Derbyshire 010B","E01019774","Total",17,7,8,2,7,1,6,0,10,6,2,2
"2011","North East Derbyshire 010C","E01019824","Total",25,13,9,3,3,0,2,1,22,13,7,2
"2011","North East Derbyshire 010D","E01019830","Total",24,12,12,0,2,0,2,0,22,12,10,0
"2011","North East Derbyshire 010E","E01019831","Total",22,10,10,2,3,1,2,0,19,9,8,2
"2011","North East Derbyshire 011A","E01019809","Total",15,3,6,6,1,0,1,0,14,3,5,6
"2011","North East Derbyshire 011B","E01019810","Total",51,17,15,19,8,0,5,3,43,17,10,16
"2011","North East Derbyshire 011C","E01019811","Total",28,10,12,6,6,1,5,0,22,9,7,6
"2011","North East Derbyshire 011D","E01019812","Total",37,15,12,10,4,1,1,2,33,14,11,8
"2011","North East Derbyshire 011E","E01019813","Total",55,23,18,14,7,1,2,4,48,22,16,10
"2011","North East Derbyshire 011F","E01019825","Total",24,10,9,5,5,0,3,2,19,10,6,3
"2011","North East Derbyshire 012A","E01019773","Total",77,28,21,28,8,0,5,3,69,28,16,25
"2011","North East Derbyshire 012B","E01019775","Total",44,14,14,16,7,0,6,1,37,14,8,15
"2011","North East Derbyshire 012C","E01019776","Total",33,11,7,15,5,1,1,3,28,10,6,12
"2011","North East Derbyshire 012D","E01019777","Total",98,32,21,45,12,0,6,6,86,32,15,39
"2011","North East Derbyshire 013A","E01019814","Total",26,10,11,5,4,0,2,2,22,10,9,3
"2011","North East Derbyshire 013B","E01019817","Total",33,11,4,18,1,0,0,1,32,11,4,17
"2011","North East Derbyshire 013C","E01019818","Total",50,17,10,23,6,0,3,3,44,17,7,20
"2011","North East Derbyshire 013D","E01019819","Total",19,8,4,7,3,0,2,1,16,8,2,6
"2011","North East Derbyshire 013E","E01019820","Total",23,5,5,13,2,0,2,0,21,5,3,13
"2011","North East Derbyshire 014A","E01019791","Total",52,17,17,18,7,0,6,1,45,17,11,17
"2011","North East Derbyshire 014B","E01019792","Total",59,25,14,20,2,1,0,1,57,24,14,19
"2011","North East Derbyshire 014C","E01019815","Total",73,29,24,20,12,0,11,1,61,29,13,19
"2011","North East Derbyshire 014D","E01032586","Total",56,28,6,22,4,0,0,4,52,28,6,18
"2011","South Derbyshire 001A","E01019839","Total",21,8,8,5,6,0,3,3,15,8,5,2
"2011","South Derbyshire 001B","E01019845","Total",28,10,10,8,3,0,2,1,25,10,8,7
"2011","South Derbyshire 001C","E01019846","Total",38,14,8,16,5,0,2,3,33,14,6,13
"2011","South Derbyshire 001D","E01019866","Total",33,9,15,9,8,1,6,1,25,8,9,8
"2011","South Derbyshire 002A","E01019840","Total",40,16,8,16,1,1,0,0,39,15,8,16
"2011","South Derbyshire 002B","E01019841","Total",19,8,8,3,3,1,2,0,16,7,6,3
"2011","South Derbyshire 002C","E01019847","Total",29,9,16,4,5,0,3,2,24,9,13,2
"2011","South Derbyshire 002D","E01019848","Total",64,23,31,10,9,3,6,0,55,20,25,10
"2011","South Derbyshire 002F","E01033532","Total",48,14,22,12,2,0,1,1,46,14,21,11
"2011","South Derbyshire 002G","E01033533","Total",49,17,23,9,4,1,3,0,45,16,20,9
"2011","South Derbyshire 002H","E01033534","Total",33,7,18,8,1,0,1,0,32,7,17,8
"2011","South Derbyshire 003A","E01019873","Total",54,18,17,19,3,0,3,0,51,18,14,19
"2011","South Derbyshire 003B","E01019874","Total",35,12,12,11,0,0,0,0,35,12,12,11
"2011","South Derbyshire 003C","E01019875","Total",36,15,16,5,1,0,1,0,35,15,15,5
"2011","South Derbyshire 003D","E01019881","Total",21,10,8,3,4,2,2,0,17,8,6,3
"2011","South Derbyshire 003E","E01019882","Total",41,18,12,11,4,1,3,0,37,17,9,11
"2011","South Derbyshire 004A","E01019832","Total",24,12,6,6,2,1,1,0,22,11,5,6
"2011","South Derbyshire 004B","E01019833","Total",25,9,10,6,6,0,6,0,19,9,4,6
"2011","South Derbyshire 004C","E01019834","Total",26,11,12,3,5,1,4,0,21,10,8,3
"2011","South Derbyshire 004D","E01019835","Total",22,5,12,5,2,0,2,0,20,5,10,5
"2011","South Derbyshire 005A","E01019867","Total",14,6,6,2,4,0,3,1,10,6,3,1
"2011","South Derbyshire 005B","E01019868","Total",32,14,9,9,1,0,0,1,31,14,9,8
"2011","South Derbyshire 005C","E01019869","Total",15,3,6,6,3,0,3,0,12,3,3,6
"2011","South Derbyshire 005D","E01019880","Total",36,12,18,6,12,0,9,3,24,12,9,3
"2011","South Derbyshire 006A","E01019843","Total",28,4,13,11,3,0,3,0,25,4,10,11
"2011","South Derbyshire 006B","E01019853","Total",30,16,8,6,5,1,3,1,25,15,5,5
"2011","South Derbyshire 006C","E01019854","Total",36,10,12,14,5,0,3,2,31,10,9,12
"2011","South Derbyshire 006D","E01019855","Total",37,14,11,12,5,0,3,2,32,14,8,10
"2011","South Derbyshire 007A","E01019844","Total",46,18,8,20,4,1,0,3,42,17,8,17
"2011","South Derbyshire 007B","E01019856","Total",71,38,7,26,2,0,1,1,69,38,6,25
"2011","South Derbyshire 007C","E01019857","Total",29,13,5,11,5,0,2,3,24,13,3,8
"2011","South Derbyshire 007D","E01019858","Total",88,33,14,41,8,4,0,4,80,29,14,37
"2011","South Derbyshire 007E","E01019859","Total",32,15,10,7,5,1,4,0,27,14,6,7
"2011","South Derbyshire 008A","E01019860","Total",27,14,8,5,7,0,5,2,20,14,3,3
"2011","South Derbyshire 008B","E01019861","Total",46,22,11,13,4,1,2,1,42,21,9,12
"2011","South Derbyshire 008C","E01019862","Total",37,15,9,13,3,0,3,0,34,15,6,13
"2011","South Derbyshire 008D","E01019863","Total",76,27,10,39,7,3,1,3,69,24,9,36
"2011","South Derbyshire 008E","E01019864","Total",47,15,8,24,1,0,0,1,46,15,8,23
"2011","South Derbyshire 008F","E01019865","Total",41,19,7,15,1,0,1,0,40,19,6,15
"2011","South Derbyshire 009A","E01019876","Total",43,12,13,18,7,2,2,3,36,10,11,15
"2011","South Derbyshire 009B","E01019877","Total",55,26,11,18,1,1,0,0,54,25,11,18
"2011","South Derbyshire 009C","E01019878","Total",42,19,9,14,5,0,3,2,37,19,6,12
"2011","South Derbyshire 009D","E01019879","Total",17,6,7,4,5,0,4,1,12,6,3,3
"2011","South Derbyshire 011A","E01019850","Total",15,5,6,4,0,0,0,0,15,5,6,4
"2011","South Derbyshire 011B","E01019851","Total",49,12,18,19,8,0,4,4,41,12,14,15
"2011","South Derbyshire 011C","E01019852","Total",41,13,11,17,5,2,3,0,36,11,8,17
"2011","South Derbyshire 011D","E01019870","Total",29,9,9,11,5,1,4,0,24,8,5,11
"2011","South Derbyshire 011E","E01019871","Total",38,16,9,13,4,0,2,2,34,16,7,11
"2011","South Derbyshire 011F","E01019872","Total",33,16,7,10,3,0,1,2,30,16,6,8
"2011","South Derbyshire 012A","E01019837","Total",78,23,18,37,9,1,4,4,69,22,14,33
"2011","South Derbyshire 012B","E01019838","Total",61,19,14,28,4,1,1,2,57,18,13,26
"2011","South Derbyshire 012C","E01033531","Total",43,18,14,11,6,0,6,0,37,18,8,11
"2011","South Derbyshire 012D","E01033536","Total",59,21,17,21,6,1,4,1,53,20,13,20
"2011","South Derbyshire 012E","E01033537","Total",63,30,12,21,4,1,3,0,59,29,9,21
"2011","South Derbyshire 013A","E01019842","Total",85,28,13,44,10,2,5,3,75,26,8,41
"2011","South Derbyshire 013B","E01019883","Total",103,43,28,32,7,1,6,0,96,42,22,32
"2011","South Derbyshire 013C","E01019885","Total",37,9,17,11,7,0,7,0,30,9,10,11
"2011","South Derbyshire 013D","E01033535","Total",41,9,18,14,8,2,4,2,33,7,14,12
"2011","Blaby 002A","E01025631","Total",39,19,12,8,3,1,2,0,36,18,10,8
"2011","Blaby 002B","E01025632","Total",30,12,16,2,3,0,3,0,27,12,13,2
"2011","Blaby 002C","E01025633","Total",34,19,12,3,7,2,4,1,27,17,8,2
"2011","Blaby 002D","E01025635","Total",23,12,8,3,6,1,3,2,17,11,5,1
"2011","Blaby 003A","E01025634","Total",20,18,0,2,0,0,0,0,20,18,0,2
"2011","Blaby 003B","E01025638","Total",17,6,9,2,4,1,3,0,13,5,6,2
"2011","Blaby 003C","E01025639","Total",20,10,4,6,2,0,0,2,18,10,4,4
"2011","Blaby 003D","E01025640","Total",39,15,12,12,9,1,7,1,30,14,5,11
"2011","Blaby 003E","E01025645","Total",25,15,8,2,3,0,3,0,22,15,5,2
"2011","Blaby 004A","E01025666","Total",49,24,15,10,9,2,5,2,40,22,10,8
"2011","Blaby 004B","E01025667","Total",24,13,7,4,3,0,3,0,21,13,4,4
"2011","Blaby 004C","E01025668","Total",81,24,38,19,10,1,6,3,71,23,32,16
"2011","Blaby 004D","E01025669","Total",54,23,15,16,6,2,3,1,48,21,12,15
"2011","Blaby 005A","E01025636","Total",27,11,8,8,4,2,2,0,23,9,6,8
"2011","Blaby 005B","E01025637","Total",46,21,14,11,7,2,5,0,39,19,9,11
"2011","Blaby 005C","E01025652","Total",36,15,14,7,3,0,2,1,33,15,12,6
"2011","Blaby 005D","E01025653","Total",60,24,19,17,8,1,6,1,52,23,13,16
"2011","Blaby 005E","E01025654","Total",27,8,9,10,1,0,1,0,26,8,8,10
"2011","Blaby 005F","E01025655","Total",37,11,13,13,4,0,2,2,33,11,11,11
"2011","Blaby 005G","E01025656","Total",34,13,15,6,7,1,6,0,27,12,9,6
"2011","Blaby 006A","E01025625","Total",73,25,15,33,9,2,3,4,64,23,12,29
"2011","Blaby 006B","E01025626","Total",34,11,12,11,2,0,2,0,32,11,10,11
"2011","Blaby 006C","E01025627","Total",73,27,26,20,4,0,2,2,69,27,24,18
"2011","Blaby 006D","E01025651","Total",36,13,20,3,7,0,7,0,29,13,13,3
"2011","Blaby 006E","E01025657","Total",28,7,12,9,4,0,3,1,24,7,9,8
"2011","Blaby 006F","E01025660","Total",26,11,8,7,5,0,4,1,21,11,4,6
"2011","Blaby 007A","E01025641","Total",33,11,14,8,4,1,2,1,29,10,12,7
"2011","Blaby 007B","E01025642","Total",63,23,19,21,7,2,3,2,56,21,16,19
"2011","Blaby 007C","E01025643","Total",53,19,17,17,6,0,3,3,47,19,14,14
"2011","Blaby 007D","E01025649","Total",25,6,15,4,7,1,6,0,18,5,9,4
"2011","Blaby 007E","E01025650","Total",63,33,18,12,11,3,6,2,52,30,12,10
"2011","Blaby 008A","E01025610","Total",59,34,11,14,9,2,5,2,50,32,6,12
"2011","Blaby 008B","E01025611","Total",37,15,12,10,0,0,0,0,37,15,12,10
"2011","Blaby 008C","E01025612","Total",29,11,12,6,5,1,4,0,24,10,8,6
"2011","Blaby 008D","E01025658","Total",56,21,22,13,16,4,11,1,40,17,11,12
"2011","Blaby 008E","E01025659","Total",45,19,19,7,9,2,7,0,36,17,12,7
"2011","Blaby 009A","E01025615","Total",37,18,13,6,3,0,3,0,34,18,10,6
"2011","Blaby 009B","E01025646","Total",71,34,18,19,4,1,3,0,67,33,15,19
"2011","Blaby 009C","E01025647","Total",55,27,15,13,4,2,1,1,51,25,14,12
"2011","Blaby 009D","E01025648","Total",51,26,18,7,8,2,6,0,43,24,12,7
"2011","Blaby 010A","E01025613","Total",22,9,9,4,4,0,3,1,18,9,6,3
"2011","Blaby 010B","E01025614","Total",46,19,20,7,2,0,2,0,44,19,18,7
"2011","Blaby 010C","E01025620","Total",41,15,16,10,7,0,6,1,34,15,10,9
"2011","Blaby 010D","E01025621","Total",18,5,8,5,4,0,2,2,14,5,6,3
"2011","Blaby 010E","E01025644","Total",44,17,12,15,8,0,5,3,36,17,7,12
"2011","Blaby 011A","E01025616","Total",20,12,6,2,3,0,2,1,17,12,4,1
"2011","Blaby 011B","E01025617","Total",40,27,10,3,3,0,3,0,37,27,7,3
"2011","Blaby 011C","E01025618","Total",36,16,13,7,5,1,4,0,31,15,9,7
"2011","Blaby 011D","E01025619","Total",25,15,5,5,1,1,0,0,24,14,5,5
"2011","Blaby 012A","E01025661","Total",48,20,16,12,3,2,1,0,45,18,15,12
"2011","Blaby 012B","E01025662","Total",56,22,15,19,11,1,5,5,45,21,10,14
"2011","Blaby 012C","E01025663","Total",20,7,6,7,1,1,0,0,19,6,6,7
"2011","Blaby 012D","E01025664","Total",13,3,6,4,4,0,3,1,9,3,3,3
"2011","Blaby 012E","E01025665","Total",21,5,9,7,10,0,6,4,11,5,3,3
"2011","Blaby 013A","E01025622","Total",45,21,9,15,7,0,4,3,38,21,5,12
"2011","Blaby 013B","E01025623","Total",34,15,11,8,4,0,4,0,30,15,7,8
"2011","Blaby 013C","E01025624","Total",32,13,17,2,2,0,2,0,30,13,15,2
"2011","Blaby 013D","E01025629","Total",41,14,17,10,9,0,5,4,32,14,12,6
"2011","Blaby 013E","E01025630","Total",18,11,5,2,5,1,3,1,13,10,2,1
"2011","Blaby 013F","E01032603","Total",26,8,10,8,6,0,5,1,20,8,5,7
"2011","Charnwood 001B","E01025692","Total",49,19,12,18,6,0,3,3,43,19,9,15
"2011","Charnwood 001C","E01025693","Total",34,15,9,10,0,0,0,0,34,15,9,10
"2011","Charnwood 001E","E01033386","Total",46,13,17,16,7,0,6,1,39,13,11,15
"2011","Charnwood 002A","E01025699","Total",60,13,15,32,9,0,3,6,51,13,12,26
"2011","Charnwood 002B","E01025700","Total",69,23,11,35,4,1,3,0,65,22,8,35
"2011","Charnwood 002C","E01025701","Total",43,16,11,16,2,0,1,1,41,16,10,15
"2011","Charnwood 002D","E01025703","Total",42,9,16,17,10,0,7,3,32,9,9,14
"2011","Charnwood 002E","E01025704","Total",31,15,6,10,1,0,1,0,30,15,5,10
"2011","Charnwood 002F","E01025705","Total",39,10,4,25,2,0,0,2,37,10,4,23
"2011","Charnwood 002G","E01025706","Total",54,15,22,17,9,3,4,2,45,12,18,15
"2011","Charnwood 003A","E01025720","Total",24,10,6,8,0,0,0,0,24,10,6,8
"2011","Charnwood 003B","E01025721","Total",10,2,4,4,3,1,2,0,7,1,2,4
"2011","Charnwood 003C","E01025722","Total",20,12,4,4,2,0,2,0,18,12,2,4
"2011","Charnwood 003D","E01025723","Total",31,9,1,21,1,0,0,1,30,9,1,20
"2011","Charnwood 003E","E01025724","Total",21,6,7,8,4,0,2,2,17,6,5,6
"2011","Charnwood 003F","E01025725","Total",52,20,7,25,1,1,0,0,51,19,7,25
"2011","Charnwood 004A","E01025695","Total",18,6,7,5,4,0,3,1,14,6,4,4
"2011","Charnwood 004B","E01025696","Total",18,4,9,5,2,0,1,1,16,4,8,4
"2011","Charnwood 004C","E01025697","Total",29,9,11,9,5,0,4,1,24,9,7,8
"2011","Charnwood 004D","E01025698","Total",30,16,6,8,1,0,0,1,29,16,6,7
"2011","Charnwood 005A","E01025744","Total",43,19,18,6,8,0,7,1,35,19,11,5
"2011","Charnwood 005B","E01025745","Total",24,6,11,7,3,0,3,0,21,6,8,7
"2011","Charnwood 005C","E01025746","Total",69,28,16,25,4,3,1,0,65,25,15,25
"2011","Charnwood 005D","E01025747","Total",68,19,27,22,9,0,7,2,59,19,20,20
"2011","Charnwood 006A","E01025740","Total",46,16,16,14,6,1,4,1,40,15,12,13
"2011","Charnwood 006B","E01025741","Total",14,7,6,1,1,0,1,0,13,7,5,1
"2011","Charnwood 006C","E01025742","Total",64,24,21,19,7,2,5,0,57,22,16,19
"2011","Charnwood 006D","E01025743","Total",50,20,22,8,8,0,8,0,42,20,14,8
"2011","Charnwood 007A","E01025689","Total",54,22,7,25,3,0,2,1,51,22,5,24
"2011","Charnwood 007B","E01025690","Total",45,17,5,23,0,0,0,0,45,17,5,23
"2011","Charnwood 007C","E01025707","Total",14,4,7,3,2,0,2,0,12,4,5,3
"2011","Charnwood 007D","E01025709","Total",10,3,6,1,0,0,0,0,10,3,6,1
"2011","Charnwood 008A","E01025760","Total",16,9,5,2,1,0,1,0,15,9,4,2
"2011","Charnwood 008B","E01025761","Total",31,15,9,7,6,2,3,1,25,13,6,6
"2011","Charnwood 008C","E01025768","Total",21,10,8,3,4,0,4,0,17,10,4,3
"2011","Charnwood 008D","E01025769","Total",16,3,9,4,2,0,2,0,14,3,7,4
"2011","Charnwood 009A","E01025702","Total",21,13,5,3,3,3,0,0,18,10,5,3
"2011","Charnwood 009B","E01025715","Total",74,27,13,34,3,0,2,1,71,27,11,33
"2011","Charnwood 009C","E01025716","Total",51,17,19,15,6,1,4,1,45,16,15,14
"2011","Charnwood 009D","E01025717","Total",97,34,17,46,2,0,1,1,95,34,16,45
"2011","Charnwood 009E","E01025718","Total",40,12,8,20,3,0,3,0,37,12,5,20
"2011","Charnwood 009F","E01025719","Total",20,10,9,1,2,0,2,0,18,10,7,1
"2011","Charnwood 010A","E01025708","Total",13,4,6,3,4,1,3,0,9,3,3,3
"2011","Charnwood 010B","E01025710","Total",8,5,3,0,1,0,1,0,7,5,2,0
"2011","Charnwood 010C","E01025711","Total",17,6,8,3,2,1,0,1,15,5,8,2
"2011","Charnwood 010D","E01025712","Total",15,7,6,2,3,2,1,0,12,5,5,2
"2011","Charnwood 010E","E01025713","Total",22,4,18,0,6,0,6,0,16,4,12,0
"2011","Charnwood 010F","E01025714","Total",39,16,13,10,5,2,3,0,34,14,10,10
"2011","Charnwood 011A","E01025674","Total",38,16,12,10,2,1,1,0,36,15,11,10
"2011","Charnwood 011B","E01025675","Total",32,14,9,9,3,1,2,0,29,13,7,9
"2011","Charnwood 011C","E01025676","Total",47,18,17,12,2,0,2,0,45,18,15,12
"2011","Charnwood 011D","E01025677","Total",27,9,4,14,2,0,1,1,25,9,3,13
"2011","Charnwood 012A","E01025732","Total",35,11,21,3,2,0,2,0,33,11,19,3
"2011","Charnwood 012B","E01025733","Total",37,15,17,5,4,1,3,0,33,14,14,5
"2011","Charnwood 012C","E01025734","Total",15,7,7,1,1,0,1,0,14,7,6,1
"2011","Charnwood 012D","E01025735","Total",44,21,17,6,5,2,3,0,39,19,14,6
"2011","Charnwood 013A","E01025748","Total",68,30,24,14,8,1,6,1,60,29,18,13
"2011","Charnwood 013B","E01025749","Total",51,11,13,27,5,0,3,2,46,11,10,25
"2011","Charnwood 013C","E01025750","Total",32,16,10,6,7,4,3,0,25,12,7,6
"2011","Charnwood 013D","E01025751","Total",63,18,21,24,5,0,3,2,58,18,18,22
"2011","Charnwood 014A","E01025726","Total",63,25,23,15,8,0,7,1,55,25,16,14
"2011","Charnwood 014B","E01025727","Total",74,32,12,30,7,1,3,3,67,31,9,27
"2011","Charnwood 014C","E01025728","Total",59,21,24,14,10,1,7,2,49,20,17,12
"2011","Charnwood 014D","E01025729","Total",34,16,12,6,7,1,6,0,27,15,6,6
"2011","Charnwood 014E","E01025737","Total",42,19,13,10,4,0,3,1,38,19,10,9
"2011","Charnwood 014F","E01025739","Total",19,9,8,2,3,0,3,0,16,9,5,2
"2011","Charnwood 015A","E01025685","Total",41,18,13,10,7,1,5,1,34,17,8,9
"2011","Charnwood 015B","E01025686","Total",26,11,8,7,3,1,0,2,23,10,8,5
"2011","Charnwood 015C","E01025730","Total",22,13,6,3,3,1,2,0,19,12,4,3
"2011","Charnwood 015D","E01025731","Total",18,10,6,2,3,2,1,0,15,8,5,2
"2011","Charnwood 016A","E01025687","Total",17,5,11,1,4,1,3,0,13,4,8,1
"2011","Charnwood 016B","E01025688","Total",32,12,9,11,2,0,1,1,30,12,8,10
"2011","Charnwood 016C","E01025736","Total",22,6,12,4,5,1,3,1,17,5,9,3
"2011","Charnwood 016D","E01025738","Total",16,8,5,3,3,1,2,0,13,7,3,3
"2011","Charnwood 017A","E01025756","Total",93,40,27,26,6,1,5,0,87,39,22,26
"2011","Charnwood 017B","E01025757","Total",52,19,15,18,4,0,3,1,48,19,12,17
"2011","Charnwood 017C","E01025758","Total",37,11,16,10,3,0,3,0,34,11,13,10
"2011","Charnwood 017D","E01025759","Total",27,12,7,8,2,0,2,0,25,12,5,8
"2011","Charnwood 018A","E01025752","Total",41,10,11,20,4,1,1,2,37,9,10,18
"2011","Charnwood 018B","E01025753","Total",66,23,18,25,13,0,9,4,53,23,9,21
"2011","Charnwood 018C","E01025754","Total",25,12,8,5,5,1,4,0,20,11,4,5
"2011","Charnwood 018D","E01025755","Total",35,13,18,4,7,1,6,0,28,12,12,4
"2011","Charnwood 019A","E01025679","Total",74,28,20,26,6,0,5,1,68,28,15,25
"2011","Charnwood 019B","E01025680","Total",26,10,13,3,3,0,3,0,23,10,10,3
"2011","Charnwood 019C","E01025681","Total",31,8,14,9,6,0,6,0,25,8,8,9
"2011","Charnwood 019D","E01025682","Total",25,8,8,9,1,0,1,0,24,8,7,9
"2011","Charnwood 020A","E01025678","Total",28,7,16,5,4,1,3,0,24,6,13,5
"2011","Charnwood 020B","E01025683","Total",55,21,15,19,4,0,3,1,51,21,12,18
"2011","Charnwood 020C","E01025684","Total",80,34,33,13,14,1,13,0,66,33,20,13
"2011","Charnwood 021A","E01025762","Total",45,15,19,11,7,0,6,1,38,15,13,10
"2011","Charnwood 021B","E01025763","Total",26,7,8,11,1,0,1,0,25,7,7,11
"2011","Charnwood 021C","E01025764","Total",25,7,12,6,3,0,3,0,22,7,9,6
"2011","Charnwood 021D","E01025765","Total",28,6,8,14,1,0,1,0,27,6,7,14
"2011","Charnwood 021E","E01025766","Total",72,28,16,28,3,0,2,1,69,28,14,27
"2011","Charnwood 021F","E01025767","Total",30,7,12,11,5,1,4,0,25,6,8,11
"2011","Charnwood 022A","E01025670","Total",36,10,9,17,2,0,2,0,34,10,7,17
"2011","Charnwood 022B","E01025671","Total",60,28,15,17,9,1,7,1,51,27,8,16
"2011","Charnwood 022C","E01025672","Total",45,19,16,10,6,1,5,0,39,18,11,10
"2011","Charnwood 022D","E01025673","Total",43,19,15,9,5,1,4,0,38,18,11,9
"2011","Harborough 002A","E01025770","Total",35,10,19,6,5,0,5,0,30,10,14,6
"2011","Harborough 002B","E01025809","Total",29,13,9,7,7,1,3,3,22,12,6,4
"2011","Harborough 002C","E01025815","Total",23,13,5,5,2,1,1,0,21,12,4,5
"2011","Harborough 003A","E01025781","Total",36,14,10,12,5,0,5,0,31,14,5,12
"2011","Harborough 003B","E01025782","Total",35,14,12,9,7,1,5,1,28,13,7,8
"2011","Harborough 003C","E01025783","Total",13,3,6,4,3,1,2,0,10,2,4,4
"2011","Harborough 003D","E01025785","Total",58,23,20,15,6,2,4,0,52,21,16,15
"2011","Harborough 003E","E01025786","Total",43,21,12,10,2,0,1,1,41,21,11,9
"2011","Harborough 003F","E01025787","Total",26,10,8,8,2,0,2,0,24,10,6,8
"2011","Harborough 004A","E01025772","Total",93,36,40,17,11,1,10,0,82,35,30,17
"2011","Harborough 004B","E01025773","Total",26,8,15,3,6,0,5,1,20,8,10,2
"2011","Harborough 004C","E01025774","Total",17,3,8,6,2,0,2,0,15,3,6,6
"2011","Harborough 004D","E01025775","Total",26,14,5,7,4,1,1,2,22,13,4,5
"2011","Harborough 004E","E01025776","Total",37,18,14,5,4,1,3,0,33,17,11,5
"2011","Harborough 005A","E01025771","Total",47,14,23,10,4,1,3,0,43,13,20,10
"2011","Harborough 005B","E01025778","Total",53,19,25,9,4,0,4,0,49,19,21,9
"2011","Harborough 005C","E01025779","Total",37,16,14,7,4,0,4,0,33,16,10,7
"2011","Harborough 005D","E01025780","Total",19,8,9,2,4,2,2,0,15,6,7,2
"2011","Harborough 005E","E01025784","Total",20,11,5,4,2,0,2,0,18,11,3,4
"2011","Harborough 005F","E01025788","Total",17,4,10,3,3,0,3,0,14,4,7,3
"2011","Harborough 006A","E01025777","Total",32,8,20,4,10,1,8,1,22,7,12,3
"2011","Harborough 006B","E01025808","Total",30,13,15,2,3,2,1,0,27,11,14,2
"2011","Harborough 006C","E01025810","Total",23,15,2,6,3,1,1,1,20,14,1,5
"2011","Harborough 006D","E01025816","Total",40,15,17,8,5,1,2,2,35,14,15,6
"2011","Harborough 007A","E01025789","Total",22,10,8,4,3,0,3,0,19,10,5,4
"2011","Harborough 007B","E01025794","Total",23,8,13,2,2,0,2,0,21,8,11,2
"2011","Harborough 007C","E01025797","Total",31,12,11,8,3,1,2,0,28,11,9,8
"2011","Harborough 007D","E01025802","Total",14,7,6,1,6,1,5,0,8,6,1,1
"2011","Harborough 007E","E01025803","Total",19,9,9,1,1,1,0,0,18,8,9,1
"2011","Harborough 007F","E01025805","Total",24,9,12,3,6,0,6,0,18,9,6,3
"2011","Harborough 008A","E01025795","Total",28,9,7,12,3,0,2,1,25,9,5,11
"2011","Harborough 008B","E01025796","Total",67,26,17,24,4,1,2,1,63,25,15,23
"2011","Harborough 008C","E01025801","Total",31,12,11,8,4,0,3,1,27,12,8,7
"2011","Harborough 008D","E01025806","Total",47,17,11,19,9,1,4,4,38,16,7,15
"2011","Harborough 009A","E01025798","Total",29,8,15,6,9,1,7,1,20,7,8,5
"2011","Harborough 009B","E01025799","Total",44,18,21,5,11,0,9,2,33,18,12,3
"2011","Harborough 009C","E01025800","Total",32,13,15,4,4,0,3,1,28,13,12,3
"2011","Harborough 009D","E01025804","Total",35,15,10,10,1,0,0,1,34,15,10,9
"2011","Harborough 009E","E01025807","Total",51,17,15,19,3,1,2,0,48,16,13,19
"2011","Harborough 010A","E01025790","Total",36,9,23,4,9,0,9,0,27,9,14,4
"2011","Harborough 010B","E01025791","Total",58,22,26,10,7,0,7,0,51,22,19,10
"2011","Harborough 010C","E01025792","Total",50,23,15,12,5,0,4,1,45,23,11,11
"2011","Harborough 010D","E01025793","Total",70,27,29,14,6,2,4,0,64,25,25,14
"2011","Harborough 011A","E01025812","Total",38,15,10,13,4,0,1,3,34,15,9,10
"2011","Harborough 011B","E01025813","Total",15,3,8,4,2,0,2,0,13,3,6,4
"2011","Harborough 011C","E01025814","Total",19,8,9,2,2,0,2,0,17,8,7,2
"2011","Harborough 011D","E01032598","Total",38,15,15,8,7,1,5,1,31,14,10,7
"2011","Hinckley and Bosworth 001A","E01025868","Total",28,19,5,4,6,3,2,1,22,16,3,3
"2011","Hinckley and Bosworth 001B","E01025869","Total",35,14,13,8,3,0,3,0,32,14,10,8
"2011","Hinckley and Bosworth 001C","E01025870","Total",29,13,13,3,6,1,4,1,23,12,9,2
"2011","Hinckley and Bosworth 001D","E01025871","Total",32,12,10,10,4,0,4,0,28,12,6,10
"2011","Hinckley and Bosworth 001E","E01025878","Total",58,18,23,17,10,0,10,0,48,18,13,17
"2011","Hinckley and Bosworth 002A","E01025846","Total",44,14,17,13,5,0,3,2,39,14,14,11
"2011","Hinckley and Bosworth 002B","E01025847","Total",44,20,15,9,5,0,4,1,39,20,11,8
"2011","Hinckley and Bosworth 002C","E01025848","Total",37,19,10,8,2,0,1,1,35,19,9,7
"2011","Hinckley and Bosworth 003A","E01025845","Total",17,6,9,2,8,0,8,0,9,6,1,2
"2011","Hinckley and Bosworth 003B","E01025877","Total",53,29,13,11,5,0,3,2,48,29,10,9
"2011","Hinckley and Bosworth 003C","E01025879","Total",45,17,14,14,7,0,7,0,38,17,7,14
"2011","Hinckley and Bosworth 003D","E01025880","Total",39,15,20,4,4,0,4,0,35,15,16,4
"2011","Hinckley and Bosworth 004A","E01025819","Total",49,19,17,13,4,1,3,0,45,18,14,13
"2011","Hinckley and Bosworth 004B","E01025820","Total",40,17,16,7,6,0,6,0,34,17,10,7
"2011","Hinckley and Bosworth 004C","E01025837","Total",31,14,12,5,5,0,3,2,26,14,9,3
"2011","Hinckley and Bosworth 004D","E01025838","Total",13,2,7,4,2,0,2,0,11,2,5,4
"2011","Hinckley and Bosworth 004E","E01025882","Total",30,15,9,6,2,2,0,0,28,13,9,6
"2011","Hinckley and Bosworth 005A","E01025872","Total",10,4,4,2,0,0,0,0,10,4,4,2
"2011","Hinckley and Bosworth 005B","E01025873","Total",18,6,8,4,3,0,2,1,15,6,6,3
"2011","Hinckley and Bosworth 005C","E01025874","Total",39,10,16,13,3,0,1,2,36,10,15,11
"2011","Hinckley and Bosworth 005D","E01025875","Total",40,12,7,21,6,0,3,3,34,12,4,18
"2011","Hinckley and Bosworth 005E","E01025876","Total",33,12,17,4,6,1,4,1,27,11,13,3
"2011","Hinckley and Bosworth 006A","E01025839","Total",47,7,16,24,5,0,2,3,42,7,14,21
"2011","Hinckley and Bosworth 006B","E01025840","Total",40,16,13,11,2,0,2,0,38,16,11,11
"2011","Hinckley and Bosworth 006C","E01025841","Total",22,11,4,7,1,0,1,0,21,11,3,7
"2011","Hinckley and Bosworth 006D","E01025842","Total",80,26,20,34,11,2,5,4,69,24,15,30
"2011","Hinckley and Bosworth 006E","E01025843","Total",46,15,13,18,6,0,2,4,40,15,11,14
"2011","Hinckley and Bosworth 006F","E01025844","Total",79,19,9,51,5,0,2,3,74,19,7,48
"2011","Hinckley and Bosworth 007A","E01025821","Total",68,31,20,17,3,0,3,0,65,31,17,17
"2011","Hinckley and Bosworth 007B","E01025822","Total",57,16,15,26,2,1,0,1,55,15,15,25
"2011","Hinckley and Bosworth 007C","E01025823","Total",65,25,14,26,9,2,5,2,56,23,9,24
"2011","Hinckley and Bosworth 007D","E01025824","Total",50,18,18,14,4,0,2,2,46,18,16,12
"2011","Hinckley and Bosworth 007E","E01025825","Total",28,13,9,6,1,0,1,0,27,13,8,6
"2011","Hinckley and Bosworth 007F","E01025826","Total",31,13,9,9,6,2,2,2,25,11,7,7
"2011","Hinckley and Bosworth 008A","E01025817","Total",30,14,12,4,1,0,0,1,29,14,12,3
"2011","Hinckley and Bosworth 008B","E01025818","Total",27,9,11,7,6,0,6,0,21,9,5,7
"2011","Hinckley and Bosworth 008C","E01025864","Total",33,18,13,2,4,1,3,0,29,17,10,2
"2011","Hinckley and Bosworth 008D","E01025881","Total",8,1,7,0,4,0,4,0,4,1,3,0
"2011","Hinckley and Bosworth 009A","E01025859","Total",22,6,11,5,2,0,2,0,20,6,9,5
"2011","Hinckley and Bosworth 009B","E01025860","Total",19,5,12,2,4,0,4,0,15,5,8,2
"2011","Hinckley and Bosworth 009C","E01025861","Total",36,14,16,6,5,1,4,0,31,13,12,6
"2011","Hinckley and Bosworth 009D","E01025862","Total",30,13,12,5,7,2,4,1,23,11,8,4
"2011","Hinckley and Bosworth 010A","E01025850","Total",44,21,13,10,7,3,4,0,37,18,9,10
"2011","Hinckley and Bosworth 010B","E01025852","Total",65,17,20,28,12,1,10,1,53,16,10,27
"2011","Hinckley and Bosworth 010C","E01025858","Total",63,22,22,19,9,0,6,3,54,22,16,16
"2011","Hinckley and Bosworth 010D","E01025863","Total",58,19,23,16,10,0,8,2,48,19,15,14
"2011","Hinckley and Bosworth 010E","E01025865","Total",60,23,18,19,9,1,5,3,51,22,13,16
"2011","Hinckley and Bosworth 011A","E01025853","Total",93,36,28,29,4,0,4,0,89,36,24,29
"2011","Hinckley and Bosworth 011B","E01025854","Total",54,20,23,11,2,0,2,0,52,20,21,11
"2011","Hinckley and Bosworth 011C","E01025855","Total",45,22,12,11,3,1,2,0,42,21,10,11
"2011","Hinckley and Bosworth 011D","E01025866","Total",59,20,16,23,8,2,3,3,51,18,13,20
"2011","Hinckley and Bosworth 011E","E01025867","Total",33,12,12,9,3,0,2,1,30,12,10,8
"2011","Hinckley and Bosworth 012A","E01025849","Total",46,17,19,10,6,0,6,0,40,17,13,10
"2011","Hinckley and Bosworth 012B","E01025851","Total",26,9,8,9,5,0,5,0,21,9,3,9
"2011","Hinckley and Bosworth 012C","E01025856","Total",57,20,14,23,9,0,6,3,48,20,8,20
"2011","Hinckley and Bosworth 012D","E01025857","Total",26,13,8,5,3,0,2,1,23,13,6,4
"2011","Hinckley and Bosworth 013A","E01025827","Total",36,11,11,14,2,0,1,1,34,11,10,13
"2011","Hinckley and Bosworth 013B","E01025828","Total",20,9,7,4,0,0,0,0,20,9,7,4
"2011","Hinckley and Bosworth 013C","E01025829","Total",47,20,10,17,1,0,1,0,46,20,9,17
"2011","Hinckley and Bosworth 013D","E01025830","Total",41,14,14,13,9,1,6,2,32,13,8,11
"2011","Hinckley and Bosworth 014A","E01025831","Total",24,10,8,6,1,0,1,0,23,10,7,6
"2011","Hinckley and Bosworth 014B","E01025832","Total",25,10,11,4,3,0,3,0,22,10,8,4
"2011","Hinckley and Bosworth 014C","E01025833","Total",41,12,13,16,5,0,1,4,36,12,12,12
"2011","Hinckley and Bosworth 014D","E01025834","Total",24,8,12,4,2,0,1,1,22,8,11,3
"2011","Hinckley and Bosworth 014E","E01025835","Total",19,9,7,3,1,1,0,0,18,8,7,3
"2011","Hinckley and Bosworth 014F","E01025836","Total",24,14,8,2,2,0,2,0,22,14,6,2
"2011","Melton 001A","E01025885","Total",24,8,11,5,5,1,4,0,19,7,7,5
"2011","Melton 001B","E01025886","Total",32,18,9,5,7,0,5,2,25,18,4,3
"2011","Melton 001C","E01025887","Total",29,4,18,7,9,0,9,0,20,4,9,7
"2011","Melton 001D","E01025890","Total",33,14,6,13,5,0,3,2,28,14,3,11
"2011","Melton 001E","E01025891","Total",31,12,15,4,3,0,3,0,28,12,12,4
"2011","Melton 001F","E01025892","Total",26,12,11,3,4,1,2,1,22,11,9,2
"2011","Melton 002A","E01025901","Total",34,16,15,3,6,0,5,1,28,16,10,2
"2011","Melton 002B","E01025902","Total",25,6,11,8,4,0,3,1,21,6,8,7
"2011","Melton 002C","E01025903","Total",67,30,25,12,13,1,9,3,54,29,16,9
"2011","Melton 002D","E01025904","Total",36,16,13,7,5,1,4,0,31,15,9,7
"2011","Melton 002E","E01025906","Total",44,20,17,7,6,1,4,1,38,19,13,6
"2011","Melton 003A","E01025883","Total",44,15,14,15,5,0,3,2,39,15,11,13
"2011","Melton 003B","E01025884","Total",58,28,18,12,7,0,7,0,51,28,11,12
"2011","Melton 003C","E01025888","Total",18,7,8,3,3,0,2,1,15,7,6,2
"2011","Melton 003D","E01025909","Total",36,17,13,6,2,0,2,0,34,17,11,6
"2011","Melton 004A","E01025896","Total",28,12,11,5,5,1,4,0,23,11,7,5
"2011","Melton 004B","E01025897","Total",88,33,18,37,6,0,4,2,82,33,14,35
"2011","Melton 004C","E01025898","Total",37,16,7,14,5,1,1,3,32,15,6,11
"2011","Melton 004D","E01025899","Total",34,15,9,10,1,0,0,1,33,15,9,9
"2011","Melton 004E","E01025900","Total",77,36,14,27,4,1,2,1,73,35,12,26
"2011","Melton 004F","E01025905","Total",76,23,23,30,8,1,5,2,68,22,18,28
"2011","Melton 005A","E01025893","Total",54,17,27,10,10,0,8,2,44,17,19,8
"2011","Melton 005B","E01025894","Total",42,8,17,17,11,1,9,1,31,7,8,16
"2011","Melton 005C","E01025895","Total",52,17,16,19,5,0,3,2,47,17,13,17
"2011","Melton 005D","E01025907","Total",64,20,21,23,10,2,7,1,54,18,14,22
"2011","Melton 005E","E01025908","Total",21,7,11,3,2,0,2,0,19,7,9,3
"2011","Melton 006A","E01025889","Total",17,2,13,2,6,0,6,0,11,2,7,2
"2011","Melton 006B","E01025910","Total",28,10,15,3,5,2,3,0,23,8,12,3
"2011","Melton 006C","E01025911","Total",29,8,15,6,7,1,6,0,22,7,9,6
"2011","Melton 006D","E01025912","Total",29,14,10,5,3,0,3,0,26,14,7,5
"2011","North West Leicestershire 001A","E01025924","Total",22,8,11,3,4,1,3,0,18,7,8,3
"2011","North West Leicestershire 001B","E01025925","Total",52,18,21,13,9,1,7,1,43,17,14,12
"2011","North West Leicestershire 001C","E01025926","Total",35,16,13,6,4,1,3,0,31,15,10,6
"2011","North West Leicestershire 001D","E01025927","Total",54,16,16,22,9,1,5,3,45,15,11,19
"2011","North West Leicestershire 001E","E01025928","Total",14,7,5,2,4,2,2,0,10,5,3,2
"2011","North West Leicestershire 002A","E01025923","Total",22,10,4,8,4,0,1,3,18,10,3,5
"2011","North West Leicestershire 002B","E01025944","Total",29,10,12,7,6,1,5,0,23,9,7,7
"2011","North West Leicestershire 002C","E01025945","Total",30,13,7,10,7,0,4,3,23,13,3,7
"2011","North West Leicestershire 002D","E01025946","Total",41,11,15,15,15,2,6,7,26,9,9,8
"2011","North West Leicestershire 003A","E01025915","Total",11,4,5,2,2,1,1,0,9,3,4,2
"2011","North West Leicestershire 003B","E01025916","Total",37,11,19,7,7,1,6,0,30,10,13,7
"2011","North West Leicestershire 003C","E01025917","Total",71,29,26,16,4,0,4,0,67,29,22,16
"2011","North West Leicestershire 003D","E01025918","Total",60,26,10,24,3,0,1,2,57,26,9,22
"2011","North West Leicestershire 004A","E01025960","Total",17,7,4,6,1,0,1,0,16,7,3,6
"2011","North West Leicestershire 004B","E01025961","Total",23,12,6,5,2,1,1,0,21,11,5,5
"2011","North West Leicestershire 004C","E01025962","Total",47,13,7,27,5,2,2,1,42,11,5,26
"2011","North West Leicestershire 004D","E01025965","Total",17,8,8,1,0,0,0,0,17,8,8,1
"2011","North West Leicestershire 005A","E01025955","Total",17,7,7,3,2,0,2,0,15,7,5,3
"2011","North West Leicestershire 005B","E01025956","Total",29,8,9,12,5,0,3,2,24,8,6,10
"2011","North West Leicestershire 005C","E01025963","Total",29,10,11,8,7,2,5,0,22,8,6,8
"2011","North West Leicestershire 005D","E01025964","Total",13,3,4,6,2,0,1,1,11,3,3,5
"2011","North West Leicestershire 006A","E01025914","Total",20,11,7,2,1,0,1,0,19,11,6,2
"2011","North West Leicestershire 006B","E01025919","Total",31,7,13,11,11,1,7,3,20,6,6,8
"2011","North West Leicestershire 006C","E01025920","Total",38,18,8,12,4,1,3,0,34,17,5,12
"2011","North West Leicestershire 006D","E01025921","Total",34,12,12,10,4,0,3,1,30,12,9,9
"2011","North West Leicestershire 007A","E01025966","Total",53,12,19,22,8,0,7,1,45,12,12,21
"2011","North West Leicestershire 007B","E01025967","Total",23,9,10,4,2,1,1,0,21,8,9,4
"2011","North West Leicestershire 007C","E01025968","Total",32,15,11,6,3,0,3,0,29,15,8,6
"2011","North West Leicestershire 007D","E01025969","Total",55,26,18,11,3,1,2,0,52,25,16,11
"2011","North West Leicestershire 008A","E01025950","Total",78,28,22,28,11,0,7,4,67,28,15,24
"2011","North West Leicestershire 008B","E01025951","Total",32,10,15,7,2,1,0,1,30,9,15,6
"2011","North West Leicestershire 008C","E01025952","Total",29,9,6,14,3,0,3,0,26,9,3,14
"2011","North West Leicestershire 008D","E01025953","Total",34,11,8,15,5,0,2,3,29,11,6,12
"2011","North West Leicestershire 008E","E01025954","Total",35,13,6,16,2,2,0,0,33,11,6,16
"2011","North West Leicestershire 009A","E01025932","Total",54,17,9,28,5,0,4,1,49,17,5,27
"2011","North West Leicestershire 009B","E01025933","Total",42,18,9,15,2,0,1,1,40,18,8,14
"2011","North West Leicestershire 009C","E01025934","Total",87,16,14,57,11,0,5,6,76,16,9,51
"2011","North West Leicestershire 009D","E01025935","Total",15,9,3,3,1,0,1,0,14,9,2,3
"2011","North West Leicestershire 009E","E01025936","Total",26,10,7,9,4,0,4,0,22,10,3,9
"2011","North West Leicestershire 010A","E01025929","Total",51,24,12,15,7,3,2,2,44,21,10,13
"2011","North West Leicestershire 010B","E01025930","Total",70,25,20,25,8,1,3,4,62,24,17,21
"2011","North West Leicestershire 010C","E01025931","Total",53,21,8,24,3,1,0,2,50,20,8,22
"2011","North West Leicestershire 010D","E01025957","Total",73,31,18,24,6,2,2,2,67,29,16,22
"2011","North West Leicestershire 011B","E01025937","Total",42,15,17,10,4,2,2,0,38,13,15,10
"2011","North West Leicestershire 011C","E01025958","Total",45,12,17,16,5,0,5,0,40,12,12,16
"2011","North West Leicestershire 011D","E01025959","Total",51,19,18,14,9,2,5,2,42,17,13,12
"2011","North West Leicestershire 011E","E01033102","Total",37,12,16,9,2,0,2,0,35,12,14,9
"2011","North West Leicestershire 011F","E01033103","Total",31,12,11,8,7,0,7,0,24,12,4,8
"2011","North West Leicestershire 012A","E01025913","Total",31,10,14,7,5,0,4,1,26,10,10,6
"2011","North West Leicestershire 012B","E01025947","Total",41,10,24,7,11,1,9,1,30,9,15,6
"2011","North West Leicestershire 012C","E01025948","Total",61,21,17,23,9,0,6,3,52,21,11,20
"2011","North West Leicestershire 012D","E01025949","Total",68,25,12,31,8,3,4,1,60,22,8,30
"2011","North West Leicestershire 013A","E01025938","Total",21,8,11,2,2,0,2,0,19,8,9,2
"2011","North West Leicestershire 013B","E01025939","Total",48,16,12,20,1,0,1,0,47,16,11,20
"2011","North West Leicestershire 013C","E01025940","Total",53,14,21,18,9,2,5,2,44,12,16,16
"2011","North West Leicestershire 013D","E01025941","Total",25,10,12,3,3,0,3,0,22,10,9,3
"2011","North West Leicestershire 013E","E01025942","Total",32,11,16,5,7,0,6,1,25,11,10,4
"2011","North West Leicestershire 013F","E01025943","Total",64,20,14,30,8,0,3,5,56,20,11,25
"2011","Oadby and Wigston 003A","E01025970","Total",17,6,8,3,1,0,1,0,16,6,7,3
"2011","Oadby and Wigston 003B","E01025971","Total",23,6,8,9,0,0,0,0,23,6,8,9
"2011","Oadby and Wigston 003C","E01025972","Total",16,3,7,6,3,0,3,0,13,3,4,6
"2011","Oadby and Wigston 003D","E01025976","Total",35,8,11,16,3,0,2,1,32,8,9,15
"2011","Oadby and Wigston 003E","E01025977","Total",17,6,9,2,3,0,3,0,14,6,6,2
"2011","Oadby and Wigston 003F","E01025978","Total",35,12,12,11,5,0,3,2,30,12,9,9
"2011","Oadby and Wigston 005A","E01025992","Total",50,10,14,26,3,1,2,0,47,9,12,26
"2011","Oadby and Wigston 005B","E01025994","Total",61,19,14,28,3,0,1,2,58,19,13,26
"2011","Oadby and Wigston 005C","E01025997","Total",44,13,12,19,4,1,3,0,40,12,9,19
"2011","Oadby and Wigston 005D","E01025999","Total",60,12,18,30,5,0,2,3,55,12,16,27
"2011","Oadby and Wigston 005E","E01026005","Total",25,7,9,9,2,0,2,0,23,7,7,9
"2011","Oadby and Wigston 006A","E01025985","Total",14,7,4,3,1,0,1,0,13,7,3,3
"2011","Oadby and Wigston 006B","E01025986","Total",21,13,3,5,1,0,1,0,20,13,2,5
"2011","Oadby and Wigston 006C","E01025987","Total",72,27,15,30,3,0,2,1,69,27,13,29
"2011","Oadby and Wigston 006D","E01025988","Total",76,27,17,32,1,0,0,1,75,27,17,31
"2011","Oadby and Wigston 006E","E01025989","Total",68,27,14,27,2,2,0,0,66,25,14,27
"2011","Oadby and Wigston 007A","E01025990","Total",21,9,8,4,3,0,3,0,18,9,5,4
"2011","Oadby and Wigston 007B","E01025991","Total",28,12,8,8,1,0,1,0,27,12,7,8
"2011","Oadby and Wigston 007C","E01025993","Total",25,15,7,3,2,0,2,0,23,15,5,3
"2011","Oadby and Wigston 007D","E01025998","Total",36,14,18,4,5,0,4,1,31,14,14,3
"2011","Oadby and Wigston 007E","E01026000","Total",10,5,2,3,0,0,0,0,10,5,2,3
"2011","Oadby and Wigston 007F","E01026001","Total",23,9,11,3,5,0,5,0,18,9,6,3
"2011","Oadby and Wigston 008A","E01025995","Total",19,10,5,4,0,0,0,0,19,10,5,4
"2011","Oadby and Wigston 008B","E01026003","Total",28,8,14,6,1,0,0,1,27,8,14,5
"2011","Oadby and Wigston 008C","E01026004","Total",16,8,5,3,3,1,2,0,13,7,3,3
"2011","Oadby and Wigston 008D","E01032600","Total",31,11,11,9,4,0,3,1,27,11,8,8
"2011","Oadby and Wigston 008E","E01032601","Total",16,6,5,5,3,0,3,0,13,6,2,5
"2011","Oadby and Wigston 009A","E01025973","Total",9,4,3,2,1,0,1,0,8,4,2,2
"2011","Oadby and Wigston 009B","E01025974","Total",38,12,14,12,1,0,1,0,37,12,13,12
"2011","Oadby and Wigston 009C","E01025975","Total",18,5,9,4,4,1,3,0,14,4,6,4
"2011","Oadby and Wigston 009E","E01025979","Total",31,18,10,3,2,1,1,0,29,17,9,3
"2011","Oadby and Wigston 009D","E01025980","Total",16,6,8,2,2,1,0,1,14,5,8,1
"2011","Oadby and Wigston 009F","E01025981","Total",24,10,6,8,2,1,1,0,22,9,5,8
"2011","Oadby and Wigston 009G","E01025982","Total",29,13,14,2,4,1,3,0,25,12,11,2
"2011","Oadby and Wigston 009H","E01025983","Total",29,8,12,9,1,0,1,0,28,8,11,9
"2011","Oadby and Wigston 009I","E01025984","Total",13,2,10,1,4,0,4,0,9,2,6,1
"2011","Boston 001A","E01026007","Total",15,4,8,3,3,0,3,0,12,4,5,3
"2011","Boston 001B","E01026008","Total",17,10,4,3,1,0,1,0,16,10,3,3
"2011","Boston 001C","E01026009","Total",24,7,7,10,1,0,1,0,23,7,6,10
"2011","Boston 001D","E01026023","Total",21,5,3,13,1,0,1,0,20,5,2,13
"2011","Boston 001E","E01026024","Total",40,20,9,11,1,0,1,0,39,20,8,11
"2011","Boston 002A","E01026010","Total",69,18,10,41,3,0,1,2,66,18,9,39
"2011","Boston 002B","E01026011","Total",115,32,30,53,10,2,5,3,105,30,25,50
"2011","Boston 002C","E01026030","Total",99,39,21,39,4,0,2,2,95,39,19,37
"2011","Boston 002D","E01026032","Total",53,16,21,16,5,1,4,0,48,15,17,16
"2011","Boston 002E","E01026037","Total",46,22,6,18,2,0,1,1,44,22,5,17
"2011","Boston 003A","E01026006","Total",91,33,26,32,6,1,3,2,85,32,23,30
"2011","Boston 003B","E01026021","Total",24,6,15,3,1,0,1,0,23,6,14,3
"2011","Boston 003C","E01026025","Total",99,42,19,38,8,1,5,2,91,41,14,36
"2011","Boston 003D","E01026036","Total",41,13,16,12,3,1,1,1,38,12,15,11
"2011","Boston 004A","E01026012","Total",43,14,6,23,2,1,0,1,41,13,6,22
"2011","Boston 004B","E01026015","Total",54,31,13,10,4,2,1,1,50,29,12,9
"2011","Boston 004C","E01026026","Total",80,33,10,37,5,0,2,3,75,33,8,34
"2011","Boston 004D","E01026027","Total",65,32,22,11,9,1,6,2,56,31,16,9
"2011","Boston 004E","E01026028","Total",52,22,13,17,2,1,1,0,50,21,12,17
"2011","Boston 006A","E01026016","Total",52,14,16,22,8,0,5,3,44,14,11,19
"2011","Boston 006B","E01026033","Total",40,21,5,14,2,0,1,1,38,21,4,13
"2011","Boston 006C","E01026034","Total",30,10,7,13,1,0,1,0,29,10,6,13
"2011","Boston 007A","E01026017","Total",30,16,6,8,3,0,3,0,27,16,3,8
"2011","Boston 007B","E01026018","Total",20,5,6,9,2,0,2,0,18,5,4,9
"2011","Boston 007C","E01026019","Total",102,30,25,47,8,3,4,1,94,27,21,46
"2011","Boston 007D","E01026020","Total",59,22,11,26,7,2,4,1,52,20,7,25
"2011","Boston 007E","E01026041","Total",41,22,4,15,3,0,1,2,38,22,3,13
"2011","Boston 008A","E01026013","Total",15,4,8,3,5,0,4,1,10,4,4,2
"2011","Boston 008B","E01026014","Total",45,16,12,17,1,0,1,0,44,16,11,17
"2011","Boston 008C","E01026022","Total",32,19,10,3,3,0,2,1,29,19,8,2
"2011","Boston 008D","E01026038","Total",37,16,17,4,2,1,1,0,35,15,16,4
"2011","Boston 008E","E01026040","Total",23,8,6,9,2,1,1,0,21,7,5,9
"2011","Boston 009A","E01026029","Total",66,30,23,13,5,2,1,2,61,28,22,11
"2011","Boston 009B","E01026031","Total",17,9,2,6,1,0,1,0,16,9,1,6
"2011","Boston 009C","E01026035","Total",28,18,9,1,1,0,0,1,27,18,9,0
"2011","Boston 009D","E01026039","Total",16,8,5,3,2,2,0,0,14,6,5,3
"2011","East Lindsey 001A","E01026045","Total",23,15,3,5,5,0,2,3,18,15,1,2
"2011","East Lindsey 001B","E01026061","Total",34,12,14,8,9,1,6,2,25,11,8,6
"2011","East Lindsey 001C","E01026062","Total",33,10,8,15,2,0,2,0,31,10,6,15
"2011","East Lindsey 001D","E01026063","Total",23,15,7,1,2,0,2,0,21,15,5,1
"2011","East Lindsey 001E","E01026080","Total",28,13,8,7,0,0,0,0,28,13,8,7
"2011","East Lindsey 001F","E01026106","Total",21,8,10,3,1,0,1,0,20,8,9,3
"2011","East Lindsey 001G","E01026107","Total",20,12,5,3,3,0,3,0,17,12,2,3
"2011","East Lindsey 002A","E01026058","Total",47,15,17,15,6,1,4,1,41,14,13,14
"2011","East Lindsey 002B","E01026076","Total",30,12,12,6,3,0,3,0,27,12,9,6
"2011","East Lindsey 002C","E01026079","Total",40,12,16,12,10,0,9,1,30,12,7,11
"2011","East Lindsey 003A","E01026077","Total",40,14,12,14,5,1,2,2,35,13,10,12
"2011","East Lindsey 003B","E01026078","Total",29,11,5,13,5,1,2,2,24,10,3,11
"2011","East Lindsey 003C","E01026087","Total",59,17,8,34,5,0,3,2,54,17,5,32
"2011","East Lindsey 003D","E01026088","Total",24,8,9,7,3,0,2,1,21,8,7,6
"2011","East Lindsey 003E","E01026090","Total",40,15,8,17,5,0,5,0,35,15,3,17
"2011","East Lindsey 003F","E01026091","Total",14,11,3,0,1,0,1,0,13,11,2,0
"2011","East Lindsey 003G","E01026108","Total",113,48,16,49,6,1,2,3,107,47,14,46
"2011","East Lindsey 004A","E01026081","Total",80,32,22,26,9,0,6,3,71,32,16,23
"2011","East Lindsey 004C","E01026089","Total",47,17,6,24,4,1,0,3,43,16,6,21
"2011","East Lindsey 004D","E01032986","Total",43,13,14,16,4,0,2,2,39,13,12,14
"2011","East Lindsey 004E","E01032987","Total",55,27,11,17,7,2,5,0,48,25,6,17
"2011","East Lindsey 005A","E01026072","Total",41,18,3,20,4,2,1,1,37,16,2,19
"2011","East Lindsey 005B","E01026073","Total",52,14,10,28,8,0,2,6,44,14,8,22
"2011","East Lindsey 005C","E01026074","Total",38,9,7,22,4,0,2,2,34,9,5,20
"2011","East Lindsey 005D","E01026099","Total",47,16,14,17,4,0,4,0,43,16,10,17
"2011","East Lindsey 006A","E01026103","Total",36,11,10,15,3,0,2,1,33,11,8,14
"2011","East Lindsey 006B","E01026104","Total",39,10,6,23,5,2,2,1,34,8,4,22
"2011","East Lindsey 006C","E01026109","Total",32,13,2,17,6,1,1,4,26,12,1,13
"2011","East Lindsey 007A","E01026071","Total",36,13,12,11,6,2,4,0,30,11,8,11
"2011","East Lindsey 007B","E01026082","Total",29,8,17,4,6,0,6,0,23,8,11,4
"2011","East Lindsey 007C","E01026121","Total",46,10,18,18,5,1,4,0,41,9,14,18
"2011","East Lindsey 008A","E01026042","Total",65,26,14,25,4,0,2,2,61,26,12,23
"2011","East Lindsey 008B","E01026043","Total",52,25,9,18,7,1,4,2,45,24,5,16
"2011","East Lindsey 008C","E01026044","Total",14,4,4,6,2,1,1,0,12,3,3,6
"2011","East Lindsey 008D","E01026113","Total",29,10,9,10,6,2,2,2,23,8,7,8
"2011","East Lindsey 008E","E01026117","Total",18,11,2,5,2,1,0,1,16,10,2,4
"2011","East Lindsey 009A","E01026060","Total",17,7,4,6,1,0,1,0,16,7,3,6
"2011","East Lindsey 009B","E01026068","Total",25,10,6,9,0,0,0,0,25,10,6,9
"2011","East Lindsey 009C","E01026070","Total",22,10,9,3,1,0,1,0,21,10,8,3
"2011","East Lindsey 009D","E01026105","Total",32,14,9,9,5,1,2,2,27,13,7,7
"2011","East Lindsey 010A","E01026048","Total",41,16,11,14,10,4,3,3,31,12,8,11
"2011","East Lindsey 010B","E01026049","Total",27,15,6,6,6,1,3,2,21,14,3,4
"2011","East Lindsey 010C","E01026050","Total",30,8,8,14,0,0,0,0,30,8,8,14
"2011","East Lindsey 010D","E01026069","Total",52,15,4,33,6,0,1,5,46,15,3,28
"2011","East Lindsey 011A","E01026064","Total",50,21,10,19,3,0,1,2,47,21,9,17
"2011","East Lindsey 011B","E01026065","Total",24,9,10,5,0,0,0,0,24,9,10,5
"2011","East Lindsey 011C","E01026066","Total",35,15,9,11,4,1,2,1,31,14,7,10
"2011","East Lindsey 011D","E01026067","Total",56,22,16,18,4,0,2,2,52,22,14,16
"2011","East Lindsey 012A","E01026084","Total",55,17,17,21,3,2,1,0,52,15,16,21
"2011","East Lindsey 012B","E01026085","Total",57,22,14,21,4,0,3,1,53,22,11,20
"2011","East Lindsey 012C","E01026115","Total",47,24,7,16,6,2,3,1,41,22,4,15
"2011","East Lindsey 012D","E01026116","Total",47,16,13,18,8,4,1,3,39,12,12,15
"2011","East Lindsey 013A","E01026046","Total",35,13,9,13,0,0,0,0,35,13,9,13
"2011","East Lindsey 013B","E01026047","Total",16,7,7,2,5,0,5,0,11,7,2,2
"2011","East Lindsey 013C","E01026055","Total",7,5,0,2,1,0,0,1,6,5,0,1
"2011","East Lindsey 013D","E01026059","Total",15,2,4,9,1,1,0,0,14,1,4,9
"2011","East Lindsey 013E","E01026100","Total",73,29,16,28,5,2,0,3,68,27,16,25
"2011","East Lindsey 013F","E01026101","Total",43,14,11,18,5,0,3,2,38,14,8,16
"2011","East Lindsey 014A","E01026092","Total",46,17,9,20,3,0,0,3,43,17,9,17
"2011","East Lindsey 014B","E01026093","Total",57,23,6,28,1,0,0,1,56,23,6,27
"2011","East Lindsey 014C","E01026095","Total",40,15,11,14,7,1,4,2,33,14,7,12
"2011","East Lindsey 014D","E01026114","Total",45,16,14,15,5,3,1,1,40,13,13,14
"2011","East Lindsey 015A","E01026083","Total",78,25,14,39,7,1,5,1,71,24,9,38
"2011","East Lindsey 015B","E01026094","Total",70,23,18,29,3,2,0,1,67,21,18,28
"2011","East Lindsey 015C","E01026096","Total",21,6,11,4,2,0,2,0,19,6,9,4
"2011","East Lindsey 015D","E01026097","Total",34,15,5,14,0,0,0,0,34,15,5,14
"2011","East Lindsey 016A","E01026051","Total",19,8,3,8,1,1,0,0,18,7,3,8
"2011","East Lindsey 016B","E01026052","Total",27,11,9,7,1,0,1,0,26,11,8,7
"2011","East Lindsey 016C","E01026053","Total",76,23,21,32,7,0,3,4,69,23,18,28
"2011","East Lindsey 016D","E01026054","Total",58,15,16,27,8,1,5,2,50,14,11,25
"2011","East Lindsey 016E","E01026118","Total",28,14,8,6,0,0,0,0,28,14,8,6
"2011","East Lindsey 016F","E01026119","Total",11,6,4,1,2,0,2,0,9,6,2,1
"2011","East Lindsey 016G","E01026120","Total",43,18,7,18,3,0,1,2,40,18,6,16
"2011","East Lindsey 017A","E01026056","Total",18,13,2,3,5,4,0,1,13,9,2,2
"2011","East Lindsey 017B","E01026110","Total",32,13,4,15,1,0,1,0,31,13,3,15
"2011","East Lindsey 017C","E01026111","Total",31,6,9,16,6,0,2,4,25,6,7,12
"2011","East Lindsey 017D","E01026112","Total",58,19,7,32,9,2,3,4,49,17,4,28
"2011","East Lindsey 018A","E01026057","Total",25,4,10,11,2,0,2,0,23,4,8,11
"2011","East Lindsey 018B","E01026075","Total",23,6,5,12,7,0,2,5,16,6,3,7
"2011","East Lindsey 018C","E01026098","Total",38,11,18,9,9,1,5,3,29,10,13,6
"2011","East Lindsey 018D","E01026102","Total",43,16,10,17,10,2,6,2,33,14,4,15
"2011","Lincoln 001A","E01026149","Total",75,31,6,38,7,1,3,3,68,30,3,35
"2011","Lincoln 001B","E01026150","Total",79,25,10,44,8,2,0,6,71,23,10,38
"2011","Lincoln 001C","E01026166","Total",66,20,18,28,8,1,3,4,58,19,15,24
"2011","Lincoln 001D","E01026168","Total",97,27,12,58,9,0,3,6,88,27,9,52
"2011","Lincoln 002A","E01026153","Total",64,26,28,10,8,0,8,0,56,26,20,10
"2011","Lincoln 002B","E01026155","Total",36,22,12,2,0,0,0,0,36,22,12,2
"2011","Lincoln 002C","E01026157","Total",63,20,12,31,7,0,4,3,56,20,8,28
"2011","Lincoln 002D","E01026165","Total",45,12,4,29,2,0,0,2,43,12,4,27
"2011","Lincoln 003A","E01026125","Total",39,9,9,21,1,0,1,0,38,9,8,21
"2011","Lincoln 003B","E01026144","Total",25,8,7,10,1,0,1,0,24,8,6,10
"2011","Lincoln 003C","E01026147","Total",36,15,10,11,2,0,2,0,34,15,8,11
"2011","Lincoln 003D","E01026148","Total",54,26,12,16,4,0,3,1,50,26,9,15
"2011","Lincoln 003E","E01026151","Total",41,23,9,9,2,1,1,0,39,22,8,9
"2011","Lincoln 003F","E01026164","Total",18,4,6,8,3,0,2,1,15,4,4,7
"2011","Lincoln 003G","E01026167","Total",22,9,11,2,3,1,2,0,19,8,9,2
"2011","Lincoln 004A","E01026122","Total",34,11,13,10,0,0,0,0,34,11,13,10
"2011","Lincoln 004B","E01026123","Total",100,30,18,52,5,3,2,0,95,27,16,52
"2011","Lincoln 004C","E01026124","Total",50,18,14,18,2,0,1,1,48,18,13,17
"2011","Lincoln 004D","E01026126","Total",38,12,10,16,2,0,0,2,36,12,10,14
"2011","Lincoln 004E","E01026152","Total",113,43,18,52,8,3,3,2,105,40,15,50
"2011","Lincoln 004F","E01026154","Total",53,19,7,27,10,0,6,4,43,19,1,23
"2011","Lincoln 004G","E01026156","Total",63,28,6,29,3,1,1,1,60,27,5,28
"2011","Lincoln 005A","E01026132","Total",35,10,11,14,7,0,3,4,28,10,8,10
"2011","Lincoln 005B","E01026143","Total",25,8,10,7,4,1,2,1,21,7,8,6
"2011","Lincoln 005C","E01026145","Total",27,6,10,11,1,0,0,1,26,6,10,10
"2011","Lincoln 005D","E01026146","Total",24,9,5,10,2,0,2,0,22,9,3,10
"2011","Lincoln 006A","E01026134","Total",45,16,15,14,2,0,1,1,43,16,14,13
"2011","Lincoln 006B","E01026176","Total",40,12,6,22,4,1,0,3,36,11,6,19
"2011","Lincoln 006C","E01026177","Total",66,22,17,27,5,2,2,1,61,20,15,26
"2011","Lincoln 006D","E01026178","Total",50,17,15,18,8,1,6,1,42,16,9,17
"2011","Lincoln 007A","E01026127","Total",97,33,14,50,10,3,2,5,87,30,12,45
"2011","Lincoln 007B","E01026128","Total",106,44,26,36,8,1,3,4,98,43,23,32
"2011","Lincoln 007C","E01026129","Total",148,39,23,86,13,1,7,5,135,38,16,81
"2011","Lincoln 007D","E01026131","Total",58,22,14,22,3,1,2,0,55,21,12,22
"2011","Lincoln 008A","E01026133","Total",79,31,17,31,9,0,6,3,70,31,11,28
"2011","Lincoln 008B","E01026135","Total",23,10,10,3,3,1,2,0,20,9,8,3
"2011","Lincoln 008C","E01026136","Total",27,10,13,4,3,0,2,1,24,10,11,3
"2011","Lincoln 008D","E01026174","Total",53,22,11,20,2,0,2,0,51,22,9,20
"2011","Lincoln 009A","E01026130","Total",25,11,9,5,1,0,1,0,24,11,8,5
"2011","Lincoln 009B","E01026158","Total",23,10,6,7,1,0,1,0,22,10,5,7
"2011","Lincoln 009C","E01026159","Total",53,26,16,11,6,0,3,3,47,26,13,8
"2011","Lincoln 009D","E01026160","Total",31,19,5,7,2,0,2,0,29,19,3,7
"2011","Lincoln 009E","E01026162","Total",39,14,10,15,7,1,5,1,32,13,5,14
"2011","Lincoln 009F","E01026163","Total",31,13,11,7,3,1,2,0,28,12,9,7
"2011","Lincoln 010A","E01026161","Total",62,22,9,31,2,1,0,1,60,21,9,30
"2011","Lincoln 010B","E01026170","Total",70,22,13,35,5,1,2,2,65,21,11,33
"2011","Lincoln 010C","E01026172","Total",50,14,7,29,6,2,0,4,44,12,7,25
"2011","Lincoln 010D","E01026173","Total",97,30,14,53,8,1,2,5,89,29,12,48
"2011","Lincoln 010E","E01026175","Total",86,29,24,33,8,1,5,2,78,28,19,31
"2011","Lincoln 011A","E01026137","Total",28,11,10,7,3,0,3,0,25,11,7,7
"2011","Lincoln 011B","E01026138","Total",23,5,13,5,7,0,6,1,16,5,7,4
"2011","Lincoln 011C","E01026139","Total",20,10,5,5,0,0,0,0,20,10,5,5
"2011","Lincoln 011D","E01026140","Total",59,28,16,15,8,0,6,2,51,28,10,13
"2011","Lincoln 011E","E01026141","Total",27,17,5,5,1,0,1,0,26,17,4,5
"2011","Lincoln 011F","E01026142","Total",63,23,17,23,12,0,7,5,51,23,10,18
"2011","Lincoln 011G","E01026169","Total",38,23,5,10,5,1,2,2,33,22,3,8
"2011","Lincoln 011H","E01026171","Total",20,9,9,2,2,0,2,0,18,9,7,2
"2011","North Kesteven 001A","E01026186","Total",28,11,14,3,7,1,6,0,21,10,8,3
"2011","North Kesteven 001B","E01026187","Total",48,19,21,8,4,0,4,0,44,19,17,8
"2011","North Kesteven 001C","E01026189","Total",28,14,10,4,2,0,2,0,26,14,8,4
"2011","North Kesteven 001D","E01026203","Total",26,10,10,6,4,1,3,0,22,9,7,6
"2011","North Kesteven 001E","E01026204","Total",26,11,12,3,2,0,2,0,24,11,10,3
"2011","North Kesteven 001F","E01026206","Total",32,18,9,5,1,0,1,0,31,18,8,5
"2011","North Kesteven 003B","E01026182","Total",24,14,6,4,1,1,0,0,23,13,6,4
"2011","North Kesteven 003C","E01026193","Total",28,14,7,7,3,0,3,0,25,14,4,7
"2011","North Kesteven 003D","E01026199","Total",25,7,12,6,8,0,8,0,17,7,4,6
"2011","North Kesteven 003E","E01026225","Total",39,15,17,7,4,0,4,0,35,15,13,7
"2011","North Kesteven 003F","E01026226","Total",15,9,5,1,3,0,2,1,12,9,3,0
"2011","North Kesteven 003G","E01032990","Total",73,20,37,16,8,0,8,0,65,20,29,16
"2011","North Kesteven 003H","E01032994","Total",34,16,13,5,5,2,3,0,29,14,10,5
"2011","North Kesteven 004A","E01026184","Total",23,3,16,4,2,0,2,0,21,3,14,4
"2011","North Kesteven 004B","E01026185","Total",35,18,9,8,3,0,3,0,32,18,6,8
"2011","North Kesteven 004C","E01026188","Total",65,28,18,19,7,1,2,4,58,27,16,15
"2011","North Kesteven 004D","E01026190","Total",36,13,6,17,3,3,0,0,33,10,6,17
"2011","North Kesteven 004E","E01026237","Total",29,11,8,10,2,0,1,1,27,11,7,9
"2011","North Kesteven 004F","E01026238","Total",26,10,9,7,1,0,1,0,25,10,8,7
"2011","North Kesteven 005A","E01026191","Total",44,18,9,17,6,0,1,5,38,18,8,12
"2011","North Kesteven 005B","E01026205","Total",43,21,14,8,6,0,6,0,37,21,8,8
"2011","North Kesteven 005C","E01026211","Total",36,18,12,6,5,0,3,2,31,18,9,4
"2011","North Kesteven 005D","E01026212","Total",52,19,16,17,3,0,3,0,49,19,13,17
"2011","North Kesteven 005E","E01026213","Total",40,13,14,13,6,0,3,3,34,13,11,10
"2011","North Kesteven 006A","E01026192","Total",20,6,9,5,5,0,5,0,15,6,4,5
"2011","North Kesteven 006B","E01026194","Total",48,21,19,8,5,0,5,0,43,21,14,8
"2011","North Kesteven 006C","E01026195","Total",33,12,15,6,3,0,3,0,30,12,12,6
"2011","North Kesteven 006D","E01026196","Total",33,10,9,14,2,0,1,1,31,10,8,13
"2011","North Kesteven 007A","E01026180","Total",24,11,4,9,4,1,2,1,20,10,2,8
"2011","North Kesteven 007B","E01026183","Total",61,23,17,21,10,1,7,2,51,22,10,19
"2011","North Kesteven 007C","E01026210","Total",37,15,12,10,5,1,4,0,32,14,8,10
"2011","North Kesteven 007D","E01026224","Total",53,16,8,29,8,2,2,4,45,14,6,25
"2011","North Kesteven 008A","E01026179","Total",12,2,7,3,4,0,4,0,8,2,3,3
"2011","North Kesteven 008B","E01026197","Total",27,7,12,8,8,1,7,0,19,6,5,8
"2011","North Kesteven 008C","E01026198","Total",24,9,8,7,6,3,3,0,18,6,5,7
"2011","North Kesteven 008D","E01026223","Total",42,11,24,7,2,0,1,1,40,11,23,6
"2011","North Kesteven 009A","E01026209","Total",35,17,13,5,6,1,5,0,29,16,8,5
"2011","North Kesteven 009B","E01026221","Total",54,27,12,15,3,1,1,1,51,26,11,14
"2011","North Kesteven 009C","E01026222","Total",34,11,15,8,2,0,1,1,32,11,14,7
"2011","North Kesteven 010A","E01026227","Total",37,18,6,13,0,0,0,0,37,18,6,13
"2011","North Kesteven 010B","E01026230","Total",47,14,17,16,8,1,6,1,39,13,11,15
"2011","North Kesteven 010C","E01026231","Total",76,39,22,15,10,3,6,1,66,36,16,14
"2011","North Kesteven 010D","E01026232","Total",52,18,15,19,3,0,2,1,49,18,13,18
"2011","North Kesteven 010E","E01026235","Total",70,23,14,33,3,0,3,0,67,23,11,33
"2011","North Kesteven 011A","E01026228","Total",49,20,15,14,4,0,4,0,45,20,11,14
"2011","North Kesteven 011B","E01026229","Total",53,18,16,19,3,0,3,0,50,18,13,19
"2011","North Kesteven 011C","E01026233","Total",39,22,13,4,1,0,1,0,38,22,12,4
"2011","North Kesteven 011D","E01026234","Total",59,26,25,8,4,1,1,2,55,25,24,6
"2011","North Kesteven 011E","E01026236","Total",26,9,10,7,3,0,3,0,23,9,7,7
"2011","North Kesteven 012A","E01026200","Total",30,16,11,3,2,0,2,0,28,16,9,3
"2011","North Kesteven 012B","E01026201","Total",54,12,19,23,6,1,5,0,48,11,14,23
"2011","North Kesteven 012C","E01026202","Total",32,10,15,7,2,0,1,1,30,10,14,6
"2011","North Kesteven 012D","E01026207","Total",18,6,4,8,3,1,2,0,15,5,2,8
"2011","North Kesteven 012E","E01026208","Total",34,12,16,6,2,0,2,0,32,12,14,6
"2011","North Kesteven 013A","E01026220","Total",47,20,12,15,5,1,4,0,42,19,8,15
"2011","North Kesteven 013B","E01032988","Total",55,22,16,17,5,0,4,1,50,22,12,16
"2011","North Kesteven 013C","E01032989","Total",57,13,22,22,4,0,3,1,53,13,19,21
"2011","North Kesteven 013D","E01032993","Total",21,8,8,5,0,0,0,0,21,8,8,5
"2011","North Kesteven 014A","E01026214","Total",31,16,13,2,4,0,4,0,27,16,9,2
"2011","North Kesteven 014B","E01026215","Total",11,6,3,2,0,0,0,0,11,6,3,2
"2011","North Kesteven 014C","E01026218","Total",16,6,8,2,3,1,2,0,13,5,6,2
"2011","North Kesteven 014D","E01026219","Total",22,6,8,8,3,0,3,0,19,6,5,8
"2011","North Kesteven 014E","E01032991","Total",24,9,7,8,0,0,0,0,24,9,7,8
"2011","North Kesteven 014F","E01032992","Total",31,13,7,11,3,2,1,0,28,11,6,11
"2011","South Holland 001A","E01026242","Total",26,10,6,10,4,0,2,2,22,10,4,8
"2011","South Holland 001B","E01026243","Total",43,17,9,17,2,1,1,0,41,16,8,17
"2011","South Holland 001C","E01026244","Total",17,5,4,8,2,0,1,1,15,5,3,7
"2011","South Holland 001D","E01026247","Total",35,6,10,19,3,0,2,1,32,6,8,18
"2011","South Holland 001E","E01026276","Total",24,8,8,8,2,0,0,2,22,8,8,6
"2011","South Holland 002A","E01026246","Total",39,19,5,15,4,0,3,1,35,19,2,14
"2011","South Holland 002B","E01026248","Total",46,21,11,14,3,0,2,1,43,21,9,13
"2011","South Holland 002C","E01026257","Total",20,8,5,7,2,0,1,1,18,8,4,6
"2011","South Holland 003A","E01026250","Total",72,21,11,40,5,2,2,1,67,19,9,39
"2011","South Holland 003B","E01026251","Total",28,11,9,8,4,0,3,1,24,11,6,7
"2011","South Holland 003C","E01026252","Total",39,14,10,15,7,0,3,4,32,14,7,11
"2011","South Holland 003D","E01026253","Total",61,15,20,26,3,1,1,1,58,14,19,25
"2011","South Holland 004A","E01026281","Total",14,3,6,5,2,0,2,0,12,3,4,5
"2011","South Holland 004B","E01026282","Total",30,12,3,15,3,0,0,3,27,12,3,12
"2011","South Holland 004C","E01026283","Total",23,6,8,9,5,1,3,1,18,5,5,8
"2011","South Holland 004D","E01026285","Total",20,6,9,5,2,0,2,0,18,6,7,5
"2011","South Holland 004E","E01026286","Total",31,7,7,17,4,0,2,2,27,7,5,15
"2011","South Holland 005A","E01026241","Total",50,20,11,19,6,1,3,2,44,19,8,17
"2011","South Holland 005B","E01026258","Total",14,6,6,2,1,0,0,1,13,6,6,1
"2011","South Holland 005C","E01026259","Total",30,10,7,13,1,1,0,0,29,9,7,13
"2011","South Holland 005D","E01026260","Total",56,19,20,17,3,0,3,0,53,19,17,17
"2011","South Holland 006B","E01026266","Total",54,13,22,19,6,0,4,2,48,13,18,17
"2011","South Holland 006C","E01026273","Total",24,10,8,6,2,0,2,0,22,10,6,6
"2011","South Holland 006D","E01026274","Total",62,26,22,14,4,0,4,0,58,26,18,14
"2011","South Holland 006E","E01026275","Total",50,19,16,15,4,0,3,1,46,19,13,14
"2011","South Holland 006F","E01032995","Total",34,7,15,12,2,0,2,0,32,7,13,12
"2011","South Holland 006G","E01032996","Total",17,5,6,6,2,0,2,0,15,5,4,6
"2011","South Holland 007A","E01026268","Total",68,25,12,31,2,0,2,0,66,25,10,31
"2011","South Holland 007B","E01026269","Total",30,12,13,5,7,1,5,1,23,11,8,4
"2011","South Holland 007C","E01026270","Total",90,33,15,42,6,1,2,3,84,32,13,39
"2011","South Holland 007D","E01026271","Total",53,13,20,20,2,0,1,1,51,13,19,19
"2011","South Holland 007E","E01026272","Total",20,6,9,5,5,0,3,2,15,6,6,3
"2011","South Holland 008A","E01026254","Total",37,10,12,15,7,0,3,4,30,10,9,11
"2011","South Holland 008B","E01026255","Total",45,15,16,14,4,1,2,1,41,14,14,13
"2011","South Holland 008C","E01026256","Total",28,7,8,13,1,0,0,1,27,7,8,12
"2011","South Holland 008D","E01026277","Total",53,15,9,29,7,1,3,3,46,14,6,26
"2011","South Holland 008E","E01026278","Total",20,7,3,10,0,0,0,0,20,7,3,10
"2011","South Holland 008F","E01026279","Total",40,16,5,19,4,2,1,1,36,14,4,18
"2011","South Holland 009A","E01026262","Total",23,6,11,6,0,0,0,0,23,6,11,6
"2011","South Holland 009B","E01026263","Total",47,19,16,12,3,0,2,1,44,19,14,11
"2011","South Holland 009C","E01026264","Total",46,11,16,19,4,1,1,2,42,10,15,17
"2011","South Holland 009D","E01026265","Total",21,11,3,7,2,1,1,0,19,10,2,7
"2011","South Holland 009E","E01026267","Total",76,30,23,23,5,1,3,1,71,29,20,22
"2011","South Holland 010A","E01026245","Total",34,10,13,11,2,0,2,0,32,10,11,11
"2011","South Holland 010B","E01026249","Total",26,9,10,7,2,0,2,0,24,9,8,7
"2011","South Holland 010C","E01026280","Total",45,14,16,15,11,1,6,4,34,13,10,11
"2011","South Holland 011A","E01026239","Total",41,12,13,16,5,1,2,2,36,11,11,14
"2011","South Holland 011B","E01026240","Total",34,9,10,15,3,0,1,2,31,9,9,13
"2011","South Holland 011C","E01026284","Total",44,19,10,15,7,0,2,5,37,19,8,10
"2011","South Kesteven 001A","E01026313","Total",24,12,8,4,4,0,2,2,20,12,6,2
"2011","South Kesteven 001B","E01026314","Total",37,13,12,12,5,1,2,2,32,12,10,10
"2011","South Kesteven 001C","E01026329","Total",39,12,13,14,4,0,2,2,35,12,11,12
"2011","South Kesteven 001D","E01026333","Total",39,20,13,6,3,0,3,0,36,20,10,6
"2011","South Kesteven 002A","E01026291","Total",31,13,11,7,4,1,2,1,27,12,9,6
"2011","South Kesteven 002B","E01026340","Total",54,19,15,20,2,0,2,0,52,19,13,20
"2011","South Kesteven 002C","E01026355","Total",47,17,16,14,2,1,1,0,45,16,15,14
"2011","South Kesteven 002D","E01026365","Total",26,12,11,3,2,0,2,0,24,12,9,3
"2011","South Kesteven 003A","E01026325","Total",71,23,17,31,5,0,3,2,66,23,14,29
"2011","South Kesteven 003B","E01026326","Total",33,10,10,13,4,0,3,1,29,10,7,12
"2011","South Kesteven 003C","E01026327","Total",39,12,12,15,3,1,2,0,36,11,10,15
"2011","South Kesteven 003D","E01026328","Total",80,26,13,41,7,2,2,3,73,24,11,38
"2011","South Kesteven 003E","E01026352","Total",16,3,8,5,2,0,1,1,14,3,7,4
"2011","South Kesteven 003F","E01026353","Total",60,20,21,19,4,0,4,0,56,20,17,19
"2011","South Kesteven 003G","E01026354","Total",15,7,6,2,2,0,1,1,13,7,5,1
"2011","South Kesteven 004A","E01026320","Total",16,11,4,1,0,0,0,0,16,11,4,1
"2011","South Kesteven 004B","E01026321","Total",14,8,5,1,1,0,1,0,13,8,4,1
"2011","South Kesteven 004C","E01026322","Total",23,17,6,0,1,0,1,0,22,17,5,0
"2011","South Kesteven 004D","E01026323","Total",40,11,13,16,2,0,1,1,38,11,12,15
"2011","South Kesteven 004E","E01026324","Total",49,22,18,9,6,2,4,0,43,20,14,9
"2011","South Kesteven 005A","E01026308","Total",119,37,10,72,11,2,2,7,108,35,8,65
"2011","South Kesteven 005B","E01026309","Total",63,26,18,19,4,0,1,3,59,26,17,16
"2011","South Kesteven 005C","E01026310","Total",49,18,11,20,3,0,3,0,46,18,8,20
"2011","South Kesteven 005D","E01026311","Total",68,26,18,24,7,1,4,2,61,25,14,22
"2011","South Kesteven 005E","E01026312","Total",119,39,12,68,13,1,1,11,106,38,11,57
"2011","South Kesteven 006A","E01026317","Total",95,32,28,35,6,1,5,0,89,31,23,35
"2011","South Kesteven 006B","E01026318","Total",107,42,26,39,9,2,2,5,98,40,24,34
"2011","South Kesteven 006C","E01026319","Total",49,20,16,13,5,0,4,1,44,20,12,12
"2011","South Kesteven 006D","E01026343","Total",79,31,24,24,14,2,8,4,65,29,16,20
"2011","South Kesteven 006E","E01026344","Total",44,14,19,11,5,0,3,2,39,14,16,9
"2011","South Kesteven 006F","E01026345","Total",66,14,19,33,9,2,3,4,57,12,16,29
"2011","South Kesteven 007A","E01026292","Total",40,23,12,5,4,2,1,1,36,21,11,4
"2011","South Kesteven 007B","E01026293","Total",52,20,20,12,5,0,4,1,47,20,16,11
"2011","South Kesteven 007C","E01026294","Total",50,27,16,7,4,2,1,1,46,25,15,6
"2011","South Kesteven 007D","E01026316","Total",43,18,19,6,7,0,7,0,36,18,12,6
"2011","South Kesteven 007E","E01026332","Total",27,15,2,10,5,0,1,4,22,15,1,6
"2011","South Kesteven 008A","E01026290","Total",37,15,11,11,4,1,3,0,33,14,8,11
"2011","South Kesteven 008B","E01026341","Total",29,11,7,11,3,0,1,2,26,11,6,9
"2011","South Kesteven 008C","E01026342","Total",28,10,14,4,3,0,2,1,25,10,12,3
"2011","South Kesteven 008D","E01026361","Total",80,28,25,27,6,1,4,1,74,27,21,26
"2011","South Kesteven 009A","E01026315","Total",47,14,20,13,1,0,1,0,46,14,19,13
"2011","South Kesteven 009B","E01026331","Total",54,24,16,14,9,2,6,1,45,22,10,13
"2011","South Kesteven 009C","E01026338","Total",23,5,8,10,5,1,1,3,18,4,7,7
"2011","South Kesteven 009D","E01026339","Total",33,14,6,13,2,1,0,1,31,13,6,12
"2011","South Kesteven 010A","E01026299","Total",56,17,15,24,5,0,3,2,51,17,12,22
"2011","South Kesteven 010B","E01026300","Total",20,12,8,0,1,1,0,0,19,11,8,0
"2011","South Kesteven 010C","E01026301","Total",19,6,10,3,5,0,5,0,14,6,5,3
"2011","South Kesteven 010D","E01026302","Total",29,12,13,4,2,1,1,0,27,11,12,4
"2011","South Kesteven 011B","E01026296","Total",18,8,5,5,3,0,1,2,15,8,4,3
"2011","South Kesteven 011C","E01026297","Total",23,10,7,6,2,1,0,1,21,9,7,5
"2011","South Kesteven 011D","E01026298","Total",63,21,16,26,6,1,3,2,57,20,13,24
"2011","South Kesteven 011E","E01032997","Total",53,22,21,10,4,0,4,0,49,22,17,10
"2011","South Kesteven 011F","E01032998","Total",45,14,19,12,5,1,2,2,40,13,17,10
"2011","South Kesteven 011G","E01032999","Total",32,19,8,5,1,0,1,0,31,19,7,5
"2011","South Kesteven 012A","E01026330","Total",34,16,11,7,2,0,2,0,32,16,9,7
"2011","South Kesteven 012B","E01026360","Total",37,15,15,7,6,0,6,0,31,15,9,7
"2011","South Kesteven 012C","E01026362","Total",27,13,9,5,3,0,2,1,24,13,7,4
"2011","South Kesteven 012D","E01026363","Total",18,6,5,7,4,1,3,0,14,5,2,7
"2011","South Kesteven 012E","E01026364","Total",33,13,11,9,3,0,3,0,30,13,8,9
"2011","South Kesteven 013A","E01026334","Total",25,13,7,5,0,0,0,0,25,13,7,5
"2011","South Kesteven 013B","E01026335","Total",30,12,12,6,4,1,3,0,26,11,9,6
"2011","South Kesteven 013C","E01026336","Total",54,15,11,28,6,1,2,3,48,14,9,25
"2011","South Kesteven 013D","E01026337","Total",37,14,16,7,4,0,4,0,33,14,12,7
"2011","South Kesteven 014A","E01026303","Total",34,16,10,8,4,0,2,2,30,16,8,6
"2011","South Kesteven 014B","E01026304","Total",27,13,7,7,2,0,0,2,25,13,7,5
"2011","South Kesteven 014C","E01026305","Total",55,25,17,13,4,1,2,1,51,24,15,12
"2011","South Kesteven 014D","E01026306","Total",51,19,16,16,3,0,3,0,48,19,13,16
"2011","South Kesteven 014E","E01026307","Total",25,10,11,4,1,0,0,1,24,10,11,3
"2011","South Kesteven 015A","E01026287","Total",41,16,10,15,3,1,1,1,38,15,9,14
"2011","South Kesteven 015B","E01026288","Total",85,26,12,47,7,0,3,4,78,26,9,43
"2011","South Kesteven 015C","E01026289","Total",67,26,15,26,3,0,3,0,64,26,12,26
"2011","South Kesteven 015D","E01026346","Total",31,9,10,12,3,0,2,1,28,9,8,11
"2011","South Kesteven 015E","E01026347","Total",41,15,15,11,3,0,2,1,38,15,13,10
"2011","South Kesteven 015F","E01026348","Total",48,24,6,18,3,1,0,2,45,23,6,16
"2011","South Kesteven 016A","E01026349","Total",88,36,23,29,4,1,2,1,84,35,21,28
"2011","South Kesteven 016B","E01026350","Total",28,6,9,13,1,0,0,1,27,6,9,12
"2011","South Kesteven 016C","E01026351","Total",27,8,12,7,4,0,4,0,23,8,8,7
"2011","South Kesteven 016D","E01026356","Total",37,16,15,6,1,0,1,0,36,16,14,6
"2011","South Kesteven 016E","E01026357","Total",40,15,20,5,4,0,4,0,36,15,16,5
"2011","South Kesteven 016F","E01026358","Total",19,12,5,2,1,0,1,0,18,12,4,2
"2011","South Kesteven 016G","E01026359","Total",24,15,7,2,2,1,0,1,22,14,7,1
"2011","West Lindsey 001A","E01026367","Total",38,12,14,12,5,2,2,1,33,10,12,11
"2011","West Lindsey 001B","E01026368","Total",47,14,17,16,6,1,5,0,41,13,12,16
"2011","West Lindsey 001C","E01026387","Total",30,13,12,5,4,2,2,0,26,11,10,5
"2011","West Lindsey 001D","E01026416","Total",22,5,9,8,2,0,1,1,20,5,8,7
"2011","West Lindsey 001G","E01032683","Total",49,27,16,6,5,3,2,0,44,24,14,6
"2011","West Lindsey 002A","E01026380","Total",60,28,15,17,7,2,4,1,53,26,11,16
"2011","West Lindsey 002B","E01026401","Total",30,11,14,5,3,0,3,0,27,11,11,5
"2011","West Lindsey 002C","E01026402","Total",46,17,17,12,8,0,5,3,38,17,12,9
"2011","West Lindsey 002D","E01026403","Total",20,7,6,7,2,1,1,0,18,6,5,7
"2011","West Lindsey 002E","E01026407","Total",13,6,5,2,1,1,0,0,12,5,5,2
"2011","West Lindsey 002F","E01026408","Total",25,14,5,6,3,0,2,1,22,14,3,5
"2011","West Lindsey 003A","E01026389","Total",60,27,17,16,3,0,2,1,57,27,15,15
"2011","West Lindsey 003B","E01026390","Total",60,28,15,17,7,1,3,3,53,27,12,14
"2011","West Lindsey 003C","E01026391","Total",32,14,9,9,7,2,5,0,25,12,4,9
"2011","West Lindsey 003D","E01026392","Total",52,20,15,17,6,0,4,2,46,20,11,15
"2011","West Lindsey 003E","E01026415","Total",29,5,7,17,5,1,2,2,24,4,5,15
"2011","West Lindsey 004A","E01026378","Total",79,22,15,42,10,0,8,2,69,22,7,40
"2011","West Lindsey 004B","E01026379","Total",40,19,4,17,1,1,0,0,39,18,4,17
"2011","West Lindsey 004C","E01026381","Total",67,28,11,28,5,2,2,1,62,26,9,27
"2011","West Lindsey 004D","E01026382","Total",48,14,8,26,4,2,2,0,44,12,6,26
"2011","West Lindsey 004E","E01026383","Total",51,15,9,27,5,0,2,3,46,15,7,24
"2011","West Lindsey 004F","E01026384","Total",76,19,22,35,9,0,5,4,67,19,17,31
"2011","West Lindsey 005A","E01026385","Total",32,10,15,7,5,0,5,0,27,10,10,7
"2011","West Lindsey 005B","E01026386","Total",36,9,12,15,2,0,1,1,34,9,11,14
"2011","West Lindsey 005C","E01026399","Total",33,18,7,8,4,2,1,1,29,16,6,7
"2011","West Lindsey 005D","E01026411","Total",35,8,13,14,6,0,3,3,29,8,10,11
"2011","West Lindsey 006A","E01026374","Total",105,31,18,56,10,1,3,6,95,30,15,50
"2011","West Lindsey 006B","E01026375","Total",77,24,15,38,6,1,2,3,71,23,13,35
"2011","West Lindsey 006C","E01026376","Total",93,28,15,50,9,2,6,1,84,26,9,49
"2011","West Lindsey 006D","E01026377","Total",91,32,25,34,6,1,4,1,85,31,21,33
"2011","West Lindsey 007A","E01026388","Total",40,19,13,8,10,1,6,3,30,18,7,5
"2011","West Lindsey 007B","E01026404","Total",28,6,12,10,7,0,5,2,21,6,7,8
"2011","West Lindsey 007C","E01026409","Total",21,4,11,6,4,1,3,0,17,3,8,6
"2011","West Lindsey 007D","E01026410","Total",19,5,9,5,4,0,3,1,15,5,6,4
"2011","West Lindsey 008A","E01026372","Total",58,28,20,10,8,1,5,2,50,27,15,8
"2011","West Lindsey 008B","E01026412","Total",49,21,14,14,3,1,2,0,46,20,12,14
"2011","West Lindsey 008C","E01026413","Total",52,21,20,11,5,0,4,1,47,21,16,10
"2011","West Lindsey 008D","E01026414","Total",43,22,13,8,2,0,2,0,41,22,11,8
"2011","West Lindsey 009A","E01026396","Total",21,12,5,4,3,0,3,0,18,12,2,4
"2011","West Lindsey 009B","E01026397","Total",45,15,19,11,6,0,5,1,39,15,14,10
"2011","West Lindsey 009C","E01026398","Total",35,18,8,9,1,0,0,1,34,18,8,8
"2011","West Lindsey 009D","E01026400","Total",50,19,14,17,3,0,1,2,47,19,13,15
"2011","West Lindsey 010A","E01026393","Total",18,5,10,3,0,0,0,0,18,5,10,3
"2011","West Lindsey 010B","E01026394","Total",34,18,10,6,2,0,2,0,32,18,8,6
"2011","West Lindsey 010C","E01026395","Total",25,11,10,4,1,0,1,0,24,11,9,4
"2011","West Lindsey 010D","E01026405","Total",14,8,5,1,3,1,2,0,11,7,3,1
"2011","West Lindsey 010E","E01026406","Total",15,6,9,0,2,1,1,0,13,5,8,0
"2011","West Lindsey 011A","E01026366","Total",39,14,13,12,5,1,2,2,34,13,11,10
"2011","West Lindsey 011B","E01026369","Total",28,10,13,5,3,1,2,0,25,9,11,5
"2011","West Lindsey 011C","E01026370","Total",35,12,14,9,0,0,0,0,35,12,14,9
"2011","West Lindsey 011D","E01026371","Total",17,8,5,4,2,2,0,0,15,6,5,4
"2011","West Lindsey 011E","E01026373","Total",39,16,14,9,1,1,0,0,38,15,14,9
"2011","Corby 001A","E01026971","Total",55,16,14,25,8,0,5,3,47,16,9,22
"2011","Corby 001B","E01026979","Total",34,15,13,6,2,1,1,0,32,14,12,6
"2011","Corby 001C","E01026980","Total",18,6,9,3,0,0,0,0,18,6,9,3
"2011","Corby 001D","E01026982","Total",103,32,27,44,6,1,4,1,97,31,23,43
"2011","Corby 002A","E01026969","Total",56,21,20,15,7,0,3,4,49,21,17,11
"2011","Corby 002B","E01026970","Total",68,29,25,14,6,0,5,1,62,29,20,13
"2011","Corby 002C","E01026972","Total",99,42,23,34,13,0,8,5,86,42,15,29
"2011","Corby 002D","E01026976","Total",64,18,20,26,7,1,4,2,57,17,16,24
"2011","Corby 002E","E01026981","Total",34,13,10,11,3,0,2,1,31,13,8,10
"2011","Corby 002F","E01026983","Total",36,10,12,14,4,1,3,0,32,9,9,14
"2011","Corby 003A","E01026957","Total",42,16,11,15,1,0,0,1,41,16,11,14
"2011","Corby 003B","E01026958","Total",84,28,14,42,7,2,3,2,77,26,11,40
"2011","Corby 003C","E01026977","Total",45,16,14,15,3,1,2,0,42,15,12,15
"2011","Corby 003D","E01026978","Total",38,15,14,9,8,1,4,3,30,14,10,6
"2011","Corby 004A","E01026962","Total",74,36,17,21,6,1,5,0,68,35,12,21
"2011","Corby 004B","E01026973","Total",46,20,13,13,3,0,1,2,43,20,12,11
"2011","Corby 004C","E01026974","Total",28,15,8,5,3,1,1,1,25,14,7,4
"2011","Corby 004D","E01026975","Total",68,23,15,30,5,0,5,0,63,23,10,30
"2011","Corby 004E","E01026984","Total",52,24,14,14,8,2,6,0,44,22,8,14
"2011","Corby 004F","E01026985","Total",39,21,8,10,3,0,1,2,36,21,7,8
"2011","Corby 005A","E01026949","Total",45,15,9,21,12,0,3,9,33,15,6,12
"2011","Corby 005B","E01026950","Total",92,31,15,46,9,1,4,4,83,30,11,42
"2011","Corby 005C","E01026951","Total",60,26,13,21,5,0,2,3,55,26,11,18
"2011","Corby 005D","E01026952","Total",36,19,7,10,2,0,1,1,34,19,6,9
"2011","Corby 006A","E01026959","Total",61,19,13,29,5,1,3,1,56,18,10,28
"2011","Corby 006B","E01026960","Total",89,31,11,47,0,0,0,0,89,31,11,47
"2011","Corby 006C","E01026961","Total",69,27,12,30,8,2,3,3,61,25,9,27
"2011","Corby 006D","E01026965","Total",64,18,12,34,5,2,1,2,59,16,11,32
"2011","Corby 006E","E01026966","Total",66,18,15,33,2,0,1,1,64,18,14,32
"2011","Corby 006F","E01026967","Total",60,14,19,27,6,4,2,0,54,10,17,27
"2011","Corby 006G","E01026968","Total",86,28,5,53,8,2,2,4,78,26,3,49
"2011","Corby 008A","E01026953","Total",27,11,10,6,3,0,2,1,24,11,8,5
"2011","Corby 008B","E01026954","Total",67,21,21,25,3,1,2,0,64,20,19,25
"2011","Corby 008C","E01026955","Total",19,9,6,4,1,0,1,0,18,9,5,4
"2011","Corby 008D","E01026956","Total",72,35,18,19,11,3,3,5,61,32,15,14
"2011","Corby 009A","E01026963","Total",92,33,25,34,6,0,4,2,86,33,21,32
"2011","Corby 009B","E01032963","Total",40,11,19,10,8,0,7,1,32,11,12,9
"2011","Corby 009C","E01032964","Total",52,24,21,7,2,1,1,0,50,23,20,7
"2011","Corby 009D","E01032965","Total",37,13,16,8,8,4,4,0,29,9,12,8
"2011","Corby 009E","E01032966","Total",48,15,24,9,7,1,5,1,41,14,19,8
"2011","Corby 009F","E01032967","Total",55,15,17,23,3,0,3,0,52,15,14,23
"2011","Daventry 001A","E01027005","Total",27,13,11,3,5,0,5,0,22,13,6,3
"2011","Daventry 001B","E01027026","Total",34,19,11,4,2,1,1,0,32,18,10,4
"2011","Daventry 001C","E01027030","Total",29,7,17,5,7,0,7,0,22,7,10,5
"2011","Daventry 002A","E01027000","Total",46,21,12,13,6,1,3,2,40,20,9,11
"2011","Daventry 002B","E01027001","Total",24,10,13,1,2,0,2,0,22,10,11,1
"2011","Daventry 002C","E01027002","Total",21,7,9,5,4,0,3,1,17,7,6,4
"2011","Daventry 002D","E01027003","Total",45,17,20,8,7,0,6,1,38,17,14,7
"2011","Daventry 002E","E01027022","Total",32,13,10,9,3,0,3,0,29,13,7,9
"2011","Daventry 003A","E01026994","Total",14,5,4,5,2,0,1,1,12,5,3,4
"2011","Daventry 003D","E01026999","Total",40,17,12,11,4,0,3,1,36,17,9,10
"2011","Daventry 003E","E01027006","Total",41,20,13,8,5,0,5,0,36,20,8,8
"2011","Daventry 003F","E01032968","Total",42,12,21,9,6,0,5,1,36,12,16,8
"2011","Daventry 004A","E01026998","Total",21,4,11,6,3,0,3,0,18,4,8,6
"2011","Daventry 004B","E01027015","Total",16,6,6,4,1,0,1,0,15,6,5,4
"2011","Daventry 004C","E01027016","Total",28,9,15,4,5,0,4,1,23,9,11,3
"2011","Daventry 004D","E01027021","Total",23,5,10,8,4,0,3,1,19,5,7,7
"2011","Daventry 004E","E01027027","Total",45,19,17,9,8,2,4,2,37,17,13,7
"2011","Daventry 005A","E01026997","Total",30,8,17,5,4,0,4,0,26,8,13,5
"2011","Daventry 005B","E01027018","Total",19,7,9,3,3,0,3,0,16,7,6,3
"2011","Daventry 005C","E01027019","Total",37,11,15,11,3,0,3,0,34,11,12,11
"2011","Daventry 005D","E01027020","Total",28,6,14,8,0,0,0,0,28,6,14,8
"2011","Daventry 005E","E01027023","Total",36,14,12,10,2,0,2,0,34,14,10,10
"2011","Daventry 006A","E01026987","Total",26,14,4,8,4,1,1,2,22,13,3,6
"2011","Daventry 006B","E01026989","Total",59,21,16,22,3,0,2,1,56,21,14,21
"2011","Daventry 006C","E01026990","Total",92,34,31,27,10,1,8,1,82,33,23,26
"2011","Daventry 006D","E01027012","Total",66,28,15,23,9,1,4,4,57,27,11,19
"2011","Daventry 006E","E01027014","Total",68,26,23,19,7,1,4,2,61,25,19,17
"2011","Daventry 007A","E01026986","Total",110,42,25,43,8,1,4,3,102,41,21,40
"2011","Daventry 007B","E01026988","Total",70,19,9,42,7,3,0,4,63,16,9,38
"2011","Daventry 007C","E01026991","Total",15,6,6,3,0,0,0,0,15,6,6,3
"2011","Daventry 007D","E01026992","Total",49,14,11,24,10,0,6,4,39,14,5,20
"2011","Daventry 007E","E01027010","Total",21,8,3,10,0,0,0,0,21,8,3,10
"2011","Daventry 008A","E01027007","Total",57,12,23,22,5,0,3,2,52,12,20,20
"2011","Daventry 008B","E01027008","Total",55,17,27,11,5,0,5,0,50,17,22,11
"2011","Daventry 008C","E01027009","Total",60,12,14,34,9,0,7,2,51,12,7,32
"2011","Daventry 008D","E01027013","Total",127,40,29,58,9,3,4,2,118,37,25,56
"2011","Daventry 009A","E01027011","Total",21,7,6,8,4,0,3,1,17,7,3,7
"2011","Daventry 009B","E01027017","Total",45,18,14,13,2,0,2,0,43,18,12,13
"2011","Daventry 009C","E01027024","Total",20,15,3,2,2,0,1,1,18,15,2,1
"2011","Daventry 009D","E01027025","Total",48,15,14,19,4,0,4,0,44,15,10,19
"2011","Daventry 010A","E01026993","Total",28,17,9,2,5,3,2,0,23,14,7,2
"2011","Daventry 010B","E01027004","Total",23,11,7,5,6,0,5,1,17,11,2,4
"2011","Daventry 010C","E01027028","Total",49,14,24,11,9,1,8,0,40,13,16,11
"2011","Daventry 010D","E01027029","Total",60,19,21,20,7,0,6,1,53,19,15,19
"2011","East Northamptonshire 001A","E01027033","Total",44,13,12,19,5,0,3,2,39,13,9,17
"2011","East Northamptonshire 001B","E01027043","Total",38,13,15,10,5,1,1,3,33,12,14,7
"2011","East Northamptonshire 001C","E01027050","Total",33,11,12,10,4,0,3,1,29,11,9,9
"2011","East Northamptonshire 002A","E01027031","Total",31,8,16,7,5,2,2,1,26,6,14,6
"2011","East Northamptonshire 002B","E01027044","Total",29,13,10,6,5,0,5,0,24,13,5,6
"2011","East Northamptonshire 002C","E01027046","Total",35,13,18,4,5,0,5,0,30,13,13,4
"2011","East Northamptonshire 002D","E01027047","Total",23,10,7,6,1,0,0,1,22,10,7,5
"2011","East Northamptonshire 002E","E01027048","Total",40,16,19,5,6,1,5,0,34,15,14,5
"2011","East Northamptonshire 002F","E01027049","Total",15,8,5,2,4,1,3,0,11,7,2,2
"2011","East Northamptonshire 003A","E01027032","Total",30,11,12,7,5,0,3,2,25,11,9,5
"2011","East Northamptonshire 003B","E01027045","Total",34,11,14,9,6,1,4,1,28,10,10,8
"2011","East Northamptonshire 003C","E01027075","Total",50,21,14,15,4,0,4,0,46,21,10,15
"2011","East Northamptonshire 003D","E01027076","Total",53,21,21,11,8,1,6,1,45,20,15,10
"2011","East Northamptonshire 003E","E01027077","Total",41,19,16,6,7,0,6,1,34,19,10,5
"2011","East Northamptonshire 004A","E01027057","Total",25,10,8,7,2,0,2,0,23,10,6,7
"2011","East Northamptonshire 004B","E01027074","Total",39,20,10,9,5,1,4,0,34,19,6,9
"2011","East Northamptonshire 004C","E01027078","Total",41,17,17,7,10,0,8,2,31,17,9,5
"2011","East Northamptonshire 005A","E01027051","Total",52,21,16,15,10,0,5,5,42,21,11,10
"2011","East Northamptonshire 005B","E01027052","Total",33,12,12,9,4,0,3,1,29,12,9,8
"2011","East Northamptonshire 005C","E01027053","Total",23,9,10,4,3,1,2,0,20,8,8,4
"2011","East Northamptonshire 005D","E01027054","Total",16,6,7,3,1,0,1,0,15,6,6,3
"2011","East Northamptonshire 005E","E01027055","Total",33,17,12,4,5,1,3,1,28,16,9,3
"2011","East Northamptonshire 005F","E01027056","Total",55,22,9,24,7,0,2,5,48,22,7,19
"2011","East Northamptonshire 006A","E01027038","Total",63,13,18,32,4,1,2,1,59,12,16,31
"2011","East Northamptonshire 006B","E01027039","Total",45,20,9,16,4,2,0,2,41,18,9,14
"2011","East Northamptonshire 006C","E01027040","Total",27,10,10,7,2,1,1,0,25,9,9,7
"2011","East Northamptonshire 006D","E01027041","Total",70,15,18,37,4,0,1,3,66,15,17,34
"2011","East Northamptonshire 006E","E01027042","Total",61,22,25,14,4,0,4,0,57,22,21,14
"2011","East Northamptonshire 007A","E01027034","Total",32,12,10,10,6,2,1,3,26,10,9,7
"2011","East Northamptonshire 007B","E01027035","Total",55,18,10,27,6,1,2,3,49,17,8,24
"2011","East Northamptonshire 007D","E01027037","Total",42,20,17,5,4,0,4,0,38,20,13,5
"2011","East Northamptonshire 007E","E01033244","Total",48,15,25,8,6,1,5,0,42,14,20,8
"2011","East Northamptonshire 007F","E01033245","Total",31,12,15,4,2,0,2,0,29,12,13,4
"2011","East Northamptonshire 008A","E01027061","Total",67,21,12,34,4,0,3,1,63,21,9,33
"2011","East Northamptonshire 008B","E01027062","Total",75,28,14,33,4,1,2,1,71,27,12,32
"2011","East Northamptonshire 008C","E01027063","Total",34,11,15,8,8,0,7,1,26,11,8,7
"2011","East Northamptonshire 008D","E01027064","Total",20,7,10,3,3,1,2,0,17,6,8,3
"2011","East Northamptonshire 008E","E01027072","Total",94,31,12,51,3,1,0,2,91,30,12,49
"2011","East Northamptonshire 008F","E01027073","Total",52,22,12,18,5,1,2,2,47,21,10,16
"2011","East Northamptonshire 009A","E01027058","Total",64,18,7,39,1,0,0,1,63,18,7,38
"2011","East Northamptonshire 009B","E01027059","Total",61,21,14,26,6,2,3,1,55,19,11,25
"2011","East Northamptonshire 009C","E01027060","Total",69,19,26,24,7,0,6,1,62,19,20,23
"2011","East Northamptonshire 009D","E01027065","Total",63,20,19,24,4,0,2,2,59,20,17,22
"2011","East Northamptonshire 009E","E01027069","Total",38,12,14,12,5,0,4,1,33,12,10,11
"2011","East Northamptonshire 010A","E01027066","Total",24,11,9,4,2,0,1,1,22,11,8,3
"2011","East Northamptonshire 010B","E01027067","Total",16,10,4,2,3,1,1,1,13,9,3,1
"2011","East Northamptonshire 010C","E01027068","Total",62,24,23,15,6,2,3,1,56,22,20,14
"2011","East Northamptonshire 010D","E01027070","Total",25,5,12,8,7,0,4,3,18,5,8,5
"2011","East Northamptonshire 010E","E01027071","Total",24,8,10,6,4,0,3,1,20,8,7,5
"2011","Kettering 001A","E01027090","Total",20,6,9,5,3,1,2,0,17,5,7,5
"2011","Kettering 001B","E01027103","Total",40,18,15,7,7,1,6,0,33,17,9,7
"2011","Kettering 001C","E01027129","Total",24,8,7,9,2,0,2,0,22,8,5,9
"2011","Kettering 002B","E01027094","Total",17,12,3,2,1,0,0,1,16,12,3,1
"2011","Kettering 002C","E01027095","Total",30,8,8,14,5,0,4,1,25,8,4,13
"2011","Kettering 002D","E01027107","Total",48,15,12,21,3,0,0,3,45,15,12,18
"2011","Kettering 002E","E01027108","Total",13,4,6,3,3,0,3,0,10,4,3,3
"2011","Kettering 002F","E01027109","Total",29,11,6,12,3,1,1,1,26,10,5,11
"2011","Kettering 002G","E01032969","Total",47,14,19,14,4,0,4,0,43,14,15,14
"2011","Kettering 002H","E01032970","Total",49,16,13,20,2,0,1,1,47,16,12,19
"2011","Kettering 002I","E01032971","Total",37,12,6,19,6,1,3,2,31,11,3,17
"2011","Kettering 003A","E01027123","Total",40,20,8,12,3,2,1,0,37,18,7,12
"2011","Kettering 003B","E01027124","Total",83,32,19,32,8,2,2,4,75,30,17,28
"2011","Kettering 003C","E01027125","Total",33,14,4,15,4,1,1,2,29,13,3,13
"2011","Kettering 003D","E01027126","Total",83,28,20,35,6,1,4,1,77,27,16,34
"2011","Kettering 004A","E01027079","Total",67,23,21,23,7,0,5,2,60,23,16,21
"2011","Kettering 004B","E01027080","Total",31,15,14,2,3,0,3,0,28,15,11,2
"2011","Kettering 004C","E01027087","Total",29,8,9,12,3,1,1,1,26,7,8,11
"2011","Kettering 004D","E01027088","Total",26,10,9,7,3,0,3,0,23,10,6,7
"2011","Kettering 004E","E01027089","Total",51,19,15,17,4,0,3,1,47,19,12,16
"2011","Kettering 005A","E01027081","Total",60,21,5,34,1,0,1,0,59,21,4,34
"2011","Kettering 005B","E01027082","Total",87,25,17,45,13,0,7,6,74,25,10,39
"2011","Kettering 005C","E01027083","Total",95,21,9,65,8,0,1,7,87,21,8,58
"2011","Kettering 005D","E01027127","Total",94,30,14,50,4,1,0,3,90,29,14,47
"2011","Kettering 005E","E01027128","Total",106,48,16,42,4,0,3,1,102,48,13,41
"2011","Kettering 006A","E01027105","Total",69,33,20,16,6,1,2,3,63,32,18,13
"2011","Kettering 006B","E01027106","Total",86,34,20,32,13,3,6,4,73,31,14,28
"2011","Kettering 006C","E01027111","Total",104,30,40,34,13,1,9,3,91,29,31,31
"2011","Kettering 006D","E01027112","Total",104,39,27,38,17,5,10,2,87,34,17,36
"2011","Kettering 007A","E01027104","Total",78,24,22,32,8,0,4,4,70,24,18,28
"2011","Kettering 007B","E01027110","Total",48,14,6,28,2,0,0,2,46,14,6,26
"2011","Kettering 007C","E01027113","Total",41,18,8,15,6,0,3,3,35,18,5,12
"2011","Kettering 007D","E01027115","Total",16,10,4,2,3,2,1,0,13,8,3,2
"2011","Kettering 007E","E01027116","Total",63,25,23,15,11,1,9,1,52,24,14,14
"2011","Kettering 007F","E01027117","Total",22,10,9,3,3,0,3,0,19,10,6,3
"2011","Kettering 008A","E01027096","Total",26,10,7,9,1,0,0,1,25,10,7,8
"2011","Kettering 008B","E01027097","Total",25,12,9,4,3,0,3,0,22,12,6,4
"2011","Kettering 008C","E01027098","Total",28,16,8,4,3,0,2,1,25,16,6,3
"2011","Kettering 008D","E01027099","Total",27,7,16,4,3,0,2,1,24,7,14,3
"2011","Kettering 008E","E01027122","Total",22,13,6,3,4,2,2,0,18,11,4,3
"2011","Kettering 009A","E01027100","Total",42,8,14,20,7,0,4,3,35,8,10,17
"2011","Kettering 009B","E01027114","Total",43,13,16,14,9,0,5,4,34,13,11,10
"2011","Kettering 009C","E01027130","Total",47,15,7,25,5,0,4,1,42,15,3,24
"2011","Kettering 009D","E01027131","Total",87,28,21,38,13,3,5,5,74,25,16,33
"2011","Kettering 010A","E01027084","Total",28,12,13,3,4,1,3,0,24,11,10,3
"2011","Kettering 010B","E01027085","Total",29,11,7,11,2,1,1,0,27,10,6,11
"2011","Kettering 010C","E01027086","Total",37,13,18,6,6,0,6,0,31,13,12,6
"2011","Kettering 010D","E01027120","Total",31,11,12,8,3,0,3,0,28,11,9,8
"2011","Kettering 010E","E01027121","Total",21,10,10,1,6,0,6,0,15,10,4,1
"2011","Kettering 011A","E01027091","Total",73,36,16,21,5,0,3,2,68,36,13,19
"2011","Kettering 011B","E01027092","Total",24,15,6,3,2,0,2,0,22,15,4,3
"2011","Kettering 011C","E01027101","Total",70,30,16,24,9,1,5,3,61,29,11,21
"2011","Kettering 011D","E01027102","Total",47,27,10,10,7,1,5,1,40,26,5,9
"2011","Kettering 011F","E01027119","Total",40,11,11,18,7,0,4,3,33,11,7,15
"2011","Kettering 011G","E01032972","Total",28,9,13,6,5,0,4,1,23,9,9,5
"2011","Kettering 011H","E01032973","Total",34,9,15,10,5,0,5,0,29,9,10,10
"2011","Kettering 011I","E01032974","Total",36,15,15,6,5,1,4,0,31,14,11,6
"2011","Northampton 001A","E01027145","Total",27,9,9,9,2,0,1,1,25,9,8,8
"2011","Northampton 001B","E01027148","Total",35,20,9,6,1,1,0,0,34,19,9,6
"2011","Northampton 001C","E01027149","Total",29,12,11,6,4,1,2,1,25,11,9,5
"2011","Northampton 001D","E01027232","Total",64,26,17,21,3,1,1,1,61,25,16,20
"2011","Northampton 002A","E01027218","Total",27,15,8,4,2,1,1,0,25,14,7,4
"2011","Northampton 002B","E01027219","Total",24,4,14,6,7,0,5,2,17,4,9,4
"2011","Northampton 002C","E01027221","Total",32,12,13,7,6,3,3,0,26,9,10,7
"2011","Northampton 002D","E01027222","Total",27,15,7,5,1,0,1,0,26,15,6,5
"2011","Northampton 003A","E01027143","Total",34,13,10,11,5,0,4,1,29,13,6,10
"2011","Northampton 003B","E01027144","Total",19,13,3,3,1,0,0,1,18,13,3,2
"2011","Northampton 003C","E01027146","Total",42,20,11,11,6,2,4,0,36,18,7,11
"2011","Northampton 003D","E01027147","Total",67,24,22,21,4,0,3,1,63,24,19,20
"2011","Northampton 004A","E01027195","Total",78,28,14,36,11,3,3,5,67,25,11,31
"2011","Northampton 004B","E01027245","Total",72,22,21,29,7,0,6,1,65,22,15,28
"2011","Northampton 004C","E01027247","Total",69,17,22,30,11,0,7,4,58,17,15,26
"2011","Northampton 004D","E01027248","Total",109,40,16,53,7,0,3,4,102,40,13,49
"2011","Northampton 004E","E01027249","Total",136,44,25,67,15,0,5,10,121,44,20,57
"2011","Northampton 005A","E01027174","Total",23,7,9,7,9,0,5,4,14,7,4,3
"2011","Northampton 005B","E01027175","Total",84,25,26,33,8,1,5,2,76,24,21,31
"2011","Northampton 005C","E01027178","Total",151,47,31,73,12,0,4,8,139,47,27,65
"2011","Northampton 005D","E01027200","Total",93,24,17,52,13,3,4,6,80,21,13,46
"2011","Northampton 005E","E01027246","Total",142,36,29,77,12,0,8,4,130,36,21,73
"2011","Northampton 006A","E01027171","Total",39,17,15,7,5,1,3,1,34,16,12,6
"2011","Northampton 006B","E01027172","Total",40,9,19,12,5,0,4,1,35,9,15,11
"2011","Northampton 006C","E01027182","Total",23,8,7,8,1,0,1,0,22,8,6,8
"2011","Northampton 006D","E01027183","Total",9,2,3,4,2,1,1,0,7,1,2,4
"2011","Northampton 007A","E01027196","Total",61,15,20,26,5,0,4,1,56,15,16,25
"2011","Northampton 007B","E01027197","Total",52,26,12,14,1,0,1,0,51,26,11,14
"2011","Northampton 007C","E01027198","Total",100,35,18,47,8,0,3,5,92,35,15,42
"2011","Northampton 007D","E01027199","Total",127,41,25,61,15,4,5,6,112,37,20,55
"2011","Northampton 008A","E01027190","Total",32,13,13,6,8,1,5,2,24,12,8,4
"2011","Northampton 008B","E01027191","Total",67,27,16,24,4,0,3,1,63,27,13,23
"2011","Northampton 008C","E01027193","Total",28,11,12,5,5,1,4,0,23,10,8,5
"2011","Northampton 008D","E01027194","Total",18,6,8,4,3,0,3,0,15,6,5,4
"2011","Northampton 009A","E01027192","Total",46,15,11,20,2,0,2,0,44,15,9,20
"2011","Northampton 009B","E01027229","Total",79,26,18,35,6,1,1,4,73,25,17,31
"2011","Northampton 009C","E01027230","Total",127,38,19,70,11,0,3,8,116,38,16,62
"2011","Northampton 009D","E01027231","Total",81,24,20,37,4,1,3,0,77,23,17,37
"2011","Northampton 010A","E01027179","Total",62,25,19,18,3,0,3,0,59,25,16,18
"2011","Northampton 010B","E01027180","Total",42,15,15,12,8,0,3,5,34,15,12,7
"2011","Northampton 010C","E01027181","Total",17,6,10,1,2,0,2,0,15,6,8,1
"2011","Northampton 011A","E01027140","Total",76,28,14,34,3,1,1,1,73,27,13,33
"2011","Northampton 011B","E01027142","Total",43,15,15,13,8,2,4,2,35,13,11,11
"2011","Northampton 011C","E01027176","Total",42,17,13,12,6,0,4,2,36,17,9,10
"2011","Northampton 011D","E01027177","Total",111,39,19,53,11,0,2,9,100,39,17,44
"2011","Northampton 012A","E01027168","Total",103,27,11,65,12,1,3,8,91,26,8,57
"2011","Northampton 012B","E01027169","Total",42,18,13,11,6,1,4,1,36,17,9,10
"2011","Northampton 012C","E01027170","Total",116,37,28,51,13,0,6,7,103,37,22,44
"2011","Northampton 012D","E01027173","Total",86,25,24,37,12,2,6,4,74,23,18,33
"2011","Northampton 013A","E01027136","Total",31,13,11,7,4,1,2,1,27,12,9,6
"2011","Northampton 013B","E01027186","Total",31,10,14,7,3,0,3,0,28,10,11,7
"2011","Northampton 013C","E01027188","Total",99,41,23,35,8,0,5,3,91,41,18,32
"2011","Northampton 013D","E01027220","Total",9,2,5,2,1,1,0,0,8,1,5,2
"2011","Northampton 014A","E01027208","Total",33,12,6,15,4,0,1,3,29,12,5,12
"2011","Northampton 014B","E01027209","Total",39,19,15,5,7,0,5,2,32,19,10,3
"2011","Northampton 014C","E01027211","Total",27,13,10,4,5,0,4,1,22,13,6,3
"2011","Northampton 014D","E01027212","Total",33,19,11,3,1,0,1,0,32,19,10,3
"2011","Northampton 015A","E01027184","Total",43,14,13,16,6,1,3,2,37,13,10,14
"2011","Northampton 015B","E01027185","Total",43,14,16,13,4,1,2,1,39,13,14,12
"2011","Northampton 015C","E01027187","Total",20,5,5,10,5,1,3,1,15,4,2,9
"2011","Northampton 015D","E01027189","Total",57,17,18,22,3,1,2,0,54,16,16,22
"2011","Northampton 016A","E01027137","Total",81,26,17,38,7,1,6,0,74,25,11,38
"2011","Northampton 016B","E01027138","Total",36,13,12,11,2,0,2,0,34,13,10,11
"2011","Northampton 016C","E01027139","Total",48,12,16,20,7,0,5,2,41,12,11,18
"2011","Northampton 016D","E01027141","Total",36,15,10,11,3,0,2,1,33,15,8,10
"2011","Northampton 016E","E01027259","Total",28,6,15,7,9,3,6,0,19,3,9,7
"2011","Northampton 017A","E01027239","Total",93,30,15,48,6,1,3,2,87,29,12,46
"2011","Northampton 017B","E01027241","Total",80,32,11,37,10,3,3,4,70,29,8,33
"2011","Northampton 017C","E01027242","Total",93,28,17,48,3,0,2,1,90,28,15,47
"2011","Northampton 017D","E01027243","Total",95,30,25,40,3,2,1,0,92,28,24,40
"2011","Northampton 017E","E01027244","Total",143,41,29,73,12,1,7,4,131,40,22,69
"2011","Northampton 018A","E01027213","Total",45,22,13,10,5,1,3,1,40,21,10,9
"2011","Northampton 018B","E01027214","Total",60,23,16,21,3,0,2,1,57,23,14,20
"2011","Northampton 018C","E01027216","Total",21,9,6,6,3,1,2,0,18,8,4,6
"2011","Northampton 018D","E01027240","Total",66,25,21,20,10,1,7,2,56,24,14,18
"2011","Northampton 019A","E01027207","Total",15,6,7,2,2,0,1,1,13,6,6,1
"2011","Northampton 019B","E01027210","Total",25,8,8,9,2,0,2,0,23,8,6,9
"2011","Northampton 019C","E01027215","Total",36,15,14,7,2,1,1,0,34,14,13,7
"2011","Northampton 019D","E01027217","Total",50,17,12,21,4,0,3,1,46,17,9,20
"2011","Northampton 020A","E01027255","Total",26,9,12,5,3,1,2,0,23,8,10,5
"2011","Northampton 020B","E01027256","Total",21,6,13,2,5,0,5,0,16,6,8,2
"2011","Northampton 020C","E01027258","Total",24,9,12,3,3,0,3,0,21,9,9,3
"2011","Northampton 020D","E01027260","Total",17,7,3,7,4,1,1,2,13,6,2,5
"2011","Northampton 021B","E01027152","Total",72,21,8,43,10,0,3,7,62,21,5,36
"2011","Northampton 021C","E01027153","Total",60,22,12,26,3,0,2,1,57,22,10,25
"2011","Northampton 021D","E01027154","Total",83,26,16,41,5,1,3,1,78,25,13,40
"2011","Northampton 021E","E01032978","Total",64,20,17,27,10,3,3,4,54,17,14,23
"2011","Northampton 021F","E01032979","Total",82,21,8,53,4,0,0,4,78,21,8,49
"2011","Northampton 022A","E01027132","Total",63,30,21,12,7,1,4,2,56,29,17,10
"2011","Northampton 022B","E01027133","Total",59,21,27,11,10,0,9,1,49,21,18,10
"2011","Northampton 022C","E01027134","Total",40,16,13,11,2,0,1,1,38,16,12,10
"2011","Northampton 022D","E01027135","Total",35,15,12,8,5,0,2,3,30,15,10,5
"2011","Northampton 023A","E01027155","Total",78,20,24,34,10,1,9,0,68,19,15,34
"2011","Northampton 023B","E01027225","Total",54,13,15,26,3,0,3,0,51,13,12,26
"2011","Northampton 023C","E01027227","Total",68,21,19,28,6,1,3,2,62,20,16,26
"2011","Northampton 023D","E01027228","Total",62,17,22,23,2,0,2,0,60,17,20,23
"2011","Northampton 024A","E01027151","Total",61,22,16,23,4,1,1,2,57,21,15,21
"2011","Northampton 024B","E01027236","Total",23,9,8,6,1,0,1,0,22,9,7,6
"2011","Northampton 024C","E01027237","Total",65,22,19,24,5,0,2,3,60,22,17,21
"2011","Northampton 024D","E01027238","Total",76,34,18,24,7,2,3,2,69,32,15,22
"2011","Northampton 025A","E01027223","Total",62,16,23,23,11,1,7,3,51,15,16,20
"2011","Northampton 025B","E01027224","Total",60,23,22,15,5,0,4,1,55,23,18,14
"2011","Northampton 025C","E01027226","Total",59,22,16,21,5,2,2,1,54,20,14,20
"2011","Northampton 025D","E01027257","Total",15,5,9,1,8,3,4,1,7,2,5,0
"2011","Northampton 026A","E01027233","Total",102,35,16,51,9,1,4,4,93,34,12,47
"2011","Northampton 026B","E01027234","Total",46,14,16,16,4,0,3,1,42,14,13,15
"2011","Northampton 026C","E01027235","Total",101,29,19,53,13,1,6,6,88,28,13,47
"2011","Northampton 026D","E01027252","Total",93,32,22,39,10,1,7,2,83,31,15,37
"2011","Northampton 027A","E01027156","Total",66,19,17,30,6,1,4,1,60,18,13,29
"2011","Northampton 027B","E01027159","Total",30,9,15,6,3,0,3,0,27,9,12,6
"2011","Northampton 027C","E01027160","Total",36,12,15,9,2,0,2,0,34,12,13,9
"2011","Northampton 027D","E01027161","Total",92,32,19,41,13,2,5,6,79,30,14,35
"2011","Northampton 028B","E01027158","Total",61,21,16,24,6,2,3,1,55,19,13,23
"2011","Northampton 028C","E01027201","Total",64,25,25,14,9,0,8,1,55,25,17,13
"2011","Northampton 028D","E01027202","Total",29,13,13,3,4,2,2,0,25,11,11,3
"2011","Northampton 028E","E01032980","Total",74,27,25,22,11,2,7,2,63,25,18,20
"2011","Northampton 028F","E01032981","Total",71,27,20,24,3,2,1,0,68,25,19,24
"2011","Northampton 029A","E01027250","Total",18,9,4,5,3,0,1,2,15,9,3,3
"2011","Northampton 029C","E01027253","Total",55,23,17,15,8,0,5,3,47,23,12,12
"2011","Northampton 029D","E01027254","Total",30,15,9,6,1,0,1,0,29,15,8,6
"2011","Northampton 029E","E01032975","Total",37,18,11,8,1,0,1,0,36,18,10,8
"2011","Northampton 029F","E01032976","Total",42,13,16,13,5,0,3,2,37,13,13,11
"2011","Northampton 029G","E01032977","Total",102,28,27,47,7,0,4,3,95,28,23,44
"2011","Northampton 030A","E01027162","Total",55,19,23,13,4,0,2,2,51,19,21,11
"2011","Northampton 030B","E01027163","Total",20,8,9,3,4,2,2,0,16,6,7,3
"2011","Northampton 030C","E01027164","Total",55,29,14,12,4,0,3,1,51,29,11,11
"2011","Northampton 030D","E01027165","Total",38,10,21,7,6,0,6,0,32,10,15,7
"2011","Northampton 030E","E01027166","Total",55,22,23,10,5,0,5,0,50,22,18,10
"2011","Northampton 030F","E01027167","Total",33,15,8,10,5,1,4,0,28,14,4,10
"2011","Northampton 031A","E01027203","Total",57,24,28,5,8,1,7,0,49,23,21,5
"2011","Northampton 031B","E01027204","Total",68,29,23,16,5,2,3,0,63,27,20,16
"2011","Northampton 031C","E01027205","Total",62,29,27,6,7,1,5,1,55,28,22,5
"2011","Northampton 031D","E01027206","Total",54,19,26,9,4,0,4,0,50,19,22,9
"2011","South Northamptonshire 001A","E01027282","Total",49,17,22,10,6,2,3,1,43,15,19,9
"2011","South Northamptonshire 001B","E01027283","Total",24,11,9,4,3,0,3,0,21,11,6,4
"2011","South Northamptonshire 001C","E01027285","Total",38,22,10,6,4,1,3,0,34,21,7,6
"2011","South Northamptonshire 001D","E01027286","Total",32,15,12,5,3,0,2,1,29,15,10,4
"2011","South Northamptonshire 001E","E01027287","Total",34,15,8,11,4,0,4,0,30,15,4,11
"2011","South Northamptonshire 002A","E01027273","Total",41,13,17,11,6,0,6,0,35,13,11,11
"2011","South Northamptonshire 002B","E01027274","Total",35,11,16,8,7,1,6,0,28,10,10,8
"2011","South Northamptonshire 002C","E01027275","Total",24,17,4,3,0,0,0,0,24,17,4,3
"2011","South Northamptonshire 002D","E01027308","Total",33,13,12,8,0,0,0,0,33,13,12,8
"2011","South Northamptonshire 003A","E01027263","Total",37,18,12,7,6,2,3,1,31,16,9,6
"2011","South Northamptonshire 003C","E01027279","Total",31,12,9,10,2,0,2,0,29,12,7,10
"2011","South Northamptonshire 003D","E01027284","Total",26,10,10,6,5,1,4,0,21,9,6,6
"2011","South Northamptonshire 003E","E01027294","Total",53,23,20,10,6,0,5,1,47,23,15,9
"2011","South Northamptonshire 003F","E01032982","Total",38,17,16,5,3,0,3,0,35,17,13,5
"2011","South Northamptonshire 003G","E01032983","Total",42,18,20,4,6,0,6,0,36,18,14,4
"2011","South Northamptonshire 003H","E01032984","Total",24,9,10,5,1,0,1,0,23,9,9,5
"2011","South Northamptonshire 003I","E01032985","Total",22,5,15,2,4,0,4,0,18,5,11,2
"2011","South Northamptonshire 004A","E01027262","Total",15,4,8,3,2,0,2,0,13,4,6,3
"2011","South Northamptonshire 004B","E01027277","Total",42,14,18,10,6,1,4,1,36,13,14,9
"2011","South Northamptonshire 004C","E01027289","Total",25,11,11,3,4,0,4,0,21,11,7,3
"2011","South Northamptonshire 004D","E01027300","Total",23,13,8,2,1,0,1,0,22,13,7,2
"2011","South Northamptonshire 004E","E01027303","Total",18,9,6,3,0,0,0,0,18,9,6,3
"2011","South Northamptonshire 005A","E01027297","Total",21,8,8,5,1,0,1,0,20,8,7,5
"2011","South Northamptonshire 005B","E01027298","Total",18,9,6,3,1,0,1,0,17,9,5,3
"2011","South Northamptonshire 005C","E01027299","Total",34,17,8,9,4,1,3,0,30,16,5,9
"2011","South Northamptonshire 005D","E01027301","Total",53,25,20,8,5,0,5,0,48,25,15,8
"2011","South Northamptonshire 005E","E01027302","Total",54,24,11,19,6,0,5,1,48,24,6,18
"2011","South Northamptonshire 006A","E01027291","Total",16,8,8,0,3,0,3,0,13,8,5,0
"2011","South Northamptonshire 006B","E01027292","Total",22,7,7,8,1,0,1,0,21,7,6,8
"2011","South Northamptonshire 006C","E01027293","Total",20,9,5,6,2,1,1,0,18,8,4,6
"2011","South Northamptonshire 006D","E01027304","Total",22,5,9,8,4,0,4,0,18,5,5,8
"2011","South Northamptonshire 006E","E01027305","Total",30,12,10,8,1,0,1,0,29,12,9,8
"2011","South Northamptonshire 007A","E01027261","Total",26,12,7,7,3,2,1,0,23,10,6,7
"2011","South Northamptonshire 007B","E01027295","Total",40,21,12,7,2,0,2,0,38,21,10,7
"2011","South Northamptonshire 007C","E01027306","Total",27,14,9,4,2,1,1,0,25,13,8,4
"2011","South Northamptonshire 008A","E01027276","Total",56,16,26,14,11,0,8,3,45,16,18,11
"2011","South Northamptonshire 008B","E01027280","Total",47,19,20,8,3,0,3,0,44,19,17,8
"2011","South Northamptonshire 008C","E01027281","Total",40,18,12,10,4,0,4,0,36,18,8,10
"2011","South Northamptonshire 008D","E01027307","Total",26,14,8,4,2,0,2,0,24,14,6,4
"2011","South Northamptonshire 009A","E01027265","Total",33,17,11,5,2,0,2,0,31,17,9,5
"2011","South Northamptonshire 009B","E01027266","Total",21,7,13,1,3,0,3,0,18,7,10,1
"2011","South Northamptonshire 009C","E01027270","Total",36,21,14,1,3,0,3,0,33,21,11,1
"2011","South Northamptonshire 009D","E01027271","Total",41,18,18,5,6,1,5,0,35,17,13,5
"2011","South Northamptonshire 009E","E01027272","Total",34,12,17,5,4,0,3,1,30,12,14,4
"2011","South Northamptonshire 010A","E01027264","Total",37,16,10,11,1,0,1,0,36,16,9,11
"2011","South Northamptonshire 010B","E01027267","Total",33,14,14,5,4,0,4,0,29,14,10,5
"2011","South Northamptonshire 010C","E01027268","Total",32,11,17,4,7,0,6,1,25,11,11,3
"2011","South Northamptonshire 010D","E01027269","Total",46,19,15,12,5,0,3,2,41,19,12,10
"2011","South Northamptonshire 011A","E01027288","Total",51,20,17,14,3,0,2,1,48,20,15,13
"2011","South Northamptonshire 011B","E01027290","Total",26,9,12,5,6,0,3,3,20,9,9,2
"2011","South Northamptonshire 011C","E01027296","Total",32,17,9,6,4,0,4,0,28,17,5,6
"2011","Wellingborough 001A","E01027326","Total",41,15,14,12,8,2,6,0,33,13,8,12
"2011","Wellingborough 001B","E01027327","Total",41,18,7,16,5,0,2,3,36,18,5,13
"2011","Wellingborough 001C","E01027328","Total",50,12,17,21,11,2,7,2,39,10,10,19
"2011","Wellingborough 001D","E01027338","Total",40,14,11,15,2,0,0,2,38,14,11,13
"2011","Wellingborough 002A","E01027330","Total",90,31,25,34,5,0,4,1,85,31,21,33
"2011","Wellingborough 002B","E01027331","Total",74,20,14,40,9,2,5,2,65,18,9,38
"2011","Wellingborough 002C","E01027332","Total",22,12,6,4,1,1,0,0,21,11,6,4
"2011","Wellingborough 002D","E01027333","Total",43,12,20,11,11,1,9,1,32,11,11,10
"2011","Wellingborough 002E","E01027334","Total",133,36,13,84,9,2,0,7,124,34,13,77
"2011","Wellingborough 003A","E01027343","Total",36,14,11,11,3,0,3,0,33,14,8,11
"2011","Wellingborough 003B","E01027344","Total",29,9,13,7,4,1,2,1,25,8,11,6
"2011","Wellingborough 003C","E01027345","Total",21,9,9,3,3,0,3,0,18,9,6,3
"2011","Wellingborough 003D","E01027346","Total",38,11,19,8,4,1,3,0,34,10,16,8
"2011","Wellingborough 003E","E01027347","Total",37,14,18,5,1,0,1,0,36,14,17,5
"2011","Wellingborough 004A","E01027313","Total",46,8,20,18,2,0,2,0,44,8,18,18
"2011","Wellingborough 004B","E01027314","Total",56,20,21,15,5,2,3,0,51,18,18,15
"2011","Wellingborough 004C","E01027315","Total",112,29,41,42,10,3,6,1,102,26,35,41
"2011","Wellingborough 004D","E01027316","Total",58,12,27,19,9,1,7,1,49,11,20,18
"2011","Wellingborough 005A","E01027339","Total",107,41,17,49,14,0,6,8,93,41,11,41
"2011","Wellingborough 005B","E01027340","Total",69,25,10,34,3,0,0,3,66,25,10,31
"2011","Wellingborough 005C","E01027341","Total",85,21,26,38,10,2,3,5,75,19,23,33
"2011","Wellingborough 005D","E01027342","Total",87,21,22,44,7,1,1,5,80,20,21,39
"2011","Wellingborough 006A","E01027349","Total",48,16,14,18,4,1,3,0,44,15,11,18
"2011","Wellingborough 006B","E01027350","Total",45,14,22,9,0,0,0,0,45,14,22,9
"2011","Wellingborough 006C","E01027351","Total",77,17,16,44,8,0,4,4,69,17,12,40
"2011","Wellingborough 006D","E01027352","Total",37,19,10,8,4,1,2,1,33,18,8,7
"2011","Wellingborough 007A","E01027309","Total",23,8,9,6,3,1,2,0,20,7,7,6
"2011","Wellingborough 007B","E01027310","Total",119,30,27,62,12,1,4,7,107,29,23,55
"2011","Wellingborough 007C","E01027311","Total",29,11,13,5,1,0,1,0,28,11,12,5
"2011","Wellingborough 007D","E01027312","Total",58,15,9,34,5,2,2,1,53,13,7,33
"2011","Wellingborough 008A","E01027317","Total",63,17,11,35,5,0,3,2,58,17,8,33
"2011","Wellingborough 008B","E01027318","Total",135,26,30,79,11,1,6,4,124,25,24,75
"2011","Wellingborough 008C","E01027319","Total",62,21,16,25,9,0,5,4,53,21,11,21
"2011","Wellingborough 008D","E01027320","Total",56,20,11,25,3,1,1,1,53,19,10,24
"2011","Wellingborough 008E","E01027321","Total",45,17,17,11,2,0,1,1,43,17,16,10
"2011","Wellingborough 009A","E01027322","Total",28,8,13,7,2,0,2,0,26,8,11,7
"2011","Wellingborough 009B","E01027323","Total",57,24,19,14,7,1,5,1,50,23,14,13
"2011","Wellingborough 009C","E01027324","Total",17,9,3,5,1,0,0,1,16,9,3,4
"2011","Wellingborough 009D","E01027325","Total",55,22,22,11,8,1,7,0,47,21,15,11
"2011","Wellingborough 009E","E01027329","Total",27,12,8,7,3,0,3,0,24,12,5,7
"2011","Wellingborough 009F","E01027353","Total",29,9,10,10,1,0,0,1,28,9,10,9
"2011","Wellingborough 010A","E01027335","Total",30,12,6,12,6,0,2,4,24,12,4,8
"2011","Wellingborough 010B","E01027336","Total",48,20,15,13,4,1,2,1,44,19,13,12
"2011","Wellingborough 010C","E01027337","Total",54,16,25,13,8,0,7,1,46,16,18,12
"2011","Wellingborough 010D","E01027348","Total",37,13,16,8,2,0,2,0,35,13,14,8
"2011","Wellingborough 010E","E01027354","Total",74,24,29,21,8,1,3,4,66,23,26,17
"2011","Wellingborough 010F","E01027355","Total",27,8,15,4,6,0,6,0,21,8,9,4
"2011","Ashfield 001A","E01027979","Total",27,10,9,8,3,0,2,1,24,10,7,7
"2011","Ashfield 001B","E01027980","Total",82,18,20,44,8,0,4,4,74,18,16,40
"2011","Ashfield 001C","E01027981","Total",29,8,5,16,5,0,4,1,24,8,1,15
"2011","Ashfield 001D","E01027983","Total",48,17,10,21,5,2,2,1,43,15,8,20
"2011","Ashfield 002A","E01027970","Total",34,14,6,14,2,1,0,1,32,13,6,13
"2011","Ashfield 002B","E01027971","Total",29,10,9,10,3,0,3,0,26,10,6,10
"2011","Ashfield 002C","E01027982","Total",29,10,10,9,2,0,1,1,27,10,9,8
"2011","Ashfield 002D","E01027984","Total",26,10,10,6,2,0,2,0,24,10,8,6
"2011","Ashfield 003A","E01027966","Total",57,20,11,26,4,0,1,3,53,20,10,23
"2011","Ashfield 003B","E01027986","Total",41,14,5,22,8,1,2,5,33,13,3,17
"2011","Ashfield 003C","E01027987","Total",91,25,19,47,10,2,3,5,81,23,16,42
"2011","Ashfield 003D","E01027990","Total",46,22,9,15,4,0,2,2,42,22,7,13
"2011","Ashfield 004A","E01027967","Total",83,26,18,39,8,1,5,2,75,25,13,37
"2011","Ashfield 004B","E01027972","Total",83,27,24,32,9,1,5,3,74,26,19,29
"2011","Ashfield 004C","E01027977","Total",62,25,11,26,6,1,2,3,56,24,9,23
"2011","Ashfield 004D","E01027978","Total",96,16,18,62,13,1,6,6,83,15,12,56
"2011","Ashfield 004E","E01027985","Total",72,23,17,32,9,2,3,4,63,21,14,28
"2011","Ashfield 005A","E01027964","Total",55,17,14,24,6,0,3,3,49,17,11,21
"2011","Ashfield 005B","E01027965","Total",89,28,10,51,12,6,3,3,77,22,7,48
"2011","Ashfield 005C","E01027968","Total",68,23,8,37,7,3,1,3,61,20,7,34
"2011","Ashfield 005D","E01027974","Total",85,17,13,55,7,0,2,5,78,17,11,50
"2011","Ashfield 005E","E01027976","Total",69,20,18,31,7,0,4,3,62,20,14,28
"2011","Ashfield 006A","E01027969","Total",50,14,17,19,4,0,3,1,46,14,14,18
"2011","Ashfield 006B","E01027975","Total",56,14,22,20,11,2,4,5,45,12,18,15
"2011","Ashfield 006C","E01027988","Total",43,9,20,14,13,0,8,5,30,9,12,9
"2011","Ashfield 006D","E01027989","Total",28,7,13,8,6,0,6,0,22,7,7,8
"2011","Ashfield 006E","E01027991","Total",40,12,10,18,11,2,4,5,29,10,6,13
"2011","Ashfield 006F","E01027992","Total",55,21,26,8,7,0,5,2,48,21,21,6
"2011","Ashfield 007A","E01027949","Total",33,12,11,10,5,0,4,1,28,12,7,9
"2011","Ashfield 007B","E01027951","Total",119,27,20,72,11,1,4,6,108,26,16,66
"2011","Ashfield 007C","E01027953","Total",31,13,8,10,2,2,0,0,29,11,8,10
"2011","Ashfield 007D","E01027954","Total",74,23,12,39,10,2,3,5,64,21,9,34
"2011","Ashfield 007E","E01027973","Total",16,7,7,2,2,0,2,0,14,7,5,2
"2011","Ashfield 008A","E01027952","Total",78,19,17,42,7,0,3,4,71,19,14,38
"2011","Ashfield 008B","E01027955","Total",52,15,14,23,6,0,5,1,46,15,9,22
"2011","Ashfield 008C","E01027956","Total",65,22,7,36,3,2,0,1,62,20,7,35
"2011","Ashfield 008D","E01027958","Total",71,25,15,31,8,0,4,4,63,25,11,27
"2011","Ashfield 009A","E01027947","Total",34,11,10,13,1,0,1,0,33,11,9,13
"2011","Ashfield 009B","E01027948","Total",35,12,13,10,3,0,3,0,32,12,10,10
"2011","Ashfield 009C","E01027950","Total",58,16,18,24,9,1,4,4,49,15,14,20
"2011","Ashfield 009D","E01027957","Total",38,7,12,19,4,0,2,2,34,7,10,17
"2011","Ashfield 009E","E01027959","Total",23,4,13,6,4,0,4,0,19,4,9,6
"2011","Ashfield 010A","E01027995","Total",39,19,13,7,6,2,4,0,33,17,9,7
"2011","Ashfield 010B","E01027996","Total",75,22,20,33,12,2,4,6,63,20,16,27
"2011","Ashfield 010C","E01027997","Total",32,16,5,11,3,1,0,2,29,15,5,9
"2011","Ashfield 010D","E01027998","Total",47,17,10,20,7,1,5,1,40,16,5,19
"2011","Ashfield 011A","E01027960","Total",43,9,14,20,4,0,3,1,39,9,11,19
"2011","Ashfield 011B","E01027961","Total",33,12,14,7,5,1,4,0,28,11,10,7
"2011","Ashfield 011C","E01027962","Total",36,12,14,10,5,1,2,2,31,11,12,8
"2011","Ashfield 011D","E01027963","Total",53,15,12,26,9,2,3,4,44,13,9,22
"2011","Ashfield 012A","E01027945","Total",56,21,17,18,7,1,5,1,49,20,12,17
"2011","Ashfield 012B","E01027946","Total",43,15,10,18,5,2,2,1,38,13,8,17
"2011","Ashfield 012C","E01027993","Total",28,10,9,9,4,0,4,0,24,10,5,9
"2011","Ashfield 012D","E01027994","Total",32,10,8,14,1,0,1,0,31,10,7,14
"2011","Ashfield 013A","E01027929","Total",92,22,27,43,4,0,3,1,88,22,24,42
"2011","Ashfield 013B","E01027931","Total",97,25,14,58,10,0,3,7,87,25,11,51
"2011","Ashfield 013C","E01027934","Total",36,13,15,8,7,0,5,2,29,13,10,6
"2011","Ashfield 013D","E01027935","Total",37,10,11,16,4,0,3,1,33,10,8,15
"2011","Ashfield 013E","E01027936","Total",23,7,8,8,4,0,3,1,19,7,5,7
"2011","Ashfield 014A","E01027927","Total",73,23,22,28,3,0,1,2,70,23,21,26
"2011","Ashfield 014B","E01027928","Total",80,23,30,27,5,1,2,2,75,22,28,25
"2011","Ashfield 014C","E01027932","Total",98,29,29,40,7,2,2,3,91,27,27,37
"2011","Ashfield 014D","E01027933","Total",57,23,10,24,7,1,2,4,50,22,8,20
"2011","Ashfield 014E","E01027937","Total",59,18,16,25,5,0,4,1,54,18,12,24
"2011","Ashfield 015A","E01027925","Total",54,25,15,14,3,1,0,2,51,24,15,12
"2011","Ashfield 015B","E01027938","Total",30,13,14,3,1,0,1,0,29,13,13,3
"2011","Ashfield 015C","E01027940","Total",28,13,10,5,9,1,5,3,19,12,5,2
"2011","Ashfield 015D","E01027943","Total",45,18,12,15,1,0,1,0,44,18,11,15
"2011","Ashfield 015E","E01027944","Total",39,16,12,11,6,1,4,1,33,15,8,10
"2011","Ashfield 016A","E01027926","Total",36,13,11,12,0,0,0,0,36,13,11,12
"2011","Ashfield 016B","E01027930","Total",87,17,17,53,12,1,4,7,75,16,13,46
"2011","Ashfield 016C","E01027939","Total",78,15,17,46,8,0,3,5,70,15,14,41
"2011","Ashfield 016D","E01027941","Total",41,13,12,16,7,2,3,2,34,11,9,14
"2011","Ashfield 016E","E01027942","Total",74,24,13,37,13,3,5,5,61,21,8,32
"2011","Bassetlaw 001A","E01028000","Total",30,13,11,6,3,1,2,0,27,12,9,6
"2011","Bassetlaw 001B","E01028024","Total",44,17,14,13,4,0,3,1,40,17,11,12
"2011","Bassetlaw 001C","E01028025","Total",60,22,18,20,9,0,6,3,51,22,12,17
"2011","Bassetlaw 001D","E01028026","Total",65,21,12,32,6,1,2,3,59,20,10,29
"2011","Bassetlaw 001E","E01028027","Total",43,17,6,20,2,0,1,1,41,17,5,19
"2011","Bassetlaw 001F","E01028028","Total",54,23,11,20,6,0,3,3,48,23,8,17
"2011","Bassetlaw 002A","E01027999","Total",23,8,10,5,2,0,2,0,21,8,8,5
"2011","Bassetlaw 002B","E01028005","Total",26,7,10,9,3,0,3,0,23,7,7,9
"2011","Bassetlaw 002C","E01028031","Total",23,9,6,8,1,0,1,0,22,9,5,8
"2011","Bassetlaw 002D","E01028032","Total",15,3,6,6,1,0,1,0,14,3,5,6
"2011","Bassetlaw 002E","E01028035","Total",45,17,13,15,6,0,4,2,39,17,9,13
"2011","Bassetlaw 003A","E01028023","Total",36,17,11,8,2,1,1,0,34,16,10,8
"2011","Bassetlaw 003B","E01028034","Total",45,16,16,13,9,1,5,3,36,15,11,10
"2011","Bassetlaw 003C","E01028036","Total",26,8,9,9,4,0,2,2,22,8,7,7
"2011","Bassetlaw 004A","E01028001","Total",69,20,12,37,3,0,1,2,66,20,11,35
"2011","Bassetlaw 004B","E01028002","Total",31,13,7,11,2,1,1,0,29,12,6,11
"2011","Bassetlaw 004C","E01028003","Total",29,10,10,9,3,1,1,1,26,9,9,8
"2011","Bassetlaw 004D","E01028004","Total",20,10,5,5,3,0,3,0,17,10,2,5
"2011","Bassetlaw 004E","E01028029","Total",44,18,11,15,3,0,2,1,41,18,9,14
"2011","Bassetlaw 004F","E01028030","Total",43,15,10,18,6,0,4,2,37,15,6,16
"2011","Bassetlaw 005A","E01028013","Total",51,19,15,17,3,0,1,2,48,19,14,15
"2011","Bassetlaw 005B","E01028014","Total",48,15,13,20,5,0,4,1,43,15,9,19
"2011","Bassetlaw 005C","E01028015","Total",38,12,15,11,4,1,3,0,34,11,12,11
"2011","Bassetlaw 005D","E01028016","Total",32,14,10,8,1,0,1,0,31,14,9,8
"2011","Bassetlaw 006A","E01028046","Total",43,20,13,10,8,4,3,1,35,16,10,9
"2011","Bassetlaw 006B","E01028047","Total",43,26,10,7,3,2,0,1,40,24,10,6
"2011","Bassetlaw 006C","E01028048","Total",38,19,13,6,4,0,3,1,34,19,10,5
"2011","Bassetlaw 006D","E01028049","Total",50,20,13,17,4,1,1,2,46,19,12,15
"2011","Bassetlaw 006E","E01028050","Total",56,23,22,11,13,2,10,1,43,21,12,10
"2011","Bassetlaw 008A","E01028008","Total",79,32,11,36,1,1,0,0,78,31,11,36
"2011","Bassetlaw 008B","E01028009","Total",13,3,6,4,1,0,1,0,12,3,5,4
"2011","Bassetlaw 008C","E01028010","Total",18,3,11,4,2,0,2,0,16,3,9,4
"2011","Bassetlaw 008D","E01028011","Total",70,26,12,32,16,1,7,8,54,25,5,24
"2011","Bassetlaw 008E","E01028012","Total",46,20,10,16,2,1,0,1,44,19,10,15
"2011","Bassetlaw 008F","E01028022","Total",58,18,15,25,2,0,1,1,56,18,14,24
"2011","Bassetlaw 009A","E01028055","Total",79,27,17,35,14,0,8,6,65,27,9,29
"2011","Bassetlaw 009B","E01028056","Total",41,11,12,18,2,1,1,0,39,10,11,18
"2011","Bassetlaw 009C","E01028058","Total",45,18,18,9,6,1,5,0,39,17,13,9
"2011","Bassetlaw 009D","E01028059","Total",47,17,24,6,11,1,10,0,36,16,14,6
"2011","Bassetlaw 010A","E01028017","Total",41,17,12,12,3,0,2,1,38,17,10,11
"2011","Bassetlaw 010B","E01028018","Total",42,12,12,18,1,0,1,0,41,12,11,18
"2011","Bassetlaw 010C","E01028019","Total",64,24,15,25,5,1,3,1,59,23,12,24
"2011","Bassetlaw 010D","E01028020","Total",71,20,25,26,14,2,9,3,57,18,16,23
"2011","Bassetlaw 010E","E01028021","Total",29,12,11,6,4,1,3,0,25,11,8,6
"2011","Bassetlaw 012A","E01028057","Total",60,15,16,29,9,1,4,4,51,14,12,25
"2011","Bassetlaw 012B","E01028065","Total",118,38,15,65,8,2,2,4,110,36,13,61
"2011","Bassetlaw 012C","E01028066","Total",86,23,5,58,10,1,2,7,76,22,3,51
"2011","Bassetlaw 012D","E01028068","Total",62,22,16,24,8,2,4,2,54,20,12,22
"2011","Bassetlaw 013A","E01028060","Total",24,11,8,5,7,1,5,1,17,10,3,4
"2011","Bassetlaw 013B","E01028061","Total",28,13,8,7,4,1,3,0,24,12,5,7
"2011","Bassetlaw 013C","E01028062","Total",58,23,22,13,1,0,1,0,57,23,21,13
"2011","Bassetlaw 013D","E01028067","Total",50,20,6,24,3,0,0,3,47,20,6,21
"2011","Bassetlaw 014A","E01028040","Total",31,11,9,11,6,1,5,0,25,10,4,11
"2011","Bassetlaw 014B","E01028041","Total",24,7,10,7,2,1,0,1,22,6,10,6
"2011","Bassetlaw 014C","E01028043","Total",32,15,7,10,7,1,4,2,25,14,3,8
"2011","Bassetlaw 014D","E01028063","Total",22,11,8,3,4,1,2,1,18,10,6,2
"2011","Bassetlaw 014E","E01028064","Total",47,19,9,19,8,2,3,3,39,17,6,16
"2011","Bassetlaw 015A","E01028006","Total",15,3,6,6,4,0,1,3,11,3,5,3
"2011","Bassetlaw 015B","E01028007","Total",25,5,9,11,1,0,1,0,24,5,8,11
"2011","Bassetlaw 015C","E01028033","Total",34,10,14,10,2,0,2,0,32,10,12,10
"2011","Bassetlaw 015D","E01028037","Total",40,14,17,9,3,0,1,2,37,14,16,7
"2011","Bassetlaw 015E","E01028038","Total",44,12,15,17,7,1,4,2,37,11,11,15
"2011","Bassetlaw 015F","E01028039","Total",16,7,5,4,2,2,0,0,14,5,5,4
"2011","Bassetlaw 016E","E01028042","Total",37,17,11,9,2,0,1,1,35,17,10,8
"2011","Bassetlaw 016F","E01028044","Total",64,25,13,26,6,2,0,4,58,23,13,22
"2011","Bassetlaw 016G","E01028045","Total",52,20,15,17,8,0,5,3,44,20,10,14
"2011","Bassetlaw 016A","E01028051","Total",32,11,11,10,5,1,3,1,27,10,8,9
"2011","Bassetlaw 016B","E01028052","Total",24,12,7,5,1,0,1,0,23,12,6,5
"2011","Bassetlaw 016C","E01028053","Total",51,19,10,22,3,0,1,2,48,19,9,20
"2011","Bassetlaw 016D","E01028054","Total",21,6,12,3,8,0,6,2,13,6,6,1
"2011","Broxtowe 001A","E01028092","Total",34,16,5,13,5,3,2,0,29,13,3,13
"2011","Broxtowe 001B","E01028093","Total",9,3,4,2,1,1,0,0,8,2,4,2
"2011","Broxtowe 001C","E01028107","Total",24,11,9,4,5,1,3,1,19,10,6,3
"2011","Broxtowe 001D","E01028108","Total",31,13,11,7,6,0,6,0,25,13,5,7
"2011","Broxtowe 001E","E01028114","Total",40,15,12,13,6,1,3,2,34,14,9,11
"2011","Broxtowe 002A","E01028110","Total",48,12,8,28,4,0,2,2,44,12,6,26
"2011","Broxtowe 002B","E01028111","Total",46,17,3,26,3,1,0,2,43,16,3,24
"2011","Broxtowe 002C","E01028112","Total",55,17,8,30,3,0,1,2,52,17,7,28
"2011","Broxtowe 002D","E01028113","Total",48,17,6,25,3,0,0,3,45,17,6,22
"2011","Broxtowe 003A","E01028109","Total",31,13,6,12,3,0,2,1,28,13,4,11
"2011","Broxtowe 003B","E01028115","Total",23,14,2,7,1,0,0,1,22,14,2,6
"2011","Broxtowe 003C","E01028116","Total",34,15,10,9,3,2,1,0,31,13,9,9
"2011","Broxtowe 003D","E01028117","Total",21,9,5,7,3,0,3,0,18,9,2,7
"2011","Broxtowe 003E","E01028118","Total",10,6,1,3,0,0,0,0,10,6,1,3
"2011","Broxtowe 004A","E01028102","Total",38,13,13,12,4,1,2,1,34,12,11,11
"2011","Broxtowe 004B","E01028103","Total",31,9,7,15,3,1,0,2,28,8,7,13
"2011","Broxtowe 004C","E01028104","Total",33,15,12,6,2,1,1,0,31,14,11,6
"2011","Broxtowe 004D","E01028122","Total",44,23,8,13,2,1,0,1,42,22,8,12
"2011","Broxtowe 004E","E01028123","Total",41,20,14,7,5,0,4,1,36,20,10,6
"2011","Broxtowe 004F","E01028124","Total",27,7,10,10,4,2,2,0,23,5,8,10
"2011","Broxtowe 007A","E01028087","Total",8,2,2,4,4,1,2,1,4,1,0,3
"2011","Broxtowe 007B","E01028088","Total",20,13,6,1,2,1,1,0,18,12,5,1
"2011","Broxtowe 007C","E01028089","Total",13,7,3,3,3,0,3,0,10,7,0,3
"2011","Broxtowe 007D","E01028090","Total",30,11,14,5,6,1,3,2,24,10,11,3
"2011","Broxtowe 007E","E01028091","Total",22,9,11,2,3,1,2,0,19,8,9,2
"2011","Broxtowe 008A","E01028125","Total",37,12,8,17,5,2,3,0,32,10,5,17
"2011","Broxtowe 008B","E01028126","Total",53,22,14,17,4,0,1,3,49,22,13,14
"2011","Broxtowe 008C","E01028127","Total",100,27,14,59,6,1,1,4,94,26,13,55
"2011","Broxtowe 008D","E01028134","Total",61,27,14,20,9,1,5,3,52,26,9,17
"2011","Broxtowe 009A","E01028076","Total",39,15,9,15,2,0,1,1,37,15,8,14
"2011","Broxtowe 009B","E01028077","Total",44,9,17,18,10,3,6,1,34,6,11,17
"2011","Broxtowe 009C","E01028078","Total",45,15,15,15,5,0,4,1,40,15,11,14
"2011","Broxtowe 009D","E01028079","Total",17,5,4,8,1,0,1,0,16,5,3,8
"2011","Broxtowe 009E","E01028084","Total",24,8,11,5,5,0,5,0,19,8,6,5
"2011","Broxtowe 010A","E01028128","Total",28,14,7,7,1,0,1,0,27,14,6,7
"2011","Broxtowe 010B","E01028129","Total",30,10,11,9,3,0,2,1,27,10,9,8
"2011","Broxtowe 010C","E01028130","Total",77,25,20,32,13,2,7,4,64,23,13,28
"2011","Broxtowe 010D","E01028131","Total",36,15,15,6,2,1,1,0,34,14,14,6
"2011","Broxtowe 010E","E01028132","Total",36,14,6,16,3,0,0,3,33,14,6,13
"2011","Broxtowe 010F","E01028133","Total",60,18,22,20,7,0,5,2,53,18,17,18
"2011","Broxtowe 011A","E01028073","Total",23,11,3,9,0,0,0,0,23,11,3,9
"2011","Broxtowe 011B","E01028074","Total",27,9,5,13,4,2,1,1,23,7,4,12
"2011","Broxtowe 011C","E01028075","Total",47,19,13,15,3,0,2,1,44,19,11,14
"2011","Broxtowe 011D","E01028085","Total",25,10,8,7,2,0,2,0,23,10,6,7
"2011","Broxtowe 011E","E01028086","Total",26,8,12,6,2,0,1,1,24,8,11,5
"2011","Broxtowe 012A","E01028080","Total",60,16,23,21,7,0,4,3,53,16,19,18
"2011","Broxtowe 012B","E01028081","Total",28,13,8,7,6,0,3,3,22,13,5,4
"2011","Broxtowe 012C","E01028082","Total",16,5,7,4,1,0,1,0,15,5,6,4
"2011","Broxtowe 012D","E01028083","Total",38,8,8,22,2,0,0,2,36,8,8,20
"2011","Broxtowe 013A","E01028097","Total",22,12,7,3,2,1,1,0,20,11,6,3
"2011","Broxtowe 013B","E01028098","Total",56,18,11,27,6,2,1,3,50,16,10,24
"2011","Broxtowe 013C","E01028099","Total",31,12,11,8,3,1,1,1,28,11,10,7
"2011","Broxtowe 013D","E01028100","Total",49,16,19,14,5,1,4,0,44,15,15,14
"2011","Broxtowe 013E","E01028101","Total",110,36,18,56,8,0,4,4,102,36,14,52
"2011","Broxtowe 014A","E01028069","Total",31,15,8,8,2,1,1,0,29,14,7,8
"2011","Broxtowe 014B","E01028070","Total",13,4,9,0,5,0,5,0,8,4,4,0
"2011","Broxtowe 014C","E01028094","Total",39,15,13,11,2,1,1,0,37,14,12,11
"2011","Broxtowe 014D","E01028095","Total",29,7,11,11,4,0,4,0,25,7,7,11
"2011","Broxtowe 014E","E01028096","Total",29,16,7,6,2,0,2,0,27,16,5,6
"2011","Broxtowe 015A","E01028135","Total",18,3,10,5,6,0,5,1,12,3,5,4
"2011","Broxtowe 015B","E01028136","Total",23,5,11,7,4,0,4,0,19,5,7,7
"2011","Broxtowe 015C","E01028137","Total",65,21,35,9,4,0,4,0,61,21,31,9
"2011","Broxtowe 015D","E01028138","Total",22,9,10,3,5,1,4,0,17,8,6,3
"2011","Broxtowe 015E","E01028139","Total",37,18,11,8,5,2,3,0,32,16,8,8
"2011","Broxtowe 016A","E01028105","Total",30,13,7,10,3,0,2,1,27,13,5,9
"2011","Broxtowe 016B","E01028106","Total",27,13,9,5,5,2,1,2,22,11,8,3
"2011","Broxtowe 016C","E01028119","Total",48,15,21,12,4,0,4,0,44,15,17,12
"2011","Broxtowe 016D","E01028120","Total",20,6,12,2,3,0,3,0,17,6,9,2
"2011","Broxtowe 016E","E01028121","Total",32,12,11,9,8,1,3,4,24,11,8,5
"2011","Broxtowe 016F","E01033412","Total",39,13,17,9,2,0,2,0,37,13,15,9
"2011","Broxtowe 016G","E01033413","Total",59,24,21,14,7,0,6,1,52,24,15,13
"2011","Gedling 001A","E01028189","Total",39,17,9,13,5,1,3,1,34,16,6,12
"2011","Gedling 001B","E01028198","Total",22,9,8,5,2,2,0,0,20,7,8,5
"2011","Gedling 001C","E01028199","Total",16,3,8,5,3,0,3,0,13,3,5,5
"2011","Gedling 001D","E01028200","Total",32,9,16,7,5,0,4,1,27,9,12,6
"2011","Gedling 001E","E01028201","Total",8,6,2,0,5,3,2,0,3,3,0,0
"2011","Gedling 002A","E01028150","Total",22,10,8,4,6,3,3,0,16,7,5,4
"2011","Gedling 002B","E01028151","Total",28,9,11,8,4,1,3,0,24,8,8,8
"2011","Gedling 002C","E01028152","Total",35,16,9,10,1,0,0,1,34,16,9,9
"2011","Gedling 002D","E01028153","Total",61,21,13,27,3,0,0,3,58,21,13,24
"2011","Gedling 002E","E01028154","Total",76,25,24,27,16,1,13,2,60,24,11,25
"2011","Gedling 002F","E01028213","Total",15,5,8,2,3,0,3,0,12,5,5,2
"2011","Gedling 004A","E01028143","Total",46,18,18,10,2,0,1,1,44,18,17,9
"2011","Gedling 004B","E01028205","Total",51,16,13,22,4,1,3,0,47,15,10,22
"2011","Gedling 004C","E01028206","Total",48,18,17,13,6,0,6,0,42,18,11,13
"2011","Gedling 004D","E01028207","Total",29,16,9,4,5,1,4,0,24,15,5,4
"2011","Gedling 004E","E01028208","Total",45,18,10,17,3,1,1,1,42,17,9,16
"2011","Gedling 005A","E01028173","Total",68,23,7,38,6,4,0,2,62,19,7,36
"2011","Gedling 005B","E01028174","Total",68,28,9,31,3,0,2,1,65,28,7,30
"2011","Gedling 005C","E01028175","Total",55,22,21,12,6,1,4,1,49,21,17,11
"2011","Gedling 005D","E01028209","Total",73,20,17,36,7,0,5,2,66,20,12,34
"2011","Gedling 006A","E01028144","Total",78,26,18,34,1,0,0,1,77,26,18,33
"2011","Gedling 006B","E01028165","Total",58,24,13,21,4,1,1,2,54,23,12,19
"2011","Gedling 006C","E01028166","Total",79,19,21,39,8,2,4,2,71,17,17,37
"2011","Gedling 006D","E01028167","Total",74,30,12,32,2,0,1,1,72,30,11,31
"2011","Gedling 007A","E01028179","Total",25,12,9,4,3,0,2,1,22,12,7,3
"2011","Gedling 007B","E01028180","Total",49,23,15,11,8,3,5,0,41,20,10,11
"2011","Gedling 007C","E01028181","Total",33,14,11,8,3,0,2,1,30,14,9,7
"2011","Gedling 007D","E01028182","Total",39,7,23,9,10,2,4,4,29,5,19,5
"2011","Gedling 007E","E01028183","Total",28,8,5,15,2,0,0,2,26,8,5,13
"2011","Gedling 008A","E01028148","Total",24,11,8,5,2,1,1,0,22,10,7,5
"2011","Gedling 008B","E01028149","Total",34,17,8,9,4,1,2,1,30,16,6,8
"2011","Gedling 008C","E01028178","Total",31,9,14,8,5,1,2,2,26,8,12,6
"2011","Gedling 009A","E01028176","Total",22,7,10,5,4,1,2,1,18,6,8,4
"2011","Gedling 009B","E01028177","Total",53,26,16,11,3,0,2,1,50,26,14,10
"2011","Gedling 009C","E01028214","Total",26,6,13,7,4,0,2,2,22,6,11,5
"2011","Gedling 009D","E01028215","Total",19,4,11,4,4,0,4,0,15,4,7,4
"2011","Gedling 009E","E01028216","Total",19,12,6,1,3,2,1,0,16,10,5,1
"2011","Gedling 009F","E01028217","Total",17,5,7,5,4,0,2,2,13,5,5,3
"2011","Gedling 009G","E01028218","Total",15,6,7,2,2,0,2,0,13,6,5,2
"2011","Gedling 010A","E01028193","Total",21,8,8,5,1,0,1,0,20,8,7,5
"2011","Gedling 010B","E01028194","Total",35,13,15,7,5,1,3,1,30,12,12,6
"2011","Gedling 010C","E01028195","Total",38,11,18,9,3,0,3,0,35,11,15,9
"2011","Gedling 010D","E01028196","Total",29,7,16,6,5,0,5,0,24,7,11,6
"2011","Gedling 010E","E01028197","Total",34,12,12,10,5,1,3,1,29,11,9,9
"2011","Gedling 010F","E01028204","Total",27,12,11,4,5,0,5,0,22,12,6,4
"2011","Gedling 011A","E01028172","Total",32,16,9,7,5,2,3,0,27,14,6,7
"2011","Gedling 011B","E01028190","Total",45,21,15,9,3,0,3,0,42,21,12,9
"2011","Gedling 011C","E01028202","Total",26,3,11,12,6,0,5,1,20,3,6,11
"2011","Gedling 011D","E01028203","Total",41,15,14,12,8,1,4,3,33,14,10,9
"2011","Gedling 011E","E01028212","Total",88,33,18,37,6,0,5,1,82,33,13,36
"2011","Gedling 012A","E01028168","Total",29,13,9,7,3,1,2,0,26,12,7,7
"2011","Gedling 012B","E01028169","Total",27,10,15,2,2,0,2,0,25,10,13,2
"2011","Gedling 012C","E01028170","Total",36,14,18,4,4,0,4,0,32,14,14,4
"2011","Gedling 012D","E01028171","Total",43,17,15,11,5,0,4,1,38,17,11,10
"2011","Gedling 012E","E01028191","Total",66,36,15,15,4,2,1,1,62,34,14,14
"2011","Gedling 012F","E01028192","Total",69,24,17,28,10,1,6,3,59,23,11,25
"2011","Gedling 013A","E01028160","Total",50,23,11,16,2,0,2,0,48,23,9,16
"2011","Gedling 013B","E01028161","Total",58,18,21,19,10,1,6,3,48,17,15,16
"2011","Gedling 013C","E01028162","Total",67,26,16,25,6,1,4,1,61,25,12,24
"2011","Gedling 013D","E01028163","Total",23,9,10,4,5,2,3,0,18,7,7,4
"2011","Gedling 013E","E01028211","Total",45,20,16,9,7,0,4,3,38,20,12,6
"2011","Gedling 014A","E01028155","Total",37,14,12,11,4,1,3,0,33,13,9,11
"2011","Gedling 014B","E01028156","Total",37,11,7,19,6,2,3,1,31,9,4,18
"2011","Gedling 014C","E01028157","Total",19,6,7,6,3,0,3,0,16,6,4,6
"2011","Gedling 014D","E01028158","Total",62,20,18,24,2,1,1,0,60,19,17,24
"2011","Gedling 014E","E01028159","Total",51,17,20,14,7,0,5,2,44,17,15,12
"2011","Gedling 014F","E01028164","Total",65,31,14,20,5,2,2,1,60,29,12,19
"2011","Gedling 014G","E01028210","Total",55,17,15,23,5,0,3,2,50,17,12,21
"2011","Gedling 015A","E01028184","Total",25,11,7,7,1,0,1,0,24,11,6,7
"2011","Gedling 015B","E01028185","Total",96,33,27,36,9,2,6,1,87,31,21,35
"2011","Gedling 015C","E01028186","Total",78,22,14,42,7,0,4,3,71,22,10,39
"2011","Gedling 015D","E01028187","Total",125,24,24,77,6,0,4,2,119,24,20,75
"2011","Gedling 015E","E01028188","Total",61,17,19,25,6,0,4,2,55,17,15,23
"2011","Gedling 016A","E01028142","Total",46,17,17,12,4,0,4,0,42,17,13,12
"2011","Gedling 016B","E01028146","Total",60,16,21,23,5,0,3,2,55,16,18,21
"2011","Gedling 016C","E01028147","Total",67,28,17,22,4,0,3,1,63,28,14,21
"2011","Gedling 016D","E01032622","Total",25,13,5,7,2,0,2,0,23,13,3,7
"2011","Mansfield 001A","E01028224","Total",31,9,12,10,2,0,2,0,29,9,10,10
"2011","Mansfield 001B","E01028257","Total",59,20,15,24,4,0,3,1,55,20,12,23
"2011","Mansfield 001C","E01028258","Total",31,12,6,13,2,0,0,2,29,12,6,11
"2011","Mansfield 001D","E01028259","Total",46,7,12,27,6,0,3,3,40,7,9,24
"2011","Mansfield 002A","E01028223","Total",23,8,3,12,3,1,0,2,20,7,3,10
"2011","Mansfield 002B","E01028225","Total",32,10,13,9,3,0,3,0,29,10,10,9
"2011","Mansfield 002C","E01028226","Total",76,26,13,37,5,0,3,2,71,26,10,35
"2011","Mansfield 002D","E01028260","Total",29,9,9,11,2,0,2,0,27,9,7,11
"2011","Mansfield 003A","E01028251","Total",17,6,7,4,3,0,3,0,14,6,4,4
"2011","Mansfield 003B","E01028252","Total",69,23,22,24,6,1,3,2,63,22,19,22
"2011","Mansfield 003C","E01028253","Total",28,6,14,8,7,0,7,0,21,6,7,8
"2011","Mansfield 003D","E01028277","Total",13,5,6,2,0,0,0,0,13,5,6,2
"2011","Mansfield 003E","E01028278","Total",41,15,9,17,5,0,1,4,36,15,8,13
"2011","Mansfield 004A","E01028271","Total",84,22,22,40,8,0,6,2,76,22,16,38
"2011","Mansfield 004B","E01028279","Total",37,15,10,12,3,0,0,3,34,15,10,9
"2011","Mansfield 004C","E01028280","Total",48,19,15,14,6,2,3,1,42,17,12,13
"2011","Mansfield 004D","E01028281","Total",89,28,15,46,9,0,4,5,80,28,11,41
"2011","Mansfield 004E","E01028283","Total",48,15,28,5,5,0,5,0,43,15,23,5
"2011","Mansfield 005A","E01028242","Total",36,15,15,6,2,0,2,0,34,15,13,6
"2011","Mansfield 005B","E01028250","Total",40,11,14,15,3,1,2,0,37,10,12,15
"2011","Mansfield 005C","E01028272","Total",74,30,18,26,9,1,4,4,65,29,14,22
"2011","Mansfield 005D","E01028273","Total",54,19,21,14,8,1,5,2,46,18,16,12
"2011","Mansfield 006A","E01028229","Total",25,12,2,11,2,1,1,0,23,11,1,11
"2011","Mansfield 006B","E01028232","Total",44,10,14,20,8,1,4,3,36,9,10,17
"2011","Mansfield 006E","E01028267","Total",82,29,21,32,6,0,5,1,76,29,16,31
"2011","Mansfield 006F","E01028282","Total",54,18,9,27,5,0,3,2,49,18,6,25
"2011","Mansfield 006G","E01033392","Total",65,22,15,28,9,2,3,4,56,20,12,24
"2011","Mansfield 007A","E01028237","Total",31,11,10,10,1,0,1,0,30,11,9,10
"2011","Mansfield 007B","E01028238","Total",71,24,17,30,7,0,4,3,64,24,13,27
"2011","Mansfield 007C","E01028239","Total",66,22,14,30,3,0,2,1,63,22,12,29
"2011","Mansfield 007D","E01028240","Total",31,11,14,6,5,1,4,0,26,10,10,6
"2011","Mansfield 007E","E01028241","Total",61,23,26,12,6,0,4,2,55,23,22,10
"2011","Mansfield 007F","E01028243","Total",40,17,11,12,4,1,3,0,36,16,8,12
"2011","Mansfield 008A","E01028227","Total",67,24,11,32,5,2,0,3,62,22,11,29
"2011","Mansfield 008B","E01028228","Total",34,11,14,9,2,1,0,1,32,10,14,8
"2011","Mansfield 008C","E01028247","Total",92,22,28,42,9,1,4,4,83,21,24,38
"2011","Mansfield 008D","E01028268","Total",88,23,15,50,11,0,3,8,77,23,12,42
"2011","Mansfield 008E","E01028269","Total",55,10,24,21,10,2,6,2,45,8,18,19
"2011","Mansfield 008F","E01028284","Total",58,19,10,29,2,1,1,0,56,18,9,29
"2011","Mansfield 009A","E01028233","Total",92,27,21,44,10,3,4,3,82,24,17,41
"2011","Mansfield 009B","E01028234","Total",107,24,26,57,11,1,3,7,96,23,23,50
"2011","Mansfield 009C","E01028274","Total",30,7,11,12,4,0,2,2,26,7,9,10
"2011","Mansfield 009D","E01028275","Total",101,19,14,68,11,0,3,8,90,19,11,60
"2011","Mansfield 009E","E01028276","Total",78,9,7,62,10,2,2,6,68,7,5,56
"2011","Mansfield 010A","E01028230","Total",64,25,15,24,6,1,3,2,58,24,12,22
"2011","Mansfield 010B","E01028231","Total",59,19,13,27,6,0,3,3,53,19,10,24
"2011","Mansfield 010C","E01028244","Total",26,12,9,5,4,2,1,1,22,10,8,4
"2011","Mansfield 010D","E01028245","Total",55,11,18,26,7,0,4,3,48,11,14,23
"2011","Mansfield 010E","E01028246","Total",30,13,11,6,8,1,5,2,22,12,6,4
"2011","Mansfield 010F","E01028248","Total",54,13,14,27,6,0,1,5,48,13,13,22
"2011","Mansfield 010G","E01028249","Total",36,17,4,15,4,0,1,3,32,17,3,12
"2011","Mansfield 011A","E01028235","Total",28,10,11,7,5,2,3,0,23,8,8,7
"2011","Mansfield 011B","E01028236","Total",57,23,22,12,10,2,7,1,47,21,15,11
"2011","Mansfield 011C","E01028262","Total",25,11,9,5,3,0,3,0,22,11,6,5
"2011","Mansfield 011D","E01028264","Total",31,12,15,4,7,0,5,2,24,12,10,2
"2011","Mansfield 012A","E01028254","Total",35,9,4,22,2,0,1,1,33,9,3,21
"2011","Mansfield 012B","E01028256","Total",73,15,17,41,9,0,4,5,64,15,13,36
"2011","Mansfield 012C","E01028261","Total",73,18,10,45,13,2,3,8,60,16,7,37
"2011","Mansfield 012D","E01028263","Total",84,24,10,50,8,0,3,5,76,24,7,45
"2011","Mansfield 013A","E01028219","Total",18,8,6,4,2,0,2,0,16,8,4,4
"2011","Mansfield 013B","E01028220","Total",41,15,19,7,9,0,8,1,32,15,11,6
"2011","Mansfield 013D","E01028222","Total",14,5,7,2,2,0,2,0,12,5,5,2
"2011","Mansfield 013E","E01028255","Total",14,4,4,6,4,1,1,2,10,3,3,4
"2011","Mansfield 013F","E01028270","Total",28,12,10,6,2,0,2,0,26,12,8,6
"2011","Mansfield 013G","E01033389","Total",40,19,14,7,8,2,5,1,32,17,9,6
"2011","Mansfield 013H","E01033390","Total",40,15,18,7,5,1,3,1,35,14,15,6
"2011","Mansfield 013I","E01033391","Total",18,11,4,3,0,0,0,0,18,11,4,3
"2011","Newark and Sherwood 001A","E01028301","Total",96,26,6,64,9,1,2,6,87,25,4,58
"2011","Newark and Sherwood 001B","E01028302","Total",40,14,16,10,7,0,4,3,33,14,12,7
"2011","Newark and Sherwood 001C","E01028338","Total",52,25,14,13,6,1,4,1,46,24,10,12
"2011","Newark and Sherwood 001D","E01028339","Total",76,30,14,32,7,0,4,3,69,30,10,29
"2011","Newark and Sherwood 001E","E01028340","Total",41,13,11,17,7,4,3,0,34,9,8,17
"2011","Newark and Sherwood 001F","E01028341","Total",13,2,7,4,3,1,2,0,10,1,5,4
"2011","Newark and Sherwood 002A","E01028313","Total",72,19,21,32,9,0,5,4,63,19,16,28
"2011","Newark and Sherwood 002B","E01028314","Total",77,33,14,30,6,1,4,1,71,32,10,29
"2011","Newark and Sherwood 002C","E01028321","Total",24,9,8,7,6,1,3,2,18,8,5,5
"2011","Newark and Sherwood 002D","E01028322","Total",48,25,13,10,4,1,2,1,44,24,11,9
"2011","Newark and Sherwood 002E","E01028323","Total",61,34,15,12,2,0,1,1,59,34,14,11
"2011","Newark and Sherwood 003A","E01028303","Total",26,6,13,7,5,0,4,1,21,6,9,6
"2011","Newark and Sherwood 003B","E01028312","Total",20,7,8,5,4,1,1,2,16,6,7,3
"2011","Newark and Sherwood 003C","E01028337","Total",28,15,10,3,5,1,4,0,23,14,6,3
"2011","Newark and Sherwood 003D","E01028349","Total",22,11,4,7,2,1,0,1,20,10,4,6
"2011","Newark and Sherwood 003E","E01028350","Total",20,5,8,7,3,0,3,0,17,5,5,7
"2011","Newark and Sherwood 004A","E01028315","Total",18,5,6,7,2,0,1,1,16,5,5,6
"2011","Newark and Sherwood 004B","E01028316","Total",23,3,6,14,4,0,2,2,19,3,4,12
"2011","Newark and Sherwood 004C","E01028317","Total",20,9,7,4,3,0,3,0,17,9,4,4
"2011","Newark and Sherwood 004D","E01028353","Total",50,18,19,13,2,0,2,0,48,18,17,13
"2011","Newark and Sherwood 005A","E01028295","Total",39,13,13,13,8,0,7,1,31,13,6,12
"2011","Newark and Sherwood 005B","E01028297","Total",84,29,17,38,7,1,3,3,77,28,14,35
"2011","Newark and Sherwood 005C","E01028327","Total",21,8,12,1,4,0,4,0,17,8,8,1
"2011","Newark and Sherwood 005D","E01028328","Total",25,15,6,4,3,0,2,1,22,15,4,3
"2011","Newark and Sherwood 005E","E01028329","Total",22,7,7,8,3,0,2,1,19,7,5,7
"2011","Newark and Sherwood 006A","E01028296","Total",34,10,10,14,4,1,2,1,30,9,8,13
"2011","Newark and Sherwood 006B","E01028298","Total",56,26,22,8,9,4,5,0,47,22,17,8
"2011","Newark and Sherwood 006C","E01028299","Total",47,13,14,20,3,0,3,0,44,13,11,20
"2011","Newark and Sherwood 006D","E01028300","Total",63,23,16,24,3,1,1,1,60,22,15,23
"2011","Newark and Sherwood 006E","E01028342","Total",75,22,25,28,6,1,3,2,69,21,22,26
"2011","Newark and Sherwood 006F","E01028343","Total",57,25,11,21,2,0,1,1,55,25,10,20
"2011","Newark and Sherwood 006G","E01028344","Total",40,11,17,12,8,2,6,0,32,9,11,12
"2011","Newark and Sherwood 007A","E01028294","Total",67,23,22,22,7,0,6,1,60,23,16,21
"2011","Newark and Sherwood 007B","E01028304","Total",63,14,14,35,3,0,2,1,60,14,12,34
"2011","Newark and Sherwood 007C","E01028305","Total",50,22,12,16,7,0,6,1,43,22,6,15
"2011","Newark and Sherwood 007D","E01028306","Total",59,16,14,29,3,0,1,2,56,16,13,27
"2011","Newark and Sherwood 007E","E01028307","Total",43,24,6,13,5,2,3,0,38,22,3,13
"2011","Newark and Sherwood 007F","E01028310","Total",64,19,9,36,2,1,0,1,62,18,9,35
"2011","Newark and Sherwood 007G","E01028311","Total",37,15,7,15,3,0,2,1,34,15,5,14
"2011","Newark and Sherwood 008A","E01028345","Total",45,16,17,12,2,0,2,0,43,16,15,12
"2011","Newark and Sherwood 008B","E01028346","Total",55,20,28,7,6,0,5,1,49,20,23,6
"2011","Newark and Sherwood 008C","E01028347","Total",36,12,20,4,3,1,2,0,33,11,18,4
"2011","Newark and Sherwood 008D","E01028348","Total",29,13,13,3,5,1,4,0,24,12,9,3
"2011","Newark and Sherwood 009A","E01028292","Total",29,15,9,5,2,0,2,0,27,15,7,5
"2011","Newark and Sherwood 009B","E01028293","Total",64,31,13,20,3,0,3,0,61,31,10,20
"2011","Newark and Sherwood 009C","E01028333","Total",47,17,11,19,4,0,4,0,43,17,7,19
"2011","Newark and Sherwood 009D","E01028334","Total",78,28,8,42,7,3,2,2,71,25,6,40
"2011","Newark and Sherwood 009E","E01028335","Total",58,22,17,19,7,0,7,0,51,22,10,19
"2011","Newark and Sherwood 010A","E01028308","Total",32,9,9,14,4,1,2,1,28,8,7,13
"2011","Newark and Sherwood 010B","E01028309","Total",19,7,9,3,1,0,1,0,18,7,8,3
"2011","Newark and Sherwood 010C","E01028318","Total",58,21,8,29,4,0,3,1,54,21,5,28
"2011","Newark and Sherwood 010D","E01028319","Total",85,24,11,50,6,1,2,3,79,23,9,47
"2011","Newark and Sherwood 010E","E01028320","Total",96,24,16,56,8,2,3,3,88,22,13,53
"2011","Newark and Sherwood 011A","E01028285","Total",48,22,17,9,7,2,5,0,41,20,12,9
"2011","Newark and Sherwood 011B","E01028286","Total",26,15,7,4,3,0,2,1,23,15,5,3
"2011","Newark and Sherwood 011C","E01028287","Total",34,18,10,6,6,1,4,1,28,17,6,5
"2011","Newark and Sherwood 011D","E01028288","Total",42,17,11,14,5,0,4,1,37,17,7,13
"2011","Newark and Sherwood 011E","E01028289","Total",28,9,10,9,2,0,2,0,26,9,8,9
"2011","Newark and Sherwood 011F","E01028290","Total",37,17,8,12,2,0,2,0,35,17,6,12
"2011","Newark and Sherwood 011G","E01028291","Total",65,21,17,27,6,1,4,1,59,20,13,26
"2011","Newark and Sherwood 012B","E01028325","Total",16,8,5,3,1,0,1,0,15,8,4,3
"2011","Newark and Sherwood 012C","E01028326","Total",29,12,6,11,3,0,2,1,26,12,4,10
"2011","Newark and Sherwood 012D","E01028336","Total",21,13,5,3,1,0,1,0,20,13,4,3
"2011","Newark and Sherwood 012E","E01028352","Total",18,5,9,4,4,2,1,1,14,3,8,3
"2011","Newark and Sherwood 012F","E01033393","Total",65,26,28,11,7,1,5,1,58,25,23,10
"2011","Newark and Sherwood 012G","E01033394","Total",24,10,6,8,2,0,1,1,22,10,5,7
"2011","Newark and Sherwood 013A","E01028330","Total",24,12,8,4,3,0,2,1,21,12,6,3
"2011","Newark and Sherwood 013B","E01028331","Total",20,8,9,3,4,0,4,0,16,8,5,3
"2011","Newark and Sherwood 013C","E01028332","Total",24,10,12,2,3,0,3,0,21,10,9,2
"2011","Newark and Sherwood 013D","E01028351","Total",12,3,7,2,4,1,3,0,8,2,4,2
"2011","Rushcliffe 001A","E01028371","Total",35,13,15,7,10,3,7,0,25,10,8,7
"2011","Rushcliffe 001B","E01028403","Total",50,17,24,9,7,0,6,1,43,17,18,8
"2011","Rushcliffe 001C","E01028411","Total",26,12,11,3,5,0,4,1,21,12,7,2
"2011","Rushcliffe 002A","E01028357","Total",21,15,3,3,2,1,0,1,19,14,3,2
"2011","Rushcliffe 002B","E01028358","Total",38,7,24,7,11,1,9,1,27,6,15,6
"2011","Rushcliffe 002C","E01028359","Total",27,9,15,3,2,0,2,0,25,9,13,3
"2011","Rushcliffe 002D","E01028360","Total",78,33,27,18,8,0,6,2,70,33,21,16
"2011","Rushcliffe 002E","E01028361","Total",49,10,30,9,4,0,4,0,45,10,26,9
"2011","Rushcliffe 002F","E01028362","Total",60,30,11,19,5,2,1,2,55,28,10,17
"2011","Rushcliffe 003A","E01028393","Total",11,4,4,3,2,0,1,1,9,4,3,2
"2011","Rushcliffe 003B","E01028394","Total",30,10,14,6,6,0,5,1,24,10,9,5
"2011","Rushcliffe 003C","E01028395","Total",27,7,15,5,8,0,6,2,19,7,9,3
"2011","Rushcliffe 003D","E01028413","Total",56,29,17,10,6,1,4,1,50,28,13,9
"2011","Rushcliffe 003E","E01028414","Total",19,7,5,7,1,0,0,1,18,7,5,6
"2011","Rushcliffe 003F","E01028415","Total",22,10,9,3,4,1,3,0,18,9,6,3
"2011","Rushcliffe 004A","E01028354","Total",23,8,12,3,9,1,8,0,14,7,4,3
"2011","Rushcliffe 004B","E01028355","Total",21,6,11,4,2,0,2,0,19,6,9,4
"2011","Rushcliffe 004C","E01028384","Total",20,9,5,6,2,0,1,1,18,9,4,5
"2011","Rushcliffe 004D","E01028385","Total",34,15,11,8,4,1,3,0,30,14,8,8
"2011","Rushcliffe 004E","E01028386","Total",28,14,13,1,4,0,4,0,24,14,9,1
"2011","Rushcliffe 005A","E01028396","Total",38,18,17,3,3,0,2,1,35,18,15,2
"2011","Rushcliffe 005B","E01028398","Total",46,14,20,12,6,0,4,2,40,14,16,10
"2011","Rushcliffe 005C","E01028399","Total",18,3,12,3,2,0,2,0,16,3,10,3
"2011","Rushcliffe 005D","E01028416","Total",27,5,18,4,10,1,9,0,17,4,9,4
"2011","Rushcliffe 005E","E01028417","Total",16,7,6,3,2,0,1,1,14,7,5,2
"2011","Rushcliffe 005F","E01028418","Total",18,7,7,4,1,0,1,0,17,7,6,4
"2011","Rushcliffe 006A","E01028356","Total",45,17,17,11,5,0,4,1,40,17,13,10
"2011","Rushcliffe 006B","E01028375","Total",88,36,23,29,9,2,3,4,79,34,20,25
"2011","Rushcliffe 006C","E01028376","Total",20,8,9,3,2,1,1,0,18,7,8,3
"2011","Rushcliffe 006D","E01028377","Total",31,11,15,5,9,1,8,0,22,10,7,5
"2011","Rushcliffe 006E","E01028397","Total",32,8,14,10,3,0,3,0,29,8,11,10
"2011","Rushcliffe 007A","E01028363","Total",23,8,13,2,4,0,4,0,19,8,9,2
"2011","Rushcliffe 007B","E01028364","Total",31,11,17,3,5,0,4,1,26,11,13,2
"2011","Rushcliffe 007C","E01028365","Total",28,10,13,5,1,0,1,0,27,10,12,5
"2011","Rushcliffe 007D","E01028391","Total",27,7,15,5,5,0,3,2,22,7,12,3
"2011","Rushcliffe 007E","E01028392","Total",57,20,21,16,3,0,3,0,54,20,18,16
"2011","Rushcliffe 008A","E01028372","Total",28,10,7,11,2,0,2,0,26,10,5,11
"2011","Rushcliffe 008B","E01028373","Total",12,5,6,1,1,0,1,0,11,5,5,1
"2011","Rushcliffe 008C","E01028374","Total",43,11,13,19,3,0,2,1,40,11,11,18
"2011","Rushcliffe 008D","E01028400","Total",9,4,4,1,2,1,0,1,7,3,4,0
"2011","Rushcliffe 008E","E01028401","Total",17,7,5,5,2,0,2,0,15,7,3,5
"2011","Rushcliffe 009A","E01028366","Total",68,31,12,25,2,0,2,0,66,31,10,25
"2011","Rushcliffe 009B","E01028367","Total",33,10,13,10,5,1,4,0,28,9,9,10
"2011","Rushcliffe 009C","E01028368","Total",43,16,16,11,5,1,4,0,38,15,12,11
"2011","Rushcliffe 009D","E01028369","Total",70,25,15,30,5,1,3,1,65,24,12,29
"2011","Rushcliffe 009E","E01028370","Total",40,15,10,15,4,0,1,3,36,15,9,12
"2011","Rushcliffe 010A","E01028402","Total",26,12,10,4,5,1,3,1,21,11,7,3
"2011","Rushcliffe 010B","E01028419","Total",48,25,16,7,17,5,12,0,31,20,4,7
"2011","Rushcliffe 010C","E01028420","Total",26,4,18,4,4,0,4,0,22,4,14,4
"2011","Rushcliffe 011A","E01028404","Total",31,10,13,8,7,3,3,1,24,7,10,7
"2011","Rushcliffe 011B","E01028405","Total",79,30,24,25,6,2,1,3,73,28,23,22
"2011","Rushcliffe 011C","E01028406","Total",43,12,19,12,4,0,4,0,39,12,15,12
"2011","Rushcliffe 011D","E01028407","Total",43,16,17,10,7,1,5,1,36,15,12,9
"2011","Rushcliffe 012A","E01028379","Total",9,3,6,0,0,0,0,0,9,3,6,0
"2011","Rushcliffe 012B","E01028412","Total",17,8,7,2,4,0,3,1,13,8,4,1
"2011","Rushcliffe 012C","E01028421","Total",24,10,9,5,5,2,3,0,19,8,6,5
"2011","Rushcliffe 013A","E01028380","Total",63,20,12,31,5,0,2,3,58,20,10,28
"2011","Rushcliffe 013B","E01028381","Total",24,7,13,4,4,0,3,1,20,7,10,3
"2011","Rushcliffe 013C","E01028382","Total",20,9,9,2,5,2,3,0,15,7,6,2
"2011","Rushcliffe 013D","E01028383","Total",13,5,6,2,1,0,1,0,12,5,5,2
"2011","Rushcliffe 014A","E01028378","Total",40,17,15,8,4,1,2,1,36,16,13,7
"2011","Rushcliffe 014B","E01028387","Total",69,30,23,16,8,1,5,2,61,29,18,14
"2011","Rushcliffe 014C","E01028408","Total",44,11,22,11,6,1,3,2,38,10,19,9
"2011","Rushcliffe 015A","E01028388","Total",23,11,10,2,10,2,6,2,13,9,4,0
"2011","Rushcliffe 015B","E01028389","Total",25,13,11,1,2,0,2,0,23,13,9,1
"2011","Rushcliffe 015C","E01028390","Total",31,10,11,10,3,0,3,0,28,10,8,10
"2011","Rushcliffe 015D","E01028409","Total",19,5,14,0,5,1,4,0,14,4,10,0
"2011","Rushcliffe 015E","E01028410","Total",19,8,8,3,3,1,1,1,16,7,7,2
"2011","Herefordshire 001A","E01013998","Total",25,9,9,7,4,2,2,0,21,7,7,7
"2011","Herefordshire 001B","E01014051","Total",49,16,13,20,3,1,1,1,46,15,12,19
"2011","Herefordshire 001C","E01014052","Total",29,15,6,8,4,0,3,1,25,15,3,7
"2011","Herefordshire 001D","E01014096","Total",34,15,9,10,3,0,2,1,31,15,7,9
"2011","Herefordshire 002A","E01014041","Total",32,13,8,11,7,2,4,1,25,11,4,10
"2011","Herefordshire 002B","E01014042","Total",84,27,12,45,4,0,1,3,80,27,11,42
"2011","Herefordshire 002C","E01014043","Total",18,8,4,6,2,0,1,1,16,8,3,5
"2011","Herefordshire 002D","E01014044","Total",41,16,9,16,4,0,3,1,37,16,6,15
"2011","Herefordshire 003A","E01014045","Total",35,22,6,7,3,0,1,2,32,22,5,5
"2011","Herefordshire 003B","E01014046","Total",26,9,7,10,2,0,2,0,24,9,5,10
"2011","Herefordshire 003C","E01014047","Total",57,17,11,29,10,1,4,5,47,16,7,24
"2011","Herefordshire 003D","E01014048","Total",48,19,12,17,5,1,4,0,43,18,8,17
"2011","Herefordshire 004A","E01013999","Total",16,9,5,2,1,0,1,0,15,9,4,2
"2011","Herefordshire 004B","E01014017","Total",26,14,8,4,6,1,5,0,20,13,3,4
"2011","Herefordshire 004C","E01014024","Total",19,7,6,6,5,2,2,1,14,5,4,5
"2011","Herefordshire 004D","E01014025","Total",20,9,3,8,1,1,0,0,19,8,3,8
"2011","Herefordshire 004E","E01014055","Total",33,14,6,13,0,0,0,0,33,14,6,13
"2011","Herefordshire 004F","E01014097","Total",18,8,6,4,3,0,3,0,15,8,3,4
"2011","Herefordshire 005A","E01014000","Total",17,7,7,3,3,0,3,0,14,7,4,3
"2011","Herefordshire 005B","E01014001","Total",18,4,7,7,5,0,4,1,13,4,3,6
"2011","Herefordshire 005C","E01014002","Total",14,4,5,5,1,0,1,0,13,4,4,5
"2011","Herefordshire 005D","E01014003","Total",29,12,6,11,2,0,2,0,27,12,4,11
"2011","Herefordshire 005E","E01014004","Total",20,8,6,6,6,2,2,2,14,6,4,4
"2011","Herefordshire 005F","E01014005","Total",79,18,21,40,14,0,6,8,65,18,15,32
"2011","Herefordshire 005G","E01014015","Total",28,13,9,6,5,3,2,0,23,10,7,6
"2011","Herefordshire 006A","E01014008","Total",15,4,4,7,1,0,0,1,14,4,4,6
"2011","Herefordshire 006B","E01014009","Total",16,7,5,4,3,1,1,1,13,6,4,3
"2011","Herefordshire 006C","E01014033","Total",31,9,8,14,1,0,1,0,30,9,7,14
"2011","Herefordshire 006D","E01014034","Total",54,20,13,21,8,1,5,2,46,19,8,19
"2011","Herefordshire 006E","E01014056","Total",19,4,10,5,7,0,5,2,12,4,5,3
"2011","Herefordshire 007A","E01014006","Total",19,10,4,5,4,2,1,1,15,8,3,4
"2011","Herefordshire 007B","E01014012","Total",15,8,6,1,1,0,1,0,14,8,5,1
"2011","Herefordshire 007C","E01014013","Total",54,25,14,15,5,1,4,0,49,24,10,15
"2011","Herefordshire 007D","E01014016","Total",36,18,7,11,7,6,0,1,29,12,7,10
"2011","Herefordshire 007E","E01014100","Total",11,4,4,3,2,0,2,0,9,4,2,3
"2011","Herefordshire 007F","E01014101","Total",12,5,4,3,1,0,1,0,11,5,3,3
"2011","Herefordshire 008A","E01014022","Total",42,25,12,5,8,5,3,0,34,20,9,5
"2011","Herefordshire 008B","E01014023","Total",48,16,17,15,9,1,5,3,39,15,12,12
"2011","Herefordshire 008C","E01014081","Total",19,11,5,3,5,2,2,1,14,9,3,2
"2011","Herefordshire 008D","E01014082","Total",39,18,14,7,6,2,3,1,33,16,11,6
"2011","Herefordshire 009A","E01014027","Total",11,4,5,2,5,1,3,1,6,3,2,1
"2011","Herefordshire 009B","E01014028","Total",23,6,11,6,7,1,6,0,16,5,5,6
"2011","Herefordshire 009C","E01014029","Total",23,8,7,8,2,1,1,0,21,7,6,8
"2011","Herefordshire 009D","E01014030","Total",22,6,9,7,6,0,3,3,16,6,6,4
"2011","Herefordshire 010A","E01014083","Total",24,11,11,2,2,0,2,0,22,11,9,2
"2011","Herefordshire 010B","E01014084","Total",40,19,11,10,4,1,2,1,36,18,9,9
"2011","Herefordshire 010C","E01014085","Total",55,20,12,23,5,0,2,3,50,20,10,20
"2011","Herefordshire 010D","E01014087","Total",23,13,8,2,3,1,2,0,20,12,6,2
"2011","Herefordshire 010E","E01014088","Total",38,18,10,10,4,1,2,1,34,17,8,9
"2011","Herefordshire 010F","E01014089","Total",56,18,19,19,3,0,2,1,53,18,17,18
"2011","Herefordshire 011A","E01013987","Total",27,11,9,7,1,0,1,0,26,11,8,7
"2011","Herefordshire 011B","E01013988","Total",18,9,5,4,3,2,0,1,15,7,5,3
"2011","Herefordshire 011C","E01014007","Total",26,9,12,5,4,0,4,0,22,9,8,5
"2011","Herefordshire 011D","E01014095","Total",58,24,14,20,4,1,2,1,54,23,12,19
"2011","Herefordshire 012A","E01013986","Total",47,21,10,16,6,0,1,5,41,21,9,11
"2011","Herefordshire 012B","E01013989","Total",46,16,11,19,0,0,0,0,46,16,11,19
"2011","Herefordshire 012C","E01014010","Total",56,17,16,23,9,1,5,3,47,16,11,20
"2011","Herefordshire 012D","E01014011","Total",49,23,13,13,4,0,2,2,45,23,11,11
"2011","Herefordshire 012E","E01014086","Total",68,26,14,28,1,0,1,0,67,26,13,28
"2011","Herefordshire 012F","E01014092","Total",53,22,22,9,1,0,0,1,52,22,22,8
"2011","Herefordshire 013A","E01014075","Total",42,18,18,6,6,1,5,0,36,17,13,6
"2011","Herefordshire 013B","E01014076","Total",89,41,31,17,10,1,8,1,79,40,23,16
"2011","Herefordshire 013C","E01014077","Total",26,12,9,5,1,0,1,0,25,12,8,5
"2011","Herefordshire 013D","E01014078","Total",39,17,8,14,4,0,0,4,35,17,8,10
"2011","Herefordshire 014A","E01014090","Total",29,11,16,2,5,1,4,0,24,10,12,2
"2011","Herefordshire 014B","E01014091","Total",26,13,10,3,1,1,0,0,25,12,10,3
"2011","Herefordshire 014C","E01014093","Total",36,16,11,9,1,0,1,0,35,16,10,9
"2011","Herefordshire 014D","E01014094","Total",30,14,8,8,4,1,3,0,26,13,5,8
"2011","Herefordshire 015A","E01014068","Total",29,9,9,11,2,0,1,1,27,9,8,10
"2011","Herefordshire 015B","E01014070","Total",41,17,15,9,6,0,5,1,35,17,10,8
"2011","Herefordshire 015C","E01014072","Total",74,25,15,34,6,1,4,1,68,24,11,33
"2011","Herefordshire 015D","E01014073","Total",85,29,10,46,6,0,3,3,79,29,7,43
"2011","Herefordshire 015E","E01014074","Total",80,23,12,45,12,3,1,8,68,20,11,37
"2011","Herefordshire 016A","E01013996","Total",36,16,14,6,4,0,4,0,32,16,10,6
"2011","Herefordshire 016B","E01013997","Total",49,20,18,11,4,0,3,1,45,20,15,10
"2011","Herefordshire 016C","E01014079","Total",29,12,9,8,2,0,2,0,27,12,7,8
"2011","Herefordshire 016D","E01014080","Total",31,17,7,7,3,0,3,0,28,17,4,7
"2011","Herefordshire 017A","E01013992","Total",59,22,16,21,9,0,6,3,50,22,10,18
"2011","Herefordshire 017B","E01013993","Total",68,26,15,27,8,2,3,3,60,24,12,24
"2011","Herefordshire 017C","E01013994","Total",85,34,15,36,7,1,5,1,78,33,10,35
"2011","Herefordshire 017D","E01013995","Total",146,37,21,88,17,1,7,9,129,36,14,79
"2011","Herefordshire 017E","E01014071","Total",68,17,12,39,12,0,3,9,56,17,9,30
"2011","Herefordshire 018A","E01013990","Total",33,14,12,7,9,2,4,3,24,12,8,4
"2011","Herefordshire 018B","E01013991","Total",18,11,2,5,5,1,2,2,13,10,0,3
"2011","Herefordshire 018C","E01014014","Total",25,10,8,7,4,0,3,1,21,10,5,6
"2011","Herefordshire 018D","E01014054","Total",11,3,4,4,5,0,4,1,6,3,0,3
"2011","Herefordshire 019A","E01014035","Total",55,20,16,19,3,1,1,1,52,19,15,18
"2011","Herefordshire 019B","E01014036","Total",20,6,6,8,2,0,1,1,18,6,5,7
"2011","Herefordshire 019C","E01014037","Total",21,7,10,4,6,0,4,2,15,7,6,2
"2011","Herefordshire 019D","E01014038","Total",29,9,8,12,0,0,0,0,29,9,8,12
"2011","Herefordshire 019E","E01014039","Total",51,23,19,9,6,0,5,1,45,23,14,8
"2011","Herefordshire 019F","E01014040","Total",31,14,9,8,5,1,2,2,26,13,7,6
"2011","Herefordshire 020A","E01014018","Total",25,10,11,4,9,1,7,1,16,9,4,3
"2011","Herefordshire 020B","E01014019","Total",25,12,8,5,4,1,3,0,21,11,5,5
"2011","Herefordshire 020C","E01014020","Total",19,10,4,5,2,0,1,1,17,10,3,4
"2011","Herefordshire 020D","E01014021","Total",21,12,4,5,5,3,2,0,16,9,2,5
"2011","Herefordshire 021A","E01014026","Total",32,14,9,9,4,1,2,1,28,13,7,8
"2011","Herefordshire 021B","E01014059","Total",24,15,6,3,2,0,1,1,22,15,5,2
"2011","Herefordshire 021C","E01014060","Total",24,11,7,6,2,1,1,0,22,10,6,6
"2011","Herefordshire 021D","E01014069","Total",73,20,21,32,6,1,2,3,67,19,19,29
"2011","Herefordshire 021E","E01014098","Total",45,14,11,20,8,0,3,5,37,14,8,15
"2011","Herefordshire 021F","E01014099","Total",30,12,13,5,5,2,3,0,25,10,10,5
"2011","Herefordshire 022A","E01014061","Total",19,9,7,3,4,2,2,0,15,7,5,3
"2011","Herefordshire 022B","E01014062","Total",42,15,12,15,5,2,2,1,37,13,10,14
"2011","Herefordshire 022C","E01014063","Total",49,23,8,18,7,0,4,3,42,23,4,15
"2011","Herefordshire 022D","E01014064","Total",56,18,8,30,10,0,5,5,46,18,3,25
"2011","Herefordshire 022E","E01014065","Total",44,20,9,15,4,2,0,2,40,18,9,13
"2011","Herefordshire 022F","E01014066","Total",28,18,4,6,3,1,1,1,25,17,3,5
"2011","Herefordshire 022G","E01014067","Total",16,7,9,0,1,0,1,0,15,7,8,0
"2011","Herefordshire 023A","E01014031","Total",21,5,9,7,5,0,4,1,16,5,5,6
"2011","Herefordshire 023B","E01014032","Total",25,8,11,6,7,1,5,1,18,7,6,5
"2011","Herefordshire 023C","E01014049","Total",26,14,6,6,2,1,1,0,24,13,5,6
"2011","Herefordshire 023D","E01014050","Total",27,15,6,6,5,2,3,0,22,13,3,6
"2011","Herefordshire 023E","E01014053","Total",14,4,4,6,1,0,0,1,13,4,4,5
"2011","Herefordshire 023F","E01014057","Total",34,9,12,13,7,0,6,1,27,9,6,12
"2011","Herefordshire 023G","E01014058","Total",10,5,3,2,2,1,1,0,8,4,2,2
"2011","Shropshire 025A","E01028853","Total",71,24,26,21,9,2,3,4,62,22,23,17
"2011","Shropshire 025B","E01028854","Total",25,11,10,4,1,0,1,0,24,11,9,4
"2011","Shropshire 025C","E01028855","Total",32,10,14,8,7,0,6,1,25,10,8,7
"2011","Shropshire 025D","E01028856","Total",30,9,15,6,4,0,4,0,26,9,11,6
"2011","Shropshire 025E","E01028857","Total",38,12,15,11,8,3,3,2,30,9,12,9
"2011","Shropshire 027A","E01028826","Total",40,12,16,12,7,0,7,0,33,12,9,12
"2011","Shropshire 027B","E01028827","Total",34,18,10,6,2,1,1,0,32,17,9,6
"2011","Shropshire 027C","E01028844","Total",22,4,18,0,8,0,8,0,14,4,10,0
"2011","Shropshire 027D","E01028845","Total",22,9,11,2,3,0,3,0,19,9,8,2
"2011","Shropshire 029A","E01028838","Total",50,16,14,20,10,2,4,4,40,14,10,16
"2011","Shropshire 029B","E01028839","Total",21,7,7,7,4,0,3,1,17,7,4,6
"2011","Shropshire 029C","E01028840","Total",26,12,9,5,2,0,1,1,24,12,8,4
"2011","Shropshire 029D","E01028841","Total",42,9,21,12,7,0,6,1,35,9,15,11
"2011","Shropshire 029E","E01028850","Total",26,13,9,4,2,1,1,0,24,12,8,4
"2011","Shropshire 029F","E01028851","Total",34,15,8,11,6,0,4,2,28,15,4,9
"2011","Shropshire 029G","E01028852","Total",33,20,5,8,3,2,0,1,30,18,5,7
"2011","Shropshire 031A","E01028830","Total",17,7,9,1,2,0,2,0,15,7,7,1
"2011","Shropshire 031B","E01028831","Total",26,9,12,5,2,1,1,0,24,8,11,5
"2011","Shropshire 031C","E01028836","Total",51,17,16,18,10,2,4,4,41,15,12,14
"2011","Shropshire 031D","E01028837","Total",21,10,8,3,3,0,3,0,18,10,5,3
"2011","Shropshire 033A","E01028832","Total",31,11,13,7,6,1,4,1,25,10,9,6
"2011","Shropshire 033B","E01028833","Total",21,11,5,5,0,0,0,0,21,11,5,5
"2011","Shropshire 033C","E01028834","Total",29,9,7,13,4,1,2,1,25,8,5,12
"2011","Shropshire 033D","E01028835","Total",31,6,16,9,11,2,6,3,20,4,10,6
"2011","Shropshire 034A","E01028828","Total",23,9,7,7,5,0,3,2,18,9,4,5
"2011","Shropshire 034B","E01028829","Total",19,7,7,5,1,0,1,0,18,7,6,5
"2011","Shropshire 034C","E01028842","Total",18,7,6,5,2,1,1,0,16,6,5,5
"2011","Shropshire 034D","E01028847","Total",17,7,4,6,2,0,2,0,15,7,2,6
"2011","Shropshire 034E","E01028859","Total",19,6,6,7,3,0,2,1,16,6,4,6
"2011","Shropshire 035A","E01028843","Total",25,9,9,7,5,1,4,0,20,8,5,7
"2011","Shropshire 035B","E01028846","Total",27,11,7,9,4,0,4,0,23,11,3,9
"2011","Shropshire 035C","E01028848","Total",31,14,8,9,8,3,4,1,23,11,4,8
"2011","Shropshire 035D","E01028849","Total",76,20,13,43,13,1,3,9,63,19,10,34
"2011","Shropshire 035E","E01028858","Total",22,9,12,1,5,0,5,0,17,9,7,1
"2011","Shropshire 001A","E01028891","Total",54,22,13,19,11,2,4,5,43,20,9,14
"2011","Shropshire 001B","E01028892","Total",21,7,10,4,9,1,8,0,12,6,2,4
"2011","Shropshire 001C","E01028894","Total",29,11,7,11,2,0,2,0,27,11,5,11
"2011","Shropshire 001D","E01028895","Total",47,18,13,16,4,1,1,2,43,17,12,14
"2011","Shropshire 001E","E01028896","Total",50,28,10,12,4,0,3,1,46,28,7,11
"2011","Shropshire 001F","E01028897","Total",47,21,7,19,3,0,2,1,44,21,5,18
"2011","Shropshire 002A","E01028880","Total",32,11,9,12,2,1,1,0,30,10,8,12
"2011","Shropshire 002B","E01028881","Total",13,3,6,4,5,0,2,3,8,3,4,1
"2011","Shropshire 002C","E01028882","Total",16,3,8,5,3,1,2,0,13,2,6,5
"2011","Shropshire 002D","E01028893","Total",17,6,9,2,4,0,3,1,13,6,6,1
"2011","Shropshire 002E","E01028899","Total",18,8,5,5,3,0,2,1,15,8,3,4
"2011","Shropshire 004A","E01028864","Total",15,7,5,3,1,0,1,0,14,7,4,3
"2011","Shropshire 004B","E01028865","Total",36,15,10,11,2,0,2,0,34,15,8,11
"2011","Shropshire 004C","E01028866","Total",34,14,10,10,2,0,1,1,32,14,9,9
"2011","Shropshire 004D","E01028867","Total",48,17,15,16,6,0,6,0,42,17,9,16
"2011","Shropshire 004E","E01028872","Total",25,9,9,7,8,1,5,2,17,8,4,5
"2011","Shropshire 005A","E01028873","Total",73,19,18,36,15,2,7,6,58,17,11,30
"2011","Shropshire 005B","E01028874","Total",21,9,8,4,5,2,3,0,16,7,5,4
"2011","Shropshire 005C","E01028875","Total",59,17,20,22,7,1,5,1,52,16,15,21
"2011","Shropshire 005D","E01028876","Total",53,16,14,23,10,1,8,1,43,15,6,22
"2011","Shropshire 005E","E01028877","Total",20,11,2,7,2,0,1,1,18,11,1,6
"2011","Shropshire 005F","E01028878","Total",44,22,9,13,6,3,2,1,38,19,7,12
"2011","Shropshire 005G","E01028879","Total",53,18,13,22,5,0,3,2,48,18,10,20
"2011","Shropshire 008A","E01028886","Total",67,30,10,27,5,0,2,3,62,30,8,24
"2011","Shropshire 008B","E01028887","Total",29,14,7,8,5,2,2,1,24,12,5,7
"2011","Shropshire 008C","E01028889","Total",19,10,5,4,1,0,1,0,18,10,4,4
"2011","Shropshire 008D","E01028890","Total",34,8,15,11,8,0,7,1,26,8,8,10
"2011","Shropshire 009A","E01028868","Total",24,9,8,7,4,3,1,0,20,6,7,7
"2011","Shropshire 009B","E01028869","Total",18,4,7,7,3,0,3,0,15,4,4,7
"2011","Shropshire 009C","E01028871","Total",22,9,2,11,3,0,0,3,19,9,2,8
"2011","Shropshire 009D","E01028885","Total",54,23,13,18,7,0,3,4,47,23,10,14
"2011","Shropshire 010A","E01028860","Total",36,8,21,7,8,1,7,0,28,7,14,7
"2011","Shropshire 010B","E01028862","Total",17,7,5,5,1,0,1,0,16,7,4,5
"2011","Shropshire 010C","E01028863","Total",15,5,5,5,3,0,3,0,12,5,2,5
"2011","Shropshire 010D","E01028888","Total",16,8,6,2,3,0,3,0,13,8,3,2
"2011","Shropshire 010E","E01028898","Total",15,4,7,4,0,0,0,0,15,4,7,4
"2011","Shropshire 013A","E01028861","Total",21,10,8,3,4,0,4,0,17,10,4,3
"2011","Shropshire 013B","E01028870","Total",17,8,6,3,6,0,5,1,11,8,1,2
"2011","Shropshire 013C","E01028883","Total",19,8,7,4,5,3,0,2,14,5,7,2
"2011","Shropshire 013D","E01028884","Total",39,13,14,12,8,1,6,1,31,12,8,11
"2011","Shropshire 003A","E01028910","Total",14,7,5,2,3,1,1,1,11,6,4,1
"2011","Shropshire 003B","E01028911","Total",11,4,5,2,0,0,0,0,11,4,5,2
"2011","Shropshire 003C","E01028912","Total",49,18,6,25,5,2,2,1,44,16,4,24
"2011","Shropshire 003D","E01028920","Total",21,8,8,5,0,0,0,0,21,8,8,5
"2011","Shropshire 003E","E01028921","Total",27,12,11,4,2,0,2,0,25,12,9,4
"2011","Shropshire 003F","E01028925","Total",18,3,9,6,4,0,4,0,14,3,5,6
"2011","Shropshire 003G","E01028926","Total",34,7,15,12,4,0,4,0,30,7,11,12
"2011","Shropshire 006C","E01028902","Total",17,8,6,3,3,1,1,1,14,7,5,2
"2011","Shropshire 006D","E01028903","Total",47,10,12,25,8,0,6,2,39,10,6,23
"2011","Shropshire 006E","E01028904","Total",42,18,10,14,4,0,3,1,38,18,7,13
"2011","Shropshire 006F","E01028905","Total",88,29,19,40,7,2,3,2,81,27,16,38
"2011","Shropshire 006G","E01028909","Total",57,16,15,26,6,0,6,0,51,16,9,26
"2011","Shropshire 006H","E01033528","Total",70,33,25,12,8,1,7,0,62,32,18,12
"2011","Shropshire 007A","E01028906","Total",35,10,12,13,7,1,4,2,28,9,8,11
"2011","Shropshire 007B","E01028907","Total",42,17,17,8,2,0,1,1,40,17,16,7
"2011","Shropshire 007C","E01028908","Total",86,27,20,39,17,2,7,8,69,25,13,31
"2011","Shropshire 007D","E01028916","Total",23,11,9,3,1,0,1,0,22,11,8,3
"2011","Shropshire 007E","E01028917","Total",27,14,10,3,3,0,3,0,24,14,7,3
"2011","Shropshire 007F","E01028924","Total",39,14,12,13,5,0,4,1,34,14,8,12
"2011","Shropshire 011A","E01028913","Total",10,4,3,3,1,0,1,0,9,4,2,3
"2011","Shropshire 011B","E01028918","Total",27,9,12,6,6,3,3,0,21,6,9,6
"2011","Shropshire 011C","E01028919","Total",25,3,13,9,7,0,6,1,18,3,7,8
"2011","Shropshire 011D","E01028927","Total",15,6,4,5,1,0,1,0,14,6,3,5
"2011","Shropshire 011E","E01028928","Total",31,12,8,11,3,1,1,1,28,11,7,10
"2011","Shropshire 012A","E01028914","Total",15,6,6,3,1,0,1,0,14,6,5,3
"2011","Shropshire 012B","E01028915","Total",18,8,6,4,1,0,1,0,17,8,5,4
"2011","Shropshire 012C","E01028922","Total",18,9,5,4,1,1,0,0,17,8,5,4
"2011","Shropshire 012D","E01028923","Total",17,10,5,2,1,0,1,0,16,10,4,2
"2011","Shropshire 014A","E01028929","Total",24,15,6,3,3,0,2,1,21,15,4,2
"2011","Shropshire 014B","E01028969","Total",31,13,14,4,5,0,5,0,26,13,9,4
"2011","Shropshire 014C","E01028970","Total",13,6,7,0,2,1,1,0,11,5,6,0
"2011","Shropshire 014D","E01028971","Total",35,16,13,6,7,1,4,2,28,15,9,4
"2011","Shropshire 014E","E01028978","Total",36,11,11,14,5,0,5,0,31,11,6,14
"2011","Shropshire 014F","E01028979","Total",21,8,9,4,4,1,3,0,17,7,6,4
"2011","Shropshire 015A","E01028933","Total",44,22,10,12,3,0,3,0,41,22,7,12
"2011","Shropshire 015B","E01028934","Total",99,32,21,46,13,1,8,4,86,31,13,42
"2011","Shropshire 015C","E01028956","Total",33,12,12,9,5,3,2,0,28,9,10,9
"2011","Shropshire 015D","E01028957","Total",97,32,15,50,12,1,3,8,85,31,12,42
"2011","Shropshire 015E","E01028958","Total",69,26,19,24,15,1,9,5,54,25,10,19
"2011","Shropshire 016A","E01028932","Total",26,11,7,8,3,0,1,2,23,11,6,6
"2011","Shropshire 016B","E01028981","Total",45,18,17,10,7,0,3,4,38,18,14,6
"2011","Shropshire 016C","E01028982","Total",52,16,11,25,1,0,1,0,51,16,10,25
"2011","Shropshire 016D","E01028983","Total",93,42,13,38,14,1,6,7,79,41,7,31
"2011","Shropshire 017A","E01028930","Total",52,20,19,13,6,1,4,1,46,19,15,12
"2011","Shropshire 017B","E01028931","Total",64,21,20,23,6,2,3,1,58,19,17,22
"2011","Shropshire 017C","E01028944","Total",49,19,10,20,8,0,5,3,41,19,5,17
"2011","Shropshire 017D","E01028945","Total",97,32,26,39,12,2,9,1,85,30,17,38
"2011","Shropshire 018A","E01028965","Total",52,19,8,25,5,0,5,0,47,19,3,25
"2011","Shropshire 018B","E01028966","Total",11,4,4,3,0,0,0,0,11,4,4,3
"2011","Shropshire 018C","E01028967","Total",94,31,17,46,7,1,3,3,87,30,14,43
"2011","Shropshire 018D","E01028968","Total",54,24,9,21,10,0,5,5,44,24,4,16
"2011","Shropshire 018E","E01028988","Total",61,34,13,14,3,0,3,0,58,34,10,14
"2011","Shropshire 018F","E01028989","Total",78,39,14,25,10,5,3,2,68,34,11,23
"2011","Shropshire 019A","E01028946","Total",43,10,22,11,21,0,14,7,22,10,8,4
"2011","Shropshire 019B","E01028972","Total",21,11,8,2,2,1,1,0,19,10,7,2
"2011","Shropshire 019C","E01028973","Total",43,13,21,9,5,1,4,0,38,12,17,9
"2011","Shropshire 019D","E01028987","Total",34,13,16,5,5,1,3,1,29,12,13,4
"2011","Shropshire 020A","E01028941","Total",61,33,16,12,4,0,4,0,57,33,12,12
"2011","Shropshire 020B","E01028942","Total",28,9,14,5,0,0,0,0,28,9,14,5
"2011","Shropshire 020C","E01028943","Total",65,27,27,11,9,1,7,1,56,26,20,10
"2011","Shropshire 020D","E01028951","Total",37,16,12,9,4,1,3,0,33,15,9,9
"2011","Shropshire 020E","E01028953","Total",16,7,8,1,2,0,2,0,14,7,6,1
"2011","Shropshire 021A","E01028947","Total",13,6,4,3,2,0,2,0,11,6,2,3
"2011","Shropshire 021B","E01028948","Total",32,14,8,10,1,0,1,0,31,14,7,10
"2011","Shropshire 021C","E01028949","Total",22,9,8,5,4,0,4,0,18,9,4,5
"2011","Shropshire 021D","E01028985","Total",22,11,10,1,2,1,1,0,20,10,9,1
"2011","Shropshire 022A","E01028938","Total",47,25,13,9,4,2,2,0,43,23,11,9
"2011","Shropshire 022B","E01028939","Total",66,28,19,19,10,2,5,3,56,26,14,16
"2011","Shropshire 022C","E01028984","Total",41,13,10,18,7,0,1,6,34,13,9,12
"2011","Shropshire 022D","E01028986","Total",35,14,17,4,6,0,6,0,29,14,11,4
"2011","Shropshire 023A","E01028940","Total",46,21,11,14,0,0,0,0,46,21,11,14
"2011","Shropshire 023B","E01028952","Total",44,17,21,6,9,2,7,0,35,15,14,6
"2011","Shropshire 023C","E01028962","Total",82,34,15,33,14,2,4,8,68,32,11,25
"2011","Shropshire 023D","E01028963","Total",25,11,10,4,3,0,3,0,22,11,7,4
"2011","Shropshire 023E","E01028964","Total",37,12,22,3,7,2,3,2,30,10,19,1
"2011","Shropshire 023F","E01028974","Total",22,9,9,4,3,1,2,0,19,8,7,4
"2011","Shropshire 024A","E01028935","Total",18,7,9,2,2,0,2,0,16,7,7,2
"2011","Shropshire 024B","E01028936","Total",32,15,13,4,4,0,4,0,28,15,9,4
"2011","Shropshire 024C","E01028937","Total",38,12,16,10,6,1,5,0,32,11,11,10
"2011","Shropshire 024D","E01028959","Total",37,12,19,6,6,0,6,0,31,12,13,6
"2011","Shropshire 026A","E01028954","Total",16,4,8,4,4,0,4,0,12,4,4,4
"2011","Shropshire 026B","E01028955","Total",25,10,6,9,10,0,5,5,15,10,1,4
"2011","Shropshire 026C","E01028975","Total",42,20,11,11,9,3,5,1,33,17,6,10
"2011","Shropshire 026D","E01028976","Total",23,7,7,9,3,1,1,1,20,6,6,8
"2011","Shropshire 026E","E01028977","Total",32,15,9,8,7,1,5,1,25,14,4,7
"2011","Shropshire 028A","E01028950","Total",48,17,17,14,2,0,2,0,46,17,15,14
"2011","Shropshire 028B","E01028960","Total",13,6,6,1,2,0,2,0,11,6,4,1
"2011","Shropshire 028C","E01028961","Total",16,5,5,6,2,0,0,2,14,5,5,4
"2011","Shropshire 028D","E01028980","Total",32,15,9,8,3,0,3,0,29,15,6,8
"2011","Shropshire 030A","E01028991","Total",24,10,5,9,5,0,4,1,19,10,1,8
"2011","Shropshire 030B","E01028992","Total",43,19,12,12,10,3,5,2,33,16,7,10
"2011","Shropshire 030D","E01033529","Total",7,3,3,1,1,0,0,1,6,3,3,0
"2011","Shropshire 030E","E01033530","Total",33,18,9,6,5,1,3,1,28,17,6,5
"2011","Shropshire 032A","E01028990","Total",18,6,5,7,2,0,1,1,16,6,4,6
"2011","Shropshire 032B","E01028997","Total",31,14,6,11,3,0,0,3,28,14,6,8
"2011","Shropshire 032C","E01028998","Total",49,23,18,8,7,2,3,2,42,21,15,6
"2011","Shropshire 036A","E01028993","Total",24,8,10,6,7,1,6,0,17,7,4,6
"2011","Shropshire 036B","E01029004","Total",12,4,2,6,1,0,0,1,11,4,2,5
"2011","Shropshire 036C","E01029013","Total",24,10,9,5,4,0,4,0,20,10,5,5
"2011","Shropshire 036D","E01029014","Total",53,15,10,28,7,0,5,2,46,15,5,26
"2011","Shropshire 036E","E01029015","Total",12,2,4,6,3,0,3,0,9,2,1,6
"2011","Shropshire 037A","E01028994","Total",14,5,6,3,3,1,2,0,11,4,4,3
"2011","Shropshire 037B","E01029003","Total",29,15,9,5,6,1,4,1,23,14,5,4
"2011","Shropshire 037C","E01029005","Total",8,5,0,3,1,1,0,0,7,4,0,3
"2011","Shropshire 037D","E01029016","Total",11,5,2,4,1,0,1,0,10,5,1,4
"2011","Shropshire 038A","E01029006","Total",27,12,6,9,2,0,0,2,25,12,6,7
"2011","Shropshire 038B","E01029007","Total",60,25,5,30,5,0,2,3,55,25,3,27
"2011","Shropshire 038D","E01029009","Total",19,10,4,5,2,1,1,0,17,9,3,5
"2011","Shropshire 038E","E01029010","Total",44,13,6,25,3,0,2,1,41,13,4,24
"2011","Shropshire 038F","E01029011","Total",36,10,12,14,4,1,3,0,32,9,9,14
"2011","Shropshire 038G","E01029012","Total",57,26,13,18,9,2,6,1,48,24,7,17
"2011","Shropshire 038H","E01033526","Total",24,8,3,13,1,0,1,0,23,8,2,13
"2011","Shropshire 038I","E01033527","Total",16,4,4,8,5,0,2,3,11,4,2,5
"2011","Shropshire 039A","E01028995","Total",21,13,5,3,1,0,1,0,20,13,4,3
"2011","Shropshire 039B","E01028996","Total",15,9,4,2,0,0,0,0,15,9,4,2
"2011","Shropshire 039C","E01028999","Total",18,11,4,3,0,0,0,0,18,11,4,3
"2011","Shropshire 039D","E01029000","Total",10,5,4,1,2,0,2,0,8,5,2,1
"2011","Shropshire 039E","E01029001","Total",43,20,11,12,5,0,4,1,38,20,7,11
"2011","Shropshire 039F","E01029002","Total",41,9,18,14,6,0,5,1,35,9,13,13
"2011","Stoke-on-Trent 001A","E01014257","Total",53,19,10,24,4,0,1,3,49,19,9,21
"2011","Stoke-on-Trent 001B","E01014258","Total",31,7,20,4,6,0,5,1,25,7,15,3
"2011","Stoke-on-Trent 001C","E01014259","Total",42,17,15,10,5,1,1,3,37,16,14,7
"2011","Stoke-on-Trent 001D","E01014260","Total",46,15,10,21,4,0,3,1,42,15,7,20
"2011","Stoke-on-Trent 001E","E01014264","Total",53,25,15,13,4,0,2,2,49,25,13,11
"2011","Stoke-on-Trent 002A","E01014357","Total",71,30,22,19,14,6,4,4,57,24,18,15
"2011","Stoke-on-Trent 002B","E01014358","Total",97,27,14,56,7,2,2,3,90,25,12,53
"2011","Stoke-on-Trent 002C","E01014359","Total",76,22,18,36,6,0,6,0,70,22,12,36
"2011","Stoke-on-Trent 002D","E01014360","Total",68,21,22,25,7,0,7,0,61,21,15,25
"2011","Stoke-on-Trent 003A","E01014261","Total",100,24,14,62,8,0,2,6,92,24,12,56
"2011","Stoke-on-Trent 003B","E01014262","Total",57,9,7,41,7,2,1,4,50,7,6,37
"2011","Stoke-on-Trent 003C","E01014263","Total",84,17,13,54,15,2,6,7,69,15,7,47
"2011","Stoke-on-Trent 003D","E01014333","Total",32,13,11,8,2,0,1,1,30,13,10,7
"2011","Stoke-on-Trent 003E","E01014334","Total",20,4,7,9,0,0,0,0,20,4,7,9
"2011","Stoke-on-Trent 004A","E01014331","Total",80,18,14,48,11,1,3,7,69,17,11,41
"2011","Stoke-on-Trent 004B","E01014332","Total",31,11,13,7,3,1,1,1,28,10,12,6
"2011","Stoke-on-Trent 004C","E01014335","Total",41,17,10,14,1,0,0,1,40,17,10,13
"2011","Stoke-on-Trent 004D","E01014336","Total",75,24,15,36,10,0,3,7,65,24,12,29
"2011","Stoke-on-Trent 004E","E01014337","Total",73,28,10,35,10,0,3,7,63,28,7,28
"2011","Stoke-on-Trent 005A","E01014354","Total",101,25,19,57,11,0,5,6,90,25,14,51
"2011","Stoke-on-Trent 005B","E01014355","Total",61,18,18,25,12,1,7,4,49,17,11,21
"2011","Stoke-on-Trent 005C","E01014356","Total",75,17,16,42,12,1,6,5,63,16,10,37
"2011","Stoke-on-Trent 005D","E01014361","Total",105,17,20,68,15,2,4,9,90,15,16,59
"2011","Stoke-on-Trent 006A","E01014241","Total",70,23,15,32,10,4,6,0,60,19,9,32
"2011","Stoke-on-Trent 006B","E01014242","Total",78,18,12,48,9,0,4,5,69,18,8,43
"2011","Stoke-on-Trent 006C","E01014243","Total",21,9,8,4,2,0,2,0,19,9,6,4
"2011","Stoke-on-Trent 006D","E01014244","Total",105,20,22,63,9,1,2,6,96,19,20,57
"2011","Stoke-on-Trent 006E","E01014245","Total",41,7,12,22,2,0,2,0,39,7,10,22
"2011","Stoke-on-Trent 006F","E01014248","Total",61,14,18,29,7,0,5,2,54,14,13,27
"2011","Stoke-on-Trent 007A","E01014214","Total",17,9,7,1,2,0,1,1,15,9,6,0
"2011","Stoke-on-Trent 007B","E01014215","Total",35,13,14,8,3,0,3,0,32,13,11,8
"2011","Stoke-on-Trent 007C","E01014216","Total",34,10,13,11,8,0,5,3,26,10,8,8
"2011","Stoke-on-Trent 007D","E01014265","Total",27,8,11,8,3,1,1,1,24,7,10,7
"2011","Stoke-on-Trent 007E","E01014267","Total",84,34,27,23,11,2,7,2,73,32,20,21
"2011","Stoke-on-Trent 007F","E01014272","Total",47,20,18,9,8,1,6,1,39,19,12,8
"2011","Stoke-on-Trent 008A","E01014246","Total",73,24,20,29,9,2,4,3,64,22,16,26
"2011","Stoke-on-Trent 008B","E01014266","Total",60,24,11,25,5,2,2,1,55,22,9,24
"2011","Stoke-on-Trent 008C","E01014268","Total",80,23,22,35,10,0,7,3,70,23,15,32
"2011","Stoke-on-Trent 008D","E01014270","Total",37,16,8,13,5,1,1,3,32,15,7,10
"2011","Stoke-on-Trent 008E","E01014271","Total",54,18,20,16,7,2,4,1,47,16,16,15
"2011","Stoke-on-Trent 009A","E01014247","Total",88,29,19,40,7,1,1,5,81,28,18,35
"2011","Stoke-on-Trent 009B","E01014250","Total",60,17,3,40,8,1,1,6,52,16,2,34
"2011","Stoke-on-Trent 009C","E01014251","Total",66,7,14,45,6,0,3,3,60,7,11,42
"2011","Stoke-on-Trent 009D","E01014252","Total",73,17,25,31,17,1,12,4,56,16,13,27
"2011","Stoke-on-Trent 009E","E01014255","Total",75,27,12,36,5,1,3,1,70,26,9,35
"2011","Stoke-on-Trent 010A","E01014269","Total",89,28,18,43,7,0,3,4,82,28,15,39
"2011","Stoke-on-Trent 010B","E01014324","Total",41,13,16,12,6,0,5,1,35,13,11,11
"2011","Stoke-on-Trent 010C","E01014325","Total",29,17,11,1,2,0,2,0,27,17,9,1
"2011","Stoke-on-Trent 010D","E01014326","Total",28,9,13,6,2,1,1,0,26,8,12,6
"2011","Stoke-on-Trent 011A","E01014249","Total",68,14,10,44,12,4,4,4,56,10,6,40
"2011","Stoke-on-Trent 011B","E01014253","Total",37,10,15,12,4,0,3,1,33,10,12,11
"2011","Stoke-on-Trent 011C","E01014254","Total",67,11,8,48,6,1,0,5,61,10,8,43
"2011","Stoke-on-Trent 011D","E01014256","Total",76,18,19,39,11,3,7,1,65,15,12,38
"2011","Stoke-on-Trent 012A","E01014210","Total",56,18,11,27,11,0,6,5,45,18,5,22
"2011","Stoke-on-Trent 012B","E01014211","Total",71,29,8,34,6,1,0,5,65,28,8,29
"2011","Stoke-on-Trent 012C","E01014212","Total",64,25,12,27,8,1,3,4,56,24,9,23
"2011","Stoke-on-Trent 012D","E01014213","Total",56,16,14,26,8,1,6,1,48,15,8,25
"2011","Stoke-on-Trent 012E","E01014217","Total",94,25,17,52,10,0,3,7,84,25,14,45
"2011","Stoke-on-Trent 013A","E01014323","Total",69,26,20,23,6,0,5,1,63,26,15,22
"2011","Stoke-on-Trent 013B","E01014327","Total",63,21,14,28,5,0,3,2,58,21,11,26
"2011","Stoke-on-Trent 013C","E01014328","Total",55,12,18,25,6,1,4,1,49,11,14,24
"2011","Stoke-on-Trent 013D","E01014329","Total",80,30,19,31,10,1,3,6,70,29,16,25
"2011","Stoke-on-Trent 013E","E01014330","Total",58,15,8,35,7,3,1,3,51,12,7,32
"2011","Stoke-on-Trent 014A","E01014218","Total",96,25,23,48,14,1,4,9,82,24,19,39
"2011","Stoke-on-Trent 014B","E01014219","Total",27,6,9,12,4,0,3,1,23,6,6,11
"2011","Stoke-on-Trent 014C","E01014225","Total",39,13,16,10,7,2,4,1,32,11,12,9
"2011","Stoke-on-Trent 014D","E01014226","Total",38,24,8,6,6,1,3,2,32,23,5,4
"2011","Stoke-on-Trent 014E","E01014228","Total",23,7,9,7,7,0,4,3,16,7,5,4
"2011","Stoke-on-Trent 014F","E01014230","Total",61,18,18,25,8,0,5,3,53,18,13,22
"2011","Stoke-on-Trent 015A","E01014281","Total",46,15,3,28,6,2,1,3,40,13,2,25
"2011","Stoke-on-Trent 015B","E01014285","Total",72,21,18,33,5,0,4,1,67,21,14,32
"2011","Stoke-on-Trent 015C","E01014286","Total",45,11,9,25,8,1,2,5,37,10,7,20
"2011","Stoke-on-Trent 015D","E01014287","Total",60,16,8,36,8,2,0,6,52,14,8,30
"2011","Stoke-on-Trent 016B","E01014231","Total",27,6,9,12,8,1,4,3,19,5,5,9
"2011","Stoke-on-Trent 016D","E01014282","Total",21,4,1,16,2,1,0,1,19,3,1,15
"2011","Stoke-on-Trent 016E","E01014283","Total",25,6,9,10,5,1,3,1,20,5,6,9
"2011","Stoke-on-Trent 016F","E01014284","Total",5,0,2,3,0,0,0,0,5,0,2,3
"2011","Stoke-on-Trent 016G","E01033216","Total",71,22,17,32,13,2,7,4,58,20,10,28
"2011","Stoke-on-Trent 017A","E01014220","Total",97,36,8,53,9,0,1,8,88,36,7,45
"2011","Stoke-on-Trent 017B","E01014221","Total",89,32,13,44,6,1,2,3,83,31,11,41
"2011","Stoke-on-Trent 017C","E01014222","Total",109,33,15,61,10,0,2,8,99,33,13,53
"2011","Stoke-on-Trent 017D","E01014223","Total",99,31,9,59,15,4,5,6,84,27,4,53
"2011","Stoke-on-Trent 017E","E01014224","Total",91,20,7,64,7,2,0,5,84,18,7,59
"2011","Stoke-on-Trent 017F","E01014229","Total",133,47,29,57,12,0,6,6,121,47,23,51
"2011","Stoke-on-Trent 018A","E01014288","Total",51,21,18,12,5,3,2,0,46,18,16,12
"2011","Stoke-on-Trent 018B","E01014289","Total",29,7,12,10,5,0,3,2,24,7,9,8
"2011","Stoke-on-Trent 018C","E01014290","Total",46,18,13,15,5,0,2,3,41,18,11,12
"2011","Stoke-on-Trent 018D","E01014291","Total",38,14,12,12,1,0,1,0,37,14,11,12
"2011","Stoke-on-Trent 018E","E01014292","Total",37,12,11,14,2,1,1,0,35,11,10,14
"2011","Stoke-on-Trent 018F","E01014294","Total",45,8,19,18,6,0,3,3,39,8,16,15
"2011","Stoke-on-Trent 019A","E01014293","Total",71,19,26,26,4,0,3,1,67,19,23,25
"2011","Stoke-on-Trent 019B","E01014295","Total",40,14,16,10,8,1,6,1,32,13,10,9
"2011","Stoke-on-Trent 019C","E01014339","Total",81,18,25,38,1,1,0,0,80,17,25,38
"2011","Stoke-on-Trent 019D","E01014340","Total",94,23,23,48,2,0,1,1,92,23,22,47
"2011","Stoke-on-Trent 019E","E01014345","Total",59,11,5,43,5,0,1,4,54,11,4,39
"2011","Stoke-on-Trent 020A","E01014274","Total",113,37,31,45,10,3,2,5,103,34,29,40
"2011","Stoke-on-Trent 020B","E01014275","Total",77,18,19,40,6,0,3,3,71,18,16,37
"2011","Stoke-on-Trent 020C","E01014276","Total",77,30,19,28,3,0,1,2,74,30,18,26
"2011","Stoke-on-Trent 020D","E01014277","Total",43,15,13,15,3,0,3,0,40,15,10,15
"2011","Stoke-on-Trent 020E","E01014279","Total",72,25,20,27,9,1,6,2,63,24,14,25
"2011","Stoke-on-Trent 021A","E01014273","Total",93,26,16,51,15,0,5,10,78,26,11,41
"2011","Stoke-on-Trent 021B","E01014278","Total",51,9,11,31,6,1,2,3,45,8,9,28
"2011","Stoke-on-Trent 021C","E01014280","Total",33,17,11,5,4,1,2,1,29,16,9,4
"2011","Stoke-on-Trent 021D","E01014297","Total",33,9,15,9,9,3,5,1,24,6,10,8
"2011","Stoke-on-Trent 022A","E01014296","Total",48,16,15,17,7,4,3,0,41,12,12,17
"2011","Stoke-on-Trent 022B","E01014298","Total",74,19,16,39,6,1,2,3,68,18,14,36
"2011","Stoke-on-Trent 022C","E01014300","Total",74,14,18,42,7,0,3,4,67,14,15,38
"2011","Stoke-on-Trent 022D","E01014302","Total",71,25,24,22,16,1,11,4,55,24,13,18
"2011","Stoke-on-Trent 023A","E01014338","Total",28,10,7,11,5,2,2,1,23,8,5,10
"2011","Stoke-on-Trent 023B","E01014341","Total",43,14,11,18,2,0,1,1,41,14,10,17
"2011","Stoke-on-Trent 023C","E01014342","Total",79,20,14,45,6,0,3,3,73,20,11,42
"2011","Stoke-on-Trent 023D","E01014343","Total",68,24,13,31,6,1,3,2,62,23,10,29
"2011","Stoke-on-Trent 023E","E01014344","Total",56,20,13,23,2,0,1,1,54,20,12,22
"2011","Stoke-on-Trent 024A","E01014363","Total",25,7,9,9,5,0,4,1,20,7,5,8
"2011","Stoke-on-Trent 024B","E01014364","Total",43,12,15,16,6,0,4,2,37,12,11,14
"2011","Stoke-on-Trent 024C","E01014365","Total",30,9,10,11,1,0,1,0,29,9,9,11
"2011","Stoke-on-Trent 024D","E01014369","Total",46,15,11,20,5,0,4,1,41,15,7,19
"2011","Stoke-on-Trent 025A","E01014299","Total",40,20,15,5,0,0,0,0,40,20,15,5
"2011","Stoke-on-Trent 025B","E01014301","Total",36,9,17,10,2,0,2,0,34,9,15,10
"2011","Stoke-on-Trent 025C","E01014303","Total",50,22,16,12,7,3,4,0,43,19,12,12
"2011","Stoke-on-Trent 025D","E01014304","Total",37,13,18,6,5,0,5,0,32,13,13,6
"2011","Stoke-on-Trent 025E","E01014362","Total",18,4,11,3,4,0,4,0,14,4,7,3
"2011","Stoke-on-Trent 026A","E01014233","Total",31,6,14,11,2,0,2,0,29,6,12,11
"2011","Stoke-on-Trent 026B","E01014234","Total",88,28,16,44,6,0,5,1,82,28,11,43
"2011","Stoke-on-Trent 026C","E01014239","Total",40,15,10,15,5,1,3,1,35,14,7,14
"2011","Stoke-on-Trent 026D","E01014240","Total",45,9,18,18,8,0,1,7,37,9,17,11
"2011","Stoke-on-Trent 027A","E01014308","Total",25,8,10,7,3,1,2,0,22,7,8,7
"2011","Stoke-on-Trent 027B","E01014309","Total",44,19,12,13,3,0,1,2,41,19,11,11
"2011","Stoke-on-Trent 027C","E01014311","Total",53,15,13,25,1,0,1,0,52,15,12,25
"2011","Stoke-on-Trent 027D","E01014313","Total",49,11,18,20,6,0,4,2,43,11,14,18
"2011","Stoke-on-Trent 028A","E01014321","Total",31,10,12,9,4,0,3,1,27,10,9,8
"2011","Stoke-on-Trent 028B","E01014366","Total",80,12,10,58,5,0,2,3,75,12,8,55
"2011","Stoke-on-Trent 028C","E01014367","Total",76,21,12,43,7,0,3,4,69,21,9,39
"2011","Stoke-on-Trent 028D","E01014368","Total",82,18,14,50,5,0,4,1,77,18,10,49
"2011","Stoke-on-Trent 029A","E01014305","Total",37,11,4,22,2,1,0,1,35,10,4,21
"2011","Stoke-on-Trent 029B","E01014306","Total",56,13,11,32,7,0,3,4,49,13,8,28
"2011","Stoke-on-Trent 029C","E01014307","Total",49,11,7,31,3,0,2,1,46,11,5,30
"2011","Stoke-on-Trent 029D","E01014312","Total",40,12,15,13,6,2,2,2,34,10,13,11
"2011","Stoke-on-Trent 030A","E01014346","Total",19,3,9,7,1,0,1,0,18,3,8,7
"2011","Stoke-on-Trent 030B","E01014348","Total",23,6,11,6,1,0,1,0,22,6,10,6
"2011","Stoke-on-Trent 030C","E01014349","Total",24,7,14,3,5,0,5,0,19,7,9,3
"2011","Stoke-on-Trent 030D","E01014353","Total",92,30,20,42,10,2,4,4,82,28,16,38
"2011","Stoke-on-Trent 031A","E01014310","Total",38,5,20,13,5,0,4,1,33,5,16,12
"2011","Stoke-on-Trent 031B","E01014314","Total",16,6,7,3,2,0,2,0,14,6,5,3
"2011","Stoke-on-Trent 031C","E01014316","Total",104,23,18,63,13,1,3,9,91,22,15,54
"2011","Stoke-on-Trent 031D","E01014317","Total",84,19,20,45,5,2,2,1,79,17,18,44
"2011","Stoke-on-Trent 031E","E01014322","Total",61,20,14,27,5,1,1,3,56,19,13,24
"2011","Stoke-on-Trent 032A","E01014235","Total",58,14,16,28,6,2,2,2,52,12,14,26
"2011","Stoke-on-Trent 032B","E01014236","Total",116,32,28,56,16,2,9,5,100,30,19,51
"2011","Stoke-on-Trent 032C","E01014237","Total",78,26,17,35,8,1,3,4,70,25,14,31
"2011","Stoke-on-Trent 032D","E01014238","Total",74,19,18,37,17,4,9,4,57,15,9,33
"2011","Stoke-on-Trent 033A","E01014315","Total",18,7,11,0,2,0,2,0,16,7,9,0
"2011","Stoke-on-Trent 033B","E01014318","Total",26,6,14,6,5,0,5,0,21,6,9,6
"2011","Stoke-on-Trent 033C","E01014319","Total",47,11,16,20,5,1,2,2,42,10,14,18
"2011","Stoke-on-Trent 033D","E01014320","Total",31,15,15,1,5,1,4,0,26,14,11,1
"2011","Stoke-on-Trent 034A","E01014347","Total",26,10,11,5,4,0,4,0,22,10,7,5
"2011","Stoke-on-Trent 034B","E01014350","Total",22,7,13,2,4,0,4,0,18,7,9,2
"2011","Stoke-on-Trent 034C","E01014351","Total",21,5,13,3,2,0,2,0,19,5,11,3
"2011","Stoke-on-Trent 034D","E01014352","Total",13,6,5,2,5,0,4,1,8,6,1,1
"2011","Telford and Wrekin 001A","E01014171","Total",47,17,17,13,3,1,1,1,44,16,16,12
"2011","Telford and Wrekin 001B","E01014172","Total",29,14,12,3,2,0,2,0,27,14,10,3
"2011","Telford and Wrekin 001C","E01014173","Total",43,22,13,8,6,3,2,1,37,19,11,7
"2011","Telford and Wrekin 001D","E01014174","Total",18,8,9,1,3,0,3,0,15,8,6,1
"2011","Telford and Wrekin 002A","E01014112","Total",25,7,12,6,4,0,1,3,21,7,11,3
"2011","Telford and Wrekin 002B","E01014131","Total",12,5,4,3,2,0,2,0,10,5,2,3
"2011","Telford and Wrekin 002C","E01014132","Total",18,7,7,4,4,0,3,1,14,7,4,3
"2011","Telford and Wrekin 002D","E01014135","Total",20,5,10,5,2,0,2,0,18,5,8,5
"2011","Telford and Wrekin 003A","E01014175","Total",33,13,13,7,6,1,4,1,27,12,9,6
"2011","Telford and Wrekin 003B","E01014176","Total",28,11,10,7,1,0,1,0,27,11,9,7
"2011","Telford and Wrekin 003C","E01014177","Total",31,15,12,4,2,1,1,0,29,14,11,4
"2011","Telford and Wrekin 003D","E01014178","Total",33,13,11,9,9,4,3,2,24,9,8,7
"2011","Telford and Wrekin 004A","E01014111","Total",21,5,11,5,5,0,4,1,16,5,7,4
"2011","Telford and Wrekin 004B","E01014167","Total",53,20,23,10,3,0,3,0,50,20,20,10
"2011","Telford and Wrekin 004C","E01014168","Total",31,8,10,13,4,0,3,1,27,8,7,12
"2011","Telford and Wrekin 004D","E01014170","Total",34,12,18,4,6,2,4,0,28,10,14,4
"2011","Telford and Wrekin 005A","E01014125","Total",55,15,13,27,11,0,6,5,44,15,7,22
"2011","Telford and Wrekin 005B","E01014126","Total",37,12,5,20,5,0,1,4,32,12,4,16
"2011","Telford and Wrekin 005C","E01014127","Total",86,30,13,43,16,3,5,8,70,27,8,35
"2011","Telford and Wrekin 005D","E01014128","Total",56,12,23,21,8,0,4,4,48,12,19,17
"2011","Telford and Wrekin 005E","E01014169","Total",91,31,28,32,3,0,2,1,88,31,26,31
"2011","Telford and Wrekin 006A","E01014129","Total",24,8,11,5,2,1,1,0,22,7,10,5
"2011","Telford and Wrekin 006B","E01014130","Total",38,18,11,9,3,0,3,0,35,18,8,9
"2011","Telford and Wrekin 006C","E01014179","Total",23,9,12,2,6,0,6,0,17,9,6,2
"2011","Telford and Wrekin 006D","E01014180","Total",36,13,12,11,5,1,2,2,31,12,10,9
"2011","Telford and Wrekin 006E","E01014189","Total",56,23,18,15,5,0,3,2,51,23,15,13
"2011","Telford and Wrekin 006F","E01014190","Total",34,10,19,5,5,1,4,0,29,9,15,5
"2011","Telford and Wrekin 007A","E01014102","Total",30,8,17,5,4,0,4,0,26,8,13,5
"2011","Telford and Wrekin 007B","E01014103","Total",16,5,6,5,2,0,2,0,14,5,4,5
"2011","Telford and Wrekin 007C","E01014138","Total",52,22,14,16,9,2,5,2,43,20,9,14
"2011","Telford and Wrekin 007D","E01014140","Total",62,17,17,28,11,0,6,5,51,17,11,23
"2011","Telford and Wrekin 008A","E01014205","Total",12,4,5,3,1,0,1,0,11,4,4,3
"2011","Telford and Wrekin 008B","E01014206","Total",54,8,17,29,7,1,3,3,47,7,14,26
"2011","Telford and Wrekin 008C","E01014207","Total",29,13,9,7,1,0,1,0,28,13,8,7
"2011","Telford and Wrekin 008D","E01014208","Total",54,13,13,28,3,0,3,0,51,13,10,28
"2011","Telford and Wrekin 008E","E01014209","Total",40,12,18,10,1,0,1,0,39,12,17,10
"2011","Telford and Wrekin 009A","E01014137","Total",32,12,15,5,7,1,6,0,25,11,9,5
"2011","Telford and Wrekin 009B","E01014139","Total",34,14,6,14,4,0,1,3,30,14,5,11
"2011","Telford and Wrekin 009C","E01014141","Total",131,42,37,52,16,4,9,3,115,38,28,49
"2011","Telford and Wrekin 009D","E01014142","Total",65,14,14,37,6,0,2,4,59,14,12,33
"2011","Telford and Wrekin 009E","E01014143","Total",63,21,17,25,8,3,0,5,55,18,17,20
"2011","Telford and Wrekin 010A","E01014136","Total",18,6,7,5,2,0,1,1,16,6,6,4
"2011","Telford and Wrekin 010B","E01014148","Total",27,6,12,9,8,1,4,3,19,5,8,6
"2011","Telford and Wrekin 010C","E01014149","Total",18,8,3,7,3,1,2,0,15,7,1,7
"2011","Telford and Wrekin 010D","E01014202","Total",38,8,12,18,8,1,5,2,30,7,7,16
"2011","Telford and Wrekin 010E","E01014203","Total",24,9,10,5,3,2,1,0,21,7,9,5
"2011","Telford and Wrekin 010F","E01014204","Total",36,16,11,9,1,0,1,0,35,16,10,9
"2011","Telford and Wrekin 011A","E01014104","Total",52,13,16,23,9,0,6,3,43,13,10,20
"2011","Telford and Wrekin 011B","E01014105","Total",82,26,10,46,6,2,2,2,76,24,8,44
"2011","Telford and Wrekin 011C","E01014113","Total",43,12,7,24,6,3,1,2,37,9,6,22
"2011","Telford and Wrekin 011D","E01014114","Total",19,5,11,3,2,0,2,0,17,5,9,3
"2011","Telford and Wrekin 012A","E01014133","Total",50,14,19,17,6,0,6,0,44,14,13,17
"2011","Telford and Wrekin 012B","E01014134","Total",13,5,5,3,3,0,2,1,10,5,3,2
"2011","Telford and Wrekin 012C","E01014144","Total",61,13,12,36,8,0,3,5,53,13,9,31
"2011","Telford and Wrekin 012D","E01014145","Total",66,21,20,25,12,0,7,5,54,21,13,20
"2011","Telford and Wrekin 013A","E01014185","Total",71,21,25,25,13,0,7,6,58,21,18,19
"2011","Telford and Wrekin 013B","E01014186","Total",58,21,17,20,6,3,3,0,52,18,14,20
"2011","Telford and Wrekin 013C","E01014187","Total",42,11,12,19,4,0,4,0,38,11,8,19
"2011","Telford and Wrekin 013D","E01014188","Total",38,17,16,5,1,0,1,0,37,17,15,5
"2011","Telford and Wrekin 014A","E01014150","Total",32,10,18,4,5,0,5,0,27,10,13,4
"2011","Telford and Wrekin 014B","E01014151","Total",56,18,7,31,5,0,0,5,51,18,7,26
"2011","Telford and Wrekin 014C","E01014152","Total",58,25,8,25,5,2,1,2,53,23,7,23
"2011","Telford and Wrekin 014D","E01014153","Total",53,17,12,24,7,1,3,3,46,16,9,21
"2011","Telford and Wrekin 014E","E01014154","Total",36,11,11,14,6,0,5,1,30,11,6,13
"2011","Telford and Wrekin 014F","E01014155","Total",57,12,16,29,8,0,6,2,49,12,10,27
"2011","Telford and Wrekin 015A","E01014181","Total",40,12,18,10,6,0,6,0,34,12,12,10
"2011","Telford and Wrekin 015B","E01014182","Total",23,4,15,4,7,0,4,3,16,4,11,1
"2011","Telford and Wrekin 015C","E01014183","Total",19,6,8,5,2,1,0,1,17,5,8,4
"2011","Telford and Wrekin 015D","E01014184","Total",38,8,12,18,4,0,4,0,34,8,8,18
"2011","Telford and Wrekin 016A","E01014146","Total",55,25,17,13,4,0,3,1,51,25,14,12
"2011","Telford and Wrekin 016B","E01014147","Total",61,19,27,15,4,0,3,1,57,19,24,14
"2011","Telford and Wrekin 016C","E01014156","Total",91,22,25,44,7,0,3,4,84,22,22,40
"2011","Telford and Wrekin 016D","E01014157","Total",23,6,10,7,3,0,3,0,20,6,7,7
"2011","Telford and Wrekin 016E","E01014158","Total",45,13,15,17,8,0,6,2,37,13,9,15
"2011","Telford and Wrekin 017A","E01014124","Total",71,17,8,46,6,3,2,1,65,14,6,45
"2011","Telford and Wrekin 017B","E01014163","Total",83,17,11,55,10,0,4,6,73,17,7,49
"2011","Telford and Wrekin 017C","E01014164","Total",102,28,10,64,13,1,2,10,89,27,8,54
"2011","Telford and Wrekin 017D","E01014165","Total",76,22,10,44,4,0,0,4,72,22,10,40
"2011","Telford and Wrekin 017E","E01014166","Total",44,11,12,21,6,0,3,3,38,11,9,18
"2011","Telford and Wrekin 018A","E01014191","Total",78,17,27,34,15,0,12,3,63,17,15,31
"2011","Telford and Wrekin 018B","E01014192","Total",55,11,14,30,2,1,1,0,53,10,13,30
"2011","Telford and Wrekin 018C","E01014193","Total",82,24,12,46,7,0,4,3,75,24,8,43
"2011","Telford and Wrekin 018D","E01014194","Total",76,18,17,41,12,0,5,7,64,18,12,34
"2011","Telford and Wrekin 018E","E01014195","Total",28,9,14,5,7,1,3,3,21,8,11,2
"2011","Telford and Wrekin 018F","E01014196","Total",67,21,9,37,9,3,2,4,58,18,7,33
"2011","Telford and Wrekin 019A","E01014119","Total",30,10,7,13,2,0,2,0,28,10,5,13
"2011","Telford and Wrekin 019B","E01014120","Total",77,23,17,37,11,2,6,3,66,21,11,34
"2011","Telford and Wrekin 019C","E01014121","Total",44,16,17,11,9,2,5,2,35,14,12,9
"2011","Telford and Wrekin 019D","E01014122","Total",73,27,16,30,8,0,5,3,65,27,11,27
"2011","Telford and Wrekin 019E","E01014123","Total",40,18,15,7,6,1,3,2,34,17,12,5
"2011","Telford and Wrekin 020A","E01014106","Total",62,20,17,25,5,2,2,1,57,18,15,24
"2011","Telford and Wrekin 020B","E01014107","Total",15,5,8,2,1,0,1,0,14,5,7,2
"2011","Telford and Wrekin 020C","E01014108","Total",94,14,19,61,24,1,10,13,70,13,9,48
"2011","Telford and Wrekin 020D","E01014109","Total",53,13,9,31,5,0,3,2,48,13,6,29
"2011","Telford and Wrekin 020E","E01014110","Total",110,28,12,70,8,1,4,3,102,27,8,67
"2011","Telford and Wrekin 021A","E01014197","Total",90,19,9,62,10,0,2,8,80,19,7,54
"2011","Telford and Wrekin 021B","E01014198","Total",82,16,15,51,12,1,9,2,70,15,6,49
"2011","Telford and Wrekin 021C","E01014199","Total",108,29,20,59,6,0,4,2,102,29,16,57
"2011","Telford and Wrekin 021D","E01014200","Total",99,19,13,67,13,1,3,9,86,18,10,58
"2011","Telford and Wrekin 021E","E01014201","Total",103,27,13,63,12,2,3,7,91,25,10,56
"2011","Telford and Wrekin 022A","E01014159","Total",39,13,8,18,4,0,1,3,35,13,7,15
"2011","Telford and Wrekin 022B","E01014160","Total",26,6,4,16,2,0,1,1,24,6,3,15
"2011","Telford and Wrekin 022C","E01014161","Total",38,11,10,17,3,0,1,2,35,11,9,15
"2011","Telford and Wrekin 022D","E01014162","Total",45,21,8,16,4,0,2,2,41,21,6,14
"2011","Telford and Wrekin 023A","E01014115","Total",53,13,16,24,8,0,6,2,45,13,10,22
"2011","Telford and Wrekin 023B","E01014116","Total",85,17,15,53,14,2,6,6,71,15,9,47
"2011","Telford and Wrekin 023C","E01014117","Total",25,8,6,11,1,0,1,0,24,8,5,11
"2011","Telford and Wrekin 023D","E01014118","Total",80,21,11,48,9,3,3,3,71,18,8,45
"2011","Cannock Chase 001A","E01029368","Total",14,6,8,0,4,0,4,0,10,6,4,0
"2011","Cannock Chase 001B","E01029369","Total",30,12,12,6,5,0,2,3,25,12,10,3
"2011","Cannock Chase 001C","E01029370","Total",13,3,7,3,4,0,3,1,9,3,4,2
"2011","Cannock Chase 001D","E01029371","Total",44,16,15,13,5,1,2,2,39,15,13,11
"2011","Cannock Chase 001E","E01029402","Total",27,13,7,7,1,0,1,0,26,13,6,7
"2011","Cannock Chase 002A","E01029372","Total",63,28,7,28,4,0,1,3,59,28,6,25
"2011","Cannock Chase 002B","E01029373","Total",58,22,10,26,6,1,4,1,52,21,6,25
"2011","Cannock Chase 002C","E01029401","Total",47,25,10,12,3,1,2,0,44,24,8,12
"2011","Cannock Chase 002D","E01029403","Total",39,20,6,13,1,0,1,0,38,20,5,13
"2011","Cannock Chase 002E","E01029404","Total",52,16,10,26,3,1,2,0,49,15,8,26
"2011","Cannock Chase 003A","E01029345","Total",53,19,15,19,7,0,4,3,46,19,11,16
"2011","Cannock Chase 003B","E01029346","Total",96,42,11,43,5,0,2,3,91,42,9,40
"2011","Cannock Chase 003C","E01029347","Total",13,6,3,4,2,0,2,0,11,6,1,4
"2011","Cannock Chase 003D","E01029348","Total",41,21,7,13,1,0,1,0,40,21,6,13
"2011","Cannock Chase 003E","E01029374","Total",92,33,27,32,11,0,8,3,81,33,19,29
"2011","Cannock Chase 004A","E01029383","Total",35,13,10,12,5,0,4,1,30,13,6,11
"2011","Cannock Chase 004B","E01029385","Total",25,9,8,8,2,0,2,0,23,9,6,8
"2011","Cannock Chase 004C","E01029388","Total",47,20,12,15,8,0,6,2,39,20,6,13
"2011","Cannock Chase 004D","E01029390","Total",47,13,8,26,6,0,2,4,41,13,6,22
"2011","Cannock Chase 005A","E01029384","Total",41,19,11,11,4,0,3,1,37,19,8,10
"2011","Cannock Chase 005B","E01029386","Total",52,13,13,26,6,0,5,1,46,13,8,25
"2011","Cannock Chase 005C","E01029387","Total",37,11,8,18,2,1,1,0,35,10,7,18
"2011","Cannock Chase 005D","E01029389","Total",46,16,17,13,4,0,3,1,42,16,14,12
"2011","Cannock Chase 006A","E01029379","Total",45,15,19,11,7,2,3,2,38,13,16,9
"2011","Cannock Chase 006B","E01029398","Total",31,10,8,13,3,0,2,1,28,10,6,12
"2011","Cannock Chase 006C","E01029399","Total",30,11,6,13,3,1,0,2,27,10,6,11
"2011","Cannock Chase 006D","E01029400","Total",32,9,5,18,1,0,1,0,31,9,4,18
"2011","Cannock Chase 007A","E01029354","Total",45,18,11,16,6,0,3,3,39,18,8,13
"2011","Cannock Chase 007B","E01029355","Total",52,15,12,25,7,0,6,1,45,15,6,24
"2011","Cannock Chase 007C","E01029356","Total",63,21,12,30,9,3,5,1,54,18,7,29
"2011","Cannock Chase 007D","E01029357","Total",40,9,8,23,5,0,3,2,35,9,5,21
"2011","Cannock Chase 007E","E01029358","Total",68,20,6,42,7,1,3,3,61,19,3,39
"2011","Cannock Chase 008A","E01029349","Total",45,17,7,21,5,1,3,1,40,16,4,20
"2011","Cannock Chase 008B","E01029350","Total",54,20,11,23,4,1,2,1,50,19,9,22
"2011","Cannock Chase 008C","E01029351","Total",86,22,10,54,7,1,1,5,79,21,9,49
"2011","Cannock Chase 008D","E01029352","Total",34,7,11,16,3,0,2,1,31,7,9,15
"2011","Cannock Chase 008E","E01029393","Total",36,21,9,6,7,2,5,0,29,19,4,6
"2011","Cannock Chase 009A","E01029380","Total",27,14,5,8,0,0,0,0,27,14,5,8
"2011","Cannock Chase 009B","E01029381","Total",41,14,10,17,3,0,2,1,38,14,8,16
"2011","Cannock Chase 009C","E01029382","Total",38,11,16,11,6,1,5,0,32,10,11,11
"2011","Cannock Chase 009D","E01029391","Total",25,9,9,7,2,0,1,1,23,9,8,6
"2011","Cannock Chase 009E","E01029392","Total",41,16,17,8,6,0,5,1,35,16,12,7
"2011","Cannock Chase 010A","E01029375","Total",44,15,14,15,4,0,2,2,40,15,12,13
"2011","Cannock Chase 010B","E01029376","Total",64,28,14,22,7,2,3,2,57,26,11,20
"2011","Cannock Chase 010C","E01029377","Total",30,13,13,4,2,0,2,0,28,13,11,4
"2011","Cannock Chase 010D","E01029378","Total",37,14,13,10,3,0,1,2,34,14,12,8
"2011","Cannock Chase 011A","E01029353","Total",31,10,10,11,1,0,1,0,30,10,9,11
"2011","Cannock Chase 011B","E01029364","Total",23,17,2,4,3,1,0,2,20,16,2,2
"2011","Cannock Chase 011C","E01029365","Total",27,9,11,7,4,2,2,0,23,7,9,7
"2011","Cannock Chase 011D","E01029366","Total",17,9,4,4,1,0,0,1,16,9,4,3
"2011","Cannock Chase 011E","E01029367","Total",53,19,15,19,3,1,1,1,50,18,14,18
"2011","Cannock Chase 012A","E01029359","Total",62,20,11,31,6,3,3,0,56,17,8,31
"2011","Cannock Chase 012B","E01029360","Total",53,17,10,26,7,0,2,5,46,17,8,21
"2011","Cannock Chase 012C","E01029361","Total",43,12,7,24,8,1,3,4,35,11,4,20
"2011","Cannock Chase 012D","E01029362","Total",99,35,13,51,8,1,1,6,91,34,12,45
"2011","Cannock Chase 012E","E01029363","Total",24,8,5,11,1,0,1,0,23,8,4,11
"2011","Cannock Chase 013A","E01029394","Total",24,8,7,9,6,0,3,3,18,8,4,6
"2011","Cannock Chase 013B","E01029395","Total",29,13,8,8,5,2,1,2,24,11,7,6
"2011","Cannock Chase 013C","E01029396","Total",37,12,10,15,5,0,3,2,32,12,7,13
"2011","Cannock Chase 013D","E01029397","Total",107,27,34,46,10,0,8,2,97,27,26,44
"2011","East Staffordshire 001A","E01029405","Total",14,6,4,4,1,0,1,0,13,6,3,4
"2011","East Staffordshire 001B","E01029406","Total",8,1,5,2,3,1,2,0,5,0,3,2
"2011","East Staffordshire 001C","E01029422","Total",17,9,5,3,0,0,0,0,17,9,5,3
"2011","East Staffordshire 001D","E01029423","Total",56,16,12,28,5,0,2,3,51,16,10,25
"2011","East Staffordshire 001E","E01029467","Total",37,13,16,8,4,0,4,0,33,13,12,8
"2011","East Staffordshire 002A","E01029430","Total",25,9,10,6,2,0,1,1,23,9,9,5
"2011","East Staffordshire 002B","E01029431","Total",71,26,20,25,7,0,6,1,64,26,14,24
"2011","East Staffordshire 002C","E01029432","Total",41,19,15,7,5,0,3,2,36,19,12,5
"2011","East Staffordshire 002D","E01029433","Total",47,20,6,21,5,1,3,1,42,19,3,20
"2011","East Staffordshire 003A","E01029459","Total",34,13,12,9,6,2,4,0,28,11,8,9
"2011","East Staffordshire 003B","E01029460","Total",30,11,12,7,5,0,5,0,25,11,7,7
"2011","East Staffordshire 003C","E01029461","Total",51,14,26,11,5,0,5,0,46,14,21,11
"2011","East Staffordshire 003D","E01029462","Total",37,13,14,10,1,1,0,0,36,12,14,10
"2011","East Staffordshire 004A","E01029443","Total",20,10,10,0,4,0,4,0,16,10,6,0
"2011","East Staffordshire 004B","E01029444","Total",26,9,10,7,3,0,3,0,23,9,7,7
"2011","East Staffordshire 004C","E01029463","Total",18,8,7,3,4,1,2,1,14,7,5,2
"2011","East Staffordshire 004D","E01029464","Total",42,14,8,20,3,0,2,1,39,14,6,19
"2011","East Staffordshire 004E","E01029465","Total",35,12,12,11,5,0,4,1,30,12,8,10
"2011","East Staffordshire 004F","E01029466","Total",25,8,9,8,4,0,4,0,21,8,5,8
"2011","East Staffordshire 005A","E01029454","Total",19,7,9,3,1,0,1,0,18,7,8,3
"2011","East Staffordshire 005B","E01029455","Total",33,14,15,4,4,0,4,0,29,14,11,4
"2011","East Staffordshire 005C","E01029456","Total",39,13,11,15,3,0,1,2,36,13,10,13
"2011","East Staffordshire 005D","E01029457","Total",40,21,17,2,4,0,4,0,36,21,13,2
"2011","East Staffordshire 005E","E01029458","Total",30,11,10,9,1,0,1,0,29,11,9,9
"2011","East Staffordshire 006A","E01029411","Total",19,9,6,4,3,0,3,0,16,9,3,4
"2011","East Staffordshire 006B","E01029412","Total",18,7,9,2,3,2,1,0,15,5,8,2
"2011","East Staffordshire 006C","E01029424","Total",11,6,3,2,0,0,0,0,11,6,3,2
"2011","East Staffordshire 006D","E01029425","Total",23,10,10,3,1,0,1,0,22,10,9,3
"2011","East Staffordshire 006E","E01029473","Total",17,7,8,2,6,0,5,1,11,7,3,1
"2011","East Staffordshire 006F","E01029474","Total",14,9,5,0,3,1,2,0,11,8,3,0
"2011","East Staffordshire 007A","E01029434","Total",75,27,17,31,4,1,2,1,71,26,15,30
"2011","East Staffordshire 007B","E01029435","Total",30,10,11,9,0,0,0,0,30,10,11,9
"2011","East Staffordshire 007C","E01029436","Total",88,31,19,38,7,1,5,1,81,30,14,37
"2011","East Staffordshire 007D","E01029437","Total",119,50,18,51,14,3,3,8,105,47,15,43
"2011","East Staffordshire 007E","E01029438","Total",45,19,14,12,7,0,7,0,38,19,7,12
"2011","East Staffordshire 008A","E01029426","Total",66,17,13,36,2,1,1,0,64,16,12,36
"2011","East Staffordshire 008B","E01029427","Total",66,13,16,37,10,2,3,5,56,11,13,32
"2011","East Staffordshire 008C","E01029428","Total",59,24,13,22,5,1,2,2,54,23,11,20
"2011","East Staffordshire 008D","E01029429","Total",48,18,7,23,1,0,1,0,47,18,6,23
"2011","East Staffordshire 009A","E01029445","Total",79,22,13,44,6,0,1,5,73,22,12,39
"2011","East Staffordshire 009B","E01029446","Total",51,17,18,16,4,0,4,0,47,17,14,16
"2011","East Staffordshire 009C","E01029447","Total",51,18,10,23,4,2,1,1,47,16,9,22
"2011","East Staffordshire 009D","E01029448","Total",50,16,11,23,6,1,2,3,44,15,9,20
"2011","East Staffordshire 010A","E01029468","Total",93,28,18,47,7,2,2,3,86,26,16,44
"2011","East Staffordshire 010B","E01029469","Total",38,9,13,16,4,0,4,0,34,9,9,16
"2011","East Staffordshire 010C","E01029470","Total",61,23,10,28,4,1,1,2,57,22,9,26
"2011","East Staffordshire 010D","E01029471","Total",23,10,8,5,3,1,2,0,20,9,6,5
"2011","East Staffordshire 010E","E01029472","Total",67,17,10,40,4,0,1,3,63,17,9,37
"2011","East Staffordshire 011A","E01029407","Total",70,16,17,37,7,0,6,1,63,16,11,36
"2011","East Staffordshire 011B","E01029408","Total",83,15,25,43,9,0,8,1,74,15,17,42
"2011","East Staffordshire 011C","E01029409","Total",50,16,6,28,5,0,3,2,45,16,3,26
"2011","East Staffordshire 011D","E01029410","Total",44,14,7,23,5,1,3,1,39,13,4,22
"2011","East Staffordshire 011F","E01032896","Total",34,11,8,15,4,2,2,0,30,9,6,15
"2011","East Staffordshire 011G","E01032897","Total",26,8,8,10,3,0,3,0,23,8,5,10
"2011","East Staffordshire 011H","E01032898","Total",48,13,10,25,3,0,2,1,45,13,8,24
"2011","East Staffordshire 012A","E01029418","Total",24,8,13,3,1,0,1,0,23,8,12,3
"2011","East Staffordshire 012B","E01029419","Total",36,14,18,4,7,0,7,0,29,14,11,4
"2011","East Staffordshire 012C","E01029420","Total",34,18,10,6,2,0,1,1,32,18,9,5
"2011","East Staffordshire 013A","E01029413","Total",41,12,18,11,9,1,7,1,32,11,11,10
"2011","East Staffordshire 013B","E01029414","Total",36,12,16,8,7,3,4,0,29,9,12,8
"2011","East Staffordshire 013C","E01029415","Total",47,21,18,8,3,0,1,2,44,21,17,6
"2011","East Staffordshire 013D","E01029416","Total",23,12,5,6,2,1,1,0,21,11,4,6
"2011","East Staffordshire 013E","E01029417","Total",30,10,9,11,4,0,2,2,26,10,7,9
"2011","East Staffordshire 014A","E01029449","Total",44,18,9,17,4,0,2,2,40,18,7,15
"2011","East Staffordshire 014B","E01029450","Total",61,23,13,25,7,0,3,4,54,23,10,21
"2011","East Staffordshire 014C","E01029451","Total",57,23,15,19,7,1,4,2,50,22,11,17
"2011","East Staffordshire 014D","E01029452","Total",71,20,21,30,12,0,7,5,59,20,14,25
"2011","East Staffordshire 014E","E01029453","Total",77,32,13,32,4,2,1,1,73,30,12,31
"2011","East Staffordshire 015A","E01029439","Total",31,13,11,7,3,0,3,0,28,13,8,7
"2011","East Staffordshire 015B","E01029440","Total",13,6,6,1,3,1,2,0,10,5,4,1
"2011","East Staffordshire 015C","E01029441","Total",39,16,18,5,5,0,5,0,34,16,13,5
"2011","East Staffordshire 015D","E01029442","Total",21,7,6,8,3,0,2,1,18,7,4,7
"2011","Lichfield 001A","E01029480","Total",40,11,20,9,4,0,3,1,36,11,17,8
"2011","Lichfield 001B","E01029481","Total",30,13,8,9,2,0,1,1,28,13,7,8
"2011","Lichfield 001C","E01029482","Total",45,17,14,14,1,0,1,0,44,17,13,14
"2011","Lichfield 001D","E01029498","Total",22,12,5,5,6,2,1,3,16,10,4,2
"2011","Lichfield 002A","E01029477","Total",17,7,10,0,3,1,2,0,14,6,8,0
"2011","Lichfield 002B","E01029478","Total",29,9,14,6,7,0,6,1,22,9,8,5
"2011","Lichfield 002C","E01029479","Total",59,24,20,15,4,0,3,1,55,24,17,14
"2011","Lichfield 002D","E01029509","Total",16,8,4,4,1,0,1,0,15,8,3,4
"2011","Lichfield 003A","E01029486","Total",14,7,3,4,3,0,0,3,11,7,3,1
"2011","Lichfield 003B","E01029507","Total",12,5,5,2,4,1,3,0,8,4,2,2
"2011","Lichfield 003C","E01029508","Total",35,15,14,6,4,0,3,1,31,15,11,5
"2011","Lichfield 003D","E01029515","Total",13,6,4,3,0,0,0,0,13,6,4,3
"2011","Lichfield 004A","E01029492","Total",128,46,16,66,6,0,2,4,122,46,14,62
"2011","Lichfield 004B","E01029499","Total",61,15,10,36,7,1,1,5,54,14,9,31
"2011","Lichfield 004C","E01029501","Total",43,14,8,21,2,0,1,1,41,14,7,20
"2011","Lichfield 004E","E01029526","Total",39,6,11,22,2,0,1,1,37,6,10,21
"2011","Lichfield 004F","E01032899","Total",24,7,10,7,5,1,3,1,19,6,7,6
"2011","Lichfield 004G","E01032900","Total",67,20,19,28,4,0,3,1,63,20,16,27
"2011","Lichfield 005A","E01029483","Total",8,3,4,1,1,0,0,1,7,3,4,0
"2011","Lichfield 005B","E01029484","Total",38,10,17,11,8,1,7,0,30,9,10,11
"2011","Lichfield 005C","E01029485","Total",28,10,14,4,0,0,0,0,28,10,14,4
"2011","Lichfield 005D","E01029500","Total",29,10,11,8,5,0,4,1,24,10,7,7
"2011","Lichfield 005E","E01029520","Total",10,5,4,1,3,1,2,0,7,4,2,1
"2011","Lichfield 005F","E01029524","Total",41,10,10,21,2,0,2,0,39,10,8,21
"2011","Lichfield 005G","E01029525","Total",29,15,5,9,2,0,1,1,27,15,4,8
"2011","Lichfield 006A","E01029487","Total",60,27,10,23,5,2,2,1,55,25,8,22
"2011","Lichfield 006B","E01029493","Total",42,20,13,9,1,0,1,0,41,20,12,9
"2011","Lichfield 006C","E01029494","Total",33,9,13,11,4,0,4,0,29,9,9,11
"2011","Lichfield 006D","E01029495","Total",32,13,13,6,3,0,3,0,29,13,10,6
"2011","Lichfield 006E","E01029497","Total",48,14,13,21,7,1,5,1,41,13,8,20
"2011","Lichfield 007A","E01029491","Total",50,17,11,22,6,1,3,2,44,16,8,20
"2011","Lichfield 007B","E01029511","Total",21,7,8,6,1,0,1,0,20,7,7,6
"2011","Lichfield 007C","E01029512","Total",40,17,10,13,4,2,1,1,36,15,9,12
"2011","Lichfield 007D","E01029518","Total",48,16,19,13,4,1,3,0,44,15,16,13
"2011","Lichfield 007E","E01029519","Total",57,21,18,18,9,1,4,4,48,20,14,14
"2011","Lichfield 008A","E01029516","Total",26,9,11,6,3,0,3,0,23,9,8,6
"2011","Lichfield 008B","E01029517","Total",17,6,5,6,3,0,3,0,14,6,2,6
"2011","Lichfield 008C","E01029530","Total",46,9,20,17,6,0,5,1,40,9,15,16
"2011","Lichfield 008D","E01029531","Total",23,8,11,4,5,0,5,0,18,8,6,4
"2011","Lichfield 009A","E01029475","Total",27,9,11,7,4,0,2,2,23,9,9,5
"2011","Lichfield 009B","E01029476","Total",16,5,8,3,1,0,1,0,15,5,7,3
"2011","Lichfield 009C","E01029489","Total",27,12,14,1,6,0,6,0,21,12,8,1
"2011","Lichfield 009D","E01029490","Total",29,10,15,4,1,0,1,0,28,10,14,4
"2011","Lichfield 009E","E01029505","Total",23,8,12,3,9,0,9,0,14,8,3,3
"2011","Lichfield 009F","E01029506","Total",11,6,3,2,0,0,0,0,11,6,3,2
"2011","Lichfield 010A","E01029496","Total",82,32,13,37,10,5,2,3,72,27,11,34
"2011","Lichfield 010B","E01029527","Total",45,19,6,20,2,0,1,1,43,19,5,19
"2011","Lichfield 010C","E01029528","Total",37,16,8,13,6,1,3,2,31,15,5,11
"2011","Lichfield 010D","E01029529","Total",33,11,8,14,4,2,1,1,29,9,7,13
"2011","Lichfield 011A","E01029513","Total",10,3,6,1,4,0,4,0,6,3,2,1
"2011","Lichfield 011B","E01029514","Total",14,5,4,5,2,0,1,1,12,5,3,4
"2011","Lichfield 011C","E01029521","Total",15,6,8,1,1,0,1,0,14,6,7,1
"2011","Lichfield 011D","E01029522","Total",29,9,12,8,3,0,2,1,26,9,10,7
"2011","Lichfield 011E","E01029523","Total",31,16,10,5,3,0,3,0,28,16,7,5
"2011","Lichfield 012A","E01029488","Total",33,6,18,9,8,0,8,0,25,6,10,9
"2011","Lichfield 012B","E01029502","Total",33,10,6,17,4,3,1,0,29,7,5,17
"2011","Lichfield 012C","E01029503","Total",37,13,11,13,5,1,2,2,32,12,9,11
"2011","Lichfield 012D","E01029504","Total",52,16,14,22,8,2,2,4,44,14,12,18
"2011","Newcastle-under-Lyme 001A","E01029562","Total",31,9,17,5,2,0,2,0,29,9,15,5
"2011","Newcastle-under-Lyme 001B","E01029565","Total",22,6,9,7,4,0,4,0,18,6,5,7
"2011","Newcastle-under-Lyme 001C","E01029581","Total",25,7,11,7,4,0,3,1,21,7,8,6
"2011","Newcastle-under-Lyme 001D","E01029582","Total",40,8,17,15,7,0,4,3,33,8,13,12
"2011","Newcastle-under-Lyme 001E","E01029586","Total",13,7,4,2,2,1,1,0,11,6,3,2
"2011","Newcastle-under-Lyme 001F","E01029587","Total",26,8,12,6,7,0,6,1,19,8,6,5
"2011","Newcastle-under-Lyme 002A","E01029561","Total",76,29,16,31,6,1,2,3,70,28,14,28
"2011","Newcastle-under-Lyme 002B","E01029563","Total",27,13,8,6,2,0,1,1,25,13,7,5
"2011","Newcastle-under-Lyme 002C","E01029564","Total",62,25,14,23,5,0,3,2,57,25,11,21
"2011","Newcastle-under-Lyme 002D","E01029588","Total",37,13,13,11,4,1,2,1,33,12,11,10
"2011","Newcastle-under-Lyme 003A","E01029540","Total",27,9,10,8,1,0,1,0,26,9,9,8
"2011","Newcastle-under-Lyme 003B","E01029541","Total",72,17,24,31,4,0,2,2,68,17,22,29
"2011","Newcastle-under-Lyme 003C","E01029542","Total",36,10,13,13,2,0,2,0,34,10,11,13
"2011","Newcastle-under-Lyme 003D","E01029543","Total",37,13,9,15,2,0,1,1,35,13,8,14
"2011","Newcastle-under-Lyme 003E","E01029595","Total",15,3,6,6,1,0,1,0,14,3,5,6
"2011","Newcastle-under-Lyme 003F","E01029597","Total",50,20,11,19,3,0,2,1,47,20,9,18
"2011","Newcastle-under-Lyme 004A","E01029536","Total",20,8,11,1,3,0,3,0,17,8,8,1
"2011","Newcastle-under-Lyme 004B","E01029544","Total",19,7,9,3,5,2,3,0,14,5,6,3
"2011","Newcastle-under-Lyme 004C","E01029545","Total",39,12,17,10,4,0,4,0,35,12,13,10
"2011","Newcastle-under-Lyme 004D","E01029546","Total",24,10,11,3,7,3,3,1,17,7,8,2
"2011","Newcastle-under-Lyme 004E","E01029596","Total",17,9,3,5,3,0,3,0,14,9,0,5
"2011","Newcastle-under-Lyme 005A","E01029532","Total",22,7,11,4,2,0,2,0,20,7,9,4
"2011","Newcastle-under-Lyme 005B","E01029533","Total",25,7,10,8,3,0,2,1,22,7,8,7
"2011","Newcastle-under-Lyme 005C","E01029534","Total",30,8,17,5,7,0,7,0,23,8,10,5
"2011","Newcastle-under-Lyme 005D","E01029535","Total",63,16,23,24,8,1,5,2,55,15,18,22
"2011","Newcastle-under-Lyme 005E","E01029556","Total",66,23,27,16,9,2,5,2,57,21,22,14
"2011","Newcastle-under-Lyme 006A","E01029537","Total",59,20,16,23,8,1,4,3,51,19,12,20
"2011","Newcastle-under-Lyme 006B","E01029538","Total",43,13,10,20,6,2,3,1,37,11,7,19
"2011","Newcastle-under-Lyme 006C","E01029539","Total",32,11,9,12,4,0,3,1,28,11,6,11
"2011","Newcastle-under-Lyme 006D","E01029552","Total",41,21,7,13,4,0,3,1,37,21,4,12
"2011","Newcastle-under-Lyme 006E","E01029558","Total",84,29,19,36,7,1,2,4,77,28,17,32
"2011","Newcastle-under-Lyme 007A","E01029547","Total",80,26,15,39,6,1,3,2,74,25,12,37
"2011","Newcastle-under-Lyme 007B","E01029548","Total",78,22,9,47,6,0,2,4,72,22,7,43
"2011","Newcastle-under-Lyme 007C","E01029559","Total",43,15,13,15,6,1,4,1,37,14,9,14
"2011","Newcastle-under-Lyme 007D","E01029560","Total",94,31,19,44,7,1,3,3,87,30,16,41
"2011","Newcastle-under-Lyme 007E","E01029568","Total",47,14,12,21,6,0,5,1,41,14,7,20
"2011","Newcastle-under-Lyme 008A","E01029583","Total",35,13,11,11,4,2,1,1,31,11,10,10
"2011","Newcastle-under-Lyme 008B","E01029584","Total",21,6,11,4,1,0,1,0,20,6,10,4
"2011","Newcastle-under-Lyme 008C","E01029585","Total",48,18,21,9,4,0,4,0,44,18,17,9
"2011","Newcastle-under-Lyme 008D","E01029609","Total",68,17,23,28,9,1,7,1,59,16,16,27
"2011","Newcastle-under-Lyme 008E","E01029611","Total",65,25,17,23,9,3,3,3,56,22,14,20
"2011","Newcastle-under-Lyme 009A","E01029577","Total",34,14,13,7,1,0,1,0,33,14,12,7
"2011","Newcastle-under-Lyme 009B","E01029579","Total",46,16,23,7,2,0,2,0,44,16,21,7
"2011","Newcastle-under-Lyme 009C","E01029580","Total",35,11,18,6,7,1,5,1,28,10,13,5
"2011","Newcastle-under-Lyme 009D","E01029610","Total",26,10,12,4,4,0,4,0,22,10,8,4
"2011","Newcastle-under-Lyme 009E","E01029612","Total",22,12,9,1,1,0,1,0,21,12,8,1
"2011","Newcastle-under-Lyme 010A","E01029553","Total",74,25,19,30,6,0,4,2,68,25,15,28
"2011","Newcastle-under-Lyme 010B","E01029554","Total",42,11,9,22,6,0,2,4,36,11,7,18
"2011","Newcastle-under-Lyme 010C","E01029566","Total",83,30,12,41,9,2,4,3,74,28,8,38
"2011","Newcastle-under-Lyme 010D","E01029567","Total",44,17,14,13,4,0,2,2,40,17,12,11
"2011","Newcastle-under-Lyme 010E","E01029598","Total",92,30,20,42,5,0,3,2,87,30,17,40
"2011","Newcastle-under-Lyme 010F","E01029599","Total",41,17,14,10,4,1,3,0,37,16,11,10
"2011","Newcastle-under-Lyme 011A","E01029555","Total",56,17,14,25,4,0,2,2,52,17,12,23
"2011","Newcastle-under-Lyme 011B","E01029578","Total",24,6,10,8,2,0,2,0,22,6,8,8
"2011","Newcastle-under-Lyme 011C","E01029602","Total",49,18,18,13,5,1,1,3,44,17,17,10
"2011","Newcastle-under-Lyme 011D","E01029603","Total",43,9,9,25,15,1,1,13,28,8,8,12
"2011","Newcastle-under-Lyme 011E","E01029604","Total",51,15,24,12,6,0,5,1,45,15,19,11
"2011","Newcastle-under-Lyme 012A","E01029576","Total",21,6,12,3,1,1,0,0,20,5,12,3
"2011","Newcastle-under-Lyme 012B","E01029593","Total",71,26,13,32,8,0,4,4,63,26,9,28
"2011","Newcastle-under-Lyme 012C","E01029594","Total",52,22,12,18,2,0,1,1,50,22,11,17
"2011","Newcastle-under-Lyme 013A","E01029557","Total",16,5,6,5,7,1,4,2,9,4,2,3
"2011","Newcastle-under-Lyme 013B","E01029573","Total",21,7,5,9,3,1,1,1,18,6,4,8
"2011","Newcastle-under-Lyme 013C","E01029574","Total",20,5,4,11,2,0,0,2,18,5,4,9
"2011","Newcastle-under-Lyme 013D","E01029575","Total",33,11,11,11,3,0,1,2,30,11,10,9
"2011","Newcastle-under-Lyme 014A","E01029549","Total",44,15,13,16,2,1,1,0,42,14,12,16
"2011","Newcastle-under-Lyme 014B","E01029551","Total",29,9,9,11,2,1,0,1,27,8,9,10
"2011","Newcastle-under-Lyme 014C","E01029591","Total",76,31,21,24,6,0,5,1,70,31,16,23
"2011","Newcastle-under-Lyme 014D","E01029600","Total",21,6,14,1,7,0,7,0,14,6,7,1
"2011","Newcastle-under-Lyme 014E","E01029605","Total",21,13,7,1,2,1,1,0,19,12,6,1
"2011","Newcastle-under-Lyme 014F","E01029607","Total",45,16,15,14,2,1,1,0,43,15,14,14
"2011","Newcastle-under-Lyme 015B","E01029589","Total",14,3,8,3,5,0,4,1,9,3,4,2
"2011","Newcastle-under-Lyme 015C","E01029590","Total",33,8,12,13,2,0,1,1,31,8,11,12
"2011","Newcastle-under-Lyme 015E","E01029601","Total",18,5,12,1,4,0,4,0,14,5,8,1
"2011","Newcastle-under-Lyme 015F","E01029606","Total",24,10,11,3,5,0,4,1,19,10,7,2
"2011","Newcastle-under-Lyme 015G","E01029608","Total",13,8,4,1,0,0,0,0,13,8,4,1
"2011","Newcastle-under-Lyme 015H","E01033257","Total",72,31,34,7,8,0,5,3,64,31,29,4
"2011","Newcastle-under-Lyme 016A","E01029569","Total",17,6,4,7,0,0,0,0,17,6,4,7
"2011","Newcastle-under-Lyme 016B","E01029570","Total",24,11,9,4,1,0,1,0,23,11,8,4
"2011","Newcastle-under-Lyme 016C","E01029571","Total",27,8,9,10,6,1,3,2,21,7,6,8
"2011","Newcastle-under-Lyme 016D","E01029572","Total",17,3,8,6,1,0,1,0,16,3,7,6
"2011","South Staffordshire 001A","E01029655","Total",39,14,9,16,2,0,0,2,37,14,9,14
"2011","South Staffordshire 001B","E01029656","Total",13,4,8,1,3,0,3,0,10,4,5,1
"2011","South Staffordshire 001C","E01029657","Total",38,16,20,2,4,0,4,0,34,16,16,2
"2011","South Staffordshire 001D","E01029658","Total",37,13,13,11,5,1,2,2,32,12,11,9
"2011","South Staffordshire 001E","E01029659","Total",22,9,4,9,1,1,0,0,21,8,4,9
"2011","South Staffordshire 001F","E01029660","Total",46,19,18,9,8,1,4,3,38,18,14,6
"2011","South Staffordshire 002A","E01029621","Total",36,13,8,15,5,0,2,3,31,13,6,12
"2011","South Staffordshire 002B","E01029646","Total",38,15,10,13,4,0,3,1,34,15,7,12
"2011","South Staffordshire 002C","E01029647","Total",66,19,22,25,5,0,5,0,61,19,17,25
"2011","South Staffordshire 002D","E01029648","Total",48,11,10,27,1,0,1,0,47,11,9,27
"2011","South Staffordshire 003A","E01029617","Total",18,9,3,6,1,0,1,0,17,9,2,6
"2011","South Staffordshire 003B","E01029618","Total",49,16,18,15,4,0,4,0,45,16,14,15
"2011","South Staffordshire 003C","E01029668","Total",14,2,10,2,2,0,2,0,12,2,8,2
"2011","South Staffordshire 003D","E01029669","Total",45,13,15,17,5,0,2,3,40,13,13,14
"2011","South Staffordshire 003E","E01029670","Total",15,4,7,4,3,0,3,0,12,4,4,4
"2011","South Staffordshire 004A","E01029620","Total",36,15,11,10,3,0,2,1,33,15,9,9
"2011","South Staffordshire 004B","E01029622","Total",31,9,13,9,5,0,5,0,26,9,8,9
"2011","South Staffordshire 004C","E01029623","Total",33,10,9,14,4,1,3,0,29,9,6,14
"2011","South Staffordshire 004D","E01029624","Total",20,6,5,9,1,0,0,1,19,6,5,8
"2011","South Staffordshire 004E","E01029625","Total",21,14,5,2,1,0,1,0,20,14,4,2
"2011","South Staffordshire 004F","E01029641","Total",33,11,8,14,4,0,2,2,29,11,6,12
"2011","South Staffordshire 004G","E01029642","Total",25,7,9,9,2,0,1,1,23,7,8,8
"2011","South Staffordshire 005A","E01029638","Total",57,20,23,14,6,0,6,0,51,20,17,14
"2011","South Staffordshire 005B","E01029639","Total",28,7,12,9,1,0,1,0,27,7,11,9
"2011","South Staffordshire 005C","E01029640","Total",56,19,20,17,6,1,4,1,50,18,16,16
"2011","South Staffordshire 005D","E01029643","Total",51,19,10,22,0,0,0,0,51,19,10,22
"2011","South Staffordshire 005E","E01029644","Total",21,8,7,6,3,1,2,0,18,7,5,6
"2011","South Staffordshire 006A","E01029616","Total",19,9,5,5,5,1,1,3,14,8,4,2
"2011","South Staffordshire 006B","E01029619","Total",40,14,20,6,5,1,2,2,35,13,18,4
"2011","South Staffordshire 006C","E01029636","Total",25,9,10,6,3,0,3,0,22,9,7,6
"2011","South Staffordshire 006D","E01029637","Total",25,8,10,7,0,0,0,0,25,8,10,7
"2011","South Staffordshire 007A","E01029632","Total",18,6,9,3,1,0,1,0,17,6,8,3
"2011","South Staffordshire 007B","E01029633","Total",22,7,9,6,3,0,3,0,19,7,6,6
"2011","South Staffordshire 007C","E01029634","Total",50,15,14,21,4,0,2,2,46,15,12,19
"2011","South Staffordshire 007D","E01029635","Total",61,22,13,26,5,0,3,2,56,22,10,24
"2011","South Staffordshire 008A","E01029613","Total",22,9,7,6,3,0,2,1,19,9,5,5
"2011","South Staffordshire 008B","E01029614","Total",68,26,22,20,6,0,5,1,62,26,17,19
"2011","South Staffordshire 008C","E01029615","Total",65,23,17,25,4,0,3,1,61,23,14,24
"2011","South Staffordshire 008D","E01029627","Total",49,13,13,23,3,0,2,1,46,13,11,22
"2011","South Staffordshire 009A","E01029626","Total",27,8,13,6,2,0,2,0,25,8,11,6
"2011","South Staffordshire 009B","E01029628","Total",9,4,4,1,0,0,0,0,9,4,4,1
"2011","South Staffordshire 009C","E01029629","Total",13,7,5,1,1,0,1,0,12,7,4,1
"2011","South Staffordshire 009D","E01029630","Total",16,5,6,5,0,0,0,0,16,5,6,5
"2011","South Staffordshire 009E","E01029631","Total",20,4,12,4,3,0,2,1,17,4,10,3
"2011","South Staffordshire 010A","E01029654","Total",47,12,19,16,6,1,2,3,41,11,17,13
"2011","South Staffordshire 010B","E01029661","Total",40,15,15,10,3,0,2,1,37,15,13,9
"2011","South Staffordshire 010C","E01029663","Total",28,9,15,4,2,0,2,0,26,9,13,4
"2011","South Staffordshire 010D","E01029665","Total",47,17,18,12,8,0,6,2,39,17,12,10
"2011","South Staffordshire 011A","E01029662","Total",40,14,17,9,10,2,7,1,30,12,10,8
"2011","South Staffordshire 011B","E01029664","Total",47,17,20,10,6,1,5,0,41,16,15,10
"2011","South Staffordshire 011C","E01029666","Total",65,23,12,30,6,1,2,3,59,22,10,27
"2011","South Staffordshire 012A","E01029671","Total",29,14,8,7,4,0,4,0,25,14,4,7
"2011","South Staffordshire 012B","E01029673","Total",31,10,10,11,1,0,1,0,30,10,9,11
"2011","South Staffordshire 012C","E01029676","Total",25,9,14,2,1,0,1,0,24,9,13,2
"2011","South Staffordshire 012D","E01029679","Total",63,19,15,29,6,0,4,2,57,19,11,27
"2011","South Staffordshire 012E","E01029680","Total",44,16,20,8,3,2,1,0,41,14,19,8
"2011","South Staffordshire 013A","E01029645","Total",19,5,7,7,0,0,0,0,19,5,7,7
"2011","South Staffordshire 013B","E01029667","Total",26,8,13,5,5,0,4,1,21,8,9,4
"2011","South Staffordshire 013C","E01029672","Total",10,5,3,2,2,0,1,1,8,5,2,1
"2011","South Staffordshire 013D","E01029674","Total",19,7,11,1,3,0,3,0,16,7,8,1
"2011","South Staffordshire 013E","E01029675","Total",12,4,4,4,3,1,2,0,9,3,2,4
"2011","South Staffordshire 013F","E01029677","Total",22,9,9,4,3,0,3,0,19,9,6,4
"2011","South Staffordshire 013G","E01029678","Total",23,6,12,5,5,1,3,1,18,5,9,4
"2011","South Staffordshire 014A","E01029649","Total",30,11,11,8,4,2,2,0,26,9,9,8
"2011","South Staffordshire 014B","E01029650","Total",18,10,3,5,1,0,1,0,17,10,2,5
"2011","South Staffordshire 014C","E01029651","Total",19,10,6,3,2,0,2,0,17,10,4,3
"2011","South Staffordshire 014D","E01029652","Total",15,3,8,4,3,0,1,2,12,3,7,2
"2011","South Staffordshire 014E","E01029653","Total",41,16,14,11,5,1,3,1,36,15,11,10
"2011","Stafford 001A","E01029702","Total",33,12,11,10,2,0,1,1,31,12,10,9
"2011","Stafford 001B","E01029703","Total",14,3,5,6,1,0,0,1,13,3,5,5
"2011","Stafford 001C","E01029704","Total",16,5,6,5,3,0,3,0,13,5,3,5
"2011","Stafford 001D","E01029705","Total",24,9,10,5,1,0,0,1,23,9,10,4
"2011","Stafford 002A","E01029681","Total",24,8,9,7,4,0,1,3,20,8,8,4
"2011","Stafford 002B","E01029682","Total",17,3,6,8,4,1,1,2,13,2,5,6
"2011","Stafford 002C","E01029683","Total",21,6,9,6,3,0,3,0,18,6,6,6
"2011","Stafford 002D","E01029748","Total",21,10,9,2,2,0,2,0,19,10,7,2
"2011","Stafford 002E","E01029749","Total",32,14,13,5,4,0,3,1,28,14,10,4
"2011","Stafford 003A","E01029740","Total",59,20,13,26,3,0,1,2,56,20,12,24
"2011","Stafford 003B","E01029744","Total",53,24,19,10,5,0,4,1,48,24,15,9
"2011","Stafford 003C","E01029745","Total",40,13,14,13,5,0,4,1,35,13,10,12
"2011","Stafford 003D","E01029746","Total",50,23,12,15,5,2,0,3,45,21,12,12
"2011","Stafford 003E","E01029753","Total",28,7,12,9,2,0,2,0,26,7,10,9
"2011","Stafford 003F","E01029756","Total",52,22,20,10,4,0,4,0,48,22,16,10
"2011","Stafford 004A","E01029733","Total",18,6,8,4,6,1,4,1,12,5,4,3
"2011","Stafford 004B","E01029739","Total",25,12,10,3,2,0,2,0,23,12,8,3
"2011","Stafford 004C","E01029741","Total",47,15,29,3,3,1,2,0,44,14,27,3
"2011","Stafford 004D","E01029754","Total",18,8,10,0,1,0,1,0,17,8,9,0
"2011","Stafford 004E","E01029755","Total",6,1,2,3,2,0,2,0,4,1,0,3
"2011","Stafford 005A","E01029695","Total",35,13,18,4,6,0,5,1,29,13,13,3
"2011","Stafford 005B","E01029696","Total",26,7,11,8,7,0,5,2,19,7,6,6
"2011","Stafford 005C","E01029697","Total",13,6,6,1,2,0,2,0,11,6,4,1
"2011","Stafford 005D","E01029698","Total",27,7,12,8,2,0,2,0,25,7,10,8
"2011","Stafford 005E","E01029747","Total",26,10,14,2,3,1,2,0,23,9,12,2
"2011","Stafford 006A","E01029690","Total",33,23,7,3,1,1,0,0,32,22,7,3
"2011","Stafford 006B","E01029718","Total",31,11,14,6,2,0,2,0,29,11,12,6
"2011","Stafford 006C","E01029743","Total",15,9,3,3,1,0,1,0,14,9,2,3
"2011","Stafford 006D","E01029751","Total",36,8,18,10,3,0,3,0,33,8,15,10
"2011","Stafford 007A","E01029719","Total",30,11,13,6,3,0,3,0,27,11,10,6
"2011","Stafford 007B","E01029720","Total",103,37,19,47,9,2,3,4,94,35,16,43
"2011","Stafford 007C","E01029721","Total",35,9,15,11,3,0,1,2,32,9,14,9
"2011","Stafford 007D","E01029750","Total",66,23,17,26,8,1,5,2,58,22,12,24
"2011","Stafford 007E","E01029752","Total",76,24,15,37,7,1,3,3,69,23,12,34
"2011","Stafford 008A","E01029687","Total",20,5,10,5,6,0,5,1,14,5,5,4
"2011","Stafford 008B","E01029710","Total",24,9,11,4,3,0,3,0,21,9,8,4
"2011","Stafford 008C","E01029711","Total",26,6,16,4,4,0,4,0,22,6,12,4
"2011","Stafford 008D","E01029712","Total",33,16,8,9,3,1,2,0,30,15,6,9
"2011","Stafford 008E","E01029713","Total",33,12,10,11,8,0,6,2,25,12,4,9
"2011","Stafford 009A","E01029692","Total",69,21,22,26,5,1,3,1,64,20,19,25
"2011","Stafford 009B","E01029693","Total",44,15,17,12,2,0,1,1,42,15,16,11
"2011","Stafford 009C","E01029722","Total",50,15,21,14,2,0,2,0,48,15,19,14
"2011","Stafford 009D","E01029725","Total",20,8,9,3,2,0,2,0,18,8,7,3
"2011","Stafford 010A","E01029689","Total",48,16,25,7,6,1,5,0,42,15,20,7
"2011","Stafford 010B","E01029691","Total",32,13,12,7,2,1,1,0,30,12,11,7
"2011","Stafford 010C","E01029694","Total",26,7,15,4,2,0,2,0,24,7,13,4
"2011","Stafford 010D","E01029699","Total",67,26,24,17,5,0,4,1,62,26,20,16
"2011","Stafford 010E","E01029701","Total",56,14,22,20,8,0,7,1,48,14,15,19
"2011","Stafford 011A","E01029686","Total",19,5,12,2,4,0,4,0,15,5,8,2
"2011","Stafford 011B","E01029700","Total",29,9,16,4,5,2,3,0,24,7,13,4
"2011","Stafford 011C","E01029723","Total",31,14,14,3,3,0,3,0,28,14,11,3
"2011","Stafford 011D","E01029724","Total",28,8,18,2,7,0,6,1,21,8,12,1
"2011","Stafford 011E","E01029732","Total",28,8,9,11,6,1,4,1,22,7,5,10
"2011","Stafford 012A","E01029714","Total",26,6,14,6,5,0,5,0,21,6,9,6
"2011","Stafford 012B","E01029736","Total",22,5,10,7,0,0,0,0,22,5,10,7
"2011","Stafford 012C","E01029737","Total",30,11,11,8,9,1,5,3,21,10,6,5
"2011","Stafford 012D","E01029738","Total",17,8,6,3,3,0,2,1,14,8,4,2
"2011","Stafford 012E","E01029742","Total",20,8,6,6,4,3,0,1,16,5,6,5
"2011","Stafford 013A","E01029715","Total",94,40,22,32,7,1,6,0,87,39,16,32
"2011","Stafford 013B","E01029716","Total",69,20,13,36,7,0,3,4,62,20,10,32
"2011","Stafford 013C","E01029717","Total",131,51,12,68,6,3,2,1,125,48,10,67
"2011","Stafford 013D","E01029727","Total",77,31,12,34,4,0,3,1,73,31,9,33
"2011","Stafford 013E","E01029728","Total",50,20,17,13,7,0,6,1,43,20,11,12
"2011","Stafford 014A","E01029684","Total",19,8,11,0,0,0,0,0,19,8,11,0
"2011","Stafford 014B","E01029685","Total",18,4,9,5,2,0,1,1,16,4,8,4
"2011","Stafford 014C","E01029730","Total",17,6,11,0,3,0,3,0,14,6,8,0
"2011","Stafford 014D","E01029731","Total",40,19,17,4,8,0,7,1,32,19,10,3
"2011","Stafford 014E","E01029757","Total",51,22,25,4,7,1,5,1,44,21,20,3
"2011","Stafford 014F","E01029758","Total",21,13,5,3,3,0,2,1,18,13,3,2
"2011","Stafford 014G","E01029759","Total",37,13,18,6,2,0,2,0,35,13,16,6
"2011","Stafford 014H","E01029760","Total",20,4,12,4,4,1,3,0,16,3,9,4
"2011","Stafford 015A","E01029688","Total",28,8,14,6,3,0,3,0,25,8,11,6
"2011","Stafford 015B","E01029706","Total",20,4,11,5,4,0,4,0,16,4,7,5
"2011","Stafford 015C","E01029707","Total",43,17,12,14,2,0,1,1,41,17,11,13
"2011","Stafford 015D","E01029708","Total",23,6,9,8,4,0,2,2,19,6,7,6
"2011","Stafford 015E","E01029709","Total",25,13,8,4,2,0,2,0,23,13,6,4
"2011","Stafford 016A","E01029726","Total",44,22,8,14,4,0,0,4,40,22,8,10
"2011","Stafford 016B","E01029729","Total",41,13,12,16,7,0,4,3,34,13,8,13
"2011","Stafford 016C","E01029734","Total",138,39,33,66,8,1,6,1,130,38,27,65
"2011","Stafford 016D","E01029735","Total",61,20,24,17,10,3,4,3,51,17,20,14
"2011","Staffordshire Moorlands 001A","E01029797","Total",14,5,4,5,1,0,1,0,13,5,3,5
"2011","Staffordshire Moorlands 001B","E01029806","Total",26,9,12,5,3,0,1,2,23,9,11,3
"2011","Staffordshire Moorlands 001C","E01029808","Total",62,21,19,22,6,1,5,0,56,20,14,22
"2011","Staffordshire Moorlands 001D","E01029809","Total",51,23,7,21,10,4,4,2,41,19,3,19
"2011","Staffordshire Moorlands 001E","E01029810","Total",51,22,12,17,7,3,1,3,44,19,11,14
"2011","Staffordshire Moorlands 002A","E01029767","Total",15,3,9,3,5,1,4,0,10,2,5,3
"2011","Staffordshire Moorlands 002B","E01029769","Total",15,7,6,2,1,0,0,1,14,7,6,1
"2011","Staffordshire Moorlands 002C","E01029770","Total",26,9,11,6,5,1,3,1,21,8,8,5
"2011","Staffordshire Moorlands 002D","E01029802","Total",19,6,7,6,4,0,2,2,15,6,5,4
"2011","Staffordshire Moorlands 003A","E01029763","Total",96,31,14,51,5,0,1,4,91,31,13,47
"2011","Staffordshire Moorlands 003B","E01029764","Total",78,24,19,35,7,0,4,3,71,24,15,32
"2011","Staffordshire Moorlands 003C","E01029765","Total",57,22,9,26,9,1,4,4,48,21,5,22
"2011","Staffordshire Moorlands 003D","E01029766","Total",47,17,17,13,5,1,4,0,42,16,13,13
"2011","Staffordshire Moorlands 003E","E01029774","Total",79,22,20,37,6,0,1,5,73,22,19,32
"2011","Staffordshire Moorlands 004A","E01029768","Total",14,6,7,1,6,2,4,0,8,4,3,1
"2011","Staffordshire Moorlands 004B","E01029771","Total",17,4,6,7,0,0,0,0,17,4,6,7
"2011","Staffordshire Moorlands 004C","E01029772","Total",27,8,9,10,4,0,2,2,23,8,7,8
"2011","Staffordshire Moorlands 004D","E01029773","Total",26,10,12,4,3,1,1,1,23,9,11,3
"2011","Staffordshire Moorlands 005A","E01029804","Total",93,23,41,29,17,2,14,1,76,21,27,28
"2011","Staffordshire Moorlands 005B","E01029807","Total",27,11,10,6,4,0,3,1,23,11,7,5
"2011","Staffordshire Moorlands 005C","E01029811","Total",60,23,21,16,7,1,4,2,53,22,17,14
"2011","Staffordshire Moorlands 005D","E01029812","Total",91,31,28,32,17,4,9,4,74,27,19,28
"2011","Staffordshire Moorlands 005E","E01029814","Total",57,14,28,15,10,1,7,2,47,13,21,13
"2011","Staffordshire Moorlands 006A","E01029792","Total",31,7,21,3,8,0,8,0,23,7,13,3
"2011","Staffordshire Moorlands 006B","E01029793","Total",35,9,19,7,9,0,6,3,26,9,13,4
"2011","Staffordshire Moorlands 006C","E01029805","Total",29,11,11,7,8,1,6,1,21,10,5,6
"2011","Staffordshire Moorlands 006D","E01029813","Total",34,12,11,11,6,1,4,1,28,11,7,10
"2011","Staffordshire Moorlands 006E","E01029815","Total",25,9,9,7,3,0,3,0,22,9,6,7
"2011","Staffordshire Moorlands 006F","E01029816","Total",17,8,8,1,3,0,3,0,14,8,5,1
"2011","Staffordshire Moorlands 007A","E01029801","Total",25,9,8,8,7,3,3,1,18,6,5,7
"2011","Staffordshire Moorlands 007B","E01029803","Total",20,9,9,2,2,1,1,0,18,8,8,2
"2011","Staffordshire Moorlands 007C","E01029817","Total",18,7,7,4,3,1,1,1,15,6,6,3
"2011","Staffordshire Moorlands 008A","E01029762","Total",25,8,14,3,9,0,8,1,16,8,6,2
"2011","Staffordshire Moorlands 008B","E01029775","Total",23,7,8,8,4,2,1,1,19,5,7,7
"2011","Staffordshire Moorlands 008C","E01029776","Total",23,8,13,2,2,0,2,0,21,8,11,2
"2011","Staffordshire Moorlands 008D","E01029777","Total",32,11,14,7,5,2,3,0,27,9,11,7
"2011","Staffordshire Moorlands 009A","E01029779","Total",22,4,15,3,2,1,1,0,20,3,14,3
"2011","Staffordshire Moorlands 009B","E01029780","Total",46,16,16,14,5,0,4,1,41,16,12,13
"2011","Staffordshire Moorlands 009C","E01029794","Total",20,9,10,1,6,1,5,0,14,8,5,1
"2011","Staffordshire Moorlands 009D","E01029818","Total",27,12,13,2,4,2,2,0,23,10,11,2
"2011","Staffordshire Moorlands 009E","E01029819","Total",21,7,11,3,4,0,4,0,17,7,7,3
"2011","Staffordshire Moorlands 010A","E01029761","Total",22,9,4,9,2,0,2,0,20,9,2,9
"2011","Staffordshire Moorlands 010B","E01029782","Total",65,15,15,35,2,0,1,1,63,15,14,34
"2011","Staffordshire Moorlands 010C","E01029795","Total",27,9,12,6,6,0,4,2,21,9,8,4
"2011","Staffordshire Moorlands 010D","E01029796","Total",28,7,9,12,8,1,4,3,20,6,5,9
"2011","Staffordshire Moorlands 011A","E01029781","Total",38,18,13,7,3,1,2,0,35,17,11,7
"2011","Staffordshire Moorlands 011B","E01029783","Total",59,22,21,16,4,0,4,0,55,22,17,16
"2011","Staffordshire Moorlands 011C","E01029786","Total",24,6,10,8,1,0,1,0,23,6,9,8
"2011","Staffordshire Moorlands 011D","E01029787","Total",51,18,21,12,12,2,9,1,39,16,12,11
"2011","Staffordshire Moorlands 012A","E01029778","Total",29,8,14,7,6,1,4,1,23,7,10,6
"2011","Staffordshire Moorlands 012B","E01029789","Total",17,5,6,6,4,0,4,0,13,5,2,6
"2011","Staffordshire Moorlands 012C","E01029798","Total",58,22,21,15,7,2,5,0,51,20,16,15
"2011","Staffordshire Moorlands 012D","E01029799","Total",33,10,17,6,4,2,2,0,29,8,15,6
"2011","Staffordshire Moorlands 012E","E01029800","Total",30,12,16,2,2,0,1,1,28,12,15,1
"2011","Staffordshire Moorlands 013A","E01029784","Total",29,6,17,6,6,0,5,1,23,6,12,5
"2011","Staffordshire Moorlands 013B","E01029785","Total",27,7,13,7,6,0,4,2,21,7,9,5
"2011","Staffordshire Moorlands 013C","E01029788","Total",14,7,5,2,2,0,2,0,12,7,3,2
"2011","Staffordshire Moorlands 013D","E01029790","Total",43,17,13,13,3,0,1,2,40,17,12,11
"2011","Staffordshire Moorlands 013E","E01029791","Total",31,9,12,10,6,1,3,2,25,8,9,8
"2011","Tamworth 001A","E01029846","Total",33,14,12,7,6,0,6,0,27,14,6,7
"2011","Tamworth 001B","E01029847","Total",17,5,9,3,4,0,4,0,13,5,5,3
"2011","Tamworth 001C","E01029848","Total",16,7,8,1,2,0,2,0,14,7,6,1
"2011","Tamworth 001D","E01029852","Total",76,23,18,35,5,3,2,0,71,20,16,35
"2011","Tamworth 001E","E01029853","Total",58,24,9,25,4,0,2,2,54,24,7,23
"2011","Tamworth 001F","E01029854","Total",18,10,8,0,0,0,0,0,18,10,8,0
"2011","Tamworth 002A","E01029835","Total",43,12,6,25,4,0,3,1,39,12,3,24
"2011","Tamworth 002B","E01029836","Total",46,15,11,20,1,0,0,1,45,15,11,19
"2011","Tamworth 002C","E01029849","Total",98,29,18,51,11,3,5,3,87,26,13,48
"2011","Tamworth 002D","E01029850","Total",51,19,17,15,5,2,2,1,46,17,15,14
"2011","Tamworth 002E","E01029851","Total",71,26,12,33,8,3,2,3,63,23,10,30
"2011","Tamworth 003A","E01029820","Total",47,13,13,21,8,0,4,4,39,13,9,17
"2011","Tamworth 003B","E01029821","Total",31,10,12,9,7,1,6,0,24,9,6,9
"2011","Tamworth 003C","E01029822","Total",33,14,11,8,6,0,5,1,27,14,6,7
"2011","Tamworth 003D","E01029824","Total",113,33,18,62,4,0,3,1,109,33,15,61
"2011","Tamworth 003E","E01029841","Total",28,13,8,7,1,0,1,0,27,13,7,7
"2011","Tamworth 004A","E01029823","Total",22,9,6,7,2,0,1,1,20,9,5,6
"2011","Tamworth 004B","E01029831","Total",53,9,10,34,1,0,1,0,52,9,9,34
"2011","Tamworth 004C","E01029832","Total",44,19,11,14,6,1,3,2,38,18,8,12
"2011","Tamworth 004D","E01029834","Total",63,13,18,32,4,0,3,1,59,13,15,31
"2011","Tamworth 004E","E01029844","Total",28,10,9,9,5,1,3,1,23,9,6,8
"2011","Tamworth 005A","E01029833","Total",48,14,18,16,9,3,5,1,39,11,13,15
"2011","Tamworth 005B","E01029837","Total",38,14,6,18,5,0,3,2,33,14,3,16
"2011","Tamworth 005C","E01029838","Total",47,19,10,18,3,1,1,1,44,18,9,17
"2011","Tamworth 005D","E01029839","Total",22,10,10,2,5,0,4,1,17,10,6,1
"2011","Tamworth 006A","E01029825","Total",29,12,8,9,5,0,4,1,24,12,4,8
"2011","Tamworth 006B","E01029826","Total",38,15,13,10,10,3,6,1,28,12,7,9
"2011","Tamworth 006C","E01029827","Total",62,17,12,33,4,0,3,1,58,17,9,32
"2011","Tamworth 006D","E01029828","Total",68,19,13,36,7,1,2,4,61,18,11,32
"2011","Tamworth 006E","E01029830","Total",59,21,12,26,5,2,2,1,54,19,10,25
"2011","Tamworth 007A","E01029840","Total",82,26,6,50,5,1,1,3,77,25,5,47
"2011","Tamworth 007B","E01029842","Total",91,27,12,52,6,0,0,6,85,27,12,46
"2011","Tamworth 007C","E01029843","Total",64,24,16,24,7,3,4,0,57,21,12,24
"2011","Tamworth 007D","E01029845","Total",58,18,8,32,2,0,1,1,56,18,7,31
"2011","Tamworth 007E","E01029859","Total",138,36,22,80,9,2,3,4,129,34,19,76
"2011","Tamworth 008A","E01029855","Total",61,19,17,25,1,0,0,1,60,19,17,24
"2011","Tamworth 008B","E01029856","Total",35,11,14,10,6,1,5,0,29,10,9,10
"2011","Tamworth 008C","E01029857","Total",61,23,9,29,5,2,3,0,56,21,6,29
"2011","Tamworth 008D","E01029858","Total",28,12,11,5,4,1,3,0,24,11,8,5
"2011","Tamworth 008E","E01029865","Total",28,11,10,7,4,0,4,0,24,11,6,7
"2011","Tamworth 009A","E01029860","Total",13,4,4,5,0,0,0,0,13,4,4,5
"2011","Tamworth 009B","E01029861","Total",29,11,12,6,3,0,3,0,26,11,9,6
"2011","Tamworth 009C","E01029862","Total",30,11,18,1,3,0,3,0,27,11,15,1
"2011","Tamworth 009D","E01029863","Total",30,15,9,6,3,0,1,2,27,15,8,4
"2011","Tamworth 009E","E01029864","Total",27,11,6,10,1,0,1,0,26,11,5,10
"2011","Tamworth 010A","E01029829","Total",79,26,17,36,9,1,5,3,70,25,12,33
"2011","Tamworth 010C","E01029867","Total",73,29,16,28,4,0,1,3,69,29,15,25
"2011","Tamworth 010D","E01029868","Total",22,12,9,1,3,1,2,0,19,11,7,1
"2011","Tamworth 010E","E01029869","Total",60,28,14,18,6,1,4,1,54,27,10,17
"2011","Tamworth 010F","E01032901","Total",58,16,24,18,6,0,3,3,52,16,21,15
"2011","Tamworth 010G","E01032902","Total",49,14,23,12,2,0,2,0,47,14,21,12
"2011","North Warwickshire 001A","E01031035","Total",42,19,9,14,4,0,3,1,38,19,6,13
"2011","North Warwickshire 001B","E01031036","Total",29,8,13,8,7,1,5,1,22,7,8,7
"2011","North Warwickshire 001C","E01031037","Total",38,13,15,10,5,0,4,1,33,13,11,9
"2011","North Warwickshire 001D","E01031038","Total",57,25,19,13,4,1,3,0,53,24,16,13
"2011","North Warwickshire 001E","E01031039","Total",27,9,12,6,6,0,4,2,21,9,8,4
"2011","North Warwickshire 001F","E01031040","Total",51,17,27,7,8,2,3,3,43,15,24,4
"2011","North Warwickshire 002A","E01031016","Total",51,19,9,23,5,0,3,2,46,19,6,21
"2011","North Warwickshire 002B","E01031025","Total",38,13,13,12,3,1,2,0,35,12,11,12
"2011","North Warwickshire 002C","E01031026","Total",55,25,9,21,7,4,1,2,48,21,8,19
"2011","North Warwickshire 002D","E01031031","Total",76,36,23,17,14,3,10,1,62,33,13,16
"2011","North Warwickshire 002E","E01031032","Total",29,9,6,14,2,0,0,2,27,9,6,12
"2011","North Warwickshire 003A","E01031009","Total",61,15,20,26,3,0,1,2,58,15,19,24
"2011","North Warwickshire 003B","E01031010","Total",78,22,16,40,8,1,3,4,70,21,13,36
"2011","North Warwickshire 003C","E01031011","Total",40,15,13,12,5,0,4,1,35,15,9,11
"2011","North Warwickshire 003D","E01031012","Total",44,17,10,17,4,0,2,2,40,17,8,15
"2011","North Warwickshire 003E","E01031013","Total",21,8,8,5,2,0,2,0,19,8,6,5
"2011","North Warwickshire 003F","E01031014","Total",18,5,7,6,7,0,5,2,11,5,2,4
"2011","North Warwickshire 003G","E01031015","Total",50,14,5,31,1,1,0,0,49,13,5,31
"2011","North Warwickshire 004A","E01031023","Total",19,8,9,2,0,0,0,0,19,8,9,2
"2011","North Warwickshire 004B","E01031024","Total",14,1,8,5,2,0,2,0,12,1,6,5
"2011","North Warwickshire 004C","E01031033","Total",56,16,23,17,7,0,5,2,49,16,18,15
"2011","North Warwickshire 004D","E01031034","Total",29,9,16,4,3,2,1,0,26,7,15,4
"2011","North Warwickshire 005A","E01031005","Total",55,24,12,19,9,3,2,4,46,21,10,15
"2011","North Warwickshire 005B","E01031008","Total",54,18,14,22,8,2,6,0,46,16,8,22
"2011","North Warwickshire 005C","E01031017","Total",11,3,6,2,1,0,1,0,10,3,5,2
"2011","North Warwickshire 005D","E01031018","Total",19,9,9,1,4,1,2,1,15,8,7,0
"2011","North Warwickshire 005E","E01031029","Total",46,18,20,8,6,0,6,0,40,18,14,8
"2011","North Warwickshire 005F","E01031030","Total",74,30,19,25,6,2,3,1,68,28,16,24
"2011","North Warwickshire 006A","E01031019","Total",46,22,16,8,6,1,3,2,40,21,13,6
"2011","North Warwickshire 006B","E01031020","Total",39,16,17,6,3,1,2,0,36,15,15,6
"2011","North Warwickshire 006C","E01031021","Total",41,15,15,11,5,0,5,0,36,15,10,11
"2011","North Warwickshire 006D","E01031022","Total",26,9,10,7,1,1,0,0,25,8,10,7
"2011","North Warwickshire 006E","E01031041","Total",24,2,18,4,0,0,0,0,24,2,18,4
"2011","North Warwickshire 006F","E01031042","Total",35,18,10,7,1,0,1,0,34,18,9,7
"2011","North Warwickshire 007A","E01031006","Total",47,20,13,14,6,1,3,2,41,19,10,12
"2011","North Warwickshire 007B","E01031007","Total",13,6,7,0,5,1,4,0,8,5,3,0
"2011","North Warwickshire 007C","E01031027","Total",13,3,5,5,1,0,1,0,12,3,4,5
"2011","North Warwickshire 007D","E01031028","Total",29,7,15,7,7,0,7,0,22,7,8,7
"2011","Nuneaton and Bedworth 001A","E01031110","Total",18,8,7,3,2,0,1,1,16,8,6,2
"2011","Nuneaton and Bedworth 001B","E01031111","Total",11,3,6,2,5,1,2,2,6,2,4,0
"2011","Nuneaton and Bedworth 001C","E01031112","Total",50,22,16,12,4,0,4,0,46,22,12,12
"2011","Nuneaton and Bedworth 001D","E01031113","Total",27,8,13,6,4,0,2,2,23,8,11,4
"2011","Nuneaton and Bedworth 001E","E01031114","Total",41,12,22,7,6,2,3,1,35,10,19,6
"2011","Nuneaton and Bedworth 002C","E01031073","Total",56,22,11,23,3,0,3,0,53,22,8,23
"2011","Nuneaton and Bedworth 002D","E01031074","Total",55,18,12,25,8,3,3,2,47,15,9,23
"2011","Nuneaton and Bedworth 002E","E01031075","Total",94,32,15,47,6,0,3,3,88,32,12,44
"2011","Nuneaton and Bedworth 002F","E01032890","Total",149,43,26,80,15,5,4,6,134,38,22,74
"2011","Nuneaton and Bedworth 003A","E01031100","Total",26,8,12,6,5,0,5,0,21,8,7,6
"2011","Nuneaton and Bedworth 003B","E01031101","Total",19,3,14,2,5,1,3,1,14,2,11,1
"2011","Nuneaton and Bedworth 003C","E01031102","Total",49,18,22,9,7,0,7,0,42,18,15,9
"2011","Nuneaton and Bedworth 003D","E01031103","Total",9,6,2,1,0,0,0,0,9,6,2,1
"2011","Nuneaton and Bedworth 003E","E01031104","Total",16,9,4,3,1,0,0,1,15,9,4,2
"2011","Nuneaton and Bedworth 004A","E01031081","Total",66,20,21,25,4,0,3,1,62,20,18,24
"2011","Nuneaton and Bedworth 004B","E01031082","Total",33,15,14,4,3,1,2,0,30,14,12,4
"2011","Nuneaton and Bedworth 004C","E01031083","Total",45,25,12,8,9,3,6,0,36,22,6,8
"2011","Nuneaton and Bedworth 004D","E01031084","Total",67,29,24,14,3,0,2,1,64,29,22,13
"2011","Nuneaton and Bedworth 004E","E01031085","Total",25,7,12,6,4,0,4,0,21,7,8,6
"2011","Nuneaton and Bedworth 005A","E01031043","Total",44,10,16,18,8,1,5,2,36,9,11,16
"2011","Nuneaton and Bedworth 005B","E01031044","Total",81,24,14,43,12,3,2,7,69,21,12,36
"2011","Nuneaton and Bedworth 005C","E01031045","Total",45,12,12,21,2,0,1,1,43,12,11,20
"2011","Nuneaton and Bedworth 005D","E01031046","Total",66,23,13,30,10,4,5,1,56,19,8,29
"2011","Nuneaton and Bedworth 005E","E01031047","Total",49,22,11,16,10,3,4,3,39,19,7,13
"2011","Nuneaton and Bedworth 006A","E01031057","Total",98,23,14,61,3,0,1,2,95,23,13,59
"2011","Nuneaton and Bedworth 006B","E01031058","Total",70,24,13,33,4,0,1,3,66,24,12,30
"2011","Nuneaton and Bedworth 006C","E01031059","Total",52,15,14,23,8,1,4,3,44,14,10,20
"2011","Nuneaton and Bedworth 006D","E01031060","Total",46,16,6,24,2,1,0,1,44,15,6,23
"2011","Nuneaton and Bedworth 006E","E01031061","Total",41,19,11,11,5,0,4,1,36,19,7,10
"2011","Nuneaton and Bedworth 007A","E01031090","Total",82,24,10,48,9,0,3,6,73,24,7,42
"2011","Nuneaton and Bedworth 007B","E01031091","Total",29,12,10,7,3,0,3,0,26,12,7,7
"2011","Nuneaton and Bedworth 007C","E01031092","Total",76,30,18,28,8,1,3,4,68,29,15,24
"2011","Nuneaton and Bedworth 007D","E01031093","Total",33,10,14,9,3,0,2,1,30,10,12,8
"2011","Nuneaton and Bedworth 007E","E01031094","Total",50,16,13,21,3,0,3,0,47,16,10,21
"2011","Nuneaton and Bedworth 008A","E01031048","Total",32,9,10,13,1,0,1,0,31,9,9,13
"2011","Nuneaton and Bedworth 008B","E01031049","Total",59,22,26,11,13,1,11,1,46,21,15,10
"2011","Nuneaton and Bedworth 008C","E01031050","Total",56,16,12,28,3,1,2,0,53,15,10,28
"2011","Nuneaton and Bedworth 008D","E01031051","Total",24,7,12,5,5,0,4,1,19,7,8,4
"2011","Nuneaton and Bedworth 009A","E01031115","Total",46,14,19,13,4,0,3,1,42,14,16,12
"2011","Nuneaton and Bedworth 009B","E01031116","Total",109,29,12,68,5,3,0,2,104,26,12,66
"2011","Nuneaton and Bedworth 009C","E01031117","Total",73,19,18,36,5,0,5,0,68,19,13,36
"2011","Nuneaton and Bedworth 009D","E01031118","Total",68,22,14,32,9,0,6,3,59,22,8,29
"2011","Nuneaton and Bedworth 009E","E01031119","Total",50,10,14,26,4,0,2,2,46,10,12,24
"2011","Nuneaton and Bedworth 010A","E01031052","Total",79,31,21,27,6,1,4,1,73,30,17,26
"2011","Nuneaton and Bedworth 010B","E01031053","Total",41,15,14,12,5,1,4,0,36,14,10,12
"2011","Nuneaton and Bedworth 010C","E01031054","Total",77,21,26,30,9,1,5,3,68,20,21,27
"2011","Nuneaton and Bedworth 010D","E01031055","Total",62,21,24,17,7,1,5,1,55,20,19,16
"2011","Nuneaton and Bedworth 010E","E01031056","Total",55,24,6,25,7,3,2,2,48,21,4,23
"2011","Nuneaton and Bedworth 011A","E01031120","Total",25,7,13,5,1,0,1,0,24,7,12,5
"2011","Nuneaton and Bedworth 011B","E01031121","Total",16,3,10,3,3,0,3,0,13,3,7,3
"2011","Nuneaton and Bedworth 011C","E01031122","Total",22,6,13,3,3,0,2,1,19,6,11,2
"2011","Nuneaton and Bedworth 011D","E01031123","Total",9,3,5,1,1,0,1,0,8,3,4,1
"2011","Nuneaton and Bedworth 011E","E01031124","Total",12,2,6,4,1,0,1,0,11,2,5,4
"2011","Nuneaton and Bedworth 012A","E01031105","Total",40,16,13,11,2,1,0,1,38,15,13,10
"2011","Nuneaton and Bedworth 012B","E01031106","Total",31,8,13,10,4,0,3,1,27,8,10,9
"2011","Nuneaton and Bedworth 012C","E01031107","Total",36,15,12,9,2,0,2,0,34,15,10,9
"2011","Nuneaton and Bedworth 012D","E01031108","Total",29,11,10,8,5,0,4,1,24,11,6,7
"2011","Nuneaton and Bedworth 012E","E01031109","Total",61,14,20,27,9,0,6,3,52,14,14,24
"2011","Nuneaton and Bedworth 013A","E01031062","Total",26,9,7,10,5,1,1,3,21,8,6,7
"2011","Nuneaton and Bedworth 013B","E01031063","Total",69,26,11,32,4,1,0,3,65,25,11,29
"2011","Nuneaton and Bedworth 013C","E01031064","Total",30,9,12,9,1,0,1,0,29,9,11,9
"2011","Nuneaton and Bedworth 013D","E01031065","Total",62,12,17,33,4,0,3,1,58,12,14,32
"2011","Nuneaton and Bedworth 013E","E01031066","Total",72,19,11,42,7,0,3,4,65,19,8,38
"2011","Nuneaton and Bedworth 014A","E01031067","Total",42,18,10,14,5,0,5,0,37,18,5,14
"2011","Nuneaton and Bedworth 014B","E01031068","Total",22,11,7,4,2,0,2,0,20,11,5,4
"2011","Nuneaton and Bedworth 014C","E01031069","Total",12,4,7,1,3,1,2,0,9,3,5,1
"2011","Nuneaton and Bedworth 014D","E01031070","Total",15,5,8,2,4,1,3,0,11,4,5,2
"2011","Nuneaton and Bedworth 015A","E01031095","Total",77,27,21,29,11,2,9,0,66,25,12,29
"2011","Nuneaton and Bedworth 015B","E01031096","Total",52,24,15,13,5,2,3,0,47,22,12,13
"2011","Nuneaton and Bedworth 015C","E01031097","Total",64,20,16,28,7,0,2,5,57,20,14,23
"2011","Nuneaton and Bedworth 015D","E01031098","Total",45,14,12,19,5,0,3,2,40,14,9,17
"2011","Nuneaton and Bedworth 015E","E01031099","Total",63,20,28,15,6,0,5,1,57,20,23,14
"2011","Nuneaton and Bedworth 016A","E01031086","Total",55,17,14,24,7,1,4,2,48,16,10,22
"2011","Nuneaton and Bedworth 016B","E01031087","Total",92,20,31,41,9,0,7,2,83,20,24,39
"2011","Nuneaton and Bedworth 016C","E01031088","Total",62,24,16,22,3,0,2,1,59,24,14,21
"2011","Nuneaton and Bedworth 016D","E01031089","Total",24,8,10,6,3,0,3,0,21,8,7,6
"2011","Nuneaton and Bedworth 018A","E01031077","Total",80,22,14,44,3,0,0,3,77,22,14,41
"2011","Nuneaton and Bedworth 018B","E01031078","Total",47,16,19,12,4,0,4,0,43,16,15,12
"2011","Nuneaton and Bedworth 018C","E01031079","Total",35,14,9,12,3,0,2,1,32,14,7,11
"2011","Nuneaton and Bedworth 018D","E01031080","Total",56,17,11,28,4,0,3,1,52,17,8,27
"2011","Nuneaton and Bedworth 018E","E01032588","Total",27,6,11,10,2,1,1,0,25,5,10,10
"2011","Rugby 001B","E01031129","Total",16,8,5,3,0,0,0,0,16,8,5,3
"2011","Rugby 001C","E01031159","Total",37,8,18,11,7,0,7,0,30,8,11,11
"2011","Rugby 001D","E01031160","Total",28,8,11,9,3,0,3,0,25,8,8,9
"2011","Rugby 001E","E01031182","Total",33,7,19,7,8,0,8,0,25,7,11,7
"2011","Rugby 001F","E01032891","Total",27,9,12,6,3,0,3,0,24,9,9,6
"2011","Rugby 001G","E01032892","Total",21,4,11,6,2,0,1,1,19,4,10,5
"2011","Rugby 002A","E01031137","Total",34,12,11,11,4,1,2,1,30,11,9,10
"2011","Rugby 002B","E01031138","Total",32,9,11,12,3,0,2,1,29,9,9,11
"2011","Rugby 002C","E01031139","Total",25,9,12,4,7,0,6,1,18,9,6,3
"2011","Rugby 002D","E01031140","Total",36,10,8,18,6,0,1,5,30,10,7,13
"2011","Rugby 002E","E01031141","Total",72,34,12,26,7,0,3,4,65,34,9,22
"2011","Rugby 002F","E01031142","Total",116,37,23,56,9,1,5,3,107,36,18,53
"2011","Rugby 003A","E01031171","Total",56,22,21,13,3,0,3,0,53,22,18,13
"2011","Rugby 003B","E01031172","Total",95,31,14,50,7,1,3,3,88,30,11,47
"2011","Rugby 003C","E01031173","Total",58,20,12,26,6,3,1,2,52,17,11,24
"2011","Rugby 003D","E01031174","Total",59,23,14,22,7,3,2,2,52,20,12,20
"2011","Rugby 004A","E01031151","Total",21,4,13,4,4,0,2,2,17,4,11,2
"2011","Rugby 004B","E01031152","Total",19,9,5,5,2,0,1,1,17,9,4,4
"2011","Rugby 004C","E01031153","Total",53,16,17,20,5,1,3,1,48,15,14,19
"2011","Rugby 004D","E01031154","Total",34,11,19,4,2,0,2,0,32,11,17,4
"2011","Rugby 004E","E01031181","Total",22,5,7,10,2,0,1,1,20,5,6,9
"2011","Rugby 005A","E01031130","Total",65,22,18,25,5,1,3,1,60,21,15,24
"2011","Rugby 005B","E01031131","Total",65,15,21,29,9,1,5,3,56,14,16,26
"2011","Rugby 005C","E01031132","Total",64,18,20,26,3,0,3,0,61,18,17,26
"2011","Rugby 005D","E01031133","Total",71,26,21,24,9,0,9,0,62,26,12,24
"2011","Rugby 006A","E01031167","Total",33,15,6,12,2,0,2,0,31,15,4,12
"2011","Rugby 006B","E01031168","Total",146,52,28,66,3,0,2,1,143,52,26,65
"2011","Rugby 006C","E01031169","Total",77,27,18,32,6,1,3,2,71,26,15,30
"2011","Rugby 006D","E01031170","Total",73,28,20,25,2,0,1,1,71,28,19,24
"2011","Rugby 007A","E01031125","Total",29,13,9,7,5,0,5,0,24,13,4,7
"2011","Rugby 007C","E01031127","Total",89,39,10,40,5,1,1,3,84,38,9,37
"2011","Rugby 007D","E01031164","Total",41,15,19,7,6,1,3,2,35,14,16,5
"2011","Rugby 007E","E01031165","Total",62,23,9,30,9,3,3,3,53,20,6,27
"2011","Rugby 007F","E01032893","Total",35,14,11,10,1,0,1,0,34,14,10,10
"2011","Rugby 007G","E01032894","Total",45,18,11,16,3,0,1,2,42,18,10,14
"2011","Rugby 007H","E01032895","Total",32,9,12,11,2,0,1,1,30,9,11,10
"2011","Rugby 008A","E01031155","Total",20,7,11,2,4,1,3,0,16,6,8,2
"2011","Rugby 008B","E01031156","Total",24,13,7,4,2,1,1,0,22,12,6,4
"2011","Rugby 008C","E01031157","Total",56,22,25,9,7,0,7,0,49,22,18,9
"2011","Rugby 008D","E01031158","Total",17,12,5,0,3,0,3,0,14,12,2,0
"2011","Rugby 009A","E01031143","Total",21,6,10,5,3,1,1,1,18,5,9,4
"2011","Rugby 009B","E01031144","Total",36,10,9,17,4,0,1,3,32,10,8,14
"2011","Rugby 009C","E01031145","Total",19,5,6,8,0,0,0,0,19,5,6,8
"2011","Rugby 009D","E01031146","Total",58,20,13,25,4,0,3,1,54,20,10,24
"2011","Rugby 010A","E01031161","Total",40,16,11,13,4,0,4,0,36,16,7,13
"2011","Rugby 010B","E01031162","Total",44,14,21,9,7,1,6,0,37,13,15,9
"2011","Rugby 010C","E01031163","Total",49,15,14,20,2,0,0,2,47,15,14,18
"2011","Rugby 010D","E01031179","Total",34,11,21,2,3,0,3,0,31,11,18,2
"2011","Rugby 010E","E01031180","Total",49,22,16,11,3,0,2,1,46,22,14,10
"2011","Rugby 011A","E01031134","Total",23,9,10,4,4,1,3,0,19,8,7,4
"2011","Rugby 011B","E01031135","Total",24,10,10,4,2,0,2,0,22,10,8,4
"2011","Rugby 011C","E01031136","Total",30,11,13,6,3,0,3,0,27,11,10,6
"2011","Rugby 011D","E01031175","Total",10,4,4,2,2,0,1,1,8,4,3,1
"2011","Rugby 011E","E01031176","Total",49,20,9,20,3,1,0,2,46,19,9,18
"2011","Rugby 011F","E01031177","Total",87,35,14,38,1,0,0,1,86,35,14,37
"2011","Rugby 011G","E01031178","Total",31,9,7,15,5,0,4,1,26,9,3,14
"2011","Rugby 012A","E01031147","Total",15,6,4,5,1,0,1,0,14,6,3,5
"2011","Rugby 012B","E01031148","Total",39,12,16,11,5,0,3,2,34,12,13,9
"2011","Rugby 012C","E01031149","Total",24,7,13,4,4,0,3,1,20,7,10,3
"2011","Rugby 012D","E01031150","Total",20,8,8,4,3,0,2,1,17,8,6,3
"2011","Rugby 012E","E01031166","Total",27,9,10,8,2,0,2,0,25,9,8,8
"2011","Stratford-on-Avon 001A","E01031213","Total",41,18,9,14,6,0,4,2,35,18,5,12
"2011","Stratford-on-Avon 001B","E01031243","Total",13,5,5,3,3,1,2,0,10,4,3,3
"2011","Stratford-on-Avon 001C","E01031244","Total",25,11,11,3,3,0,3,0,22,11,8,3
"2011","Stratford-on-Avon 002A","E01031195","Total",28,15,12,1,5,0,5,0,23,15,7,1
"2011","Stratford-on-Avon 002B","E01031202","Total",22,15,6,1,3,1,2,0,19,14,4,1
"2011","Stratford-on-Avon 002C","E01031203","Total",41,17,12,12,2,0,2,0,39,17,10,12
"2011","Stratford-on-Avon 002D","E01031204","Total",11,4,6,1,2,1,1,0,9,3,5,1
"2011","Stratford-on-Avon 003A","E01031239","Total",45,18,21,6,4,1,3,0,41,17,18,6
"2011","Stratford-on-Avon 003B","E01031240","Total",43,16,14,13,5,1,3,1,38,15,11,12
"2011","Stratford-on-Avon 003C","E01031241","Total",42,15,15,12,3,0,3,0,39,15,12,12
"2011","Stratford-on-Avon 003D","E01031242","Total",44,18,10,16,6,0,4,2,38,18,6,14
"2011","Stratford-on-Avon 004A","E01031219","Total",59,19,15,25,8,1,2,5,51,18,13,20
"2011","Stratford-on-Avon 004B","E01031220","Total",32,11,13,8,8,1,7,0,24,10,6,8
"2011","Stratford-on-Avon 004C","E01031221","Total",64,36,9,19,5,1,4,0,59,35,5,19
"2011","Stratford-on-Avon 004D","E01031222","Total",38,17,13,8,5,1,3,1,33,16,10,7
"2011","Stratford-on-Avon 004E","E01031223","Total",26,12,8,6,3,1,2,0,23,11,6,6
"2011","Stratford-on-Avon 004F","E01031224","Total",28,10,11,7,3,0,3,0,25,10,8,7
"2011","Stratford-on-Avon 005A","E01031197","Total",10,2,4,4,2,0,2,0,8,2,2,4
"2011","Stratford-on-Avon 005B","E01031198","Total",28,15,11,2,4,0,4,0,24,15,7,2
"2011","Stratford-on-Avon 005C","E01031199","Total",26,12,5,9,3,1,1,1,23,11,4,8
"2011","Stratford-on-Avon 005D","E01031200","Total",31,12,10,9,5,1,4,0,26,11,6,9
"2011","Stratford-on-Avon 005E","E01031201","Total",26,12,9,5,5,0,4,1,21,12,5,4
"2011","Stratford-on-Avon 005F","E01031210","Total",18,10,2,6,1,0,0,1,17,10,2,5
"2011","Stratford-on-Avon 005G","E01031211","Total",35,18,10,7,4,0,4,0,31,18,6,7
"2011","Stratford-on-Avon 006A","E01031183","Total",52,19,18,15,7,0,6,1,45,19,12,14
"2011","Stratford-on-Avon 006B","E01031184","Total",40,17,14,9,7,1,5,1,33,16,9,8
"2011","Stratford-on-Avon 006C","E01031185","Total",59,26,18,15,4,0,3,1,55,26,15,14
"2011","Stratford-on-Avon 006D","E01031186","Total",46,16,9,21,0,0,0,0,46,16,9,21
"2011","Stratford-on-Avon 007A","E01031187","Total",27,15,6,6,4,0,2,2,23,15,4,4
"2011","Stratford-on-Avon 007B","E01031188","Total",31,11,10,10,3,0,3,0,28,11,7,10
"2011","Stratford-on-Avon 007C","E01031208","Total",26,7,12,7,6,0,6,0,20,7,6,7
"2011","Stratford-on-Avon 008A","E01031217","Total",18,12,4,2,3,3,0,0,15,9,4,2
"2011","Stratford-on-Avon 008B","E01031218","Total",13,6,4,3,0,0,0,0,13,6,4,3
"2011","Stratford-on-Avon 008C","E01031249","Total",36,17,8,11,1,0,0,1,35,17,8,10
"2011","Stratford-on-Avon 008D","E01031250","Total",28,12,7,9,3,1,1,1,25,11,6,8
"2011","Stratford-on-Avon 008E","E01031251","Total",10,0,8,2,4,0,3,1,6,0,5,1
"2011","Stratford-on-Avon 008F","E01031252","Total",18,7,7,4,3,1,2,0,15,6,5,4
"2011","Stratford-on-Avon 008G","E01031253","Total",37,11,15,11,1,0,1,0,36,11,14,11
"2011","Stratford-on-Avon 009A","E01031228","Total",15,7,6,2,0,0,0,0,15,7,6,2
"2011","Stratford-on-Avon 009B","E01031229","Total",29,12,8,9,3,1,1,1,26,11,7,8
"2011","Stratford-on-Avon 009C","E01031230","Total",74,40,22,12,8,3,3,2,66,37,19,10
"2011","Stratford-on-Avon 009D","E01031231","Total",84,39,13,32,13,3,3,7,71,36,10,25
"2011","Stratford-on-Avon 009E","E01031236","Total",46,12,22,12,4,0,4,0,42,12,18,12
"2011","Stratford-on-Avon 009F","E01031238","Total",42,16,10,16,1,1,0,0,41,15,10,16
"2011","Stratford-on-Avon 010A","E01031225","Total",21,7,10,4,6,0,6,0,15,7,4,4
"2011","Stratford-on-Avon 010C","E01031227","Total",35,12,15,8,2,0,1,1,33,12,14,7
"2011","Stratford-on-Avon 010D","E01033250","Total",45,18,14,13,4,0,2,2,41,18,12,11
"2011","Stratford-on-Avon 010E","E01033251","Total",52,21,13,18,4,2,0,2,48,19,13,16
"2011","Stratford-on-Avon 010F","E01033252","Total",12,3,7,2,3,0,2,1,9,3,5,1
"2011","Stratford-on-Avon 011A","E01031232","Total",50,24,19,7,9,2,4,3,41,22,15,4
"2011","Stratford-on-Avon 011B","E01031233","Total",45,23,7,15,1,1,0,0,44,22,7,15
"2011","Stratford-on-Avon 011C","E01031234","Total",31,10,16,5,2,0,2,0,29,10,14,5
"2011","Stratford-on-Avon 011D","E01031235","Total",34,10,12,12,3,0,2,1,31,10,10,11
"2011","Stratford-on-Avon 011E","E01031237","Total",20,7,6,7,1,0,1,0,19,7,5,7
"2011","Stratford-on-Avon 012A","E01031189","Total",36,18,9,9,4,0,2,2,32,18,7,7
"2011","Stratford-on-Avon 012B","E01031190","Total",56,25,12,19,3,1,2,0,53,24,10,19
"2011","Stratford-on-Avon 012C","E01031191","Total",28,10,13,5,4,0,4,0,24,10,9,5
"2011","Stratford-on-Avon 012D","E01031192","Total",35,15,15,5,5,0,5,0,30,15,10,5
"2011","Stratford-on-Avon 012E","E01031248","Total",23,10,5,8,1,1,0,0,22,9,5,8
"2011","Stratford-on-Avon 013A","E01031194","Total",36,14,13,9,5,0,4,1,31,14,9,8
"2011","Stratford-on-Avon 013B","E01031205","Total",21,10,9,2,2,1,1,0,19,9,8,2
"2011","Stratford-on-Avon 013C","E01031206","Total",31,10,15,6,2,0,2,0,29,10,13,6
"2011","Stratford-on-Avon 013D","E01031207","Total",36,12,11,13,3,1,1,1,33,11,10,12
"2011","Stratford-on-Avon 013E","E01031247","Total",35,13,16,6,7,1,5,1,28,12,11,5
"2011","Stratford-on-Avon 014A","E01031196","Total",45,22,15,8,11,3,7,1,34,19,8,7
"2011","Stratford-on-Avon 014B","E01031212","Total",76,30,28,18,6,1,4,1,70,29,24,17
"2011","Stratford-on-Avon 014C","E01031245","Total",17,7,5,5,2,0,2,0,15,7,3,5
"2011","Stratford-on-Avon 014D","E01031246","Total",16,7,8,1,1,0,1,0,15,7,7,1
"2011","Stratford-on-Avon 015A","E01031193","Total",33,16,10,7,4,1,2,1,29,15,8,6
"2011","Stratford-on-Avon 015B","E01031209","Total",30,8,16,6,7,2,5,0,23,6,11,6
"2011","Stratford-on-Avon 015C","E01031214","Total",33,10,16,7,5,0,5,0,28,10,11,7
"2011","Stratford-on-Avon 015D","E01031215","Total",40,13,17,10,6,1,5,0,34,12,12,10
"2011","Stratford-on-Avon 015E","E01031216","Total",32,13,12,7,3,0,3,0,29,13,9,7
"2011","Warwick 001A","E01031254","Total",10,4,5,1,0,0,0,0,10,4,5,1
"2011","Warwick 001B","E01031255","Total",22,11,6,5,2,1,1,0,20,10,5,5
"2011","Warwick 001C","E01031256","Total",22,8,10,4,7,1,5,1,15,7,5,3
"2011","Warwick 001D","E01031257","Total",45,14,23,8,5,0,5,0,40,14,18,8
"2011","Warwick 001E","E01031258","Total",34,15,10,9,1,0,1,0,33,15,9,9
"2011","Warwick 002A","E01031296","Total",54,18,34,2,5,1,4,0,49,17,30,2
"2011","Warwick 002B","E01031297","Total",60,24,29,7,13,2,8,3,47,22,21,4
"2011","Warwick 002C","E01031298","Total",34,12,14,8,8,1,5,2,26,11,9,6
"2011","Warwick 002D","E01031299","Total",18,10,6,2,4,0,3,1,14,10,3,1
"2011","Warwick 002E","E01031300","Total",29,11,10,8,0,0,0,0,29,11,10,8
"2011","Warwick 003A","E01031303","Total",47,21,16,10,6,1,3,2,41,20,13,8
"2011","Warwick 003B","E01031304","Total",37,12,13,12,6,1,3,2,31,11,10,10
"2011","Warwick 003C","E01031305","Total",8,6,2,0,0,0,0,0,8,6,2,0
"2011","Warwick 003D","E01031306","Total",27,10,8,9,2,1,1,0,25,9,7,9
"2011","Warwick 003E","E01031307","Total",15,3,7,5,3,0,3,0,12,3,4,5
"2011","Warwick 004A","E01031281","Total",17,7,6,4,3,0,3,0,14,7,3,4
"2011","Warwick 004B","E01031282","Total",25,10,7,8,1,0,1,0,24,10,6,8
"2011","Warwick 004C","E01031283","Total",19,11,4,4,2,0,1,1,17,11,3,3
"2011","Warwick 004D","E01031284","Total",21,4,13,4,4,0,4,0,17,4,9,4
"2011","Warwick 005A","E01031277","Total",29,13,8,8,3,0,3,0,26,13,5,8
"2011","Warwick 005B","E01031278","Total",18,9,5,4,3,1,0,2,15,8,5,2
"2011","Warwick 005C","E01031279","Total",28,18,7,3,2,1,1,0,26,17,6,3
"2011","Warwick 005D","E01031280","Total",18,5,9,4,2,0,2,0,16,5,7,4
"2011","Warwick 005E","E01031301","Total",21,10,6,5,1,1,0,0,20,9,6,5
"2011","Warwick 005F","E01031302","Total",27,8,12,7,2,1,1,0,25,7,11,7
"2011","Warwick 005G","E01031308","Total",25,10,10,5,4,1,3,0,21,9,7,5
"2011","Warwick 006A","E01031273","Total",86,29,15,42,21,2,7,12,65,27,8,30
"2011","Warwick 006B","E01031274","Total",87,35,16,36,7,1,3,3,80,34,13,33
"2011","Warwick 006C","E01031275","Total",18,5,6,7,0,0,0,0,18,5,6,7
"2011","Warwick 006D","E01031276","Total",72,24,18,30,9,1,5,3,63,23,13,27
"2011","Warwick 007B","E01031272","Total",31,8,14,9,6,0,6,0,25,8,8,9
"2011","Warwick 007C","E01031285","Total",21,6,11,4,4,0,1,3,17,6,10,1
"2011","Warwick 007D","E01031286","Total",34,15,13,6,6,0,5,1,28,15,8,5
"2011","Warwick 007E","E01031287","Total",24,9,11,4,2,0,2,0,22,9,9,4
"2011","Warwick 007F","E01031288","Total",19,9,6,4,1,0,1,0,18,9,5,4
"2011","Warwick 007G","E01031289","Total",29,18,6,5,0,0,0,0,29,18,6,5
"2011","Warwick 007H","E01033253","Total",23,6,13,4,5,0,4,1,18,6,9,3
"2011","Warwick 007I","E01033256","Total",15,7,4,4,0,0,0,0,15,7,4,4
"2011","Warwick 008A","E01031309","Total",61,21,19,21,7,1,3,3,54,20,16,18
"2011","Warwick 008B","E01031310","Total",25,7,9,9,3,0,2,1,22,7,7,8
"2011","Warwick 008C","E01031311","Total",47,21,9,17,7,1,4,2,40,20,5,15
"2011","Warwick 008D","E01031312","Total",53,21,14,18,8,1,6,1,45,20,8,17
"2011","Warwick 008E","E01031313","Total",21,6,13,2,3,0,3,0,18,6,10,2
"2011","Warwick 008F","E01031314","Total",21,8,9,4,5,0,4,1,16,8,5,3
"2011","Warwick 009A","E01031290","Total",32,10,12,10,8,1,6,1,24,9,6,9
"2011","Warwick 009B","E01031291","Total",26,8,10,8,7,1,5,1,19,7,5,7
"2011","Warwick 009C","E01031292","Total",44,13,22,9,6,0,6,0,38,13,16,9
"2011","Warwick 009D","E01031293","Total",51,16,18,17,8,1,7,0,43,15,11,17
"2011","Warwick 009E","E01031294","Total",27,12,9,6,6,1,5,0,21,11,4,6
"2011","Warwick 009F","E01031295","Total",6,1,4,1,1,0,1,0,5,1,3,1
"2011","Warwick 010A","E01031271","Total",30,7,5,18,1,1,0,0,29,6,5,18
"2011","Warwick 010B","E01031332","Total",65,22,9,34,6,1,3,2,59,21,6,32
"2011","Warwick 010C","E01031333","Total",35,13,7,15,4,0,2,2,31,13,5,13
"2011","Warwick 010D","E01031334","Total",62,25,22,15,9,2,5,2,53,23,17,13
"2011","Warwick 010E","E01031335","Total",20,2,11,7,2,0,2,0,18,2,9,7
"2011","Warwick 010F","E01031336","Total",33,7,13,13,6,1,4,1,27,6,9,12
"2011","Warwick 010G","E01031337","Total",57,22,20,15,4,0,2,2,53,22,18,13
"2011","Warwick 011A","E01031321","Total",55,16,6,33,4,0,1,3,51,16,5,30
"2011","Warwick 011B","E01031322","Total",45,14,16,15,7,2,3,2,38,12,13,13
"2011","Warwick 011C","E01031323","Total",36,14,14,8,5,0,4,1,31,14,10,7
"2011","Warwick 011D","E01031324","Total",64,17,32,15,9,2,7,0,55,15,25,15
"2011","Warwick 011E","E01031325","Total",70,29,14,27,6,1,3,2,64,28,11,25
"2011","Warwick 011G","E01033254","Total",47,20,16,11,5,1,4,0,42,19,12,11
"2011","Warwick 011H","E01033255","Total",42,13,16,13,4,0,2,2,38,13,14,11
"2011","Warwick 012A","E01031315","Total",81,34,32,15,8,1,6,1,73,33,26,14
"2011","Warwick 012B","E01031316","Total",29,9,14,6,5,0,5,0,24,9,9,6
"2011","Warwick 012C","E01031317","Total",22,5,12,5,3,0,1,2,19,5,11,3
"2011","Warwick 012D","E01031318","Total",35,11,19,5,2,0,2,0,33,11,17,5
"2011","Warwick 012E","E01031319","Total",47,17,19,11,4,0,3,1,43,17,16,10
"2011","Warwick 012F","E01031320","Total",28,14,10,4,5,0,5,0,23,14,5,4
"2011","Warwick 013A","E01031261","Total",55,18,9,28,6,0,3,3,49,18,6,25
"2011","Warwick 013B","E01031262","Total",52,17,13,22,3,1,1,1,49,16,12,21
"2011","Warwick 013C","E01031263","Total",49,21,10,18,4,1,2,1,45,20,8,17
"2011","Warwick 013D","E01031264","Total",77,20,18,39,7,1,2,4,70,19,16,35
"2011","Warwick 013E","E01031265","Total",65,22,12,31,7,0,2,5,58,22,10,26
"2011","Warwick 013F","E01031266","Total",43,13,15,15,8,3,3,2,35,10,12,13
"2011","Warwick 014A","E01031259","Total",25,11,9,5,1,0,1,0,24,11,8,5
"2011","Warwick 014B","E01031260","Total",36,20,11,5,4,2,2,0,32,18,9,5
"2011","Warwick 014C","E01031267","Total",21,8,11,2,3,1,2,0,18,7,9,2
"2011","Warwick 014D","E01031268","Total",78,38,30,10,9,2,7,0,69,36,23,10
"2011","Warwick 014E","E01031269","Total",39,16,17,6,7,0,4,3,32,16,13,3
"2011","Warwick 015A","E01031327","Total",66,28,17,21,7,3,4,0,59,25,13,21
"2011","Warwick 015B","E01031328","Total",58,24,18,16,6,0,6,0,52,24,12,16
"2011","Warwick 015C","E01031329","Total",93,34,34,25,14,0,11,3,79,34,23,22
"2011","Warwick 015D","E01031330","Total",43,19,12,12,4,1,1,2,39,18,11,10
"2011","Warwick 015E","E01031331","Total",39,17,20,2,1,0,1,0,38,17,19,2
"2011","Birmingham 001A","E01009417","Total",36,16,12,8,1,0,1,0,35,16,11,8
"2011","Birmingham 001B","E01009418","Total",65,23,15,27,2,0,1,1,63,23,14,26
"2011","Birmingham 001C","E01009419","Total",27,10,17,0,3,0,3,0,24,10,14,0
"2011","Birmingham 001D","E01009433","Total",33,7,19,7,8,0,8,0,25,7,11,7
"2011","Birmingham 002A","E01009415","Total",19,11,2,6,1,1,0,0,18,10,2,6
"2011","Birmingham 002B","E01009422","Total",31,6,17,8,4,0,4,0,27,6,13,8
"2011","Birmingham 002C","E01009423","Total",43,8,14,21,6,0,4,2,37,8,10,19
"2011","Birmingham 002D","E01009425","Total",39,13,11,15,7,0,2,5,32,13,9,10
"2011","Birmingham 003A","E01009416","Total",75,25,35,15,6,3,3,0,69,22,32,15
"2011","Birmingham 003B","E01009420","Total",42,13,19,10,1,0,1,0,41,13,18,10
"2011","Birmingham 003C","E01009426","Total",22,8,12,2,1,0,1,0,21,8,11,2
"2011","Birmingham 003D","E01009429","Total",19,2,15,2,1,0,0,1,18,2,15,1
"2011","Birmingham 003E","E01009431","Total",27,13,11,3,7,3,3,1,20,10,8,2
"2011","Birmingham 004A","E01009421","Total",8,2,6,0,0,0,0,0,8,2,6,0
"2011","Birmingham 004B","E01009424","Total",36,12,16,8,5,1,3,1,31,11,13,7
"2011","Birmingham 004C","E01009427","Total",30,6,13,11,3,0,3,0,27,6,10,11
"2011","Birmingham 004D","E01009428","Total",21,11,5,5,1,0,1,0,20,11,4,5
"2011","Birmingham 004E","E01009430","Total",14,7,5,2,1,0,1,0,13,7,4,2
"2011","Birmingham 004F","E01009468","Total",13,7,5,1,2,0,2,0,11,7,3,1
"2011","Birmingham 005A","E01009445","Total",130,38,36,56,10,2,6,2,120,36,30,54
"2011","Birmingham 005B","E01009446","Total",84,42,33,9,4,1,3,0,80,41,30,9
"2011","Birmingham 005C","E01009447","Total",47,16,19,12,5,0,4,1,42,16,15,11
"2011","Birmingham 005D","E01009448","Total",81,22,17,42,8,1,3,4,73,21,14,38
"2011","Birmingham 005E","E01009452","Total",48,14,20,14,5,0,3,2,43,14,17,12
"2011","Birmingham 005F","E01009455","Total",57,23,13,21,6,2,1,3,51,21,12,18
"2011","Birmingham 006A","E01009432","Total",70,9,16,45,6,0,4,2,64,9,12,43
"2011","Birmingham 006B","E01009435","Total",29,9,13,7,3,0,1,2,26,9,12,5
"2011","Birmingham 006C","E01009437","Total",39,12,20,7,7,1,4,2,32,11,16,5
"2011","Birmingham 006D","E01009444","Total",10,5,3,2,0,0,0,0,10,5,3,2
"2011","Birmingham 006E","E01009454","Total",34,12,17,5,2,0,2,0,32,12,15,5
"2011","Birmingham 007A","E01009221","Total",57,18,23,16,6,1,5,0,51,17,18,16
"2011","Birmingham 007B","E01009464","Total",17,7,2,8,3,1,0,2,14,6,2,6
"2011","Birmingham 007C","E01009465","Total",26,10,11,5,5,0,4,1,21,10,7,4
"2011","Birmingham 007D","E01009467","Total",38,8,17,13,3,0,1,2,35,8,16,11
"2011","Birmingham 008A","E01009220","Total",78,22,22,34,3,0,2,1,75,22,20,33
"2011","Birmingham 008B","E01009222","Total",107,29,22,56,2,1,1,0,105,28,21,56
"2011","Birmingham 008C","E01009224","Total",45,11,18,16,0,0,0,0,45,11,18,16
"2011","Birmingham 008D","E01009233","Total",97,16,20,61,6,2,4,0,91,14,16,61
"2011","Birmingham 009A","E01009449","Total",47,20,18,9,4,1,2,1,43,19,16,8
"2011","Birmingham 009B","E01009451","Total",41,11,20,10,6,0,4,2,35,11,16,8
"2011","Birmingham 009C","E01009453","Total",33,12,12,9,4,0,3,1,29,12,9,8
"2011","Birmingham 009D","E01009466","Total",20,3,14,3,4,0,4,0,16,3,10,3
"2011","Birmingham 009E","E01009471","Total",23,9,9,5,1,0,1,0,22,9,8,5
"2011","Birmingham 010A","E01009135","Total",21,6,10,5,1,0,1,0,20,6,9,5
"2011","Birmingham 010B","E01009469","Total",17,9,5,3,4,3,1,0,13,6,4,3
"2011","Birmingham 010C","E01009470","Total",8,4,3,1,1,1,0,0,7,3,3,1
"2011","Birmingham 010D","E01009472","Total",33,10,14,9,2,0,2,0,31,10,12,9
"2011","Birmingham 010E","E01009473","Total",50,13,20,17,3,0,3,0,47,13,17,17
"2011","Birmingham 010F","E01009474","Total",34,11,13,10,5,1,3,1,29,10,10,9
"2011","Birmingham 011A","E01009127","Total",121,35,17,69,10,0,6,4,111,35,11,65
"2011","Birmingham 011B","E01009128","Total",71,29,14,28,2,0,1,1,69,29,13,27
"2011","Birmingham 011C","E01009130","Total",83,22,13,48,6,0,3,3,77,22,10,45
"2011","Birmingham 011D","E01009131","Total",79,30,11,38,3,0,1,2,76,30,10,36
"2011","Birmingham 011E","E01009133","Total",92,24,19,49,4,1,2,1,88,23,17,48
"2011","Birmingham 011F","E01009134","Total",89,26,14,49,6,1,1,4,83,25,13,45
"2011","Birmingham 011G","E01009137","Total",89,17,16,56,6,0,2,4,83,17,14,52
"2011","Birmingham 012A","E01009434","Total",37,11,22,4,3,0,3,0,34,11,19,4
"2011","Birmingham 012B","E01009436","Total",8,4,3,1,0,0,0,0,8,4,3,1
"2011","Birmingham 012C","E01009438","Total",22,6,10,6,1,0,0,1,21,6,10,5
"2011","Birmingham 012D","E01009440","Total",22,5,9,8,2,0,1,1,20,5,8,7
"2011","Birmingham 012E","E01009450","Total",39,14,16,9,2,0,2,0,37,14,14,9
"2011","Birmingham 013A","E01009223","Total",47,13,18,16,3,0,1,2,44,13,17,14
"2011","Birmingham 013B","E01009225","Total",87,17,31,39,4,0,1,3,83,17,30,36
"2011","Birmingham 013C","E01009227","Total",51,27,13,11,4,0,2,2,47,27,11,9
"2011","Birmingham 013D","E01009228","Total",69,20,21,28,6,0,4,2,63,20,17,26
"2011","Birmingham 014A","E01009121","Total",151,52,38,61,13,0,5,8,138,52,33,53
"2011","Birmingham 014B","E01009122","Total",87,15,14,58,7,0,2,5,80,15,12,53
"2011","Birmingham 014C","E01009129","Total",110,27,27,56,14,2,6,6,96,25,21,50
"2011","Birmingham 014D","E01009132","Total",104,31,14,59,8,1,3,4,96,30,11,55
"2011","Birmingham 014E","E01009136","Total",61,11,15,35,5,0,3,2,56,11,12,33
"2011","Birmingham 015A","E01009457","Total",17,10,7,0,1,0,1,0,16,10,6,0
"2011","Birmingham 015B","E01009459","Total",22,12,7,3,2,1,1,0,20,11,6,3
"2011","Birmingham 015C","E01009461","Total",16,4,3,9,3,0,0,3,13,4,3,6
"2011","Birmingham 015D","E01009463","Total",20,7,12,1,4,1,3,0,16,6,9,1
"2011","Birmingham 016A","E01009235","Total",64,24,21,19,5,1,4,0,59,23,17,19
"2011","Birmingham 016B","E01009243","Total",53,18,16,19,5,0,1,4,48,18,15,15
"2011","Birmingham 016C","E01009245","Total",46,14,13,19,5,0,4,1,41,14,9,18
"2011","Birmingham 016D","E01009246","Total",54,17,25,12,4,0,2,2,50,17,23,10
"2011","Birmingham 016E","E01009247","Total",59,18,22,19,4,1,3,0,55,17,19,19
"2011","Birmingham 017A","E01009226","Total",87,28,25,34,4,0,3,1,83,28,22,33
"2011","Birmingham 017B","E01009229","Total",46,16,19,11,5,0,5,0,41,16,14,11
"2011","Birmingham 017C","E01009230","Total",46,14,17,15,6,1,3,2,40,13,14,13
"2011","Birmingham 017D","E01009231","Total",58,11,27,20,8,2,4,2,50,9,23,18
"2011","Birmingham 018A","E01009001","Total",54,20,15,19,4,0,3,1,50,20,12,18
"2011","Birmingham 018B","E01009003","Total",30,5,10,15,2,0,1,1,28,5,9,14
"2011","Birmingham 018C","E01009456","Total",28,9,9,10,3,0,1,2,25,9,8,8
"2011","Birmingham 018D","E01009458","Total",27,10,11,6,2,0,2,0,25,10,9,6
"2011","Birmingham 018E","E01009460","Total",47,14,20,13,10,1,5,4,37,13,15,9
"2011","Birmingham 018F","E01009462","Total",54,13,26,15,5,1,1,3,49,12,25,12
"2011","Birmingham 019A","E01009234","Total",84,21,32,31,8,0,5,3,76,21,27,28
"2011","Birmingham 019B","E01009236","Total",67,26,23,18,7,0,6,1,60,26,17,17
"2011","Birmingham 019C","E01009244","Total",57,17,26,14,3,0,3,0,54,17,23,14
"2011","Birmingham 019D","E01009248","Total",96,24,38,34,8,0,4,4,88,24,34,30
"2011","Birmingham 020A","E01009403","Total",89,21,15,53,5,0,1,4,84,21,14,49
"2011","Birmingham 020B","E01009404","Total",97,39,17,41,9,1,2,6,88,38,15,35
"2011","Birmingham 020C","E01009405","Total",62,29,15,18,2,0,2,0,60,29,13,18
"2011","Birmingham 020D","E01009406","Total",73,22,22,29,3,0,1,2,70,22,21,27
"2011","Birmingham 020E","E01009407","Total",89,25,16,48,6,1,4,1,83,24,12,47
"2011","Birmingham 021A","E01009439","Total",30,11,14,5,4,0,4,0,26,11,10,5
"2011","Birmingham 021B","E01009441","Total",52,25,16,11,3,0,2,1,49,25,14,10
"2011","Birmingham 021C","E01009442","Total",28,11,10,7,2,0,2,0,26,11,8,7
"2011","Birmingham 021D","E01009443","Total",39,16,17,6,4,0,2,2,35,16,15,4
"2011","Birmingham 022A","E01009123","Total",75,25,17,33,6,0,3,3,69,25,14,30
"2011","Birmingham 022B","E01009124","Total",199,51,28,120,10,3,3,4,189,48,25,116
"2011","Birmingham 022C","E01009125","Total",94,26,18,50,2,1,0,1,92,25,18,49
"2011","Birmingham 022D","E01009232","Total",65,24,24,17,3,0,3,0,62,24,21,17
"2011","Birmingham 023A","E01009002","Total",138,30,19,89,6,0,0,6,132,30,19,83
"2011","Birmingham 023C","E01009006","Total",60,17,20,23,3,0,1,2,57,17,19,21
"2011","Birmingham 023D","E01009007","Total",83,25,17,41,4,0,1,3,79,25,16,38
"2011","Birmingham 023F","E01033632","Total",143,37,21,85,12,2,2,8,131,35,19,77
"2011","Birmingham 024A","E01009237","Total",72,19,24,29,4,0,3,1,68,19,21,28
"2011","Birmingham 024B","E01009238","Total",33,8,12,13,5,0,3,2,28,8,9,11
"2011","Birmingham 024C","E01009240","Total",59,21,19,19,4,0,3,1,55,21,16,18
"2011","Birmingham 024D","E01009241","Total",57,17,23,17,4,0,3,1,53,17,20,16
"2011","Birmingham 024E","E01009242","Total",48,13,13,22,2,1,1,0,46,12,12,22
"2011","Birmingham 025A","E01009005","Total",38,11,16,11,4,0,4,0,34,11,12,11
"2011","Birmingham 025B","E01009009","Total",44,15,12,17,3,1,1,1,41,14,11,16
"2011","Birmingham 025C","E01009098","Total",82,23,20,39,5,0,4,1,77,23,16,38
"2011","Birmingham 025D","E01009100","Total",104,29,30,45,8,1,6,1,96,28,24,44
"2011","Birmingham 025E","E01009105","Total",35,7,12,16,2,1,1,0,33,6,11,16
"2011","Birmingham 026A","E01009126","Total",47,14,16,17,4,1,3,0,43,13,13,17
"2011","Birmingham 026B","E01009408","Total",86,23,21,42,1,0,1,0,85,23,20,42
"2011","Birmingham 026C","E01009409","Total",71,24,21,26,7,3,2,2,64,21,19,24
"2011","Birmingham 026D","E01009410","Total",76,21,23,32,3,0,2,1,73,21,21,31
"2011","Birmingham 028A","E01009008","Total",38,10,14,14,6,1,5,0,32,9,9,14
"2011","Birmingham 028B","E01009011","Total",55,20,21,14,4,1,3,0,51,19,18,14
"2011","Birmingham 028C","E01009012","Total",50,19,17,14,4,2,2,0,46,17,15,14
"2011","Birmingham 028D","E01009102","Total",87,32,13,42,5,0,2,3,82,32,11,39
"2011","Birmingham 028E","E01009104","Total",109,33,28,48,8,2,5,1,101,31,23,47
"2011","Birmingham 029A","E01009096","Total",73,27,17,29,8,3,5,0,65,24,12,29
"2011","Birmingham 029B","E01009097","Total",164,55,29,80,15,1,6,8,149,54,23,72
"2011","Birmingham 029C","E01009099","Total",173,59,36,78,6,0,2,4,167,59,34,74
"2011","Birmingham 029D","E01009101","Total",108,41,22,45,6,2,2,2,102,39,20,43
"2011","Birmingham 029E","E01009103","Total",116,43,19,54,3,0,0,3,113,43,19,51
"2011","Birmingham 029F","E01009106","Total",49,20,13,16,2,0,0,2,47,20,13,14
"2011","Birmingham 030A","E01008915","Total",69,23,12,34,5,0,2,3,64,23,10,31
"2011","Birmingham 030B","E01009411","Total",83,20,36,27,5,1,3,1,78,19,33,26
"2011","Birmingham 030C","E01009412","Total",64,18,20,26,7,1,5,1,57,17,15,25
"2011","Birmingham 030D","E01009413","Total",65,18,20,27,6,1,2,3,59,17,18,24
"2011","Birmingham 030E","E01009414","Total",92,26,30,36,8,1,3,4,84,25,27,32
"2011","Birmingham 031A","E01008998","Total",94,26,20,48,6,0,3,3,88,26,17,45
"2011","Birmingham 031B","E01008999","Total",44,16,13,15,2,0,2,0,42,16,11,15
"2011","Birmingham 031C","E01009000","Total",78,25,26,27,6,3,0,3,72,22,26,24
"2011","Birmingham 031D","E01009013","Total",68,14,26,28,6,2,1,3,62,12,25,25
"2011","Birmingham 031E","E01009400","Total",58,19,13,26,3,0,3,0,55,19,10,26
"2011","Birmingham 031F","E01009401","Total",90,20,34,36,9,2,5,2,81,18,29,34
"2011","Birmingham 031H","E01033630","Total",70,24,15,31,1,0,0,1,69,24,15,30
"2011","Birmingham 031I","E01033646","Total",77,20,17,40,9,1,0,8,68,19,17,32
"2011","Birmingham 032A","E01009049","Total",46,15,10,21,7,1,2,4,39,14,8,17
"2011","Birmingham 032B","E01009056","Total",86,25,24,37,7,0,3,4,79,25,21,33
"2011","Birmingham 032C","E01009263","Total",70,23,23,24,3,0,2,1,67,23,21,23
"2011","Birmingham 032D","E01009264","Total",47,10,16,21,4,2,1,1,43,8,15,20
"2011","Birmingham 032E","E01009265","Total",48,8,19,21,3,0,3,0,45,8,16,21
"2011","Birmingham 033A","E01009051","Total",54,11,13,30,5,0,0,5,49,11,13,25
"2011","Birmingham 033B","E01009053","Total",59,11,11,37,6,1,1,4,53,10,10,33
"2011","Birmingham 033C","E01009054","Total",21,4,6,11,3,0,1,2,18,4,5,9
"2011","Birmingham 033D","E01009058","Total",36,5,3,28,3,1,0,2,33,4,3,26
"2011","Birmingham 033E","E01009061","Total",43,5,8,30,8,1,3,4,35,4,5,26
"2011","Birmingham 033F","E01009239","Total",42,17,6,19,7,1,0,6,35,16,6,13
"2011","Birmingham 034A","E01009266","Total",80,23,30,27,1,0,1,0,79,23,29,27
"2011","Birmingham 034B","E01009269","Total",77,18,19,40,7,3,3,1,70,15,16,39
"2011","Birmingham 034C","E01009270","Total",104,23,25,56,9,1,3,5,95,22,22,51
"2011","Birmingham 034D","E01009271","Total",81,25,16,40,2,0,2,0,79,25,14,40
"2011","Birmingham 034E","E01009273","Total",41,9,8,24,2,1,0,1,39,8,8,23
"2011","Birmingham 035A","E01009050","Total",94,24,21,49,4,1,1,2,90,23,20,47
"2011","Birmingham 035D","E01009057","Total",83,12,13,58,9,0,0,9,74,12,13,49
"2011","Birmingham 035E","E01009059","Total",78,22,15,41,12,3,3,6,66,19,12,35
"2011","Birmingham 035F","E01009060","Total",48,12,11,25,4,0,2,2,44,12,9,23
"2011","Birmingham 035G","E01033621","Total",110,21,21,68,10,1,0,9,100,20,21,59
"2011","Birmingham 036A","E01009268","Total",23,6,6,11,4,0,2,2,19,6,4,9
"2011","Birmingham 036B","E01009272","Total",93,22,35,36,8,0,4,4,85,22,31,32
"2011","Birmingham 036C","E01009274","Total",95,22,23,50,13,3,2,8,82,19,21,42
"2011","Birmingham 036D","E01009349","Total",113,31,23,59,8,0,1,7,105,31,22,52
"2011","Birmingham 036E","E01009351","Total",98,27,24,47,7,2,1,4,91,25,23,43
"2011","Birmingham 036F","E01009354","Total",69,23,11,35,5,0,1,4,64,23,10,31
"2011","Birmingham 037A","E01008899","Total",65,14,14,37,8,0,2,6,57,14,12,31
"2011","Birmingham 037C","E01008901","Total",67,19,11,37,8,0,1,7,59,19,10,30
"2011","Birmingham 037E","E01008916","Total",63,11,12,40,5,1,1,3,58,10,11,37
"2011","Birmingham 037F","E01033636","Total",65,19,5,41,4,1,1,2,61,18,4,39
"2011","Birmingham 038A","E01009079","Total",136,39,18,79,15,2,4,9,121,37,14,70
"2011","Birmingham 038B","E01009080","Total",99,25,13,61,8,0,1,7,91,25,12,54
"2011","Birmingham 038C","E01009081","Total",92,19,17,56,6,1,2,3,86,18,15,53
"2011","Birmingham 038D","E01009083","Total",119,28,13,78,5,0,2,3,114,28,11,75
"2011","Birmingham 039A","E01009275","Total",64,18,19,27,7,3,2,2,57,15,17,25
"2011","Birmingham 039B","E01009350","Total",78,18,8,52,12,3,1,8,66,15,7,44
"2011","Birmingham 039C","E01009352","Total",55,11,9,35,4,1,2,1,51,10,7,34
"2011","Birmingham 039D","E01009353","Total",36,6,6,24,2,1,0,1,34,5,6,23
"2011","Birmingham 039E","E01009355","Total",56,17,9,30,6,2,0,4,50,15,9,26
"2011","Birmingham 039H","E01033635","Total",130,38,29,63,5,4,1,0,125,34,28,63
"2011","Birmingham 040A","E01008905","Total",38,9,5,24,4,1,0,3,34,8,5,21
"2011","Birmingham 040B","E01008907","Total",69,26,10,33,7,2,0,5,62,24,10,28
"2011","Birmingham 040C","E01009047","Total",59,13,6,40,8,2,2,4,51,11,4,36
"2011","Birmingham 040D","E01009048","Total",47,16,13,18,10,2,5,3,37,14,8,15
"2011","Birmingham 040E","E01009062","Total",59,13,12,34,2,0,0,2,57,13,12,32
"2011","Birmingham 041D","E01008909","Total",94,34,22,38,1,0,1,0,93,34,21,38
"2011","Birmingham 041F","E01033628","Total",83,28,12,43,9,3,1,5,74,25,11,38
"2011","Birmingham 041G","E01033637","Total",106,30,16,60,5,2,0,3,101,28,16,57
"2011","Birmingham 042A","E01009084","Total",45,8,12,25,1,0,0,1,44,8,12,24
"2011","Birmingham 042B","E01009085","Total",35,5,11,19,4,0,4,0,31,5,7,19
"2011","Birmingham 042C","E01009087","Total",27,6,9,12,5,0,4,1,22,6,5,11
"2011","Birmingham 042D","E01009089","Total",37,7,8,22,1,0,1,0,36,7,7,22
"2011","Birmingham 042E","E01009090","Total",40,12,7,21,3,1,1,1,37,11,6,20
"2011","Birmingham 043A","E01009201","Total",82,23,10,49,1,0,0,1,81,23,10,48
"2011","Birmingham 043B","E01009202","Total",121,37,20,64,11,5,2,4,110,32,18,60
"2011","Birmingham 043C","E01009203","Total",274,60,37,177,24,0,5,19,250,60,32,158
"2011","Birmingham 044A","E01009082","Total",81,30,20,31,8,1,5,2,73,29,15,29
"2011","Birmingham 044B","E01009086","Total",42,14,8,20,4,3,1,0,38,11,7,20
"2011","Birmingham 044C","E01009480","Total",83,20,15,48,5,1,3,1,78,19,12,47
"2011","Birmingham 044D","E01009481","Total",61,17,11,33,5,0,4,1,56,17,7,32
"2011","Birmingham 044E","E01009486","Total",48,14,7,27,6,2,3,1,42,12,4,26
"2011","Birmingham 044F","E01009487","Total",48,8,7,33,3,1,1,1,45,7,6,32
"2011","Birmingham 045A","E01009088","Total",57,20,17,20,5,1,4,0,52,19,13,20
"2011","Birmingham 045B","E01009091","Total",81,24,25,32,6,0,5,1,75,24,20,31
"2011","Birmingham 045C","E01009305","Total",132,38,25,69,19,0,7,12,113,38,18,57
"2011","Birmingham 045D","E01009307","Total",108,24,10,74,3,0,1,2,105,24,9,72
"2011","Birmingham 045E","E01009309","Total",94,29,6,59,6,0,2,4,88,29,4,55
"2011","Birmingham 046A","E01009304","Total",104,23,27,54,6,0,4,2,98,23,23,52
"2011","Birmingham 046B","E01009306","Total",87,22,18,47,4,0,2,2,83,22,16,45
"2011","Birmingham 046C","E01009308","Total",133,43,19,71,3,0,0,3,130,43,19,68
"2011","Birmingham 046D","E01009310","Total",133,42,21,70,7,0,2,5,126,42,19,65
"2011","Birmingham 047A","E01009348","Total",125,37,38,50,10,1,6,3,115,36,32,47
"2011","Birmingham 047B","E01009358","Total",73,19,20,34,5,2,0,3,68,17,20,31
"2011","Birmingham 047C","E01009359","Total",102,35,14,53,7,2,0,5,95,33,14,48
"2011","Birmingham 047D","E01009360","Total",185,55,47,83,9,1,0,8,176,54,47,75
"2011","Birmingham 047E","E01009361","Total",156,40,26,90,14,6,4,4,142,34,22,86
"2011","Birmingham 048A","E01009478","Total",85,21,13,51,5,0,1,4,80,21,12,47
"2011","Birmingham 048B","E01009479","Total",60,11,4,45,3,0,2,1,57,11,2,44
"2011","Birmingham 048C","E01009482","Total",47,10,5,32,3,0,0,3,44,10,5,29
"2011","Birmingham 048D","E01009484","Total",63,9,9,45,3,0,2,1,60,9,7,44
"2011","Birmingham 048E","E01009485","Total",54,10,11,33,8,1,2,5,46,9,9,28
"2011","Birmingham 049A","E01008906","Total",60,16,6,38,3,0,0,3,57,16,6,35
"2011","Birmingham 049B","E01008911","Total",157,34,23,100,14,2,4,8,143,32,19,92
"2011","Birmingham 049D","E01009347","Total",137,40,19,78,14,1,5,8,123,39,14,70
"2011","Birmingham 049E","E01033559","Total",24,10,7,7,1,0,1,0,23,10,6,7
"2011","Birmingham 049F","E01033638","Total",124,30,16,78,11,0,3,8,113,30,13,70
"2011","Birmingham 050A","E01008910","Total",115,19,20,76,10,0,2,8,105,19,18,68
"2011","Birmingham 050B","E01008913","Total",115,53,21,41,3,0,1,2,112,53,20,39
"2011","Birmingham 050C","E01008914","Total",151,37,21,93,17,1,6,10,134,36,15,83
"2011","Birmingham 050E","E01033561","Total",58,22,8,28,7,7,0,0,51,15,8,28
"2011","Birmingham 050F","E01033617","Total",6,0,0,6,0,0,0,0,6,0,0,6
"2011","Birmingham 051A","E01009194","Total",63,15,4,44,3,1,1,1,60,14,3,43
"2011","Birmingham 051B","E01009483","Total",57,15,2,40,5,3,0,2,52,12,2,38
"2011","Birmingham 051C","E01009488","Total",101,22,9,70,7,2,0,5,94,20,9,65
"2011","Birmingham 051D","E01009489","Total",61,12,7,42,7,2,2,3,54,10,5,39
"2011","Birmingham 051E","E01009491","Total",31,6,2,23,3,1,1,1,28,5,1,22
"2011","Birmingham 052B","E01009192","Total",50,11,7,32,5,0,1,4,45,11,6,28
"2011","Birmingham 052D","E01009199","Total",70,20,16,34,7,0,2,5,63,20,14,29
"2011","Birmingham 052E","E01009204","Total",133,30,18,85,18,1,4,13,115,29,14,72
"2011","Birmingham 052F","E01033644","Total",118,25,12,81,5,1,0,4,113,24,12,77
"2011","Birmingham 053A","E01009151","Total",76,26,8,42,5,4,0,1,71,22,8,41
"2011","Birmingham 053B","E01009152","Total",47,15,6,26,6,1,1,4,41,14,5,22
"2011","Birmingham 053C","E01009153","Total",105,29,20,56,12,4,4,4,93,25,16,52
"2011","Birmingham 053D","E01009345","Total",122,34,20,68,9,2,3,4,113,32,17,64
"2011","Birmingham 053E","E01009346","Total",79,21,12,46,11,1,4,6,68,20,8,40
"2011","Birmingham 054A","E01009092","Total",164,58,22,84,8,0,1,7,156,58,21,77
"2011","Birmingham 054B","E01009093","Total",132,37,14,81,6,2,2,2,126,35,12,79
"2011","Birmingham 054C","E01009094","Total",95,21,19,55,4,1,2,1,91,20,17,54
"2011","Birmingham 054D","E01009298","Total",137,38,26,73,14,0,4,10,123,38,22,63
"2011","Birmingham 054E","E01009311","Total",115,36,15,64,12,2,2,8,103,34,13,56
"2011","Birmingham 054F","E01009511","Total",85,21,16,48,6,1,3,2,79,20,13,46
"2011","Birmingham 055A","E01009475","Total",90,14,15,61,2,1,1,0,88,13,14,61
"2011","Birmingham 055B","E01009476","Total",46,13,6,27,4,1,2,1,42,12,4,26
"2011","Birmingham 055C","E01009477","Total",91,29,13,49,5,2,1,2,86,27,12,47
"2011","Birmingham 055D","E01009490","Total",84,21,8,55,10,3,2,5,74,18,6,50
"2011","Birmingham 055E","E01009492","Total",60,21,4,35,5,2,1,2,55,19,3,33
"2011","Birmingham 056A","E01009095","Total",59,17,18,24,2,0,0,2,57,17,18,22
"2011","Birmingham 056B","E01009507","Total",65,12,16,37,8,0,4,4,57,12,12,33
"2011","Birmingham 056C","E01009508","Total",51,16,14,21,2,1,1,0,49,15,13,21
"2011","Birmingham 056D","E01009509","Total",63,15,15,33,4,2,2,0,59,13,13,33
"2011","Birmingham 056E","E01009510","Total",74,15,16,43,9,2,3,4,65,13,13,39
"2011","Birmingham 057A","E01009297","Total",79,24,25,30,4,0,1,3,75,24,24,27
"2011","Birmingham 057B","E01009299","Total",104,31,23,50,5,0,2,3,99,31,21,47
"2011","Birmingham 057C","E01009300","Total",147,36,25,86,4,1,2,1,143,35,23,85
"2011","Birmingham 057D","E01009301","Total",101,24,18,59,9,3,2,4,92,21,16,55
"2011","Birmingham 057E","E01009303","Total",64,15,15,34,3,0,2,1,61,15,13,33
"2011","Birmingham 058A","E01009195","Total",82,19,10,53,7,3,0,4,75,16,10,49
"2011","Birmingham 058C","E01009197","Total",72,17,19,36,4,0,1,3,68,17,18,33
"2011","Birmingham 058D","E01009198","Total",71,16,5,50,8,2,1,5,63,14,4,45
"2011","Birmingham 058E","E01033647","Total",62,9,11,42,7,1,2,4,55,8,9,38
"2011","Birmingham 058F","E01033649","Total",61,18,13,30,5,0,3,2,56,18,10,28
"2011","Birmingham 060A","E01009138","Total",37,10,11,16,3,0,3,0,34,10,8,16
"2011","Birmingham 060B","E01009139","Total",49,16,17,16,2,0,2,0,47,16,15,16
"2011","Birmingham 060C","E01009140","Total",52,12,15,25,3,1,0,2,49,11,15,23
"2011","Birmingham 060D","E01009145","Total",61,14,20,27,11,2,8,1,50,12,12,26
"2011","Birmingham 060E","E01009147","Total",40,11,10,19,5,1,0,4,35,10,10,15
"2011","Birmingham 062A","E01009512","Total",87,26,22,39,10,0,7,3,77,26,15,36
"2011","Birmingham 062B","E01009514","Total",86,24,10,52,4,0,0,4,82,24,10,48
"2011","Birmingham 062C","E01009516","Total",55,18,14,23,3,1,2,0,52,17,12,23
"2011","Birmingham 062D","E01009517","Total",76,25,20,31,6,1,2,3,70,24,18,28
"2011","Birmingham 063A","E01009325","Total",74,22,5,47,1,0,0,1,73,22,5,46
"2011","Birmingham 063D","E01009342","Total",35,11,0,24,8,2,0,6,27,9,0,18
"2011","Birmingham 063E","E01009343","Total",69,10,13,46,4,1,2,1,65,9,11,45
"2011","Birmingham 063F","E01033642","Total",88,17,8,63,6,1,2,3,82,16,6,60
"2011","Birmingham 064A","E01008986","Total",57,10,19,28,3,1,2,0,54,9,17,28
"2011","Birmingham 064B","E01008987","Total",45,13,10,22,3,0,1,2,42,13,9,20
"2011","Birmingham 064C","E01008988","Total",25,5,11,9,3,0,2,1,22,5,9,8
"2011","Birmingham 064D","E01008989","Total",53,16,14,23,5,2,1,2,48,14,13,21
"2011","Birmingham 064E","E01008990","Total",10,1,4,5,3,0,2,1,7,1,2,4
"2011","Birmingham 064F","E01008991","Total",14,4,8,2,2,1,0,1,12,3,8,1
"2011","Birmingham 066A","E01008882","Total",94,17,25,52,5,1,2,2,89,16,23,50
"2011","Birmingham 066B","E01008896","Total",75,16,13,46,6,0,2,4,69,16,11,42
"2011","Birmingham 066C","E01008898","Total",86,24,16,46,5,0,1,4,81,24,15,42
"2011","Birmingham 066D","E01009326","Total",59,15,7,37,5,0,1,4,54,15,6,33
"2011","Birmingham 066E","E01009341","Total",83,15,14,54,9,1,3,5,74,14,11,49
"2011","Birmingham 066F","E01009513","Total",69,18,14,37,6,1,4,1,63,17,10,36
"2011","Birmingham 067A","E01008881","Total",62,17,18,27,2,0,1,1,60,17,17,26
"2011","Birmingham 067B","E01008897","Total",52,13,13,26,5,2,2,1,47,11,11,25
"2011","Birmingham 067C","E01009515","Total",36,11,17,8,3,1,2,0,33,10,15,8
"2011","Birmingham 067D","E01009518","Total",46,13,17,16,3,1,1,1,43,12,16,15
"2011","Birmingham 067E","E01009521","Total",45,16,14,15,6,0,4,2,39,16,10,13
"2011","Birmingham 069A","E01009302","Total",48,11,16,21,2,0,2,0,46,11,14,21
"2011","Birmingham 069B","E01009314","Total",76,24,17,35,6,0,2,4,70,24,15,31
"2011","Birmingham 069C","E01009321","Total",137,36,21,80,8,0,1,7,129,36,20,73
"2011","Birmingham 069D","E01009322","Total",81,19,15,47,11,1,2,8,70,18,13,39
"2011","Birmingham 069E","E01009323","Total",70,22,13,35,3,1,1,1,67,21,12,34
"2011","Birmingham 070A","E01009329","Total",57,14,6,37,2,1,0,1,55,13,6,36
"2011","Birmingham 070B","E01009334","Total",30,10,2,18,1,0,0,1,29,10,2,17
"2011","Birmingham 070C","E01009337","Total",36,9,3,24,2,0,1,1,34,9,2,23
"2011","Birmingham 070D","E01009338","Total",42,5,6,31,3,0,0,3,39,5,6,28
"2011","Birmingham 070E","E01009380","Total",63,18,4,41,3,3,0,0,60,15,4,41
"2011","Birmingham 071A","E01009362","Total",77,18,5,54,8,3,0,5,69,15,5,49
"2011","Birmingham 071B","E01009363","Total",51,13,9,29,8,2,3,3,43,11,6,26
"2011","Birmingham 071C","E01009364","Total",105,26,15,64,5,0,2,3,100,26,13,61
"2011","Birmingham 071D","E01009365","Total",55,18,4,33,7,3,1,3,48,15,3,30
"2011","Birmingham 071E","E01009379","Total",59,17,7,35,4,2,1,1,55,15,6,34
"2011","Birmingham 072A","E01009312","Total",35,8,14,13,4,1,1,2,31,7,13,11
"2011","Birmingham 072B","E01009324","Total",60,14,27,19,9,0,9,0,51,14,18,19
"2011","Birmingham 072C","E01009519","Total",38,10,20,8,4,0,4,0,34,10,16,8
"2011","Birmingham 072D","E01009520","Total",29,6,15,8,3,0,2,1,26,6,13,7
"2011","Birmingham 073A","E01009066","Total",8,4,2,2,3,0,2,1,5,4,0,1
"2011","Birmingham 073B","E01009070","Total",31,5,17,9,3,1,2,0,28,4,15,9
"2011","Birmingham 073C","E01009252","Total",21,6,7,8,0,0,0,0,21,6,7,8
"2011","Birmingham 073D","E01009260","Total",16,5,7,4,4,0,4,0,12,5,3,4
"2011","Birmingham 073E","E01009261","Total",43,11,18,14,2,0,2,0,41,11,16,14
"2011","Birmingham 074A","E01008984","Total",44,10,5,29,8,0,0,8,36,10,5,21
"2011","Birmingham 074B","E01008994","Total",28,10,8,10,3,0,2,1,25,10,6,9
"2011","Birmingham 074C","E01008996","Total",74,22,12,40,6,0,2,4,68,22,10,36
"2011","Birmingham 074D","E01008997","Total",36,8,11,17,3,0,3,0,33,8,8,17
"2011","Birmingham 075A","E01009065","Total",31,9,16,6,3,0,2,1,28,9,14,5
"2011","Birmingham 075B","E01009067","Total",21,6,14,1,1,0,1,0,20,6,13,1
"2011","Birmingham 075C","E01009068","Total",29,6,11,12,5,1,3,1,24,5,8,11
"2011","Birmingham 075D","E01009069","Total",32,9,13,10,2,0,2,0,30,9,11,10
"2011","Birmingham 075E","E01009072","Total",35,6,18,11,2,0,2,0,33,6,16,11
"2011","Birmingham 076A","E01008885","Total",52,16,22,14,5,0,4,1,47,16,18,13
"2011","Birmingham 076B","E01008886","Total",67,29,19,19,2,1,0,1,65,28,19,18
"2011","Birmingham 076C","E01008888","Total",42,20,14,8,5,1,3,1,37,19,11,7
"2011","Birmingham 076D","E01009313","Total",56,28,6,22,2,2,0,0,54,26,6,22
"2011","Birmingham 077A","E01009368","Total",39,11,3,25,7,1,1,5,32,10,2,20
"2011","Birmingham 077D","E01009371","Total",62,10,4,48,2,1,0,1,60,9,4,47
"2011","Birmingham 077E","E01009397","Total",75,13,10,52,2,0,0,2,73,13,10,50
"2011","Birmingham 077F","E01033650","Total",55,8,6,41,4,0,0,4,51,8,6,37
"2011","Birmingham 078A","E01008883","Total",69,20,9,40,0,0,0,0,69,20,9,40
"2011","Birmingham 078B","E01008884","Total",109,28,17,64,9,0,2,7,100,28,15,57
"2011","Birmingham 078C","E01008887","Total",82,20,20,42,9,0,5,4,73,20,15,38
"2011","Birmingham 078D","E01008889","Total",47,14,9,24,7,1,2,4,40,13,7,20
"2011","Birmingham 079A","E01008982","Total",27,5,8,14,2,0,2,0,25,5,6,14
"2011","Birmingham 079C","E01008992","Total",10,3,7,0,2,2,0,0,8,1,7,0
"2011","Birmingham 079E","E01009283","Total",33,10,13,10,3,0,2,1,30,10,11,9
"2011","Birmingham 079F","E01033631","Total",9,1,5,3,1,0,0,1,8,1,5,2
"2011","Birmingham 080A","E01009249","Total",64,24,11,29,5,1,3,1,59,23,8,28
"2011","Birmingham 080B","E01009250","Total",68,21,20,27,6,1,4,1,62,20,16,26
"2011","Birmingham 080C","E01009251","Total",31,9,16,6,1,0,1,0,30,9,15,6
"2011","Birmingham 080D","E01009253","Total",60,13,18,29,6,0,3,3,54,13,15,26
"2011","Birmingham 080E","E01009255","Total",88,31,19,38,6,2,2,2,82,29,17,36
"2011","Birmingham 080F","E01009257","Total",75,14,16,45,5,0,3,2,70,14,13,43
"2011","Birmingham 081A","E01009315","Total",45,13,13,19,3,0,2,1,42,13,11,18
"2011","Birmingham 081B","E01009316","Total",61,21,17,23,7,1,4,2,54,20,13,21
"2011","Birmingham 081C","E01009317","Total",104,19,25,60,13,0,6,7,91,19,19,53
"2011","Birmingham 081D","E01009318","Total",42,13,12,17,2,0,1,1,40,13,11,16
"2011","Birmingham 081E","E01009319","Total",29,9,12,8,3,0,3,0,26,9,9,8
"2011","Birmingham 081F","E01009320","Total",26,5,6,15,1,0,0,1,25,5,6,14
"2011","Birmingham 082A","E01009372","Total",37,6,3,28,1,0,0,1,36,6,3,27
"2011","Birmingham 082B","E01009373","Total",53,7,6,40,3,0,1,2,50,7,5,38
"2011","Birmingham 082D","E01009396","Total",28,7,2,19,3,1,1,1,25,6,1,18
"2011","Birmingham 082F","E01033643","Total",96,18,9,69,2,2,0,0,94,16,9,69
"2011","Birmingham 083A","E01009367","Total",34,10,5,19,2,1,0,1,32,9,5,18
"2011","Birmingham 083B","E01009375","Total",59,16,9,34,4,0,1,3,55,16,8,31
"2011","Birmingham 083C","E01009377","Total",72,13,9,50,7,0,0,7,65,13,9,43
"2011","Birmingham 083D","E01009383","Total",25,10,4,11,4,1,0,3,21,9,4,8
"2011","Birmingham 083E","E01009399","Total",50,8,5,37,0,0,0,0,50,8,5,37
"2011","Birmingham 084A","E01009366","Total",50,9,14,27,4,0,2,2,46,9,12,25
"2011","Birmingham 084B","E01009374","Total",53,23,5,25,3,0,0,3,50,23,5,22
"2011","Birmingham 084C","E01009376","Total",72,17,14,41,9,2,4,3,63,15,10,38
"2011","Birmingham 084F","E01033648","Total",95,20,17,58,9,0,0,9,86,20,17,49
"2011","Birmingham 085A","E01009073","Total",202,37,30,135,11,2,1,8,191,35,29,127
"2011","Birmingham 085B","E01009074","Total",124,25,33,66,16,2,4,10,108,23,29,56
"2011","Birmingham 085C","E01009254","Total",62,16,17,29,3,1,0,2,59,15,17,27
"2011","Birmingham 085D","E01009256","Total",75,12,23,40,7,0,5,2,68,12,18,38
"2011","Birmingham 085E","E01009258","Total",110,28,16,66,8,0,4,4,102,28,12,62
"2011","Birmingham 087B","E01009071","Total",38,5,14,19,5,2,2,1,33,3,12,18
"2011","Birmingham 087C","E01009075","Total",52,11,9,32,4,0,0,4,48,11,9,28
"2011","Birmingham 087E","E01009078","Total",36,7,17,12,2,0,2,0,34,7,15,12
"2011","Birmingham 087F","E01033562","Total",65,18,14,33,8,0,4,4,57,18,10,29
"2011","Birmingham 088C","E01009183","Total",19,5,8,6,1,0,0,1,18,5,8,5
"2011","Birmingham 088D","E01009186","Total",34,9,8,17,10,3,2,5,24,6,6,12
"2011","Birmingham 088E","E01033645","Total",82,17,13,52,9,2,3,4,73,15,10,48
"2011","Birmingham 089A","E01008890","Total",57,19,13,25,5,2,2,1,52,17,11,24
"2011","Birmingham 089B","E01008891","Total",49,19,11,19,5,1,1,3,44,18,10,16
"2011","Birmingham 089C","E01008892","Total",79,26,18,35,6,0,3,3,73,26,15,32
"2011","Birmingham 089D","E01008893","Total",46,9,18,19,4,0,4,0,42,9,14,19
"2011","Birmingham 089E","E01008894","Total",24,5,7,12,2,1,0,1,22,4,7,11
"2011","Birmingham 089F","E01008895","Total",63,19,25,19,5,1,4,0,58,18,21,19
"2011","Birmingham 089G","E01009015","Total",52,15,14,23,9,2,4,3,43,13,10,20
"2011","Birmingham 090A","E01009014","Total",87,33,14,40,4,0,3,1,83,33,11,39
"2011","Birmingham 090B","E01009018","Total",56,13,16,27,3,1,0,2,53,12,16,25
"2011","Birmingham 090C","E01009026","Total",128,42,17,69,7,0,3,4,121,42,14,65
"2011","Birmingham 090D","E01009028","Total",94,25,14,55,3,0,1,2,91,25,13,53
"2011","Birmingham 090E","E01009029","Total",68,10,16,42,2,0,0,2,66,10,16,40
"2011","Birmingham 092A","E01009182","Total",35,11,7,17,7,1,2,4,28,10,5,13
"2011","Birmingham 092B","E01009184","Total",23,5,7,11,3,0,2,1,20,5,5,10
"2011","Birmingham 092C","E01009187","Total",24,7,7,10,0,0,0,0,24,7,7,10
"2011","Birmingham 092D","E01009188","Total",28,8,13,7,3,0,3,0,25,8,10,7
"2011","Birmingham 092E","E01009384","Total",61,16,13,32,4,0,4,0,57,16,9,32
"2011","Birmingham 092F","E01009385","Total",26,5,5,16,2,1,1,0,24,4,4,16
"2011","Birmingham 093A","E01009185","Total",16,4,10,2,4,0,4,0,12,4,6,2
"2011","Birmingham 093B","E01009389","Total",19,4,6,9,3,0,0,3,16,4,6,6
"2011","Birmingham 093C","E01009390","Total",42,6,6,30,1,0,0,1,41,6,6,29
"2011","Birmingham 093D","E01009394","Total",23,5,8,10,3,1,1,1,20,4,7,9
"2011","Birmingham 094A","E01008918","Total",95,27,23,45,6,1,3,2,89,26,20,43
"2011","Birmingham 094B","E01008920","Total",54,11,23,20,3,0,3,0,51,11,20,20
"2011","Birmingham 094C","E01008921","Total",66,14,16,36,7,1,5,1,59,13,11,35
"2011","Birmingham 094D","E01008931","Total",106,31,25,50,5,0,2,3,101,31,23,47
"2011","Birmingham 094E","E01009259","Total",121,26,15,80,11,3,1,7,110,23,14,73
"2011","Birmingham 095A","E01008919","Total",86,22,24,40,8,1,4,3,78,21,20,37
"2011","Birmingham 095B","E01009064","Total",68,14,20,34,3,0,1,2,65,14,19,32
"2011","Birmingham 095C","E01009077","Total",59,11,18,30,2,0,1,1,57,11,17,29
"2011","Birmingham 095D","E01009291","Total",83,18,24,41,8,0,3,5,75,18,21,36
"2011","Birmingham 095E","E01009500","Total",97,20,22,55,2,0,2,0,95,20,20,55
"2011","Birmingham 096A","E01009284","Total",40,9,10,21,1,0,0,1,39,9,10,20
"2011","Birmingham 096C","E01009286","Total",12,1,2,9,1,0,1,0,11,1,1,9
"2011","Birmingham 096E","E01009289","Total",22,11,3,8,0,0,0,0,22,11,3,8
"2011","Birmingham 096F","E01009290","Total",5,1,1,3,1,0,0,1,4,1,1,2
"2011","Birmingham 096G","E01033634","Total",35,5,7,23,2,1,1,0,33,4,6,23
"2011","Birmingham 097A","E01009017","Total",36,16,3,17,3,3,0,0,33,13,3,17
"2011","Birmingham 097B","E01009043","Total",60,14,15,31,7,0,3,4,53,14,12,27
"2011","Birmingham 097C","E01009044","Total",41,10,8,23,4,0,0,4,37,10,8,19
"2011","Birmingham 097D","E01009045","Total",49,12,12,25,5,2,2,1,44,10,10,24
"2011","Birmingham 097E","E01009046","Total",22,8,7,7,0,0,0,0,22,8,7,7
"2011","Birmingham 097F","E01009395","Total",42,13,6,23,1,1,0,0,41,12,6,23
"2011","Birmingham 098A","E01009016","Total",45,20,9,16,2,1,1,0,43,19,8,16
"2011","Birmingham 098B","E01009022","Total",70,18,14,38,3,0,1,2,67,18,13,36
"2011","Birmingham 098C","E01009023","Total",55,19,18,18,3,0,2,1,52,19,16,17
"2011","Birmingham 098D","E01009030","Total",28,11,5,12,4,0,2,2,24,11,3,10
"2011","Birmingham 099A","E01009281","Total",31,9,10,12,2,0,2,0,29,9,8,12
"2011","Birmingham 099B","E01009292","Total",28,13,11,4,3,0,2,1,25,13,9,3
"2011","Birmingham 099C","E01009294","Total",84,17,19,48,8,1,2,5,76,16,17,43
"2011","Birmingham 099D","E01009295","Total",30,4,10,16,1,0,1,0,29,4,9,16
"2011","Birmingham 100A","E01009280","Total",50,16,19,15,3,0,3,0,47,16,16,15
"2011","Birmingham 100B","E01009282","Total",38,12,8,18,4,1,1,2,34,11,7,16
"2011","Birmingham 100C","E01009288","Total",17,7,6,4,5,2,2,1,12,5,4,3
"2011","Birmingham 100D","E01009293","Total",28,9,8,11,5,1,4,0,23,8,4,11
"2011","Birmingham 100E","E01009296","Total",38,7,12,19,1,0,0,1,37,7,12,18
"2011","Birmingham 101A","E01008924","Total",39,16,9,14,4,0,2,2,35,16,7,12
"2011","Birmingham 101B","E01009501","Total",122,36,16,70,10,2,3,5,112,34,13,65
"2011","Birmingham 101C","E01009502","Total",88,24,15,49,3,1,0,2,85,23,15,47
"2011","Birmingham 101D","E01009503","Total",94,26,17,51,3,0,0,3,91,26,17,48
"2011","Birmingham 101E","E01009505","Total",97,16,22,59,10,3,0,7,87,13,22,52
"2011","Birmingham 102A","E01008917","Total",49,22,12,15,3,0,2,1,46,22,10,14
"2011","Birmingham 102B","E01008923","Total",91,29,18,44,3,0,1,2,88,29,17,42
"2011","Birmingham 102C","E01008925","Total",36,8,14,14,3,0,2,1,33,8,12,13
"2011","Birmingham 102D","E01008927","Total",98,27,16,55,8,1,5,2,90,26,11,53
"2011","Birmingham 102E","E01008928","Total",89,28,19,42,7,0,2,5,82,28,17,37
"2011","Birmingham 103A","E01009019","Total",91,41,9,41,7,4,2,1,84,37,7,40
"2011","Birmingham 103B","E01009020","Total",56,19,9,28,1,0,1,0,55,19,8,28
"2011","Birmingham 103C","E01009021","Total",103,31,23,49,7,2,1,4,96,29,22,45
"2011","Birmingham 103D","E01009024","Total",91,32,10,49,2,0,0,2,89,32,10,47
"2011","Birmingham 103E","E01009025","Total",81,28,18,35,10,1,4,5,71,27,14,30
"2011","Birmingham 103F","E01009033","Total",96,24,19,53,8,2,4,2,88,22,15,51
"2011","Birmingham 104A","E01009175","Total",43,10,20,13,6,1,4,1,37,9,16,12
"2011","Birmingham 104B","E01009177","Total",37,13,17,7,3,0,3,0,34,13,14,7
"2011","Birmingham 104C","E01009178","Total",65,18,22,25,5,0,3,2,60,18,19,23
"2011","Birmingham 104D","E01009179","Total",26,5,13,8,2,0,1,1,24,5,12,7
"2011","Birmingham 104E","E01009189","Total",42,12,13,17,5,0,5,0,37,12,8,17
"2011","Birmingham 105A","E01008933","Total",61,19,13,29,1,0,0,1,60,19,13,28
"2011","Birmingham 105B","E01008934","Total",30,10,12,8,0,0,0,0,30,10,12,8
"2011","Birmingham 105C","E01009031","Total",19,3,8,8,1,0,1,0,18,3,7,8
"2011","Birmingham 105D","E01009037","Total",33,10,15,8,2,0,2,0,31,10,13,8
"2011","Birmingham 105E","E01009176","Total",44,15,9,20,7,2,2,3,37,13,7,17
"2011","Birmingham 106C","E01008929","Total",86,17,14,55,3,0,0,3,83,17,14,52
"2011","Birmingham 106D","E01008930","Total",80,23,21,36,9,0,6,3,71,23,15,33
"2011","Birmingham 106E","E01009495","Total",85,13,8,64,8,0,0,8,77,13,8,56
"2011","Birmingham 106F","E01033629","Total",147,50,27,70,7,2,3,2,140,48,24,68
"2011","Birmingham 107A","E01008953","Total",62,16,15,31,3,0,1,2,59,16,14,29
"2011","Birmingham 107B","E01008963","Total",58,15,21,22,1,0,1,0,57,15,20,22
"2011","Birmingham 107C","E01008964","Total",56,23,11,22,5,1,1,3,51,22,10,19
"2011","Birmingham 107D","E01008965","Total",33,9,15,9,2,0,0,2,31,9,15,7
"2011","Birmingham 107E","E01008966","Total",90,18,26,46,13,0,6,7,77,18,20,39
"2011","Birmingham 108A","E01009032","Total",34,10,10,14,3,1,2,0,31,9,8,14
"2011","Birmingham 108B","E01009034","Total",27,6,11,10,1,0,0,1,26,6,11,9
"2011","Birmingham 108C","E01009035","Total",61,22,12,27,2,0,2,0,59,22,10,27
"2011","Birmingham 108D","E01009036","Total",23,5,7,11,3,0,3,0,20,5,4,11
"2011","Birmingham 109A","E01009494","Total",158,32,31,95,9,1,5,3,149,31,26,92
"2011","Birmingham 109B","E01009496","Total",35,11,12,12,1,0,1,0,34,11,11,12
"2011","Birmingham 109C","E01009497","Total",66,21,22,23,15,2,4,9,51,19,18,14
"2011","Birmingham 109D","E01009504","Total",32,6,10,16,4,0,3,1,28,6,7,15
"2011","Birmingham 109E","E01009506","Total",26,8,8,10,4,1,2,1,22,7,6,9
"2011","Birmingham 110A","E01008967","Total",34,15,13,6,7,3,4,0,27,12,9,6
"2011","Birmingham 110B","E01008968","Total",29,8,12,9,6,0,5,1,23,8,7,8
"2011","Birmingham 110C","E01008970","Total",103,24,22,57,5,0,4,1,98,24,18,56
"2011","Birmingham 110D","E01008981","Total",19,4,10,5,3,0,1,2,16,4,9,3
"2011","Birmingham 111A","E01008932","Total",67,18,10,39,2,0,0,2,65,18,10,37
"2011","Birmingham 111B","E01008935","Total",92,29,12,51,4,0,0,4,88,29,12,47
"2011","Birmingham 111C","E01008936","Total",52,12,13,27,6,0,6,0,46,12,7,27
"2011","Birmingham 111D","E01008938","Total",80,23,9,48,10,2,1,7,70,21,8,41
"2011","Birmingham 111E","E01008939","Total",71,20,12,39,5,1,0,4,66,19,12,35
"2011","Birmingham 112A","E01008951","Total",44,16,16,12,4,0,2,2,40,16,14,10
"2011","Birmingham 112B","E01008952","Total",63,15,24,24,2,0,1,1,61,15,23,23
"2011","Birmingham 112C","E01008955","Total",39,14,15,10,1,0,1,0,38,14,14,10
"2011","Birmingham 112D","E01008956","Total",40,10,19,11,3,1,1,1,37,9,18,10
"2011","Birmingham 112E","E01008957","Total",77,23,26,28,6,0,4,2,71,23,22,26
"2011","Birmingham 113A","E01008950","Total",37,9,16,12,2,0,0,2,35,9,16,10
"2011","Birmingham 113B","E01008954","Total",35,15,8,12,3,1,2,0,32,14,6,12
"2011","Birmingham 113C","E01008958","Total",73,24,16,33,4,0,2,2,69,24,14,31
"2011","Birmingham 113D","E01009493","Total",93,23,14,56,6,3,3,0,87,20,11,56
"2011","Birmingham 115A","E01008937","Total",55,13,12,30,2,0,2,0,53,13,10,30
"2011","Birmingham 115B","E01008940","Total",112,27,22,63,10,0,3,7,102,27,19,56
"2011","Birmingham 115C","E01008941","Total",93,27,16,50,7,2,0,5,86,25,16,45
"2011","Birmingham 115D","E01008944","Total",86,23,18,45,5,1,4,0,81,22,14,45
"2011","Birmingham 116A","E01008959","Total",76,27,27,22,2,0,1,1,74,27,26,21
"2011","Birmingham 116B","E01008960","Total",55,20,29,6,9,0,9,0,46,20,20,6
"2011","Birmingham 116C","E01008961","Total",42,13,18,11,7,0,6,1,35,13,12,10
"2011","Birmingham 116D","E01008962","Total",146,22,29,95,14,1,4,9,132,21,25,86
"2011","Birmingham 117A","E01008942","Total",99,34,20,45,6,1,2,3,93,33,18,42
"2011","Birmingham 117B","E01008943","Total",79,17,31,31,4,0,3,1,75,17,28,30
"2011","Birmingham 117C","E01008969","Total",37,18,11,8,6,1,3,2,31,17,8,6
"2011","Birmingham 117D","E01008971","Total",76,30,23,23,6,0,6,0,70,30,17,23
"2011","Birmingham 118A","E01008972","Total",109,41,22,46,12,2,6,4,97,39,16,42
"2011","Birmingham 118B","E01008973","Total",78,27,31,20,6,0,6,0,72,27,25,20
"2011","Birmingham 118C","E01008974","Total",110,24,33,53,7,1,4,2,103,23,29,51
"2011","Birmingham 118D","E01008975","Total",38,18,16,4,3,0,2,1,35,18,14,3
"2011","Birmingham 119A","E01009172","Total",76,20,17,39,5,0,4,1,71,20,13,38
"2011","Birmingham 119B","E01009173","Total",105,28,14,63,14,1,3,10,91,27,11,53
"2011","Birmingham 119C","E01009174","Total",78,22,17,39,10,4,5,1,68,18,12,38
"2011","Birmingham 119D","E01009498","Total",109,23,19,67,10,0,2,8,99,23,17,59
"2011","Birmingham 119E","E01009499","Total",109,48,18,43,8,1,2,5,101,47,16,38
"2011","Birmingham 120A","E01009205","Total",37,16,14,7,4,1,3,0,33,15,11,7
"2011","Birmingham 120B","E01009206","Total",44,7,17,20,4,0,4,0,40,7,13,20
"2011","Birmingham 120C","E01009211","Total",30,10,13,7,3,1,1,1,27,9,12,6
"2011","Birmingham 120D","E01009218","Total",18,6,6,6,4,0,3,1,14,6,3,5
"2011","Birmingham 120E","E01009219","Total",98,41,16,41,2,0,2,0,96,41,14,41
"2011","Birmingham 121A","E01008976","Total",78,18,17,43,4,0,1,3,74,18,16,40
"2011","Birmingham 121B","E01008978","Total",134,28,18,88,23,5,1,17,111,23,17,71
"2011","Birmingham 121C","E01008979","Total",88,27,13,48,10,2,3,5,78,25,10,43
"2011","Birmingham 121D","E01008980","Total",89,30,17,42,8,0,2,6,81,30,15,36
"2011","Birmingham 122A","E01008945","Total",88,33,19,36,6,0,4,2,82,33,15,34
"2011","Birmingham 122B","E01008946","Total",42,18,16,8,8,1,4,3,34,17,12,5
"2011","Birmingham 122C","E01008947","Total",53,16,19,18,4,1,2,1,49,15,17,17
"2011","Birmingham 122D","E01008948","Total",39,15,12,12,5,2,1,2,34,13,11,10
"2011","Birmingham 122E","E01008949","Total",34,10,17,7,3,0,3,0,31,10,14,7
"2011","Birmingham 123A","E01008977","Total",66,19,17,30,6,0,3,3,60,19,14,27
"2011","Birmingham 123B","E01009109","Total",167,40,24,103,13,2,3,8,154,38,21,95
"2011","Birmingham 123C","E01009119","Total",50,18,15,17,6,1,3,2,44,17,12,15
"2011","Birmingham 123D","E01009120","Total",67,20,14,33,5,0,3,2,62,20,11,31
"2011","Birmingham 124A","E01009162","Total",65,18,11,36,5,2,1,2,60,16,10,34
"2011","Birmingham 124B","E01009207","Total",34,6,17,11,6,0,5,1,28,6,12,10
"2011","Birmingham 124C","E01009208","Total",36,7,19,10,4,0,4,0,32,7,15,10
"2011","Birmingham 124D","E01009209","Total",111,41,31,39,8,0,5,3,103,41,26,36
"2011","Birmingham 124E","E01009213","Total",42,9,14,19,4,0,2,2,38,9,12,17
"2011","Birmingham 125B","E01009155","Total",61,13,11,37,2,0,1,1,59,13,10,36
"2011","Birmingham 125D","E01009157","Total",86,17,13,56,10,0,2,8,76,17,11,48
"2011","Birmingham 125E","E01009160","Total",143,38,20,85,9,1,3,5,134,37,17,80
"2011","Birmingham 125F","E01009161","Total",60,19,20,21,6,2,4,0,54,17,16,21
"2011","Birmingham 125G","E01033633","Total",120,33,17,70,7,2,0,5,113,31,17,65
"2011","Birmingham 126A","E01009117","Total",170,40,19,111,13,1,3,9,157,39,16,102
"2011","Birmingham 126B","E01009210","Total",101,23,19,59,7,0,3,4,94,23,16,55
"2011","Birmingham 126C","E01009212","Total",97,32,16,49,6,0,2,4,91,32,14,45
"2011","Birmingham 126D","E01009214","Total",117,40,23,54,5,1,0,4,112,39,23,50
"2011","Birmingham 126E","E01009215","Total",116,28,24,64,9,2,2,5,107,26,22,59
"2011","Birmingham 127A","E01009108","Total",43,15,11,17,4,0,1,3,39,15,10,14
"2011","Birmingham 127B","E01009111","Total",56,19,21,16,4,0,4,0,52,19,17,16
"2011","Birmingham 127C","E01009112","Total",71,22,21,28,9,4,1,4,62,18,20,24
"2011","Birmingham 127D","E01009116","Total",12,1,7,4,2,0,1,1,10,1,6,3
"2011","Birmingham 127E","E01009118","Total",56,10,20,26,7,0,5,2,49,10,15,24
"2011","Birmingham 128A","E01009107","Total",161,34,22,105,7,0,0,7,154,34,22,98
"2011","Birmingham 128B","E01009110","Total",94,23,20,51,7,3,3,1,87,20,17,50
"2011","Birmingham 128C","E01009113","Total",89,16,15,58,11,2,2,7,78,14,13,51
"2011","Birmingham 128D","E01009114","Total",79,17,22,40,8,0,3,5,71,17,19,35
"2011","Birmingham 128E","E01009115","Total",68,15,10,43,4,0,0,4,64,15,10,39
"2011","Birmingham 129A","E01009158","Total",111,37,30,44,4,1,3,0,107,36,27,44
"2011","Birmingham 129B","E01009163","Total",95,25,18,52,5,1,2,2,90,24,16,50
"2011","Birmingham 129C","E01009165","Total",75,19,22,34,6,1,3,2,69,18,19,32
"2011","Birmingham 129D","E01009169","Total",69,20,25,24,7,0,6,1,62,20,19,23
"2011","Birmingham 130A","E01009159","Total",74,17,30,27,15,3,9,3,59,14,21,24
"2011","Birmingham 130B","E01009164","Total",62,18,18,26,6,1,3,2,56,17,15,24
"2011","Birmingham 130C","E01009167","Total",59,23,13,23,3,1,2,0,56,22,11,23
"2011","Birmingham 130D","E01009171","Total",79,16,24,39,9,2,6,1,70,14,18,38
"2011","Birmingham 131A","E01009166","Total",74,21,18,35,3,0,3,0,71,21,15,35
"2011","Birmingham 131B","E01009168","Total",47,17,11,19,5,2,1,2,42,15,10,17
"2011","Birmingham 131C","E01009170","Total",42,20,12,10,1,0,1,0,41,20,11,10
"2011","Birmingham 131D","E01009216","Total",87,23,26,38,4,0,3,1,83,23,23,37
"2011","Birmingham 131E","E01009217","Total",45,14,19,12,4,1,1,2,41,13,18,10
"2011","Birmingham 132A","E01009039","Total",28,11,11,6,3,0,2,1,25,11,9,5
"2011","Birmingham 132B","E01009040","Total",27,7,8,12,3,0,0,3,24,7,8,9
"2011","Birmingham 132C","E01009041","Total",39,16,14,9,3,0,3,0,36,16,11,9
"2011","Birmingham 132D","E01009042","Total",57,23,10,24,1,0,1,0,56,23,9,24
"2011","Birmingham 132E","E01032589","Total",43,16,7,20,2,0,1,1,41,16,6,19
"2011","Birmingham 133A","E01009262","Total",31,8,17,6,6,1,4,1,25,7,13,5
"2011","Birmingham 133B","E01009267","Total",28,7,7,14,2,0,1,1,26,7,6,13
"2011","Birmingham 133C","E01009276","Total",41,20,14,7,1,0,0,1,40,20,14,6
"2011","Birmingham 133D","E01009278","Total",40,16,13,11,3,1,2,0,37,15,11,11
"2011","Birmingham 133E","E01009279","Total",31,9,12,10,2,0,1,1,29,9,11,9
"2011","Birmingham 133F","E01032591","Total",17,6,8,3,0,0,0,0,17,6,8,3
"2011","Birmingham 134A","E01008995","Total",95,26,17,52,8,0,2,6,87,26,15,46
"2011","Birmingham 134B","E01033557","Total",6,2,3,1,1,0,1,0,5,2,2,1
"2011","Birmingham 134C","E01033624","Total",62,19,11,32,7,0,1,6,55,19,10,26
"2011","Birmingham 134D","E01033626","Total",44,13,13,18,5,2,3,0,39,11,10,18
"2011","Birmingham 134E","E01033640","Total",110,28,22,60,7,2,1,4,103,26,21,56
"2011","Birmingham 135A","E01009378","Total",79,28,17,34,5,0,0,5,74,28,17,29
"2011","Birmingham 135B","E01033567","Total",11,4,3,4,2,1,1,0,9,3,2,4
"2011","Birmingham 135C","E01033615","Total",9,3,3,3,1,0,1,0,8,3,2,3
"2011","Birmingham 135D","E01033616","Total",5,1,2,2,2,0,1,1,3,1,1,1
"2011","Birmingham 136A","E01009143","Total",126,28,11,87,22,2,7,13,104,26,4,74
"2011","Birmingham 136B","E01009146","Total",60,20,16,24,6,1,2,3,54,19,14,21
"2011","Birmingham 136C","E01033564","Total",10,3,2,5,1,0,1,0,9,3,1,5
"2011","Birmingham 136D","E01033639","Total",140,41,29,70,19,1,10,8,121,40,19,62
"2011","Birmingham 137A","E01009141","Total",145,36,38,71,13,0,10,3,132,36,28,68
"2011","Birmingham 137B","E01033565","Total",3,0,1,2,1,0,1,0,2,0,0,2
"2011","Birmingham 137C","E01033618","Total",6,0,4,2,1,0,0,1,5,0,4,1
"2011","Birmingham 137D","E01033619","Total",32,10,10,12,3,0,3,0,29,10,7,12
"2011","Birmingham 137E","E01033627","Total",47,10,7,30,4,0,0,4,43,10,7,26
"2011","Birmingham 138A","E01033620","Total",7,2,1,4,1,0,1,0,6,2,0,4
"2011","Birmingham 138B","E01033622","Total",17,5,6,6,1,0,1,0,16,5,5,6
"2011","Birmingham 138C","E01033623","Total",19,4,5,10,2,1,1,0,17,3,4,10
"2011","Birmingham 138D","E01033625","Total",1,0,0,1,0,0,0,0,1,0,0,1
"2011","Birmingham 139A","E01009200","Total",113,30,28,55,12,3,5,4,101,27,23,51
"2011","Birmingham 139B","E01009327","Total",44,10,3,31,6,1,3,2,38,9,0,29
"2011","Birmingham 139C","E01009328","Total",28,6,2,20,2,2,0,0,26,4,2,20
"2011","Birmingham 139D","E01009331","Total",54,21,2,31,9,6,1,2,45,15,1,29
"2011","Birmingham 139E","E01009332","Total",85,22,16,47,12,2,6,4,73,20,10,43
"2011","Birmingham 139F","E01009333","Total",45,9,4,32,5,1,1,3,40,8,3,29
"2011","Birmingham 139G","E01009335","Total",52,11,1,40,6,1,1,4,46,10,0,36
"2011","Birmingham 139H","E01009344","Total",69,18,12,39,12,2,7,3,57,16,5,36
"2011","Birmingham 140A","E01009339","Total",43,12,2,29,7,2,1,4,36,10,1,25
"2011","Birmingham 140B","E01009340","Total",121,30,17,74,12,6,4,2,109,24,13,72
"2011","Birmingham 140C","E01009382","Total",37,3,2,32,2,0,0,2,35,3,2,30
"2011","Birmingham 140D","E01009391","Total",53,10,5,38,3,1,1,1,50,9,4,37
"2011","Birmingham 140E","E01009392","Total",34,8,5,21,1,1,0,0,33,7,5,21
"2011","Birmingham 140F","E01009393","Total",57,13,5,39,3,0,0,3,54,13,5,36
"2011","Birmingham 140G","E01033641","Total",72,18,3,51,4,1,0,3,68,17,3,48
"2011","Coventry 001A","E01009589","Total",78,26,23,29,13,5,5,3,65,21,18,26
"2011","Coventry 001F","E01032536","Total",80,38,18,24,8,2,4,2,72,36,14,22
"2011","Coventry 001G","E01032537","Total",83,29,28,26,7,1,4,2,76,28,24,24
"2011","Coventry 001H","E01032538","Total",150,53,39,58,8,0,6,2,142,53,33,56
"2011","Coventry 002A","E01009590","Total",49,19,15,15,2,0,1,1,47,19,14,14
"2011","Coventry 002B","E01009591","Total",73,18,28,27,12,2,5,5,61,16,23,22
"2011","Coventry 002C","E01009593","Total",55,21,16,18,1,0,0,1,54,21,16,17
"2011","Coventry 002D","E01009598","Total",32,14,6,12,5,1,2,2,27,13,4,10
"2011","Coventry 004A","E01009604","Total",72,13,22,37,7,0,5,2,65,13,17,35
"2011","Coventry 004B","E01009605","Total",111,23,23,65,8,2,5,1,103,21,18,64
"2011","Coventry 004C","E01009607","Total",106,38,11,57,7,1,0,6,99,37,11,51
"2011","Coventry 004D","E01009608","Total",89,33,17,39,10,0,3,7,79,33,14,32
"2011","Coventry 004E","E01009610","Total",91,35,18,38,8,1,2,5,83,34,16,33
"2011","Coventry 005A","E01009564","Total",91,23,10,58,7,0,3,4,84,23,7,54
"2011","Coventry 005B","E01009575","Total",80,21,13,46,8,2,2,4,72,19,11,42
"2011","Coventry 005C","E01009606","Total",63,22,14,27,5,1,3,1,58,21,11,26
"2011","Coventry 005D","E01009609","Total",112,28,18,66,7,2,2,3,105,26,16,63
"2011","Coventry 006A","E01009524","Total",42,17,14,11,2,0,2,0,40,17,12,11
"2011","Coventry 006B","E01009525","Total",36,15,10,11,6,0,3,3,30,15,7,8
"2011","Coventry 006C","E01009527","Total",73,35,21,17,7,1,4,2,66,34,17,15
"2011","Coventry 006D","E01009594","Total",33,11,12,10,0,0,0,0,33,11,12,10
"2011","Coventry 007A","E01009577","Total",105,27,10,68,9,2,1,6,96,25,9,62
"2011","Coventry 007B","E01009579","Total",141,38,23,80,17,1,7,9,124,37,16,71
"2011","Coventry 007C","E01009581","Total",108,30,14,64,3,0,2,1,105,30,12,63
"2011","Coventry 007D","E01009584","Total",70,18,16,36,7,1,3,3,63,17,13,33
"2011","Coventry 007E","E01009585","Total",96,15,7,74,7,0,2,5,89,15,5,69
"2011","Coventry 007F","E01009709","Total",90,26,8,56,3,0,1,2,87,26,7,54
"2011","Coventry 008A","E01009576","Total",57,20,11,26,4,0,2,2,53,20,9,24
"2011","Coventry 008B","E01009578","Total",35,18,8,9,2,0,2,0,33,18,6,9
"2011","Coventry 008C","E01009582","Total",78,33,29,16,7,0,4,3,71,33,25,13
"2011","Coventry 008D","E01009583","Total",67,22,24,21,7,1,5,1,60,21,19,20
"2011","Coventry 008E","E01009586","Total",56,22,19,15,3,0,2,1,53,22,17,14
"2011","Coventry 009A","E01009565","Total",43,10,5,28,2,0,1,1,41,10,4,27
"2011","Coventry 009B","E01009566","Total",88,22,12,54,7,3,2,2,81,19,10,52
"2011","Coventry 009C","E01009567","Total",75,21,5,49,2,2,0,0,73,19,5,49
"2011","Coventry 009D","E01009568","Total",54,10,8,36,2,0,0,2,52,10,8,34
"2011","Coventry 010A","E01009523","Total",13,7,4,2,2,0,1,1,11,7,3,1
"2011","Coventry 010B","E01009526","Total",40,21,6,13,3,0,0,3,37,21,6,10
"2011","Coventry 010C","E01009528","Total",38,14,15,9,5,1,3,1,33,13,12,8
"2011","Coventry 010D","E01009531","Total",62,15,23,24,9,1,7,1,53,14,16,23
"2011","Coventry 011A","E01009587","Total",70,21,22,27,8,0,3,5,62,21,19,22
"2011","Coventry 011B","E01009624","Total",83,26,17,40,5,2,2,1,78,24,15,39
"2011","Coventry 011C","E01009625","Total",97,28,20,49,9,1,6,2,88,27,14,47
"2011","Coventry 011D","E01009626","Total",60,17,13,30,6,1,2,3,54,16,11,27
"2011","Coventry 012A","E01009622","Total",121,40,26,55,9,3,5,1,112,37,21,54
"2011","Coventry 012B","E01009623","Total",85,23,17,45,6,1,4,1,79,22,13,44
"2011","Coventry 012C","E01009627","Total",80,18,20,42,4,1,2,1,76,17,18,41
"2011","Coventry 012D","E01009628","Total",57,21,13,23,3,0,2,1,54,21,11,22
"2011","Coventry 013A","E01009599","Total",52,13,15,24,0,0,0,0,52,13,15,24
"2011","Coventry 013B","E01009663","Total",31,9,5,17,2,0,0,2,29,9,5,15
"2011","Coventry 013C","E01009710","Total",42,15,15,12,4,0,3,1,38,15,12,11
"2011","Coventry 013D","E01009711","Total",44,15,11,18,4,0,2,2,40,15,9,16
"2011","Coventry 014A","E01009522","Total",67,24,16,27,3,0,0,3,64,24,16,24
"2011","Coventry 014B","E01009529","Total",59,20,29,10,9,1,5,3,50,19,24,7
"2011","Coventry 014C","E01009530","Total",48,16,19,13,11,2,7,2,37,14,12,11
"2011","Coventry 014D","E01009645","Total",64,27,20,17,5,1,4,0,59,26,16,17
"2011","Coventry 015A","E01009569","Total",72,17,10,45,3,0,0,3,69,17,10,42
"2011","Coventry 015B","E01009570","Total",68,15,5,48,7,0,1,6,61,15,4,42
"2011","Coventry 015C","E01009571","Total",81,19,6,56,2,0,1,1,79,19,5,55
"2011","Coventry 015D","E01009572","Total",137,27,12,98,14,3,3,8,123,24,9,90
"2011","Coventry 015E","E01009573","Total",56,12,9,35,2,0,1,1,54,12,8,34
"2011","Coventry 015F","E01009574","Total",86,20,11,55,5,2,0,3,81,18,11,52
"2011","Coventry 016A","E01009655","Total",113,35,32,46,11,0,4,7,102,35,28,39
"2011","Coventry 016B","E01009656","Total",83,25,14,44,10,0,4,6,73,25,10,38
"2011","Coventry 016C","E01009659","Total",108,29,17,62,7,0,3,4,101,29,14,58
"2011","Coventry 016D","E01009662","Total",43,8,16,19,9,1,3,5,34,7,13,14
"2011","Coventry 016E","E01009664","Total",60,19,14,27,7,1,3,3,53,18,11,24
"2011","Coventry 017A","E01009643","Total",52,18,26,8,7,0,5,2,45,18,21,6
"2011","Coventry 017B","E01009644","Total",61,27,22,12,3,0,3,0,58,27,19,12
"2011","Coventry 017C","E01009647","Total",53,16,19,18,4,0,3,1,49,16,16,17
"2011","Coventry 017D","E01009648","Total",55,17,24,14,6,1,2,3,49,16,22,11
"2011","Coventry 017E","E01009652","Total",34,13,13,8,7,2,5,0,27,11,8,8
"2011","Coventry 017F","E01009653","Total",41,15,17,9,1,0,1,0,40,15,16,9
"2011","Coventry 018A","E01009613","Total",38,18,12,8,4,2,2,0,34,16,10,8
"2011","Coventry 018B","E01009657","Total",69,21,20,28,5,0,4,1,64,21,16,27
"2011","Coventry 018C","E01009712","Total",79,24,28,27,5,0,4,1,74,24,24,26
"2011","Coventry 018D","E01009714","Total",60,24,22,14,7,0,6,1,53,24,16,13
"2011","Coventry 018E","E01009716","Total",68,28,27,13,5,1,3,1,63,27,24,12
"2011","Coventry 019A","E01009580","Total",36,9,14,13,5,1,3,1,31,8,11,12
"2011","Coventry 019B","E01009713","Total",45,18,12,15,5,1,4,0,40,17,8,15
"2011","Coventry 019C","E01009715","Total",42,16,8,18,1,0,0,1,41,16,8,17
"2011","Coventry 019D","E01009717","Total",29,11,14,4,4,0,4,0,25,11,10,4
"2011","Coventry 019E","E01009718","Total",89,32,17,40,5,0,2,3,84,32,15,37
"2011","Coventry 020A","E01009629","Total",111,27,27,57,5,0,3,2,106,27,24,55
"2011","Coventry 020B","E01009630","Total",104,35,23,46,5,1,2,2,99,34,21,44
"2011","Coventry 020C","E01009631","Total",88,29,19,40,11,1,4,6,77,28,15,34
"2011","Coventry 020D","E01009632","Total",53,16,7,30,5,2,0,3,48,14,7,27
"2011","Coventry 020E","E01009650","Total",32,9,3,20,2,0,1,1,30,9,2,19
"2011","Coventry 021A","E01009614","Total",59,23,26,10,4,1,2,1,55,22,24,9
"2011","Coventry 021B","E01009654","Total",72,22,25,25,3,1,1,1,69,21,24,24
"2011","Coventry 021C","E01009658","Total",50,16,15,19,6,0,5,1,44,16,10,18
"2011","Coventry 021D","E01009660","Total",40,12,10,18,5,1,2,2,35,11,8,16
"2011","Coventry 022A","E01009646","Total",52,20,24,8,7,0,6,1,45,20,18,7
"2011","Coventry 022B","E01009692","Total",24,6,12,6,1,0,0,1,23,6,12,5
"2011","Coventry 022C","E01009693","Total",58,23,22,13,5,1,4,0,53,22,18,13
"2011","Coventry 022D","E01009694","Total",33,9,13,11,4,2,2,0,29,7,11,11
"2011","Coventry 023A","E01009695","Total",27,13,9,5,2,0,1,1,25,13,8,4
"2011","Coventry 023B","E01009696","Total",26,8,13,5,2,0,1,1,24,8,12,4
"2011","Coventry 023C","E01009704","Total",34,15,15,4,4,0,3,1,30,15,12,3
"2011","Coventry 023D","E01009705","Total",26,14,6,6,2,0,2,0,24,14,4,6
"2011","Coventry 024A","E01009636","Total",100,39,12,49,8,0,3,5,92,39,9,44
"2011","Coventry 024B","E01009637","Total",79,19,7,53,7,0,3,4,72,19,4,49
"2011","Coventry 024C","E01009638","Total",89,15,9,65,3,0,1,2,86,15,8,63
"2011","Coventry 024D","E01009639","Total",44,12,5,27,4,1,1,2,40,11,4,25
"2011","Coventry 024E","E01009640","Total",130,37,19,74,5,0,3,2,125,37,16,72
"2011","Coventry 024F","E01009641","Total",68,15,8,45,3,0,0,3,65,15,8,42
"2011","Coventry 025A","E01009697","Total",39,17,13,9,6,0,5,1,33,17,8,8
"2011","Coventry 025B","E01009698","Total",25,6,13,6,6,0,6,0,19,6,7,6
"2011","Coventry 025C","E01009703","Total",117,43,29,45,3,0,1,2,114,43,28,43
"2011","Coventry 025D","E01009706","Total",43,16,18,9,6,1,4,1,37,15,14,8
"2011","Coventry 026A","E01009649","Total",36,13,9,14,6,3,3,0,30,10,6,14
"2011","Coventry 026B","E01009684","Total",73,22,26,25,5,0,3,2,68,22,23,23
"2011","Coventry 026C","E01009685","Total",42,15,18,9,3,0,2,1,39,15,16,8
"2011","Coventry 026D","E01009686","Total",33,13,15,5,6,1,4,1,27,12,11,4
"2011","Coventry 026E","E01009687","Total",35,11,12,12,6,1,3,2,29,10,9,10
"2011","Coventry 027A","E01009615","Total",43,14,19,10,7,0,6,1,36,14,13,9
"2011","Coventry 027B","E01009616","Total",54,19,17,18,5,0,3,2,49,19,14,16
"2011","Coventry 027C","E01009617","Total",40,13,6,21,3,0,1,2,37,13,5,19
"2011","Coventry 027D","E01009618","Total",39,12,12,15,4,0,1,3,35,12,11,12
"2011","Coventry 027E","E01009620","Total",50,15,16,19,8,1,2,5,42,14,14,14
"2011","Coventry 027F","E01009621","Total",69,23,18,28,12,3,3,6,57,20,15,22
"2011","Coventry 028A","E01009633","Total",76,25,11,40,3,0,0,3,73,25,11,37
"2011","Coventry 028B","E01009634","Total",46,13,10,23,4,1,2,1,42,12,8,22
"2011","Coventry 028C","E01009635","Total",69,22,12,35,7,1,2,4,62,21,10,31
"2011","Coventry 028D","E01009661","Total",95,23,24,48,9,0,5,4,86,23,19,44
"2011","Coventry 029A","E01009674","Total",100,24,26,50,18,3,8,7,82,21,18,43
"2011","Coventry 029B","E01009699","Total",54,16,14,24,12,2,4,6,42,14,10,18
"2011","Coventry 029C","E01009700","Total",102,21,14,67,9,1,4,4,93,20,10,63
"2011","Coventry 029D","E01009701","Total",104,37,16,51,12,1,4,7,92,36,12,44
"2011","Coventry 029E","E01009702","Total",100,39,12,49,10,1,2,7,90,38,10,42
"2011","Coventry 030A","E01009688","Total",49,15,14,20,2,0,2,0,47,15,12,20
"2011","Coventry 030B","E01009689","Total",29,4,13,12,3,0,1,2,26,4,12,10
"2011","Coventry 030C","E01009690","Total",37,13,10,14,4,0,1,3,33,13,9,11
"2011","Coventry 030D","E01009691","Total",49,13,15,21,4,2,2,0,45,11,13,21
"2011","Coventry 031A","E01009548","Total",62,14,22,26,8,0,7,1,54,14,15,25
"2011","Coventry 031B","E01009553","Total",20,7,6,7,3,3,0,0,17,4,6,7
"2011","Coventry 031C","E01009642","Total",34,6,4,24,5,0,1,4,29,6,3,20
"2011","Coventry 031D","E01009651","Total",87,12,20,55,16,1,9,6,71,11,11,49
"2011","Coventry 032A","E01009676","Total",56,19,18,19,10,2,8,0,46,17,10,19
"2011","Coventry 032B","E01009681","Total",27,9,10,8,4,1,2,1,23,8,8,7
"2011","Coventry 032C","E01009682","Total",35,11,9,15,2,1,0,1,33,10,9,14
"2011","Coventry 032D","E01009683","Total",85,21,28,36,4,1,3,0,81,20,25,36
"2011","Coventry 033A","E01009532","Total",47,21,8,18,6,1,2,3,41,20,6,15
"2011","Coventry 033B","E01009535","Total",38,12,18,8,4,0,4,0,34,12,14,8
"2011","Coventry 033C","E01009536","Total",18,5,8,5,4,0,4,0,14,5,4,5
"2011","Coventry 033D","E01009543","Total",19,7,8,4,1,0,1,0,18,7,7,4
"2011","Coventry 033E","E01009707","Total",58,19,23,16,1,0,1,0,57,19,22,16
"2011","Coventry 033F","E01009708","Total",38,16,17,5,1,0,1,0,37,16,16,5
"2011","Coventry 034A","E01009554","Total",36,14,18,4,2,0,1,1,34,14,17,3
"2011","Coventry 034B","E01009555","Total",23,5,10,8,5,0,4,1,18,5,6,7
"2011","Coventry 034C","E01009556","Total",35,20,8,7,5,1,2,2,30,19,6,5
"2011","Coventry 034D","E01009557","Total",10,3,6,1,3,0,3,0,7,3,3,1
"2011","Coventry 034E","E01009558","Total",42,12,24,6,12,1,9,2,30,11,15,4
"2011","Coventry 034F","E01009559","Total",13,2,7,4,5,1,4,0,8,1,3,4
"2011","Coventry 035C","E01009537","Total",69,16,19,34,11,0,5,6,58,16,14,28
"2011","Coventry 035D","E01009538","Total",92,29,27,36,5,1,2,2,87,28,25,34
"2011","Coventry 035E","E01009611","Total",169,54,29,86,11,2,4,5,158,52,25,81
"2011","Coventry 035F","E01009612","Total",84,27,13,44,6,1,2,3,78,26,11,41
"2011","Coventry 035G","E01032527","Total",93,40,19,34,5,0,2,3,88,40,17,31
"2011","Coventry 035H","E01032528","Total",95,22,27,46,15,2,10,3,80,20,17,43
"2011","Coventry 036C","E01009679","Total",62,15,10,37,7,0,2,5,55,15,8,32
"2011","Coventry 036E","E01032531","Total",213,66,39,108,14,4,6,4,199,62,33,104
"2011","Coventry 036F","E01032532","Total",38,7,16,15,9,0,7,2,29,7,9,13
"2011","Coventry 036G","E01032533","Total",26,1,14,11,10,1,8,1,16,0,6,10
"2011","Coventry 037B","E01009549","Total",23,8,10,5,3,0,3,0,20,8,7,5
"2011","Coventry 037C","E01009550","Total",74,28,23,23,5,0,4,1,69,28,19,22
"2011","Coventry 037E","E01009552","Total",57,19,17,21,5,1,3,1,52,18,14,20
"2011","Coventry 037F","E01032534","Total",80,29,26,25,13,4,6,3,67,25,20,22
"2011","Coventry 037G","E01032535","Total",22,4,6,12,3,0,0,3,19,4,6,9
"2011","Coventry 038A","E01009544","Total",61,15,25,21,11,0,8,3,50,15,17,18
"2011","Coventry 038D","E01009619","Total",85,30,17,38,6,1,4,1,79,29,13,37
"2011","Coventry 038E","E01032529","Total",65,25,13,27,7,1,3,3,58,24,10,24
"2011","Coventry 038F","E01032530","Total",53,16,21,16,8,0,5,3,45,16,16,13
"2011","Coventry 039A","E01009539","Total",107,36,10,61,10,0,2,8,97,36,8,53
"2011","Coventry 039B","E01009540","Total",161,37,21,103,22,1,8,13,139,36,13,90
"2011","Coventry 039C","E01009541","Total",90,25,14,51,8,1,3,4,82,24,11,47
"2011","Coventry 039D","E01009542","Total",97,28,12,57,7,2,2,3,90,26,10,54
"2011","Coventry 040A","E01009560","Total",8,3,4,1,3,0,2,1,5,3,2,0
"2011","Coventry 040B","E01009561","Total",45,17,9,19,6,0,2,4,39,17,7,15
"2011","Coventry 040C","E01009562","Total",26,6,9,11,4,0,1,3,22,6,8,8
"2011","Coventry 040D","E01009563","Total",25,6,12,7,5,0,4,1,20,6,8,6
"2011","Coventry 040E","E01009672","Total",24,8,10,6,5,1,3,1,19,7,7,5
"2011","Coventry 041A","E01009666","Total",28,10,11,7,3,1,2,0,25,9,9,7
"2011","Coventry 041B","E01009667","Total",18,6,6,6,3,2,0,1,15,4,6,5
"2011","Coventry 041C","E01009668","Total",51,17,25,9,6,0,4,2,45,17,21,7
"2011","Coventry 041D","E01009670","Total",51,16,25,10,10,3,6,1,41,13,19,9
"2011","Coventry 042A","E01009665","Total",7,4,2,1,1,0,1,0,6,4,1,1
"2011","Coventry 042B","E01009669","Total",20,12,7,1,2,1,1,0,18,11,6,1
"2011","Coventry 042C","E01009671","Total",13,3,7,3,2,0,2,0,11,3,5,3
"2011","Coventry 042F","E01033058","Total",37,12,6,19,7,0,2,5,30,12,4,14
"2011","Coventry 043A","E01009588","Total",78,21,19,38,6,1,2,3,72,20,17,35
"2011","Coventry 043B","E01009592","Total",118,40,18,60,5,0,2,3,113,40,16,57
"2011","Coventry 043C","E01009596","Total",89,27,23,39,12,1,5,6,77,26,18,33
"2011","Coventry 043D","E01009597","Total",98,33,15,50,8,1,1,6,90,32,14,44
"2011","Coventry 043E","E01032587","Total",108,36,20,52,7,1,2,4,101,35,18,48
"2011","Dudley 001A","E01009763","Total",89,33,19,37,3,0,2,1,86,33,17,36
"2011","Dudley 001B","E01009764","Total",30,14,11,5,4,0,3,1,26,14,8,4
"2011","Dudley 001C","E01009767","Total",31,10,5,16,6,0,1,5,25,10,4,11
"2011","Dudley 001D","E01009769","Total",95,27,13,55,9,1,3,5,86,26,10,50
"2011","Dudley 001E","E01009770","Total",51,14,10,27,3,0,2,1,48,14,8,26
"2011","Dudley 002A","E01009773","Total",49,17,15,17,4,0,3,1,45,17,12,16
"2011","Dudley 002B","E01009777","Total",46,19,7,20,5,1,1,3,41,18,6,17
"2011","Dudley 002C","E01009778","Total",40,19,10,11,5,1,4,0,35,18,6,11
"2011","Dudley 002D","E01009895","Total",39,20,10,9,3,0,3,0,36,20,7,9
"2011","Dudley 003A","E01009896","Total",24,5,9,10,4,1,2,1,20,4,7,9
"2011","Dudley 003B","E01009897","Total",14,12,1,1,1,0,0,1,13,12,1,0
"2011","Dudley 003C","E01009898","Total",12,5,5,2,2,0,2,0,10,5,3,2
"2011","Dudley 003D","E01009901","Total",15,7,7,1,4,0,4,0,11,7,3,1
"2011","Dudley 003E","E01009902","Total",16,8,6,2,1,0,1,0,15,8,5,2
"2011","Dudley 004A","E01009765","Total",36,18,5,13,2,0,1,1,34,18,4,12
"2011","Dudley 004B","E01009766","Total",48,14,15,19,3,0,1,2,45,14,14,17
"2011","Dudley 004C","E01009768","Total",32,12,3,17,0,0,0,0,32,12,3,17
"2011","Dudley 004D","E01009771","Total",14,5,7,2,1,0,1,0,13,5,6,2
"2011","Dudley 004E","E01009775","Total",47,12,5,30,4,0,0,4,43,12,5,26
"2011","Dudley 004F","E01009776","Total",28,5,11,12,2,0,1,1,26,5,10,11
"2011","Dudley 005A","E01009758","Total",72,20,6,46,6,0,3,3,66,20,3,43
"2011","Dudley 005B","E01009760","Total",54,16,13,25,6,0,4,2,48,16,9,23
"2011","Dudley 005C","E01009772","Total",82,23,14,45,7,0,4,3,75,23,10,42
"2011","Dudley 005D","E01009774","Total",31,12,6,13,1,0,1,0,30,12,5,13
"2011","Dudley 005E","E01009788","Total",58,20,13,25,1,0,0,1,57,20,13,24
"2011","Dudley 006B","E01009756","Total",55,22,8,25,2,0,0,2,53,22,8,23
"2011","Dudley 006C","E01009757","Total",50,8,12,30,6,1,3,2,44,7,9,28
"2011","Dudley 006D","E01009759","Total",14,6,4,4,2,1,0,1,12,5,4,3
"2011","Dudley 006F","E01009762","Total",89,25,8,56,4,1,2,1,85,24,6,55
"2011","Dudley 006G","E01033187","Total",168,37,16,115,10,1,1,8,158,36,15,107
"2011","Dudley 007A","E01009781","Total",56,15,16,25,6,0,4,2,50,15,12,23
"2011","Dudley 007B","E01009786","Total",73,27,9,37,7,0,2,5,66,27,7,32
"2011","Dudley 007C","E01009789","Total",24,10,9,5,4,2,2,0,20,8,7,5
"2011","Dudley 007D","E01009790","Total",51,18,13,20,4,0,4,0,47,18,9,20
"2011","Dudley 008A","E01009779","Total",22,7,9,6,2,0,1,1,20,7,8,5
"2011","Dudley 008B","E01009782","Total",74,30,12,32,4,0,4,0,70,30,8,32
"2011","Dudley 008C","E01009783","Total",65,25,13,27,5,0,3,2,60,25,10,25
"2011","Dudley 008D","E01009785","Total",9,4,4,1,1,0,0,1,8,4,4,0
"2011","Dudley 008E","E01009899","Total",13,7,2,4,0,0,0,0,13,7,2,4
"2011","Dudley 008F","E01009900","Total",13,4,7,2,2,0,1,1,11,4,6,1
"2011","Dudley 009A","E01009780","Total",41,17,15,9,3,0,3,0,38,17,12,9
"2011","Dudley 009B","E01009784","Total",30,11,14,5,2,0,2,0,28,11,12,5
"2011","Dudley 009C","E01009787","Total",20,10,5,5,2,0,1,1,18,10,4,4
"2011","Dudley 009D","E01009880","Total",34,14,9,11,4,0,4,0,30,14,5,11
"2011","Dudley 009E","E01009882","Total",49,20,8,21,2,1,1,0,47,19,7,21
"2011","Dudley 010A","E01009891","Total",86,20,17,49,9,0,2,7,77,20,15,42
"2011","Dudley 010B","E01009892","Total",67,8,15,44,4,0,2,2,63,8,13,42
"2011","Dudley 010C","E01009893","Total",93,24,11,58,10,2,0,8,83,22,11,50
"2011","Dudley 010D","E01009894","Total",60,20,16,24,5,0,2,3,55,20,14,21
"2011","Dudley 011A","E01009844","Total",59,11,12,36,7,0,1,6,52,11,11,30
"2011","Dudley 011B","E01009879","Total",60,18,12,30,3,0,1,2,57,18,11,28
"2011","Dudley 011C","E01009881","Total",48,9,12,27,3,0,1,2,45,9,11,25
"2011","Dudley 011D","E01009885","Total",53,11,6,36,2,0,1,1,51,11,5,35
"2011","Dudley 012A","E01009816","Total",29,11,7,11,2,0,1,1,27,11,6,10
"2011","Dudley 012B","E01009817","Total",22,12,9,1,2,0,2,0,20,12,7,1
"2011","Dudley 012C","E01009819","Total",41,18,12,11,5,0,5,0,36,18,7,11
"2011","Dudley 012D","E01009820","Total",41,14,15,12,6,0,5,1,35,14,10,11
"2011","Dudley 013A","E01009748","Total",95,23,16,56,7,0,4,3,88,23,12,53
"2011","Dudley 013B","E01009839","Total",45,11,11,23,6,0,4,2,39,11,7,21
"2011","Dudley 013C","E01009883","Total",50,12,12,26,4,0,2,2,46,12,10,24
"2011","Dudley 013D","E01009884","Total",42,14,10,18,3,0,2,1,39,14,8,17
"2011","Dudley 013E","E01009886","Total",43,16,11,16,6,0,4,2,37,16,7,14
"2011","Dudley 014A","E01009814","Total",17,8,4,5,1,0,1,0,16,8,3,5
"2011","Dudley 014B","E01009815","Total",19,7,12,0,2,0,2,0,17,7,10,0
"2011","Dudley 014C","E01009818","Total",25,6,6,13,4,1,1,2,21,5,5,11
"2011","Dudley 014D","E01009821","Total",14,6,5,3,0,0,0,0,14,6,5,3
"2011","Dudley 014E","E01009822","Total",18,5,7,6,2,0,1,1,16,5,6,5
"2011","Dudley 015A","E01009887","Total",47,11,8,28,3,1,0,2,44,10,8,26
"2011","Dudley 015B","E01009888","Total",48,18,12,18,2,0,1,1,46,18,11,17
"2011","Dudley 015C","E01009889","Total",85,19,18,48,6,1,2,3,79,18,16,45
"2011","Dudley 015D","E01009890","Total",82,28,15,39,8,3,2,3,74,25,13,36
"2011","Dudley 016A","E01009749","Total",23,12,5,6,2,1,1,0,21,11,4,6
"2011","Dudley 016B","E01009750","Total",43,12,12,19,9,0,4,5,34,12,8,14
"2011","Dudley 016C","E01009823","Total",15,6,6,3,1,0,1,0,14,6,5,3
"2011","Dudley 016D","E01009824","Total",58,16,18,24,4,0,3,1,54,16,15,23
"2011","Dudley 017A","E01009751","Total",54,17,12,25,4,0,2,2,50,17,10,23
"2011","Dudley 017B","E01009752","Total",81,20,13,48,11,0,6,5,70,20,7,43
"2011","Dudley 017C","E01009753","Total",91,34,13,44,8,1,2,5,83,33,11,39
"2011","Dudley 017D","E01009754","Total",66,16,15,35,5,1,1,3,61,15,14,32
"2011","Dudley 017E","E01009841","Total",79,22,10,47,10,0,1,9,69,22,9,38
"2011","Dudley 018A","E01009840","Total",51,12,10,29,6,0,0,6,45,12,10,23
"2011","Dudley 018B","E01009842","Total",62,21,10,31,8,3,4,1,54,18,6,30
"2011","Dudley 018C","E01009843","Total",49,15,13,21,4,0,2,2,45,15,11,19
"2011","Dudley 018D","E01009871","Total",46,11,7,28,2,1,0,1,44,10,7,27
"2011","Dudley 018E","E01009875","Total",46,18,4,24,6,1,2,3,40,17,2,21
"2011","Dudley 019A","E01009825","Total",38,14,9,15,3,0,1,2,35,14,8,13
"2011","Dudley 019B","E01009826","Total",20,6,12,2,4,0,3,1,16,6,9,1
"2011","Dudley 019C","E01009827","Total",14,4,8,2,5,0,5,0,9,4,3,2
"2011","Dudley 019D","E01009828","Total",34,11,5,18,4,2,0,2,30,9,5,16
"2011","Dudley 019E","E01009829","Total",24,9,12,3,4,1,3,0,20,8,9,3
"2011","Dudley 019F","E01009830","Total",21,7,7,7,0,0,0,0,21,7,7,7
"2011","Dudley 020A","E01009872","Total",57,17,7,33,5,0,1,4,52,17,6,29
"2011","Dudley 020B","E01009873","Total",38,14,6,18,0,0,0,0,38,14,6,18
"2011","Dudley 020C","E01009874","Total",68,25,8,35,6,0,1,5,62,25,7,30
"2011","Dudley 020D","E01009876","Total",59,22,13,24,5,2,2,1,54,20,11,23
"2011","Dudley 020E","E01009877","Total",70,16,8,46,5,1,0,4,65,15,8,42
"2011","Dudley 021A","E01009911","Total",16,5,7,4,0,0,0,0,16,5,7,4
"2011","Dudley 021B","E01009912","Total",42,13,13,16,4,2,2,0,38,11,11,16
"2011","Dudley 021C","E01009913","Total",34,18,9,7,3,1,2,0,31,17,7,7
"2011","Dudley 021D","E01009914","Total",20,10,6,4,1,0,1,0,19,10,5,4
"2011","Dudley 021E","E01009915","Total",27,14,11,2,2,0,2,0,25,14,9,2
"2011","Dudley 021F","E01009916","Total",41,12,16,13,7,1,4,2,34,11,12,11
"2011","Dudley 022A","E01009741","Total",111,18,27,66,9,0,4,5,102,18,23,61
"2011","Dudley 022B","E01009744","Total",57,12,13,32,4,0,3,1,53,12,10,31
"2011","Dudley 022C","E01009746","Total",50,11,10,29,5,0,3,2,45,11,7,27
"2011","Dudley 022D","E01009747","Total",73,27,18,28,12,3,5,4,61,24,13,24
"2011","Dudley 023A","E01009731","Total",35,11,15,9,3,0,3,0,32,11,12,9
"2011","Dudley 023B","E01009740","Total",74,19,17,38,4,0,1,3,70,19,16,35
"2011","Dudley 023C","E01009742","Total",50,13,11,26,2,1,0,1,48,12,11,25
"2011","Dudley 023D","E01009743","Total",90,29,14,47,5,0,3,2,85,29,11,45
"2011","Dudley 023E","E01009745","Total",36,10,19,7,3,0,2,1,33,10,17,6
"2011","Dudley 024A","E01009917","Total",23,10,5,8,4,0,3,1,19,10,2,7
"2011","Dudley 024B","E01009918","Total",69,27,15,27,7,1,2,4,62,26,13,23
"2011","Dudley 024C","E01009919","Total",14,5,6,3,3,0,2,1,11,5,4,2
"2011","Dudley 024D","E01009920","Total",21,7,12,2,4,1,3,0,17,6,9,2
"2011","Dudley 025A","E01009864","Total",46,22,10,14,3,0,3,0,43,22,7,14
"2011","Dudley 025B","E01009865","Total",50,21,11,18,4,1,2,1,46,20,9,17
"2011","Dudley 025C","E01009866","Total",54,21,10,23,4,2,2,0,50,19,8,23
"2011","Dudley 025D","E01009867","Total",47,10,8,29,7,1,1,5,40,9,7,24
"2011","Dudley 025E","E01009878","Total",41,16,7,18,8,3,4,1,33,13,3,17
"2011","Dudley 026A","E01009791","Total",31,8,8,15,4,0,2,2,27,8,6,13
"2011","Dudley 026B","E01009792","Total",57,24,10,23,2,0,2,0,55,24,8,23
"2011","Dudley 026C","E01009795","Total",61,20,13,28,1,0,1,0,60,20,12,28
"2011","Dudley 026D","E01009796","Total",31,12,9,10,2,0,1,1,29,12,8,9
"2011","Dudley 026E","E01009798","Total",44,18,10,16,3,2,1,0,41,16,9,16
"2011","Dudley 027A","E01009719","Total",35,8,14,13,4,1,3,0,31,7,11,13
"2011","Dudley 027B","E01009722","Total",35,17,14,4,4,1,3,0,31,16,11,4
"2011","Dudley 027C","E01009727","Total",27,12,10,5,1,1,0,0,26,11,10,5
"2011","Dudley 027D","E01009728","Total",20,11,6,3,2,1,1,0,18,10,5,3
"2011","Dudley 027E","E01009729","Total",46,11,14,21,5,0,3,2,41,11,11,19
"2011","Dudley 028A","E01009720","Total",23,12,7,4,3,0,2,1,20,12,5,3
"2011","Dudley 028B","E01009723","Total",18,6,7,5,2,0,0,2,16,6,7,3
"2011","Dudley 028C","E01009724","Total",25,12,7,6,4,0,4,0,21,12,3,6
"2011","Dudley 028D","E01009730","Total",26,6,13,7,1,0,1,0,25,6,12,7
"2011","Dudley 029A","E01009903","Total",17,7,6,4,3,1,2,0,14,6,4,4
"2011","Dudley 029B","E01009904","Total",15,5,7,3,3,0,2,1,12,5,5,2
"2011","Dudley 029C","E01009909","Total",31,12,9,10,6,0,4,2,25,12,5,8
"2011","Dudley 029D","E01009910","Total",67,21,5,41,14,1,4,9,53,20,1,32
"2011","Dudley 030A","E01009793","Total",29,15,8,6,2,1,0,1,27,14,8,5
"2011","Dudley 030B","E01009794","Total",25,12,8,5,3,0,3,0,22,12,5,5
"2011","Dudley 030C","E01009797","Total",36,14,12,10,2,1,1,0,34,13,11,10
"2011","Dudley 030D","E01009801","Total",23,13,6,4,2,0,2,0,21,13,4,4
"2011","Dudley 031A","E01009721","Total",51,20,13,18,5,0,4,1,46,20,9,17
"2011","Dudley 031B","E01009725","Total",86,26,14,46,5,1,1,3,81,25,13,43
"2011","Dudley 031C","E01009726","Total",32,16,9,7,1,1,0,0,31,15,9,7
"2011","Dudley 031D","E01009834","Total",50,18,10,22,3,2,0,1,47,16,10,21
"2011","Dudley 032A","E01009833","Total",56,10,7,39,8,1,4,3,48,9,3,36
"2011","Dudley 032B","E01009835","Total",37,12,7,18,2,0,2,0,35,12,5,18
"2011","Dudley 032C","E01009869","Total",33,15,7,11,2,0,0,2,31,15,7,9
"2011","Dudley 032D","E01009870","Total",21,4,9,8,4,1,3,0,17,3,6,8
"2011","Dudley 033A","E01009809","Total",73,21,14,38,5,1,2,2,68,20,12,36
"2011","Dudley 033B","E01009813","Total",61,26,16,19,4,0,3,1,57,26,13,18
"2011","Dudley 033C","E01009861","Total",46,12,14,20,2,0,2,0,44,12,12,20
"2011","Dudley 033D","E01009862","Total",59,15,12,32,6,0,2,4,53,15,10,28
"2011","Dudley 033E","E01009863","Total",70,20,18,32,9,0,6,3,61,20,12,29
"2011","Dudley 033F","E01009868","Total",44,14,5,25,1,0,0,1,43,14,5,24
"2011","Dudley 034A","E01009734","Total",49,16,12,21,6,0,3,3,43,16,9,18
"2011","Dudley 034B","E01009735","Total",29,10,12,7,4,0,4,0,25,10,8,7
"2011","Dudley 034C","E01009736","Total",27,10,9,8,3,0,3,0,24,10,6,8
"2011","Dudley 034D","E01009737","Total",34,18,10,6,2,0,2,0,32,18,8,6
"2011","Dudley 034E","E01009738","Total",37,6,15,16,3,0,3,0,34,6,12,16
"2011","Dudley 035A","E01009856","Total",62,18,22,22,7,0,5,2,55,18,17,20
"2011","Dudley 035B","E01009905","Total",37,12,17,8,3,0,2,1,34,12,15,7
"2011","Dudley 035C","E01009906","Total",51,12,17,22,7,1,4,2,44,11,13,20
"2011","Dudley 035D","E01009907","Total",48,15,12,21,3,1,2,0,45,14,10,21
"2011","Dudley 035E","E01009908","Total",37,12,14,11,8,1,6,1,29,11,8,10
"2011","Dudley 036A","E01009800","Total",16,6,6,4,1,0,0,1,15,6,6,3
"2011","Dudley 036B","E01009802","Total",41,13,15,13,5,0,3,2,36,13,12,11
"2011","Dudley 036C","E01009803","Total",10,4,5,1,1,0,1,0,9,4,4,1
"2011","Dudley 036D","E01009804","Total",8,2,3,3,0,0,0,0,8,2,3,3
"2011","Dudley 037A","E01009831","Total",32,12,7,13,4,0,2,2,28,12,5,11
"2011","Dudley 037B","E01009836","Total",80,13,11,56,9,1,3,5,71,12,8,51
"2011","Dudley 037C","E01009837","Total",38,6,7,25,5,0,2,3,33,6,5,22
"2011","Dudley 037D","E01009838","Total",64,18,11,35,8,1,2,5,56,17,9,30
"2011","Dudley 038A","E01009847","Total",29,12,10,7,3,0,3,0,26,12,7,7
"2011","Dudley 038B","E01009848","Total",41,17,15,9,3,0,3,0,38,17,12,9
"2011","Dudley 038C","E01009849","Total",38,13,8,17,4,2,0,2,34,11,8,15
"2011","Dudley 038D","E01009851","Total",24,10,12,2,2,0,2,0,22,10,10,2
"2011","Dudley 039A","E01009732","Total",55,19,13,23,2,0,2,0,53,19,11,23
"2011","Dudley 039B","E01009733","Total",91,16,18,57,13,0,9,4,78,16,9,53
"2011","Dudley 039C","E01009739","Total",58,19,17,22,6,2,4,0,52,17,13,22
"2011","Dudley 039D","E01009799","Total",28,12,8,8,2,0,2,0,26,12,6,8
"2011","Dudley 039E","E01009805","Total",37,8,17,12,2,0,2,0,35,8,15,12
"2011","Dudley 039F","E01009806","Total",32,7,15,10,5,0,4,1,27,7,11,9
"2011","Dudley 040A","E01009854","Total",8,0,6,2,2,0,2,0,6,0,4,2
"2011","Dudley 040B","E01009857","Total",49,17,9,23,4,2,0,2,45,15,9,21
"2011","Dudley 040C","E01009858","Total",28,10,13,5,5,2,3,0,23,8,10,5
"2011","Dudley 040D","E01009859","Total",20,9,9,2,3,1,2,0,17,8,7,2
"2011","Dudley 041A","E01009845","Total",11,4,7,0,2,1,1,0,9,3,6,0
"2011","Dudley 041B","E01009846","Total",37,14,8,15,4,2,1,1,33,12,7,14
"2011","Dudley 041C","E01009850","Total",19,7,9,3,1,0,1,0,18,7,8,3
"2011","Dudley 041D","E01009852","Total",14,7,6,1,1,0,1,0,13,7,5,1
"2011","Dudley 042A","E01009832","Total",68,22,16,30,6,0,3,3,62,22,13,27
"2011","Dudley 042B","E01009853","Total",7,1,5,1,0,0,0,0,7,1,5,1
"2011","Dudley 042C","E01009855","Total",16,5,7,4,5,2,3,0,11,3,4,4
"2011","Dudley 042D","E01009860","Total",16,5,7,4,2,1,1,0,14,4,6,4
"2011","Dudley 043A","E01009807","Total",17,8,9,0,1,0,1,0,16,8,8,0
"2011","Dudley 043B","E01009808","Total",18,7,7,4,2,0,2,0,16,7,5,4
"2011","Dudley 043C","E01009810","Total",42,14,10,18,3,1,2,0,39,13,8,18
"2011","Dudley 043D","E01009811","Total",38,14,8,16,1,0,0,1,37,14,8,15
"2011","Dudley 043E","E01009812","Total",19,9,5,5,2,0,2,0,17,9,3,5
"2011","Sandwell 001A","E01010085","Total",33,4,12,17,3,0,1,2,30,4,11,15
"2011","Sandwell 001B","E01010086","Total",74,29,16,29,4,1,1,2,70,28,15,27
"2011","Sandwell 001C","E01010087","Total",68,26,9,33,5,2,1,2,63,24,8,31
"2011","Sandwell 001D","E01010088","Total",48,12,14,22,4,0,4,0,44,12,10,22
"2011","Sandwell 001E","E01010089","Total",81,23,15,43,6,1,4,1,75,22,11,42
"2011","Sandwell 002A","E01009969","Total",95,25,16,54,5,2,2,1,90,23,14,53
"2011","Sandwell 002B","E01009970","Total",51,17,10,24,3,0,2,1,48,17,8,23
"2011","Sandwell 002C","E01009971","Total",100,29,25,46,8,0,3,5,92,29,22,41
"2011","Sandwell 002D","E01009973","Total",60,22,20,18,2,0,2,0,58,22,18,18
"2011","Sandwell 003A","E01009960","Total",41,15,6,20,1,0,1,0,40,15,5,20
"2011","Sandwell 003B","E01009961","Total",23,8,12,3,3,0,3,0,20,8,9,3
"2011","Sandwell 003C","E01009966","Total",70,11,10,49,8,0,4,4,62,11,6,45
"2011","Sandwell 003D","E01009967","Total",64,20,16,28,10,0,5,5,54,20,11,23
"2011","Sandwell 003E","E01010092","Total",61,17,21,23,5,0,4,1,56,17,17,22
"2011","Sandwell 004A","E01009962","Total",71,22,12,37,3,1,0,2,68,21,12,35
"2011","Sandwell 004B","E01009963","Total",60,16,12,32,2,0,2,0,58,16,10,32
"2011","Sandwell 004C","E01009964","Total",76,16,9,51,7,1,1,5,69,15,8,46
"2011","Sandwell 004D","E01009965","Total",56,15,12,29,3,0,1,2,53,15,11,27
"2011","Sandwell 005A","E01010090","Total",80,26,8,46,2,0,1,1,78,26,7,45
"2011","Sandwell 005B","E01010091","Total",36,7,10,19,3,0,2,1,33,7,8,18
"2011","Sandwell 005C","E01010096","Total",45,14,12,19,3,0,2,1,42,14,10,18
"2011","Sandwell 005D","E01010097","Total",36,9,11,16,5,0,3,2,31,9,8,14
"2011","Sandwell 006A","E01009968","Total",30,8,14,8,5,1,3,1,25,7,11,7
"2011","Sandwell 006B","E01009972","Total",23,8,11,4,1,1,0,0,22,7,11,4
"2011","Sandwell 006C","E01009974","Total",19,6,11,2,6,0,5,1,13,6,6,1
"2011","Sandwell 006D","E01009975","Total",29,6,10,13,5,0,3,2,24,6,7,11
"2011","Sandwell 007A","E01010030","Total",84,22,13,49,3,0,1,2,81,22,12,47
"2011","Sandwell 007B","E01010034","Total",24,7,10,7,2,0,2,0,22,7,8,7
"2011","Sandwell 007C","E01010035","Total",20,12,4,4,4,2,1,1,16,10,3,3
"2011","Sandwell 007D","E01010036","Total",83,26,11,46,1,0,0,1,82,26,11,45
"2011","Sandwell 009A","E01009982","Total",64,16,12,36,6,1,1,4,58,15,11,32
"2011","Sandwell 009B","E01009983","Total",64,23,11,30,4,0,1,3,60,23,10,27
"2011","Sandwell 009C","E01010029","Total",77,15,15,47,8,3,3,2,69,12,12,45
"2011","Sandwell 009D","E01010037","Total",65,17,13,35,6,1,3,2,59,16,10,33
"2011","Sandwell 010A","E01009991","Total",96,29,29,38,8,0,2,6,88,29,27,32
"2011","Sandwell 010B","E01009994","Total",55,19,10,26,3,0,1,2,52,19,9,24
"2011","Sandwell 010C","E01009995","Total",64,19,12,33,5,0,3,2,59,19,9,31
"2011","Sandwell 010D","E01009996","Total",65,21,9,35,5,0,1,4,60,21,8,31
"2011","Sandwell 010E","E01009997","Total",74,25,19,30,4,0,2,2,70,25,17,28
"2011","Sandwell 010F","E01009998","Total",95,25,16,54,4,0,2,2,91,25,14,52
"2011","Sandwell 011A","E01010008","Total",53,15,21,17,3,0,2,1,50,15,19,16
"2011","Sandwell 011B","E01010010","Total",69,18,15,36,4,1,1,2,65,17,14,34
"2011","Sandwell 011C","E01010011","Total",35,10,14,11,2,0,1,1,33,10,13,10
"2011","Sandwell 011D","E01010012","Total",31,10,14,7,5,0,4,1,26,10,10,6
"2011","Sandwell 012A","E01010007","Total",55,22,19,14,3,1,2,0,52,21,17,14
"2011","Sandwell 012B","E01010009","Total",64,28,18,18,0,0,0,0,64,28,18,18
"2011","Sandwell 012C","E01010013","Total",41,15,16,10,6,2,4,0,35,13,12,10
"2011","Sandwell 012D","E01010014","Total",40,9,24,7,4,0,4,0,36,9,20,7
"2011","Sandwell 013A","E01010093","Total",45,17,14,14,4,0,2,2,41,17,12,12
"2011","Sandwell 013B","E01010094","Total",47,17,13,17,4,1,1,2,43,16,12,15
"2011","Sandwell 013C","E01010095","Total",54,15,13,26,1,0,1,0,53,15,12,26
"2011","Sandwell 013D","E01010098","Total",59,16,13,30,7,2,2,3,52,14,11,27
"2011","Sandwell 013E","E01010099","Total",31,6,10,15,4,0,1,3,27,6,9,12
"2011","Sandwell 013F","E01010100","Total",36,14,4,18,0,0,0,0,36,14,4,18
"2011","Sandwell 014A","E01009978","Total",34,6,12,16,3,0,1,2,31,6,11,14
"2011","Sandwell 014B","E01010031","Total",81,15,11,55,5,0,2,3,76,15,9,52
"2011","Sandwell 014C","E01010032","Total",77,27,6,44,2,0,0,2,75,27,6,42
"2011","Sandwell 014D","E01010033","Total",69,22,11,36,8,0,2,6,61,22,9,30
"2011","Sandwell 014E","E01010074","Total",98,22,22,54,9,2,4,3,89,20,18,51
"2011","Sandwell 015A","E01010066","Total",51,18,11,22,3,0,2,1,48,18,9,21
"2011","Sandwell 015B","E01010067","Total",59,9,14,36,10,1,4,5,49,8,10,31
"2011","Sandwell 015C","E01010068","Total",45,15,8,22,5,0,3,2,40,15,5,20
"2011","Sandwell 015D","E01010070","Total",51,21,10,20,2,0,1,1,49,21,9,19
"2011","Sandwell 015E","E01010075","Total",26,5,11,10,5,0,5,0,21,5,6,10
"2011","Sandwell 015F","E01010076","Total",38,9,6,23,2,0,0,2,36,9,6,21
"2011","Sandwell 016A","E01009976","Total",62,23,18,21,8,2,4,2,54,21,14,19
"2011","Sandwell 016B","E01009977","Total",69,17,25,27,8,0,7,1,61,17,18,26
"2011","Sandwell 016C","E01009979","Total",57,16,11,30,4,0,3,1,53,16,8,29
"2011","Sandwell 016D","E01009980","Total",72,17,19,36,4,0,3,1,68,17,16,35
"2011","Sandwell 016E","E01010069","Total",59,13,23,23,7,1,5,1,52,12,18,22
"2011","Sandwell 016F","E01010071","Total",60,15,18,27,2,0,1,1,58,15,17,26
"2011","Sandwell 017A","E01009947","Total",65,19,17,29,4,1,3,0,61,18,14,29
"2011","Sandwell 017B","E01009992","Total",62,21,12,29,5,0,4,1,57,21,8,28
"2011","Sandwell 017C","E01009993","Total",66,18,12,36,7,0,1,6,59,18,11,30
"2011","Sandwell 017D","E01010103","Total",89,24,19,46,4,0,3,1,85,24,16,45
"2011","Sandwell 017E","E01010104","Total",40,11,6,23,3,0,1,2,37,11,5,21
"2011","Sandwell 017F","E01010105","Total",32,5,12,15,3,0,2,1,29,5,10,14
"2011","Sandwell 018A","E01009981","Total",64,22,12,30,6,2,2,2,58,20,10,28
"2011","Sandwell 018C","E01009985","Total",56,13,13,30,5,0,1,4,51,13,12,26
"2011","Sandwell 018E","E01032887","Total",73,20,16,37,9,1,3,5,64,19,13,32
"2011","Sandwell 019A","E01009986","Total",36,8,10,18,2,1,1,0,34,7,9,18
"2011","Sandwell 019B","E01009987","Total",45,11,5,29,5,2,0,3,40,9,5,26
"2011","Sandwell 019C","E01009989","Total",47,9,8,30,7,1,3,3,40,8,5,27
"2011","Sandwell 019D","E01010106","Total",34,9,7,18,4,0,2,2,30,9,5,16
"2011","Sandwell 020A","E01009988","Total",73,27,10,36,6,1,4,1,67,26,6,35
"2011","Sandwell 020B","E01010101","Total",54,18,18,18,6,3,2,1,48,15,16,17
"2011","Sandwell 020C","E01010102","Total",50,16,14,20,1,0,1,0,49,16,13,20
"2011","Sandwell 020D","E01010107","Total",73,17,15,41,7,1,2,4,66,16,13,37
"2011","Sandwell 021A","E01010015","Total",31,8,10,13,1,0,1,0,30,8,9,13
"2011","Sandwell 021B","E01010016","Total",55,20,12,23,10,1,2,7,45,19,10,16
"2011","Sandwell 021C","E01010018","Total",105,29,33,43,5,0,3,2,100,29,30,41
"2011","Sandwell 021D","E01010072","Total",85,16,31,38,9,0,6,3,76,16,25,35
"2011","Sandwell 021E","E01010073","Total",69,20,12,37,5,0,3,2,64,20,9,35
"2011","Sandwell 022A","E01010077","Total",71,26,13,32,5,2,0,3,66,24,13,29
"2011","Sandwell 022B","E01010079","Total",34,15,8,11,4,0,2,2,30,15,6,9
"2011","Sandwell 022C","E01010080","Total",112,16,27,69,6,0,4,2,106,16,23,67
"2011","Sandwell 022D","E01010081","Total",39,15,17,7,4,1,3,0,35,14,14,7
"2011","Sandwell 022E","E01010082","Total",57,19,14,24,5,0,3,2,52,19,11,22
"2011","Sandwell 022F","E01010083","Total",54,24,10,20,3,0,2,1,51,24,8,19
"2011","Sandwell 022G","E01010084","Total",96,29,15,52,2,0,1,1,94,29,14,51
"2011","Sandwell 023A","E01010046","Total",74,11,12,51,3,2,0,1,71,9,12,50
"2011","Sandwell 023B","E01010047","Total",44,16,6,22,3,1,1,1,41,15,5,21
"2011","Sandwell 023C","E01010048","Total",49,8,10,31,5,1,3,1,44,7,7,30
"2011","Sandwell 023D","E01010049","Total",50,10,11,29,3,0,3,0,47,10,8,29
"2011","Sandwell 023E","E01010050","Total",31,6,7,18,4,0,1,3,27,6,6,15
"2011","Sandwell 023F","E01010052","Total",39,11,8,20,3,0,1,2,36,11,7,18
"2011","Sandwell 023G","E01010053","Total",90,19,15,56,4,0,1,3,86,19,14,53
"2011","Sandwell 024A","E01010017","Total",69,14,22,33,6,2,2,2,63,12,20,31
"2011","Sandwell 024B","E01010019","Total",58,11,13,34,5,0,2,3,53,11,11,31
"2011","Sandwell 024C","E01010020","Total",79,22,18,39,7,2,3,2,72,20,15,37
"2011","Sandwell 024D","E01010021","Total",88,28,19,41,4,0,1,3,84,28,18,38
"2011","Sandwell 025A","E01010039","Total",55,21,6,28,2,1,1,0,53,20,5,28
"2011","Sandwell 025B","E01010043","Total",33,9,16,8,3,0,2,1,30,9,14,7
"2011","Sandwell 025C","E01010044","Total",66,20,13,33,5,0,2,3,61,20,11,30
"2011","Sandwell 025D","E01010078","Total",9,1,3,5,1,0,0,1,8,1,3,4
"2011","Sandwell 026A","E01010059","Total",79,25,18,36,5,2,1,2,74,23,17,34
"2011","Sandwell 026B","E01010061","Total",60,13,8,39,3,1,1,1,57,12,7,38
"2011","Sandwell 026C","E01010062","Total",97,39,14,44,8,0,3,5,89,39,11,39
"2011","Sandwell 026D","E01010063","Total",136,36,18,82,15,1,2,12,121,35,16,70
"2011","Sandwell 026E","E01010064","Total",79,25,17,37,7,1,3,3,72,24,14,34
"2011","Sandwell 026F","E01010065","Total",129,38,20,71,10,3,0,7,119,35,20,64
"2011","Sandwell 027A","E01009934","Total",80,22,18,40,5,0,4,1,75,22,14,39
"2011","Sandwell 027B","E01009935","Total",85,28,22,35,10,1,6,3,75,27,16,32
"2011","Sandwell 027C","E01009936","Total",32,17,8,7,6,1,3,2,26,16,5,5
"2011","Sandwell 027D","E01010004","Total",62,14,17,31,4,1,3,0,58,13,14,31
"2011","Sandwell 028A","E01010054","Total",90,19,19,52,6,0,2,4,84,19,17,48
"2011","Sandwell 028B","E01010055","Total",55,11,13,31,8,0,5,3,47,11,8,28
"2011","Sandwell 028C","E01010056","Total",55,15,10,30,2,0,1,1,53,15,9,29
"2011","Sandwell 028D","E01010057","Total",47,13,5,29,4,1,0,3,43,12,5,26
"2011","Sandwell 028E","E01010060","Total",79,20,15,44,8,0,5,3,71,20,10,41
"2011","Sandwell 029A","E01010038","Total",81,26,15,40,4,0,2,2,77,26,13,38
"2011","Sandwell 029B","E01010040","Total",43,14,12,17,3,2,0,1,40,12,12,16
"2011","Sandwell 029C","E01010041","Total",79,20,14,45,10,0,4,6,69,20,10,39
"2011","Sandwell 029D","E01010045","Total",59,18,13,28,5,1,2,2,54,17,11,26
"2011","Sandwell 030A","E01010000","Total",41,6,15,20,6,0,4,2,35,6,11,18
"2011","Sandwell 030B","E01010002","Total",70,23,25,22,6,0,5,1,64,23,20,21
"2011","Sandwell 030C","E01010003","Total",68,17,12,39,4,0,2,2,64,17,10,37
"2011","Sandwell 030D","E01010005","Total",47,16,9,22,2,0,0,2,45,16,9,20
"2011","Sandwell 030E","E01010006","Total",34,11,12,11,1,0,0,1,33,11,12,10
"2011","Sandwell 031A","E01009938","Total",68,26,17,25,3,1,0,2,65,25,17,23
"2011","Sandwell 031B","E01009943","Total",57,15,11,31,5,0,1,4,52,15,10,27
"2011","Sandwell 031C","E01009944","Total",45,18,8,19,2,0,1,1,43,18,7,18
"2011","Sandwell 031D","E01010051","Total",60,25,12,23,2,0,1,1,58,25,11,22
"2011","Sandwell 031E","E01010058","Total",83,29,21,33,8,1,2,5,75,28,19,28
"2011","Sandwell 032A","E01009937","Total",66,17,15,34,3,1,1,1,63,16,14,33
"2011","Sandwell 032B","E01009939","Total",36,14,12,10,4,2,1,1,32,12,11,9
"2011","Sandwell 032C","E01009940","Total",58,21,9,28,5,0,3,2,53,21,6,26
"2011","Sandwell 032D","E01009941","Total",45,12,14,19,1,0,0,1,44,12,14,18
"2011","Sandwell 032E","E01009942","Total",74,24,17,33,5,0,1,4,69,24,16,29
"2011","Sandwell 033A","E01009929","Total",86,26,8,52,8,1,2,5,78,25,6,47
"2011","Sandwell 033B","E01009930","Total",56,17,12,27,4,0,3,1,52,17,9,26
"2011","Sandwell 033C","E01009931","Total",48,15,18,15,5,0,4,1,43,15,14,14
"2011","Sandwell 033D","E01009932","Total",63,21,21,21,8,0,5,3,55,21,16,18
"2011","Sandwell 033E","E01009999","Total",53,20,10,23,4,1,2,1,49,19,8,22
"2011","Sandwell 034A","E01009921","Total",50,27,11,12,3,1,2,0,47,26,9,12
"2011","Sandwell 034B","E01009922","Total",56,19,15,22,6,0,4,2,50,19,11,20
"2011","Sandwell 034C","E01009924","Total",37,19,13,5,0,0,0,0,37,19,13,5
"2011","Sandwell 034D","E01009925","Total",20,2,14,4,3,1,2,0,17,1,12,4
"2011","Sandwell 034E","E01009926","Total",48,21,10,17,2,0,1,1,46,21,9,16
"2011","Sandwell 034F","E01009927","Total",32,14,12,6,5,3,0,2,27,11,12,4
"2011","Sandwell 034G","E01009928","Total",87,27,21,39,4,0,1,3,83,27,20,36
"2011","Sandwell 035A","E01009933","Total",57,14,10,33,7,1,1,5,50,13,9,28
"2011","Sandwell 035B","E01009952","Total",89,30,16,43,3,0,1,2,86,30,15,41
"2011","Sandwell 035C","E01009955","Total",58,15,20,23,8,0,4,4,50,15,16,19
"2011","Sandwell 035D","E01009956","Total",50,20,8,22,6,2,3,1,44,18,5,21
"2011","Sandwell 035E","E01009959","Total",20,6,10,4,3,0,3,0,17,6,7,4
"2011","Sandwell 035F","E01010042","Total",54,17,14,23,4,0,2,2,50,17,12,21
"2011","Sandwell 036A","E01009923","Total",50,12,19,19,8,1,3,4,42,11,16,15
"2011","Sandwell 036B","E01010024","Total",31,11,12,8,2,2,0,0,29,9,12,8
"2011","Sandwell 036C","E01010026","Total",50,15,14,21,3,0,2,1,47,15,12,20
"2011","Sandwell 036D","E01010027","Total",25,8,10,7,3,0,3,0,22,8,7,7
"2011","Sandwell 037A","E01010001","Total",63,21,17,25,4,0,3,1,59,21,14,24
"2011","Sandwell 037B","E01010022","Total",49,15,19,15,4,1,3,0,45,14,16,15
"2011","Sandwell 037C","E01010023","Total",37,9,16,12,4,1,2,1,33,8,14,11
"2011","Sandwell 037D","E01010025","Total",53,20,12,21,5,1,1,3,48,19,11,18
"2011","Sandwell 037E","E01010028","Total",79,22,24,33,4,1,2,1,75,21,22,32
"2011","Sandwell 038A","E01009953","Total",58,20,14,24,8,1,4,3,50,19,10,21
"2011","Sandwell 038B","E01009954","Total",45,12,10,23,2,0,2,0,43,12,8,23
"2011","Sandwell 038C","E01009957","Total",85,21,8,56,6,1,1,4,79,20,7,52
"2011","Sandwell 038D","E01009958","Total",25,12,6,7,3,1,1,1,22,11,5,6
"2011","Sandwell 039A","E01009946","Total",29,14,7,8,3,1,1,1,26,13,6,7
"2011","Sandwell 039B","E01009948","Total",22,7,9,6,3,0,2,1,19,7,7,5
"2011","Sandwell 039C","E01009949","Total",21,9,10,2,4,1,3,0,17,8,7,2
"2011","Sandwell 039D","E01009950","Total",36,10,11,15,4,1,0,3,32,9,11,12
"2011","Sandwell 039E","E01009951","Total",125,26,25,74,11,0,3,8,114,26,22,66
"2011","Sandwell 039F","E01032592","Total",55,24,11,20,1,0,1,0,54,24,10,20
"2011","Solihull 001A","E01010118","Total",35,12,12,11,6,2,3,1,29,10,9,10
"2011","Solihull 001B","E01010120","Total",68,29,16,23,3,1,1,1,65,28,15,22
"2011","Solihull 001C","E01010121","Total",17,1,9,7,3,0,3,0,14,1,6,7
"2011","Solihull 001D","E01010122","Total",20,4,7,9,2,0,2,0,18,4,5,9
"2011","Solihull 002A","E01010235","Total",90,33,13,44,7,1,4,2,83,32,9,42
"2011","Solihull 002B","E01010236","Total",138,38,22,78,10,1,2,7,128,37,20,71
"2011","Solihull 002C","E01010239","Total",85,29,16,40,6,0,4,2,79,29,12,38
"2011","Solihull 002D","E01010240","Total",83,33,19,31,9,3,1,5,74,30,18,26
"2011","Solihull 003A","E01010117","Total",31,12,11,8,2,0,2,0,29,12,9,8
"2011","Solihull 003B","E01010119","Total",23,6,12,5,2,0,2,0,21,6,10,5
"2011","Solihull 003C","E01010123","Total",23,8,12,3,3,0,2,1,20,8,10,2
"2011","Solihull 003D","E01010124","Total",14,7,4,3,2,0,2,0,12,7,2,3
"2011","Solihull 004A","E01010146","Total",113,37,18,58,5,0,1,4,108,37,17,54
"2011","Solihull 004B","E01010234","Total",95,22,17,56,6,0,3,3,89,22,14,53
"2011","Solihull 004C","E01010237","Total",101,31,27,43,5,0,4,1,96,31,23,42
"2011","Solihull 004D","E01010238","Total",102,34,18,50,8,1,1,6,94,33,17,44
"2011","Solihull 005A","E01010145","Total",49,16,10,23,4,0,0,4,45,16,10,19
"2011","Solihull 005B","E01010147","Total",156,39,26,91,9,2,4,3,147,37,22,88
"2011","Solihull 005C","E01010148","Total",148,56,24,68,10,1,2,7,138,55,22,61
"2011","Solihull 005D","E01010149","Total",45,19,18,8,3,2,1,0,42,17,17,8
"2011","Solihull 006A","E01010125","Total",104,30,21,53,6,1,2,3,98,29,19,50
"2011","Solihull 006B","E01010129","Total",128,34,20,74,7,0,1,6,121,34,19,68
"2011","Solihull 006C","E01010139","Total",31,9,7,15,3,0,0,3,28,9,7,12
"2011","Solihull 006D","E01010141","Total",109,29,16,64,6,2,1,3,103,27,15,61
"2011","Solihull 007A","E01010140","Total",100,38,10,52,5,0,1,4,95,38,9,48
"2011","Solihull 007B","E01010142","Total",120,31,20,69,11,1,5,5,109,30,15,64
"2011","Solihull 007C","E01010143","Total",107,33,29,45,4,0,1,3,103,33,28,42
"2011","Solihull 007D","E01010144","Total",57,14,19,24,4,0,4,0,53,14,15,24
"2011","Solihull 008A","E01010111","Total",124,36,29,59,13,0,7,6,111,36,22,53
"2011","Solihull 008B","E01010126","Total",100,33,14,53,9,2,2,5,91,31,12,48
"2011","Solihull 008C","E01010127","Total",94,34,21,39,8,1,4,3,86,33,17,36
"2011","Solihull 008D","E01010128","Total",88,41,14,33,11,7,2,2,77,34,12,31
"2011","Solihull 008E","E01010130","Total",165,39,33,93,10,5,1,4,155,34,32,89
"2011","Solihull 008F","E01010131","Total",107,39,18,50,5,2,3,0,102,37,15,50
"2011","Solihull 009A","E01010109","Total",27,12,11,4,3,1,1,1,24,11,10,3
"2011","Solihull 009B","E01010110","Total",43,18,15,10,2,0,2,0,41,18,13,10
"2011","Solihull 009C","E01010112","Total",70,28,12,30,3,0,1,2,67,28,11,28
"2011","Solihull 009D","E01010113","Total",61,14,19,28,3,1,1,1,58,13,18,27
"2011","Solihull 009E","E01010114","Total",37,17,8,12,1,0,0,1,36,17,8,11
"2011","Solihull 010A","E01010157","Total",39,18,13,8,1,0,1,0,38,18,12,8
"2011","Solihull 010B","E01010159","Total",47,9,20,18,7,0,4,3,40,9,16,15
"2011","Solihull 010C","E01010162","Total",25,6,9,10,3,0,3,0,22,6,6,10
"2011","Solihull 010D","E01010163","Total",27,10,7,10,0,0,0,0,27,10,7,10
"2011","Solihull 011A","E01010132","Total",49,15,17,17,5,3,2,0,44,12,15,17
"2011","Solihull 011B","E01010133","Total",34,11,11,12,7,1,6,0,27,10,5,12
"2011","Solihull 011C","E01010134","Total",29,6,9,14,2,0,2,0,27,6,7,14
"2011","Solihull 011D","E01010135","Total",33,11,8,14,2,1,1,0,31,10,7,14
"2011","Solihull 011E","E01010138","Total",35,14,12,9,8,1,6,1,27,13,6,8
"2011","Solihull 012A","E01010136","Total",30,12,9,9,1,0,1,0,29,12,8,9
"2011","Solihull 012B","E01010137","Total",43,18,10,15,6,1,2,3,37,17,8,12
"2011","Solihull 012C","E01010158","Total",66,20,13,33,5,0,2,3,61,20,11,30
"2011","Solihull 012D","E01010160","Total",35,14,11,10,4,1,2,1,31,13,9,9
"2011","Solihull 012E","E01010161","Total",21,9,8,4,2,0,1,1,19,9,7,3
"2011","Solihull 013A","E01010174","Total",49,13,19,17,5,1,4,0,44,12,15,17
"2011","Solihull 013B","E01010175","Total",38,11,16,11,3,0,3,0,35,11,13,11
"2011","Solihull 013C","E01010177","Total",38,12,13,13,4,1,0,3,34,11,13,10
"2011","Solihull 013D","E01010178","Total",59,17,14,28,6,1,2,3,53,16,12,25
"2011","Solihull 014A","E01010172","Total",23,8,10,5,1,0,1,0,22,8,9,5
"2011","Solihull 014B","E01010173","Total",15,4,7,4,1,0,1,0,14,4,6,4
"2011","Solihull 014C","E01010176","Total",16,5,5,6,2,0,2,0,14,5,3,6
"2011","Solihull 014D","E01010179","Total",29,10,12,7,4,0,4,0,25,10,8,7
"2011","Solihull 015A","E01010115","Total",37,18,8,11,6,0,2,4,31,18,6,7
"2011","Solihull 015B","E01010116","Total",13,4,4,5,3,0,2,1,10,4,2,4
"2011","Solihull 015C","E01010227","Total",21,12,6,3,2,1,1,0,19,11,5,3
"2011","Solihull 015D","E01010228","Total",34,20,8,6,1,0,1,0,33,20,7,6
"2011","Solihull 015E","E01010232","Total",101,33,31,37,7,1,4,2,94,32,27,35
"2011","Solihull 016A","E01010195","Total",13,3,6,4,2,0,2,0,11,3,4,4
"2011","Solihull 016B","E01010226","Total",26,7,8,11,4,1,3,0,22,6,5,11
"2011","Solihull 016C","E01010229","Total",6,2,2,2,1,0,1,0,5,2,1,2
"2011","Solihull 016D","E01010230","Total",56,14,11,31,2,0,0,2,54,14,11,29
"2011","Solihull 016E","E01010231","Total",20,7,10,3,3,0,2,1,17,7,8,2
"2011","Solihull 016F","E01010233","Total",51,21,14,16,9,2,4,3,42,19,10,13
"2011","Solihull 017A","E01010108","Total",29,7,13,9,6,1,5,0,23,6,8,9
"2011","Solihull 017B","E01010164","Total",20,9,8,3,2,0,2,0,18,9,6,3
"2011","Solihull 017C","E01010165","Total",33,11,13,9,5,2,2,1,28,9,11,8
"2011","Solihull 017D","E01010167","Total",30,13,8,9,5,0,3,2,25,13,5,7
"2011","Solihull 018A","E01010199","Total",29,11,13,5,4,0,4,0,25,11,9,5
"2011","Solihull 018B","E01010200","Total",44,16,16,12,4,1,3,0,40,15,13,12
"2011","Solihull 018C","E01010201","Total",25,12,8,5,3,0,1,2,22,12,7,3
"2011","Solihull 018D","E01010204","Total",62,19,13,30,4,0,2,2,58,19,11,28
"2011","Solihull 018E","E01010205","Total",25,15,5,5,5,2,2,1,20,13,3,4
"2011","Solihull 018F","E01010206","Total",36,15,13,8,3,1,2,0,33,14,11,8
"2011","Solihull 019A","E01010192","Total",19,5,11,3,4,0,4,0,15,5,7,3
"2011","Solihull 019B","E01010196","Total",11,2,6,3,1,0,1,0,10,2,5,3
"2011","Solihull 019C","E01010197","Total",14,2,9,3,1,0,1,0,13,2,8,3
"2011","Solihull 019D","E01010198","Total",22,10,9,3,4,0,3,1,18,10,6,2
"2011","Solihull 021A","E01010218","Total",48,12,15,21,1,0,1,0,47,12,14,21
"2011","Solihull 021B","E01010219","Total",41,15,8,18,6,1,4,1,35,14,4,17
"2011","Solihull 021C","E01010221","Total",35,16,11,8,1,0,1,0,34,16,10,8
"2011","Solihull 021D","E01010222","Total",35,15,16,4,5,0,5,0,30,15,11,4
"2011","Solihull 022A","E01010191","Total",27,8,14,5,2,0,2,0,25,8,12,5
"2011","Solihull 022B","E01010202","Total",23,7,10,6,1,0,1,0,22,7,9,6
"2011","Solihull 022C","E01010203","Total",49,20,12,17,3,0,2,1,46,20,10,16
"2011","Solihull 022D","E01010209","Total",50,18,16,16,4,0,4,0,46,18,12,16
"2011","Solihull 022E","E01010213","Total",48,18,15,15,5,0,4,1,43,18,11,14
"2011","Solihull 023A","E01010208","Total",35,14,15,6,3,2,0,1,32,12,15,5
"2011","Solihull 023B","E01010210","Total",14,4,8,2,1,0,1,0,13,4,7,2
"2011","Solihull 023C","E01010211","Total",29,10,12,7,1,0,1,0,28,10,11,7
"2011","Solihull 023D","E01010217","Total",21,12,5,4,0,0,0,0,21,12,5,4
"2011","Solihull 024A","E01010190","Total",35,12,18,5,6,0,4,2,29,12,14,3
"2011","Solihull 024B","E01010193","Total",11,6,4,1,1,0,0,1,10,6,4,0
"2011","Solihull 024C","E01010194","Total",35,21,11,3,3,1,1,1,32,20,10,2
"2011","Solihull 024D","E01010207","Total",28,12,10,6,5,1,4,0,23,11,6,6
"2011","Solihull 025A","E01010166","Total",18,4,8,6,2,1,0,1,16,3,8,5
"2011","Solihull 025B","E01010168","Total",36,20,13,3,6,0,6,0,30,20,7,3
"2011","Solihull 025C","E01010169","Total",19,8,8,3,3,0,2,1,16,8,6,2
"2011","Solihull 025D","E01010170","Total",19,7,11,1,3,0,3,0,16,7,8,1
"2011","Solihull 025E","E01010171","Total",27,8,7,12,1,0,1,0,26,8,6,12
"2011","Solihull 026A","E01010151","Total",46,16,22,8,5,1,4,0,41,15,18,8
"2011","Solihull 026B","E01010152","Total",17,8,8,1,2,0,1,1,15,8,7,0
"2011","Solihull 026C","E01010153","Total",19,9,7,3,1,0,1,0,18,9,6,3
"2011","Solihull 026D","E01010154","Total",15,3,9,3,4,0,4,0,11,3,5,3
"2011","Solihull 026E","E01010155","Total",26,7,9,10,5,0,3,2,21,7,6,8
"2011","Solihull 026F","E01010156","Total",22,11,8,3,3,0,2,1,19,11,6,2
"2011","Solihull 027A","E01010212","Total",11,5,3,3,1,0,1,0,10,5,2,3
"2011","Solihull 027B","E01010214","Total",21,5,10,6,2,0,2,0,19,5,8,6
"2011","Solihull 027C","E01010215","Total",37,18,14,5,4,2,2,0,33,16,12,5
"2011","Solihull 027D","E01010216","Total",30,10,10,10,7,1,2,4,23,9,8,6
"2011","Solihull 028A","E01010150","Total",19,9,9,1,2,0,2,0,17,9,7,1
"2011","Solihull 028B","E01010184","Total",50,16,18,16,8,0,6,2,42,16,12,14
"2011","Solihull 028C","E01010185","Total",8,1,3,4,0,0,0,0,8,1,3,4
"2011","Solihull 028D","E01010186","Total",48,23,20,5,2,0,2,0,46,23,18,5
"2011","Solihull 028E","E01010187","Total",23,9,11,3,1,0,1,0,22,9,10,3
"2011","Solihull 028F","E01010188","Total",8,3,5,0,2,0,2,0,6,3,3,0
"2011","Solihull 029A","E01010180","Total",23,11,9,3,3,1,2,0,20,10,7,3
"2011","Solihull 029B","E01010181","Total",38,18,13,7,5,1,4,0,33,17,9,7
"2011","Solihull 029D","E01010183","Total",25,12,9,4,1,0,1,0,24,12,8,4
"2011","Solihull 029E","E01010189","Total",29,12,14,3,3,0,3,0,26,12,11,3
"2011","Solihull 029F","E01032885","Total",40,8,18,14,8,0,5,3,32,8,13,11
"2011","Solihull 029G","E01032886","Total",48,21,18,9,6,1,4,1,42,20,14,8
"2011","Solihull 030A","E01010220","Total",38,13,16,9,3,0,1,2,35,13,15,7
"2011","Solihull 030B","E01010223","Total",38,9,12,17,1,0,1,0,37,9,11,17
"2011","Solihull 030C","E01010225","Total",47,21,15,11,3,0,1,2,44,21,14,9
"2011","Solihull 030D","E01032590","Total",36,18,10,8,3,0,2,1,33,18,8,7
"2011","Walsall 001A","E01010301","Total",65,22,12,31,3,0,2,1,62,22,10,30
"2011","Walsall 001B","E01010303","Total",34,12,12,10,4,0,4,0,30,12,8,10
"2011","Walsall 001C","E01010306","Total",45,15,21,9,5,1,3,1,40,14,18,8
"2011","Walsall 001D","E01010307","Total",44,14,16,14,6,1,5,0,38,13,11,14
"2011","Walsall 002A","E01010302","Total",49,11,11,27,10,0,3,7,39,11,8,20
"2011","Walsall 002B","E01010304","Total",36,7,11,18,6,0,4,2,30,7,7,16
"2011","Walsall 002C","E01010305","Total",53,11,10,32,2,1,0,1,51,10,10,31
"2011","Walsall 002D","E01010308","Total",34,15,7,12,4,0,1,3,30,15,6,9
"2011","Walsall 003A","E01010345","Total",15,6,5,4,2,0,1,1,13,6,4,3
"2011","Walsall 003B","E01010346","Total",33,19,10,4,4,1,1,2,29,18,9,2
"2011","Walsall 003C","E01010347","Total",59,16,8,35,3,0,1,2,56,16,7,33
"2011","Walsall 003D","E01010350","Total",25,8,9,8,1,0,1,0,24,8,8,8
"2011","Walsall 004A","E01010249","Total",74,24,21,29,6,0,2,4,68,24,19,25
"2011","Walsall 004B","E01010250","Total",29,10,8,11,1,0,0,1,28,10,8,10
"2011","Walsall 004C","E01010252","Total",73,23,20,30,8,2,5,1,65,21,15,29
"2011","Walsall 004D","E01010254","Total",34,11,9,14,2,0,1,1,32,11,8,13
"2011","Walsall 005A","E01010348","Total",44,19,11,14,1,0,1,0,43,19,10,14
"2011","Walsall 005B","E01010349","Total",31,14,5,12,0,0,0,0,31,14,5,12
"2011","Walsall 005C","E01010351","Total",34,17,7,10,5,0,4,1,29,17,3,9
"2011","Walsall 005D","E01010352","Total",23,5,10,8,3,0,2,1,20,5,8,7
"2011","Walsall 006A","E01010284","Total",55,20,9,26,3,0,0,3,52,20,9,23
"2011","Walsall 006B","E01010285","Total",35,12,5,18,4,1,1,2,31,11,4,16
"2011","Walsall 006C","E01010286","Total",68,15,6,47,3,0,0,3,65,15,6,44
"2011","Walsall 006D","E01010290","Total",51,16,17,18,5,1,1,3,46,15,16,15
"2011","Walsall 007A","E01010251","Total",12,6,4,2,1,1,0,0,11,5,4,2
"2011","Walsall 007B","E01010253","Total",41,13,15,13,2,0,1,1,39,13,14,12
"2011","Walsall 007C","E01010255","Total",14,7,4,3,0,0,0,0,14,7,4,3
"2011","Walsall 007D","E01010256","Total",33,7,12,14,11,0,2,9,22,7,10,5
"2011","Walsall 007E","E01010257","Total",11,4,5,2,1,1,0,0,10,3,5,2
"2011","Walsall 008A","E01010292","Total",65,21,11,33,4,1,1,2,61,20,10,31
"2011","Walsall 008B","E01010294","Total",62,18,13,31,4,0,1,3,58,18,12,28
"2011","Walsall 008C","E01010296","Total",39,18,15,6,1,0,1,0,38,18,14,6
"2011","Walsall 008D","E01010297","Total",10,6,3,1,1,0,1,0,9,6,2,1
"2011","Walsall 009A","E01010291","Total",76,23,10,43,9,0,3,6,67,23,7,37
"2011","Walsall 009B","E01010293","Total",44,9,9,26,5,0,2,3,39,9,7,23
"2011","Walsall 009C","E01010298","Total",40,17,8,15,6,0,3,3,34,17,5,12
"2011","Walsall 009D","E01010299","Total",80,26,12,42,9,1,3,5,71,25,9,37
"2011","Walsall 009E","E01010300","Total",56,12,8,36,7,0,2,5,49,12,6,31
"2011","Walsall 010A","E01010319","Total",17,9,6,2,3,3,0,0,14,6,6,2
"2011","Walsall 010B","E01010321","Total",50,17,9,24,4,2,1,1,46,15,8,23
"2011","Walsall 010C","E01010353","Total",50,23,6,21,2,0,1,1,48,23,5,20
"2011","Walsall 010D","E01010354","Total",37,9,8,20,6,2,4,0,31,7,4,20
"2011","Walsall 011A","E01010395","Total",22,8,9,5,2,0,2,0,20,8,7,5
"2011","Walsall 011B","E01010397","Total",66,18,9,39,5,2,1,2,61,16,8,37
"2011","Walsall 011C","E01010398","Total",27,10,12,5,4,0,3,1,23,10,9,4
"2011","Walsall 011D","E01010399","Total",46,15,9,22,6,0,2,4,40,15,7,18
"2011","Walsall 012A","E01010282","Total",69,21,8,40,8,2,3,3,61,19,5,37
"2011","Walsall 012B","E01010287","Total",52,17,16,19,5,0,5,0,47,17,11,19
"2011","Walsall 012C","E01010288","Total",67,17,14,36,3,0,1,2,64,17,13,34
"2011","Walsall 012D","E01010289","Total",61,15,10,36,9,3,3,3,52,12,7,33
"2011","Walsall 013B","E01010277","Total",60,14,15,31,4,0,4,0,56,14,11,31
"2011","Walsall 013D","E01010283","Total",96,24,11,61,8,2,3,3,88,22,8,58
"2011","Walsall 013E","E01032889","Total",75,13,5,57,4,1,0,3,71,12,5,54
"2011","Walsall 014A","E01010393","Total",26,12,8,6,3,0,2,1,23,12,6,5
"2011","Walsall 014B","E01010394","Total",25,8,8,9,3,1,1,1,22,7,7,8
"2011","Walsall 014C","E01010396","Total",37,14,12,11,0,0,0,0,37,14,12,11
"2011","Walsall 014D","E01010400","Total",94,22,14,58,6,1,3,2,88,21,11,56
"2011","Walsall 015A","E01010241","Total",54,26,15,13,5,2,2,1,49,24,13,12
"2011","Walsall 015B","E01010242","Total",51,18,10,23,2,0,2,0,49,18,8,23
"2011","Walsall 015C","E01010243","Total",32,15,11,6,3,0,3,0,29,15,8,6
"2011","Walsall 015D","E01010244","Total",93,27,18,48,7,1,3,3,86,26,15,45
"2011","Walsall 016A","E01010320","Total",48,20,14,14,2,0,1,1,46,20,13,13
"2011","Walsall 016B","E01010322","Total",46,14,9,23,4,2,2,0,42,12,7,23
"2011","Walsall 016C","E01010323","Total",33,8,9,16,2,0,1,1,31,8,8,15
"2011","Walsall 016D","E01010324","Total",42,8,17,17,5,0,3,2,37,8,14,15
"2011","Walsall 017A","E01010271","Total",97,27,8,62,1,0,0,1,96,27,8,61
"2011","Walsall 017B","E01010272","Total",102,34,11,57,8,3,0,5,94,31,11,52
"2011","Walsall 017C","E01010273","Total",98,23,15,60,10,1,3,6,88,22,12,54
"2011","Walsall 017D","E01010295","Total",56,18,7,31,5,1,1,3,51,17,6,28
"2011","Walsall 018B","E01010279","Total",70,8,21,41,7,2,0,5,63,6,21,36
"2011","Walsall 018D","E01010374","Total",82,15,17,50,4,0,3,1,78,15,14,49
"2011","Walsall 018E","E01010375","Total",87,20,25,42,12,1,8,3,75,19,17,39
"2011","Walsall 018F","E01032888","Total",100,28,10,62,9,2,4,3,91,26,6,59
"2011","Walsall 019A","E01010378","Total",30,15,6,9,4,0,3,1,26,15,3,8
"2011","Walsall 019B","E01010379","Total",19,4,8,7,1,0,0,1,18,4,8,6
"2011","Walsall 019C","E01010382","Total",39,9,13,17,0,0,0,0,39,9,13,17
"2011","Walsall 019D","E01010383","Total",73,29,15,29,6,1,5,0,67,28,10,29
"2011","Walsall 020A","E01010376","Total",11,6,2,3,2,1,1,0,9,5,1,3
"2011","Walsall 020B","E01010377","Total",42,12,9,21,3,0,1,2,39,12,8,19
"2011","Walsall 020C","E01010380","Total",11,4,4,3,1,0,1,0,10,4,3,3
"2011","Walsall 020D","E01010381","Total",52,13,16,23,12,0,5,7,40,13,11,16
"2011","Walsall 021A","E01010267","Total",42,16,15,11,1,0,1,0,41,16,14,11
"2011","Walsall 021B","E01010268","Total",52,9,12,31,2,0,1,1,50,9,11,30
"2011","Walsall 021C","E01010274","Total",82,23,7,52,6,0,2,4,76,23,5,48
"2011","Walsall 021D","E01010275","Total",71,23,7,41,2,0,0,2,69,23,7,39
"2011","Walsall 022A","E01010245","Total",25,9,14,2,1,0,1,0,24,9,13,2
"2011","Walsall 022B","E01010246","Total",38,14,16,8,4,0,3,1,34,14,13,7
"2011","Walsall 022C","E01010247","Total",27,7,11,9,3,1,1,1,24,6,10,8
"2011","Walsall 022D","E01010248","Total",16,9,6,1,2,1,1,0,14,8,5,1
"2011","Walsall 022E","E01010388","Total",16,6,8,2,5,0,3,2,11,6,5,0
"2011","Walsall 023A","E01010258","Total",103,21,12,70,8,0,1,7,95,21,11,63
"2011","Walsall 023B","E01010259","Total",41,16,13,12,4,1,3,0,37,15,10,12
"2011","Walsall 023C","E01010260","Total",50,13,7,30,4,1,3,0,46,12,4,30
"2011","Walsall 023D","E01010266","Total",72,17,14,41,7,2,2,3,65,15,12,38
"2011","Walsall 024A","E01010317","Total",8,2,4,2,0,0,0,0,8,2,4,2
"2011","Walsall 024B","E01010318","Total",60,17,11,32,1,0,0,1,59,17,11,31
"2011","Walsall 024C","E01010325","Total",36,11,12,13,0,0,0,0,36,11,12,13
"2011","Walsall 024D","E01010369","Total",72,11,18,43,8,1,5,2,64,10,13,41
"2011","Walsall 025A","E01010401","Total",82,15,14,53,8,1,2,5,74,14,12,48
"2011","Walsall 025B","E01010403","Total",101,22,22,57,4,1,1,2,97,21,21,55
"2011","Walsall 025C","E01010404","Total",89,20,23,46,7,1,4,2,82,19,19,44
"2011","Walsall 025D","E01010407","Total",63,21,12,30,3,0,1,2,60,21,11,28
"2011","Walsall 025E","E01010408","Total",61,17,9,35,7,2,4,1,54,15,5,34
"2011","Walsall 026A","E01010269","Total",64,14,11,39,3,0,2,1,61,14,9,38
"2011","Walsall 026B","E01010270","Total",58,11,10,37,1,1,0,0,57,10,10,37
"2011","Walsall 026C","E01010362","Total",74,14,11,49,9,0,2,7,65,14,9,42
"2011","Walsall 026D","E01010363","Total",73,9,14,50,8,0,4,4,65,9,10,46
"2011","Walsall 027A","E01010402","Total",44,15,11,18,4,0,2,2,40,15,9,16
"2011","Walsall 027B","E01010405","Total",52,17,12,23,8,2,3,3,44,15,9,20
"2011","Walsall 027C","E01010406","Total",122,26,38,58,12,0,7,5,110,26,31,53
"2011","Walsall 027D","E01010409","Total",72,19,14,39,1,0,1,0,71,19,13,39
"2011","Walsall 028A","E01010385","Total",13,2,7,4,3,0,1,2,10,2,6,2
"2011","Walsall 028B","E01010386","Total",27,16,7,4,1,0,1,0,26,16,6,4
"2011","Walsall 028C","E01010387","Total",22,9,8,5,4,0,3,1,18,9,5,4
"2011","Walsall 028D","E01010392","Total",25,5,14,6,3,0,2,1,22,5,12,5
"2011","Walsall 029A","E01010326","Total",20,10,6,4,2,1,1,0,18,9,5,4
"2011","Walsall 029B","E01010327","Total",68,12,24,32,9,0,4,5,59,12,20,27
"2011","Walsall 029C","E01010328","Total",14,7,4,3,2,0,2,0,12,7,2,3
"2011","Walsall 029D","E01010330","Total",42,13,14,15,4,2,2,0,38,11,12,15
"2011","Walsall 030A","E01010368","Total",84,20,12,52,8,1,5,2,76,19,7,50
"2011","Walsall 030B","E01010370","Total",67,22,12,33,7,2,2,3,60,20,10,30
"2011","Walsall 030C","E01010371","Total",88,17,14,57,17,4,4,9,71,13,10,48
"2011","Walsall 030D","E01010372","Total",36,12,6,18,4,2,0,2,32,10,6,16
"2011","Walsall 030E","E01010373","Total",26,3,13,10,2,0,2,0,24,3,11,10
"2011","Walsall 031A","E01010361","Total",52,22,13,17,22,13,5,4,30,9,8,13
"2011","Walsall 031B","E01010364","Total",55,11,13,31,5,2,3,0,50,9,10,31
"2011","Walsall 031C","E01010365","Total",76,20,10,46,10,1,2,7,66,19,8,39
"2011","Walsall 031D","E01010366","Total",78,21,9,48,3,1,0,2,75,20,9,46
"2011","Walsall 031E","E01010367","Total",59,18,8,33,4,0,0,4,55,18,8,29
"2011","Walsall 032A","E01010384","Total",32,16,10,6,3,0,2,1,29,16,8,5
"2011","Walsall 032B","E01010389","Total",15,4,4,7,3,0,2,1,12,4,2,6
"2011","Walsall 032C","E01010390","Total",29,17,12,0,1,0,1,0,28,17,11,0
"2011","Walsall 032D","E01010391","Total",37,15,19,3,5,0,3,2,32,15,16,1
"2011","Walsall 033A","E01010261","Total",82,22,16,44,4,0,2,2,78,22,14,42
"2011","Walsall 033B","E01010263","Total",42,9,10,23,9,4,4,1,33,5,6,22
"2011","Walsall 033C","E01010264","Total",35,9,10,16,1,0,1,0,34,9,9,16
"2011","Walsall 033D","E01010265","Total",90,24,16,50,8,1,3,4,82,23,13,46
"2011","Walsall 034A","E01010336","Total",35,11,7,17,4,1,2,1,31,10,5,16
"2011","Walsall 034B","E01010340","Total",43,10,3,30,7,0,1,6,36,10,2,24
"2011","Walsall 034C","E01010341","Total",36,8,5,23,2,1,0,1,34,7,5,22
"2011","Walsall 034D","E01010342","Total",65,10,11,44,5,1,1,3,60,9,10,41
"2011","Walsall 034E","E01010343","Total",41,10,10,21,6,3,1,2,35,7,9,19
"2011","Walsall 034F","E01010344","Total",62,11,12,39,3,2,1,0,59,9,11,39
"2011","Walsall 035A","E01010331","Total",10,5,4,1,0,0,0,0,10,5,4,1
"2011","Walsall 035B","E01010332","Total",12,3,7,2,2,1,1,0,10,2,6,2
"2011","Walsall 035C","E01010333","Total",20,7,9,4,4,1,2,1,16,6,7,3
"2011","Walsall 035D","E01010334","Total",8,5,3,0,1,1,0,0,7,4,3,0
"2011","Walsall 036A","E01010262","Total",52,16,13,23,9,0,5,4,43,16,8,19
"2011","Walsall 036B","E01010309","Total",99,29,13,57,7,1,1,5,92,28,12,52
"2011","Walsall 036C","E01010311","Total",62,17,8,37,2,0,1,1,60,17,7,36
"2011","Walsall 036D","E01010316","Total",83,29,10,44,13,4,3,6,70,25,7,38
"2011","Walsall 037A","E01010335","Total",72,19,8,45,5,0,1,4,67,19,7,41
"2011","Walsall 037B","E01010337","Total",27,10,6,11,2,0,2,0,25,10,4,11
"2011","Walsall 037C","E01010338","Total",44,9,8,27,8,2,3,3,36,7,5,24
"2011","Walsall 037D","E01010339","Total",34,9,11,14,4,1,1,2,30,8,10,12
"2011","Walsall 038A","E01010310","Total",64,21,8,35,4,0,1,3,60,21,7,32
"2011","Walsall 038B","E01010312","Total",76,21,20,35,9,0,6,3,67,21,14,32
"2011","Walsall 038C","E01010313","Total",61,17,8,36,7,0,3,4,54,17,5,32
"2011","Walsall 038D","E01010314","Total",64,19,10,35,6,1,4,1,58,18,6,34
"2011","Walsall 038E","E01010315","Total",56,13,14,29,12,0,9,3,44,13,5,26
"2011","Walsall 039A","E01010329","Total",25,7,11,7,3,0,3,0,22,7,8,7
"2011","Walsall 039B","E01010355","Total",26,10,7,9,4,0,2,2,22,10,5,7
"2011","Walsall 039C","E01010356","Total",26,10,11,5,2,0,2,0,24,10,9,5
"2011","Walsall 039D","E01010357","Total",44,14,11,19,5,0,1,4,39,14,10,15
"2011","Walsall 039E","E01010358","Total",42,16,18,8,6,0,6,0,36,16,12,8
"2011","Walsall 039F","E01010359","Total",56,20,21,15,1,0,1,0,55,20,20,15
"2011","Walsall 039G","E01010360","Total",32,8,9,15,3,0,2,1,29,8,7,14
"2011","Wolverhampton 001A","E01010434","Total",77,18,21,38,6,1,2,3,71,17,19,35
"2011","Wolverhampton 001B","E01010436","Total",20,8,9,3,4,0,4,0,16,8,5,3
"2011","Wolverhampton 001C","E01010437","Total",16,3,12,1,1,0,1,0,15,3,11,1
"2011","Wolverhampton 001D","E01010438","Total",44,10,17,17,7,1,4,2,37,9,13,15
"2011","Wolverhampton 001E","E01010439","Total",59,23,9,27,2,0,1,1,57,23,8,26
"2011","Wolverhampton 001F","E01010440","Total",70,21,16,33,4,1,0,3,66,20,16,30
"2011","Wolverhampton 001G","E01010441","Total",80,17,18,45,7,0,3,4,73,17,15,41
"2011","Wolverhampton 002A","E01010495","Total",84,29,20,35,8,1,3,4,76,28,17,31
"2011","Wolverhampton 002B","E01010497","Total",21,6,9,6,3,0,3,0,18,6,6,6
"2011","Wolverhampton 002C","E01010499","Total",47,20,10,17,0,0,0,0,47,20,10,17
"2011","Wolverhampton 002D","E01010500","Total",97,27,15,55,8,0,3,5,89,27,12,50
"2011","Wolverhampton 003A","E01010496","Total",75,26,17,32,5,0,2,3,70,26,15,29
"2011","Wolverhampton 003B","E01010498","Total",37,11,14,12,4,1,2,1,33,10,12,11
"2011","Wolverhampton 003C","E01010541","Total",115,28,27,60,14,2,1,11,101,26,26,49
"2011","Wolverhampton 003D","E01010543","Total",105,23,27,55,6,0,4,2,99,23,23,53
"2011","Wolverhampton 004A","E01010456","Total",165,34,13,118,6,1,1,4,159,33,12,114
"2011","Wolverhampton 004B","E01010457","Total",41,13,14,14,9,0,7,2,32,13,7,12
"2011","Wolverhampton 004C","E01010462","Total",95,27,18,50,12,2,7,3,83,25,11,47
"2011","Wolverhampton 004D","E01010481","Total",102,21,17,64,7,2,2,3,95,19,15,61
"2011","Wolverhampton 005A","E01010555","Total",78,25,13,40,7,0,3,4,71,25,10,36
"2011","Wolverhampton 005B","E01010556","Total",38,17,8,13,3,0,1,2,35,17,7,11
"2011","Wolverhampton 005C","E01010557","Total",28,5,12,11,5,0,2,3,23,5,10,8
"2011","Wolverhampton 005D","E01010559","Total",45,14,10,21,1,0,0,1,44,14,10,20
"2011","Wolverhampton 005E","E01010560","Total",60,13,13,34,6,0,4,2,54,13,9,32
"2011","Wolverhampton 006A","E01010435","Total",89,24,15,50,9,1,3,5,80,23,12,45
"2011","Wolverhampton 006B","E01010501","Total",63,17,15,31,5,1,2,2,58,16,13,29
"2011","Wolverhampton 006C","E01010502","Total",25,9,8,8,4,1,2,1,21,8,6,7
"2011","Wolverhampton 006D","E01010503","Total",54,23,12,19,4,0,2,2,50,23,10,17
"2011","Wolverhampton 007A","E01010482","Total",82,26,11,45,6,0,1,5,76,26,10,40
"2011","Wolverhampton 007B","E01010483","Total",111,30,12,69,3,0,0,3,108,30,12,66
"2011","Wolverhampton 007C","E01010484","Total",76,22,12,42,4,0,1,3,72,22,11,39
"2011","Wolverhampton 007D","E01010485","Total",122,22,20,80,7,0,2,5,115,22,18,75
"2011","Wolverhampton 008A","E01010458","Total",65,22,19,24,4,0,1,3,61,22,18,21
"2011","Wolverhampton 008B","E01010459","Total",44,10,19,15,5,0,5,0,39,10,14,15
"2011","Wolverhampton 008C","E01010460","Total",39,8,19,12,4,0,3,1,35,8,16,11
"2011","Wolverhampton 008D","E01010461","Total",24,5,6,13,1,0,1,0,23,5,5,13
"2011","Wolverhampton 008E","E01010566","Total",56,18,15,23,3,0,2,1,53,18,13,22
"2011","Wolverhampton 009A","E01010539","Total",70,15,21,34,2,0,2,0,68,15,19,34
"2011","Wolverhampton 009B","E01010540","Total",19,8,7,4,2,1,1,0,17,7,6,4
"2011","Wolverhampton 009C","E01010542","Total",51,19,10,22,8,2,3,3,43,17,7,19
"2011","Wolverhampton 009D","E01010544","Total",21,6,9,6,5,1,3,1,16,5,6,5
"2011","Wolverhampton 009E","E01010545","Total",43,14,12,17,5,2,2,1,38,12,10,16
"2011","Wolverhampton 010A","E01010554","Total",24,6,8,10,1,0,1,0,23,6,7,10
"2011","Wolverhampton 010B","E01010558","Total",29,9,4,16,2,0,1,1,27,9,3,15
"2011","Wolverhampton 010C","E01010562","Total",53,14,11,28,6,0,3,3,47,14,8,25
"2011","Wolverhampton 010D","E01010563","Total",81,26,10,45,7,2,1,4,74,24,9,41
"2011","Wolverhampton 010E","E01010567","Total",57,20,10,27,3,0,1,2,54,20,9,25
"2011","Wolverhampton 011A","E01010478","Total",80,16,17,47,2,0,2,0,78,16,15,47
"2011","Wolverhampton 011B","E01010479","Total",68,23,12,33,6,1,2,3,62,22,10,30
"2011","Wolverhampton 011C","E01010480","Total",59,15,15,29,4,0,2,2,55,15,13,27
"2011","Wolverhampton 011D","E01010486","Total",148,38,15,95,14,3,2,9,134,35,13,86
"2011","Wolverhampton 012A","E01010474","Total",68,26,16,26,5,0,1,4,63,26,15,22
"2011","Wolverhampton 012B","E01010561","Total",26,10,10,6,3,0,3,0,23,10,7,6
"2011","Wolverhampton 012C","E01010564","Total",89,19,26,44,8,2,4,2,81,17,22,42
"2011","Wolverhampton 012D","E01010565","Total",33,11,14,8,3,1,2,0,30,10,12,8
"2011","Wolverhampton 013A","E01010522","Total",101,22,20,59,11,2,1,8,90,20,19,51
"2011","Wolverhampton 013B","E01010523","Total",64,18,21,25,8,0,7,1,56,18,14,24
"2011","Wolverhampton 013C","E01010524","Total",80,24,20,36,9,2,2,5,71,22,18,31
"2011","Wolverhampton 013D","E01010525","Total",74,21,13,40,3,0,1,2,71,21,12,38
"2011","Wolverhampton 014A","E01010546","Total",8,3,3,2,1,0,1,0,7,3,2,2
"2011","Wolverhampton 014B","E01010547","Total",31,3,16,12,3,0,3,0,28,3,13,12
"2011","Wolverhampton 014C","E01010548","Total",42,21,10,11,5,2,3,0,37,19,7,11
"2011","Wolverhampton 014D","E01010549","Total",50,11,20,19,5,0,3,2,45,11,17,17
"2011","Wolverhampton 014E","E01010553","Total",32,12,11,9,5,1,2,2,27,11,9,7
"2011","Wolverhampton 015A","E01010471","Total",92,27,18,47,11,2,4,5,81,25,14,42
"2011","Wolverhampton 015B","E01010472","Total",119,39,24,56,6,3,2,1,113,36,22,55
"2011","Wolverhampton 015C","E01010473","Total",172,33,27,112,18,3,5,10,154,30,22,102
"2011","Wolverhampton 015D","E01010475","Total",56,21,15,20,8,1,6,1,48,20,9,19
"2011","Wolverhampton 015E","E01010476","Total",101,26,19,56,13,3,3,7,88,23,16,49
"2011","Wolverhampton 015F","E01010477","Total",112,25,28,59,10,0,8,2,102,25,20,57
"2011","Wolverhampton 016A","E01010526","Total",59,13,10,36,2,1,1,0,57,12,9,36
"2011","Wolverhampton 016B","E01010527","Total",85,21,21,43,13,1,10,2,72,20,11,41
"2011","Wolverhampton 016C","E01010528","Total",22,2,4,16,2,0,1,1,20,2,3,15
"2011","Wolverhampton 016D","E01010529","Total",40,7,8,25,4,1,2,1,36,6,6,24
"2011","Wolverhampton 017A","E01010506","Total",53,15,15,23,6,0,0,6,47,15,15,17
"2011","Wolverhampton 017B","E01010508","Total",42,13,13,16,12,2,5,5,30,11,8,11
"2011","Wolverhampton 017C","E01010510","Total",47,18,17,12,3,1,0,2,44,17,17,10
"2011","Wolverhampton 017D","E01010511","Total",58,18,19,21,2,2,0,0,56,16,19,21
"2011","Wolverhampton 017E","E01010512","Total",36,10,19,7,4,1,3,0,32,9,16,7
"2011","Wolverhampton 018A","E01010442","Total",68,21,11,36,0,0,0,0,68,21,11,36
"2011","Wolverhampton 018B","E01010443","Total",109,27,14,68,9,0,5,4,100,27,9,64
"2011","Wolverhampton 018C","E01010444","Total",41,12,10,19,4,0,3,1,37,12,7,18
"2011","Wolverhampton 018D","E01010445","Total",90,17,18,55,7,1,3,3,83,16,15,52
"2011","Wolverhampton 018E","E01010447","Total",57,20,19,18,6,0,5,1,51,20,14,17
"2011","Wolverhampton 018F","E01010448","Total",62,20,10,32,4,1,1,2,58,19,9,30
"2011","Wolverhampton 019A","E01010509","Total",56,16,20,20,1,0,1,0,55,16,19,20
"2011","Wolverhampton 019B","E01010550","Total",10,0,6,4,2,0,2,0,8,0,4,4
"2011","Wolverhampton 019C","E01010551","Total",35,8,17,10,6,0,3,3,29,8,14,7
"2011","Wolverhampton 019D","E01010552","Total",58,27,15,16,2,1,0,1,56,26,15,15
"2011","Wolverhampton 020A","E01010463","Total",61,17,13,31,7,0,3,4,54,17,10,27
"2011","Wolverhampton 020B","E01010464","Total",70,22,9,39,4,0,1,3,66,22,8,36
"2011","Wolverhampton 020C","E01010465","Total",67,19,25,23,5,1,3,1,62,18,22,22
"2011","Wolverhampton 020D","E01010466","Total",67,19,19,29,3,1,1,1,64,18,18,28
"2011","Wolverhampton 020E","E01010470","Total",45,9,13,23,7,1,2,4,38,8,11,19
"2011","Wolverhampton 020F","E01010521","Total",95,26,22,47,10,5,2,3,85,21,20,44
"2011","Wolverhampton 021A","E01010487","Total",34,10,16,8,1,0,1,0,33,10,15,8
"2011","Wolverhampton 021B","E01010488","Total",36,7,15,14,4,0,2,2,32,7,13,12
"2011","Wolverhampton 021C","E01010493","Total",44,10,13,21,4,1,1,2,40,9,12,19
"2011","Wolverhampton 021D","E01010504","Total",12,2,7,3,4,0,4,0,8,2,3,3
"2011","Wolverhampton 021E","E01010505","Total",19,6,9,4,5,0,4,1,14,6,5,3
"2011","Wolverhampton 021F","E01010507","Total",15,2,10,3,5,0,5,0,10,2,5,3
"2011","Wolverhampton 022A","E01010418","Total",23,5,15,3,1,0,1,0,22,5,14,3
"2011","Wolverhampton 022B","E01010421","Total",83,27,11,45,7,1,1,5,76,26,10,40
"2011","Wolverhampton 022C","E01010423","Total",84,28,10,46,5,2,2,1,79,26,8,45
"2011","Wolverhampton 022D","E01010424","Total",30,8,10,12,3,1,2,0,27,7,8,12
"2011","Wolverhampton 023A","E01010417","Total",66,23,13,30,2,0,1,1,64,23,12,29
"2011","Wolverhampton 023B","E01010419","Total",56,16,10,30,3,1,1,1,53,15,9,29
"2011","Wolverhampton 023C","E01010420","Total",62,19,9,34,9,0,2,7,53,19,7,27
"2011","Wolverhampton 023D","E01010425","Total",56,21,14,21,4,1,0,3,52,20,14,18
"2011","Wolverhampton 023E","E01010446","Total",51,19,10,22,1,0,1,0,50,19,9,22
"2011","Wolverhampton 026A","E01010467","Total",38,12,9,17,8,0,4,4,30,12,5,13
"2011","Wolverhampton 026B","E01010468","Total",34,9,13,12,1,0,1,0,33,9,12,12
"2011","Wolverhampton 026C","E01010469","Total",36,15,8,13,4,0,3,1,32,15,5,12
"2011","Wolverhampton 026D","E01010516","Total",27,11,8,8,2,1,0,1,25,10,8,7
"2011","Wolverhampton 026E","E01010518","Total",25,8,12,5,8,2,4,2,17,6,8,3
"2011","Wolverhampton 027A","E01010414","Total",110,25,20,65,14,1,5,8,96,24,15,57
"2011","Wolverhampton 027B","E01010415","Total",110,18,26,66,10,0,5,5,100,18,21,61
"2011","Wolverhampton 027C","E01010416","Total",94,17,19,58,8,1,3,4,86,16,16,54
"2011","Wolverhampton 027D","E01010422","Total",28,8,3,17,2,0,1,1,26,8,2,16
"2011","Wolverhampton 028A","E01010489","Total",55,19,18,18,9,3,4,2,46,16,14,16
"2011","Wolverhampton 028B","E01010490","Total",119,35,26,58,10,1,4,5,109,34,22,53
"2011","Wolverhampton 028C","E01010491","Total",62,17,20,25,0,0,0,0,62,17,20,25
"2011","Wolverhampton 028D","E01010492","Total",18,8,4,6,1,0,1,0,17,8,3,6
"2011","Wolverhampton 028E","E01010494","Total",27,7,16,4,4,0,4,0,23,7,12,4
"2011","Wolverhampton 029A","E01010449","Total",152,23,48,81,13,0,4,9,139,23,44,72
"2011","Wolverhampton 029B","E01010450","Total",86,16,21,49,8,1,4,3,78,15,17,46
"2011","Wolverhampton 029C","E01010451","Total",49,18,15,16,4,1,3,0,45,17,12,16
"2011","Wolverhampton 029D","E01010452","Total",99,31,26,42,10,2,4,4,89,29,22,38
"2011","Wolverhampton 029E","E01010455","Total",131,17,29,85,3,0,0,3,128,17,29,82
"2011","Wolverhampton 030A","E01010427","Total",32,12,3,17,2,0,0,2,30,12,3,15
"2011","Wolverhampton 030B","E01010431","Total",24,10,6,8,3,2,1,0,21,8,5,8
"2011","Wolverhampton 030C","E01010432","Total",11,2,2,7,3,2,1,0,8,0,1,7
"2011","Wolverhampton 030D","E01010519","Total",30,13,7,10,4,2,2,0,26,11,5,10
"2011","Wolverhampton 030E","E01010520","Total",29,7,15,7,4,0,4,0,25,7,11,7
"2011","Wolverhampton 031A","E01010513","Total",17,5,7,5,2,0,2,0,15,5,5,5
"2011","Wolverhampton 031B","E01010514","Total",33,6,15,12,2,0,1,1,31,6,14,11
"2011","Wolverhampton 031C","E01010515","Total",30,7,13,10,3,0,2,1,27,7,11,9
"2011","Wolverhampton 031D","E01010517","Total",52,10,18,24,9,1,4,4,43,9,14,20
"2011","Wolverhampton 032A","E01010533","Total",101,20,25,56,8,0,2,6,93,20,23,50
"2011","Wolverhampton 032B","E01010535","Total",87,23,15,49,6,1,3,2,81,22,12,47
"2011","Wolverhampton 032C","E01010536","Total",29,11,6,12,3,2,0,1,26,9,6,11
"2011","Wolverhampton 032D","E01010537","Total",17,13,4,0,2,0,2,0,15,13,2,0
"2011","Wolverhampton 033A","E01010410","Total",94,27,8,59,4,0,2,2,90,27,6,57
"2011","Wolverhampton 033B","E01010411","Total",66,24,9,33,6,1,4,1,60,23,5,32
"2011","Wolverhampton 033C","E01010412","Total",81,22,14,45,9,0,5,4,72,22,9,41
"2011","Wolverhampton 033D","E01010413","Total",85,22,11,52,10,1,3,6,75,21,8,46
"2011","Wolverhampton 034A","E01010531","Total",70,25,23,22,12,2,10,0,58,23,13,22
"2011","Wolverhampton 034B","E01010532","Total",73,30,19,24,11,0,11,0,62,30,8,24
"2011","Wolverhampton 034C","E01010534","Total",21,6,9,6,2,1,1,0,19,5,8,6
"2011","Wolverhampton 034D","E01010538","Total",57,15,20,22,7,2,4,1,50,13,16,21
"2011","Wolverhampton 035A","E01010426","Total",28,7,6,15,2,0,1,1,26,7,5,14
"2011","Wolverhampton 035B","E01010428","Total",53,14,11,28,6,1,1,4,47,13,10,24
"2011","Wolverhampton 035C","E01010429","Total",35,14,9,12,1,0,1,0,34,14,8,12
"2011","Wolverhampton 035D","E01010430","Total",67,16,11,40,3,0,1,2,64,16,10,38
"2011","Wolverhampton 035E","E01010433","Total",41,7,10,24,2,0,0,2,39,7,10,22
"2011","Wolverhampton 035F","E01010453","Total",130,34,35,61,10,0,7,3,120,34,28,58
"2011","Wolverhampton 035G","E01010454","Total",86,17,14,55,6,0,3,3,80,17,11,52
"2011","Wolverhampton 035H","E01010530","Total",68,13,14,41,4,0,2,2,64,13,12,39
"2011","Bromsgrove 001A","E01032138","Total",15,4,9,2,3,0,3,0,12,4,6,2
"2011","Bromsgrove 001B","E01032139","Total",39,16,17,6,10,1,8,1,29,15,9,5
"2011","Bromsgrove 001C","E01032140","Total",51,21,18,12,2,0,1,1,49,21,17,11
"2011","Bromsgrove 001D","E01032141","Total",21,10,8,3,1,0,1,0,20,10,7,3
"2011","Bromsgrove 002A","E01032136","Total",7,3,3,1,1,0,1,0,6,3,2,1
"2011","Bromsgrove 002B","E01032137","Total",28,10,9,9,4,1,2,1,24,9,7,8
"2011","Bromsgrove 002C","E01032168","Total",24,7,9,8,6,0,5,1,18,7,4,7
"2011","Bromsgrove 002D","E01032169","Total",14,3,9,2,3,0,3,0,11,3,6,2
"2011","Bromsgrove 002E","E01032176","Total",20,12,3,5,0,0,0,0,20,12,3,5
"2011","Bromsgrove 003A","E01032126","Total",39,23,10,6,3,0,3,0,36,23,7,6
"2011","Bromsgrove 003B","E01032170","Total",45,20,17,8,2,0,1,1,43,20,16,7
"2011","Bromsgrove 003C","E01032171","Total",20,7,8,5,4,0,3,1,16,7,5,4
"2011","Bromsgrove 003D","E01032172","Total",49,15,19,15,6,0,4,2,43,15,15,13
"2011","Bromsgrove 004A","E01032133","Total",61,20,17,24,6,2,2,2,55,18,15,22
"2011","Bromsgrove 004B","E01032135","Total",34,16,17,1,5,0,5,0,29,16,12,1
"2011","Bromsgrove 004C","E01032145","Total",25,8,14,3,5,0,5,0,20,8,9,3
"2011","Bromsgrove 004D","E01032147","Total",19,6,7,6,4,0,3,1,15,6,4,5
"2011","Bromsgrove 005A","E01032134","Total",22,7,7,8,2,1,1,0,20,6,6,8
"2011","Bromsgrove 005B","E01032146","Total",20,7,5,8,0,0,0,0,20,7,5,8
"2011","Bromsgrove 005C","E01032177","Total",11,5,5,1,1,0,1,0,10,5,4,1
"2011","Bromsgrove 005D","E01032178","Total",11,7,3,1,2,1,1,0,9,6,2,1
"2011","Bromsgrove 006A","E01032142","Total",23,6,11,6,2,0,1,1,21,6,10,5
"2011","Bromsgrove 006B","E01032143","Total",15,4,7,4,5,1,3,1,10,3,4,3
"2011","Bromsgrove 006C","E01032144","Total",32,11,16,5,4,1,3,0,28,10,13,5
"2011","Bromsgrove 006D","E01032149","Total",10,4,5,1,0,0,0,0,10,4,5,1
"2011","Bromsgrove 007A","E01032127","Total",30,12,11,7,3,0,2,1,27,12,9,6
"2011","Bromsgrove 007B","E01032128","Total",49,23,12,14,4,0,2,2,45,23,10,12
"2011","Bromsgrove 007C","E01032129","Total",61,27,14,20,5,1,4,0,56,26,10,20
"2011","Bromsgrove 007D","E01032152","Total",60,17,19,24,9,1,4,4,51,16,15,20
"2011","Bromsgrove 008A","E01032148","Total",6,2,2,2,1,1,0,0,5,1,2,2
"2011","Bromsgrove 008B","E01032150","Total",16,6,8,2,3,1,2,0,13,5,6,2
"2011","Bromsgrove 008C","E01032151","Total",18,5,10,3,2,0,2,0,16,5,8,3
"2011","Bromsgrove 008D","E01032153","Total",34,10,15,9,8,2,3,3,26,8,12,6
"2011","Bromsgrove 008E","E01032155","Total",34,17,16,1,3,0,3,0,31,17,13,1
"2011","Bromsgrove 009A","E01032122","Total",28,8,10,10,4,0,4,0,24,8,6,10
"2011","Bromsgrove 009B","E01032123","Total",14,7,5,2,5,0,3,2,9,7,2,0
"2011","Bromsgrove 009C","E01032124","Total",52,23,16,13,2,0,1,1,50,23,15,12
"2011","Bromsgrove 009D","E01032125","Total",29,12,9,8,2,0,2,0,27,12,7,8
"2011","Bromsgrove 010A","E01032154","Total",38,16,16,6,4,1,3,0,34,15,13,6
"2011","Bromsgrove 010B","E01032159","Total",31,17,7,7,3,0,2,1,28,17,5,6
"2011","Bromsgrove 010C","E01032160","Total",35,20,8,7,1,0,1,0,34,20,7,7
"2011","Bromsgrove 010D","E01032161","Total",60,22,12,26,7,1,2,4,53,21,10,22
"2011","Bromsgrove 011A","E01032156","Total",54,21,17,16,7,0,4,3,47,21,13,13
"2011","Bromsgrove 011B","E01032157","Total",52,20,14,18,10,1,4,5,42,19,10,13
"2011","Bromsgrove 011C","E01032173","Total",39,14,13,12,4,0,3,1,35,14,10,11
"2011","Bromsgrove 011D","E01032175","Total",32,15,12,5,2,0,2,0,30,15,10,5
"2011","Bromsgrove 012A","E01032158","Total",18,4,11,3,3,0,1,2,15,4,10,1
"2011","Bromsgrove 012B","E01032162","Total",42,18,18,6,3,2,1,0,39,16,17,6
"2011","Bromsgrove 012D","E01033059","Total",39,13,21,5,4,0,3,1,35,13,18,4
"2011","Bromsgrove 012E","E01033061","Total",28,8,16,4,2,0,2,0,26,8,14,4
"2011","Bromsgrove 013A","E01032130","Total",110,32,46,32,16,3,11,2,94,29,35,30
"2011","Bromsgrove 013B","E01032131","Total",101,27,14,60,12,1,6,5,89,26,8,55
"2011","Bromsgrove 013C","E01032132","Total",95,33,27,35,14,0,10,4,81,33,17,31
"2011","Bromsgrove 013D","E01032174","Total",56,21,11,24,9,1,2,6,47,20,9,18
"2011","Bromsgrove 014C","E01032166","Total",38,13,20,5,8,0,6,2,30,13,14,3
"2011","Bromsgrove 014E","E01033060","Total",12,5,7,0,0,0,0,0,12,5,7,0
"2011","Bromsgrove 014F","E01033062","Total",49,20,24,5,5,0,5,0,44,20,19,5
"2011","Bromsgrove 014G","E01033243","Total",23,10,12,1,5,1,4,0,18,9,8,1
"2011","Malvern Hills 001A","E01032193","Total",36,11,10,15,3,0,2,1,33,11,8,14
"2011","Malvern Hills 001B","E01032212","Total",31,12,12,7,8,1,4,3,23,11,8,4
"2011","Malvern Hills 001C","E01032213","Total",16,5,9,2,7,1,5,1,9,4,4,1
"2011","Malvern Hills 001D","E01032214","Total",63,21,18,24,9,3,3,3,54,18,15,21
"2011","Malvern Hills 002A","E01032181","Total",30,7,16,7,6,0,6,0,24,7,10,7
"2011","Malvern Hills 002B","E01032190","Total",28,9,7,12,4,1,3,0,24,8,4,12
"2011","Malvern Hills 002C","E01032199","Total",34,14,10,10,6,1,5,0,28,13,5,10
"2011","Malvern Hills 002D","E01032223","Total",29,10,11,8,3,0,3,0,26,10,8,8
"2011","Malvern Hills 003A","E01032179","Total",30,10,8,12,3,0,1,2,27,10,7,10
"2011","Malvern Hills 003B","E01032180","Total",19,6,4,9,3,0,2,1,16,6,2,8
"2011","Malvern Hills 003C","E01032182","Total",16,9,5,2,2,0,2,0,14,9,3,2
"2011","Malvern Hills 003D","E01032183","Total",32,17,12,3,3,0,2,1,29,17,10,2
"2011","Malvern Hills 004A","E01032194","Total",64,17,13,34,7,1,0,6,57,16,13,28
"2011","Malvern Hills 004B","E01032195","Total",33,14,7,12,4,0,1,3,29,14,6,9
"2011","Malvern Hills 004C","E01032196","Total",36,13,11,12,4,1,2,1,32,12,9,11
"2011","Malvern Hills 004D","E01032197","Total",37,13,10,14,7,0,4,3,30,13,6,11
"2011","Malvern Hills 005A","E01032205","Total",13,4,4,5,5,2,2,1,8,2,2,4
"2011","Malvern Hills 005B","E01032206","Total",20,6,8,6,2,0,2,0,18,6,6,6
"2011","Malvern Hills 005C","E01032207","Total",26,13,11,2,5,1,4,0,21,12,7,2
"2011","Malvern Hills 005D","E01032217","Total",27,9,10,8,1,1,0,0,26,8,10,8
"2011","Malvern Hills 006A","E01032188","Total",69,33,18,18,5,1,4,0,64,32,14,18
"2011","Malvern Hills 006B","E01032189","Total",44,15,14,15,8,0,7,1,36,15,7,14
"2011","Malvern Hills 006C","E01032220","Total",27,11,10,6,4,0,4,0,23,11,6,6
"2011","Malvern Hills 006D","E01032221","Total",18,9,3,6,3,1,2,0,15,8,1,6
"2011","Malvern Hills 006E","E01032222","Total",55,31,12,12,7,1,4,2,48,30,8,10
"2011","Malvern Hills 007A","E01032201","Total",67,24,9,34,6,2,3,1,61,22,6,33
"2011","Malvern Hills 007B","E01032202","Total",80,21,14,45,9,1,4,4,71,20,10,41
"2011","Malvern Hills 007C","E01032203","Total",30,11,10,9,3,0,2,1,27,11,8,8
"2011","Malvern Hills 007D","E01032204","Total",103,28,18,57,13,0,2,11,90,28,16,46
"2011","Malvern Hills 008A","E01032191","Total",30,14,11,5,3,0,2,1,27,14,9,4
"2011","Malvern Hills 008B","E01032192","Total",40,21,7,12,3,0,1,2,37,21,6,10
"2011","Malvern Hills 008C","E01032211","Total",15,4,7,4,3,1,2,0,12,3,5,4
"2011","Malvern Hills 009A","E01032184","Total",30,12,8,10,3,0,3,0,27,12,5,10
"2011","Malvern Hills 009B","E01032185","Total",25,16,5,4,2,0,1,1,23,16,4,3
"2011","Malvern Hills 009C","E01032186","Total",30,10,10,10,10,2,6,2,20,8,4,8
"2011","Malvern Hills 009D","E01032187","Total",67,34,5,28,2,1,1,0,65,33,4,28
"2011","Malvern Hills 010A","E01032208","Total",23,8,6,9,7,2,3,2,16,6,3,7
"2011","Malvern Hills 010B","E01032209","Total",12,5,4,3,3,0,2,1,9,5,2,2
"2011","Malvern Hills 010C","E01032210","Total",24,10,9,5,3,1,2,0,21,9,7,5
"2011","Malvern Hills 010D","E01032218","Total",26,8,10,8,3,0,2,1,23,8,8,7
"2011","Malvern Hills 010E","E01032219","Total",22,6,9,7,3,0,3,0,19,6,6,7
"2011","Malvern Hills 011A","E01032198","Total",24,11,10,3,2,0,2,0,22,11,8,3
"2011","Malvern Hills 011B","E01032200","Total",27,10,13,4,2,0,2,0,25,10,11,4
"2011","Malvern Hills 011C","E01032215","Total",30,13,6,11,1,0,1,0,29,13,5,11
"2011","Malvern Hills 011D","E01032216","Total",43,19,16,8,4,1,3,0,39,18,13,8
"2011","Redditch 001A","E01032226","Total",54,19,18,17,8,3,4,1,46,16,14,16
"2011","Redditch 001B","E01032227","Total",4,2,1,1,0,0,0,0,4,2,1,1
"2011","Redditch 001C","E01032243","Total",19,7,10,2,5,1,4,0,14,6,6,2
"2011","Redditch 001D","E01032244","Total",27,8,11,8,2,0,0,2,25,8,11,6
"2011","Redditch 002A","E01032240","Total",54,19,13,22,7,1,3,3,47,18,10,19
"2011","Redditch 002B","E01032241","Total",63,22,13,28,5,0,3,2,58,22,10,26
"2011","Redditch 002C","E01032242","Total",57,21,16,20,2,0,2,0,55,21,14,20
"2011","Redditch 002D","E01032245","Total",64,15,17,32,7,1,4,2,57,14,13,30
"2011","Redditch 003A","E01032232","Total",113,36,24,53,11,2,6,3,102,34,18,50
"2011","Redditch 003B","E01032233","Total",71,19,30,22,9,1,8,0,62,18,22,22
"2011","Redditch 003C","E01032234","Total",95,34,13,48,7,3,2,2,88,31,11,46
"2011","Redditch 003D","E01032235","Total",111,28,18,65,12,2,3,7,99,26,15,58
"2011","Redditch 004A","E01032224","Total",61,14,15,32,11,1,3,7,50,13,12,25
"2011","Redditch 004B","E01032225","Total",65,21,13,31,7,0,2,5,58,21,11,26
"2011","Redditch 004C","E01032239","Total",61,19,18,24,5,2,1,2,56,17,17,22
"2011","Redditch 004D","E01032262","Total",91,28,13,50,9,2,0,7,82,26,13,43
"2011","Redditch 005A","E01032273","Total",23,7,11,5,4,0,4,0,19,7,7,5
"2011","Redditch 005B","E01032275","Total",46,19,14,13,9,1,6,2,37,18,8,11
"2011","Redditch 005C","E01032277","Total",47,9,12,26,7,0,3,4,40,9,9,22
"2011","Redditch 005D","E01032278","Total",110,23,20,67,12,0,5,7,98,23,15,60
"2011","Redditch 006A","E01032236","Total",58,13,22,23,6,0,5,1,52,13,17,22
"2011","Redditch 006B","E01032237","Total",23,9,7,7,0,0,0,0,23,9,7,7
"2011","Redditch 006C","E01032238","Total",17,6,8,3,1,0,1,0,16,6,7,3
"2011","Redditch 006D","E01032264","Total",58,27,15,16,6,2,2,2,52,25,13,14
"2011","Redditch 007A","E01032255","Total",29,13,12,4,8,3,5,0,21,10,7,4
"2011","Redditch 007B","E01032263","Total",48,20,14,14,9,0,7,2,39,20,7,12
"2011","Redditch 007C","E01032266","Total",43,10,16,17,6,1,4,1,37,9,12,16
"2011","Redditch 007D","E01032274","Total",25,12,10,3,5,1,3,1,20,11,7,2
"2011","Redditch 008A","E01032259","Total",36,13,18,5,5,1,4,0,31,12,14,5
"2011","Redditch 008B","E01032269","Total",35,13,13,9,3,1,2,0,32,12,11,9
"2011","Redditch 008C","E01032270","Total",20,8,11,1,2,0,2,0,18,8,9,1
"2011","Redditch 008D","E01032271","Total",16,8,7,1,4,0,4,0,12,8,3,1
"2011","Redditch 008E","E01032272","Total",15,9,4,2,1,0,1,0,14,9,3,2
"2011","Redditch 009A","E01032253","Total",22,9,8,5,4,1,2,1,18,8,6,4
"2011","Redditch 009B","E01032265","Total",62,22,17,23,4,0,1,3,58,22,16,20
"2011","Redditch 009C","E01032267","Total",72,21,21,30,9,0,5,4,63,21,16,26
"2011","Redditch 009D","E01032268","Total",26,11,11,4,4,0,4,0,22,11,7,4
"2011","Redditch 009E","E01032276","Total",32,9,18,5,1,0,1,0,31,9,17,5
"2011","Redditch 010A","E01032250","Total",74,22,12,40,7,0,4,3,67,22,8,37
"2011","Redditch 010B","E01032251","Total",87,34,14,39,7,1,5,1,80,33,9,38
"2011","Redditch 010C","E01032252","Total",88,18,20,50,8,0,4,4,80,18,16,46
"2011","Redditch 010D","E01032254","Total",43,19,9,15,2,0,1,1,41,19,8,14
"2011","Redditch 011A","E01032256","Total",64,23,19,22,7,0,3,4,57,23,16,18
"2011","Redditch 011B","E01032257","Total",44,14,17,13,6,0,3,3,38,14,14,10
"2011","Redditch 011C","E01032258","Total",35,12,18,5,7,1,6,0,28,11,12,5
"2011","Redditch 011D","E01032260","Total",92,27,24,41,5,1,1,3,87,26,23,38
"2011","Redditch 012A","E01032246","Total",25,8,11,6,2,0,2,0,23,8,9,6
"2011","Redditch 012B","E01032247","Total",45,18,14,13,6,2,4,0,39,16,10,13
"2011","Redditch 012C","E01032248","Total",23,10,11,2,2,1,1,0,21,9,10,2
"2011","Redditch 012D","E01032249","Total",44,18,17,9,3,0,3,0,41,18,14,9
"2011","Redditch 012E","E01032261","Total",21,8,11,2,6,0,5,1,15,8,6,1
"2011","Redditch 013A","E01032228","Total",16,6,7,3,3,0,3,0,13,6,4,3
"2011","Redditch 013B","E01032229","Total",50,15,16,19,7,1,6,0,43,14,10,19
"2011","Redditch 013C","E01032230","Total",25,9,11,5,3,1,1,1,22,8,10,4
"2011","Redditch 013D","E01032231","Total",54,17,25,12,5,0,5,0,49,17,20,12
"2011","Worcester 001A","E01032296","Total",37,10,10,17,1,0,1,0,36,10,9,17
"2011","Worcester 001B","E01032297","Total",24,9,10,5,2,0,2,0,22,9,8,5
"2011","Worcester 001C","E01032298","Total",15,8,6,1,3,0,3,0,12,8,3,1
"2011","Worcester 001D","E01032299","Total",30,12,13,5,3,0,3,0,27,12,10,5
"2011","Worcester 001E","E01032300","Total",14,5,5,4,2,1,1,0,12,4,4,4
"2011","Worcester 002A","E01032303","Total",64,20,7,37,2,1,1,0,62,19,6,37
"2011","Worcester 002B","E01032304","Total",91,25,9,57,3,1,1,1,88,24,8,56
"2011","Worcester 002C","E01032331","Total",70,19,10,41,6,0,3,3,64,19,7,38
"2011","Worcester 002D","E01032332","Total",77,20,6,51,6,1,1,4,71,19,5,47
"2011","Worcester 003A","E01032330","Total",30,10,10,10,2,0,2,0,28,10,8,10
"2011","Worcester 003B","E01032334","Total",88,36,30,22,10,2,6,2,78,34,24,20
"2011","Worcester 003C","E01032335","Total",22,9,10,3,3,1,1,1,19,8,9,2
"2011","Worcester 003D","E01032336","Total",37,15,12,10,0,0,0,0,37,15,12,10
"2011","Worcester 004A","E01032279","Total",40,16,7,17,4,1,3,0,36,15,4,17
"2011","Worcester 004B","E01032312","Total",48,20,10,18,6,1,3,2,42,19,7,16
"2011","Worcester 004C","E01032327","Total",45,18,19,8,7,0,6,1,38,18,13,7
"2011","Worcester 004D","E01032328","Total",56,23,14,19,8,1,6,1,48,22,8,18
"2011","Worcester 004E","E01032329","Total",39,17,15,7,6,0,6,0,33,17,9,7
"2011","Worcester 005A","E01032301","Total",30,11,6,13,3,1,1,1,27,10,5,12
"2011","Worcester 005B","E01032302","Total",70,22,8,40,1,0,1,0,69,22,7,40
"2011","Worcester 005C","E01032310","Total",53,31,6,16,7,2,2,3,46,29,4,13
"2011","Worcester 005D","E01032311","Total",93,30,18,45,12,0,7,5,81,30,11,40
"2011","Worcester 005E","E01032313","Total",78,25,6,47,6,1,1,4,72,24,5,43
"2011","Worcester 005F","E01032333","Total",146,50,15,81,5,0,2,3,141,50,13,78
"2011","Worcester 006A","E01032314","Total",22,10,8,4,0,0,0,0,22,10,8,4
"2011","Worcester 006B","E01032315","Total",16,4,7,5,0,0,0,0,16,4,7,5
"2011","Worcester 006C","E01032316","Total",14,5,4,5,6,1,4,1,8,4,0,4
"2011","Worcester 006D","E01032317","Total",28,13,11,4,2,0,2,0,26,13,9,4
"2011","Worcester 007A","E01032280","Total",35,17,10,8,3,1,2,0,32,16,8,8
"2011","Worcester 007B","E01032281","Total",45,15,19,11,5,1,3,1,40,14,16,10
"2011","Worcester 007C","E01032282","Total",52,19,17,16,2,0,2,0,50,19,15,16
"2011","Worcester 007E","E01033246","Total",20,6,8,6,2,0,2,0,18,6,6,6
"2011","Worcester 007F","E01033247","Total",16,7,2,7,1,0,0,1,15,7,2,6
"2011","Worcester 008A","E01032337","Total",40,17,18,5,3,0,3,0,37,17,15,5
"2011","Worcester 008B","E01032338","Total",88,30,35,23,8,2,6,0,80,28,29,23
"2011","Worcester 008C","E01032339","Total",35,15,16,4,6,1,4,1,29,14,12,3
"2011","Worcester 009A","E01032318","Total",111,36,21,54,10,2,5,3,101,34,16,51
"2011","Worcester 009B","E01032319","Total",23,12,7,4,3,0,2,1,20,12,5,3
"2011","Worcester 009C","E01032320","Total",48,19,16,13,8,2,5,1,40,17,11,12
"2011","Worcester 009D","E01032321","Total",70,34,9,27,8,2,2,4,62,32,7,23
"2011","Worcester 009E","E01032322","Total",53,25,14,14,7,1,4,2,46,24,10,12
"2011","Worcester 010A","E01032305","Total",57,30,10,17,4,1,2,1,53,29,8,16
"2011","Worcester 010B","E01032306","Total",45,9,9,27,6,0,1,5,39,9,8,22
"2011","Worcester 010C","E01032307","Total",62,25,10,27,2,0,0,2,60,25,10,25
"2011","Worcester 010D","E01032309","Total",76,32,19,25,6,2,3,1,70,30,16,24
"2011","Worcester 011A","E01032285","Total",36,13,16,7,5,0,4,1,31,13,12,6
"2011","Worcester 011B","E01032292","Total",47,16,16,15,5,2,2,1,42,14,14,14
"2011","Worcester 011D","E01032294","Total",27,7,13,7,3,0,3,0,24,7,10,7
"2011","Worcester 011E","E01033248","Total",28,9,6,13,1,0,0,1,27,9,6,12
"2011","Worcester 011F","E01033249","Total",46,21,4,21,4,2,0,2,42,19,4,19
"2011","Worcester 012A","E01032286","Total",45,15,16,14,5,0,5,0,40,15,11,14
"2011","Worcester 012B","E01032287","Total",49,22,16,11,8,2,4,2,41,20,12,9
"2011","Worcester 012C","E01032288","Total",31,16,7,8,2,0,1,1,29,16,6,7
"2011","Worcester 012D","E01032289","Total",18,10,5,3,2,0,2,0,16,10,3,3
"2011","Worcester 012E","E01032290","Total",43,15,16,12,10,1,5,4,33,14,11,8
"2011","Worcester 013A","E01032283","Total",57,22,18,17,4,0,3,1,53,22,15,16
"2011","Worcester 013B","E01032284","Total",23,11,9,3,3,0,3,0,20,11,6,3
"2011","Worcester 013C","E01032295","Total",73,17,23,33,15,1,8,6,58,16,15,27
"2011","Worcester 013D","E01032308","Total",37,25,8,4,4,1,3,0,33,24,5,4
"2011","Worcester 014A","E01032323","Total",34,14,12,8,1,0,1,0,33,14,11,8
"2011","Worcester 014B","E01032324","Total",24,11,9,4,2,0,2,0,22,11,7,4
"2011","Worcester 014C","E01032325","Total",48,23,18,7,1,0,1,0,47,23,17,7
"2011","Worcester 014D","E01032326","Total",44,23,15,6,4,2,2,0,40,21,13,6
"2011","Wychavon 001A","E01032354","Total",59,26,25,8,7,0,6,1,52,26,19,7
"2011","Wychavon 001B","E01032386","Total",16,7,5,4,1,0,0,1,15,7,5,3
"2011","Wychavon 001C","E01032387","Total",28,9,7,12,6,0,2,4,22,9,5,8
"2011","Wychavon 001D","E01032401","Total",14,5,7,2,1,0,1,0,13,5,6,2
"2011","Wychavon 002A","E01032368","Total",52,18,11,23,4,0,3,1,48,18,8,22
"2011","Wychavon 002B","E01032369","Total",94,28,19,47,12,2,7,3,82,26,12,44
"2011","Wychavon 002C","E01032370","Total",30,8,8,14,4,0,2,2,26,8,6,12
"2011","Wychavon 002D","E01032371","Total",34,10,11,13,2,1,1,0,32,9,10,13
"2011","Wychavon 003A","E01032359","Total",43,13,14,16,3,2,1,0,40,11,13,16
"2011","Wychavon 003B","E01032360","Total",68,28,19,21,0,0,0,0,68,28,19,21
"2011","Wychavon 003C","E01032361","Total",26,7,15,4,3,0,3,0,23,7,12,4
"2011","Wychavon 004A","E01032357","Total",30,12,8,10,3,1,2,0,27,11,6,10
"2011","Wychavon 004B","E01032358","Total",45,17,15,13,6,0,3,3,39,17,12,10
"2011","Wychavon 004C","E01032365","Total",75,37,15,23,8,2,4,2,67,35,11,21
"2011","Wychavon 004D","E01032367","Total",29,12,8,9,2,2,0,0,27,10,8,9
"2011","Wychavon 005A","E01032362","Total",38,11,18,9,3,1,1,1,35,10,17,8
"2011","Wychavon 005B","E01032363","Total",14,4,7,3,4,0,3,1,10,4,4,2
"2011","Wychavon 005C","E01032364","Total",25,14,8,3,1,0,1,0,24,14,7,3
"2011","Wychavon 005D","E01032366","Total",36,15,11,10,3,0,2,1,33,15,9,9
"2011","Wychavon 006A","E01032399","Total",30,9,11,10,3,1,1,1,27,8,10,9
"2011","Wychavon 006B","E01032400","Total",42,12,13,17,4,0,3,1,38,12,10,16
"2011","Wychavon 006C","E01032404","Total",30,10,9,11,10,0,4,6,20,10,5,5
"2011","Wychavon 007A","E01032345","Total",20,10,7,3,2,0,2,0,18,10,5,3
"2011","Wychavon 007B","E01032346","Total",20,6,8,6,3,1,2,0,17,5,6,6
"2011","Wychavon 007C","E01032395","Total",13,4,7,2,1,1,0,0,12,3,7,2
"2011","Wychavon 007D","E01032417","Total",21,7,10,4,3,0,2,1,18,7,8,3
"2011","Wychavon 008A","E01032392","Total",11,2,4,5,3,0,2,1,8,2,2,4
"2011","Wychavon 008B","E01032393","Total",14,7,5,2,1,0,1,0,13,7,4,2
"2011","Wychavon 008C","E01032394","Total",11,4,5,2,1,0,1,0,10,4,4,2
"2011","Wychavon 008D","E01032416","Total",8,4,2,2,1,0,1,0,7,4,1,2
"2011","Wychavon 009A","E01032355","Total",17,6,5,6,0,0,0,0,17,6,5,6
"2011","Wychavon 009B","E01032356","Total",18,7,9,2,5,1,3,1,13,6,6,1
"2011","Wychavon 009C","E01032402","Total",38,11,20,7,8,0,7,1,30,11,13,6
"2011","Wychavon 009D","E01032403","Total",28,14,8,6,2,2,0,0,26,12,8,6
"2011","Wychavon 010A","E01032375","Total",20,10,3,7,3,0,1,2,17,10,2,5
"2011","Wychavon 010B","E01032382","Total",21,12,7,2,2,1,1,0,19,11,6,2
"2011","Wychavon 010C","E01032383","Total",13,7,3,3,0,0,0,0,13,7,3,3
"2011","Wychavon 010D","E01032410","Total",17,7,6,4,4,2,1,1,13,5,5,3
"2011","Wychavon 010E","E01032411","Total",49,19,13,17,5,0,5,0,44,19,8,17
"2011","Wychavon 011A","E01032390","Total",26,16,7,3,1,0,1,0,25,16,6,3
"2011","Wychavon 011B","E01032391","Total",39,15,10,14,3,0,1,2,36,15,9,12
"2011","Wychavon 011C","E01032414","Total",28,9,10,9,5,0,3,2,23,9,7,7
"2011","Wychavon 011D","E01032415","Total",22,13,8,1,2,0,2,0,20,13,6,1
"2011","Wychavon 012A","E01032405","Total",29,10,11,8,5,1,4,0,24,9,7,8
"2011","Wychavon 012B","E01032406","Total",42,11,7,24,7,1,1,5,35,10,6,19
"2011","Wychavon 012C","E01032407","Total",17,2,6,9,2,0,0,2,15,2,6,7
"2011","Wychavon 012D","E01032408","Total",15,7,7,1,3,0,3,0,12,7,4,1
"2011","Wychavon 012E","E01032409","Total",34,17,6,11,2,0,1,1,32,17,5,10
"2011","Wychavon 013A","E01032340","Total",45,15,14,16,6,0,3,3,39,15,11,13
"2011","Wychavon 013B","E01032341","Total",19,10,4,5,2,0,2,0,17,10,2,5
"2011","Wychavon 013C","E01032349","Total",20,10,4,6,1,0,0,1,19,10,4,5
"2011","Wychavon 013D","E01032350","Total",22,9,7,6,6,0,4,2,16,9,3,4
"2011","Wychavon 013E","E01032388","Total",11,3,5,3,3,0,2,1,8,3,3,2
"2011","Wychavon 013F","E01032389","Total",35,9,13,13,5,1,4,0,30,8,9,13
"2011","Wychavon 014A","E01032343","Total",80,28,36,16,14,0,9,5,66,28,27,11
"2011","Wychavon 014B","E01032377","Total",65,27,14,24,8,1,2,5,57,26,12,19
"2011","Wychavon 014C","E01032378","Total",58,23,13,22,7,1,4,2,51,22,9,20
"2011","Wychavon 015A","E01032376","Total",22,13,8,1,3,1,1,1,19,12,7,0
"2011","Wychavon 015B","E01032384","Total",35,10,8,17,6,1,3,2,29,9,5,15
"2011","Wychavon 015C","E01032385","Total",17,4,6,7,2,0,0,2,15,4,6,5
"2011","Wychavon 015D","E01032396","Total",33,15,12,6,4,2,2,0,29,13,10,6
"2011","Wychavon 016A","E01032342","Total",40,15,10,15,6,1,4,1,34,14,6,14
"2011","Wychavon 016B","E01032344","Total",25,8,11,6,2,0,2,0,23,8,9,6
"2011","Wychavon 016C","E01032379","Total",45,18,15,12,2,0,1,1,43,18,14,11
"2011","Wychavon 016D","E01032380","Total",17,7,3,7,1,0,0,1,16,7,3,6
"2011","Wychavon 017A","E01032381","Total",60,26,17,17,5,0,3,2,55,26,14,15
"2011","Wychavon 017B","E01032397","Total",46,15,7,24,4,0,1,3,42,15,6,21
"2011","Wychavon 017C","E01032398","Total",53,24,14,15,5,1,3,1,48,23,11,14
"2011","Wychavon 018A","E01032351","Total",10,4,5,1,0,0,0,0,10,4,5,1
"2011","Wychavon 018B","E01032352","Total",19,7,5,7,3,0,0,3,16,7,5,4
"2011","Wychavon 018C","E01032353","Total",48,18,14,16,3,0,3,0,45,18,11,16
"2011","Wychavon 018D","E01032374","Total",19,7,8,4,6,3,3,0,13,4,5,4
"2011","Wychavon 019A","E01032347","Total",26,11,12,3,3,0,3,0,23,11,9,3
"2011","Wychavon 019B","E01032348","Total",12,7,4,1,1,1,0,0,11,6,4,1
"2011","Wychavon 019C","E01032372","Total",23,9,10,4,6,0,5,1,17,9,5,3
"2011","Wychavon 019D","E01032373","Total",8,2,4,2,2,0,2,0,6,2,2,2
"2011","Wychavon 019E","E01032412","Total",19,9,5,5,4,0,3,1,15,9,2,4
"2011","Wychavon 019F","E01032413","Total",23,12,7,4,3,1,2,0,20,11,5,4
"2011","Wyre Forest 001A","E01032431","Total",16,10,2,4,1,0,1,0,15,10,1,4
"2011","Wyre Forest 001B","E01032432","Total",21,7,6,8,4,1,2,1,17,6,4,7
"2011","Wyre Forest 001C","E01032433","Total",17,5,7,5,0,0,0,0,17,5,7,5
"2011","Wyre Forest 001D","E01032439","Total",20,7,7,6,3,0,2,1,17,7,5,5
"2011","Wyre Forest 001E","E01032440","Total",42,17,13,12,2,1,0,1,40,16,13,11
"2011","Wyre Forest 001F","E01032479","Total",33,15,5,13,1,0,0,1,32,15,5,12
"2011","Wyre Forest 002A","E01032441","Total",17,5,7,5,1,0,1,0,16,5,6,5
"2011","Wyre Forest 002B","E01032442","Total",40,16,14,10,1,0,0,1,39,16,14,9
"2011","Wyre Forest 002C","E01032443","Total",11,7,4,0,2,1,1,0,9,6,3,0
"2011","Wyre Forest 002D","E01032444","Total",35,12,10,13,4,1,3,0,31,11,7,13
"2011","Wyre Forest 002E","E01032445","Total",49,15,13,21,6,0,5,1,43,15,8,20
"2011","Wyre Forest 003A","E01032436","Total",29,8,11,10,8,0,5,3,21,8,6,7
"2011","Wyre Forest 003B","E01032438","Total",30,14,14,2,7,3,4,0,23,11,10,2
"2011","Wyre Forest 003C","E01032446","Total",35,9,21,5,2,0,2,0,33,9,19,5
"2011","Wyre Forest 003D","E01032447","Total",44,12,20,12,8,0,8,0,36,12,12,12
"2011","Wyre Forest 003E","E01032448","Total",20,10,7,3,2,0,0,2,18,10,7,1
"2011","Wyre Forest 004A","E01032434","Total",109,29,15,65,13,0,5,8,96,29,10,57
"2011","Wyre Forest 004B","E01032435","Total",51,17,9,25,6,1,2,3,45,16,7,22
"2011","Wyre Forest 004C","E01032437","Total",91,30,14,47,8,0,5,3,83,30,9,44
"2011","Wyre Forest 004D","E01032450","Total",92,30,26,36,8,0,7,1,84,30,19,35
"2011","Wyre Forest 005A","E01032430","Total",25,9,4,12,4,1,0,3,21,8,4,9
"2011","Wyre Forest 005B","E01032480","Total",34,14,15,5,5,2,3,0,29,12,12,5
"2011","Wyre Forest 005C","E01032481","Total",44,21,15,8,4,0,4,0,40,21,11,8
"2011","Wyre Forest 005D","E01032482","Total",36,15,16,5,7,1,4,2,29,14,12,3
"2011","Wyre Forest 006A","E01032451","Total",12,4,2,6,1,0,0,1,11,4,2,5
"2011","Wyre Forest 006B","E01032452","Total",22,13,6,3,3,1,1,1,19,12,5,2
"2011","Wyre Forest 006C","E01032453","Total",63,27,11,25,8,2,5,1,55,25,6,24
"2011","Wyre Forest 006D","E01032454","Total",39,12,17,10,4,0,2,2,35,12,15,8
"2011","Wyre Forest 007A","E01032449","Total",73,16,21,36,11,0,7,4,62,16,14,32
"2011","Wyre Forest 007B","E01032464","Total",76,26,13,37,7,2,4,1,69,24,9,36
"2011","Wyre Forest 007C","E01032465","Total",83,24,12,47,8,0,2,6,75,24,10,41
"2011","Wyre Forest 007D","E01032466","Total",24,7,8,9,7,1,5,1,17,6,3,8
"2011","Wyre Forest 007E","E01032467","Total",12,4,6,2,4,1,3,0,8,3,3,2
"2011","Wyre Forest 007F","E01032468","Total",16,8,4,4,1,0,0,1,15,8,4,3
"2011","Wyre Forest 008A","E01032474","Total",101,35,29,37,12,1,9,2,89,34,20,35
"2011","Wyre Forest 008B","E01032475","Total",72,28,29,15,9,1,7,1,63,27,22,14
"2011","Wyre Forest 008C","E01032476","Total",39,15,10,14,4,2,1,1,35,13,9,13
"2011","Wyre Forest 008D","E01032477","Total",14,4,9,1,3,1,2,0,11,3,7,1
"2011","Wyre Forest 008E","E01032478","Total",65,15,17,33,14,0,12,2,51,15,5,31
"2011","Wyre Forest 009A","E01032469","Total",60,25,5,30,5,1,2,2,55,24,3,28
"2011","Wyre Forest 009B","E01032470","Total",62,14,18,30,7,0,3,4,55,14,15,26
"2011","Wyre Forest 009C","E01032471","Total",101,28,13,60,8,0,1,7,93,28,12,53
"2011","Wyre Forest 010A","E01032418","Total",32,11,15,6,2,0,2,0,30,11,13,6
"2011","Wyre Forest 010B","E01032419","Total",13,5,3,5,2,0,1,1,11,5,2,4
"2011","Wyre Forest 010C","E01032420","Total",31,13,9,9,4,2,1,1,27,11,8,8
"2011","Wyre Forest 010D","E01032421","Total",22,10,7,5,1,0,0,1,21,10,7,4
"2011","Wyre Forest 010E","E01032422","Total",122,36,30,56,7,1,3,3,115,35,27,53
"2011","Wyre Forest 011A","E01032427","Total",36,13,13,10,4,1,1,2,32,12,12,8
"2011","Wyre Forest 011B","E01032428","Total",32,11,13,8,7,2,3,2,25,9,10,6
"2011","Wyre Forest 011C","E01032429","Total",31,9,14,8,3,0,1,2,28,9,13,6
"2011","Wyre Forest 011D","E01032472","Total",11,3,4,4,4,0,3,1,7,3,1,3
"2011","Wyre Forest 011E","E01032473","Total",27,9,6,12,8,0,4,4,19,9,2,8
"2011","Wyre Forest 012A","E01032455","Total",33,17,7,9,6,0,4,2,27,17,3,7
"2011","Wyre Forest 012B","E01032456","Total",54,18,14,22,3,0,1,2,51,18,13,20
"2011","Wyre Forest 012C","E01032457","Total",36,19,9,8,3,1,2,0,33,18,7,8
"2011","Wyre Forest 012D","E01032458","Total",17,8,6,3,3,0,3,0,14,8,3,3
"2011","Wyre Forest 012E","E01032459","Total",43,15,13,15,7,0,4,3,36,15,9,12
"2011","Wyre Forest 013A","E01032460","Total",55,22,15,18,7,1,5,1,48,21,10,17
"2011","Wyre Forest 013B","E01032461","Total",53,16,11,26,5,0,3,2,48,16,8,24
"2011","Wyre Forest 013C","E01032462","Total",63,21,25,17,9,2,6,1,54,19,19,16
"2011","Wyre Forest 013D","E01032463","Total",21,6,9,6,5,0,4,1,16,6,5,5
"2011","Wyre Forest 014A","E01032423","Total",32,13,7,12,1,0,1,0,31,13,6,12
"2011","Wyre Forest 014B","E01032424","Total",83,24,7,52,8,1,1,6,75,23,6,46
"2011","Wyre Forest 014C","E01032425","Total",26,7,6,13,1,0,0,1,25,7,6,12
"2011","Wyre Forest 014D","E01032426","Total",31,16,6,9,1,0,0,1,30,16,6,8
"2011","Bedford 001A","E01017540","Total",21,7,8,6,1,0,1,0,20,7,7,6
"2011","Bedford 001B","E01017541","Total",29,17,7,5,1,0,1,0,28,17,6,5
"2011","Bedford 001C","E01017544","Total",34,9,22,3,6,0,6,0,28,9,16,3
"2011","Bedford 001D","E01017545","Total",48,13,29,6,10,1,9,0,38,12,20,6
"2011","Bedford 002A","E01017464","Total",19,4,13,2,8,0,8,0,11,4,5,2
"2011","Bedford 002B","E01017465","Total",31,9,12,10,6,0,5,1,25,9,7,9
"2011","Bedford 002C","E01017503","Total",32,15,14,3,8,0,8,0,24,15,6,3
"2011","Bedford 002D","E01017504","Total",47,21,17,9,2,0,2,0,45,21,15,9
"2011","Bedford 002E","E01017546","Total",28,11,8,9,3,0,3,0,25,11,5,9
"2011","Bedford 002F","E01017547","Total",19,6,7,6,2,0,0,2,17,6,7,4
"2011","Bedford 003A","E01017478","Total",44,16,18,10,7,3,2,2,37,13,16,8
"2011","Bedford 003B","E01017479","Total",22,10,7,5,4,0,2,2,18,10,5,3
"2011","Bedford 003C","E01017480","Total",79,30,25,24,4,0,3,1,75,30,22,23
"2011","Bedford 003D","E01017481","Total",42,9,12,21,5,3,1,1,37,6,11,20
"2011","Bedford 003E","E01017528","Total",65,25,23,17,10,1,8,1,55,24,15,16
"2011","Bedford 004B","E01017495","Total",49,26,10,13,4,1,1,2,45,25,9,11
"2011","Bedford 004C","E01017496","Total",29,6,9,14,7,1,3,3,22,5,6,11
"2011","Bedford 004D","E01017542","Total",27,11,8,8,5,0,4,1,22,11,4,7
"2011","Bedford 004E","E01017543","Total",23,8,12,3,7,0,7,0,16,8,5,3
"2011","Bedford 004F","E01033431","Total",84,32,26,26,4,0,3,1,80,32,23,25
"2011","Bedford 004G","E01033432","Total",70,26,24,20,5,1,4,0,65,25,20,20
"2011","Bedford 005A","E01017453","Total",39,15,10,14,2,2,0,0,37,13,10,14
"2011","Bedford 005B","E01017454","Total",30,9,13,8,3,0,3,0,27,9,10,8
"2011","Bedford 005C","E01017455","Total",29,7,15,7,6,1,4,1,23,6,11,6
"2011","Bedford 005D","E01017456","Total",26,9,10,7,2,1,1,0,24,8,9,7
"2011","Bedford 005E","E01017457","Total",44,19,13,12,3,0,2,1,41,19,11,11
"2011","Bedford 005F","E01017458","Total",41,15,16,10,3,0,2,1,38,15,14,9
"2011","Bedford 006A","E01017529","Total",25,11,6,8,1,0,1,0,24,11,5,8
"2011","Bedford 006B","E01017530","Total",15,4,11,0,3,0,3,0,12,4,8,0
"2011","Bedford 006C","E01017531","Total",57,20,12,25,2,0,1,1,55,20,11,24
"2011","Bedford 006D","E01017532","Total",14,6,4,4,1,0,0,1,13,6,4,3
"2011","Bedford 006E","E01017533","Total",15,6,7,2,3,0,3,0,12,6,4,2
"2011","Bedford 006F","E01017534","Total",29,9,17,3,3,0,3,0,26,9,14,3
"2011","Bedford 007A","E01017488","Total",26,11,9,6,2,0,2,0,24,11,7,6
"2011","Bedford 007B","E01017489","Total",118,35,22,61,3,0,2,1,115,35,20,60
"2011","Bedford 007C","E01017490","Total",97,41,13,43,4,0,1,3,93,41,12,40
"2011","Bedford 007D","E01017491","Total",34,14,13,7,3,1,1,1,31,13,12,6
"2011","Bedford 007E","E01017492","Total",99,29,19,51,4,0,2,2,95,29,17,49
"2011","Bedford 007F","E01017493","Total",102,34,33,35,7,0,5,2,95,34,28,33
"2011","Bedford 008A","E01017459","Total",45,15,23,7,6,0,6,0,39,15,17,7
"2011","Bedford 008B","E01017460","Total",30,14,8,8,4,2,1,1,26,12,7,7
"2011","Bedford 008C","E01017461","Total",53,8,18,27,3,0,2,1,50,8,16,26
"2011","Bedford 008D","E01017462","Total",29,10,15,4,6,0,5,1,23,10,10,3
"2011","Bedford 008E","E01017463","Total",20,8,9,3,1,0,1,0,19,8,8,3
"2011","Bedford 009A","E01017482","Total",25,12,5,8,5,2,1,2,20,10,4,6
"2011","Bedford 009B","E01017483","Total",24,10,9,5,4,1,3,0,20,9,6,5
"2011","Bedford 009C","E01017484","Total",14,2,6,6,2,0,2,0,12,2,4,6
"2011","Bedford 009D","E01017485","Total",25,5,14,6,2,1,0,1,23,4,14,5
"2011","Bedford 010A","E01017497","Total",52,17,13,22,6,0,6,0,46,17,7,22
"2011","Bedford 010B","E01017498","Total",35,5,19,11,7,0,4,3,28,5,15,8
"2011","Bedford 010C","E01017499","Total",22,3,8,11,6,1,3,2,16,2,5,9
"2011","Bedford 010D","E01017500","Total",24,4,9,11,3,0,3,0,21,4,6,11
"2011","Bedford 010E","E01017501","Total",25,7,11,7,8,5,3,0,17,2,8,7
"2011","Bedford 010F","E01017502","Total",34,11,7,16,1,0,1,0,33,11,6,16
"2011","Bedford 011A","E01017524","Total",48,22,15,11,5,0,5,0,43,22,10,11
"2011","Bedford 011B","E01017525","Total",45,13,11,21,5,0,2,3,40,13,9,18
"2011","Bedford 011C","E01017526","Total",53,21,19,13,4,1,2,1,49,20,17,12
"2011","Bedford 011D","E01017527","Total",52,17,17,18,3,0,1,2,49,17,16,16
"2011","Bedford 012A","E01017466","Total",45,7,12,26,5,1,0,4,40,6,12,22
"2011","Bedford 012B","E01017467","Total",33,10,14,9,8,0,5,3,25,10,9,6
"2011","Bedford 012C","E01017468","Total",40,15,18,7,8,0,8,0,32,15,10,7
"2011","Bedford 012D","E01017469","Total",35,9,18,8,6,1,5,0,29,8,13,8
"2011","Bedford 012E","E01017470","Total",27,9,10,8,0,0,0,0,27,9,10,8
"2011","Bedford 012F","E01017471","Total",51,15,18,18,4,0,3,1,47,15,15,17
"2011","Bedford 013A","E01017535","Total",36,8,12,16,6,1,4,1,30,7,8,15
"2011","Bedford 013B","E01017536","Total",89,19,27,43,8,1,7,0,81,18,20,43
"2011","Bedford 013C","E01017537","Total",61,16,11,34,4,1,1,2,57,15,10,32
"2011","Bedford 013D","E01017538","Total",53,11,11,31,4,1,3,0,49,10,8,31
"2011","Bedford 013E","E01017539","Total",37,8,10,19,2,0,2,0,35,8,8,19
"2011","Bedford 014A","E01017518","Total",70,25,16,29,8,3,3,2,62,22,13,27
"2011","Bedford 014B","E01017519","Total",86,16,16,54,2,0,0,2,84,16,16,52
"2011","Bedford 014C","E01017520","Total",49,19,15,15,8,1,7,0,41,18,8,15
"2011","Bedford 014D","E01017521","Total",51,17,15,19,10,2,4,4,41,15,11,15
"2011","Bedford 014E","E01017522","Total",75,14,22,39,6,1,3,2,69,13,19,37
"2011","Bedford 014F","E01017523","Total",127,33,20,74,5,0,2,3,122,33,18,71
"2011","Bedford 015A","E01017472","Total",87,35,14,38,5,1,3,1,82,34,11,37
"2011","Bedford 015B","E01017473","Total",89,23,30,36,4,0,3,1,85,23,27,35
"2011","Bedford 015C","E01017474","Total",61,20,18,23,5,0,4,1,56,20,14,22
"2011","Bedford 015D","E01017475","Total",33,10,12,11,0,0,0,0,33,10,12,11
"2011","Bedford 015E","E01017476","Total",35,8,12,15,3,0,0,3,32,8,12,12
"2011","Bedford 015F","E01017477","Total",72,21,12,39,7,1,1,5,65,20,11,34
"2011","Bedford 016A","E01017509","Total",67,33,16,18,8,1,5,2,59,32,11,16
"2011","Bedford 016B","E01017510","Total",50,21,15,14,4,0,3,1,46,21,12,13
"2011","Bedford 016C","E01017511","Total",45,17,13,15,3,1,2,0,42,16,11,15
"2011","Bedford 016D","E01017512","Total",61,24,18,19,8,2,4,2,53,22,14,17
"2011","Bedford 017A","E01017505","Total",53,18,13,22,1,0,1,0,52,18,12,22
"2011","Bedford 017B","E01017506","Total",69,18,19,32,7,1,4,2,62,17,15,30
"2011","Bedford 017C","E01017507","Total",47,14,17,16,5,1,3,1,42,13,14,15
"2011","Bedford 017D","E01017508","Total",53,17,20,16,6,0,4,2,47,17,16,14
"2011","Bedford 018A","E01017513","Total",46,15,14,17,3,0,2,1,43,15,12,16
"2011","Bedford 018B","E01017514","Total",71,25,13,33,7,0,4,3,64,25,9,30
"2011","Bedford 018C","E01017515","Total",62,22,10,30,6,2,1,3,56,20,9,27
"2011","Bedford 018D","E01017516","Total",34,12,11,11,5,1,3,1,29,11,8,10
"2011","Bedford 018E","E01017517","Total",52,12,24,16,7,1,4,2,45,11,20,14
"2011","Bedford 019A","E01017486","Total",51,15,16,20,6,1,2,3,45,14,14,17
"2011","Bedford 019B","E01017487","Total",85,26,17,42,2,0,0,2,83,26,17,40
"2011","Bedford 019C","E01017548","Total",74,18,21,35,4,0,4,0,70,18,17,35
"2011","Bedford 019D","E01017549","Total",15,7,6,2,1,0,1,0,14,7,5,2
"2011","Bedford 019E","E01017550","Total",73,24,26,23,4,2,2,0,69,22,24,23
"2011","Bedford 020A","E01017551","Total",40,16,14,10,4,1,3,0,36,15,11,10
"2011","Bedford 020B","E01017552","Total",30,13,6,11,4,0,3,1,26,13,3,10
"2011","Bedford 020C","E01017553","Total",28,14,7,7,1,0,0,1,27,14,7,6
"2011","Bedford 020D","E01017554","Total",35,10,9,16,5,0,3,2,30,10,6,14
"2011","Central Bedfordshire 001A","E01017433","Total",67,32,10,25,6,0,2,4,61,32,8,21
"2011","Central Bedfordshire 001B","E01017434","Total",43,13,14,16,5,0,2,3,38,13,12,13
"2011","Central Bedfordshire 001C","E01017436","Total",44,14,20,10,9,0,8,1,35,14,12,9
"2011","Central Bedfordshire 002A","E01017430","Total",45,9,15,21,6,0,4,2,39,9,11,19
"2011","Central Bedfordshire 002B","E01017431","Total",41,17,6,18,4,1,1,2,37,16,5,16
"2011","Central Bedfordshire 002C","E01017432","Total",18,4,10,4,5,1,3,1,13,3,7,3
"2011","Central Bedfordshire 002D","E01017435","Total",50,18,10,22,5,1,2,2,45,17,8,20
"2011","Central Bedfordshire 003A","E01017425","Total",14,6,3,5,3,1,2,0,11,5,1,5
"2011","Central Bedfordshire 003B","E01017426","Total",14,3,6,5,2,0,1,1,12,3,5,4
"2011","Central Bedfordshire 003C","E01017427","Total",38,11,18,9,7,0,5,2,31,11,13,7
"2011","Central Bedfordshire 003D","E01017428","Total",36,17,10,9,2,0,2,0,34,17,8,9
"2011","Central Bedfordshire 003E","E01017429","Total",24,13,5,6,4,1,2,1,20,12,3,5
"2011","Central Bedfordshire 004A","E01017412","Total",25,11,10,4,3,1,2,0,22,10,8,4
"2011","Central Bedfordshire 004B","E01017422","Total",19,4,6,9,3,0,1,2,16,4,5,7
"2011","Central Bedfordshire 004C","E01017423","Total",25,11,8,6,8,2,5,1,17,9,3,5
"2011","Central Bedfordshire 004D","E01017424","Total",30,11,12,7,6,0,5,1,24,11,7,6
"2011","Central Bedfordshire 005A","E01017383","Total",48,18,17,13,6,2,4,0,42,16,13,13
"2011","Central Bedfordshire 005B","E01017384","Total",48,18,10,20,3,1,2,0,45,17,8,20
"2011","Central Bedfordshire 005C","E01017385","Total",43,13,15,15,3,0,3,0,40,13,12,15
"2011","Central Bedfordshire 005D","E01017386","Total",50,15,17,18,7,0,6,1,43,15,11,17
"2011","Central Bedfordshire 005E","E01017387","Total",29,12,6,11,2,1,1,0,27,11,5,11
"2011","Central Bedfordshire 005F","E01017388","Total",45,16,14,15,7,1,4,2,38,15,10,13
"2011","Central Bedfordshire 006A","E01017381","Total",20,9,4,7,4,0,2,2,16,9,2,5
"2011","Central Bedfordshire 006B","E01017382","Total",44,17,12,15,2,0,2,0,42,17,10,15
"2011","Central Bedfordshire 006C","E01017389","Total",37,10,9,18,5,0,4,1,32,10,5,17
"2011","Central Bedfordshire 006D","E01017390","Total",86,33,19,34,9,1,7,1,77,32,12,33
"2011","Central Bedfordshire 007A","E01017379","Total",23,8,9,6,2,2,0,0,21,6,9,6
"2011","Central Bedfordshire 007B","E01017380","Total",16,5,11,0,1,0,1,0,15,5,10,0
"2011","Central Bedfordshire 007C","E01017394","Total",26,12,6,8,3,0,2,1,23,12,4,7
"2011","Central Bedfordshire 007F","E01017397","Total",21,5,9,7,5,0,3,2,16,5,6,5
"2011","Central Bedfordshire 007G","E01033194","Total",22,9,6,7,2,0,1,1,20,9,5,6
"2011","Central Bedfordshire 008A","E01017410","Total",15,5,8,2,2,0,2,0,13,5,6,2
"2011","Central Bedfordshire 008B","E01017411","Total",26,8,10,8,3,1,1,1,23,7,9,7
"2011","Central Bedfordshire 008C","E01017419","Total",14,3,7,4,2,0,2,0,12,3,5,4
"2011","Central Bedfordshire 008D","E01017420","Total",32,16,12,4,3,0,3,0,29,16,9,4
"2011","Central Bedfordshire 008E","E01017421","Total",31,8,15,8,4,0,4,0,27,8,11,8
"2011","Central Bedfordshire 009A","E01017416","Total",39,15,17,7,3,1,2,0,36,14,15,7
"2011","Central Bedfordshire 009B","E01017417","Total",81,29,34,18,7,0,6,1,74,29,28,17
"2011","Central Bedfordshire 009C","E01017418","Total",61,22,21,18,8,0,7,1,53,22,14,17
"2011","Central Bedfordshire 009D","E01017451","Total",18,6,7,5,1,0,0,1,17,6,7,4
"2011","Central Bedfordshire 009E","E01017452","Total",15,7,3,5,1,0,0,1,14,7,3,4
"2011","Central Bedfordshire 010A","E01017376","Total",49,21,16,12,5,3,2,0,44,18,14,12
"2011","Central Bedfordshire 010B","E01017377","Total",52,20,20,12,4,0,3,1,48,20,17,11
"2011","Central Bedfordshire 010C","E01017378","Total",51,11,23,17,14,0,9,5,37,11,14,12
"2011","Central Bedfordshire 010D","E01017413","Total",28,15,7,6,3,1,1,1,25,14,6,5
"2011","Central Bedfordshire 010E","E01017414","Total",39,12,11,16,9,0,6,3,30,12,5,13
"2011","Central Bedfordshire 010F","E01017415","Total",62,23,28,11,4,0,3,1,58,23,25,10
"2011","Central Bedfordshire 011A","E01017437","Total",56,17,16,23,4,2,2,0,52,15,14,23
"2011","Central Bedfordshire 011B","E01017438","Total",26,9,15,2,2,0,2,0,24,9,13,2
"2011","Central Bedfordshire 011C","E01017439","Total",32,11,11,10,4,0,2,2,28,11,9,8
"2011","Central Bedfordshire 011D","E01017440","Total",48,15,13,20,4,0,3,1,44,15,10,19
"2011","Central Bedfordshire 011E","E01017441","Total",40,6,29,5,9,0,7,2,31,6,22,3
"2011","Central Bedfordshire 011F","E01017444","Total",45,14,24,7,8,0,8,0,37,14,16,7
"2011","Central Bedfordshire 012A","E01017371","Total",22,7,14,1,4,0,3,1,18,7,11,0
"2011","Central Bedfordshire 012B","E01017372","Total",43,20,14,9,4,0,4,0,39,20,10,9
"2011","Central Bedfordshire 012C","E01017373","Total",33,12,15,6,2,0,2,0,31,12,13,6
"2011","Central Bedfordshire 012D","E01017374","Total",28,7,15,6,2,0,1,1,26,7,14,5
"2011","Central Bedfordshire 012E","E01017375","Total",25,7,16,2,6,1,5,0,19,6,11,2
"2011","Central Bedfordshire 013A","E01017391","Total",35,13,18,4,9,0,9,0,26,13,9,4
"2011","Central Bedfordshire 013B","E01017392","Total",21,9,10,2,3,1,1,1,18,8,9,1
"2011","Central Bedfordshire 013C","E01017393","Total",30,16,10,4,3,2,1,0,27,14,9,4
"2011","Central Bedfordshire 013D","E01017442","Total",42,13,20,9,9,0,7,2,33,13,13,7
"2011","Central Bedfordshire 013E","E01017443","Total",37,13,16,8,11,1,8,2,26,12,8,6
"2011","Central Bedfordshire 014A","E01017446","Total",43,10,17,16,4,0,2,2,39,10,15,14
"2011","Central Bedfordshire 014B","E01017447","Total",41,20,13,8,4,0,3,1,37,20,10,7
"2011","Central Bedfordshire 014D","E01017449","Total",24,13,6,5,2,0,2,0,22,13,4,5
"2011","Central Bedfordshire 014E","E01033188","Total",36,13,14,9,3,1,2,0,33,12,12,9
"2011","Central Bedfordshire 014F","E01033189","Total",32,12,11,9,2,1,1,0,30,11,10,9
"2011","Central Bedfordshire 014G","E01033190","Total",39,11,19,9,6,0,6,0,33,11,13,9
"2011","Central Bedfordshire 015A","E01017399","Total",42,18,16,8,3,0,3,0,39,18,13,8
"2011","Central Bedfordshire 015B","E01017400","Total",69,29,8,32,3,1,1,1,66,28,7,31
"2011","Central Bedfordshire 015C","E01017401","Total",24,13,5,6,5,1,2,2,19,12,3,4
"2011","Central Bedfordshire 015D","E01017402","Total",20,6,13,1,5,0,5,0,15,6,8,1
"2011","Central Bedfordshire 016A","E01017403","Total",37,10,19,8,9,1,8,0,28,9,11,8
"2011","Central Bedfordshire 016B","E01017404","Total",13,4,7,2,1,0,1,0,12,4,6,2
"2011","Central Bedfordshire 016C","E01017405","Total",40,17,15,8,6,1,4,1,34,16,11,7
"2011","Central Bedfordshire 016D","E01017406","Total",46,22,18,6,5,1,3,1,41,21,15,5
"2011","Central Bedfordshire 016E","E01017407","Total",36,16,16,4,2,0,2,0,34,16,14,4
"2011","Central Bedfordshire 017A","E01017398","Total",25,7,11,7,4,1,3,0,21,6,8,7
"2011","Central Bedfordshire 017B","E01017408","Total",20,7,11,2,5,0,5,0,15,7,6,2
"2011","Central Bedfordshire 017C","E01017409","Total",26,9,14,3,7,0,7,0,19,9,7,3
"2011","Central Bedfordshire 017D","E01017445","Total",35,9,17,9,7,2,3,2,28,7,14,7
"2011","Central Bedfordshire 017E","E01017450","Total",46,22,11,13,4,0,4,0,42,22,7,13
"2011","Central Bedfordshire 018A","E01017558","Total",56,23,23,10,6,0,5,1,50,23,18,9
"2011","Central Bedfordshire 018B","E01017559","Total",39,15,14,10,6,1,5,0,33,14,9,10
"2011","Central Bedfordshire 018C","E01017560","Total",26,8,13,5,6,0,5,1,20,8,8,4
"2011","Central Bedfordshire 018D","E01017616","Total",80,30,31,19,7,0,7,0,73,30,24,19
"2011","Central Bedfordshire 019A","E01017577","Total",32,9,15,8,4,1,3,0,28,8,12,8
"2011","Central Bedfordshire 019B","E01017615","Total",21,8,7,6,3,0,2,1,18,8,5,5
"2011","Central Bedfordshire 019C","E01017620","Total",49,21,19,9,6,0,4,2,43,21,15,7
"2011","Central Bedfordshire 019D","E01017621","Total",30,9,17,4,6,0,6,0,24,9,11,4
"2011","Central Bedfordshire 019E","E01017622","Total",64,24,17,23,4,0,2,2,60,24,15,21
"2011","Central Bedfordshire 020A","E01017603","Total",34,14,10,10,3,0,2,1,31,14,8,9
"2011","Central Bedfordshire 020B","E01017604","Total",42,16,20,6,6,0,5,1,36,16,15,5
"2011","Central Bedfordshire 020C","E01017605","Total",89,23,18,48,9,1,5,3,80,22,13,45
"2011","Central Bedfordshire 020D","E01017606","Total",17,9,4,4,3,2,1,0,14,7,3,4
"2011","Central Bedfordshire 020E","E01017607","Total",10,6,2,2,0,0,0,0,10,6,2,2
"2011","Central Bedfordshire 021A","E01017555","Total",71,21,18,32,5,1,4,0,66,20,14,32
"2011","Central Bedfordshire 021B","E01017556","Total",32,12,10,10,3,0,2,1,29,12,8,9
"2011","Central Bedfordshire 021C","E01017557","Total",66,15,18,33,9,0,3,6,57,15,15,27
"2011","Central Bedfordshire 021D","E01017608","Total",44,9,14,21,6,0,4,2,38,9,10,19
"2011","Central Bedfordshire 021E","E01017609","Total",128,40,19,69,6,0,2,4,122,40,17,65
"2011","Central Bedfordshire 022A","E01017589","Total",50,16,10,24,1,0,1,0,49,16,9,24
"2011","Central Bedfordshire 022B","E01017590","Total",20,6,7,7,4,0,4,0,16,6,3,7
"2011","Central Bedfordshire 022C","E01017591","Total",46,22,14,10,5,1,3,1,41,21,11,9
"2011","Central Bedfordshire 022D","E01017610","Total",14,7,4,3,1,0,1,0,13,7,3,3
"2011","Central Bedfordshire 023A","E01017611","Total",18,7,9,2,0,0,0,0,18,7,9,2
"2011","Central Bedfordshire 023B","E01017612","Total",23,9,13,1,1,0,1,0,22,9,12,1
"2011","Central Bedfordshire 023C","E01017613","Total",31,9,14,8,1,1,0,0,30,8,14,8
"2011","Central Bedfordshire 023D","E01017614","Total",25,10,10,5,2,0,2,0,23,10,8,5
"2011","Central Bedfordshire 025A","E01017600","Total",66,17,20,29,10,1,6,3,56,16,14,26
"2011","Central Bedfordshire 025B","E01017601","Total",77,18,19,40,9,1,5,3,68,17,14,37
"2011","Central Bedfordshire 025C","E01017602","Total",71,14,18,39,9,2,3,4,62,12,15,35
"2011","Central Bedfordshire 025D","E01017618","Total",107,31,17,59,12,0,7,5,95,31,10,54
"2011","Central Bedfordshire 025E","E01017619","Total",121,33,18,70,8,2,4,2,113,31,14,68
"2011","Central Bedfordshire 024A","E01017573","Total",20,8,9,3,3,0,3,0,17,8,6,3
"2011","Central Bedfordshire 024C","E01017575","Total",94,28,41,25,10,0,9,1,84,28,32,24
"2011","Central Bedfordshire 024D","E01017576","Total",35,8,12,15,4,0,2,2,31,8,10,13
"2011","Central Bedfordshire 024E","E01033191","Total",43,14,13,16,4,0,3,1,39,14,10,15
"2011","Central Bedfordshire 024F","E01033192","Total",50,14,14,22,5,1,2,2,45,13,12,20
"2011","Central Bedfordshire 024G","E01033193","Total",43,12,11,20,2,1,0,1,41,11,11,19
"2011","Central Bedfordshire 026A","E01017578","Total",40,11,10,19,4,0,3,1,36,11,7,18
"2011","Central Bedfordshire 026B","E01017579","Total",64,22,21,21,1,0,1,0,63,22,20,21
"2011","Central Bedfordshire 026C","E01017580","Total",158,49,32,77,17,7,5,5,141,42,27,72
"2011","Central Bedfordshire 026D","E01017581","Total",68,17,19,32,3,0,1,2,65,17,18,30
"2011","Central Bedfordshire 026E","E01017617","Total",36,11,10,15,6,1,4,1,30,10,6,14
"2011","Central Bedfordshire 027A","E01017582","Total",20,6,9,5,0,0,0,0,20,6,9,5
"2011","Central Bedfordshire 027B","E01017583","Total",48,14,25,9,3,1,2,0,45,13,23,9
"2011","Central Bedfordshire 027C","E01017584","Total",56,16,18,22,6,2,4,0,50,14,14,22
"2011","Central Bedfordshire 027D","E01017585","Total",19,3,13,3,5,0,5,0,14,3,8,3
"2011","Central Bedfordshire 028A","E01017566","Total",16,8,7,1,1,0,1,0,15,8,6,1
"2011","Central Bedfordshire 028B","E01017595","Total",48,12,8,28,5,3,2,0,43,9,6,28
"2011","Central Bedfordshire 028C","E01017596","Total",65,21,15,29,7,0,2,5,58,21,13,24
"2011","Central Bedfordshire 028D","E01017597","Total",62,12,20,30,6,0,4,2,56,12,16,28
"2011","Central Bedfordshire 028E","E01017598","Total",23,10,7,6,3,0,3,0,20,10,4,6
"2011","Central Bedfordshire 028F","E01017599","Total",106,28,24,54,14,2,6,6,92,26,18,48
"2011","Central Bedfordshire 029A","E01017565","Total",26,11,12,3,3,0,2,1,23,11,10,2
"2011","Central Bedfordshire 029B","E01017567","Total",90,31,25,34,8,1,6,1,82,30,19,33
"2011","Central Bedfordshire 029C","E01017568","Total",92,26,23,43,7,0,1,6,85,26,22,37
"2011","Central Bedfordshire 029D","E01017569","Total",64,19,25,20,8,1,6,1,56,18,19,19
"2011","Central Bedfordshire 029E","E01017570","Total",59,16,21,22,5,1,2,2,54,15,19,20
"2011","Central Bedfordshire 030A","E01017592","Total",39,12,13,14,1,0,1,0,38,12,12,14
"2011","Central Bedfordshire 030B","E01017593","Total",44,14,16,14,6,0,4,2,38,14,12,12
"2011","Central Bedfordshire 030C","E01017594","Total",199,49,32,118,21,4,7,10,178,45,25,108
"2011","Central Bedfordshire 031A","E01017623","Total",58,22,18,18,9,0,7,2,49,22,11,16
"2011","Central Bedfordshire 031B","E01017624","Total",63,29,18,16,7,3,3,1,56,26,15,15
"2011","Central Bedfordshire 031C","E01017625","Total",14,6,7,1,2,0,2,0,12,6,5,1
"2011","Central Bedfordshire 031D","E01017626","Total",24,12,10,2,5,1,3,1,19,11,7,1
"2011","Central Bedfordshire 032A","E01017571","Total",33,11,7,15,6,0,3,3,27,11,4,12
"2011","Central Bedfordshire 032B","E01017572","Total",34,16,14,4,4,0,4,0,30,16,10,4
"2011","Central Bedfordshire 032C","E01017586","Total",32,7,13,12,5,0,4,1,27,7,9,11
"2011","Central Bedfordshire 032D","E01017587","Total",13,3,2,8,2,1,0,1,11,2,2,7
"2011","Central Bedfordshire 032E","E01017588","Total",11,7,1,3,2,2,0,0,9,5,1,3
"2011","Central Bedfordshire 033A","E01017561","Total",23,10,8,5,3,0,2,1,20,10,6,4
"2011","Central Bedfordshire 033B","E01017562","Total",36,15,10,11,2,0,1,1,34,15,9,10
"2011","Central Bedfordshire 033C","E01017563","Total",24,11,6,7,1,1,0,0,23,10,6,7
"2011","Central Bedfordshire 033D","E01017564","Total",37,13,16,8,3,1,1,1,34,12,15,7
"2011","Luton 001A","E01015706","Total",21,9,6,6,2,0,1,1,19,9,5,5
"2011","Luton 001B","E01015707","Total",17,10,5,2,1,0,1,0,16,10,4,2
"2011","Luton 001C","E01015708","Total",16,7,6,3,3,0,3,0,13,7,3,3
"2011","Luton 001D","E01015709","Total",30,13,12,5,5,1,4,0,25,12,8,5
"2011","Luton 001E","E01015710","Total",39,15,12,12,3,1,2,0,36,14,10,12
"2011","Luton 001F","E01015770","Total",20,11,7,2,2,0,1,1,18,11,6,1
"2011","Luton 002A","E01015801","Total",114,23,36,55,14,0,8,6,100,23,28,49
"2011","Luton 002B","E01015803","Total",26,14,6,6,1,1,0,0,25,13,6,6
"2011","Luton 002C","E01015804","Total",99,23,18,58,2,1,1,0,97,22,17,58
"2011","Luton 002D","E01015805","Total",23,11,7,5,4,0,4,0,19,11,3,5
"2011","Luton 003A","E01015769","Total",53,16,17,20,6,2,1,3,47,14,16,17
"2011","Luton 003B","E01015771","Total",98,21,25,52,8,1,6,1,90,20,19,51
"2011","Luton 003C","E01015772","Total",77,22,14,41,8,0,4,4,69,22,10,37
"2011","Luton 003D","E01015773","Total",92,25,22,45,5,0,3,2,87,25,19,43
"2011","Luton 003E","E01015774","Total",76,23,10,43,2,0,1,1,74,23,9,42
"2011","Luton 003F","E01015802","Total",97,26,19,52,7,1,3,3,90,25,16,49
"2011","Luton 004A","E01015744","Total",61,15,21,25,2,0,2,0,59,15,19,25
"2011","Luton 004B","E01015746","Total",28,11,9,8,4,0,2,2,24,11,7,6
"2011","Luton 004C","E01015747","Total",14,2,10,2,3,0,3,0,11,2,7,2
"2011","Luton 004D","E01015748","Total",41,16,7,18,4,2,1,1,37,14,6,17
"2011","Luton 005A","E01015749","Total",107,29,18,60,6,4,2,0,101,25,16,60
"2011","Luton 005B","E01015751","Total",80,19,21,40,3,0,3,0,77,19,18,40
"2011","Luton 005C","E01015752","Total",50,11,17,22,1,0,1,0,49,11,16,22
"2011","Luton 005D","E01015753","Total",67,13,33,21,8,1,6,1,59,12,27,20
"2011","Luton 005E","E01015754","Total",94,19,28,47,6,0,3,3,88,19,25,44
"2011","Luton 005F","E01015755","Total",31,7,14,10,1,0,0,1,30,7,14,9
"2011","Luton 006A","E01015764","Total",29,6,15,8,2,0,1,1,27,6,14,7
"2011","Luton 006B","E01015765","Total",70,23,17,30,5,1,4,0,65,22,13,30
"2011","Luton 006C","E01015766","Total",60,16,22,22,2,0,1,1,58,16,21,21
"2011","Luton 006D","E01015767","Total",41,11,20,10,6,0,4,2,35,11,16,8
"2011","Luton 006E","E01015768","Total",41,17,11,13,3,2,1,0,38,15,10,13
"2011","Luton 006F","E01015783","Total",54,16,9,29,4,0,1,3,50,16,8,26
"2011","Luton 006G","E01015785","Total",64,19,20,25,6,0,4,2,58,19,16,23
"2011","Luton 007A","E01015693","Total",21,7,9,5,2,0,1,1,19,7,8,4
"2011","Luton 007B","E01015694","Total",14,6,7,1,1,0,1,0,13,6,6,1
"2011","Luton 007C","E01015695","Total",29,9,13,7,4,1,2,1,25,8,11,6
"2011","Luton 007D","E01015696","Total",61,21,21,19,3,0,3,0,58,21,18,19
"2011","Luton 007E","E01015697","Total",41,16,16,9,5,0,4,1,36,16,12,8
"2011","Luton 007F","E01015745","Total",25,10,10,5,3,1,2,0,22,9,8,5
"2011","Luton 008A","E01015797","Total",21,6,11,4,4,1,3,0,17,5,8,4
"2011","Luton 008B","E01015798","Total",45,10,18,17,4,1,3,0,41,9,15,17
"2011","Luton 008C","E01015799","Total",33,11,13,9,3,0,3,0,30,11,10,9
"2011","Luton 008D","E01015800","Total",52,18,19,15,3,0,2,1,49,18,17,14
"2011","Luton 008E","E01015812","Total",37,12,15,10,0,0,0,0,37,12,15,10
"2011","Luton 008F","E01015813","Total",34,10,13,11,0,0,0,0,34,10,13,11
"2011","Luton 009A","E01015756","Total",76,24,15,37,2,1,1,0,74,23,14,37
"2011","Luton 009B","E01015757","Total",73,22,17,34,7,1,4,2,66,21,13,32
"2011","Luton 009C","E01015758","Total",85,27,23,35,5,1,2,2,80,26,21,33
"2011","Luton 009D","E01015759","Total",61,19,14,28,2,1,1,0,59,18,13,28
"2011","Luton 009E","E01015760","Total",78,21,20,37,3,0,0,3,75,21,20,34
"2011","Luton 009F","E01015761","Total",75,29,8,38,2,0,2,0,73,29,6,38
"2011","Luton 010A","E01015700","Total",49,15,7,27,0,0,0,0,49,15,7,27
"2011","Luton 010B","E01015701","Total",30,6,2,22,2,0,1,1,28,6,1,21
"2011","Luton 010C","E01015704","Total",52,19,3,30,2,1,0,1,50,18,3,29
"2011","Luton 010D","E01015782","Total",34,15,9,10,5,1,3,1,29,14,6,9
"2011","Luton 010E","E01015784","Total",32,4,13,15,1,0,1,0,31,4,12,15
"2011","Luton 010F","E01015786","Total",35,12,8,15,6,6,0,0,29,6,8,15
"2011","Luton 011A","E01015711","Total",24,8,6,10,1,0,1,0,23,8,5,10
"2011","Luton 011B","E01015712","Total",21,9,4,8,1,0,1,0,20,9,3,8
"2011","Luton 011C","E01015715","Total",49,12,6,31,2,0,1,1,47,12,5,30
"2011","Luton 011D","E01015716","Total",93,27,21,45,5,2,2,1,88,25,19,44
"2011","Luton 011E","E01015717","Total",59,19,17,23,5,1,3,1,54,18,14,22
"2011","Luton 011F","E01015750","Total",62,18,18,26,6,1,2,3,56,17,16,23
"2011","Luton 012A","E01015740","Total",23,8,7,8,0,0,0,0,23,8,7,8
"2011","Luton 012B","E01015775","Total",41,17,16,8,4,1,2,1,37,16,14,7
"2011","Luton 012C","E01015776","Total",55,25,11,19,2,1,0,1,53,24,11,18
"2011","Luton 012D","E01015777","Total",51,19,15,17,2,0,2,0,49,19,13,17
"2011","Luton 012E","E01015778","Total",59,23,22,14,3,0,2,1,56,23,20,13
"2011","Luton 012F","E01015796","Total",19,6,7,6,0,0,0,0,19,6,7,6
"2011","Luton 013A","E01015713","Total",29,5,9,15,3,0,0,3,26,5,9,12
"2011","Luton 013B","E01015714","Total",33,9,14,10,5,1,4,0,28,8,10,10
"2011","Luton 013C","E01015718","Total",36,13,16,7,5,2,2,1,31,11,14,6
"2011","Luton 013D","E01015762","Total",40,13,14,13,2,0,1,1,38,13,13,12
"2011","Luton 013E","E01015763","Total",35,13,10,12,1,0,1,0,34,13,9,12
"2011","Luton 014A","E01015721","Total",35,11,11,13,3,0,3,0,32,11,8,13
"2011","Luton 014B","E01015722","Total",45,13,14,18,2,1,0,1,43,12,14,17
"2011","Luton 014C","E01015806","Total",45,15,12,18,2,0,2,0,43,15,10,18
"2011","Luton 014D","E01015808","Total",33,16,10,7,0,0,0,0,33,16,10,7
"2011","Luton 014E","E01015809","Total",17,6,6,5,2,0,2,0,15,6,4,5
"2011","Luton 014F","E01015810","Total",87,24,22,41,5,0,5,0,82,24,17,41
"2011","Luton 014G","E01015811","Total",27,8,8,11,3,0,2,1,24,8,6,10
"2011","Luton 015A","E01015703","Total",22,9,6,7,4,1,3,0,18,8,3,7
"2011","Luton 015B","E01015726","Total",59,7,7,45,8,0,3,5,51,7,4,40
"2011","Luton 015C","E01015731","Total",41,7,6,28,3,0,0,3,38,7,6,25
"2011","Luton 015D","E01015787","Total",28,6,2,20,1,0,0,1,27,6,2,19
"2011","Luton 015E","E01015788","Total",30,6,6,18,2,1,0,1,28,5,6,17
"2011","Luton 016A","E01015719","Total",27,10,10,7,2,1,1,0,25,9,9,7
"2011","Luton 016B","E01015720","Total",57,14,10,33,2,0,2,0,55,14,8,33
"2011","Luton 016C","E01015723","Total",51,19,13,19,0,0,0,0,51,19,13,19
"2011","Luton 016D","E01015779","Total",58,24,11,23,4,1,3,0,54,23,8,23
"2011","Luton 016E","E01015780","Total",44,16,12,16,3,0,2,1,41,16,10,15
"2011","Luton 016F","E01015781","Total",48,14,10,24,4,0,2,2,44,14,8,22
"2011","Luton 016G","E01015807","Total",67,24,18,25,2,0,2,0,65,24,16,25
"2011","Luton 017A","E01015698","Total",50,13,8,29,6,0,3,3,44,13,5,26
"2011","Luton 017B","E01015699","Total",55,12,12,31,3,1,0,2,52,11,12,29
"2011","Luton 017C","E01015702","Total",39,10,4,25,0,0,0,0,39,10,4,25
"2011","Luton 017D","E01015705","Total",75,11,11,53,6,1,4,1,69,10,7,52
"2011","Luton 017E","E01015725","Total",35,9,2,24,0,0,0,0,35,9,2,24
"2011","Luton 017F","E01015727","Total",24,6,4,14,2,1,0,1,22,5,4,13
"2011","Luton 018A","E01015739","Total",46,9,17,20,2,2,0,0,44,7,17,20
"2011","Luton 018B","E01015741","Total",79,22,26,31,9,3,5,1,70,19,21,30
"2011","Luton 018C","E01015742","Total",59,19,18,22,4,1,2,1,55,18,16,21
"2011","Luton 018D","E01015743","Total",67,18,18,31,2,0,1,1,65,18,17,30
"2011","Luton 018E","E01015789","Total",75,21,9,45,3,0,1,2,72,21,8,43
"2011","Luton 018F","E01015794","Total",39,16,12,11,1,0,1,0,38,16,11,11
"2011","Luton 019A","E01015724","Total",45,8,6,31,5,0,1,4,40,8,5,27
"2011","Luton 019B","E01015728","Total",39,7,6,26,3,2,0,1,36,5,6,25
"2011","Luton 019C","E01015729","Total",43,9,11,23,6,4,1,1,37,5,10,22
"2011","Luton 019D","E01015730","Total",60,12,11,37,3,0,1,2,57,12,10,35
"2011","Luton 020A","E01015732","Total",86,21,25,40,6,1,0,5,80,20,25,35
"2011","Luton 020B","E01015733","Total",67,17,15,35,3,0,2,1,64,17,13,34
"2011","Luton 020C","E01015734","Total",50,13,21,16,7,1,4,2,43,12,17,14
"2011","Luton 020D","E01015735","Total",65,13,20,32,7,2,2,3,58,11,18,29
"2011","Luton 020E","E01015736","Total",70,14,12,44,8,2,3,3,62,12,9,41
"2011","Luton 020F","E01015737","Total",68,18,20,30,1,0,1,0,67,18,19,30
"2011","Luton 021A","E01015738","Total",44,13,17,14,4,1,3,0,40,12,14,14
"2011","Luton 021B","E01015790","Total",38,13,10,15,2,0,1,1,36,13,9,14
"2011","Luton 021C","E01015791","Total",98,35,16,47,5,0,1,4,93,35,15,43
"2011","Luton 021D","E01015792","Total",51,20,15,16,1,0,1,0,50,20,14,16
"2011","Luton 021E","E01015793","Total",40,10,10,20,2,0,0,2,38,10,10,18
"2011","Luton 021F","E01015795","Total",66,20,9,37,6,0,2,4,60,20,7,33
"2011","Peterborough 001A","E01015629","Total",32,14,12,6,6,2,3,1,26,12,9,5
"2011","Peterborough 001B","E01015635","Total",25,11,7,7,2,0,1,1,23,11,6,6
"2011","Peterborough 001C","E01015636","Total",28,7,14,7,2,0,2,0,26,7,12,7
"2011","Peterborough 001D","E01015679","Total",52,32,12,8,4,0,3,1,48,32,9,7
"2011","Peterborough 002A","E01015678","Total",49,25,12,12,3,0,3,0,46,25,9,12
"2011","Peterborough 002B","E01015680","Total",96,33,22,41,6,1,3,2,90,32,19,39
"2011","Peterborough 002C","E01015681","Total",30,14,10,6,3,0,2,1,27,14,8,5
"2011","Peterborough 002D","E01015682","Total",54,26,16,12,6,0,5,1,48,26,11,11
"2011","Peterborough 003A","E01015630","Total",28,7,11,10,1,0,1,0,27,7,10,10
"2011","Peterborough 003B","E01015631","Total",20,6,10,4,0,0,0,0,20,6,10,4
"2011","Peterborough 003C","E01015659","Total",66,30,20,16,6,0,5,1,60,30,15,15
"2011","Peterborough 003D","E01015684","Total",15,4,9,2,2,0,2,0,13,4,7,2
"2011","Peterborough 003E","E01015685","Total",25,13,10,2,1,0,1,0,24,13,9,2
"2011","Peterborough 004A","E01015589","Total",22,9,7,6,4,1,3,0,18,8,4,6
"2011","Peterborough 004B","E01015590","Total",16,4,5,7,2,0,1,1,14,4,4,6
"2011","Peterborough 004C","E01015626","Total",32,7,18,7,4,0,4,0,28,7,14,7
"2011","Peterborough 004D","E01015628","Total",48,13,21,14,5,0,3,2,43,13,18,12
"2011","Peterborough 005A","E01015617","Total",26,9,9,8,2,0,1,1,24,9,8,7
"2011","Peterborough 005B","E01015618","Total",27,12,10,5,3,0,2,1,24,12,8,4
"2011","Peterborough 005C","E01015619","Total",89,36,26,27,8,1,4,3,81,35,22,24
"2011","Peterborough 005D","E01015620","Total",36,16,13,7,5,1,3,1,31,15,10,6
"2011","Peterborough 006A","E01015674","Total",56,20,9,27,3,0,0,3,53,20,9,24
"2011","Peterborough 006B","E01015675","Total",47,15,13,19,4,0,2,2,43,15,11,17
"2011","Peterborough 006C","E01015676","Total",42,12,13,17,4,0,2,2,38,12,11,15
"2011","Peterborough 006D","E01015683","Total",37,18,13,6,7,2,4,1,30,16,9,5
"2011","Peterborough 006E","E01015686","Total",27,11,12,4,1,1,0,0,26,10,12,4
"2011","Peterborough 007A","E01015607","Total",86,21,15,50,6,0,2,4,80,21,13,46
"2011","Peterborough 007B","E01015609","Total",106,26,24,56,14,1,8,5,92,25,16,51
"2011","Peterborough 007C","E01015656","Total",67,22,13,32,8,3,4,1,59,19,9,31
"2011","Peterborough 007D","E01015657","Total",127,34,21,72,4,0,1,3,123,34,20,69
"2011","Peterborough 007E","E01015658","Total",87,29,16,42,11,2,6,3,76,27,10,39
"2011","Peterborough 007F","E01015660","Total",74,29,22,23,5,0,3,2,69,29,19,21
"2011","Peterborough 008A","E01015605","Total",50,15,9,26,5,0,1,4,45,15,8,22
"2011","Peterborough 008B","E01015608","Total",52,15,9,28,3,0,2,1,49,15,7,27
"2011","Peterborough 008C","E01015610","Total",78,25,20,33,9,0,6,3,69,25,14,30
"2011","Peterborough 008D","E01015633","Total",100,40,12,48,6,1,3,2,94,39,9,46
"2011","Peterborough 008E","E01015634","Total",50,13,7,30,1,0,0,1,49,13,7,29
"2011","Peterborough 009A","E01015593","Total",72,28,12,32,4,0,2,2,68,28,10,30
"2011","Peterborough 009B","E01015596","Total",81,25,15,41,7,1,3,3,74,24,12,38
"2011","Peterborough 009C","E01015662","Total",71,20,14,37,3,0,1,2,68,20,13,35
"2011","Peterborough 009D","E01015663","Total",74,25,10,39,6,1,4,1,68,24,6,38
"2011","Peterborough 009E","E01015664","Total",107,29,14,64,8,0,3,5,99,29,11,59
"2011","Peterborough 010A","E01015603","Total",56,18,11,27,6,3,2,1,50,15,9,26
"2011","Peterborough 010B","E01015604","Total",43,13,7,23,2,1,1,0,41,12,6,23
"2011","Peterborough 010C","E01015632","Total",55,18,11,26,5,0,0,5,50,18,11,21
"2011","Peterborough 010D","E01015661","Total",50,15,5,30,5,1,2,2,45,14,3,28
"2011","Peterborough 010E","E01015677","Total",34,9,12,13,3,0,2,1,31,9,10,12
"2011","Peterborough 011A","E01015591","Total",43,20,11,12,6,2,4,0,37,18,7,12
"2011","Peterborough 011B","E01015592","Total",68,31,12,25,3,1,2,0,65,30,10,25
"2011","Peterborough 011C","E01015594","Total",75,35,12,28,3,2,1,0,72,33,11,28
"2011","Peterborough 011D","E01015595","Total",69,24,13,32,5,0,2,3,64,24,11,29
"2011","Peterborough 011E","E01015597","Total",103,28,16,59,8,0,5,3,95,28,11,56
"2011","Peterborough 012A","E01015601","Total",29,15,1,13,1,1,0,0,28,14,1,13
"2011","Peterborough 012B","E01015651","Total",32,14,12,6,9,2,7,0,23,12,5,6
"2011","Peterborough 012C","E01015652","Total",29,14,7,8,4,1,3,0,25,13,4,8
"2011","Peterborough 012D","E01015653","Total",32,12,7,13,4,0,4,0,28,12,3,13
"2011","Peterborough 012E","E01015654","Total",55,13,26,16,2,0,2,0,53,13,24,16
"2011","Peterborough 013A","E01015606","Total",61,18,17,26,5,1,2,2,56,17,15,24
"2011","Peterborough 013B","E01015611","Total",65,24,6,35,6,1,3,2,59,23,3,33
"2011","Peterborough 013C","E01015613","Total",80,28,14,38,7,3,3,1,73,25,11,37
"2011","Peterborough 013D","E01015614","Total",71,23,22,26,3,0,3,0,68,23,19,26
"2011","Peterborough 013E","E01015615","Total",57,17,12,28,6,1,3,2,51,16,9,26
"2011","Peterborough 013F","E01015616","Total",67,18,8,41,1,0,0,1,66,18,8,40
"2011","Peterborough 014A","E01015599","Total",43,8,13,22,4,1,1,2,39,7,12,20
"2011","Peterborough 014B","E01015600","Total",25,7,2,16,3,1,0,2,22,6,2,14
"2011","Peterborough 014C","E01015602","Total",44,17,9,18,2,0,1,1,42,17,8,17
"2011","Peterborough 014D","E01015612","Total",62,21,13,28,5,1,4,0,57,20,9,28
"2011","Peterborough 014E","E01015655","Total",41,16,14,11,6,2,3,1,35,14,11,10
"2011","Peterborough 015A","E01015598","Total",24,8,13,3,4,0,4,0,20,8,9,3
"2011","Peterborough 015B","E01015687","Total",18,5,8,5,2,0,1,1,16,5,7,4
"2011","Peterborough 015C","E01015689","Total",14,5,4,5,1,0,1,0,13,5,3,5
"2011","Peterborough 015D","E01015690","Total",8,4,3,1,1,0,1,0,7,4,2,1
"2011","Peterborough 015E","E01015691","Total",24,3,8,13,2,0,1,1,22,3,7,12
"2011","Peterborough 016A","E01015622","Total",78,28,25,25,4,1,2,1,74,27,23,24
"2011","Peterborough 016C","E01015665","Total",24,9,9,6,0,0,0,0,24,9,9,6
"2011","Peterborough 016D","E01015688","Total",32,6,13,13,8,1,4,3,24,5,9,10
"2011","Peterborough 016E","E01015692","Total",26,10,3,13,0,0,0,0,26,10,3,13
"2011","Peterborough 016F","E01033173","Total",48,19,18,11,5,0,4,1,43,19,14,10
"2011","Peterborough 016G","E01033182","Total",89,23,21,45,11,1,2,8,78,22,19,37
"2011","Peterborough 017A","E01015621","Total",59,19,18,22,6,1,3,2,53,18,15,20
"2011","Peterborough 017B","E01015623","Total",51,16,10,25,4,0,3,1,47,16,7,24
"2011","Peterborough 017C","E01015624","Total",55,24,17,14,9,2,6,1,46,22,11,13
"2011","Peterborough 017D","E01015666","Total",37,13,7,17,2,1,1,0,35,12,6,17
"2011","Peterborough 017E","E01015668","Total",85,26,21,38,3,0,2,1,82,26,19,37
"2011","Peterborough 018A","E01015627","Total",29,11,11,7,7,3,4,0,22,8,7,7
"2011","Peterborough 018B","E01015644","Total",61,20,22,19,6,0,6,0,55,20,16,19
"2011","Peterborough 018C","E01015645","Total",33,14,11,8,2,0,2,0,31,14,9,8
"2011","Peterborough 018D","E01015646","Total",21,7,10,4,3,0,2,1,18,7,8,3
"2011","Peterborough 018E","E01015648","Total",5,2,2,1,1,0,1,0,4,2,1,1
"2011","Peterborough 019A","E01015667","Total",27,8,7,12,2,1,1,0,25,7,6,12
"2011","Peterborough 019B","E01015669","Total",34,13,10,11,2,1,1,0,32,12,9,11
"2011","Peterborough 019C","E01015670","Total",32,15,7,10,5,2,2,1,27,13,5,9
"2011","Peterborough 019D","E01015671","Total",36,18,10,8,6,1,3,2,30,17,7,6
"2011","Peterborough 019E","E01015672","Total",32,18,9,5,4,0,4,0,28,18,5,5
"2011","Peterborough 019F","E01015673","Total",69,21,18,30,6,1,4,1,63,20,14,29
"2011","Peterborough 021A","E01015637","Total",67,15,8,44,3,0,1,2,64,15,7,42
"2011","Peterborough 021B","E01015639","Total",71,20,9,42,4,0,1,3,67,20,8,39
"2011","Peterborough 021C","E01015640","Total",45,14,7,24,5,2,0,3,40,12,7,21
"2011","Peterborough 021D","E01015641","Total",59,19,10,30,4,0,2,2,55,19,8,28
"2011","Peterborough 021E","E01015642","Total",91,20,18,53,3,0,2,1,88,20,16,52
"2011","Peterborough 021F","E01015647","Total",75,21,18,36,9,2,5,2,66,19,13,34
"2011","Peterborough 022A","E01015638","Total",29,13,7,9,2,0,0,2,27,13,7,7
"2011","Peterborough 022B","E01015650","Total",41,12,16,13,7,0,3,4,34,12,13,9
"2011","Peterborough 022C","E01033174","Total",91,30,20,41,7,1,4,2,84,29,16,39
"2011","Peterborough 022D","E01033179","Total",79,30,22,27,3,0,3,0,76,30,19,27
"2011","Peterborough 022E","E01033181","Total",58,27,18,13,6,0,3,3,52,27,15,10
"2011","Peterborough 023A","E01015643","Total",43,21,6,16,2,1,0,1,41,20,6,15
"2011","Peterborough 023B","E01033175","Total",49,20,19,10,4,1,3,0,45,19,16,10
"2011","Peterborough 023C","E01033176","Total",60,17,23,20,4,0,2,2,56,17,21,18
"2011","Peterborough 023D","E01033177","Total",55,21,15,19,3,0,2,1,52,21,13,18
"2011","Peterborough 023E","E01033178","Total",117,36,30,51,4,0,3,1,113,36,27,50
"2011","Peterborough 023F","E01033180","Total",90,27,19,44,3,0,1,2,87,27,18,42
"2011","Southend-on-Sea 001A","E01015833","Total",20,8,2,10,0,0,0,0,20,8,2,10
"2011","Southend-on-Sea 001B","E01015834","Total",28,12,7,9,1,0,1,0,27,12,6,9
"2011","Southend-on-Sea 001C","E01015835","Total",67,28,14,25,7,1,4,2,60,27,10,23
"2011","Southend-on-Sea 001D","E01015836","Total",33,13,12,8,4,0,4,0,29,13,8,8
"2011","Southend-on-Sea 001E","E01015837","Total",26,11,6,9,1,0,0,1,25,11,6,8
"2011","Southend-on-Sea 001F","E01015838","Total",24,11,10,3,0,0,0,0,24,11,10,3
"2011","Southend-on-Sea 002A","E01015863","Total",66,29,19,18,6,1,5,0,60,28,14,18
"2011","Southend-on-Sea 002B","E01015864","Total",26,15,4,7,2,1,1,0,24,14,3,7
"2011","Southend-on-Sea 002C","E01015865","Total",22,6,9,7,1,0,0,1,21,6,9,6
"2011","Southend-on-Sea 002D","E01015866","Total",31,16,11,4,2,0,2,0,29,16,9,4
"2011","Southend-on-Sea 002E","E01015867","Total",67,20,7,40,5,1,1,3,62,19,6,37
"2011","Southend-on-Sea 002F","E01015868","Total",51,14,8,29,6,2,2,2,45,12,6,27
"2011","Southend-on-Sea 003A","E01015814","Total",27,8,7,12,0,0,0,0,27,8,7,12
"2011","Southend-on-Sea 003B","E01015815","Total",31,17,6,8,2,0,1,1,29,17,5,7
"2011","Southend-on-Sea 003C","E01015816","Total",21,10,6,5,3,0,1,2,18,10,5,3
"2011","Southend-on-Sea 003D","E01015817","Total",25,9,7,9,3,1,0,2,22,8,7,7
"2011","Southend-on-Sea 003E","E01015818","Total",32,16,6,10,0,0,0,0,32,16,6,10
"2011","Southend-on-Sea 003F","E01015819","Total",55,24,5,26,5,1,1,3,50,23,4,23
"2011","Southend-on-Sea 004A","E01015857","Total",25,10,12,3,2,0,2,0,23,10,10,3
"2011","Southend-on-Sea 004B","E01015858","Total",23,12,6,5,3,0,3,0,20,12,3,5
"2011","Southend-on-Sea 004C","E01015859","Total",43,21,11,11,0,0,0,0,43,21,11,11
"2011","Southend-on-Sea 004D","E01015860","Total",26,11,5,10,3,1,0,2,23,10,5,8
"2011","Southend-on-Sea 004E","E01015861","Total",52,18,12,22,2,0,2,0,50,18,10,22
"2011","Southend-on-Sea 004F","E01015862","Total",61,18,12,31,4,1,0,3,57,17,12,28
"2011","Southend-on-Sea 005A","E01015820","Total",54,21,12,21,4,1,3,0,50,20,9,21
"2011","Southend-on-Sea 005B","E01015821","Total",34,15,9,10,4,0,3,1,30,15,6,9
"2011","Southend-on-Sea 005C","E01015822","Total",22,10,8,4,1,0,0,1,21,10,8,3
"2011","Southend-on-Sea 005D","E01015823","Total",36,17,13,6,1,0,1,0,35,17,12,6
"2011","Southend-on-Sea 005E","E01015824","Total",68,22,12,34,5,0,2,3,63,22,10,31
"2011","Southend-on-Sea 005F","E01015825","Total",31,10,10,11,1,0,1,0,30,10,9,11
"2011","Southend-on-Sea 005G","E01015826","Total",22,8,8,6,0,0,0,0,22,8,8,6
"2011","Southend-on-Sea 006A","E01015869","Total",64,26,12,26,8,2,3,3,56,24,9,23
"2011","Southend-on-Sea 006B","E01015870","Total",46,22,11,13,4,2,1,1,42,20,10,12
"2011","Southend-on-Sea 006C","E01015871","Total",40,13,3,24,2,0,1,1,38,13,2,23
"2011","Southend-on-Sea 006D","E01015872","Total",50,16,9,25,3,0,1,2,47,16,8,23
"2011","Southend-on-Sea 006E","E01015873","Total",50,15,13,22,4,0,4,0,46,15,9,22
"2011","Southend-on-Sea 006F","E01015874","Total",58,18,15,25,7,1,5,1,51,17,10,24
"2011","Southend-on-Sea 006G","E01015875","Total",80,25,12,43,9,2,5,2,71,23,7,41
"2011","Southend-on-Sea 007A","E01015901","Total",60,15,9,36,5,1,2,2,55,14,7,34
"2011","Southend-on-Sea 007B","E01015902","Total",50,13,13,24,6,0,4,2,44,13,9,22
"2011","Southend-on-Sea 007C","E01015903","Total",73,29,13,31,4,2,1,1,69,27,12,30
"2011","Southend-on-Sea 007D","E01015904","Total",52,19,12,21,3,0,2,1,49,19,10,20
"2011","Southend-on-Sea 007E","E01015905","Total",55,18,10,27,1,1,0,0,54,17,10,27
"2011","Southend-on-Sea 007F","E01015906","Total",51,11,13,27,5,2,1,2,46,9,12,25
"2011","Southend-on-Sea 007G","E01015907","Total",48,14,16,18,9,2,5,2,39,12,11,16
"2011","Southend-on-Sea 008A","E01015908","Total",16,3,9,4,4,0,4,0,12,3,5,4
"2011","Southend-on-Sea 008B","E01015909","Total",24,10,11,3,8,4,4,0,16,6,7,3
"2011","Southend-on-Sea 008C","E01015910","Total",22,14,4,4,3,0,3,0,19,14,1,4
"2011","Southend-on-Sea 008D","E01015911","Total",18,9,5,4,1,0,1,0,17,9,4,4
"2011","Southend-on-Sea 008E","E01015912","Total",22,5,14,3,1,0,1,0,21,5,13,3
"2011","Southend-on-Sea 008F","E01015913","Total",43,16,15,12,3,0,3,0,40,16,12,12
"2011","Southend-on-Sea 009A","E01015883","Total",17,9,7,1,3,0,3,0,14,9,4,1
"2011","Southend-on-Sea 009B","E01015884","Total",84,25,7,52,4,2,0,2,80,23,7,50
"2011","Southend-on-Sea 009C","E01015885","Total",14,4,6,4,3,0,3,0,11,4,3,4
"2011","Southend-on-Sea 009D","E01015886","Total",90,32,14,44,12,1,4,7,78,31,10,37
"2011","Southend-on-Sea 009E","E01015887","Total",84,33,11,40,9,4,2,3,75,29,9,37
"2011","Southend-on-Sea 009F","E01015888","Total",27,12,3,12,2,1,0,1,25,11,3,11
"2011","Southend-on-Sea 010A","E01015895","Total",111,36,19,56,13,4,5,4,98,32,14,52
"2011","Southend-on-Sea 010B","E01015896","Total",83,26,15,42,11,3,2,6,72,23,13,36
"2011","Southend-on-Sea 010C","E01015897","Total",90,32,12,46,7,0,2,5,83,32,10,41
"2011","Southend-on-Sea 010D","E01015898","Total",74,24,13,37,6,0,2,4,68,24,11,33
"2011","Southend-on-Sea 010E","E01015899","Total",60,15,18,27,11,0,7,4,49,15,11,23
"2011","Southend-on-Sea 010F","E01015900","Total",73,24,20,29,4,0,3,1,69,24,17,28
"2011","Southend-on-Sea 011A","E01015845","Total",50,24,18,8,4,0,4,0,46,24,14,8
"2011","Southend-on-Sea 011B","E01015846","Total",33,12,8,13,5,1,1,3,28,11,7,10
"2011","Southend-on-Sea 011C","E01015847","Total",67,25,18,24,5,0,4,1,62,25,14,23
"2011","Southend-on-Sea 011D","E01015848","Total",31,15,10,6,4,0,3,1,27,15,7,5
"2011","Southend-on-Sea 011E","E01015849","Total",53,25,13,15,2,1,1,0,51,24,12,15
"2011","Southend-on-Sea 011F","E01015850","Total",38,17,10,11,1,1,0,0,37,16,10,11
"2011","Southend-on-Sea 012A","E01015827","Total",16,4,6,6,2,0,1,1,14,4,5,5
"2011","Southend-on-Sea 012B","E01015828","Total",27,10,5,12,0,0,0,0,27,10,5,12
"2011","Southend-on-Sea 012C","E01015829","Total",30,17,6,7,3,1,2,0,27,16,4,7
"2011","Southend-on-Sea 012D","E01015830","Total",15,5,5,5,1,0,1,0,14,5,4,5
"2011","Southend-on-Sea 012E","E01015831","Total",49,13,15,21,6,0,3,3,43,13,12,18
"2011","Southend-on-Sea 012F","E01015832","Total",25,9,8,8,4,1,2,1,21,8,6,7
"2011","Southend-on-Sea 013A","E01015876","Total",60,21,19,20,13,4,5,4,47,17,14,16
"2011","Southend-on-Sea 013B","E01015877","Total",60,23,6,31,6,1,0,5,54,22,6,26
"2011","Southend-on-Sea 013C","E01015878","Total",50,17,12,21,3,0,3,0,47,17,9,21
"2011","Southend-on-Sea 013D","E01015879","Total",79,29,14,36,5,1,2,2,74,28,12,34
"2011","Southend-on-Sea 013E","E01015880","Total",70,20,11,39,9,2,2,5,61,18,9,34
"2011","Southend-on-Sea 013F","E01015881","Total",35,10,12,13,3,0,2,1,32,10,10,12
"2011","Southend-on-Sea 013G","E01015882","Total",93,35,18,40,11,1,6,4,82,34,12,36
"2011","Southend-on-Sea 014A","E01015839","Total",70,28,12,30,5,1,1,3,65,27,11,27
"2011","Southend-on-Sea 014B","E01015840","Total",66,17,14,35,6,1,1,4,60,16,13,31
"2011","Southend-on-Sea 014C","E01015841","Total",111,41,19,51,5,0,3,2,106,41,16,49
"2011","Southend-on-Sea 014D","E01015842","Total",135,40,13,82,9,2,1,6,126,38,12,76
"2011","Southend-on-Sea 014E","E01015843","Total",65,22,12,31,6,0,4,2,59,22,8,29
"2011","Southend-on-Sea 014F","E01015844","Total",56,21,12,23,4,1,2,1,52,20,10,22
"2011","Southend-on-Sea 015A","E01015851","Total",19,5,3,11,0,0,0,0,19,5,3,11
"2011","Southend-on-Sea 015B","E01015852","Total",58,18,12,28,7,5,2,0,51,13,10,28
"2011","Southend-on-Sea 015C","E01015853","Total",38,16,10,12,3,2,0,1,35,14,10,11
"2011","Southend-on-Sea 015D","E01015854","Total",74,22,14,38,6,1,2,3,68,21,12,35
"2011","Southend-on-Sea 015E","E01015855","Total",69,24,14,31,8,2,3,3,61,22,11,28
"2011","Southend-on-Sea 015F","E01015856","Total",43,12,12,19,6,0,4,2,37,12,8,17
"2011","Southend-on-Sea 016A","E01015889","Total",10,5,4,1,1,0,1,0,9,5,3,1
"2011","Southend-on-Sea 016B","E01015890","Total",17,6,4,7,1,0,0,1,16,6,4,6
"2011","Southend-on-Sea 016C","E01015891","Total",45,17,6,22,6,0,2,4,39,17,4,18
"2011","Southend-on-Sea 016D","E01015892","Total",35,14,10,11,1,0,0,1,34,14,10,10
"2011","Southend-on-Sea 016E","E01015893","Total",9,2,3,4,2,1,1,0,7,1,2,4
"2011","Southend-on-Sea 016F","E01015894","Total",20,12,6,2,1,0,1,0,19,12,5,2
"2011","Southend-on-Sea 017A","E01015914","Total",15,7,7,1,2,0,2,0,13,7,5,1
"2011","Southend-on-Sea 017B","E01015915","Total",36,14,15,7,5,1,3,1,31,13,12,6
"2011","Southend-on-Sea 017C","E01015916","Total",93,23,16,54,10,2,6,2,83,21,10,52
"2011","Southend-on-Sea 017D","E01015917","Total",83,20,18,45,12,2,7,3,71,18,11,42
"2011","Southend-on-Sea 017E","E01015918","Total",51,19,11,21,7,1,4,2,44,18,7,19
"2011","Southend-on-Sea 017F","E01015919","Total",28,13,4,11,4,2,0,2,24,11,4,9
"2011","Southend-on-Sea 017G","E01015920","Total",24,9,7,8,1,0,1,0,23,9,6,8
"2011","Thurrock 001A","E01015943","Total",33,15,13,5,3,0,3,0,30,15,10,5
"2011","Thurrock 001B","E01015944","Total",16,6,7,3,2,0,2,0,14,6,5,3
"2011","Thurrock 001C","E01015946","Total",33,15,9,9,1,0,1,0,32,15,8,9
"2011","Thurrock 001D","E01015997","Total",17,5,10,2,0,0,0,0,17,5,10,2
"2011","Thurrock 001E","E01015999","Total",21,7,10,4,1,0,1,0,20,7,9,4
"2011","Thurrock 002A","E01015945","Total",25,11,3,11,2,0,0,2,23,11,3,9
"2011","Thurrock 002B","E01015983","Total",34,10,8,16,4,0,1,3,30,10,7,13
"2011","Thurrock 002C","E01015987","Total",65,24,15,26,7,0,5,2,58,24,10,24
"2011","Thurrock 002D","E01015988","Total",67,16,19,32,2,0,2,0,65,16,17,32
"2011","Thurrock 002E","E01015998","Total",29,12,11,6,0,0,0,0,29,12,11,6
"2011","Thurrock 003A","E01015984","Total",24,9,6,9,2,0,1,1,22,9,5,8
"2011","Thurrock 003B","E01015985","Total",22,9,5,8,0,0,0,0,22,9,5,8
"2011","Thurrock 003C","E01015986","Total",59,18,7,34,5,0,3,2,54,18,4,32
"2011","Thurrock 003D","E01015990","Total",31,10,6,15,4,0,2,2,27,10,4,13
"2011","Thurrock 003E","E01016001","Total",29,15,7,7,3,0,2,1,26,15,5,6
"2011","Thurrock 004A","E01015977","Total",39,14,9,16,7,0,5,2,32,14,4,14
"2011","Thurrock 004B","E01015978","Total",11,4,3,4,1,0,1,0,10,4,2,4
"2011","Thurrock 004C","E01015979","Total",24,8,7,9,0,0,0,0,24,8,7,9
"2011","Thurrock 004D","E01015980","Total",19,7,6,6,3,0,3,0,16,7,3,6
"2011","Thurrock 005A","E01015989","Total",41,10,12,19,6,0,4,2,35,10,8,17
"2011","Thurrock 005B","E01015991","Total",31,11,12,8,5,0,4,1,26,11,8,7
"2011","Thurrock 005C","E01015992","Total",71,26,19,26,3,0,2,1,68,26,17,25
"2011","Thurrock 005D","E01016000","Total",39,16,10,13,4,0,3,1,35,16,7,12
"2011","Thurrock 005E","E01016002","Total",15,8,4,3,2,1,1,0,13,7,3,3
"2011","Thurrock 006A","E01015932","Total",56,15,14,27,3,2,1,0,53,13,13,27
"2011","Thurrock 006B","E01015971","Total",47,17,7,23,1,0,1,0,46,17,6,23
"2011","Thurrock 006C","E01015972","Total",50,19,8,23,3,1,0,2,47,18,8,21
"2011","Thurrock 006D","E01015973","Total",69,27,10,32,2,0,2,0,67,27,8,32
"2011","Thurrock 006E","E01015974","Total",18,7,5,6,0,0,0,0,18,7,5,6
"2011","Thurrock 006F","E01015975","Total",31,12,9,10,2,0,1,1,29,12,8,9
"2011","Thurrock 007A","E01015927","Total",79,23,18,38,7,1,5,1,72,22,13,37
"2011","Thurrock 007B","E01015928","Total",50,13,17,20,2,0,2,0,48,13,15,20
"2011","Thurrock 007C","E01015929","Total",63,21,12,30,6,1,3,2,57,20,9,28
"2011","Thurrock 007D","E01015930","Total",51,16,11,24,1,0,1,0,50,16,10,24
"2011","Thurrock 007E","E01015931","Total",63,18,7,38,4,2,0,2,59,16,7,36
"2011","Thurrock 007F","E01015976","Total",90,34,12,44,4,0,3,1,86,34,9,43
"2011","Thurrock 008A","E01015922","Total",45,12,7,26,2,0,2,0,43,12,5,26
"2011","Thurrock 008B","E01015923","Total",52,13,14,25,6,2,0,4,46,11,14,21
"2011","Thurrock 008C","E01015924","Total",51,17,12,22,2,0,1,1,49,17,11,21
"2011","Thurrock 008D","E01015925","Total",27,6,11,10,4,0,2,2,23,6,9,8
"2011","Thurrock 008E","E01015926","Total",30,11,10,9,3,0,3,0,27,11,7,9
"2011","Thurrock 009A","E01015957","Total",33,13,8,12,3,1,1,1,30,12,7,11
"2011","Thurrock 009B","E01015958","Total",44,15,15,14,5,0,1,4,39,15,14,10
"2011","Thurrock 009C","E01015993","Total",35,14,6,15,3,0,1,2,32,14,5,13
"2011","Thurrock 009D","E01015994","Total",34,12,6,16,5,0,0,5,29,12,6,11
"2011","Thurrock 009E","E01015995","Total",20,11,7,2,3,0,2,1,17,11,5,1
"2011","Thurrock 009F","E01015996","Total",43,12,13,18,5,1,0,4,38,11,13,14
"2011","Thurrock 010A","E01015963","Total",67,22,5,40,7,0,3,4,60,22,2,36
"2011","Thurrock 010B","E01015964","Total",22,9,7,6,2,0,1,1,20,9,6,5
"2011","Thurrock 010C","E01015965","Total",8,2,2,4,2,0,2,0,6,2,0,4
"2011","Thurrock 010D","E01015966","Total",23,6,10,7,2,0,2,0,21,6,8,7
"2011","Thurrock 012A","E01015933","Total",24,9,4,11,2,0,1,1,22,9,3,10
"2011","Thurrock 012B","E01015934","Total",68,22,7,39,2,1,0,1,66,21,7,38
"2011","Thurrock 012C","E01015935","Total",56,8,12,36,8,1,3,4,48,7,9,32
"2011","Thurrock 012D","E01015936","Total",39,12,6,21,1,0,1,0,38,12,5,21
"2011","Thurrock 012E","E01015937","Total",21,8,8,5,4,3,1,0,17,5,7,5
"2011","Thurrock 012F","E01015938","Total",136,37,14,85,14,0,4,10,122,37,10,75
"2011","Thurrock 013A","E01015947","Total",57,19,9,29,4,0,4,0,53,19,5,29
"2011","Thurrock 013B","E01015948","Total",49,19,6,24,2,0,1,1,47,19,5,23
"2011","Thurrock 013C","E01015949","Total",60,28,12,20,1,0,0,1,59,28,12,19
"2011","Thurrock 013D","E01015950","Total",28,14,3,11,3,1,0,2,25,13,3,9
"2011","Thurrock 014A","E01015960","Total",10,5,4,1,1,0,1,0,9,5,3,1
"2011","Thurrock 014B","E01015967","Total",35,13,12,10,3,2,1,0,32,11,11,10
"2011","Thurrock 014C","E01015968","Total",30,11,9,10,3,0,2,1,27,11,7,9
"2011","Thurrock 014D","E01015969","Total",37,14,13,10,4,0,3,1,33,14,10,9
"2011","Thurrock 014E","E01015970","Total",20,6,6,8,2,1,1,0,18,5,5,8
"2011","Thurrock 015A","E01015921","Total",41,13,9,19,4,0,2,2,37,13,7,17
"2011","Thurrock 015B","E01016011","Total",63,15,16,32,6,1,4,1,57,14,12,31
"2011","Thurrock 015C","E01016012","Total",93,21,18,54,9,3,5,1,84,18,13,53
"2011","Thurrock 015D","E01016013","Total",93,18,23,52,6,0,5,1,87,18,18,51
"2011","Thurrock 015E","E01016014","Total",165,35,43,87,13,1,8,4,152,34,35,83
"2011","Thurrock 015F","E01016015","Total",47,15,18,14,3,0,2,1,44,15,16,13
"2011","Thurrock 016A","E01015955","Total",39,7,12,20,10,0,1,9,29,7,11,11
"2011","Thurrock 016B","E01015956","Total",59,7,19,33,8,0,2,6,51,7,17,27
"2011","Thurrock 016C","E01015959","Total",35,9,8,18,1,0,1,0,34,9,7,18
"2011","Thurrock 016D","E01015961","Total",35,11,8,16,1,0,0,1,34,11,8,15
"2011","Thurrock 016E","E01015962","Total",61,10,19,32,5,0,3,2,56,10,16,30
"2011","Thurrock 017A","E01015951","Total",87,36,15,36,14,10,1,3,73,26,14,33
"2011","Thurrock 017B","E01015952","Total",82,16,19,47,10,0,3,7,72,16,16,40
"2011","Thurrock 017C","E01015953","Total",78,18,16,44,13,0,7,6,65,18,9,38
"2011","Thurrock 017D","E01015954","Total",150,35,30,85,11,2,4,5,139,33,26,80
"2011","Thurrock 018A","E01016003","Total",64,24,15,25,7,1,3,3,57,23,12,22
"2011","Thurrock 018B","E01016004","Total",99,28,13,58,9,3,2,4,90,25,11,54
"2011","Thurrock 018C","E01016005","Total",63,12,14,37,4,1,2,1,59,11,12,36
"2011","Thurrock 018D","E01016006","Total",140,24,19,97,8,0,1,7,132,24,18,90
"2011","Thurrock 018E","E01016007","Total",52,13,12,27,0,0,0,0,52,13,12,27
"2011","Thurrock 018F","E01016008","Total",57,11,14,32,4,0,3,1,53,11,11,31
"2011","Thurrock 018G","E01016009","Total",69,9,17,43,6,0,2,4,63,9,15,39
"2011","Thurrock 018H","E01016010","Total",65,23,13,29,10,0,6,4,55,23,7,25
"2011","Thurrock 019A","E01015982","Total",51,15,15,21,5,0,2,3,46,15,13,18
"2011","Thurrock 019B","E01033610","Total",39,11,16,12,4,0,4,0,35,11,12,12
"2011","Thurrock 019C","E01033611","Total",49,18,13,18,3,0,3,0,46,18,10,18
"2011","Thurrock 019D","E01033613","Total",41,16,12,13,5,0,4,1,36,16,8,12
"2011","Thurrock 020A","E01015939","Total",26,6,14,6,3,0,3,0,23,6,11,6
"2011","Thurrock 020B","E01015941","Total",29,13,10,6,1,0,0,1,28,13,10,5
"2011","Thurrock 020C","E01015942","Total",28,4,15,9,7,0,7,0,21,4,8,9
"2011","Thurrock 020D","E01033612","Total",36,11,11,14,3,1,2,0,33,10,9,14
"2011","Thurrock 020E","E01033614","Total",27,12,6,9,3,2,1,0,24,10,5,9
"2011","Cambridge 001A","E01017975","Total",53,21,8,24,6,0,3,3,47,21,5,21
"2011","Cambridge 001B","E01017976","Total",28,10,10,8,6,0,3,3,22,10,7,5
"2011","Cambridge 001C","E01017977","Total",52,18,9,25,3,1,2,0,49,17,7,25
"2011","Cambridge 001D","E01017978","Total",61,20,10,31,2,0,1,1,59,20,9,30
"2011","Cambridge 001E","E01017979","Total",62,20,19,23,6,0,3,3,56,20,16,20
"2011","Cambridge 001F","E01017980","Total",25,10,6,9,1,0,1,0,24,10,5,9
"2011","Cambridge 002A","E01017949","Total",27,7,10,10,5,0,4,1,22,7,6,9
"2011","Cambridge 002B","E01017950","Total",15,6,6,3,2,0,2,0,13,6,4,3
"2011","Cambridge 002C","E01017951","Total",21,8,3,10,3,0,1,2,18,8,2,8
"2011","Cambridge 002D","E01017952","Total",50,16,13,21,2,0,1,1,48,16,12,20
"2011","Cambridge 002E","E01017953","Total",30,9,8,13,1,0,0,1,29,9,8,12
"2011","Cambridge 002F","E01017954","Total",40,16,4,20,1,0,1,0,39,16,3,20
"2011","Cambridge 003B","E01017971","Total",59,22,12,25,5,2,2,1,54,20,10,24
"2011","Cambridge 003C","E01017972","Total",33,9,10,14,0,0,0,0,33,9,10,14
"2011","Cambridge 003D","E01017973","Total",49,21,6,22,1,0,1,0,48,21,5,22
"2011","Cambridge 003E","E01017974","Total",33,10,5,18,4,1,2,1,29,9,3,17
"2011","Cambridge 003F","E01032792","Total",27,4,6,17,3,0,2,1,24,4,4,16
"2011","Cambridge 003G","E01032802","Total",20,11,3,6,1,0,0,1,19,11,3,5
"2011","Cambridge 004A","E01018006","Total",13,6,4,3,3,0,2,1,10,6,2,2
"2011","Cambridge 004B","E01018007","Total",9,3,3,3,1,0,1,0,8,3,2,3
"2011","Cambridge 004C","E01018008","Total",18,4,6,8,4,1,1,2,14,3,5,6
"2011","Cambridge 004D","E01018009","Total",30,8,5,17,6,3,2,1,24,5,3,16
"2011","Cambridge 004E","E01018010","Total",12,2,7,3,6,0,6,0,6,2,1,3
"2011","Cambridge 005A","E01017955","Total",10,3,4,3,4,1,1,2,6,2,3,1
"2011","Cambridge 005B","E01017956","Total",10,0,4,6,3,0,1,2,7,0,3,4
"2011","Cambridge 005C","E01017957","Total",2,1,1,0,0,0,0,0,2,1,1,0
"2011","Cambridge 005D","E01017958","Total",13,2,3,8,2,1,1,0,11,1,2,8
"2011","Cambridge 006A","E01017943","Total",32,9,7,16,2,1,1,0,30,8,6,16
"2011","Cambridge 006B","E01017944","Total",49,23,7,19,2,0,2,0,47,23,5,19
"2011","Cambridge 006C","E01017945","Total",33,11,3,19,2,0,1,1,31,11,2,18
"2011","Cambridge 006D","E01017946","Total",54,12,8,34,2,0,0,2,52,12,8,32
"2011","Cambridge 006E","E01017947","Total",43,17,8,18,6,3,1,2,37,14,7,16
"2011","Cambridge 006F","E01017948","Total",69,17,14,38,4,0,2,2,65,17,12,36
"2011","Cambridge 007C","E01017983","Total",16,6,8,2,2,0,2,0,14,6,6,2
"2011","Cambridge 007D","E01017984","Total",7,1,6,0,3,0,3,0,4,1,3,0
"2011","Cambridge 007E","E01017985","Total",24,9,8,7,4,2,2,0,20,7,6,7
"2011","Cambridge 007F","E01017986","Total",13,5,2,6,1,0,0,1,12,5,2,5
"2011","Cambridge 007G","E01032797","Total",18,7,3,8,1,1,0,0,17,6,3,8
"2011","Cambridge 008A","E01017987","Total",24,9,10,5,3,0,2,1,21,9,8,4
"2011","Cambridge 008B","E01017988","Total",5,0,3,2,0,0,0,0,5,0,3,2
"2011","Cambridge 008C","E01017989","Total",41,16,11,14,5,0,3,2,36,16,8,12
"2011","Cambridge 008D","E01017990","Total",19,8,8,3,3,0,3,0,16,8,5,3
"2011","Cambridge 008E","E01017991","Total",21,8,6,7,3,0,3,0,18,8,3,7
"2011","Cambridge 009A","E01017997","Total",35,11,5,19,1,0,0,1,34,11,5,18
"2011","Cambridge 009B","E01017998","Total",12,3,5,4,0,0,0,0,12,3,5,4
"2011","Cambridge 009C","E01017999","Total",33,14,5,14,2,1,0,1,31,13,5,13
"2011","Cambridge 009D","E01018000","Total",16,7,6,3,0,0,0,0,16,7,6,3
"2011","Cambridge 009E","E01018001","Total",13,2,11,0,4,0,4,0,9,2,7,0
"2011","Cambridge 010A","E01017965","Total",32,14,8,10,0,0,0,0,32,14,8,10
"2011","Cambridge 010B","E01017966","Total",45,16,16,13,4,1,3,0,41,15,13,13
"2011","Cambridge 010C","E01017967","Total",35,15,4,16,1,0,0,1,34,15,4,15
"2011","Cambridge 010D","E01017968","Total",7,2,2,3,1,0,1,0,6,2,1,3
"2011","Cambridge 010E","E01017969","Total",21,6,7,8,5,0,2,3,16,6,5,5
"2011","Cambridge 011A","E01017959","Total",25,6,10,9,2,1,1,0,23,5,9,9
"2011","Cambridge 011B","E01017960","Total",58,21,7,30,3,0,1,2,55,21,6,28
"2011","Cambridge 011C","E01017961","Total",41,18,10,13,5,0,2,3,36,18,8,10
"2011","Cambridge 011D","E01017962","Total",30,12,6,12,0,0,0,0,30,12,6,12
"2011","Cambridge 011E","E01017963","Total",50,15,19,16,1,0,1,0,49,15,18,16
"2011","Cambridge 011F","E01017964","Total",12,4,4,4,1,0,1,0,11,4,3,4
"2011","Cambridge 012A","E01018002","Total",29,11,15,3,3,0,3,0,26,11,12,3
"2011","Cambridge 012B","E01018003","Total",28,12,11,5,3,0,3,0,25,12,8,5
"2011","Cambridge 012D","E01018005","Total",29,9,8,12,5,2,2,1,24,7,6,11
"2011","Cambridge 012E","E01032794","Total",8,0,5,3,3,0,2,1,5,0,3,2
"2011","Cambridge 012F","E01032795","Total",33,9,10,14,4,1,2,1,29,8,8,13
"2011","Cambridge 013A","E01017992","Total",28,10,9,9,2,0,1,1,26,10,8,8
"2011","Cambridge 013B","E01017993","Total",15,4,7,4,0,0,0,0,15,4,7,4
"2011","Cambridge 013C","E01017994","Total",45,11,10,24,3,0,1,2,42,11,9,22
"2011","Cambridge 013D","E01017995","Total",9,4,5,0,0,0,0,0,9,4,5,0
"2011","Cambridge 013E","E01017996","Total",11,3,6,2,3,1,2,0,8,2,4,2
"2011","East Cambridgeshire 001A","E01018042","Total",24,5,6,13,4,0,1,3,20,5,5,10
"2011","East Cambridgeshire 001B","E01018043","Total",50,19,12,19,4,0,4,0,46,19,8,19
"2011","East Cambridgeshire 001C","E01018044","Total",36,15,8,13,4,0,3,1,32,15,5,12
"2011","East Cambridgeshire 001D","E01018045","Total",31,13,10,8,4,1,2,1,27,12,8,7
"2011","East Cambridgeshire 001E","E01018046","Total",62,27,13,22,10,1,7,2,52,26,6,20
"2011","East Cambridgeshire 002A","E01018020","Total",9,5,1,3,1,1,0,0,8,4,1,3
"2011","East Cambridgeshire 002B","E01018021","Total",20,9,8,3,0,0,0,0,20,9,8,3
"2011","East Cambridgeshire 002C","E01018022","Total",25,7,9,9,3,0,3,0,22,7,6,9
"2011","East Cambridgeshire 002D","E01018055","Total",23,11,6,6,2,0,1,1,21,11,5,5
"2011","East Cambridgeshire 002E","E01018056","Total",60,23,15,22,2,1,1,0,58,22,14,22
"2011","East Cambridgeshire 003A","E01018027","Total",18,7,7,4,1,0,1,0,17,7,6,4
"2011","East Cambridgeshire 003C","E01018029","Total",39,14,15,10,2,0,1,1,37,14,14,9
"2011","East Cambridgeshire 003D","E01018032","Total",37,16,12,9,2,0,1,1,35,16,11,8
"2011","East Cambridgeshire 003E","E01018033","Total",36,10,13,13,2,1,1,0,34,9,12,13
"2011","East Cambridgeshire 003F","E01033426","Total",25,10,7,8,4,1,3,0,21,9,4,8
"2011","East Cambridgeshire 003G","E01033430","Total",72,16,21,35,8,1,5,2,64,15,16,33
"2011","East Cambridgeshire 004A","E01018024","Total",3,1,1,1,0,0,0,0,3,1,1,1
"2011","East Cambridgeshire 004B","E01018025","Total",20,6,8,6,2,1,1,0,18,5,7,6
"2011","East Cambridgeshire 004C","E01018026","Total",23,7,13,3,3,0,1,2,20,7,12,1
"2011","East Cambridgeshire 004D","E01018030","Total",25,10,4,11,3,0,2,1,22,10,2,10
"2011","East Cambridgeshire 004F","E01033425","Total",39,16,12,11,3,0,3,0,36,16,9,11
"2011","East Cambridgeshire 004G","E01033428","Total",20,4,11,5,2,0,2,0,18,4,9,5
"2011","East Cambridgeshire 005A","E01018036","Total",31,11,12,8,3,1,2,0,28,10,10,8
"2011","East Cambridgeshire 005B","E01018037","Total",18,8,5,5,6,0,3,3,12,8,2,2
"2011","East Cambridgeshire 005C","E01018038","Total",25,7,14,4,2,0,2,0,23,7,12,4
"2011","East Cambridgeshire 005D","E01018039","Total",25,14,6,5,5,1,3,1,20,13,3,4
"2011","East Cambridgeshire 005E","E01018053","Total",19,4,6,9,2,0,1,1,17,4,5,8
"2011","East Cambridgeshire 005F","E01018054","Total",39,14,17,8,4,1,3,0,35,13,14,8
"2011","East Cambridgeshire 006A","E01018047","Total",43,14,10,19,2,0,1,1,41,14,9,18
"2011","East Cambridgeshire 006C","E01018049","Total",24,9,8,7,4,0,2,2,20,9,6,5
"2011","East Cambridgeshire 006D","E01018050","Total",26,10,9,7,3,0,2,1,23,10,7,6
"2011","East Cambridgeshire 006E","E01018051","Total",32,6,10,16,4,0,4,0,28,6,6,16
"2011","East Cambridgeshire 006F","E01018052","Total",26,10,6,10,2,1,0,1,24,9,6,9
"2011","East Cambridgeshire 006G","E01033427","Total",37,16,13,8,2,0,2,0,35,16,11,8
"2011","East Cambridgeshire 006H","E01033429","Total",31,13,8,10,6,1,4,1,25,12,4,9
"2011","East Cambridgeshire 007A","E01018034","Total",18,8,5,5,1,0,1,0,17,8,4,5
"2011","East Cambridgeshire 007B","E01018035","Total",51,20,14,17,3,0,3,0,48,20,11,17
"2011","East Cambridgeshire 007C","E01018040","Total",7,1,3,3,1,0,0,1,6,1,3,2
"2011","East Cambridgeshire 007D","E01018041","Total",18,4,6,8,1,0,1,0,17,4,5,8
"2011","East Cambridgeshire 008A","E01018013","Total",27,11,14,2,8,0,6,2,19,11,8,0
"2011","East Cambridgeshire 008B","E01018014","Total",30,11,16,3,3,0,3,0,27,11,13,3
"2011","East Cambridgeshire 008C","E01018015","Total",22,10,9,3,4,1,3,0,18,9,6,3
"2011","East Cambridgeshire 008D","E01018016","Total",30,10,7,13,3,0,2,1,27,10,5,12
"2011","East Cambridgeshire 009A","E01018011","Total",32,12,11,9,4,0,2,2,28,12,9,7
"2011","East Cambridgeshire 009B","E01018012","Total",29,14,7,8,1,0,1,0,28,14,6,8
"2011","East Cambridgeshire 009C","E01018057","Total",24,12,8,4,7,0,6,1,17,12,2,3
"2011","East Cambridgeshire 011A","E01018017","Total",22,8,4,10,3,1,2,0,19,7,2,10
"2011","East Cambridgeshire 011B","E01018019","Total",8,2,3,3,2,0,2,0,6,2,1,3
"2011","East Cambridgeshire 011C","E01018023","Total",46,12,17,17,8,1,6,1,38,11,11,16
"2011","East Cambridgeshire 011D","E01032611","Total",17,8,6,3,2,0,2,0,15,8,4,3
"2011","Fenland 001A","E01018094","Total",50,13,10,27,3,0,1,2,47,13,9,25
"2011","Fenland 001B","E01018095","Total",32,11,8,13,5,1,3,1,27,10,5,12
"2011","Fenland 001C","E01018096","Total",28,12,9,7,6,1,5,0,22,11,4,7
"2011","Fenland 001D","E01018097","Total",23,12,5,6,2,0,2,0,21,12,3,6
"2011","Fenland 002A","E01018063","Total",82,20,19,43,9,2,1,6,73,18,18,37
"2011","Fenland 002B","E01018073","Total",40,15,14,11,4,0,3,1,36,15,11,10
"2011","Fenland 002C","E01018107","Total",68,19,16,33,8,2,2,4,60,17,14,29
"2011","Fenland 002D","E01018108","Total",73,17,18,38,8,2,2,4,65,15,16,34
"2011","Fenland 002E","E01018109","Total",70,25,13,32,10,0,7,3,60,25,6,29
"2011","Fenland 003A","E01018069","Total",38,16,10,12,7,2,3,2,31,14,7,10
"2011","Fenland 003B","E01018070","Total",74,22,23,29,4,1,2,1,70,21,21,28
"2011","Fenland 003C","E01018071","Total",45,19,12,14,9,4,2,3,36,15,10,11
"2011","Fenland 003E","E01018093","Total",60,12,18,30,11,1,3,7,49,11,15,23
"2011","Fenland 003F","E01018103","Total",50,19,7,24,1,0,1,0,49,19,6,24
"2011","Fenland 003G","E01018104","Total",21,9,4,8,3,2,0,1,18,7,4,7
"2011","Fenland 003H","E01033111","Total",39,8,13,18,5,0,3,2,34,8,10,16
"2011","Fenland 003I","E01033112","Total",29,4,11,14,4,0,1,3,25,4,10,11
"2011","Fenland 004A","E01018066","Total",33,5,6,22,3,0,2,1,30,5,4,21
"2011","Fenland 004B","E01018067","Total",49,14,13,22,5,0,3,2,44,14,10,20
"2011","Fenland 004C","E01018068","Total",26,4,4,18,4,0,2,2,22,4,2,16
"2011","Fenland 004D","E01018090","Total",42,11,9,22,4,1,2,1,38,10,7,21
"2011","Fenland 004E","E01018091","Total",23,5,4,14,8,0,1,7,15,5,3,7
"2011","Fenland 004F","E01018092","Total",45,16,6,23,6,3,3,0,39,13,3,23
"2011","Fenland 005A","E01018081","Total",39,13,11,15,4,0,2,2,35,13,9,13
"2011","Fenland 005B","E01018082","Total",42,18,10,14,5,0,4,1,37,18,6,13
"2011","Fenland 005C","E01018083","Total",68,26,21,21,6,0,6,0,62,26,15,21
"2011","Fenland 005D","E01018084","Total",54,19,21,14,10,0,10,0,44,19,11,14
"2011","Fenland 006A","E01018064","Total",57,25,14,18,6,2,3,1,51,23,11,17
"2011","Fenland 006B","E01018072","Total",71,27,18,26,5,0,3,2,66,27,15,24
"2011","Fenland 006C","E01018074","Total",32,16,10,6,4,0,3,1,28,16,7,5
"2011","Fenland 006D","E01018075","Total",54,14,15,25,7,0,4,3,47,14,11,22
"2011","Fenland 006E","E01018098","Total",21,7,9,5,2,0,2,0,19,7,7,5
"2011","Fenland 006F","E01018099","Total",31,9,11,11,2,0,1,1,29,9,10,10
"2011","Fenland 006G","E01018100","Total",48,15,15,18,4,0,4,0,44,15,11,18
"2011","Fenland 006H","E01018101","Total",30,11,8,11,3,1,1,1,27,10,7,10
"2011","Fenland 007A","E01018077","Total",69,25,25,19,12,1,10,1,57,24,15,18
"2011","Fenland 007B","E01018078","Total",68,20,13,35,15,0,9,6,53,20,4,29
"2011","Fenland 007C","E01018079","Total",40,13,10,17,4,0,3,1,36,13,7,16
"2011","Fenland 007D","E01018080","Total",74,22,25,27,6,0,5,1,68,22,20,26
"2011","Fenland 008A","E01018058","Total",45,17,14,14,7,1,3,3,38,16,11,11
"2011","Fenland 008B","E01018059","Total",24,11,6,7,3,0,3,0,21,11,3,7
"2011","Fenland 008C","E01018060","Total",45,14,9,22,6,1,1,4,39,13,8,18
"2011","Fenland 008D","E01018061","Total",34,16,11,7,3,0,3,0,31,16,8,7
"2011","Fenland 009A","E01018085","Total",37,15,12,10,3,1,1,1,34,14,11,9
"2011","Fenland 009B","E01018086","Total",44,14,14,16,2,0,2,0,42,14,12,16
"2011","Fenland 009C","E01018087","Total",49,16,12,21,3,0,2,1,46,16,10,20
"2011","Fenland 009D","E01018088","Total",29,9,10,10,4,1,2,1,25,8,8,9
"2011","Fenland 010A","E01018065","Total",43,14,20,9,2,0,0,2,41,14,20,7
"2011","Fenland 010B","E01018076","Total",46,25,9,12,9,4,3,2,37,21,6,10
"2011","Fenland 010C","E01018111","Total",46,13,13,20,8,2,5,1,38,11,8,19
"2011","Fenland 011A","E01018062","Total",57,19,19,19,5,1,1,3,52,18,18,16
"2011","Fenland 011B","E01018102","Total",97,30,25,42,11,0,5,6,86,30,20,36
"2011","Fenland 011C","E01018105","Total",43,17,16,10,5,1,2,2,38,16,14,8
"2011","Fenland 011D","E01018106","Total",38,12,12,14,5,0,3,2,33,12,9,12
"2011","Fenland 011E","E01018110","Total",64,11,24,29,11,1,7,3,53,10,17,26
"2011","Huntingdonshire 001A","E01018212","Total",42,11,13,18,4,1,2,1,38,10,11,17
"2011","Huntingdonshire 001B","E01018213","Total",55,17,11,27,6,1,4,1,49,16,7,26
"2011","Huntingdonshire 001C","E01018214","Total",65,24,18,23,4,1,2,1,61,23,16,22
"2011","Huntingdonshire 001D","E01018215","Total",35,19,9,7,4,0,4,0,31,19,5,7
"2011","Huntingdonshire 001E","E01018216","Total",43,13,18,12,8,1,6,1,35,12,12,11
"2011","Huntingdonshire 001F","E01018217","Total",32,14,14,4,6,0,5,1,26,14,9,3
"2011","Huntingdonshire 002A","E01018127","Total",26,7,12,7,6,1,3,2,20,6,9,5
"2011","Huntingdonshire 002B","E01018128","Total",28,9,14,5,4,0,3,1,24,9,11,4
"2011","Huntingdonshire 002C","E01018200","Total",31,14,13,4,8,1,7,0,23,13,6,4
"2011","Huntingdonshire 002D","E01018201","Total",42,19,15,8,4,0,3,1,38,19,12,7
"2011","Huntingdonshire 003A","E01018156","Total",24,8,8,8,6,2,4,0,18,6,4,8
"2011","Huntingdonshire 003B","E01018157","Total",33,9,9,15,8,2,4,2,25,7,5,13
"2011","Huntingdonshire 003C","E01018158","Total",47,12,21,14,7,0,3,4,40,12,18,10
"2011","Huntingdonshire 003D","E01018159","Total",24,6,8,10,2,1,1,0,22,5,7,10
"2011","Huntingdonshire 003E","E01018160","Total",50,20,10,20,5,1,3,1,45,19,7,19
"2011","Huntingdonshire 004A","E01018191","Total",37,16,16,5,6,0,5,1,31,16,11,4
"2011","Huntingdonshire 004B","E01018192","Total",17,8,4,5,2,1,1,0,15,7,3,5
"2011","Huntingdonshire 004C","E01018193","Total",21,8,12,1,0,0,0,0,21,8,12,1
"2011","Huntingdonshire 004D","E01018194","Total",28,12,9,7,4,0,3,1,24,12,6,6
"2011","Huntingdonshire 004E","E01018195","Total",38,9,12,17,3,0,2,1,35,9,10,16
"2011","Huntingdonshire 005A","E01018208","Total",37,9,10,18,1,0,1,0,36,9,9,18
"2011","Huntingdonshire 005B","E01018209","Total",22,3,7,12,4,0,1,3,18,3,6,9
"2011","Huntingdonshire 005C","E01018210","Total",32,10,8,14,2,0,2,0,30,10,6,14
"2011","Huntingdonshire 005D","E01018211","Total",35,16,16,3,3,0,3,0,32,16,13,3
"2011","Huntingdonshire 006A","E01018196","Total",15,6,5,4,2,0,2,0,13,6,3,4
"2011","Huntingdonshire 006B","E01018197","Total",43,18,15,10,8,1,5,2,35,17,10,8
"2011","Huntingdonshire 006C","E01018198","Total",22,12,4,6,0,0,0,0,22,12,4,6
"2011","Huntingdonshire 006D","E01018199","Total",18,4,7,7,2,0,1,1,16,4,6,6
"2011","Huntingdonshire 006E","E01018206","Total",52,16,25,11,6,1,5,0,46,15,20,11
"2011","Huntingdonshire 006F","E01018207","Total",37,12,12,13,1,0,1,0,36,12,11,13
"2011","Huntingdonshire 007A","E01018121","Total",15,8,4,3,1,1,0,0,14,7,4,3
"2011","Huntingdonshire 007B","E01018122","Total",16,5,8,3,4,0,4,0,12,5,4,3
"2011","Huntingdonshire 007C","E01018123","Total",19,6,8,5,2,0,2,0,17,6,6,5
"2011","Huntingdonshire 007D","E01018124","Total",31,12,10,9,5,2,3,0,26,10,7,9
"2011","Huntingdonshire 008A","E01018143","Total",50,17,15,18,3,0,1,2,47,17,14,16
"2011","Huntingdonshire 008B","E01018144","Total",72,20,11,41,9,0,5,4,63,20,6,37
"2011","Huntingdonshire 008C","E01018145","Total",56,16,10,30,1,0,0,1,55,16,10,29
"2011","Huntingdonshire 008D","E01018146","Total",78,21,17,40,10,0,4,6,68,21,13,34
"2011","Huntingdonshire 008E","E01018147","Total",59,14,13,32,3,2,1,0,56,12,12,32
"2011","Huntingdonshire 009A","E01018139","Total",41,14,13,14,3,1,1,1,38,13,12,13
"2011","Huntingdonshire 009B","E01018140","Total",17,4,7,6,1,1,0,0,16,3,7,6
"2011","Huntingdonshire 009C","E01018141","Total",20,8,8,4,5,0,4,1,15,8,4,3
"2011","Huntingdonshire 009D","E01018142","Total",41,13,10,18,6,3,2,1,35,10,8,17
"2011","Huntingdonshire 010B","E01018113","Total",23,10,4,9,2,1,0,1,21,9,4,8
"2011","Huntingdonshire 010D","E01018116","Total",12,3,9,0,2,0,2,0,10,3,7,0
"2011","Huntingdonshire 010E","E01018117","Total",24,10,7,7,4,0,3,1,20,10,4,6
"2011","Huntingdonshire 010F","E01018118","Total",46,19,21,6,2,1,1,0,44,18,20,6
"2011","Huntingdonshire 010G","E01033433","Total",22,7,5,10,1,0,0,1,21,7,5,9
"2011","Huntingdonshire 011A","E01018161","Total",42,11,26,5,6,0,5,1,36,11,21,4
"2011","Huntingdonshire 011B","E01018162","Total",41,10,11,20,3,0,3,0,38,10,8,20
"2011","Huntingdonshire 011C","E01018163","Total",63,26,15,22,5,0,4,1,58,26,11,21
"2011","Huntingdonshire 011D","E01018164","Total",24,10,8,6,2,0,2,0,22,10,6,6
"2011","Huntingdonshire 011E","E01018165","Total",34,16,12,6,4,0,3,1,30,16,9,5
"2011","Huntingdonshire 011F","E01018170","Total",24,10,7,7,0,0,0,0,24,10,7,7
"2011","Huntingdonshire 011G","E01018171","Total",22,9,6,7,3,0,2,1,19,9,4,6
"2011","Huntingdonshire 012A","E01018138","Total",40,15,17,8,3,0,2,1,37,15,15,7
"2011","Huntingdonshire 012B","E01018148","Total",82,29,33,20,4,1,3,0,78,28,30,20
"2011","Huntingdonshire 012C","E01018149","Total",33,13,14,6,3,0,3,0,30,13,11,6
"2011","Huntingdonshire 012D","E01018150","Total",51,16,21,14,5,1,4,0,46,15,17,14
"2011","Huntingdonshire 012E","E01018151","Total",38,11,17,10,2,0,2,0,36,11,15,10
"2011","Huntingdonshire 013A","E01018166","Total",27,6,11,10,5,0,3,2,22,6,8,8
"2011","Huntingdonshire 013B","E01018167","Total",27,9,15,3,6,1,4,1,21,8,11,2
"2011","Huntingdonshire 013C","E01018168","Total",38,12,16,10,8,2,5,1,30,10,11,9
"2011","Huntingdonshire 013D","E01018169","Total",41,8,13,20,0,0,0,0,41,8,13,20
"2011","Huntingdonshire 014A","E01018131","Total",35,12,10,13,11,2,5,4,24,10,5,9
"2011","Huntingdonshire 014B","E01018132","Total",17,6,8,3,4,2,2,0,13,4,6,3
"2011","Huntingdonshire 014C","E01018133","Total",25,9,10,6,4,0,3,1,21,9,7,5
"2011","Huntingdonshire 014D","E01018134","Total",47,9,23,15,4,0,2,2,43,9,21,13
"2011","Huntingdonshire 015A","E01018125","Total",19,3,10,6,6,0,3,3,13,3,7,3
"2011","Huntingdonshire 015B","E01018126","Total",23,5,9,9,1,0,1,0,22,5,8,9
"2011","Huntingdonshire 015C","E01018152","Total",20,6,6,8,1,0,1,0,19,6,5,8
"2011","Huntingdonshire 015D","E01018153","Total",33,16,5,12,6,3,2,1,27,13,3,11
"2011","Huntingdonshire 016A","E01018129","Total",31,9,14,8,5,1,3,1,26,8,11,7
"2011","Huntingdonshire 016B","E01018130","Total",35,11,17,7,2,1,1,0,33,10,16,7
"2011","Huntingdonshire 016C","E01018202","Total",17,9,7,1,4,0,4,0,13,9,3,1
"2011","Huntingdonshire 016D","E01018203","Total",16,7,7,2,1,0,1,0,15,7,6,2
"2011","Huntingdonshire 016E","E01018204","Total",24,9,10,5,0,0,0,0,24,9,10,5
"2011","Huntingdonshire 016F","E01018205","Total",31,10,18,3,3,0,3,0,28,10,15,3
"2011","Huntingdonshire 017A","E01018115","Total",14,6,8,0,1,0,1,0,13,6,7,0
"2011","Huntingdonshire 017B","E01018119","Total",29,11,10,8,8,2,5,1,21,9,5,7
"2011","Huntingdonshire 017C","E01018120","Total",44,16,17,11,0,0,0,0,44,16,17,11
"2011","Huntingdonshire 017D","E01018137","Total",32,11,10,11,4,1,2,1,28,10,8,10
"2011","Huntingdonshire 018A","E01018135","Total",101,31,24,46,10,0,8,2,91,31,16,44
"2011","Huntingdonshire 018B","E01018136","Total",21,10,9,2,3,0,2,1,18,10,7,1
"2011","Huntingdonshire 018C","E01018154","Total",34,19,7,8,2,1,1,0,32,18,6,8
"2011","Huntingdonshire 018D","E01018155","Total",14,6,6,2,4,1,3,0,10,5,3,2
"2011","Huntingdonshire 019A","E01018187","Total",54,23,11,20,4,0,3,1,50,23,8,19
"2011","Huntingdonshire 019B","E01018188","Total",37,13,16,8,5,0,2,3,32,13,14,5
"2011","Huntingdonshire 019C","E01018189","Total",8,5,2,1,0,0,0,0,8,5,2,1
"2011","Huntingdonshire 019D","E01018190","Total",29,9,8,12,1,0,1,0,28,9,7,12
"2011","Huntingdonshire 020A","E01018172","Total",24,10,14,0,4,1,3,0,20,9,11,0
"2011","Huntingdonshire 020B","E01018173","Total",28,15,5,8,1,0,1,0,27,15,4,8
"2011","Huntingdonshire 020C","E01018174","Total",32,10,8,14,2,0,2,0,30,10,6,14
"2011","Huntingdonshire 020D","E01018175","Total",17,6,8,3,4,0,3,1,13,6,5,2
"2011","Huntingdonshire 020E","E01018176","Total",15,10,5,0,0,0,0,0,15,10,5,0
"2011","Huntingdonshire 021A","E01018181","Total",53,26,14,13,9,2,7,0,44,24,7,13
"2011","Huntingdonshire 021B","E01018182","Total",35,10,12,13,3,0,2,1,32,10,10,12
"2011","Huntingdonshire 021C","E01018183","Total",67,28,12,27,3,0,1,2,64,28,11,25
"2011","Huntingdonshire 021D","E01018184","Total",62,16,24,22,8,0,6,2,54,16,18,20
"2011","Huntingdonshire 021E","E01018185","Total",37,14,13,10,6,0,5,1,31,14,8,9
"2011","Huntingdonshire 021F","E01018186","Total",48,20,16,12,5,0,3,2,43,20,13,10
"2011","Huntingdonshire 022A","E01018177","Total",13,5,7,1,4,0,3,1,9,5,4,0
"2011","Huntingdonshire 022B","E01018178","Total",28,13,10,5,5,1,2,2,23,12,8,3
"2011","Huntingdonshire 022C","E01018179","Total",50,22,10,18,4,1,1,2,46,21,9,16
"2011","Huntingdonshire 022D","E01018180","Total",74,24,14,36,4,0,2,2,70,24,12,34
"2011","South Cambridgeshire 001A","E01018304","Total",45,23,10,12,5,0,3,2,40,23,7,10
"2011","South Cambridgeshire 001B","E01018305","Total",15,10,3,2,0,0,0,0,15,10,3,2
"2011","South Cambridgeshire 001C","E01018306","Total",22,7,11,4,0,0,0,0,22,7,11,4
"2011","South Cambridgeshire 001D","E01018307","Total",23,7,11,5,4,1,3,0,19,6,8,5
"2011","South Cambridgeshire 002A","E01018233","Total",21,8,10,3,4,2,2,0,17,6,8,3
"2011","South Cambridgeshire 002B","E01018234","Total",24,6,11,7,1,0,1,0,23,6,10,7
"2011","South Cambridgeshire 002C","E01018235","Total",33,6,23,4,7,0,7,0,26,6,16,4
"2011","South Cambridgeshire 002D","E01018236","Total",42,20,11,11,3,2,1,0,39,18,10,11
"2011","South Cambridgeshire 003A","E01018237","Total",28,12,6,10,4,3,0,1,24,9,6,9
"2011","South Cambridgeshire 003B","E01018266","Total",53,15,27,11,7,1,5,1,46,14,22,10
"2011","South Cambridgeshire 003C","E01018284","Total",17,9,6,2,3,2,1,0,14,7,5,2
"2011","South Cambridgeshire 003D","E01018285","Total",25,10,9,6,2,0,1,1,23,10,8,5
"2011","South Cambridgeshire 004A","E01018298","Total",19,1,13,5,4,0,4,0,15,1,9,5
"2011","South Cambridgeshire 004B","E01018299","Total",32,13,8,11,1,0,1,0,31,13,7,11
"2011","South Cambridgeshire 004C","E01018300","Total",13,6,5,2,2,0,2,0,11,6,3,2
"2011","South Cambridgeshire 004D","E01018301","Total",13,5,8,0,2,0,2,0,11,5,6,0
"2011","South Cambridgeshire 005A","E01018221","Total",28,11,13,4,5,1,4,0,23,10,9,4
"2011","South Cambridgeshire 005B","E01018222","Total",18,3,12,3,6,0,5,1,12,3,7,2
"2011","South Cambridgeshire 005C","E01018223","Total",43,17,16,10,7,0,6,1,36,17,10,9
"2011","South Cambridgeshire 006A","E01018257","Total",25,8,7,10,1,0,1,0,24,8,6,10
"2011","South Cambridgeshire 006B","E01018258","Total",25,12,9,4,0,0,0,0,25,12,9,4
"2011","South Cambridgeshire 006C","E01018259","Total",27,13,8,6,9,1,3,5,18,12,5,1
"2011","South Cambridgeshire 006D","E01018260","Total",17,3,7,7,1,0,1,0,16,3,6,7
"2011","South Cambridgeshire 006F","E01018262","Total",21,10,10,1,4,1,3,0,17,9,7,1
"2011","South Cambridgeshire 006G","E01033120","Total",52,17,14,21,5,3,0,2,47,14,14,19
"2011","South Cambridgeshire 006H","E01033121","Total",57,13,13,31,4,1,1,2,53,12,12,29
"2011","South Cambridgeshire 007A","E01018272","Total",16,6,6,4,1,0,1,0,15,6,5,4
"2011","South Cambridgeshire 007B","E01018273","Total",27,14,4,9,0,0,0,0,27,14,4,9
"2011","South Cambridgeshire 007C","E01018274","Total",21,7,5,9,3,0,2,1,18,7,3,8
"2011","South Cambridgeshire 007D","E01018297","Total",32,14,12,6,3,1,2,0,29,13,10,6
"2011","South Cambridgeshire 009A","E01018224","Total",22,14,4,4,0,0,0,0,22,14,4,4
"2011","South Cambridgeshire 009B","E01018225","Total",13,7,4,2,0,0,0,0,13,7,4,2
"2011","South Cambridgeshire 009C","E01018248","Total",29,10,16,3,4,0,4,0,25,10,12,3
"2011","South Cambridgeshire 009D","E01018249","Total",6,4,2,0,0,0,0,0,6,4,2,0
"2011","South Cambridgeshire 009E","E01018250","Total",11,5,4,2,0,0,0,0,11,5,4,2
"2011","South Cambridgeshire 010A","E01018231","Total",27,15,6,6,2,1,0,1,25,14,6,5
"2011","South Cambridgeshire 010B","E01018232","Total",50,16,26,8,6,0,4,2,44,16,22,6
"2011","South Cambridgeshire 010C","E01018251","Total",24,11,9,4,1,0,1,0,23,11,8,4
"2011","South Cambridgeshire 010D","E01018252","Total",28,8,14,6,3,0,2,1,25,8,12,5
"2011","South Cambridgeshire 010E","E01018255","Total",26,9,12,5,6,1,5,0,20,8,7,5
"2011","South Cambridgeshire 011A","E01018242","Total",26,8,12,6,3,0,3,0,23,8,9,6
"2011","South Cambridgeshire 011B","E01018243","Total",37,13,18,6,4,0,3,1,33,13,15,5
"2011","South Cambridgeshire 011C","E01018244","Total",15,7,4,4,3,0,1,2,12,7,3,2
"2011","South Cambridgeshire 011D","E01018286","Total",35,14,12,9,7,1,5,1,28,13,7,8
"2011","South Cambridgeshire 011E","E01018287","Total",21,3,11,7,2,0,2,0,19,3,9,7
"2011","South Cambridgeshire 011F","E01018296","Total",12,3,5,4,3,0,2,1,9,3,3,3
"2011","South Cambridgeshire 012A","E01018292","Total",20,6,10,4,1,0,1,0,19,6,9,4
"2011","South Cambridgeshire 012B","E01018293","Total",23,7,10,6,2,1,0,1,21,6,10,5
"2011","South Cambridgeshire 012C","E01018294","Total",39,15,14,10,3,1,2,0,36,14,12,10
"2011","South Cambridgeshire 012D","E01018295","Total",23,7,9,7,4,1,3,0,19,6,6,7
"2011","South Cambridgeshire 013A","E01018245","Total",23,10,8,5,1,0,1,0,22,10,7,5
"2011","South Cambridgeshire 013B","E01018246","Total",40,13,18,9,8,2,6,0,32,11,12,9
"2011","South Cambridgeshire 013C","E01018247","Total",24,8,11,5,3,1,2,0,21,7,9,5
"2011","South Cambridgeshire 013D","E01018275","Total",36,20,8,8,4,0,1,3,32,20,7,5
"2011","South Cambridgeshire 014A","E01018240","Total",16,7,5,4,1,0,1,0,15,7,4,4
"2011","South Cambridgeshire 014B","E01018253","Total",15,6,5,4,1,0,1,0,14,6,4,4
"2011","South Cambridgeshire 014C","E01018254","Total",20,6,8,6,3,0,2,1,17,6,6,5
"2011","South Cambridgeshire 014D","E01018256","Total",18,5,7,6,2,1,0,1,16,4,7,5
"2011","South Cambridgeshire 014E","E01018291","Total",13,5,5,3,2,0,1,1,11,5,4,2
"2011","South Cambridgeshire 015A","E01018279","Total",29,13,6,10,0,0,0,0,29,13,6,10
"2011","South Cambridgeshire 015B","E01018280","Total",28,15,5,8,3,1,2,0,25,14,3,8
"2011","South Cambridgeshire 015C","E01018281","Total",28,13,5,10,2,0,0,2,26,13,5,8
"2011","South Cambridgeshire 015D","E01018282","Total",19,12,6,1,3,1,2,0,16,11,4,1
"2011","South Cambridgeshire 015E","E01018283","Total",22,8,11,3,6,0,5,1,16,8,6,2
"2011","South Cambridgeshire 016A","E01018218","Total",17,6,8,3,4,0,4,0,13,6,4,3
"2011","South Cambridgeshire 016B","E01018219","Total",24,12,8,4,3,1,2,0,21,11,6,4
"2011","South Cambridgeshire 016C","E01018220","Total",21,7,8,6,0,0,0,0,21,7,8,6
"2011","South Cambridgeshire 016D","E01018263","Total",18,5,8,5,2,1,1,0,16,4,7,5
"2011","South Cambridgeshire 016E","E01018264","Total",46,15,20,11,6,1,5,0,40,14,15,11
"2011","South Cambridgeshire 016F","E01018265","Total",20,8,11,1,4,1,3,0,16,7,8,1
"2011","South Cambridgeshire 017A","E01018238","Total",31,10,10,11,5,1,4,0,26,9,6,11
"2011","South Cambridgeshire 017B","E01018239","Total",18,5,8,5,0,0,0,0,18,5,8,5
"2011","South Cambridgeshire 017C","E01018288","Total",20,5,10,5,2,0,1,1,18,5,9,4
"2011","South Cambridgeshire 017D","E01018289","Total",12,3,8,1,4,1,3,0,8,2,5,1
"2011","South Cambridgeshire 017E","E01018302","Total",15,7,5,3,3,2,1,0,12,5,4,3
"2011","South Cambridgeshire 017F","E01018303","Total",17,8,4,5,4,1,2,1,13,7,2,4
"2011","South Cambridgeshire 018A","E01018241","Total",12,8,4,0,1,0,1,0,11,8,3,0
"2011","South Cambridgeshire 018B","E01018267","Total",25,7,14,4,6,0,6,0,19,7,8,4
"2011","South Cambridgeshire 018C","E01018268","Total",39,14,19,6,5,1,4,0,34,13,15,6
"2011","South Cambridgeshire 018D","E01018269","Total",41,17,11,13,5,1,4,0,36,16,7,13
"2011","South Cambridgeshire 018E","E01018270","Total",18,6,9,3,3,2,1,0,15,4,8,3
"2011","South Cambridgeshire 018F","E01018271","Total",24,11,9,4,3,1,2,0,21,10,7,4
"2011","South Cambridgeshire 019A","E01018226","Total",21,6,12,3,8,1,7,0,13,5,5,3
"2011","South Cambridgeshire 019B","E01018227","Total",59,26,16,17,5,0,4,1,54,26,12,16
"2011","South Cambridgeshire 019C","E01018228","Total",22,10,6,6,4,2,1,1,18,8,5,5
"2011","South Cambridgeshire 019D","E01018290","Total",43,16,19,8,6,0,6,0,37,16,13,8
"2011","South Cambridgeshire 020A","E01033113","Total",47,12,17,18,4,0,4,0,43,12,13,18
"2011","South Cambridgeshire 020B","E01033114","Total",35,7,15,13,5,0,5,0,30,7,10,13
"2011","South Cambridgeshire 020C","E01033115","Total",35,17,8,10,2,1,1,0,33,16,7,10
"2011","South Cambridgeshire 020D","E01033117","Total",39,13,14,12,5,2,3,0,34,11,11,12
"2011","South Cambridgeshire 020E","E01033119","Total",45,10,18,17,6,0,6,0,39,10,12,17
"2011","South Cambridgeshire 021A","E01018276","Total",22,5,10,7,1,0,1,0,21,5,9,7
"2011","South Cambridgeshire 021B","E01018277","Total",16,3,11,2,1,0,1,0,15,3,10,2
"2011","South Cambridgeshire 021C","E01018278","Total",20,9,8,3,2,0,2,0,18,9,6,3
"2011","South Cambridgeshire 021D","E01033116","Total",25,10,6,9,3,1,0,2,22,9,6,7
"2011","South Cambridgeshire 021E","E01033118","Total",29,9,15,5,4,0,4,0,25,9,11,5
"2011","Basildon 001A","E01021237","Total",9,3,2,4,0,0,0,0,9,3,2,4
"2011","Basildon 001B","E01021238","Total",30,15,10,5,2,0,2,0,28,15,8,5
"2011","Basildon 001C","E01021242","Total",23,6,13,4,5,0,5,0,18,6,8,4
"2011","Basildon 001D","E01021250","Total",18,7,10,1,2,1,1,0,16,6,9,1
"2011","Basildon 001E","E01021251","Total",20,10,6,4,2,0,2,0,18,10,4,4
"2011","Basildon 002A","E01021245","Total",57,27,10,20,4,1,1,2,53,26,9,18
"2011","Basildon 002B","E01021246","Total",19,6,9,4,0,0,0,0,19,6,9,4
"2011","Basildon 002C","E01021248","Total",48,23,15,10,4,1,3,0,44,22,12,10
"2011","Basildon 002D","E01021249","Total",23,12,7,4,2,0,2,0,21,12,5,4
"2011","Basildon 002E","E01021252","Total",28,14,9,5,3,0,3,0,25,14,6,5
"2011","Basildon 003A","E01021239","Total",10,5,1,4,0,0,0,0,10,5,1,4
"2011","Basildon 003B","E01021240","Total",32,16,6,10,5,1,2,2,27,15,4,8
"2011","Basildon 003C","E01021241","Total",57,27,14,16,2,0,2,0,55,27,12,16
"2011","Basildon 003D","E01021243","Total",27,8,14,5,3,0,3,0,24,8,11,5
"2011","Basildon 003E","E01021247","Total",16,6,7,3,7,1,5,1,9,5,2,2
"2011","Basildon 004A","E01021244","Total",22,6,10,6,5,0,4,1,17,6,6,5
"2011","Basildon 004B","E01021253","Total",18,4,7,7,3,0,2,1,15,4,5,6
"2011","Basildon 004C","E01021255","Total",20,12,3,5,1,0,0,1,19,12,3,4
"2011","Basildon 004D","E01021256","Total",10,5,3,2,1,0,1,0,9,5,2,2
"2011","Basildon 004E","E01021258","Total",46,21,13,12,4,0,3,1,42,21,10,11
"2011","Basildon 005A","E01021334","Total",32,12,9,11,3,0,2,1,29,12,7,10
"2011","Basildon 005B","E01021336","Total",25,10,5,10,1,1,0,0,24,9,5,10
"2011","Basildon 005C","E01021338","Total",49,11,9,29,2,1,0,1,47,10,9,28
"2011","Basildon 005D","E01021339","Total",44,12,9,23,3,0,2,1,41,12,7,22
"2011","Basildon 006A","E01021264","Total",15,3,3,9,3,0,2,1,12,3,1,8
"2011","Basildon 006B","E01021329","Total",26,14,6,6,0,0,0,0,26,14,6,6
"2011","Basildon 006C","E01021330","Total",29,10,14,5,7,0,7,0,22,10,7,5
"2011","Basildon 006D","E01021332","Total",20,7,10,3,1,0,1,0,19,7,9,3
"2011","Basildon 006E","E01021333","Total",12,3,8,1,1,0,1,0,11,3,7,1
"2011","Basildon 007A","E01021335","Total",36,21,8,7,1,0,1,0,35,21,7,7
"2011","Basildon 007B","E01021337","Total",12,6,5,1,1,0,1,0,11,6,4,1
"2011","Basildon 007C","E01021340","Total",33,18,10,5,4,1,3,0,29,17,7,5
"2011","Basildon 007D","E01021341","Total",28,9,9,10,3,0,3,0,25,9,6,10
"2011","Basildon 007E","E01021345","Total",42,14,17,11,4,1,2,1,38,13,15,10
"2011","Basildon 008A","E01021331","Total",27,6,13,8,5,0,4,1,22,6,9,7
"2011","Basildon 008B","E01021342","Total",43,15,10,18,1,0,1,0,42,15,9,18
"2011","Basildon 008C","E01021343","Total",72,19,23,30,1,0,1,0,71,19,22,30
"2011","Basildon 008D","E01021344","Total",63,22,23,18,8,0,7,1,55,22,16,17
"2011","Basildon 008E","E01021346","Total",40,17,15,8,5,2,3,0,35,15,12,8
"2011","Basildon 009A","E01021254","Total",7,2,4,1,0,0,0,0,7,2,4,1
"2011","Basildon 009B","E01021257","Total",31,13,12,6,5,0,5,0,26,13,7,6
"2011","Basildon 009C","E01021259","Total",33,13,9,11,5,0,4,1,28,13,5,10
"2011","Basildon 009D","E01021260","Total",21,8,8,5,2,0,1,1,19,8,7,4
"2011","Basildon 010A","E01021261","Total",40,8,11,21,3,0,1,2,37,8,10,19
"2011","Basildon 010B","E01021262","Total",50,18,18,14,4,0,3,1,46,18,15,13
"2011","Basildon 010C","E01021263","Total",71,27,24,20,3,0,1,2,68,27,23,18
"2011","Basildon 010D","E01021274","Total",54,13,18,23,9,0,4,5,45,13,14,18
"2011","Basildon 010E","E01021279","Total",84,25,15,44,6,0,4,2,78,25,11,42
"2011","Basildon 011A","E01021301","Total",84,20,14,50,11,3,3,5,73,17,11,45
"2011","Basildon 011B","E01021303","Total",41,10,8,23,3,1,1,1,38,9,7,22
"2011","Basildon 011C","E01021307","Total",67,23,16,28,4,1,2,1,63,22,14,27
"2011","Basildon 011D","E01021308","Total",19,8,5,6,3,0,2,1,16,8,3,5
"2011","Basildon 011E","E01021309","Total",65,18,20,27,8,1,5,2,57,17,15,25
"2011","Basildon 011F","E01021312","Total",29,10,8,11,4,2,2,0,25,8,6,11
"2011","Basildon 012A","E01021265","Total",53,17,11,25,3,0,1,2,50,17,10,23
"2011","Basildon 012B","E01021267","Total",52,13,7,32,4,0,1,3,48,13,6,29
"2011","Basildon 012C","E01021269","Total",65,21,18,26,7,1,3,3,58,20,15,23
"2011","Basildon 012D","E01021270","Total",57,11,22,24,6,1,3,2,51,10,19,22
"2011","Basildon 012E","E01021272","Total",76,22,17,37,6,0,5,1,70,22,12,36
"2011","Basildon 013A","E01021271","Total",110,33,23,54,7,2,5,0,103,31,18,54
"2011","Basildon 013B","E01021302","Total",103,26,11,66,8,0,1,7,95,26,10,59
"2011","Basildon 013C","E01021304","Total",68,13,12,43,3,0,2,1,65,13,10,42
"2011","Basildon 013D","E01021305","Total",67,17,17,33,6,0,5,1,61,17,12,32
"2011","Basildon 013E","E01021306","Total",55,16,7,32,4,0,1,3,51,16,6,29
"2011","Basildon 014A","E01021273","Total",57,12,16,29,8,0,4,4,49,12,12,25
"2011","Basildon 014B","E01021275","Total",38,18,5,15,2,0,0,2,36,18,5,13
"2011","Basildon 014C","E01021276","Total",44,13,11,20,8,0,6,2,36,13,5,18
"2011","Basildon 014D","E01021277","Total",47,16,8,23,6,0,0,6,41,16,8,17
"2011","Basildon 014E","E01021278","Total",78,25,20,33,12,0,5,7,66,25,15,26
"2011","Basildon 015A","E01021266","Total",59,16,11,32,3,0,3,0,56,16,8,32
"2011","Basildon 015B","E01021268","Total",65,17,10,38,4,0,1,3,61,17,9,35
"2011","Basildon 015C","E01021318","Total",95,24,20,51,10,2,7,1,85,22,13,50
"2011","Basildon 015D","E01021320","Total",62,23,13,26,3,1,0,2,59,22,13,24
"2011","Basildon 015E","E01021321","Total",65,21,14,30,4,2,0,2,61,19,14,28
"2011","Basildon 016A","E01021286","Total",94,19,25,50,8,1,2,5,86,18,23,45
"2011","Basildon 016B","E01021288","Total",171,41,22,108,6,1,3,2,165,40,19,106
"2011","Basildon 016C","E01021289","Total",95,31,19,45,6,2,1,3,89,29,18,42
"2011","Basildon 016D","E01021290","Total",174,39,19,116,15,1,3,11,159,38,16,105
"2011","Basildon 016E","E01021291","Total",59,14,9,36,9,1,4,4,50,13,5,32
"2011","Basildon 017A","E01021287","Total",50,13,12,25,8,1,2,5,42,12,10,20
"2011","Basildon 017B","E01021292","Total",58,14,17,27,6,0,4,2,52,14,13,25
"2011","Basildon 017C","E01021293","Total",55,23,10,22,2,1,1,0,53,22,9,22
"2011","Basildon 017D","E01021298","Total",66,26,11,29,5,1,2,2,61,25,9,27
"2011","Basildon 017E","E01021319","Total",69,20,17,32,3,1,1,1,66,19,16,31
"2011","Basildon 018A","E01021313","Total",21,4,7,10,4,0,3,1,17,4,4,9
"2011","Basildon 018B","E01021314","Total",61,22,7,32,5,2,1,2,56,20,6,30
"2011","Basildon 018C","E01021315","Total",61,20,10,31,5,1,2,2,56,19,8,29
"2011","Basildon 018D","E01021316","Total",73,26,11,36,6,0,2,4,67,26,9,32
"2011","Basildon 018E","E01021317","Total",78,22,12,44,7,1,3,3,71,21,9,41
"2011","Basildon 019A","E01021322","Total",64,26,7,31,3,0,1,2,61,26,6,29
"2011","Basildon 019B","E01021323","Total",119,32,18,69,12,2,5,5,107,30,13,64
"2011","Basildon 019C","E01021324","Total",110,27,20,63,8,0,3,5,102,27,17,58
"2011","Basildon 019D","E01021325","Total",105,27,12,66,5,1,2,2,100,26,10,64
"2011","Basildon 019E","E01021327","Total",81,25,15,41,8,1,4,3,73,24,11,38
"2011","Basildon 020A","E01021294","Total",46,18,15,13,5,0,2,3,41,18,13,10
"2011","Basildon 020B","E01021295","Total",59,18,9,32,9,1,6,2,50,17,3,30
"2011","Basildon 020C","E01021296","Total",69,29,19,21,12,1,9,2,57,28,10,19
"2011","Basildon 020D","E01021297","Total",65,16,18,31,5,0,3,2,60,16,15,29
"2011","Basildon 020E","E01021299","Total",11,4,7,0,2,0,2,0,9,4,5,0
"2011","Basildon 021A","E01021280","Total",40,13,13,14,6,0,3,3,34,13,10,11
"2011","Basildon 021B","E01021281","Total",18,4,10,4,3,0,3,0,15,4,7,4
"2011","Basildon 021C","E01021282","Total",19,5,4,10,1,0,1,0,18,5,3,10
"2011","Basildon 021D","E01021283","Total",64,27,8,29,2,0,2,0,62,27,6,29
"2011","Basildon 021E","E01021284","Total",25,9,8,8,2,0,2,0,23,9,6,8
"2011","Basildon 021F","E01021285","Total",19,7,5,7,1,0,0,1,18,7,5,6
"2011","Basildon 022A","E01021300","Total",94,21,13,60,6,0,3,3,88,21,10,57
"2011","Basildon 022B","E01021310","Total",27,3,10,14,8,0,7,1,19,3,3,13
"2011","Basildon 022C","E01021311","Total",42,10,8,24,8,2,1,5,34,8,7,19
"2011","Basildon 022D","E01021326","Total",76,19,14,43,9,3,2,4,67,16,12,39
"2011","Basildon 022E","E01021328","Total",76,23,13,40,4,2,1,1,72,21,12,39
"2011","Braintree 001A","E01021375","Total",23,12,5,6,2,0,2,0,21,12,3,6
"2011","Braintree 001B","E01021376","Total",17,2,10,5,1,0,1,0,16,2,9,5
"2011","Braintree 001C","E01021414","Total",43,12,12,19,3,0,2,1,40,12,10,18
"2011","Braintree 001D","E01021430","Total",48,18,11,19,5,2,2,1,43,16,9,18
"2011","Braintree 002A","E01021398","Total",24,11,8,5,4,0,4,0,20,11,4,5
"2011","Braintree 002B","E01021406","Total",36,16,11,9,7,1,4,2,29,15,7,7
"2011","Braintree 002C","E01021407","Total",37,16,11,10,6,1,3,2,31,15,8,8
"2011","Braintree 003A","E01021382","Total",20,10,7,3,2,0,2,0,18,10,5,3
"2011","Braintree 003B","E01021397","Total",59,24,19,16,3,0,3,0,56,24,16,16
"2011","Braintree 003C","E01021399","Total",41,16,8,17,6,2,2,2,35,14,6,15
"2011","Braintree 003D","E01021400","Total",49,18,16,15,9,1,2,6,40,17,14,9
"2011","Braintree 004A","E01021387","Total",64,25,22,17,8,1,5,2,56,24,17,15
"2011","Braintree 004B","E01021388","Total",46,20,11,15,4,0,3,1,42,20,8,14
"2011","Braintree 004C","E01021391","Total",112,28,20,64,10,0,4,6,102,28,16,58
"2011","Braintree 004D","E01021392","Total",53,27,10,16,9,3,3,3,44,24,7,13
"2011","Braintree 004E","E01021393","Total",32,14,7,11,2,0,1,1,30,14,6,10
"2011","Braintree 005A","E01021404","Total",32,10,11,11,2,0,2,0,30,10,9,11
"2011","Braintree 005B","E01021411","Total",26,13,9,4,6,1,5,0,20,12,4,4
"2011","Braintree 005C","E01021412","Total",23,9,10,4,4,0,3,1,19,9,7,3
"2011","Braintree 005D","E01021413","Total",23,11,7,5,4,0,4,0,19,11,3,5
"2011","Braintree 006A","E01021389","Total",31,10,10,11,2,0,2,0,29,10,8,11
"2011","Braintree 006B","E01021390","Total",28,15,6,7,1,0,1,0,27,15,5,7
"2011","Braintree 006C","E01021408","Total",20,9,6,5,0,0,0,0,20,9,6,5
"2011","Braintree 006D","E01021409","Total",35,15,13,7,4,0,4,0,31,15,9,7
"2011","Braintree 006E","E01021410","Total",72,24,17,31,6,1,2,3,66,23,15,28
"2011","Braintree 007A","E01021349","Total",33,15,7,11,3,0,1,2,30,15,6,9
"2011","Braintree 007B","E01021351","Total",37,16,17,4,4,0,3,1,33,16,14,3
"2011","Braintree 007C","E01021352","Total",35,12,12,11,1,0,1,0,34,12,11,11
"2011","Braintree 007D","E01021355","Total",46,15,15,16,8,1,5,2,38,14,10,14
"2011","Braintree 007E","E01021356","Total",19,9,6,4,2,1,1,0,17,8,5,4
"2011","Braintree 007F","E01021381","Total",10,5,2,3,2,0,2,0,8,5,0,3
"2011","Braintree 008A","E01021354","Total",63,27,9,27,10,3,5,2,53,24,4,25
"2011","Braintree 008B","E01021357","Total",37,11,13,13,7,1,5,1,30,10,8,12
"2011","Braintree 008C","E01021358","Total",120,29,22,69,7,0,5,2,113,29,17,67
"2011","Braintree 008D","E01021359","Total",88,23,15,50,6,1,2,3,82,22,13,47
"2011","Braintree 009A","E01021350","Total",28,8,11,9,5,0,4,1,23,8,7,8
"2011","Braintree 009B","E01021353","Total",50,21,13,16,7,0,5,2,43,21,8,14
"2011","Braintree 009D","E01021365","Total",82,29,22,31,12,1,8,3,70,28,14,28
"2011","Braintree 009E","E01033458","Total",54,15,18,21,5,0,3,2,49,15,15,19
"2011","Braintree 009F","E01033459","Total",59,20,8,31,4,0,0,4,55,20,8,27
"2011","Braintree 010A","E01021364","Total",42,21,9,12,1,0,1,0,41,21,8,12
"2011","Braintree 010B","E01021366","Total",26,10,10,6,2,0,2,0,24,10,8,6
"2011","Braintree 010C","E01021383","Total",48,18,15,15,3,0,3,0,45,18,12,15
"2011","Braintree 010D","E01021405","Total",51,21,12,18,8,0,7,1,43,21,5,17
"2011","Braintree 011A","E01021368","Total",38,8,10,20,2,0,2,0,36,8,8,20
"2011","Braintree 011B","E01021370","Total",81,22,20,39,10,0,7,3,71,22,13,36
"2011","Braintree 011C","E01021372","Total",56,17,10,29,7,0,2,5,49,17,8,24
"2011","Braintree 011D","E01021373","Total",83,36,15,32,8,0,3,5,75,36,12,27
"2011","Braintree 011E","E01021374","Total",59,15,11,33,6,0,4,2,53,15,7,31
"2011","Braintree 012A","E01021360","Total",73,16,16,41,11,0,3,8,62,16,13,33
"2011","Braintree 012B","E01021361","Total",41,17,8,16,5,0,3,2,36,17,5,14
"2011","Braintree 012C","E01021367","Total",74,31,13,30,10,2,3,5,64,29,10,25
"2011","Braintree 012D","E01021369","Total",115,33,31,51,10,1,8,1,105,32,23,50
"2011","Braintree 012E","E01021380","Total",52,17,18,17,8,1,3,4,44,16,15,13
"2011","Braintree 013A","E01021347","Total",55,19,14,22,8,1,1,6,47,18,13,16
"2011","Braintree 013B","E01021371","Total",33,12,9,12,2,1,1,0,31,11,8,12
"2011","Braintree 013C","E01021384","Total",65,32,19,14,6,1,5,0,59,31,14,14
"2011","Braintree 013D","E01021385","Total",62,27,16,19,6,0,6,0,56,27,10,19
"2011","Braintree 013E","E01021386","Total",39,15,14,10,7,0,6,1,32,15,8,9
"2011","Braintree 014A","E01021377","Total",27,12,7,8,3,0,3,0,24,12,4,8
"2011","Braintree 014B","E01021378","Total",33,15,7,11,5,2,3,0,28,13,4,11
"2011","Braintree 014C","E01021379","Total",37,16,13,8,5,0,4,1,32,16,9,7
"2011","Braintree 014D","E01021401","Total",42,14,11,17,5,0,1,4,37,14,10,13
"2011","Braintree 014E","E01021402","Total",53,21,15,17,7,1,4,2,46,20,11,15
"2011","Braintree 014F","E01021403","Total",25,11,8,6,6,1,4,1,19,10,4,5
"2011","Braintree 015A","E01021362","Total",28,11,12,5,7,0,6,1,21,11,6,4
"2011","Braintree 015B","E01021417","Total",35,15,7,13,0,0,0,0,35,15,7,13
"2011","Braintree 015C","E01021418","Total",79,23,12,44,8,1,4,3,71,22,8,41
"2011","Braintree 015D","E01021419","Total",40,13,11,16,3,0,2,1,37,13,9,15
"2011","Braintree 015E","E01021426","Total",62,12,9,41,9,0,2,7,53,12,7,34
"2011","Braintree 015F","E01021428","Total",14,4,7,3,1,0,1,0,13,4,6,3
"2011","Braintree 016A","E01021423","Total",82,25,22,35,9,1,6,2,73,24,16,33
"2011","Braintree 016B","E01021425","Total",71,26,14,31,10,1,4,5,61,25,10,26
"2011","Braintree 016C","E01021427","Total",51,17,11,23,2,1,0,1,49,16,11,22
"2011","Braintree 016D","E01021429","Total",47,14,6,27,5,0,1,4,42,14,5,23
"2011","Braintree 017A","E01021415","Total",38,10,10,18,2,0,2,0,36,10,8,18
"2011","Braintree 017B","E01021416","Total",33,12,16,5,10,4,3,3,23,8,13,2
"2011","Braintree 017C","E01021420","Total",53,24,15,14,8,2,4,2,45,22,11,12
"2011","Braintree 017E","E01021422","Total",62,20,22,20,11,2,8,1,51,18,14,19
"2011","Braintree 017F","E01033460","Total",30,7,12,11,4,0,4,0,26,7,8,11
"2011","Braintree 017G","E01033461","Total",41,13,11,17,4,0,2,2,37,13,9,15
"2011","Braintree 017H","E01033462","Total",35,13,6,16,1,0,1,0,34,13,5,16
"2011","Braintree 018A","E01021348","Total",24,5,7,12,5,0,3,2,19,5,4,10
"2011","Braintree 018B","E01021394","Total",38,8,12,18,5,2,2,1,33,6,10,17
"2011","Braintree 018C","E01021395","Total",28,7,13,8,5,0,4,1,23,7,9,7
"2011","Braintree 018D","E01021396","Total",16,8,3,5,4,1,2,1,12,7,1,4
"2011","Braintree 018E","E01021424","Total",55,22,14,19,1,0,0,1,54,22,14,18
"2011","Brentwood 001A","E01021441","Total",42,17,10,15,3,2,1,0,39,15,9,15
"2011","Brentwood 001B","E01021442","Total",9,3,4,2,3,0,2,1,6,3,2,1
"2011","Brentwood 001C","E01021443","Total",28,7,8,13,5,0,4,1,23,7,4,12
"2011","Brentwood 001D","E01021444","Total",30,16,4,10,2,0,2,0,28,16,2,10
"2011","Brentwood 001E","E01021469","Total",14,9,2,3,1,0,1,0,13,9,1,3
"2011","Brentwood 001F","E01021470","Total",25,11,2,12,0,0,0,0,25,11,2,12
"2011","Brentwood 001G","E01021471","Total",16,6,6,4,1,0,1,0,15,6,5,4
"2011","Brentwood 002A","E01021457","Total",27,5,14,8,2,0,2,0,25,5,12,8
"2011","Brentwood 002B","E01021458","Total",30,12,8,10,1,0,1,0,29,12,7,10
"2011","Brentwood 002C","E01021459","Total",13,4,5,4,1,0,1,0,12,4,4,4
"2011","Brentwood 002D","E01021460","Total",39,17,10,12,1,0,1,0,38,17,9,12
"2011","Brentwood 003A","E01021448","Total",38,9,17,12,3,0,2,1,35,9,15,11
"2011","Brentwood 003B","E01021449","Total",41,19,10,12,0,0,0,0,41,19,10,12
"2011","Brentwood 003C","E01021450","Total",43,22,13,8,4,1,3,0,39,21,10,8
"2011","Brentwood 003D","E01021451","Total",96,32,30,34,16,1,8,7,80,31,22,27
"2011","Brentwood 003E","E01021452","Total",27,9,12,6,3,0,3,0,24,9,9,6
"2011","Brentwood 004A","E01021431","Total",35,12,14,9,5,0,3,2,30,12,11,7
"2011","Brentwood 004B","E01021432","Total",88,40,17,31,7,1,3,3,81,39,14,28
"2011","Brentwood 004C","E01021434","Total",41,18,14,9,3,0,1,2,38,18,13,7
"2011","Brentwood 004D","E01021461","Total",84,28,22,34,4,0,2,2,80,28,20,32
"2011","Brentwood 004E","E01021464","Total",27,14,8,5,1,0,1,0,26,14,7,5
"2011","Brentwood 005A","E01021447","Total",30,11,7,12,2,0,2,0,28,11,5,12
"2011","Brentwood 005B","E01021453","Total",19,4,9,6,1,0,1,0,18,4,8,6
"2011","Brentwood 005C","E01021455","Total",14,2,7,5,1,0,1,0,13,2,6,5
"2011","Brentwood 005D","E01021465","Total",18,9,7,2,0,0,0,0,18,9,7,2
"2011","Brentwood 005E","E01021466","Total",7,4,1,2,1,0,0,1,6,4,1,1
"2011","Brentwood 005F","E01021467","Total",17,7,7,3,2,0,2,0,15,7,5,3
"2011","Brentwood 006A","E01021438","Total",22,7,10,5,2,1,1,0,20,6,9,5
"2011","Brentwood 006B","E01021462","Total",25,13,7,5,4,3,1,0,21,10,6,5
"2011","Brentwood 006C","E01021463","Total",30,12,8,10,1,0,0,1,29,12,8,9
"2011","Brentwood 006D","E01021468","Total",25,10,8,7,4,1,2,1,21,9,6,6
"2011","Brentwood 007A","E01021433","Total",51,13,23,15,2,0,2,0,49,13,21,15
"2011","Brentwood 007B","E01021436","Total",46,10,22,14,3,0,1,2,43,10,21,12
"2011","Brentwood 007C","E01021439","Total",80,25,26,29,11,1,5,5,69,24,21,24
"2011","Brentwood 007E","E01021475","Total",39,15,16,8,3,0,3,0,36,15,13,8
"2011","Brentwood 007F","E01033063","Total",52,19,19,14,7,1,4,2,45,18,15,12
"2011","Brentwood 007G","E01033064","Total",48,18,11,19,7,1,1,5,41,17,10,14
"2011","Brentwood 008A","E01021435","Total",56,17,12,27,1,0,0,1,55,17,12,26
"2011","Brentwood 008B","E01021437","Total",95,33,21,41,2,0,1,1,93,33,20,40
"2011","Brentwood 008C","E01021472","Total",52,19,9,24,6,1,3,2,46,18,6,22
"2011","Brentwood 008D","E01021473","Total",21,7,10,4,3,0,3,0,18,7,7,4
"2011","Brentwood 008E","E01021474","Total",10,3,5,2,2,0,2,0,8,3,3,2
"2011","Brentwood 009A","E01021445","Total",30,17,8,5,0,0,0,0,30,17,8,5
"2011","Brentwood 009B","E01021446","Total",16,8,2,6,1,0,1,0,15,8,1,6
"2011","Brentwood 009C","E01021454","Total",32,12,12,8,1,0,1,0,31,12,11,8
"2011","Brentwood 009D","E01021456","Total",12,5,5,2,0,0,0,0,12,5,5,2
"2011","Castle Point 001A","E01021513","Total",25,12,6,7,0,0,0,0,25,12,6,7
"2011","Castle Point 001B","E01021514","Total",35,12,12,11,2,0,2,0,33,12,10,11
"2011","Castle Point 001C","E01021515","Total",28,13,4,11,1,0,1,0,27,13,3,11
"2011","Castle Point 001D","E01021525","Total",63,25,14,24,7,0,2,5,56,25,12,19
"2011","Castle Point 001E","E01021527","Total",33,18,8,7,4,0,4,0,29,18,4,7
"2011","Castle Point 002A","E01021509","Total",28,18,5,5,4,0,3,1,24,18,2,4
"2011","Castle Point 002B","E01021510","Total",34,16,8,10,3,0,2,1,31,16,6,9
"2011","Castle Point 002C","E01021511","Total",27,11,9,7,4,2,2,0,23,9,7,7
"2011","Castle Point 002D","E01021528","Total",21,5,9,7,6,1,5,0,15,4,4,7
"2011","Castle Point 002E","E01021531","Total",29,11,4,14,0,0,0,0,29,11,4,14
"2011","Castle Point 003A","E01021476","Total",33,13,7,13,4,0,3,1,29,13,4,12
"2011","Castle Point 003B","E01021477","Total",16,5,8,3,2,0,2,0,14,5,6,3
"2011","Castle Point 003C","E01021478","Total",31,15,13,3,2,0,2,0,29,15,11,3
"2011","Castle Point 003D","E01021516","Total",30,8,14,8,5,0,5,0,25,8,9,8
"2011","Castle Point 004A","E01021479","Total",23,13,4,6,1,0,1,0,22,13,3,6
"2011","Castle Point 004B","E01021481","Total",19,7,9,3,2,0,2,0,17,7,7,3
"2011","Castle Point 004C","E01021483","Total",26,10,9,7,5,1,4,0,21,9,5,7
"2011","Castle Point 004D","E01021512","Total",31,14,11,6,4,2,2,0,27,12,9,6
"2011","Castle Point 004E","E01021526","Total",32,14,11,7,6,2,4,0,26,12,7,7
"2011","Castle Point 005A","E01021517","Total",26,12,8,6,1,0,1,0,25,12,7,6
"2011","Castle Point 005B","E01021519","Total",30,15,8,7,2,0,1,1,28,15,7,6
"2011","Castle Point 005C","E01021530","Total",32,13,11,8,5,0,4,1,27,13,7,7
"2011","Castle Point 005D","E01021532","Total",20,11,6,3,1,0,1,0,19,11,5,3
"2011","Castle Point 006A","E01021482","Total",26,7,15,4,5,0,4,1,21,7,11,3
"2011","Castle Point 006B","E01021518","Total",70,31,21,18,5,2,2,1,65,29,19,17
"2011","Castle Point 006C","E01021520","Total",42,15,14,13,5,0,4,1,37,15,10,12
"2011","Castle Point 006D","E01021529","Total",51,20,11,20,8,4,2,2,43,16,9,18
"2011","Castle Point 007A","E01021480","Total",37,12,12,13,5,2,3,0,32,10,9,13
"2011","Castle Point 007B","E01021521","Total",28,13,10,5,4,0,3,1,24,13,7,4
"2011","Castle Point 007C","E01021522","Total",51,16,15,20,6,1,4,1,45,15,11,19
"2011","Castle Point 007D","E01021523","Total",11,2,4,5,2,0,1,1,9,2,3,4
"2011","Castle Point 007E","E01021524","Total",26,14,8,4,3,1,2,0,23,13,6,4
"2011","Castle Point 008A","E01021487","Total",20,5,5,10,3,0,1,2,17,5,4,8
"2011","Castle Point 008B","E01021494","Total",37,13,9,15,3,1,1,1,34,12,8,14
"2011","Castle Point 008C","E01021504","Total",28,10,8,10,2,0,2,0,26,10,6,10
"2011","Castle Point 008D","E01021505","Total",28,15,6,7,2,1,1,0,26,14,5,7
"2011","Castle Point 008E","E01021506","Total",54,17,20,17,8,0,7,1,46,17,13,16
"2011","Castle Point 009A","E01021492","Total",45,9,14,22,4,0,4,0,41,9,10,22
"2011","Castle Point 009B","E01021493","Total",32,11,5,16,1,0,1,0,31,11,4,16
"2011","Castle Point 009C","E01021495","Total",17,9,3,5,0,0,0,0,17,9,3,5
"2011","Castle Point 009D","E01021496","Total",43,10,10,23,7,1,3,3,36,9,7,20
"2011","Castle Point 010A","E01021485","Total",35,7,8,20,3,0,1,2,32,7,7,18
"2011","Castle Point 010B","E01021486","Total",72,21,8,43,6,3,0,3,66,18,8,40
"2011","Castle Point 010C","E01021488","Total",46,15,6,25,6,0,1,5,40,15,5,20
"2011","Castle Point 010D","E01021503","Total",56,18,10,28,4,0,3,1,52,18,7,27
"2011","Castle Point 010E","E01021507","Total",113,33,15,65,7,1,2,4,106,32,13,61
"2011","Castle Point 010F","E01021508","Total",65,26,10,29,2,0,2,0,63,26,8,29
"2011","Castle Point 011A","E01021484","Total",27,10,5,12,3,0,2,1,24,10,3,11
"2011","Castle Point 011B","E01021498","Total",18,3,8,7,3,0,2,1,15,3,6,6
"2011","Castle Point 011C","E01021499","Total",16,5,4,7,1,0,1,0,15,5,3,7
"2011","Castle Point 011D","E01021501","Total",21,7,2,12,2,0,1,1,19,7,1,11
"2011","Castle Point 011E","E01021502","Total",58,18,13,27,7,0,3,4,51,18,10,23
"2011","Castle Point 012A","E01021489","Total",27,7,6,14,2,0,1,1,25,7,5,13
"2011","Castle Point 012B","E01021490","Total",50,17,10,23,3,0,2,1,47,17,8,22
"2011","Castle Point 012C","E01021491","Total",40,12,8,20,5,0,4,1,35,12,4,19
"2011","Castle Point 012D","E01021497","Total",33,13,5,15,3,1,1,1,30,12,4,14
"2011","Castle Point 012E","E01021500","Total",41,10,9,22,4,0,4,0,37,10,5,22
"2011","Chelmsford 001A","E01021538","Total",61,19,22,20,6,0,4,2,55,19,18,18
"2011","Chelmsford 001B","E01021539","Total",22,9,4,9,1,0,0,1,21,9,4,8
"2011","Chelmsford 001C","E01021540","Total",19,9,6,4,2,1,1,0,17,8,5,4
"2011","Chelmsford 001D","E01021541","Total",26,9,9,8,1,0,0,1,25,9,9,7
"2011","Chelmsford 002A","E01021542","Total",32,14,10,8,2,0,1,1,30,14,9,7
"2011","Chelmsford 002B","E01021543","Total",28,12,9,7,2,0,1,1,26,12,8,6
"2011","Chelmsford 002C","E01021587","Total",16,9,4,3,4,1,2,1,12,8,2,2
"2011","Chelmsford 002D","E01021590","Total",18,7,7,4,1,0,1,0,17,7,6,4
"2011","Chelmsford 002E","E01021591","Total",20,11,4,5,1,1,0,0,19,10,4,5
"2011","Chelmsford 003A","E01021550","Total",13,7,3,3,5,1,2,2,8,6,1,1
"2011","Chelmsford 003B","E01021597","Total",65,32,12,21,7,1,4,2,58,31,8,19
"2011","Chelmsford 003C","E01021598","Total",77,26,17,34,9,2,5,2,68,24,12,32
"2011","Chelmsford 003D","E01021600","Total",15,5,7,3,2,0,1,1,13,5,6,2
"2011","Chelmsford 003E","E01021601","Total",62,19,5,38,7,2,2,3,55,17,3,35
"2011","Chelmsford 004A","E01021616","Total",28,9,14,5,1,0,1,0,27,9,13,5
"2011","Chelmsford 004B","E01021617","Total",37,10,15,12,4,1,1,2,33,9,14,10
"2011","Chelmsford 004C","E01021619","Total",41,16,17,8,3,0,3,0,38,16,14,8
"2011","Chelmsford 004D","E01021620","Total",38,14,13,11,6,0,2,4,32,14,11,7
"2011","Chelmsford 004E","E01021623","Total",36,12,16,8,3,0,3,0,33,12,13,8
"2011","Chelmsford 004F","E01021624","Total",8,1,4,3,1,0,0,1,7,1,4,2
"2011","Chelmsford 005A","E01021536","Total",51,20,15,16,4,1,2,1,47,19,13,15
"2011","Chelmsford 005B","E01021537","Total",33,11,14,8,4,1,1,2,29,10,13,6
"2011","Chelmsford 005D","E01021568","Total",22,3,9,10,3,0,3,0,19,3,6,10
"2011","Chelmsford 005E","E01033142","Total",62,23,19,20,4,1,2,1,58,22,17,19
"2011","Chelmsford 005F","E01033144","Total",59,24,15,20,6,0,5,1,53,24,10,19
"2011","Chelmsford 006A","E01021576","Total",139,45,16,78,12,4,2,6,127,41,14,72
"2011","Chelmsford 006B","E01021588","Total",53,13,17,23,4,0,2,2,49,13,15,21
"2011","Chelmsford 006C","E01021589","Total",72,24,24,24,10,0,8,2,62,24,16,22
"2011","Chelmsford 006D","E01021592","Total",80,17,15,48,4,0,3,1,76,17,12,47
"2011","Chelmsford 006E","E01021596","Total",69,26,7,36,3,2,0,1,66,24,7,35
"2011","Chelmsford 007A","E01021618","Total",30,5,16,9,3,0,3,0,27,5,13,9
"2011","Chelmsford 007B","E01021621","Total",42,18,12,12,2,0,2,0,40,18,10,12
"2011","Chelmsford 007C","E01021622","Total",17,5,10,2,1,0,1,0,16,5,9,2
"2011","Chelmsford 007D","E01021625","Total",35,13,15,7,2,0,2,0,33,13,13,7
"2011","Chelmsford 007E","E01021626","Total",20,8,3,9,1,1,0,0,19,7,3,9
"2011","Chelmsford 008A","E01021544","Total",35,12,12,11,3,0,2,1,32,12,10,10
"2011","Chelmsford 008B","E01021545","Total",35,18,13,4,2,0,2,0,33,18,11,4
"2011","Chelmsford 008C","E01021546","Total",32,14,9,9,1,0,0,1,31,14,9,8
"2011","Chelmsford 008D","E01021547","Total",35,17,13,5,3,0,3,0,32,17,10,5
"2011","Chelmsford 008E","E01021628","Total",50,18,10,22,5,1,3,1,45,17,7,21
"2011","Chelmsford 008F","E01021629","Total",41,17,7,17,3,0,2,1,38,17,5,16
"2011","Chelmsford 009A","E01021573","Total",21,7,8,6,4,2,1,1,17,5,7,5
"2011","Chelmsford 009B","E01021575","Total",39,18,9,12,4,2,1,1,35,16,8,11
"2011","Chelmsford 009C","E01021599","Total",26,7,8,11,4,0,3,1,22,7,5,10
"2011","Chelmsford 009E","E01021631","Total",82,33,13,36,7,1,3,3,75,32,10,33
"2011","Chelmsford 009F","E01033138","Total",39,15,5,19,0,0,0,0,39,15,5,19
"2011","Chelmsford 009G","E01033139","Total",51,18,11,22,3,1,2,0,48,17,9,22
"2011","Chelmsford 010A","E01021574","Total",45,14,10,21,0,0,0,0,45,14,10,21
"2011","Chelmsford 010B","E01021578","Total",34,13,7,14,5,1,3,1,29,12,4,13
"2011","Chelmsford 010D","E01021582","Total",38,9,12,17,6,0,4,2,32,9,8,15
"2011","Chelmsford 010E","E01021627","Total",12,5,4,3,0,0,0,0,12,5,4,3
"2011","Chelmsford 010F","E01033140","Total",31,12,9,10,4,1,3,0,27,11,6,10
"2011","Chelmsford 010G","E01033141","Total",23,5,9,9,2,1,0,1,21,4,9,8
"2011","Chelmsford 011A","E01021551","Total",27,11,4,12,2,0,1,1,25,11,3,11
"2011","Chelmsford 011B","E01021632","Total",24,11,4,9,2,1,0,1,22,10,4,8
"2011","Chelmsford 011C","E01021633","Total",12,6,1,5,0,0,0,0,12,6,1,5
"2011","Chelmsford 011D","E01021634","Total",24,9,11,4,1,0,1,0,23,9,10,4
"2011","Chelmsford 011E","E01021635","Total",13,6,4,3,2,1,1,0,11,5,3,3
"2011","Chelmsford 011F","E01021636","Total",42,11,11,20,5,1,2,2,37,10,9,18
"2011","Chelmsford 012A","E01021556","Total",25,10,11,4,3,0,2,1,22,10,9,3
"2011","Chelmsford 012B","E01021577","Total",35,16,9,10,5,2,3,0,30,14,6,10
"2011","Chelmsford 012C","E01021579","Total",26,13,8,5,1,0,0,1,25,13,8,4
"2011","Chelmsford 012D","E01021580","Total",15,7,6,2,1,0,1,0,14,7,5,2
"2011","Chelmsford 012E","E01021584","Total",13,6,6,1,1,0,1,0,12,6,5,1
"2011","Chelmsford 013A","E01021548","Total",8,3,5,0,1,0,1,0,7,3,4,0
"2011","Chelmsford 013B","E01021560","Total",23,14,2,7,2,1,1,0,21,13,1,7
"2011","Chelmsford 013C","E01021561","Total",34,18,12,4,6,0,6,0,28,18,6,4
"2011","Chelmsford 013D","E01021564","Total",16,7,4,5,1,0,1,0,15,7,3,5
"2011","Chelmsford 013E","E01021571","Total",21,10,4,7,3,0,2,1,18,10,2,6
"2011","Chelmsford 014A","E01021562","Total",62,27,16,19,4,0,1,3,58,27,15,16
"2011","Chelmsford 014B","E01021563","Total",70,28,15,27,8,1,5,2,62,27,10,25
"2011","Chelmsford 014C","E01021565","Total",91,31,17,43,7,0,4,3,84,31,13,40
"2011","Chelmsford 014D","E01021566","Total",37,15,11,11,5,0,3,2,32,15,8,9
"2011","Chelmsford 014F","E01033137","Total",57,20,13,24,3,0,1,2,54,20,12,22
"2011","Chelmsford 014G","E01033145","Total",38,15,7,16,2,1,0,1,36,14,7,15
"2011","Chelmsford 015A","E01021557","Total",26,12,11,3,3,1,2,0,23,11,9,3
"2011","Chelmsford 015B","E01021558","Total",15,9,6,0,1,0,1,0,14,9,5,0
"2011","Chelmsford 015C","E01021583","Total",52,19,19,14,3,0,3,0,49,19,16,14
"2011","Chelmsford 015D","E01021585","Total",28,15,6,7,0,0,0,0,28,15,6,7
"2011","Chelmsford 015E","E01021586","Total",26,11,8,7,0,0,0,0,26,11,8,7
"2011","Chelmsford 016A","E01021533","Total",44,24,16,4,3,0,3,0,41,24,13,4
"2011","Chelmsford 016B","E01021535","Total",42,13,16,13,1,0,1,0,41,13,15,13
"2011","Chelmsford 016C","E01021569","Total",21,9,10,2,3,0,3,0,18,9,7,2
"2011","Chelmsford 016D","E01021570","Total",25,13,7,5,4,2,0,2,21,11,7,3
"2011","Chelmsford 016E","E01021572","Total",47,18,7,22,3,0,1,2,44,18,6,20
"2011","Chelmsford 017A","E01021552","Total",38,17,9,12,4,0,3,1,34,17,6,11
"2011","Chelmsford 017B","E01021553","Total",33,9,9,15,6,0,5,1,27,9,4,14
"2011","Chelmsford 017C","E01021554","Total",67,16,11,40,9,1,3,5,58,15,8,35
"2011","Chelmsford 017D","E01021555","Total",19,8,5,6,2,0,1,1,17,8,4,5
"2011","Chelmsford 017E","E01021559","Total",23,7,11,5,4,0,4,0,19,7,7,5
"2011","Chelmsford 018B","E01021602","Total",29,12,9,8,3,0,1,2,26,12,8,6
"2011","Chelmsford 018D","E01021604","Total",43,18,10,15,5,2,1,2,38,16,9,13
"2011","Chelmsford 018E","E01033143","Total",13,3,2,8,3,1,0,2,10,2,2,6
"2011","Chelmsford 019A","E01021611","Total",28,14,10,4,5,1,4,0,23,13,6,4
"2011","Chelmsford 019B","E01021612","Total",25,15,4,6,4,1,3,0,21,14,1,6
"2011","Chelmsford 019C","E01021613","Total",58,23,19,16,8,3,3,2,50,20,16,14
"2011","Chelmsford 019D","E01021614","Total",32,13,10,9,8,2,6,0,24,11,4,9
"2011","Chelmsford 019E","E01021615","Total",37,19,12,6,5,0,4,1,32,19,8,5
"2011","Chelmsford 020A","E01021605","Total",29,12,10,7,4,2,2,0,25,10,8,7
"2011","Chelmsford 020B","E01021606","Total",52,19,18,15,5,0,4,1,47,19,14,14
"2011","Chelmsford 020C","E01021607","Total",55,22,15,18,7,1,4,2,48,21,11,16
"2011","Chelmsford 020D","E01021608","Total",33,14,9,10,5,0,1,4,28,14,8,6
"2011","Chelmsford 020E","E01021609","Total",18,7,9,2,3,0,3,0,15,7,6,2
"2011","Chelmsford 020F","E01021610","Total",42,12,16,14,6,1,5,0,36,11,11,14
"2011","Chelmsford 021A","E01021593","Total",23,7,11,5,3,0,3,0,20,7,8,5
"2011","Chelmsford 021B","E01021594","Total",22,6,5,11,3,0,2,1,19,6,3,10
"2011","Chelmsford 021C","E01021595","Total",16,5,2,9,2,0,0,2,14,5,2,7
"2011","Colchester 001A","E01021655","Total",12,4,6,2,3,0,3,0,9,4,3,2
"2011","Colchester 001B","E01021656","Total",26,9,8,9,6,0,2,4,20,9,6,5
"2011","Colchester 001C","E01021659","Total",28,15,8,5,1,0,0,1,27,15,8,4
"2011","Colchester 001D","E01021661","Total",29,16,7,6,2,0,0,2,27,16,7,4
"2011","Colchester 002A","E01021668","Total",56,20,15,21,4,1,1,2,52,19,14,19
"2011","Colchester 002B","E01021669","Total",82,24,15,43,2,0,1,1,80,24,14,42
"2011","Colchester 002C","E01021670","Total",89,29,18,42,10,3,4,3,79,26,14,39
"2011","Colchester 002D","E01021671","Total",27,9,3,15,4,0,1,3,23,9,2,12
"2011","Colchester 002F","E01033720","Total",89,37,19,33,10,0,8,2,79,37,11,31
"2011","Colchester 002G","E01033721","Total",53,27,20,6,6,2,4,0,47,25,16,6
"2011","Colchester 003A","E01021660","Total",14,5,6,3,2,0,2,0,12,5,4,3
"2011","Colchester 003B","E01021728","Total",15,5,9,1,1,0,1,0,14,5,8,1
"2011","Colchester 003C","E01021729","Total",42,21,12,9,2,1,1,0,40,20,11,9
"2011","Colchester 003D","E01021730","Total",48,27,4,17,5,0,1,4,43,27,3,13
"2011","Colchester 004A","E01021679","Total",64,19,14,31,3,0,2,1,61,19,12,30
"2011","Colchester 004B","E01021680","Total",78,27,23,28,13,1,6,6,65,26,17,22
"2011","Colchester 004C","E01021681","Total",71,25,21,25,10,3,6,1,61,22,15,24
"2011","Colchester 004D","E01021682","Total",79,40,25,14,2,0,1,1,77,40,24,13
"2011","Colchester 007A","E01021646","Total",63,12,32,19,8,0,8,0,55,12,24,19
"2011","Colchester 007B","E01021647","Total",53,20,9,24,2,0,2,0,51,20,7,24
"2011","Colchester 007C","E01021648","Total",79,24,23,32,7,1,3,3,72,23,20,29
"2011","Colchester 007D","E01021649","Total",67,24,12,31,7,0,3,4,60,24,9,27
"2011","Colchester 007E","E01021650","Total",65,29,19,17,3,0,2,1,62,29,17,16
"2011","Colchester 008A","E01021696","Total",103,32,14,57,7,2,3,2,96,30,11,55
"2011","Colchester 008B","E01021697","Total",75,29,12,34,9,3,5,1,66,26,7,33
"2011","Colchester 008C","E01021698","Total",60,17,5,38,5,2,2,1,55,15,3,37
"2011","Colchester 008D","E01021699","Total",70,26,9,35,8,3,1,4,62,23,8,31
"2011","Colchester 008E","E01021700","Total",108,37,10,61,8,3,2,3,100,34,8,58
"2011","Colchester 008G","E01033719","Total",16,5,2,9,1,0,0,1,15,5,2,8
"2011","Colchester 008H","E01033722","Total",58,16,6,36,1,0,0,1,57,16,6,35
"2011","Colchester 009A","E01021673","Total",18,6,10,2,2,0,2,0,16,6,8,2
"2011","Colchester 009B","E01021674","Total",57,25,18,14,3,0,2,1,54,25,16,13
"2011","Colchester 009C","E01021675","Total",26,11,5,10,4,0,1,3,22,11,4,7
"2011","Colchester 009D","E01021676","Total",32,15,10,7,4,0,3,1,28,15,7,6
"2011","Colchester 010A","E01021654","Total",25,10,9,6,3,0,1,2,22,10,8,4
"2011","Colchester 010B","E01021662","Total",24,10,6,8,6,2,3,1,18,8,3,7
"2011","Colchester 010C","E01021663","Total",12,8,0,4,0,0,0,0,12,8,0,4
"2011","Colchester 010D","E01021677","Total",12,7,3,2,1,0,1,0,11,7,2,2
"2011","Colchester 010E","E01021678","Total",39,21,13,5,6,0,4,2,33,21,9,3
"2011","Colchester 011A","E01021683","Total",61,24,12,25,4,1,3,0,57,23,9,25
"2011","Colchester 011B","E01021684","Total",48,18,13,17,5,0,5,0,43,18,8,17
"2011","Colchester 011C","E01021685","Total",100,27,19,54,12,2,6,4,88,25,13,50
"2011","Colchester 011D","E01021686","Total",87,25,14,48,7,2,2,3,80,23,12,45
"2011","Colchester 011E","E01021687","Total",77,20,29,28,6,0,5,1,71,20,24,27
"2011","Colchester 011F","E01021688","Total",56,20,13,23,3,2,1,0,53,18,12,23
"2011","Colchester 012A","E01021718","Total",44,22,16,6,5,2,3,0,39,20,13,6
"2011","Colchester 012B","E01021719","Total",26,12,8,6,3,0,2,1,23,12,6,5
"2011","Colchester 012C","E01021720","Total",50,21,9,20,2,0,2,0,48,21,7,20
"2011","Colchester 012D","E01021721","Total",49,16,22,11,9,0,8,1,40,16,14,10
"2011","Colchester 012E","E01021722","Total",48,20,16,12,3,0,3,0,45,20,13,12
"2011","Colchester 013A","E01021651","Total",72,22,32,18,8,0,7,1,64,22,25,17
"2011","Colchester 013B","E01021652","Total",30,9,16,5,4,0,4,0,26,9,12,5
"2011","Colchester 013C","E01021653","Total",27,7,14,6,4,1,3,0,23,6,11,6
"2011","Colchester 013D","E01021717","Total",41,14,9,18,3,1,1,1,38,13,8,17
"2011","Colchester 014A","E01021689","Total",43,24,10,9,2,0,0,2,41,24,10,7
"2011","Colchester 014B","E01021690","Total",40,24,6,10,6,4,2,0,34,20,4,10
"2011","Colchester 014C","E01021691","Total",25,11,10,4,1,0,1,0,24,11,9,4
"2011","Colchester 014D","E01021692","Total",16,7,8,1,3,0,3,0,13,7,5,1
"2011","Colchester 014E","E01021693","Total",29,12,10,7,3,0,3,0,26,12,7,7
"2011","Colchester 015A","E01021711","Total",62,24,8,30,4,0,2,2,58,24,6,28
"2011","Colchester 015C","E01021713","Total",35,16,4,15,2,0,0,2,33,16,4,13
"2011","Colchester 015D","E01021714","Total",85,32,20,33,3,2,1,0,82,30,19,33
"2011","Colchester 015E","E01021715","Total",58,24,13,21,8,1,6,1,50,23,7,20
"2011","Colchester 015G","E01033723","Total",74,17,25,32,4,0,4,0,70,17,21,32
"2011","Colchester 016A","E01021657","Total",66,25,19,22,11,0,8,3,55,25,11,19
"2011","Colchester 016B","E01021658","Total",38,17,9,12,3,0,2,1,35,17,7,11
"2011","Colchester 016C","E01021664","Total",60,18,19,23,8,0,8,0,52,18,11,23
"2011","Colchester 016D","E01021665","Total",66,17,10,39,4,0,0,4,62,17,10,35
"2011","Colchester 016E","E01021666","Total",28,15,3,10,1,0,0,1,27,15,3,9
"2011","Colchester 016F","E01021667","Total",62,21,14,27,4,0,3,1,58,21,11,26
"2011","Colchester 017A","E01021736","Total",25,12,6,7,1,0,1,0,24,12,5,7
"2011","Colchester 017B","E01021737","Total",43,24,10,9,4,1,3,0,39,23,7,9
"2011","Colchester 017C","E01021738","Total",41,14,19,8,5,0,5,0,36,14,14,8
"2011","Colchester 017D","E01021739","Total",22,9,7,6,1,0,1,0,21,9,6,6
"2011","Colchester 017E","E01021740","Total",42,16,17,9,5,2,3,0,37,14,14,9
"2011","Colchester 018A","E01021637","Total",37,17,10,10,8,1,4,3,29,16,6,7
"2011","Colchester 018B","E01021638","Total",61,15,11,35,2,0,0,2,59,15,11,33
"2011","Colchester 018C","E01021639","Total",72,28,16,28,10,1,2,7,62,27,14,21
"2011","Colchester 018D","E01021640","Total",46,11,12,23,4,0,3,1,42,11,9,22
"2011","Colchester 018E","E01021641","Total",53,18,16,19,7,1,2,4,46,17,14,15
"2011","Colchester 018F","E01021642","Total",74,27,15,32,7,1,6,0,67,26,9,32
"2011","Colchester 019A","E01021643","Total",41,14,20,7,10,0,9,1,31,14,11,6
"2011","Colchester 019B","E01021644","Total",31,15,7,9,2,1,0,1,29,14,7,8
"2011","Colchester 019C","E01021645","Total",26,12,8,6,2,0,2,0,24,12,6,6
"2011","Colchester 019D","E01021694","Total",14,7,5,2,2,0,1,1,12,7,4,1
"2011","Colchester 019E","E01021695","Total",11,5,2,4,1,0,1,0,10,5,1,4
"2011","Colchester 020A","E01021723","Total",34,10,9,15,7,0,6,1,27,10,3,14
"2011","Colchester 020B","E01021724","Total",25,12,3,10,0,0,0,0,25,12,3,10
"2011","Colchester 020C","E01021725","Total",14,6,4,4,3,0,3,0,11,6,1,4
"2011","Colchester 020D","E01021726","Total",60,18,19,23,11,1,8,2,49,17,11,21
"2011","Colchester 020E","E01021727","Total",32,17,13,2,2,0,2,0,30,17,11,2
"2011","Colchester 021A","E01021731","Total",18,7,3,8,0,0,0,0,18,7,3,8
"2011","Colchester 021B","E01021732","Total",44,18,14,12,8,0,7,1,36,18,7,11
"2011","Colchester 021C","E01021733","Total",30,18,3,9,1,0,0,1,29,18,3,8
"2011","Colchester 021D","E01021734","Total",16,8,3,5,2,0,1,1,14,8,2,4
"2011","Colchester 021E","E01021735","Total",18,9,5,4,1,0,1,0,17,9,4,4
"2011","Colchester 022D","E01021702","Total",35,11,8,16,5,2,2,1,30,9,6,15
"2011","Colchester 022E","E01021703","Total",96,28,21,47,9,2,2,5,87,26,19,42
"2011","Colchester 022F","E01021704","Total",60,24,10,26,1,0,1,0,59,24,9,26
"2011","Colchester 022G","E01021705","Total",42,18,9,15,3,1,2,0,39,17,7,15
"2011","Colchester 022H","E01021706","Total",36,19,7,10,4,0,3,1,32,19,4,9
"2011","Colchester 022I","E01021707","Total",45,20,9,16,1,0,0,1,44,20,9,15
"2011","Colchester 022A","E01021708","Total",22,11,9,2,2,0,2,0,20,11,7,2
"2011","Colchester 022B","E01021709","Total",25,12,5,8,2,0,2,0,23,12,3,8
"2011","Colchester 022C","E01021710","Total",25,14,3,8,1,1,0,0,24,13,3,8
"2011","Epping Forest 001A","E01021768","Total",39,18,4,17,1,0,0,1,38,18,4,16
"2011","Epping Forest 001B","E01021795","Total",36,13,14,9,4,1,2,1,32,12,12,8
"2011","Epping Forest 001C","E01021797","Total",23,11,8,4,3,2,1,0,20,9,7,4
"2011","Epping Forest 001D","E01021798","Total",30,8,13,9,6,0,6,0,24,8,7,9
"2011","Epping Forest 001E","E01021799","Total",50,13,16,21,5,1,3,1,45,12,13,20
"2011","Epping Forest 002A","E01021741","Total",33,13,10,10,2,0,2,0,31,13,8,10
"2011","Epping Forest 002B","E01021792","Total",12,5,3,4,2,0,1,1,10,5,2,3
"2011","Epping Forest 002C","E01021793","Total",13,3,6,4,2,0,2,0,11,3,4,4
"2011","Epping Forest 002D","E01021794","Total",27,10,8,9,1,0,0,1,26,10,8,8
"2011","Epping Forest 002E","E01021801","Total",30,7,12,11,1,0,1,0,29,7,11,11
"2011","Epping Forest 003A","E01021769","Total",35,11,9,15,8,3,4,1,27,8,5,14
"2011","Epping Forest 003B","E01021796","Total",38,12,14,12,4,0,3,1,34,12,11,11
"2011","Epping Forest 003C","E01021800","Total",31,10,4,17,3,2,1,0,28,8,3,17
"2011","Epping Forest 004A","E01021753","Total",39,17,8,14,7,0,5,2,32,17,3,12
"2011","Epping Forest 004B","E01021754","Total",22,8,3,11,3,1,1,1,19,7,2,10
"2011","Epping Forest 004C","E01021755","Total",17,4,9,4,4,0,3,1,13,4,6,3
"2011","Epping Forest 004D","E01021802","Total",91,28,24,39,5,0,4,1,86,28,20,38
"2011","Epping Forest 005A","E01021760","Total",29,12,7,10,0,0,0,0,29,12,7,10
"2011","Epping Forest 005B","E01021761","Total",70,15,19,36,12,1,8,3,58,14,11,33
"2011","Epping Forest 005C","E01021762","Total",33,12,4,17,3,1,2,0,30,11,2,17
"2011","Epping Forest 005D","E01021763","Total",40,10,15,15,5,1,3,1,35,9,12,14
"2011","Epping Forest 006A","E01021756","Total",35,13,12,10,4,0,3,1,31,13,9,9
"2011","Epping Forest 006B","E01021757","Total",18,9,6,3,1,0,1,0,17,9,5,3
"2011","Epping Forest 006C","E01021758","Total",35,10,10,15,0,0,0,0,35,10,10,15
"2011","Epping Forest 006D","E01021759","Total",35,7,18,10,2,0,0,2,33,7,18,8
"2011","Epping Forest 007A","E01021811","Total",71,23,17,31,3,1,1,1,68,22,16,30
"2011","Epping Forest 007B","E01021813","Total",23,10,8,5,4,1,3,0,19,9,5,5
"2011","Epping Forest 007C","E01021814","Total",39,12,11,16,4,0,1,3,35,12,10,13
"2011","Epping Forest 007D","E01021815","Total",54,23,11,20,5,0,1,4,49,23,10,16
"2011","Epping Forest 007E","E01021816","Total",31,9,7,15,3,1,0,2,28,8,7,13
"2011","Epping Forest 008A","E01021807","Total",48,12,21,15,3,1,2,0,45,11,19,15
"2011","Epping Forest 008B","E01021808","Total",70,21,16,33,7,0,4,3,63,21,12,30
"2011","Epping Forest 008C","E01021809","Total",33,14,8,11,0,0,0,0,33,14,8,11
"2011","Epping Forest 008D","E01021810","Total",71,15,20,36,4,1,1,2,67,14,19,34
"2011","Epping Forest 008E","E01021817","Total",105,32,20,53,6,0,1,5,99,32,19,48
"2011","Epping Forest 009A","E01021806","Total",35,7,15,13,8,0,8,0,27,7,7,13
"2011","Epping Forest 009B","E01021812","Total",18,6,5,7,2,0,2,0,16,6,3,7
"2011","Epping Forest 009C","E01021818","Total",61,21,16,24,5,1,2,2,56,20,14,22
"2011","Epping Forest 010A","E01021770","Total",51,22,8,21,3,1,1,1,48,21,7,20
"2011","Epping Forest 010B","E01021803","Total",21,10,9,2,5,0,4,1,16,10,5,1
"2011","Epping Forest 010C","E01021804","Total",24,9,8,7,2,0,2,0,22,9,6,7
"2011","Epping Forest 010D","E01021805","Total",11,2,5,4,1,0,1,0,10,2,4,4
"2011","Epping Forest 011A","E01021774","Total",58,20,8,30,1,0,0,1,57,20,8,29
"2011","Epping Forest 011B","E01021775","Total",69,19,16,34,3,0,2,1,66,19,14,33
"2011","Epping Forest 011C","E01021776","Total",36,9,10,17,4,0,2,2,32,9,8,15
"2011","Epping Forest 011D","E01021777","Total",55,18,14,23,5,1,3,1,50,17,11,22
"2011","Epping Forest 011E","E01021778","Total",54,16,13,25,5,0,2,3,49,16,11,22
"2011","Epping Forest 011F","E01021779","Total",59,21,12,26,5,0,3,2,54,21,9,24
"2011","Epping Forest 012A","E01021786","Total",22,13,4,5,3,2,0,1,19,11,4,4
"2011","Epping Forest 012B","E01021787","Total",18,5,6,7,1,0,1,0,17,5,5,7
"2011","Epping Forest 012C","E01021788","Total",34,9,13,12,1,0,1,0,33,9,12,12
"2011","Epping Forest 012D","E01021789","Total",18,7,4,7,3,0,2,1,15,7,2,6
"2011","Epping Forest 012E","E01021790","Total",67,22,19,26,4,2,1,1,63,20,18,25
"2011","Epping Forest 012F","E01021791","Total",41,8,18,15,1,0,1,0,40,8,17,15
"2011","Epping Forest 013A","E01021771","Total",81,25,18,38,5,0,3,2,76,25,15,36
"2011","Epping Forest 013B","E01021772","Total",38,12,15,11,2,0,1,1,36,12,14,10
"2011","Epping Forest 013C","E01021773","Total",54,23,10,21,3,1,1,1,51,22,9,20
"2011","Epping Forest 013D","E01021783","Total",46,14,19,13,3,0,2,1,43,14,17,12
"2011","Epping Forest 013E","E01021784","Total",50,16,27,7,4,0,4,0,46,16,23,7
"2011","Epping Forest 014A","E01021780","Total",24,7,10,7,4,1,3,0,20,6,7,7
"2011","Epping Forest 014B","E01021781","Total",28,8,13,7,1,0,1,0,27,8,12,7
"2011","Epping Forest 014C","E01021782","Total",24,12,6,6,0,0,0,0,24,12,6,6
"2011","Epping Forest 014D","E01021785","Total",82,31,13,38,8,3,3,2,74,28,10,36
"2011","Epping Forest 015A","E01021742","Total",34,12,6,16,1,1,0,0,33,11,6,16
"2011","Epping Forest 015B","E01021743","Total",52,20,18,14,9,2,6,1,43,18,12,13
"2011","Epping Forest 015C","E01021744","Total",44,13,17,14,2,0,2,0,42,13,15,14
"2011","Epping Forest 015D","E01021745","Total",31,10,11,10,2,1,1,0,29,9,10,10
"2011","Epping Forest 015E","E01021746","Total",55,20,19,16,5,1,3,1,50,19,16,15
"2011","Epping Forest 015F","E01021747","Total",34,14,11,9,3,0,0,3,31,14,11,6
"2011","Epping Forest 015G","E01021748","Total",53,15,16,22,3,2,1,0,50,13,15,22
"2011","Epping Forest 016A","E01021749","Total",43,24,9,10,3,0,2,1,40,24,7,9
"2011","Epping Forest 016B","E01021750","Total",10,2,2,6,0,0,0,0,10,2,2,6
"2011","Epping Forest 016C","E01021751","Total",9,3,3,3,0,0,0,0,9,3,3,3
"2011","Epping Forest 016D","E01021752","Total",54,18,12,24,3,0,2,1,51,18,10,23
"2011","Epping Forest 017A","E01021764","Total",152,43,29,80,6,1,4,1,146,42,25,79
"2011","Epping Forest 017B","E01021765","Total",43,11,15,17,1,0,1,0,42,11,14,17
"2011","Epping Forest 017C","E01021766","Total",31,8,8,15,3,0,2,1,28,8,6,14
"2011","Epping Forest 017D","E01021767","Total",25,8,10,7,3,2,1,0,22,6,9,7
"2011","Harlow 001A","E01021854","Total",53,17,23,13,5,0,5,0,48,17,18,13
"2011","Harlow 001B","E01021855","Total",43,17,6,20,2,2,0,0,41,15,6,20
"2011","Harlow 001C","E01021856","Total",46,20,14,12,6,0,4,2,40,20,10,10
"2011","Harlow 001D","E01021857","Total",74,25,25,24,8,1,6,1,66,24,19,23
"2011","Harlow 002A","E01021844","Total",59,23,17,19,9,1,5,3,50,22,12,16
"2011","Harlow 002B","E01021845","Total",80,29,16,35,5,2,2,1,75,27,14,34
"2011","Harlow 002C","E01021846","Total",85,27,17,41,8,3,4,1,77,24,13,40
"2011","Harlow 002D","E01021847","Total",37,13,7,17,4,3,0,1,33,10,7,16
"2011","Harlow 002E","E01021848","Total",66,17,21,28,9,0,6,3,57,17,15,25
"2011","Harlow 003A","E01021849","Total",42,13,7,22,3,0,3,0,39,13,4,22
"2011","Harlow 003B","E01021850","Total",75,31,17,27,6,0,6,0,69,31,11,27
"2011","Harlow 003C","E01021851","Total",77,26,11,40,6,0,1,5,71,26,10,35
"2011","Harlow 003D","E01021852","Total",60,27,4,29,2,0,0,2,58,27,4,27
"2011","Harlow 003E","E01021853","Total",42,12,9,21,7,3,2,2,35,9,7,19
"2011","Harlow 004A","E01021839","Total",42,10,13,19,4,0,3,1,38,10,10,18
"2011","Harlow 004B","E01021840","Total",63,21,16,26,8,0,6,2,55,21,10,24
"2011","Harlow 004C","E01021841","Total",52,18,13,21,2,0,2,0,50,18,11,21
"2011","Harlow 004D","E01021842","Total",75,28,17,30,9,1,4,4,66,27,13,26
"2011","Harlow 004E","E01021843","Total",66,21,13,32,5,1,4,0,61,20,9,32
"2011","Harlow 005A","E01021824","Total",54,24,19,11,3,1,2,0,51,23,17,11
"2011","Harlow 005B","E01021825","Total",58,23,15,20,2,0,2,0,56,23,13,20
"2011","Harlow 005C","E01021826","Total",40,20,16,4,3,1,2,0,37,19,14,4
"2011","Harlow 005D","E01021827","Total",64,25,15,24,6,1,5,0,58,24,10,24
"2011","Harlow 005E","E01021828","Total",71,28,27,16,11,0,9,2,60,28,18,14
"2011","Harlow 006A","E01021819","Total",57,17,12,28,2,1,1,0,55,16,11,28
"2011","Harlow 006B","E01021820","Total",73,29,13,31,6,2,2,2,67,27,11,29
"2011","Harlow 006C","E01021822","Total",62,19,17,26,4,0,2,2,58,19,15,24
"2011","Harlow 006D","E01021823","Total",94,32,18,44,7,2,4,1,87,30,14,43
"2011","Harlow 006E","E01021870","Total",44,17,9,18,2,0,1,1,42,17,8,17
"2011","Harlow 007A","E01021831","Total",46,14,11,21,4,1,3,0,42,13,8,21
"2011","Harlow 007B","E01021868","Total",62,24,21,17,5,1,3,1,57,23,18,16
"2011","Harlow 007C","E01021869","Total",50,16,9,25,3,0,3,0,47,16,6,25
"2011","Harlow 007D","E01021871","Total",61,15,14,32,8,1,4,3,53,14,10,29
"2011","Harlow 007E","E01021872","Total",74,24,13,37,10,0,6,4,64,24,7,33
"2011","Harlow 008A","E01021821","Total",57,21,12,24,8,1,5,2,49,20,7,22
"2011","Harlow 008B","E01021834","Total",67,20,10,37,4,0,2,2,63,20,8,35
"2011","Harlow 008C","E01021835","Total",56,22,11,23,7,1,2,4,49,21,9,19
"2011","Harlow 008D","E01021836","Total",64,24,12,28,8,2,4,2,56,22,8,26
"2011","Harlow 008E","E01021837","Total",47,19,12,16,4,0,2,2,43,19,10,14
"2011","Harlow 009A","E01021829","Total",42,15,8,19,1,0,1,0,41,15,7,19
"2011","Harlow 009B","E01021830","Total",23,7,7,9,5,1,2,2,18,6,5,7
"2011","Harlow 009C","E01021832","Total",29,11,12,6,4,0,4,0,25,11,8,6
"2011","Harlow 009D","E01021833","Total",29,15,6,8,3,0,2,1,26,15,4,7
"2011","Harlow 009E","E01021865","Total",44,15,12,17,3,0,1,2,41,15,11,15
"2011","Harlow 010A","E01021838","Total",57,21,10,26,2,0,1,1,55,21,9,25
"2011","Harlow 010B","E01021858","Total",73,25,15,33,8,3,3,2,65,22,12,31
"2011","Harlow 010C","E01021859","Total",76,22,12,42,3,1,1,1,73,21,11,41
"2011","Harlow 010D","E01021860","Total",67,22,15,30,8,2,5,1,59,20,10,29
"2011","Harlow 010E","E01021861","Total",65,22,15,28,3,0,3,0,62,22,12,28
"2011","Harlow 011A","E01021862","Total",64,24,9,31,3,0,2,1,61,24,7,30
"2011","Harlow 011B","E01021863","Total",61,16,13,32,8,1,5,2,53,15,8,30
"2011","Harlow 011C","E01021864","Total",79,25,17,37,7,0,3,4,72,25,14,33
"2011","Harlow 011D","E01021866","Total",43,16,13,14,4,0,1,3,39,16,12,11
"2011","Harlow 011E","E01021867","Total",26,8,10,8,2,0,2,0,24,8,8,8
"2011","Maldon 001A","E01021908","Total",33,17,7,9,5,1,3,1,28,16,4,8
"2011","Maldon 001B","E01021909","Total",16,10,5,1,2,0,2,0,14,10,3,1
"2011","Maldon 001C","E01021910","Total",26,11,5,10,0,0,0,0,26,11,5,10
"2011","Maldon 001D","E01021911","Total",10,5,3,2,1,0,1,0,9,5,2,2
"2011","Maldon 002A","E01021882","Total",18,3,10,5,4,1,3,0,14,2,7,5
"2011","Maldon 002B","E01021883","Total",26,11,7,8,2,0,2,0,24,11,5,8
"2011","Maldon 002C","E01021912","Total",21,7,9,5,5,1,4,0,16,6,5,5
"2011","Maldon 002D","E01021913","Total",17,4,6,7,5,1,2,2,12,3,4,5
"2011","Maldon 003A","E01021884","Total",27,11,7,9,0,0,0,0,27,11,7,9
"2011","Maldon 003B","E01021885","Total",19,9,6,4,2,0,2,0,17,9,4,4
"2011","Maldon 003C","E01021886","Total",30,10,12,8,2,1,0,1,28,9,12,7
"2011","Maldon 003D","E01021887","Total",43,19,12,12,2,0,2,0,41,19,10,12
"2011","Maldon 003E","E01021888","Total",60,17,13,30,6,0,4,2,54,17,9,28
"2011","Maldon 004A","E01021889","Total",79,29,16,34,3,0,2,1,76,29,14,33
"2011","Maldon 004B","E01021890","Total",61,18,18,25,7,1,4,2,54,17,14,23
"2011","Maldon 004C","E01021891","Total",15,4,2,9,1,0,0,1,14,4,2,8
"2011","Maldon 004D","E01021892","Total",40,13,4,23,3,0,3,0,37,13,1,23
"2011","Maldon 005A","E01021893","Total",29,17,8,4,3,1,1,1,26,16,7,3
"2011","Maldon 005B","E01021894","Total",39,9,7,23,5,0,2,3,34,9,5,20
"2011","Maldon 005C","E01021895","Total",36,17,10,9,4,0,3,1,32,17,7,8
"2011","Maldon 005D","E01021896","Total",18,7,7,4,2,0,1,1,16,7,6,3
"2011","Maldon 005E","E01021897","Total",33,15,10,8,2,0,2,0,31,15,8,8
"2011","Maldon 005F","E01021898","Total",15,6,4,5,3,1,2,0,12,5,2,5
"2011","Maldon 006A","E01021901","Total",21,8,5,8,4,1,3,0,17,7,2,8
"2011","Maldon 006B","E01021904","Total",31,11,9,11,4,0,3,1,27,11,6,10
"2011","Maldon 006C","E01021905","Total",32,9,7,16,2,0,1,1,30,9,6,15
"2011","Maldon 006D","E01021906","Total",36,11,9,16,3,0,3,0,33,11,6,16
"2011","Maldon 006E","E01021907","Total",28,16,7,5,3,2,0,1,25,14,7,4
"2011","Maldon 007A","E01021873","Total",17,7,4,6,5,1,3,1,12,6,1,5
"2011","Maldon 007B","E01021874","Total",34,13,7,14,3,1,0,2,31,12,7,12
"2011","Maldon 007C","E01021875","Total",11,5,3,3,2,0,2,0,9,5,1,3
"2011","Maldon 007D","E01021899","Total",22,11,5,6,3,1,2,0,19,10,3,6
"2011","Maldon 007E","E01021900","Total",18,7,8,3,1,0,1,0,17,7,7,3
"2011","Maldon 007F","E01021902","Total",16,8,5,3,2,1,1,0,14,7,4,3
"2011","Maldon 007G","E01021903","Total",16,7,5,4,2,0,2,0,14,7,3,4
"2011","Maldon 008C","E01021878","Total",22,8,7,7,3,0,2,1,19,8,5,6
"2011","Maldon 008D","E01021879","Total",27,9,8,10,3,0,3,0,24,9,5,10
"2011","Maldon 008E","E01021880","Total",38,15,11,12,3,0,1,2,35,15,10,10
"2011","Maldon 008F","E01021881","Total",19,10,5,4,3,1,2,0,16,9,3,4
"2011","Maldon 008G","E01033057","Total",42,14,9,19,0,0,0,0,42,14,9,19
"2011","Rochford 001A","E01021942","Total",21,9,1,11,0,0,0,0,21,9,1,11
"2011","Rochford 001B","E01021943","Total",26,11,9,6,3,0,2,1,23,11,7,5
"2011","Rochford 001C","E01021944","Total",24,10,5,9,1,0,0,1,23,10,5,8
"2011","Rochford 001D","E01021945","Total",19,10,7,2,4,1,2,1,15,9,5,1
"2011","Rochford 002A","E01021914","Total",25,17,4,4,0,0,0,0,25,17,4,4
"2011","Rochford 002B","E01021927","Total",20,9,4,7,0,0,0,0,20,9,4,7
"2011","Rochford 002C","E01021928","Total",15,5,8,2,1,0,1,0,14,5,7,2
"2011","Rochford 002D","E01021929","Total",30,18,7,5,1,0,1,0,29,18,6,5
"2011","Rochford 002E","E01021931","Total",21,9,6,6,2,1,1,0,19,8,5,6
"2011","Rochford 003A","E01021933","Total",16,10,3,3,0,0,0,0,16,10,3,3
"2011","Rochford 003B","E01021934","Total",20,9,7,4,1,1,0,0,19,8,7,4
"2011","Rochford 003C","E01021935","Total",14,10,3,1,3,0,3,0,11,10,0,1
"2011","Rochford 003D","E01021936","Total",23,11,8,4,2,0,2,0,21,11,6,4
"2011","Rochford 003E","E01021937","Total",43,20,10,13,6,2,4,0,37,18,6,13
"2011","Rochford 003F","E01021938","Total",19,10,7,2,0,0,0,0,19,10,7,2
"2011","Rochford 003G","E01021939","Total",13,4,7,2,4,1,3,0,9,3,4,2
"2011","Rochford 003H","E01021940","Total",28,11,12,5,2,1,1,0,26,10,11,5
"2011","Rochford 003I","E01021941","Total",24,9,12,3,3,0,3,0,21,9,9,3
"2011","Rochford 004A","E01021915","Total",31,8,14,9,4,1,3,0,27,7,11,9
"2011","Rochford 004B","E01021916","Total",19,7,4,8,2,2,0,0,17,5,4,8
"2011","Rochford 004C","E01021953","Total",109,32,17,60,10,4,5,1,99,28,12,59
"2011","Rochford 004D","E01021955","Total",96,32,22,42,9,2,1,6,87,30,21,36
"2011","Rochford 005A","E01021918","Total",17,9,4,4,0,0,0,0,17,9,4,4
"2011","Rochford 005B","E01021919","Total",11,4,5,2,3,0,3,0,8,4,2,2
"2011","Rochford 005C","E01021925","Total",24,7,9,8,3,0,2,1,21,7,7,7
"2011","Rochford 005D","E01021960","Total",18,10,6,2,1,1,0,0,17,9,6,2
"2011","Rochford 005E","E01021961","Total",28,14,11,3,3,0,3,0,25,14,8,3
"2011","Rochford 006A","E01021920","Total",32,8,11,13,4,0,3,1,28,8,8,12
"2011","Rochford 006B","E01021926","Total",35,16,9,10,1,0,1,0,34,16,8,10
"2011","Rochford 006C","E01021957","Total",46,16,13,17,8,0,7,1,38,16,6,16
"2011","Rochford 006D","E01021958","Total",23,9,9,5,2,0,2,0,21,9,7,5
"2011","Rochford 006E","E01021959","Total",35,15,11,9,9,2,6,1,26,13,5,8
"2011","Rochford 007A","E01021930","Total",23,10,9,4,2,1,0,1,21,9,9,3
"2011","Rochford 007B","E01021932","Total",36,18,10,8,4,1,2,1,32,17,8,7
"2011","Rochford 007C","E01021952","Total",36,20,7,9,5,0,4,1,31,20,3,8
"2011","Rochford 007D","E01021954","Total",34,14,6,14,3,1,1,1,31,13,5,13
"2011","Rochford 007E","E01021956","Total",39,12,8,19,2,0,1,1,37,12,7,18
"2011","Rochford 008A","E01021950","Total",22,7,7,8,0,0,0,0,22,7,7,8
"2011","Rochford 008B","E01021951","Total",17,9,5,3,1,0,1,0,16,9,4,3
"2011","Rochford 008C","E01021962","Total",41,18,6,17,3,0,3,0,38,18,3,17
"2011","Rochford 008D","E01021963","Total",15,3,5,7,4,0,3,1,11,3,2,6
"2011","Rochford 008E","E01021964","Total",21,7,10,4,2,0,2,0,19,7,8,4
"2011","Rochford 008F","E01021966","Total",32,18,6,8,2,0,1,1,30,18,5,7
"2011","Rochford 009A","E01021946","Total",10,5,4,1,1,0,1,0,9,5,3,1
"2011","Rochford 009B","E01021947","Total",14,5,4,5,3,1,0,2,11,4,4,3
"2011","Rochford 009C","E01021948","Total",29,14,8,7,1,0,1,0,28,14,7,7
"2011","Rochford 009D","E01021949","Total",19,5,11,3,3,0,3,0,16,5,8,3
"2011","Rochford 009E","E01021965","Total",34,17,12,5,2,0,1,1,32,17,11,4
"2011","Rochford 010A","E01021917","Total",28,10,8,10,3,0,1,2,25,10,7,8
"2011","Rochford 010B","E01021921","Total",40,15,6,19,1,0,0,1,39,15,6,18
"2011","Rochford 010C","E01021922","Total",46,23,8,15,4,0,3,1,42,23,5,14
"2011","Rochford 010D","E01021923","Total",25,7,8,10,4,0,2,2,21,7,6,8
"2011","Rochford 010E","E01021924","Total",26,12,7,7,2,0,2,0,24,12,5,7
"2011","Tendring 001A","E01021997","Total",52,9,4,39,6,2,0,4,46,7,4,35
"2011","Tendring 001B","E01021998","Total",56,20,7,29,2,0,1,1,54,20,6,28
"2011","Tendring 001C","E01021999","Total",66,26,12,28,5,0,1,4,61,26,11,24
"2011","Tendring 001D","E01022001","Total",78,30,9,39,5,1,1,3,73,29,8,36
"2011","Tendring 002A","E01022000","Total",49,21,14,14,5,0,5,0,44,21,9,14
"2011","Tendring 002C","E01022006","Total",78,31,11,36,14,2,6,6,64,29,5,30
"2011","Tendring 002D","E01022007","Total",68,33,12,23,8,1,5,2,60,32,7,21
"2011","Tendring 002F","E01033051","Total",86,29,15,42,8,3,2,3,78,26,13,39
"2011","Tendring 003A","E01021978","Total",36,17,6,13,6,1,2,3,30,16,4,10
"2011","Tendring 003B","E01022013","Total",21,11,8,2,6,1,5,0,15,10,3,2
"2011","Tendring 003C","E01022014","Total",37,18,9,10,6,2,4,0,31,16,5,10
"2011","Tendring 003D","E01022015","Total",43,21,16,6,5,1,3,1,38,20,13,5
"2011","Tendring 003E","E01022019","Total",17,8,6,3,4,0,4,0,13,8,2,3
"2011","Tendring 003F","E01022020","Total",41,13,16,12,10,2,6,2,31,11,10,10
"2011","Tendring 003G","E01022021","Total",44,20,11,13,6,0,4,2,38,20,7,11
"2011","Tendring 004A","E01021991","Total",18,8,4,6,3,1,1,1,15,7,3,5
"2011","Tendring 004B","E01021992","Total",30,15,5,10,1,0,1,0,29,15,4,10
"2011","Tendring 004C","E01022002","Total",54,21,11,22,4,0,1,3,50,21,10,19
"2011","Tendring 004D","E01022004","Total",42,15,13,14,7,0,6,1,35,15,7,13
"2011","Tendring 004E","E01022005","Total",46,19,13,14,5,0,3,2,41,19,10,12
"2011","Tendring 004F","E01022028","Total",36,10,11,15,4,0,4,0,32,10,7,15
"2011","Tendring 005A","E01021971","Total",14,3,6,5,1,0,1,0,13,3,5,5
"2011","Tendring 005B","E01021972","Total",19,8,4,7,1,0,1,0,18,8,3,7
"2011","Tendring 005C","E01022051","Total",23,14,5,4,3,0,2,1,20,14,3,3
"2011","Tendring 005D","E01022052","Total",26,8,10,8,1,0,1,0,25,8,9,8
"2011","Tendring 006A","E01021985","Total",20,6,6,8,1,0,1,0,19,6,5,8
"2011","Tendring 006B","E01021986","Total",34,11,8,15,5,0,4,1,29,11,4,14
"2011","Tendring 006C","E01022054","Total",48,10,11,27,8,0,3,5,40,10,8,22
"2011","Tendring 006D","E01022055","Total",24,9,4,11,2,0,1,1,22,9,3,10
"2011","Tendring 006E","E01022056","Total",60,18,8,34,8,2,4,2,52,16,4,32
"2011","Tendring 007A","E01021973","Total",21,8,6,7,2,2,0,0,19,6,6,7
"2011","Tendring 007B","E01021974","Total",19,7,7,5,2,0,1,1,17,7,6,4
"2011","Tendring 007C","E01022016","Total",31,8,7,16,3,0,1,2,28,8,6,14
"2011","Tendring 007D","E01022017","Total",30,19,8,3,3,1,2,0,27,18,6,3
"2011","Tendring 007E","E01022018","Total",31,12,5,14,2,1,1,0,29,11,4,14
"2011","Tendring 008A","E01021987","Total",27,6,5,16,1,0,0,1,26,6,5,15
"2011","Tendring 008B","E01021994","Total",15,4,5,6,4,1,3,0,11,3,2,6
"2011","Tendring 008C","E01021995","Total",26,14,5,7,5,1,3,1,21,13,2,6
"2011","Tendring 008D","E01021996","Total",40,19,9,12,4,1,3,0,36,18,6,12
"2011","Tendring 008E","E01022009","Total",21,10,5,6,4,0,3,1,17,10,2,5
"2011","Tendring 008F","E01022010","Total",40,21,9,10,4,1,2,1,36,20,7,9
"2011","Tendring 008G","E01022011","Total",37,14,4,19,1,0,0,1,36,14,4,18
"2011","Tendring 008H","E01022012","Total",45,14,5,26,3,1,1,1,42,13,4,25
"2011","Tendring 009A","E01021967","Total",35,13,12,10,4,0,4,0,31,13,8,10
"2011","Tendring 009B","E01021983","Total",24,8,9,7,5,0,3,2,19,8,6,5
"2011","Tendring 009C","E01021993","Total",47,21,10,16,6,0,4,2,41,21,6,14
"2011","Tendring 009D","E01022053","Total",15,5,4,6,2,0,2,0,13,5,2,6
"2011","Tendring 010A","E01021984","Total",41,16,8,17,4,0,3,1,37,16,5,16
"2011","Tendring 010B","E01022039","Total",72,29,9,34,5,1,0,4,67,28,9,30
"2011","Tendring 010C","E01022040","Total",44,21,5,18,2,0,2,0,42,21,3,18
"2011","Tendring 010D","E01022041","Total",39,11,7,21,4,0,3,1,35,11,4,20
"2011","Tendring 011A","E01021979","Total",49,23,10,16,5,1,3,1,44,22,7,15
"2011","Tendring 011B","E01021980","Total",32,17,9,6,4,0,2,2,28,17,7,4
"2011","Tendring 011C","E01021981","Total",36,21,9,6,3,0,2,1,33,21,7,5
"2011","Tendring 011D","E01021982","Total",90,45,19,26,6,1,4,1,84,44,15,25
"2011","Tendring 011E","E01022046","Total",38,17,4,17,6,1,0,5,32,16,4,12
"2011","Tendring 012A","E01022008","Total",28,8,7,13,1,0,1,0,27,8,6,13
"2011","Tendring 012B","E01022033","Total",17,9,1,7,4,1,0,3,13,8,1,4
"2011","Tendring 012C","E01022034","Total",42,11,10,21,4,0,2,2,38,11,8,19
"2011","Tendring 012D","E01022035","Total",34,19,7,8,4,1,3,0,30,18,4,8
"2011","Tendring 013A","E01021975","Total",64,31,6,27,3,0,2,1,61,31,4,26
"2011","Tendring 013B","E01021976","Total",35,12,12,11,3,0,1,2,32,12,11,9
"2011","Tendring 013C","E01021977","Total",51,13,9,29,6,0,5,1,45,13,4,28
"2011","Tendring 013D","E01022022","Total",55,16,16,23,7,1,4,2,48,15,12,21
"2011","Tendring 013E","E01022044","Total",37,12,8,17,4,2,2,0,33,10,6,17
"2011","Tendring 014A","E01022042","Total",74,21,10,43,6,1,1,4,68,20,9,39
"2011","Tendring 014B","E01022043","Total",105,33,18,54,8,1,2,5,97,32,16,49
"2011","Tendring 014C","E01022048","Total",30,10,5,15,3,0,2,1,27,10,3,14
"2011","Tendring 014D","E01022049","Total",55,17,12,26,8,1,3,4,47,16,9,22
"2011","Tendring 014E","E01022050","Total",69,24,11,34,4,0,1,3,65,24,10,31
"2011","Tendring 015A","E01022023","Total",73,24,14,35,10,1,6,3,63,23,8,32
"2011","Tendring 015B","E01022024","Total",69,24,13,32,8,0,2,6,61,24,11,26
"2011","Tendring 015C","E01022030","Total",69,16,6,47,10,0,3,7,59,16,3,40
"2011","Tendring 015D","E01022031","Total",117,23,11,83,18,0,2,16,99,23,9,67
"2011","Tendring 015E","E01022032","Total",96,25,19,52,11,0,6,5,85,25,13,47
"2011","Tendring 016A","E01021970","Total",76,20,11,45,9,1,4,4,67,19,7,41
"2011","Tendring 016B","E01022025","Total",51,12,6,33,5,1,2,2,46,11,4,31
"2011","Tendring 016C","E01022026","Total",73,23,8,42,2,0,0,2,71,23,8,40
"2011","Tendring 016D","E01022027","Total",58,23,9,26,4,0,3,1,54,23,6,25
"2011","Tendring 017A","E01021968","Total",115,45,13,57,11,2,5,4,104,43,8,53
"2011","Tendring 017B","E01021969","Total",70,21,15,34,4,0,2,2,66,21,13,32
"2011","Tendring 017C","E01022036","Total",32,14,8,10,0,0,0,0,32,14,8,10
"2011","Tendring 017D","E01022037","Total",23,9,5,9,2,0,2,0,21,9,3,9
"2011","Tendring 017E","E01022038","Total",53,15,11,27,1,0,1,0,52,15,10,27
"2011","Tendring 018A","E01021988","Total",76,14,6,56,15,0,4,11,61,14,2,45
"2011","Tendring 018B","E01021989","Total",20,9,5,6,4,0,4,0,16,9,1,6
"2011","Tendring 018C","E01021990","Total",38,16,8,14,5,1,3,1,33,15,5,13
"2011","Tendring 018D","E01022045","Total",41,18,10,13,2,0,2,0,39,18,8,13
"2011","Tendring 018E","E01022047","Total",24,11,2,11,1,1,0,0,23,10,2,11
"2011","Uttlesford 001A","E01022057","Total",27,10,7,10,0,0,0,0,27,10,7,10
"2011","Uttlesford 001B","E01022075","Total",17,11,4,2,1,0,1,0,16,11,3,2
"2011","Uttlesford 001C","E01022077","Total",30,13,12,5,1,1,0,0,29,12,12,5
"2011","Uttlesford 001D","E01022094","Total",14,7,4,3,1,0,1,0,13,7,3,3
"2011","Uttlesford 002A","E01022074","Total",42,15,9,18,3,1,1,1,39,14,8,17
"2011","Uttlesford 002B","E01022076","Total",24,12,9,3,1,0,1,0,23,12,8,3
"2011","Uttlesford 002C","E01022078","Total",58,23,11,24,10,4,3,3,48,19,8,21
"2011","Uttlesford 002D","E01022079","Total",37,12,12,13,4,0,2,2,33,12,10,11
"2011","Uttlesford 002E","E01022080","Total",42,11,20,11,4,0,3,1,38,11,17,10
"2011","Uttlesford 002F","E01022081","Total",62,21,21,20,10,0,5,5,52,21,16,15
"2011","Uttlesford 002G","E01022082","Total",41,17,14,10,2,0,2,0,39,17,12,10
"2011","Uttlesford 003A","E01022061","Total",20,9,4,7,3,0,3,0,17,9,1,7
"2011","Uttlesford 003B","E01022071","Total",21,8,11,2,1,0,1,0,20,8,10,2
"2011","Uttlesford 003C","E01022072","Total",22,7,8,7,1,0,1,0,21,7,7,7
"2011","Uttlesford 003D","E01022073","Total",36,13,11,12,4,0,3,1,32,13,8,11
"2011","Uttlesford 003E","E01022098","Total",11,7,3,1,2,0,1,1,9,7,2,0
"2011","Uttlesford 004A","E01022092","Total",17,5,5,7,1,0,1,0,16,5,4,7
"2011","Uttlesford 004B","E01022093","Total",52,20,11,21,3,1,2,0,49,19,9,21
"2011","Uttlesford 004C","E01022097","Total",27,14,3,10,2,1,1,0,25,13,2,10
"2011","Uttlesford 004D","E01022099","Total",33,14,12,7,3,0,2,1,30,14,10,6
"2011","Uttlesford 005A","E01022062","Total",28,9,11,8,4,1,3,0,24,8,8,8
"2011","Uttlesford 005B","E01022063","Total",38,17,11,10,2,0,2,0,36,17,9,10
"2011","Uttlesford 005C","E01022083","Total",17,6,7,4,3,1,2,0,14,5,5,4
"2011","Uttlesford 005D","E01022084","Total",26,12,9,5,5,0,5,0,21,12,4,5
"2011","Uttlesford 005E","E01022085","Total",28,8,11,9,0,0,0,0,28,8,11,9
"2011","Uttlesford 005F","E01022087","Total",30,11,8,11,0,0,0,0,30,11,8,11
"2011","Uttlesford 005G","E01022089","Total",24,14,6,4,2,1,1,0,22,13,5,4
"2011","Uttlesford 006A","E01022086","Total",43,16,9,18,4,0,2,2,39,16,7,16
"2011","Uttlesford 006B","E01022090","Total",48,11,13,24,5,0,3,2,43,11,10,22
"2011","Uttlesford 006C","E01022091","Total",50,25,13,12,0,0,0,0,50,25,13,12
"2011","Uttlesford 006D","E01022095","Total",19,4,8,7,6,1,4,1,13,3,4,6
"2011","Uttlesford 007B","E01022067","Total",41,11,17,13,10,0,9,1,31,11,8,12
"2011","Uttlesford 007C","E01022068","Total",43,20,12,11,9,1,4,4,34,19,8,7
"2011","Uttlesford 007D","E01033054","Total",45,20,10,15,1,0,0,1,44,20,10,14
"2011","Uttlesford 007E","E01033055","Total",26,13,6,7,0,0,0,0,26,13,6,7
"2011","Uttlesford 007F","E01033056","Total",31,14,4,13,0,0,0,0,31,14,4,13
"2011","Uttlesford 008A","E01022058","Total",18,6,4,8,3,0,2,1,15,6,2,7
"2011","Uttlesford 008B","E01022064","Total",20,6,8,6,0,0,0,0,20,6,8,6
"2011","Uttlesford 008D","E01022069","Total",21,12,3,6,0,0,0,0,21,12,3,6
"2011","Uttlesford 008E","E01022088","Total",25,13,4,8,2,0,0,2,23,13,4,6
"2011","Uttlesford 008F","E01033052","Total",28,7,8,13,1,0,0,1,27,7,8,12
"2011","Uttlesford 008G","E01033053","Total",45,20,14,11,7,0,4,3,38,20,10,8
"2011","Uttlesford 009A","E01022059","Total",18,6,6,6,2,0,2,0,16,6,4,6
"2011","Uttlesford 009B","E01022060","Total",18,8,5,5,1,0,1,0,17,8,4,5
"2011","Uttlesford 009C","E01022070","Total",29,11,8,10,2,0,2,0,27,11,6,10
"2011","Uttlesford 009D","E01022096","Total",34,10,11,13,5,0,5,0,29,10,6,13
"2011","Broxbourne 001A","E01023316","Total",22,14,6,2,2,0,2,0,20,14,4,2
"2011","Broxbourne 001B","E01023317","Total",81,32,11,38,2,0,1,1,79,32,10,37
"2011","Broxbourne 001C","E01023318","Total",44,23,9,12,2,1,1,0,42,22,8,12
"2011","Broxbourne 001D","E01023319","Total",16,8,4,4,0,0,0,0,16,8,4,4
"2011","Broxbourne 002A","E01023327","Total",50,16,9,25,4,1,2,1,46,15,7,24
"2011","Broxbourne 002B","E01023328","Total",40,11,10,19,4,1,3,0,36,10,7,19
"2011","Broxbourne 002C","E01023329","Total",26,12,5,9,3,0,2,1,23,12,3,8
"2011","Broxbourne 002D","E01023330","Total",70,30,6,34,8,3,3,2,62,27,3,32
"2011","Broxbourne 002E","E01023331","Total",45,18,11,16,5,1,4,0,40,17,7,16
"2011","Broxbourne 003A","E01023320","Total",59,23,18,18,7,0,5,2,52,23,13,16
"2011","Broxbourne 003B","E01023321","Total",30,12,8,10,6,3,2,1,24,9,6,9
"2011","Broxbourne 003C","E01023322","Total",56,17,19,20,7,1,4,2,49,16,15,18
"2011","Broxbourne 003D","E01023323","Total",58,18,13,27,8,0,6,2,50,18,7,25
"2011","Broxbourne 004A","E01023289","Total",7,3,3,1,0,0,0,0,7,3,3,1
"2011","Broxbourne 004B","E01023290","Total",14,4,5,5,1,0,1,0,13,4,4,5
"2011","Broxbourne 004C","E01023291","Total",11,7,3,1,1,0,1,0,10,7,2,1
"2011","Broxbourne 004D","E01023292","Total",31,9,13,9,1,0,0,1,30,9,13,8
"2011","Broxbourne 005A","E01023340","Total",69,21,16,32,7,2,2,3,62,19,14,29
"2011","Broxbourne 005B","E01023341","Total",34,14,12,8,1,0,1,0,33,14,11,8
"2011","Broxbourne 005C","E01023342","Total",168,51,37,80,8,1,4,3,160,50,33,77
"2011","Broxbourne 005D","E01023343","Total",142,40,20,82,6,1,2,3,136,39,18,79
"2011","Broxbourne 005E","E01023344","Total",51,19,14,18,2,0,1,1,49,19,13,17
"2011","Broxbourne 006A","E01023307","Total",32,13,9,10,5,1,3,1,27,12,6,9
"2011","Broxbourne 006B","E01023308","Total",28,13,9,6,3,1,2,0,25,12,7,6
"2011","Broxbourne 006C","E01023309","Total",31,15,12,4,4,0,4,0,27,15,8,4
"2011","Broxbourne 006D","E01023310","Total",158,46,20,92,5,2,2,1,153,44,18,91
"2011","Broxbourne 007A","E01023311","Total",33,14,10,9,4,1,2,1,29,13,8,8
"2011","Broxbourne 007B","E01023312","Total",31,11,9,11,3,0,3,0,28,11,6,11
"2011","Broxbourne 007C","E01023313","Total",9,4,4,1,2,0,2,0,7,4,2,1
"2011","Broxbourne 007D","E01023315","Total",40,11,11,18,5,0,4,1,35,11,7,17
"2011","Broxbourne 008A","E01023302","Total",58,22,16,20,4,0,2,2,54,22,14,18
"2011","Broxbourne 008B","E01023303","Total",56,23,8,25,4,0,1,3,52,23,7,22
"2011","Broxbourne 008C","E01023304","Total",44,19,4,21,2,1,0,1,42,18,4,20
"2011","Broxbourne 008D","E01023305","Total",42,18,10,14,5,1,2,2,37,17,8,12
"2011","Broxbourne 008E","E01023306","Total",39,16,15,8,1,0,1,0,38,16,14,8
"2011","Broxbourne 009A","E01023314","Total",31,10,8,13,2,0,1,1,29,10,7,12
"2011","Broxbourne 009B","E01023324","Total",30,6,10,14,3,1,1,1,27,5,9,13
"2011","Broxbourne 009C","E01023325","Total",36,13,8,15,7,0,5,2,29,13,3,13
"2011","Broxbourne 009D","E01023326","Total",53,16,14,23,6,1,4,1,47,15,10,22
"2011","Broxbourne 010A","E01023297","Total",27,9,10,8,2,0,2,0,25,9,8,8
"2011","Broxbourne 010B","E01023298","Total",36,14,12,10,2,1,1,0,34,13,11,10
"2011","Broxbourne 010C","E01023299","Total",31,8,12,11,9,1,7,1,22,7,5,10
"2011","Broxbourne 010D","E01023300","Total",51,13,11,27,5,2,3,0,46,11,8,27
"2011","Broxbourne 010E","E01023301","Total",75,24,15,36,5,0,3,2,70,24,12,34
"2011","Broxbourne 011A","E01023293","Total",42,14,11,17,3,0,1,2,39,14,10,15
"2011","Broxbourne 011B","E01023294","Total",73,22,20,31,2,0,2,0,71,22,18,31
"2011","Broxbourne 011C","E01023295","Total",43,16,10,17,2,0,0,2,41,16,10,15
"2011","Broxbourne 011D","E01023296","Total",51,17,17,17,2,0,1,1,49,17,16,16
"2011","Broxbourne 012A","E01023332","Total",68,16,21,31,9,2,7,0,59,14,14,31
"2011","Broxbourne 012B","E01023333","Total",82,18,23,41,4,1,3,0,78,17,20,41
"2011","Broxbourne 012C","E01023334","Total",26,16,3,7,1,0,0,1,25,16,3,6
"2011","Broxbourne 012D","E01023335","Total",33,12,12,9,3,0,2,1,30,12,10,8
"2011","Broxbourne 013A","E01023336","Total",89,24,27,38,3,1,2,0,86,23,25,38
"2011","Broxbourne 013B","E01023337","Total",75,16,22,37,7,0,5,2,68,16,17,35
"2011","Broxbourne 013C","E01023338","Total",131,28,24,79,10,0,3,7,121,28,21,72
"2011","Broxbourne 013D","E01023339","Total",79,21,12,46,4,1,0,3,75,20,12,43
"2011","Dacorum 001A","E01023430","Total",15,7,6,2,5,3,2,0,10,4,4,2
"2011","Dacorum 001B","E01023431","Total",16,9,3,4,1,0,1,0,15,9,2,4
"2011","Dacorum 001C","E01023432","Total",30,11,10,9,3,0,3,0,27,11,7,9
"2011","Dacorum 001D","E01023433","Total",54,18,17,19,3,0,2,1,51,18,15,18
"2011","Dacorum 002A","E01023423","Total",24,8,10,6,1,0,1,0,23,8,9,6
"2011","Dacorum 002B","E01023424","Total",16,9,3,4,2,0,1,1,14,9,2,3
"2011","Dacorum 002C","E01023425","Total",26,9,14,3,4,0,4,0,22,9,10,3
"2011","Dacorum 002D","E01023426","Total",46,13,21,12,6,1,4,1,40,12,17,11
"2011","Dacorum 003A","E01023418","Total",45,14,15,16,4,0,4,0,41,14,11,16
"2011","Dacorum 003B","E01023419","Total",52,19,21,12,5,0,3,2,47,19,18,10
"2011","Dacorum 003C","E01023420","Total",26,12,11,3,0,0,0,0,26,12,11,3
"2011","Dacorum 004A","E01023352","Total",28,10,8,10,5,3,2,0,23,7,6,10
"2011","Dacorum 004B","E01023421","Total",27,12,11,4,4,1,3,0,23,11,8,4
"2011","Dacorum 004C","E01023422","Total",9,4,3,2,0,0,0,0,9,4,3,2
"2011","Dacorum 005A","E01023434","Total",46,10,14,22,6,1,3,2,40,9,11,20
"2011","Dacorum 005B","E01023435","Total",56,12,21,23,5,2,2,1,51,10,19,22
"2011","Dacorum 005C","E01023436","Total",21,8,11,2,3,0,3,0,18,8,8,2
"2011","Dacorum 005D","E01023437","Total",105,23,17,65,3,0,0,3,102,23,17,62
"2011","Dacorum 006A","E01023355","Total",16,6,6,4,1,0,1,0,15,6,5,4
"2011","Dacorum 006B","E01023356","Total",12,9,1,2,2,1,0,1,10,8,1,1
"2011","Dacorum 006C","E01023416","Total",17,7,7,3,2,0,2,0,15,7,5,3
"2011","Dacorum 006D","E01023417","Total",33,17,13,3,4,2,2,0,29,15,11,3
"2011","Dacorum 007A","E01023393","Total",53,15,11,27,7,2,3,2,46,13,8,25
"2011","Dacorum 007B","E01023394","Total",50,21,12,17,4,1,3,0,46,20,9,17
"2011","Dacorum 007C","E01023395","Total",72,21,17,34,6,1,4,1,66,20,13,33
"2011","Dacorum 007D","E01023396","Total",55,14,16,25,7,0,4,3,48,14,12,22
"2011","Dacorum 007E","E01023397","Total",75,19,21,35,9,1,5,3,66,18,16,32
"2011","Dacorum 008A","E01023401","Total",93,30,19,44,4,1,2,1,89,29,17,43
"2011","Dacorum 008B","E01023402","Total",43,16,13,14,4,0,3,1,39,16,10,13
"2011","Dacorum 008C","E01023403","Total",51,19,10,22,2,0,1,1,49,19,9,21
"2011","Dacorum 008D","E01023404","Total",84,24,16,44,9,0,7,2,75,24,9,42
"2011","Dacorum 008E","E01023405","Total",75,27,13,35,3,0,0,3,72,27,13,32
"2011","Dacorum 009A","E01023361","Total",42,15,14,13,8,1,6,1,34,14,8,12
"2011","Dacorum 009B","E01023362","Total",16,7,6,3,1,0,1,0,15,7,5,3
"2011","Dacorum 009C","E01023363","Total",34,12,20,2,2,0,2,0,32,12,18,2
"2011","Dacorum 009D","E01023364","Total",6,1,4,1,1,1,0,0,5,0,4,1
"2011","Dacorum 010A","E01023390","Total",79,27,14,38,9,3,3,3,70,24,11,35
"2011","Dacorum 010B","E01023391","Total",48,16,12,20,4,0,3,1,44,16,9,19
"2011","Dacorum 010C","E01023399","Total",43,15,17,11,5,1,2,2,38,14,15,9
"2011","Dacorum 011A","E01023392","Total",62,31,16,15,4,0,3,1,58,31,13,14
"2011","Dacorum 011B","E01023427","Total",63,20,15,28,6,1,3,2,57,19,12,26
"2011","Dacorum 011C","E01023428","Total",27,10,12,5,2,0,2,0,25,10,10,5
"2011","Dacorum 011D","E01023429","Total",56,14,16,26,7,0,5,2,49,14,11,24
"2011","Dacorum 012A","E01023369","Total",58,17,16,25,5,0,2,3,53,17,14,22
"2011","Dacorum 012B","E01023370","Total",47,19,16,12,4,0,4,0,43,19,12,12
"2011","Dacorum 012C","E01023371","Total",27,11,8,8,1,0,0,1,26,11,8,7
"2011","Dacorum 012D","E01023372","Total",9,3,4,2,2,1,1,0,7,2,3,2
"2011","Dacorum 013A","E01023345","Total",52,16,15,21,7,2,4,1,45,14,11,20
"2011","Dacorum 013B","E01023346","Total",50,9,15,26,4,0,3,1,46,9,12,25
"2011","Dacorum 013C","E01023347","Total",22,7,6,9,2,0,1,1,20,7,5,8
"2011","Dacorum 013D","E01023348","Total",69,16,15,38,4,0,2,2,65,16,13,36
"2011","Dacorum 014A","E01023365","Total",18,4,10,4,0,0,0,0,18,4,10,4
"2011","Dacorum 014B","E01023366","Total",65,27,17,21,2,0,1,1,63,27,16,20
"2011","Dacorum 014C","E01023367","Total",14,5,6,3,2,1,1,0,12,4,5,3
"2011","Dacorum 014D","E01023368","Total",44,18,18,8,7,2,4,1,37,16,14,7
"2011","Dacorum 015A","E01023349","Total",74,19,19,36,11,1,4,6,63,18,15,30
"2011","Dacorum 015B","E01023350","Total",68,26,10,32,7,3,3,1,61,23,7,31
"2011","Dacorum 015C","E01023351","Total",53,21,13,19,5,0,2,3,48,21,11,16
"2011","Dacorum 015D","E01023398","Total",65,24,23,18,10,3,5,2,55,21,18,16
"2011","Dacorum 015E","E01023400","Total",48,9,22,17,6,0,3,3,42,9,19,14
"2011","Dacorum 016A","E01023383","Total",34,12,12,10,3,0,2,1,31,12,10,9
"2011","Dacorum 016B","E01023384","Total",67,26,15,26,1,0,1,0,66,26,14,26
"2011","Dacorum 016C","E01023385","Total",26,10,13,3,7,1,5,1,19,9,8,2
"2011","Dacorum 017A","E01023409","Total",30,8,10,12,3,0,3,0,27,8,7,12
"2011","Dacorum 017B","E01023410","Total",12,1,6,5,1,0,0,1,11,1,6,4
"2011","Dacorum 017C","E01023411","Total",59,18,14,27,2,0,1,1,57,18,13,26
"2011","Dacorum 017D","E01023412","Total",14,6,5,3,0,0,0,0,14,6,5,3
"2011","Dacorum 017E","E01023413","Total",68,25,16,27,6,0,5,1,62,25,11,26
"2011","Dacorum 018B","E01023354","Total",41,7,22,12,7,0,4,3,34,7,18,9
"2011","Dacorum 018C","E01023379","Total",24,8,9,7,7,1,3,3,17,7,6,4
"2011","Dacorum 018D","E01023380","Total",32,14,10,8,4,2,1,1,28,12,9,7
"2011","Dacorum 018E","E01023381","Total",13,3,7,3,2,0,2,0,11,3,5,3
"2011","Dacorum 018F","E01023382","Total",45,18,17,10,7,1,6,0,38,17,11,10
"2011","Dacorum 018G","E01033022","Total",40,13,12,15,6,0,4,2,34,13,8,13
"2011","Dacorum 018H","E01033023","Total",36,12,15,9,4,0,4,0,32,12,11,9
"2011","Dacorum 019A","E01023386","Total",45,13,13,19,5,0,3,2,40,13,10,17
"2011","Dacorum 019B","E01023387","Total",84,31,22,31,9,2,5,2,75,29,17,29
"2011","Dacorum 019C","E01023388","Total",45,18,13,14,6,1,4,1,39,17,9,13
"2011","Dacorum 019D","E01023389","Total",35,15,6,14,5,2,0,3,30,13,6,11
"2011","Dacorum 020A","E01023357","Total",68,19,12,37,5,1,2,2,63,18,10,35
"2011","Dacorum 020B","E01023358","Total",71,21,25,25,5,1,4,0,66,20,21,25
"2011","Dacorum 020C","E01023359","Total",70,23,15,32,5,0,5,0,65,23,10,32
"2011","Dacorum 020D","E01023360","Total",43,21,11,11,3,0,2,1,40,21,9,10
"2011","Dacorum 020E","E01023414","Total",37,13,13,11,6,0,3,3,31,13,10,8
"2011","Dacorum 020F","E01023415","Total",38,17,5,16,3,2,1,0,35,15,4,16
"2011","Dacorum 021A","E01023373","Total",26,10,12,4,4,1,3,0,22,9,9,4
"2011","Dacorum 021B","E01023374","Total",32,18,13,1,2,0,2,0,30,18,11,1
"2011","Dacorum 021C","E01023375","Total",27,10,8,9,3,0,3,0,24,10,5,9
"2011","Dacorum 021D","E01023376","Total",28,8,10,10,1,0,1,0,27,8,9,10
"2011","Dacorum 021E","E01023377","Total",14,5,5,4,2,0,2,0,12,5,3,4
"2011","Dacorum 021F","E01023378","Total",12,5,4,3,2,1,1,0,10,4,3,3
"2011","Dacorum 022A","E01023406","Total",62,32,16,14,6,0,3,3,56,32,13,11
"2011","Dacorum 022B","E01023407","Total",28,10,4,14,8,3,3,2,20,7,1,12
"2011","Dacorum 022C","E01023408","Total",32,8,14,10,2,0,2,0,30,8,12,10
"2011","East Hertfordshire 001A","E01023462","Total",23,6,7,10,6,1,4,1,17,5,3,9
"2011","East Hertfordshire 001B","E01023464","Total",28,12,11,5,5,1,4,0,23,11,7,5
"2011","East Hertfordshire 001C","E01023465","Total",30,12,9,9,5,0,4,1,25,12,5,8
"2011","East Hertfordshire 001D","E01023466","Total",48,28,12,8,4,0,2,2,44,28,10,6
"2011","East Hertfordshire 002A","E01023467","Total",20,9,4,7,0,0,0,0,20,9,4,7
"2011","East Hertfordshire 002B","E01023494","Total",19,5,9,5,4,0,2,2,15,5,7,3
"2011","East Hertfordshire 002C","E01023495","Total",21,9,5,7,2,1,1,0,19,8,4,7
"2011","East Hertfordshire 002D","E01023508","Total",27,6,13,8,4,1,3,0,23,5,10,8
"2011","East Hertfordshire 002E","E01023509","Total",45,15,13,17,7,1,5,1,38,14,8,16
"2011","East Hertfordshire 003A","E01023452","Total",35,16,8,11,4,1,3,0,31,15,5,11
"2011","East Hertfordshire 003B","E01023453","Total",25,7,14,4,5,0,4,1,20,7,10,3
"2011","East Hertfordshire 003C","E01023454","Total",22,11,4,7,2,0,2,0,20,11,2,7
"2011","East Hertfordshire 003D","E01023455","Total",30,12,8,10,4,1,2,1,26,11,6,9
"2011","East Hertfordshire 003E","E01023463","Total",14,6,7,1,1,0,1,0,13,6,6,1
"2011","East Hertfordshire 003F","E01023493","Total",38,16,10,12,5,0,5,0,33,16,5,12
"2011","East Hertfordshire 004A","E01023449","Total",20,6,13,1,1,0,1,0,19,6,12,1
"2011","East Hertfordshire 004B","E01023450","Total",42,12,17,13,3,0,3,0,39,12,14,13
"2011","East Hertfordshire 004C","E01023451","Total",29,9,15,5,2,0,1,1,27,9,14,4
"2011","East Hertfordshire 005A","E01023438","Total",48,19,19,10,5,0,5,0,43,19,14,10
"2011","East Hertfordshire 005B","E01023439","Total",44,16,11,17,0,0,0,0,44,16,11,17
"2011","East Hertfordshire 005C","E01023440","Total",29,14,8,7,1,1,0,0,28,13,8,7
"2011","East Hertfordshire 005D","E01023441","Total",31,13,11,7,3,0,3,0,28,13,8,7
"2011","East Hertfordshire 005E","E01023442","Total",54,23,12,19,8,1,3,4,46,22,9,15
"2011","East Hertfordshire 006A","E01023498","Total",49,13,17,19,2,0,1,1,47,13,16,18
"2011","East Hertfordshire 006B","E01023506","Total",15,5,2,8,1,0,0,1,14,5,2,7
"2011","East Hertfordshire 006C","E01023507","Total",16,8,4,4,0,0,0,0,16,8,4,4
"2011","East Hertfordshire 007A","E01023443","Total",39,22,12,5,2,0,2,0,37,22,10,5
"2011","East Hertfordshire 007B","E01023444","Total",30,11,10,9,2,0,2,0,28,11,8,9
"2011","East Hertfordshire 007C","E01023445","Total",58,22,12,24,7,2,3,2,51,20,9,22
"2011","East Hertfordshire 007D","E01023446","Total",58,23,20,15,6,0,4,2,52,23,16,13
"2011","East Hertfordshire 007E","E01023447","Total",75,24,17,34,3,0,2,1,72,24,15,33
"2011","East Hertfordshire 007F","E01023448","Total",40,14,11,15,5,0,5,0,35,14,6,15
"2011","East Hertfordshire 008A","E01023456","Total",30,10,13,7,0,0,0,0,30,10,13,7
"2011","East Hertfordshire 008B","E01023457","Total",38,24,8,6,1,0,1,0,37,24,7,6
"2011","East Hertfordshire 008C","E01023458","Total",24,8,7,9,3,0,2,1,21,8,5,8
"2011","East Hertfordshire 008D","E01023459","Total",24,10,14,0,2,0,2,0,22,10,12,0
"2011","East Hertfordshire 008E","E01023460","Total",20,7,10,3,6,1,5,0,14,6,5,3
"2011","East Hertfordshire 008F","E01023461","Total",23,10,9,4,3,0,2,1,20,10,7,3
"2011","East Hertfordshire 009A","E01023491","Total",26,12,10,4,1,0,1,0,25,12,9,4
"2011","East Hertfordshire 009B","E01023492","Total",31,12,7,12,2,2,0,0,29,10,7,12
"2011","East Hertfordshire 009C","E01023496","Total",28,12,7,9,0,0,0,0,28,12,7,9
"2011","East Hertfordshire 009D","E01023497","Total",22,10,6,6,3,0,3,0,19,10,3,6
"2011","East Hertfordshire 010A","E01023485","Total",22,11,4,7,3,0,0,3,19,11,4,4
"2011","East Hertfordshire 010B","E01023486","Total",36,11,12,13,2,0,2,0,34,11,10,13
"2011","East Hertfordshire 010E","E01033609","Total",53,22,13,18,4,0,3,1,49,22,10,17
"2011","East Hertfordshire 011A","E01023499","Total",59,24,16,19,4,0,3,1,55,24,13,18
"2011","East Hertfordshire 011B","E01023500","Total",20,6,12,2,5,0,5,0,15,6,7,2
"2011","East Hertfordshire 011C","E01023501","Total",32,13,12,7,2,1,1,0,30,12,11,7
"2011","East Hertfordshire 011D","E01023502","Total",41,19,13,9,6,0,4,2,35,19,9,7
"2011","East Hertfordshire 011E","E01023503","Total",26,10,9,7,4,1,3,0,22,9,6,7
"2011","East Hertfordshire 012A","E01023512","Total",35,12,11,12,1,0,1,0,34,12,10,12
"2011","East Hertfordshire 012B","E01023513","Total",27,6,9,12,2,0,1,1,25,6,8,11
"2011","East Hertfordshire 012C","E01023514","Total",36,9,10,17,3,1,2,0,33,8,8,17
"2011","East Hertfordshire 012D","E01023518","Total",63,21,12,30,6,2,2,2,57,19,10,28
"2011","East Hertfordshire 012E","E01023519","Total",49,14,14,21,3,0,0,3,46,14,14,18
"2011","East Hertfordshire 012F","E01023520","Total",21,8,6,7,3,0,1,2,18,8,5,5
"2011","East Hertfordshire 013A","E01023510","Total",13,4,6,3,1,0,1,0,12,4,5,3
"2011","East Hertfordshire 013B","E01023511","Total",33,9,7,17,4,1,1,2,29,8,6,15
"2011","East Hertfordshire 013C","E01023515","Total",24,9,9,6,2,0,1,1,22,9,8,5
"2011","East Hertfordshire 013D","E01023516","Total",38,14,20,4,4,0,4,0,34,14,16,4
"2011","East Hertfordshire 013E","E01023517","Total",50,19,22,9,5,2,3,0,45,17,19,9
"2011","East Hertfordshire 014A","E01023470","Total",28,9,15,4,2,0,2,0,26,9,13,4
"2011","East Hertfordshire 014B","E01023471","Total",11,4,3,4,0,0,0,0,11,4,3,4
"2011","East Hertfordshire 014C","E01023472","Total",50,20,10,20,4,2,1,1,46,18,9,19
"2011","East Hertfordshire 014D","E01023473","Total",11,6,4,1,1,0,0,1,10,6,4,0
"2011","East Hertfordshire 014E","E01023474","Total",19,8,6,5,1,0,0,1,18,8,6,4
"2011","East Hertfordshire 015A","E01023487","Total",60,17,11,32,6,0,2,4,54,17,9,28
"2011","East Hertfordshire 015B","E01023488","Total",114,25,14,75,5,1,2,2,109,24,12,73
"2011","East Hertfordshire 015C","E01023489","Total",25,11,7,7,0,0,0,0,25,11,7,7
"2011","East Hertfordshire 015D","E01023490","Total",32,6,11,15,1,0,1,0,31,6,10,15
"2011","East Hertfordshire 016A","E01023482","Total",51,25,18,8,4,1,3,0,47,24,15,8
"2011","East Hertfordshire 016B","E01023483","Total",44,15,20,9,4,1,3,0,40,14,17,9
"2011","East Hertfordshire 016C","E01023484","Total",50,15,14,21,5,2,1,2,45,13,13,19
"2011","East Hertfordshire 017A","E01023475","Total",65,27,17,21,6,1,3,2,59,26,14,19
"2011","East Hertfordshire 017B","E01023476","Total",28,5,14,9,2,0,1,1,26,5,13,8
"2011","East Hertfordshire 017C","E01023477","Total",63,18,33,12,12,1,8,3,51,17,25,9
"2011","East Hertfordshire 017D","E01023478","Total",47,13,24,10,9,1,7,1,38,12,17,9
"2011","East Hertfordshire 017E","E01023479","Total",29,12,6,11,1,0,0,1,28,12,6,10
"2011","East Hertfordshire 018A","E01023468","Total",13,5,8,0,5,0,5,0,8,5,3,0
"2011","East Hertfordshire 018B","E01023469","Total",36,16,9,11,3,1,0,2,33,15,9,9
"2011","East Hertfordshire 018C","E01023480","Total",28,7,10,11,4,0,3,1,24,7,7,10
"2011","East Hertfordshire 018D","E01023481","Total",19,5,9,5,3,2,1,0,16,3,8,5
"2011","East Hertfordshire 018E","E01023504","Total",32,10,10,12,3,1,2,0,29,9,8,12
"2011","East Hertfordshire 018F","E01023505","Total",34,13,9,12,2,1,1,0,32,12,8,12
"2011","Hertsmere 001A","E01023576","Total",14,3,6,5,0,0,0,0,14,3,6,5
"2011","Hertsmere 001B","E01023577","Total",25,6,11,8,5,0,4,1,20,6,7,7
"2011","Hertsmere 001C","E01023578","Total",20,10,7,3,3,2,1,0,17,8,6,3
"2011","Hertsmere 001D","E01023579","Total",51,13,24,14,4,0,3,1,47,13,21,13
"2011","Hertsmere 001E","E01023580","Total",40,9,18,13,6,0,5,1,34,9,13,12
"2011","Hertsmere 002A","E01023567","Total",36,11,19,6,6,1,5,0,30,10,14,6
"2011","Hertsmere 002B","E01023568","Total",22,9,8,5,1,1,0,0,21,8,8,5
"2011","Hertsmere 002C","E01023569","Total",49,16,15,18,4,0,1,3,45,16,14,15
"2011","Hertsmere 002D","E01023570","Total",37,16,7,14,4,1,3,0,33,15,4,14
"2011","Hertsmere 003A","E01023571","Total",20,2,16,2,5,0,5,0,15,2,11,2
"2011","Hertsmere 003B","E01023572","Total",35,8,9,18,2,0,1,1,33,8,8,17
"2011","Hertsmere 003C","E01023573","Total",58,25,11,22,2,0,2,0,56,25,9,22
"2011","Hertsmere 003D","E01023574","Total",95,34,21,40,11,1,5,5,84,33,16,35
"2011","Hertsmere 003E","E01023575","Total",30,13,9,8,3,1,1,1,27,12,8,7
"2011","Hertsmere 004A","E01023581","Total",19,8,7,4,1,0,0,1,18,8,7,3
"2011","Hertsmere 004B","E01023582","Total",66,26,15,25,5,1,2,2,61,25,13,23
"2011","Hertsmere 004C","E01023583","Total",42,6,11,25,2,0,1,1,40,6,10,24
"2011","Hertsmere 004D","E01023584","Total",31,8,14,9,3,1,2,0,28,7,12,9
"2011","Hertsmere 005A","E01023523","Total",12,3,4,5,2,0,2,0,10,3,2,5
"2011","Hertsmere 005B","E01023524","Total",18,8,6,4,4,0,2,2,14,8,4,2
"2011","Hertsmere 005C","E01023525","Total",39,11,12,16,1,1,0,0,38,10,12,16
"2011","Hertsmere 005D","E01023526","Total",15,9,2,4,1,0,1,0,14,9,1,4
"2011","Hertsmere 005E","E01023527","Total",40,10,10,20,4,0,2,2,36,10,8,18
"2011","Hertsmere 006A","E01023534","Total",51,15,16,20,6,0,5,1,45,15,11,19
"2011","Hertsmere 006B","E01023535","Total",64,23,14,27,5,0,4,1,59,23,10,26
"2011","Hertsmere 006C","E01023536","Total",103,31,11,61,7,0,1,6,96,31,10,55
"2011","Hertsmere 006D","E01023537","Total",53,21,12,20,8,0,4,4,45,21,8,16
"2011","Hertsmere 006E","E01023538","Total",64,16,18,30,5,0,4,1,59,16,14,29
"2011","Hertsmere 007A","E01023529","Total",61,22,12,27,2,0,1,1,59,22,11,26
"2011","Hertsmere 007B","E01023530","Total",76,23,18,35,6,3,0,3,70,20,18,32
"2011","Hertsmere 007C","E01023531","Total",63,18,14,31,4,0,3,1,59,18,11,30
"2011","Hertsmere 007D","E01023532","Total",30,7,8,15,1,1,0,0,29,6,8,15
"2011","Hertsmere 007E","E01023533","Total",78,25,18,35,3,0,2,1,75,25,16,34
"2011","Hertsmere 008A","E01023552","Total",42,18,14,10,1,0,0,1,41,18,14,9
"2011","Hertsmere 008B","E01023553","Total",21,9,5,7,2,0,1,1,19,9,4,6
"2011","Hertsmere 008C","E01023554","Total",60,18,16,26,3,0,3,0,57,18,13,26
"2011","Hertsmere 008D","E01023555","Total",74,25,15,34,5,2,2,1,69,23,13,33
"2011","Hertsmere 009A","E01023544","Total",37,6,12,19,4,1,2,1,33,5,10,18
"2011","Hertsmere 009B","E01023545","Total",41,16,10,15,6,3,2,1,35,13,8,14
"2011","Hertsmere 009C","E01023546","Total",73,32,17,24,0,0,0,0,73,32,17,24
"2011","Hertsmere 009D","E01023547","Total",73,26,11,36,5,1,2,2,68,25,9,34
"2011","Hertsmere 010A","E01023528","Total",36,14,10,12,3,0,2,1,33,14,8,11
"2011","Hertsmere 010B","E01023564","Total",50,13,20,17,3,1,2,0,47,12,18,17
"2011","Hertsmere 010C","E01023565","Total",33,8,11,14,1,0,1,0,32,8,10,14
"2011","Hertsmere 010D","E01023566","Total",13,5,6,2,2,0,2,0,11,5,4,2
"2011","Hertsmere 011A","E01023539","Total",95,35,21,39,13,4,4,5,82,31,17,34
"2011","Hertsmere 011B","E01023540","Total",41,15,10,16,5,1,2,2,36,14,8,14
"2011","Hertsmere 011C","E01023541","Total",47,22,15,10,4,0,2,2,43,22,13,8
"2011","Hertsmere 011D","E01023542","Total",65,21,18,26,3,0,1,2,62,21,17,24
"2011","Hertsmere 011E","E01023543","Total",51,18,15,18,2,0,0,2,49,18,15,16
"2011","Hertsmere 012A","E01023558","Total",41,15,16,10,6,0,6,0,35,15,10,10
"2011","Hertsmere 012B","E01023559","Total",23,11,7,5,0,0,0,0,23,11,7,5
"2011","Hertsmere 012C","E01023560","Total",60,26,13,21,3,1,2,0,57,25,11,21
"2011","Hertsmere 012D","E01023561","Total",52,13,12,27,2,0,2,0,50,13,10,27
"2011","Hertsmere 012E","E01023562","Total",27,11,9,7,4,1,1,2,23,10,8,5
"2011","Hertsmere 012F","E01023563","Total",40,11,17,12,8,0,7,1,32,11,10,11
"2011","Hertsmere 013A","E01023548","Total",28,13,7,8,1,1,0,0,27,12,7,8
"2011","Hertsmere 013B","E01023549","Total",43,13,19,11,6,0,5,1,37,13,14,10
"2011","Hertsmere 013C","E01023550","Total",9,2,4,3,1,0,1,0,8,2,3,3
"2011","Hertsmere 013D","E01023551","Total",17,8,5,4,4,1,2,1,13,7,3,3
"2011","Hertsmere 013E","E01023556","Total",33,11,11,11,1,0,1,0,32,11,10,11
"2011","Hertsmere 013F","E01023557","Total",34,16,11,7,4,1,3,0,30,15,8,7
"2011","North Hertfordshire 001A","E01023660","Total",34,11,13,10,2,0,2,0,32,11,11,10
"2011","North Hertfordshire 001B","E01023661","Total",48,15,13,20,2,0,2,0,46,15,11,20
"2011","North Hertfordshire 001C","E01023662","Total",38,8,18,12,5,0,5,0,33,8,13,12
"2011","North Hertfordshire 002A","E01023654","Total",17,7,5,5,3,0,3,0,14,7,2,5
"2011","North Hertfordshire 002B","E01023655","Total",31,14,9,8,1,0,1,0,30,14,8,8
"2011","North Hertfordshire 002C","E01023656","Total",59,19,24,16,9,3,4,2,50,16,20,14
"2011","North Hertfordshire 002D","E01023657","Total",18,7,9,2,1,0,1,0,17,7,8,2
"2011","North Hertfordshire 002E","E01023658","Total",44,19,14,11,6,1,4,1,38,18,10,10
"2011","North Hertfordshire 002F","E01023659","Total",11,6,5,0,0,0,0,0,11,6,5,0
"2011","North Hertfordshire 003A","E01023635","Total",45,18,12,15,1,0,1,0,44,18,11,15
"2011","North Hertfordshire 003B","E01023636","Total",51,17,14,20,3,0,2,1,48,17,12,19
"2011","North Hertfordshire 003C","E01023637","Total",62,17,13,32,7,0,4,3,55,17,9,29
"2011","North Hertfordshire 003D","E01023638","Total",45,19,3,23,3,0,1,2,42,19,2,21
"2011","North Hertfordshire 004A","E01023587","Total",22,9,8,5,1,0,1,0,21,9,7,5
"2011","North Hertfordshire 004B","E01023588","Total",20,7,11,2,4,0,4,0,16,7,7,2
"2011","North Hertfordshire 004C","E01023589","Total",31,9,13,9,2,0,1,1,29,9,12,8
"2011","North Hertfordshire 004D","E01023590","Total",36,16,11,9,2,1,0,1,34,15,11,8
"2011","North Hertfordshire 004E","E01023591","Total",20,5,8,7,3,0,2,1,17,5,6,6
"2011","North Hertfordshire 004F","E01023592","Total",54,19,16,19,4,1,3,0,50,18,13,19
"2011","North Hertfordshire 004G","E01023593","Total",57,21,12,24,9,1,3,5,48,20,9,19
"2011","North Hertfordshire 005A","E01023585","Total",9,4,2,3,1,0,0,1,8,4,2,2
"2011","North Hertfordshire 005B","E01023586","Total",29,14,5,10,1,0,0,1,28,14,5,9
"2011","North Hertfordshire 005C","E01023597","Total",21,8,6,7,4,1,3,0,17,7,3,7
"2011","North Hertfordshire 005D","E01023598","Total",33,14,4,15,1,0,0,1,32,14,4,14
"2011","North Hertfordshire 005F","E01023600","Total",34,9,9,16,2,0,0,2,32,9,9,14
"2011","North Hertfordshire 005G","E01023663","Total",49,19,16,14,7,0,6,1,42,19,10,13
"2011","North Hertfordshire 005H","E01033024","Total",25,9,11,5,4,0,3,1,21,9,8,4
"2011","North Hertfordshire 005I","E01033025","Total",34,8,17,9,5,1,4,0,29,7,13,9
"2011","North Hertfordshire 005J","E01033026","Total",32,12,13,7,5,0,5,0,27,12,8,7
"2011","North Hertfordshire 005K","E01033027","Total",45,17,12,16,9,1,7,1,36,16,5,15
"2011","North Hertfordshire 006A","E01023630","Total",51,22,6,23,1,0,0,1,50,22,6,22
"2011","North Hertfordshire 006B","E01023631","Total",60,21,13,26,9,1,4,4,51,20,9,22
"2011","North Hertfordshire 006C","E01023632","Total",32,12,5,15,1,0,0,1,31,12,5,14
"2011","North Hertfordshire 006D","E01023633","Total",61,23,19,19,3,1,2,0,58,22,17,19
"2011","North Hertfordshire 006E","E01023634","Total",15,7,3,5,0,0,0,0,15,7,3,5
"2011","North Hertfordshire 007A","E01023649","Total",39,12,13,14,3,1,2,0,36,11,11,14
"2011","North Hertfordshire 007B","E01023650","Total",61,19,9,33,5,0,1,4,56,19,8,29
"2011","North Hertfordshire 007C","E01023651","Total",29,10,12,7,4,0,4,0,25,10,8,7
"2011","North Hertfordshire 007D","E01023652","Total",56,18,6,32,2,0,0,2,54,18,6,30
"2011","North Hertfordshire 008A","E01023644","Total",26,14,9,3,6,1,4,1,20,13,5,2
"2011","North Hertfordshire 008B","E01023645","Total",42,15,12,15,6,2,2,2,36,13,10,13
"2011","North Hertfordshire 008C","E01023646","Total",88,37,16,35,13,6,4,3,75,31,12,32
"2011","North Hertfordshire 008D","E01023647","Total",13,3,6,4,1,0,0,1,12,3,6,3
"2011","North Hertfordshire 008E","E01023648","Total",6,1,3,2,1,0,1,0,5,1,2,2
"2011","North Hertfordshire 009A","E01023639","Total",27,9,8,10,5,0,2,3,22,9,6,7
"2011","North Hertfordshire 009B","E01023640","Total",53,13,9,31,6,0,3,3,47,13,6,28
"2011","North Hertfordshire 009C","E01023641","Total",72,22,20,30,8,1,2,5,64,21,18,25
"2011","North Hertfordshire 009D","E01023642","Total",13,2,6,5,1,0,0,1,12,2,6,4
"2011","North Hertfordshire 009E","E01023643","Total",60,17,18,25,10,0,7,3,50,17,11,22
"2011","North Hertfordshire 010A","E01023601","Total",54,17,21,16,7,1,6,0,47,16,15,16
"2011","North Hertfordshire 010B","E01023602","Total",30,11,11,8,4,2,1,1,26,9,10,7
"2011","North Hertfordshire 010C","E01023603","Total",35,13,11,11,6,1,4,1,29,12,7,10
"2011","North Hertfordshire 010D","E01023604","Total",25,10,7,8,2,0,1,1,23,10,6,7
"2011","North Hertfordshire 010E","E01023605","Total",55,18,14,23,6,0,5,1,49,18,9,22
"2011","North Hertfordshire 011A","E01023617","Total",31,13,15,3,1,0,0,1,30,13,15,2
"2011","North Hertfordshire 011B","E01023618","Total",37,16,9,12,2,0,2,0,35,16,7,12
"2011","North Hertfordshire 011C","E01023619","Total",28,13,11,4,7,0,5,2,21,13,6,2
"2011","North Hertfordshire 011D","E01023620","Total",52,21,15,16,2,0,1,1,50,21,14,15
"2011","North Hertfordshire 011E","E01023621","Total",40,10,13,17,3,1,2,0,37,9,11,17
"2011","North Hertfordshire 012A","E01023611","Total",78,22,21,35,5,3,2,0,73,19,19,35
"2011","North Hertfordshire 012B","E01023612","Total",51,28,13,10,2,0,2,0,49,28,11,10
"2011","North Hertfordshire 012C","E01023613","Total",93,28,18,47,6,2,1,3,87,26,17,44
"2011","North Hertfordshire 012D","E01023614","Total",25,10,12,3,4,1,2,1,21,9,10,2
"2011","North Hertfordshire 012E","E01023615","Total",18,5,10,3,3,1,2,0,15,4,8,3
"2011","North Hertfordshire 012F","E01023616","Total",36,10,17,9,4,0,4,0,32,10,13,9
"2011","North Hertfordshire 013A","E01023606","Total",65,30,21,14,6,0,5,1,59,30,16,13
"2011","North Hertfordshire 013B","E01023607","Total",30,10,14,6,3,1,2,0,27,9,12,6
"2011","North Hertfordshire 013C","E01023608","Total",20,8,11,1,2,0,2,0,18,8,9,1
"2011","North Hertfordshire 013D","E01023609","Total",25,5,10,10,1,0,1,0,24,5,9,10
"2011","North Hertfordshire 013E","E01023610","Total",18,10,7,1,4,1,3,0,14,9,4,1
"2011","North Hertfordshire 014A","E01023594","Total",65,29,20,16,8,2,3,3,57,27,17,13
"2011","North Hertfordshire 014B","E01023622","Total",30,11,14,5,2,0,2,0,28,11,12,5
"2011","North Hertfordshire 014C","E01023623","Total",19,7,5,7,6,1,2,3,13,6,3,4
"2011","North Hertfordshire 014D","E01023624","Total",28,10,10,8,3,2,0,1,25,8,10,7
"2011","North Hertfordshire 014E","E01023625","Total",18,10,7,1,3,1,2,0,15,9,5,1
"2011","North Hertfordshire 014F","E01023653","Total",44,14,19,11,4,0,3,1,40,14,16,10
"2011","North Hertfordshire 015A","E01023595","Total",22,10,11,1,0,0,0,0,22,10,11,1
"2011","North Hertfordshire 015B","E01023596","Total",22,12,6,4,2,0,2,0,20,12,4,4
"2011","North Hertfordshire 015C","E01023626","Total",37,17,9,11,6,0,4,2,31,17,5,9
"2011","North Hertfordshire 015D","E01023627","Total",19,7,6,6,1,0,1,0,18,7,5,6
"2011","North Hertfordshire 015E","E01023628","Total",48,21,21,6,5,0,5,0,43,21,16,6
"2011","North Hertfordshire 015F","E01023629","Total",36,16,8,12,3,1,2,0,33,15,6,12
"2011","St Albans 001A","E01023690","Total",26,11,12,3,5,0,5,0,21,11,7,3
"2011","St Albans 001B","E01023691","Total",11,1,7,3,4,0,4,0,7,1,3,3
"2011","St Albans 001C","E01023692","Total",57,25,12,20,2,0,1,1,55,25,11,19
"2011","St Albans 001D","E01023693","Total",20,8,9,3,2,1,1,0,18,7,8,3
"2011","St Albans 001E","E01023694","Total",20,11,6,3,0,0,0,0,20,11,6,3
"2011","St Albans 002A","E01023685","Total",30,12,12,6,2,0,1,1,28,12,11,5
"2011","St Albans 002B","E01023686","Total",9,4,2,3,0,0,0,0,9,4,2,3
"2011","St Albans 002C","E01023687","Total",63,22,13,28,3,1,1,1,60,21,12,27
"2011","St Albans 002D","E01023688","Total",46,10,18,18,7,1,6,0,39,9,12,18
"2011","St Albans 002E","E01023689","Total",16,9,4,3,2,0,1,1,14,9,3,2
"2011","St Albans 003A","E01023699","Total",9,4,2,3,2,1,0,1,7,3,2,2
"2011","St Albans 003B","E01023700","Total",7,4,2,1,0,0,0,0,7,4,2,1
"2011","St Albans 003C","E01023701","Total",40,16,13,11,9,2,5,2,31,14,8,9
"2011","St Albans 003D","E01023702","Total",18,8,8,2,3,1,2,0,15,7,6,2
"2011","St Albans 003E","E01023703","Total",14,5,7,2,1,0,1,0,13,5,6,2
"2011","St Albans 004A","E01023746","Total",84,26,14,44,7,1,3,3,77,25,11,41
"2011","St Albans 004B","E01023747","Total",30,13,11,6,1,0,1,0,29,13,10,6
"2011","St Albans 004C","E01023748","Total",14,5,3,6,2,0,2,0,12,5,1,6
"2011","St Albans 004D","E01023749","Total",28,11,4,13,0,0,0,0,28,11,4,13
"2011","St Albans 005A","E01023695","Total",14,4,8,2,1,0,1,0,13,4,7,2
"2011","St Albans 005B","E01023696","Total",9,3,1,5,2,1,1,0,7,2,0,5
"2011","St Albans 005C","E01023697","Total",39,16,15,8,5,1,4,0,34,15,11,8
"2011","St Albans 005D","E01023698","Total",6,3,1,2,1,0,1,0,5,3,0,2
"2011","St Albans 006A","E01023722","Total",14,4,7,3,2,0,2,0,12,4,5,3
"2011","St Albans 006B","E01023723","Total",64,29,16,19,6,2,4,0,58,27,12,19
"2011","St Albans 006C","E01023724","Total",29,11,11,7,2,0,1,1,27,11,10,6
"2011","St Albans 006D","E01023725","Total",20,10,6,4,2,0,1,1,18,10,5,3
"2011","St Albans 007A","E01023713","Total",36,14,8,14,4,0,2,2,32,14,6,12
"2011","St Albans 007B","E01023734","Total",27,8,13,6,4,0,2,2,23,8,11,4
"2011","St Albans 007C","E01023735","Total",37,12,16,9,6,0,4,2,31,12,12,7
"2011","St Albans 007D","E01023736","Total",30,10,12,8,1,0,1,0,29,10,11,8
"2011","St Albans 008A","E01023709","Total",40,16,17,7,6,1,4,1,34,15,13,6
"2011","St Albans 008B","E01023710","Total",11,1,8,2,5,0,5,0,6,1,3,2
"2011","St Albans 008C","E01023711","Total",26,6,9,11,3,1,1,1,23,5,8,10
"2011","St Albans 008D","E01023712","Total",42,9,16,17,4,1,3,0,38,8,13,17
"2011","St Albans 009A","E01023669","Total",81,26,21,34,9,0,5,4,72,26,16,30
"2011","St Albans 009B","E01023670","Total",32,10,9,13,2,1,1,0,30,9,8,13
"2011","St Albans 009C","E01023671","Total",52,14,20,18,7,0,6,1,45,14,14,17
"2011","St Albans 009D","E01023672","Total",39,14,15,10,4,0,2,2,35,14,13,8
"2011","St Albans 010A","E01023673","Total",13,4,4,5,1,0,0,1,12,4,4,4
"2011","St Albans 010B","E01023714","Total",20,7,10,3,2,1,1,0,18,6,9,3
"2011","St Albans 010C","E01023715","Total",14,4,4,6,3,0,2,1,11,4,2,5
"2011","St Albans 010D","E01023716","Total",27,12,11,4,2,1,1,0,25,11,10,4
"2011","St Albans 011A","E01023666","Total",36,8,10,18,1,0,1,0,35,8,9,18
"2011","St Albans 011B","E01023674","Total",33,12,16,5,5,0,4,1,28,12,12,4
"2011","St Albans 011C","E01023675","Total",8,3,5,0,1,0,1,0,7,3,4,0
"2011","St Albans 011D","E01023676","Total",63,17,24,22,12,2,6,4,51,15,18,18
"2011","St Albans 012A","E01023726","Total",21,5,11,5,0,0,0,0,21,5,11,5
"2011","St Albans 012B","E01023727","Total",34,12,5,17,1,0,1,0,33,12,4,17
"2011","St Albans 012C","E01023728","Total",28,7,12,9,7,0,6,1,21,7,6,8
"2011","St Albans 012D","E01023729","Total",59,14,25,20,12,1,10,1,47,13,15,19
"2011","St Albans 013A","E01023664","Total",43,14,18,11,4,0,4,0,39,14,14,11
"2011","St Albans 013B","E01023665","Total",28,6,18,4,5,0,5,0,23,6,13,4
"2011","St Albans 013C","E01023667","Total",23,3,12,8,2,0,2,0,21,3,10,8
"2011","St Albans 013D","E01023668","Total",16,4,9,3,2,0,2,0,14,4,7,3
"2011","St Albans 014A","E01023742","Total",11,6,4,1,2,1,1,0,9,5,3,1
"2011","St Albans 014B","E01023743","Total",11,6,3,2,2,1,1,0,9,5,2,2
"2011","St Albans 014C","E01023744","Total",15,4,8,3,3,0,3,0,12,4,5,3
"2011","St Albans 014D","E01023745","Total",22,8,9,5,2,0,1,1,20,8,8,4
"2011","St Albans 015A","E01023677","Total",53,17,18,18,5,0,4,1,48,17,14,17
"2011","St Albans 015B","E01023678","Total",37,10,15,12,6,0,4,2,31,10,11,10
"2011","St Albans 015C","E01023679","Total",37,13,14,10,5,0,5,0,32,13,9,10
"2011","St Albans 015D","E01023680","Total",38,10,13,15,3,1,2,0,35,9,11,15
"2011","St Albans 016A","E01023681","Total",45,12,9,24,3,1,1,1,42,11,8,23
"2011","St Albans 016B","E01023682","Total",30,12,10,8,3,0,2,1,27,12,8,7
"2011","St Albans 016C","E01023683","Total",48,14,8,26,1,0,0,1,47,14,8,25
"2011","St Albans 016D","E01023684","Total",18,3,13,2,4,0,4,0,14,3,9,2
"2011","St Albans 017A","E01023737","Total",41,16,14,11,3,1,2,0,38,15,12,11
"2011","St Albans 017B","E01023738","Total",42,14,9,19,2,0,1,1,40,14,8,18
"2011","St Albans 017C","E01023739","Total",34,11,8,15,2,0,2,0,32,11,6,15
"2011","St Albans 017D","E01023740","Total",32,5,14,13,4,1,3,0,28,4,11,13
"2011","St Albans 017E","E01023741","Total",30,8,13,9,2,0,1,1,28,8,12,8
"2011","St Albans 018A","E01023704","Total",50,15,17,18,3,1,2,0,47,14,15,18
"2011","St Albans 018B","E01023705","Total",55,20,13,22,6,0,3,3,49,20,10,19
"2011","St Albans 018C","E01023706","Total",46,13,17,16,6,0,3,3,40,13,14,13
"2011","St Albans 018E","E01023708","Total",36,13,10,13,5,0,2,3,31,13,8,10
"2011","St Albans 018F","E01033028","Total",45,14,18,13,5,0,5,0,40,14,13,13
"2011","St Albans 018G","E01033029","Total",42,9,14,19,1,0,1,0,41,9,13,19
"2011","St Albans 019A","E01023718","Total",22,9,6,7,3,0,3,0,19,9,3,7
"2011","St Albans 019B","E01023719","Total",36,13,12,11,3,0,3,0,33,13,9,11
"2011","St Albans 019C","E01023720","Total",56,22,13,21,4,0,3,1,52,22,10,20
"2011","St Albans 019D","E01023721","Total",14,7,2,5,5,0,2,3,9,7,0,2
"2011","St Albans 020A","E01023717","Total",27,12,14,1,3,0,2,1,24,12,12,0
"2011","St Albans 020B","E01023730","Total",22,12,7,3,1,0,1,0,21,12,6,3
"2011","St Albans 020C","E01023731","Total",23,10,7,6,2,1,1,0,21,9,6,6
"2011","St Albans 020D","E01023732","Total",25,13,7,5,1,0,1,0,24,13,6,5
"2011","St Albans 020E","E01023733","Total",27,10,12,5,6,2,4,0,21,8,8,5
"2011","Stevenage 001A","E01023787","Total",39,15,9,15,5,0,3,2,34,15,6,13
"2011","Stevenage 001B","E01023788","Total",57,15,17,25,6,0,6,0,51,15,11,25
"2011","Stevenage 001C","E01023789","Total",87,18,26,43,9,0,6,3,78,18,20,40
"2011","Stevenage 001D","E01023790","Total",78,33,14,31,2,0,1,1,76,33,13,30
"2011","Stevenage 002A","E01023776","Total",75,22,17,36,6,1,3,2,69,21,14,34
"2011","Stevenage 002B","E01023777","Total",39,20,11,8,3,1,2,0,36,19,9,8
"2011","Stevenage 002C","E01023778","Total",78,27,21,30,7,1,3,3,71,26,18,27
"2011","Stevenage 002D","E01023799","Total",37,6,11,20,3,0,2,1,34,6,9,19
"2011","Stevenage 002E","E01023800","Total",35,14,10,11,3,0,1,2,32,14,9,9
"2011","Stevenage 002F","E01023801","Total",118,35,29,54,11,1,7,3,107,34,22,51
"2011","Stevenage 003A","E01023771","Total",48,23,13,12,7,3,4,0,41,20,9,12
"2011","Stevenage 003B","E01023772","Total",53,21,13,19,7,0,3,4,46,21,10,15
"2011","Stevenage 003C","E01023773","Total",82,26,16,40,7,0,5,2,75,26,11,38
"2011","Stevenage 003D","E01023774","Total",74,29,18,27,13,11,1,1,61,18,17,26
"2011","Stevenage 004A","E01023767","Total",24,9,11,4,2,0,2,0,22,9,9,4
"2011","Stevenage 004B","E01023768","Total",34,12,17,5,4,0,3,1,30,12,14,4
"2011","Stevenage 004C","E01023769","Total",57,34,12,11,8,6,2,0,49,28,10,11
"2011","Stevenage 004D","E01023770","Total",25,4,13,8,6,1,5,0,19,3,8,8
"2011","Stevenage 005A","E01023795","Total",49,17,15,17,3,0,3,0,46,17,12,17
"2011","Stevenage 005B","E01023796","Total",50,19,12,19,8,0,5,3,42,19,7,16
"2011","Stevenage 005C","E01023797","Total",47,17,14,16,5,1,3,1,42,16,11,15
"2011","Stevenage 005D","E01023798","Total",53,21,12,20,5,0,1,4,48,21,11,16
"2011","Stevenage 006A","E01023775","Total",63,20,20,23,9,0,4,5,54,20,16,18
"2011","Stevenage 006B","E01023779","Total",75,25,16,34,8,0,5,3,67,25,11,31
"2011","Stevenage 006C","E01023780","Total",33,10,11,12,5,0,4,1,28,10,7,11
"2011","Stevenage 006D","E01023781","Total",54,15,15,24,4,0,3,1,50,15,12,23
"2011","Stevenage 006E","E01023782","Total",42,15,11,16,4,1,3,0,38,14,8,16
"2011","Stevenage 007A","E01023759","Total",56,28,12,16,1,1,0,0,55,27,12,16
"2011","Stevenage 007B","E01023760","Total",49,14,16,19,5,1,2,2,44,13,14,17
"2011","Stevenage 007C","E01023761","Total",91,42,14,35,11,1,5,5,80,41,9,30
"2011","Stevenage 007D","E01023762","Total",50,20,15,15,5,0,3,2,45,20,12,13
"2011","Stevenage 008A","E01023755","Total",61,19,12,30,9,0,2,7,52,19,10,23
"2011","Stevenage 008B","E01023756","Total",83,27,15,41,6,0,3,3,77,27,12,38
"2011","Stevenage 008C","E01023757","Total",91,34,11,46,8,1,2,5,83,33,9,41
"2011","Stevenage 008D","E01023758","Total",95,22,21,52,10,0,5,5,85,22,16,47
"2011","Stevenage 009A","E01023750","Total",43,14,11,18,4,3,0,1,39,11,11,17
"2011","Stevenage 009B","E01023751","Total",36,13,5,18,3,0,1,2,33,13,4,16
"2011","Stevenage 009C","E01023752","Total",53,14,13,26,5,0,4,1,48,14,9,25
"2011","Stevenage 009D","E01023753","Total",29,13,10,6,2,0,2,0,27,13,8,6
"2011","Stevenage 009E","E01023754","Total",55,15,23,17,4,0,4,0,51,15,19,17
"2011","Stevenage 010A","E01023791","Total",48,14,11,23,4,0,3,1,44,14,8,22
"2011","Stevenage 010B","E01023792","Total",78,31,14,33,7,4,3,0,71,27,11,33
"2011","Stevenage 010C","E01023793","Total",76,26,13,37,1,0,1,0,75,26,12,37
"2011","Stevenage 010D","E01023794","Total",55,17,14,24,8,2,2,4,47,15,12,20
"2011","Stevenage 011A","E01023783","Total",57,17,18,22,10,2,4,4,47,15,14,18
"2011","Stevenage 011B","E01023784","Total",47,17,9,21,2,0,1,1,45,17,8,20
"2011","Stevenage 011C","E01023785","Total",71,18,15,38,8,1,2,5,63,17,13,33
"2011","Stevenage 011D","E01023786","Total",57,21,14,22,3,2,0,1,54,19,14,21
"2011","Stevenage 012A","E01023763","Total",45,21,14,10,7,1,3,3,38,20,11,7
"2011","Stevenage 012B","E01023764","Total",35,11,8,16,7,2,3,2,28,9,5,14
"2011","Stevenage 012C","E01023765","Total",41,15,13,13,4,1,2,1,37,14,11,12
"2011","Stevenage 012D","E01023766","Total",77,23,18,36,3,1,2,0,74,22,16,36
"2011","Three Rivers 001A","E01023802","Total",38,15,17,6,5,0,5,0,33,15,12,6
"2011","Three Rivers 001B","E01023803","Total",5,2,2,1,0,0,0,0,5,2,2,1
"2011","Three Rivers 001C","E01023804","Total",54,17,16,21,3,0,1,2,51,17,15,19
"2011","Three Rivers 001D","E01023807","Total",35,12,9,14,0,0,0,0,35,12,9,14
"2011","Three Rivers 001E","E01023808","Total",66,13,29,24,12,0,9,3,54,13,20,21
"2011","Three Rivers 002A","E01023829","Total",75,20,16,39,1,0,1,0,74,20,15,39
"2011","Three Rivers 002B","E01023830","Total",32,12,7,13,3,0,2,1,29,12,5,12
"2011","Three Rivers 002C","E01023832","Total",59,22,20,17,5,1,3,1,54,21,17,16
"2011","Three Rivers 002D","E01023833","Total",60,20,19,21,6,0,5,1,54,20,14,20
"2011","Three Rivers 002E","E01023834","Total",28,9,13,6,4,1,3,0,24,8,10,6
"2011","Three Rivers 003A","E01023823","Total",33,12,11,10,3,1,1,1,30,11,10,9
"2011","Three Rivers 003B","E01023824","Total",25,11,9,5,0,0,0,0,25,11,9,5
"2011","Three Rivers 003C","E01023831","Total",51,22,17,12,5,0,2,3,46,22,15,9
"2011","Three Rivers 003D","E01023854","Total",23,11,8,4,6,1,5,0,17,10,3,4
"2011","Three Rivers 004A","E01023812","Total",13,3,4,6,1,0,1,0,12,3,3,6
"2011","Three Rivers 004B","E01023813","Total",19,9,8,2,2,0,2,0,17,9,6,2
"2011","Three Rivers 004C","E01023814","Total",15,9,4,2,2,2,0,0,13,7,4,2
"2011","Three Rivers 004D","E01023851","Total",26,7,12,7,4,0,4,0,22,7,8,7
"2011","Three Rivers 005A","E01023815","Total",20,10,3,7,4,1,1,2,16,9,2,5
"2011","Three Rivers 005B","E01023816","Total",22,13,4,5,1,0,1,0,21,13,3,5
"2011","Three Rivers 005C","E01023817","Total",27,11,11,5,10,0,9,1,17,11,2,4
"2011","Three Rivers 005D","E01023818","Total",7,2,4,1,2,0,2,0,5,2,2,1
"2011","Three Rivers 006A","E01023819","Total",56,20,16,20,2,0,1,1,54,20,15,19
"2011","Three Rivers 006B","E01023820","Total",22,9,9,4,3,1,2,0,19,8,7,4
"2011","Three Rivers 006C","E01023821","Total",19,11,6,2,2,1,1,0,17,10,5,2
"2011","Three Rivers 006D","E01023822","Total",26,13,12,1,4,1,3,0,22,12,9,1
"2011","Three Rivers 006E","E01023825","Total",46,14,18,14,12,1,8,3,34,13,10,11
"2011","Three Rivers 006F","E01023826","Total",24,11,8,5,1,0,1,0,23,11,7,5
"2011","Three Rivers 007A","E01023847","Total",56,17,18,21,6,0,4,2,50,17,14,19
"2011","Three Rivers 007B","E01023848","Total",48,14,11,23,4,0,3,1,44,14,8,22
"2011","Three Rivers 007C","E01023850","Total",25,13,5,7,2,1,1,0,23,12,4,7
"2011","Three Rivers 007D","E01023852","Total",26,11,6,9,1,1,0,0,25,10,6,9
"2011","Three Rivers 007E","E01023853","Total",17,9,7,1,2,0,2,0,15,9,5,1
"2011","Three Rivers 008A","E01023827","Total",89,27,18,44,7,0,6,1,82,27,12,43
"2011","Three Rivers 008B","E01023828","Total",65,24,11,30,7,1,4,2,58,23,7,28
"2011","Three Rivers 008C","E01023845","Total",77,21,27,29,4,0,2,2,73,21,25,27
"2011","Three Rivers 008D","E01023846","Total",24,8,8,8,2,0,2,0,22,8,6,8
"2011","Three Rivers 009A","E01023835","Total",35,11,16,8,5,0,5,0,30,11,11,8
"2011","Three Rivers 009B","E01023836","Total",49,14,18,17,5,0,4,1,44,14,14,16
"2011","Three Rivers 009C","E01023837","Total",33,8,11,14,2,0,2,0,31,8,9,14
"2011","Three Rivers 009D","E01023838","Total",70,26,17,27,6,0,6,0,64,26,11,27
"2011","Three Rivers 010A","E01023805","Total",73,30,14,29,5,0,3,2,68,30,11,27
"2011","Three Rivers 010B","E01023809","Total",39,13,13,13,3,0,3,0,36,13,10,13
"2011","Three Rivers 010C","E01023810","Total",23,5,7,11,1,0,0,1,22,5,7,10
"2011","Three Rivers 010D","E01023811","Total",17,5,8,4,2,0,1,1,15,5,7,3
"2011","Three Rivers 011A","E01023839","Total",14,6,6,2,3,0,3,0,11,6,3,2
"2011","Three Rivers 011B","E01023840","Total",14,3,9,2,1,0,1,0,13,3,8,2
"2011","Three Rivers 011C","E01023841","Total",11,3,2,6,1,0,1,0,10,3,1,6
"2011","Three Rivers 011D","E01023849","Total",13,3,4,6,4,0,2,2,9,3,2,4
"2011","Three Rivers 012A","E01023806","Total",86,39,23,24,11,1,10,0,75,38,13,24
"2011","Three Rivers 012B","E01023842","Total",82,29,14,39,5,1,2,2,77,28,12,37
"2011","Three Rivers 012C","E01023843","Total",87,33,20,34,8,4,3,1,79,29,17,33
"2011","Three Rivers 012D","E01023844","Total",103,31,23,49,4,1,3,0,99,30,20,49
"2011","Watford 001A","E01023904","Total",63,29,16,18,7,1,3,3,56,28,13,15
"2011","Watford 001B","E01023905","Total",70,24,23,23,7,0,5,2,63,24,18,21
"2011","Watford 001C","E01023906","Total",64,24,16,24,6,2,2,2,58,22,14,22
"2011","Watford 001D","E01023907","Total",32,11,12,9,4,0,3,1,28,11,9,8
"2011","Watford 002A","E01023890","Total",21,8,9,4,2,1,1,0,19,7,8,4
"2011","Watford 002B","E01023891","Total",81,31,22,28,4,0,4,0,77,31,18,28
"2011","Watford 002C","E01023892","Total",47,14,18,15,0,0,0,0,47,14,18,15
"2011","Watford 002D","E01023893","Total",44,20,14,10,2,0,2,0,42,20,12,10
"2011","Watford 002E","E01023894","Total",34,10,12,12,2,0,0,2,32,10,12,10
"2011","Watford 003A","E01023873","Total",64,17,17,30,5,0,4,1,59,17,13,29
"2011","Watford 003B","E01023874","Total",34,11,8,15,1,0,1,0,33,11,7,15
"2011","Watford 003C","E01023875","Total",40,16,19,5,7,1,6,0,33,15,13,5
"2011","Watford 003D","E01023876","Total",143,45,28,70,14,0,6,8,129,45,22,62
"2011","Watford 003E","E01023877","Total",54,13,17,24,5,0,5,0,49,13,12,24
"2011","Watford 004A","E01023868","Total",67,22,19,26,5,0,4,1,62,22,15,25
"2011","Watford 004B","E01023869","Total",36,8,11,17,1,0,1,0,35,8,10,17
"2011","Watford 004C","E01023870","Total",59,13,16,30,5,0,2,3,54,13,14,27
"2011","Watford 004D","E01023871","Total",41,13,16,12,7,2,4,1,34,11,12,11
"2011","Watford 004E","E01023872","Total",28,6,15,7,5,0,3,2,23,6,12,5
"2011","Watford 005A","E01023895","Total",25,8,11,6,4,1,3,0,21,7,8,6
"2011","Watford 005B","E01023896","Total",27,13,8,6,2,0,1,1,25,13,7,5
"2011","Watford 005C","E01023897","Total",27,11,8,8,7,0,4,3,20,11,4,5
"2011","Watford 005D","E01023898","Total",15,4,6,5,4,0,3,1,11,4,3,4
"2011","Watford 006A","E01023855","Total",58,17,18,23,7,0,4,3,51,17,14,20
"2011","Watford 006B","E01023856","Total",84,41,23,20,6,3,2,1,78,38,21,19
"2011","Watford 006C","E01023857","Total",63,12,15,36,23,0,4,19,40,12,11,17
"2011","Watford 006D","E01023858","Total",58,17,23,18,9,0,2,7,49,17,21,11
"2011","Watford 007A","E01023878","Total",30,8,11,11,4,1,3,0,26,7,8,11
"2011","Watford 007B","E01023879","Total",63,10,21,32,2,0,2,0,61,10,19,32
"2011","Watford 007C","E01023880","Total",40,14,16,10,3,0,0,3,37,14,16,7
"2011","Watford 007D","E01023881","Total",22,7,10,5,2,0,2,0,20,7,8,5
"2011","Watford 008A","E01023886","Total",85,27,28,30,9,2,6,1,76,25,22,29
"2011","Watford 008B","E01023887","Total",19,8,5,6,4,0,3,1,15,8,2,5
"2011","Watford 008C","E01023888","Total",34,9,10,15,7,0,4,3,27,9,6,12
"2011","Watford 008D","E01023889","Total",15,6,6,3,3,0,3,0,12,6,3,3
"2011","Watford 009A","E01023859","Total",57,15,16,26,5,1,3,1,52,14,13,25
"2011","Watford 009B","E01023860","Total",70,19,12,39,4,0,3,1,66,19,9,38
"2011","Watford 009C","E01023861","Total",42,13,16,13,3,0,2,1,39,13,14,12
"2011","Watford 009D","E01023862","Total",45,14,16,15,6,1,3,2,39,13,13,13
"2011","Watford 010A","E01023899","Total",26,8,7,11,3,0,1,2,23,8,6,9
"2011","Watford 010B","E01023900","Total",28,14,10,4,1,0,1,0,27,14,9,4
"2011","Watford 010C","E01023901","Total",54,20,16,18,4,1,3,0,50,19,13,18
"2011","Watford 010D","E01023902","Total",39,14,21,4,8,2,6,0,31,12,15,4
"2011","Watford 010E","E01023903","Total",35,15,10,10,4,0,3,1,31,15,7,9
"2011","Watford 011A","E01023863","Total",47,17,17,13,12,2,9,1,35,15,8,12
"2011","Watford 011B","E01023864","Total",50,20,16,14,2,0,2,0,48,20,14,14
"2011","Watford 011C","E01023865","Total",93,40,15,38,2,0,2,0,91,40,13,38
"2011","Watford 011D","E01023866","Total",105,29,23,53,4,2,0,2,101,27,23,51
"2011","Watford 011E","E01023867","Total",74,30,21,23,11,4,3,4,63,26,18,19
"2011","Watford 012A","E01023882","Total",25,13,8,4,1,0,1,0,24,13,7,4
"2011","Watford 012B","E01023883","Total",60,18,13,29,5,0,1,4,55,18,12,25
"2011","Watford 012C","E01023884","Total",64,19,27,18,11,2,6,3,53,17,21,15
"2011","Watford 012D","E01023885","Total",32,11,13,8,3,1,1,1,29,10,12,7
"2011","Welwyn Hatfield 001A","E01023965","Total",16,7,5,4,2,1,1,0,14,6,4,4
"2011","Welwyn Hatfield 001B","E01023966","Total",14,3,9,2,1,0,1,0,13,3,8,2
"2011","Welwyn Hatfield 001C","E01023967","Total",31,11,12,8,6,3,2,1,25,8,10,7
"2011","Welwyn Hatfield 001D","E01023971","Total",15,4,7,4,4,0,3,1,11,4,4,3
"2011","Welwyn Hatfield 002B","E01023968","Total",19,4,8,7,3,0,2,1,16,4,6,6
"2011","Welwyn Hatfield 002C","E01023969","Total",14,3,7,4,2,0,2,0,12,3,5,4
"2011","Welwyn Hatfield 002D","E01023970","Total",51,23,9,19,3,0,0,3,48,23,9,16
"2011","Welwyn Hatfield 002E","E01033310","Total",49,18,16,15,6,1,4,1,43,17,12,14
"2011","Welwyn Hatfield 002F","E01033313","Total",38,13,15,10,3,0,2,1,35,13,13,9
"2011","Welwyn Hatfield 003A","E01023959","Total",14,6,7,1,4,1,3,0,10,5,4,1
"2011","Welwyn Hatfield 003B","E01023960","Total",49,16,17,16,6,0,5,1,43,16,12,15
"2011","Welwyn Hatfield 003C","E01023961","Total",57,17,17,23,4,1,2,1,53,16,15,22
"2011","Welwyn Hatfield 003D","E01023962","Total",41,13,17,11,3,0,2,1,38,13,15,10
"2011","Welwyn Hatfield 004A","E01023912","Total",28,10,10,8,4,0,3,1,24,10,7,7
"2011","Welwyn Hatfield 004B","E01023913","Total",36,16,6,14,3,0,1,2,33,16,5,12
"2011","Welwyn Hatfield 004C","E01023914","Total",58,21,15,22,4,1,3,0,54,20,12,22
"2011","Welwyn Hatfield 004D","E01023915","Total",58,20,15,23,6,1,2,3,52,19,13,20
"2011","Welwyn Hatfield 005A","E01023950","Total",28,9,13,6,2,0,2,0,26,9,11,6
"2011","Welwyn Hatfield 005B","E01023951","Total",57,19,13,25,4,1,1,2,53,18,12,23
"2011","Welwyn Hatfield 005C","E01023952","Total",39,11,16,12,2,0,2,0,37,11,14,12
"2011","Welwyn Hatfield 005D","E01023953","Total",26,10,7,9,4,0,4,0,22,10,3,9
"2011","Welwyn Hatfield 006A","E01023916","Total",55,18,21,16,7,0,5,2,48,18,16,14
"2011","Welwyn Hatfield 006B","E01023917","Total",23,10,8,5,3,1,2,0,20,9,6,5
"2011","Welwyn Hatfield 006C","E01023918","Total",16,3,5,8,3,0,2,1,13,3,3,7
"2011","Welwyn Hatfield 006D","E01023919","Total",25,9,11,5,7,0,7,0,18,9,4,5
"2011","Welwyn Hatfield 007A","E01023954","Total",96,39,15,42,6,1,2,3,90,38,13,39
"2011","Welwyn Hatfield 007B","E01023955","Total",56,20,17,19,3,0,2,1,53,20,15,18
"2011","Welwyn Hatfield 007C","E01023956","Total",64,18,21,25,1,0,1,0,63,18,20,25
"2011","Welwyn Hatfield 007D","E01023957","Total",69,29,15,25,4,0,2,2,65,29,13,23
"2011","Welwyn Hatfield 007E","E01023958","Total",88,25,11,52,7,4,0,3,81,21,11,49
"2011","Welwyn Hatfield 008A","E01023943","Total",50,19,9,22,3,0,2,1,47,19,7,21
"2011","Welwyn Hatfield 008B","E01023944","Total",71,23,18,30,9,0,5,4,62,23,13,26
"2011","Welwyn Hatfield 008C","E01023945","Total",55,19,18,18,6,0,4,2,49,19,14,16
"2011","Welwyn Hatfield 008D","E01023946","Total",20,7,5,8,1,1,0,0,19,6,5,8
"2011","Welwyn Hatfield 009A","E01023939","Total",29,11,9,9,5,2,1,2,24,9,8,7
"2011","Welwyn Hatfield 009B","E01023940","Total",54,20,17,17,5,1,3,1,49,19,14,16
"2011","Welwyn Hatfield 009C","E01023941","Total",91,27,29,35,9,1,8,0,82,26,21,35
"2011","Welwyn Hatfield 009D","E01023942","Total",55,25,13,17,5,0,4,1,50,25,9,16
"2011","Welwyn Hatfield 010A","E01023929","Total",59,26,16,17,8,2,4,2,51,24,12,15
"2011","Welwyn Hatfield 010B","E01023930","Total",56,24,13,19,6,1,4,1,50,23,9,18
"2011","Welwyn Hatfield 010D","E01023938","Total",23,10,9,4,4,0,4,0,19,10,5,4
"2011","Welwyn Hatfield 010E","E01033308","Total",43,12,12,19,5,0,3,2,38,12,9,17
"2011","Welwyn Hatfield 010F","E01033311","Total",41,12,20,9,6,0,5,1,35,12,15,8
"2011","Welwyn Hatfield 010G","E01033314","Total",56,19,16,21,2,0,1,1,54,19,15,20
"2011","Welwyn Hatfield 011A","E01023924","Total",42,14,10,18,4,0,4,0,38,14,6,18
"2011","Welwyn Hatfield 011B","E01023925","Total",21,6,5,10,2,0,0,2,19,6,5,8
"2011","Welwyn Hatfield 011C","E01023926","Total",22,8,10,4,7,0,6,1,15,8,4,3
"2011","Welwyn Hatfield 011D","E01023927","Total",82,31,14,37,6,2,1,3,76,29,13,34
"2011","Welwyn Hatfield 012A","E01023920","Total",70,14,23,33,6,0,6,0,64,14,17,33
"2011","Welwyn Hatfield 012B","E01023921","Total",70,19,13,38,7,2,2,3,63,17,11,35
"2011","Welwyn Hatfield 012C","E01023922","Total",67,15,16,36,8,1,1,6,59,14,15,30
"2011","Welwyn Hatfield 012D","E01023923","Total",39,15,5,19,2,0,0,2,37,15,5,17
"2011","Welwyn Hatfield 013A","E01023932","Total",53,15,12,26,4,1,0,3,49,14,12,23
"2011","Welwyn Hatfield 013B","E01023934","Total",31,10,6,15,3,0,2,1,28,10,4,14
"2011","Welwyn Hatfield 013C","E01023935","Total",24,11,5,8,1,0,0,1,23,11,5,7
"2011","Welwyn Hatfield 013D","E01023936","Total",70,24,16,30,3,0,2,1,67,24,14,29
"2011","Welwyn Hatfield 013E","E01023937","Total",22,4,9,9,5,0,4,1,17,4,5,8
"2011","Welwyn Hatfield 014A","E01023933","Total",42,14,4,24,2,0,1,1,40,14,3,23
"2011","Welwyn Hatfield 014B","E01023963","Total",58,23,13,22,3,0,3,0,55,23,10,22
"2011","Welwyn Hatfield 014C","E01023964","Total",21,6,14,1,7,0,6,1,14,6,8,0
"2011","Welwyn Hatfield 015A","E01023908","Total",19,8,5,6,4,0,3,1,15,8,2,5
"2011","Welwyn Hatfield 015B","E01023909","Total",13,6,2,5,2,1,0,1,11,5,2,4
"2011","Welwyn Hatfield 015C","E01023910","Total",10,1,3,6,0,0,0,0,10,1,3,6
"2011","Welwyn Hatfield 015D","E01023911","Total",45,17,18,10,2,0,2,0,43,17,16,10
"2011","Welwyn Hatfield 016A","E01023947","Total",42,25,7,10,5,2,2,1,37,23,5,9
"2011","Welwyn Hatfield 016B","E01023948","Total",13,3,4,6,2,0,2,0,11,3,2,6
"2011","Welwyn Hatfield 016C","E01023949","Total",10,6,1,3,1,0,1,0,9,6,0,3
"2011","Breckland 001A","E01026436","Total",40,17,12,11,6,1,2,3,34,16,10,8
"2011","Breckland 001C","E01026461","Total",16,7,4,5,2,0,2,0,14,7,2,5
"2011","Breckland 001E","E01026483","Total",16,10,3,3,3,1,2,0,13,9,1,3
"2011","Breckland 001F","E01033042","Total",34,15,8,11,8,3,5,0,26,12,3,11
"2011","Breckland 002A","E01026442","Total",33,16,10,7,5,2,2,1,28,14,8,6
"2011","Breckland 002B","E01026443","Total",35,14,6,15,7,0,3,4,28,14,3,11
"2011","Breckland 002C","E01026445","Total",47,22,10,15,8,2,3,3,39,20,7,12
"2011","Breckland 002D","E01026462","Total",40,15,17,8,7,1,6,0,33,14,11,8
"2011","Breckland 003A","E01026428","Total",108,28,27,53,12,1,4,7,96,27,23,46
"2011","Breckland 003B","E01026429","Total",34,13,9,12,3,0,2,1,31,13,7,11
"2011","Breckland 003C","E01026430","Total",28,5,11,12,4,0,3,1,24,5,8,11
"2011","Breckland 003D","E01026431","Total",21,10,4,7,2,0,1,1,19,10,3,6
"2011","Breckland 004A","E01026446","Total",21,10,4,7,1,0,1,0,20,10,3,7
"2011","Breckland 004B","E01026452","Total",27,10,8,9,3,0,2,1,24,10,6,8
"2011","Breckland 004C","E01026453","Total",20,8,7,5,2,0,1,1,18,8,6,4
"2011","Breckland 004D","E01026454","Total",42,11,27,4,8,0,7,1,34,11,20,3
"2011","Breckland 005A","E01026425","Total",85,28,24,33,7,0,6,1,78,28,18,32
"2011","Breckland 005B","E01026426","Total",88,22,27,39,9,1,6,2,79,21,21,37
"2011","Breckland 005C","E01026427","Total",49,18,13,18,4,2,1,1,45,16,12,17
"2011","Breckland 005D","E01026432","Total",25,10,11,4,2,0,2,0,23,10,9,4
"2011","Breckland 005E","E01026433","Total",46,19,9,18,2,1,0,1,44,18,9,17
"2011","Breckland 005F","E01026434","Total",55,26,17,12,7,0,5,2,48,26,12,10
"2011","Breckland 006A","E01026479","Total",20,4,7,9,1,0,1,0,19,4,6,9
"2011","Breckland 006B","E01026480","Total",24,6,10,8,3,0,3,0,21,6,7,8
"2011","Breckland 006C","E01026481","Total",21,12,5,4,5,3,1,1,16,9,4,3
"2011","Breckland 006D","E01026484","Total",8,4,1,3,1,0,0,1,7,4,1,2
"2011","Breckland 006E","E01026485","Total",15,8,5,2,1,1,0,0,14,7,5,2
"2011","Breckland 007A","E01026455","Total",65,25,12,28,6,2,1,3,59,23,11,25
"2011","Breckland 007B","E01026456","Total",24,11,6,7,0,0,0,0,24,11,6,7
"2011","Breckland 007C","E01026457","Total",6,2,3,1,1,0,1,0,5,2,2,1
"2011","Breckland 007D","E01026458","Total",60,22,11,27,4,0,3,1,56,22,8,26
"2011","Breckland 007E","E01026459","Total",29,5,5,19,4,0,0,4,25,5,5,15
"2011","Breckland 008A","E01026437","Total",16,8,2,6,2,1,1,0,14,7,1,6
"2011","Breckland 008B","E01026438","Total",23,8,7,8,5,2,2,1,18,6,5,7
"2011","Breckland 008C","E01026451","Total",40,13,13,14,8,1,4,3,32,12,9,11
"2011","Breckland 008D","E01026495","Total",19,5,3,11,0,0,0,0,19,5,3,11
"2011","Breckland 008E","E01026496","Total",9,5,3,1,0,0,0,0,9,5,3,1
"2011","Breckland 009A","E01026486","Total",42,17,9,16,2,0,2,0,40,17,7,16
"2011","Breckland 009B","E01026487","Total",52,12,20,20,9,2,6,1,43,10,14,19
"2011","Breckland 009C","E01026488","Total",26,10,5,11,5,1,1,3,21,9,4,8
"2011","Breckland 009D","E01026489","Total",24,8,11,5,4,2,2,0,20,6,9,5
"2011","Breckland 009E","E01026490","Total",25,8,12,5,2,1,0,1,23,7,12,4
"2011","Breckland 010A","E01026419","Total",10,2,4,4,0,0,0,0,10,2,4,4
"2011","Breckland 010B","E01026420","Total",21,2,13,6,6,0,5,1,15,2,8,5
"2011","Breckland 010D","E01026464","Total",20,6,3,11,1,0,1,0,19,6,2,11
"2011","Breckland 010E","E01026491","Total",17,6,9,2,3,0,3,0,14,6,6,2
"2011","Breckland 010F","E01033040","Total",55,19,6,30,5,1,1,3,50,18,5,27
"2011","Breckland 010G","E01033041","Total",26,9,4,13,1,0,1,0,25,9,3,13
"2011","Breckland 011A","E01026422","Total",26,12,9,5,6,0,4,2,20,12,5,3
"2011","Breckland 011B","E01026423","Total",60,22,19,19,6,0,4,2,54,22,15,17
"2011","Breckland 011C","E01026447","Total",65,21,15,29,5,0,4,1,60,21,11,28
"2011","Breckland 011D","E01026449","Total",53,23,19,11,8,3,2,3,45,20,17,8
"2011","Breckland 011E","E01026450","Total",31,14,8,9,2,0,2,0,29,14,6,9
"2011","Breckland 012A","E01026424","Total",31,10,14,7,6,1,4,1,25,9,10,6
"2011","Breckland 012B","E01026444","Total",40,19,13,8,4,1,2,1,36,18,11,7
"2011","Breckland 012C","E01026492","Total",22,9,4,9,0,0,0,0,22,9,4,9
"2011","Breckland 012D","E01026493","Total",28,14,8,6,5,1,2,2,23,13,6,4
"2011","Breckland 013A","E01026421","Total",36,16,14,6,4,0,3,1,32,16,11,5
"2011","Breckland 013B","E01026435","Total",37,19,9,9,6,1,2,3,31,18,7,6
"2011","Breckland 013C","E01026448","Total",52,24,17,11,6,1,4,1,46,23,13,10
"2011","Breckland 014A","E01026439","Total",26,10,10,6,3,0,2,1,23,10,8,5
"2011","Breckland 014B","E01026440","Total",24,8,8,8,3,0,1,2,21,8,7,6
"2011","Breckland 014C","E01026441","Total",29,14,0,15,0,0,0,0,29,14,0,15
"2011","Breckland 014D","E01026494","Total",42,19,10,13,5,0,3,2,37,19,7,11
"2011","Breckland 015A","E01026465","Total",63,21,13,29,8,2,5,1,55,19,8,28
"2011","Breckland 015B","E01026466","Total",56,14,25,17,5,0,4,1,51,14,21,16
"2011","Breckland 015C","E01026467","Total",158,45,31,82,30,0,16,14,128,45,15,68
"2011","Breckland 016A","E01026468","Total",50,27,11,12,11,1,7,3,39,26,4,9
"2011","Breckland 016B","E01026469","Total",25,6,13,6,7,0,5,2,18,6,8,4
"2011","Breckland 016C","E01026470","Total",56,22,23,11,7,1,5,1,49,21,18,10
"2011","Breckland 016D","E01026471","Total",27,2,19,6,5,0,4,1,22,2,15,5
"2011","Breckland 016E","E01026472","Total",22,11,8,3,4,2,2,0,18,9,6,3
"2011","Breckland 016F","E01026473","Total",38,17,14,7,2,1,1,0,36,16,13,7
"2011","Breckland 017A","E01026474","Total",58,16,12,30,4,0,2,2,54,16,10,28
"2011","Breckland 017B","E01026475","Total",47,12,14,21,6,1,3,2,41,11,11,19
"2011","Breckland 017C","E01026476","Total",65,20,14,31,9,2,3,4,56,18,11,27
"2011","Breckland 017D","E01026477","Total",73,24,14,35,6,0,4,2,67,24,10,33
"2011","Breckland 017E","E01026478","Total",89,26,17,46,12,4,6,2,77,22,11,44
"2011","Broadland 001A","E01026499","Total",51,21,13,17,5,1,3,1,46,20,10,16
"2011","Broadland 001B","E01026500","Total",25,11,9,5,4,1,3,0,21,10,6,5
"2011","Broadland 001C","E01026501","Total",27,9,4,14,2,0,2,0,25,9,2,14
"2011","Broadland 001D","E01026502","Total",25,9,11,5,6,0,5,1,19,9,6,4
"2011","Broadland 001E","E01026503","Total",22,13,5,4,2,2,0,0,20,11,5,4
"2011","Broadland 002A","E01026522","Total",37,19,9,9,3,1,2,0,34,18,7,9
"2011","Broadland 002B","E01026523","Total",57,18,21,18,14,3,7,4,43,15,14,14
"2011","Broadland 002C","E01026524","Total",21,11,4,6,2,0,1,1,19,11,3,5
"2011","Broadland 002D","E01026525","Total",19,5,7,7,6,0,5,1,13,5,2,6
"2011","Broadland 002E","E01026547","Total",35,15,12,8,3,0,1,2,32,15,11,6
"2011","Broadland 002F","E01026548","Total",40,21,9,10,4,1,3,0,36,20,6,10
"2011","Broadland 003A","E01026514","Total",35,15,10,10,7,1,5,1,28,14,5,9
"2011","Broadland 003B","E01026515","Total",11,6,2,3,3,0,1,2,8,6,1,1
"2011","Broadland 003C","E01026516","Total",23,11,2,10,0,0,0,0,23,11,2,10
"2011","Broadland 003D","E01026517","Total",25,12,7,6,4,0,4,0,21,12,3,6
"2011","Broadland 004A","E01026533","Total",14,7,2,5,1,1,0,0,13,6,2,5
"2011","Broadland 004B","E01026534","Total",33,12,9,12,4,0,4,0,29,12,5,12
"2011","Broadland 004C","E01026535","Total",37,15,13,9,7,1,5,1,30,14,8,8
"2011","Broadland 004D","E01026536","Total",31,18,3,10,1,0,1,0,30,18,2,10
"2011","Broadland 004E","E01026537","Total",37,21,8,8,2,0,2,0,35,21,6,8
"2011","Broadland 005A","E01026549","Total",30,10,10,10,2,0,0,2,28,10,10,8
"2011","Broadland 005B","E01026550","Total",27,14,7,6,3,0,3,0,24,14,4,6
"2011","Broadland 005C","E01026551","Total",18,8,6,4,3,1,2,0,15,7,4,4
"2011","Broadland 005D","E01026552","Total",5,1,4,0,2,0,2,0,3,1,2,0
"2011","Broadland 006A","E01026562","Total",30,14,11,5,5,1,4,0,25,13,7,5
"2011","Broadland 006B","E01026563","Total",55,26,14,15,3,0,2,1,52,26,12,14
"2011","Broadland 006C","E01026564","Total",36,17,9,10,5,2,3,0,31,15,6,10
"2011","Broadland 006D","E01026565","Total",49,34,6,9,3,1,2,0,46,33,4,9
"2011","Broadland 006E","E01026566","Total",44,23,13,8,3,0,3,0,41,23,10,8
"2011","Broadland 006F","E01026567","Total",23,14,4,5,4,0,2,2,19,14,2,3
"2011","Broadland 006G","E01026568","Total",27,16,6,5,2,0,2,0,25,16,4,5
"2011","Broadland 007A","E01026518","Total",52,25,17,10,4,2,2,0,48,23,15,10
"2011","Broadland 007B","E01026519","Total",51,27,15,9,6,0,5,1,45,27,10,8
"2011","Broadland 007C","E01026520","Total",22,8,6,8,3,2,1,0,19,6,5,8
"2011","Broadland 007D","E01026521","Total",19,10,4,5,3,1,2,0,16,9,2,5
"2011","Broadland 008A","E01026545","Total",42,22,11,9,4,0,3,1,38,22,8,8
"2011","Broadland 008B","E01026546","Total",21,10,9,2,3,0,3,0,18,10,6,2
"2011","Broadland 008C","E01026578","Total",57,25,13,19,11,1,5,5,46,24,8,14
"2011","Broadland 008D","E01026579","Total",29,11,10,8,7,1,2,4,22,10,8,4
"2011","Broadland 008E","E01026580","Total",27,15,4,8,2,0,2,0,25,15,2,8
"2011","Broadland 009A","E01026540","Total",11,5,4,2,0,0,0,0,11,5,4,2
"2011","Broadland 009B","E01026541","Total",87,39,19,29,9,0,9,0,78,39,10,29
"2011","Broadland 009C","E01026542","Total",31,15,9,7,5,1,4,0,26,14,5,7
"2011","Broadland 009D","E01026543","Total",22,9,10,3,4,0,4,0,18,9,6,3
"2011","Broadland 009E","E01026544","Total",40,21,6,13,5,2,2,1,35,19,4,12
"2011","Broadland 010A","E01026526","Total",24,11,8,5,3,1,2,0,21,10,6,5
"2011","Broadland 010B","E01026527","Total",16,6,6,4,1,0,1,0,15,6,5,4
"2011","Broadland 010C","E01026528","Total",25,9,5,11,4,1,1,2,21,8,4,9
"2011","Broadland 010D","E01026529","Total",33,15,13,5,8,0,7,1,25,15,6,4
"2011","Broadland 011A","E01026530","Total",24,13,3,8,1,0,1,0,23,13,2,8
"2011","Broadland 011B","E01026531","Total",18,11,5,2,1,0,1,0,17,11,4,2
"2011","Broadland 011C","E01026532","Total",26,13,6,7,1,0,1,0,25,13,5,7
"2011","Broadland 012A","E01026553","Total",32,19,5,8,4,1,1,2,28,18,4,6
"2011","Broadland 012B","E01026554","Total",29,14,9,6,4,0,3,1,25,14,6,5
"2011","Broadland 012C","E01026555","Total",31,12,6,13,2,0,2,0,29,12,4,13
"2011","Broadland 012D","E01026556","Total",45,22,8,15,1,0,1,0,44,22,7,15
"2011","Broadland 013A","E01026557","Total",11,7,3,1,1,1,0,0,10,6,3,1
"2011","Broadland 013B","E01026558","Total",19,10,5,4,3,0,1,2,16,10,4,2
"2011","Broadland 013C","E01026559","Total",23,12,5,6,3,1,2,0,20,11,3,6
"2011","Broadland 013D","E01026560","Total",19,10,9,0,5,0,5,0,14,10,4,0
"2011","Broadland 013E","E01026561","Total",11,5,3,3,1,0,1,0,10,5,2,3
"2011","Broadland 014A","E01026504","Total",18,8,3,7,2,0,1,1,16,8,2,6
"2011","Broadland 014B","E01026505","Total",23,8,6,9,3,0,3,0,20,8,3,9
"2011","Broadland 014C","E01026506","Total",20,7,9,4,4,0,3,1,16,7,6,3
"2011","Broadland 014D","E01026507","Total",26,11,11,4,3,0,3,0,23,11,8,4
"2011","Broadland 014E","E01026512","Total",29,8,15,6,7,1,6,0,22,7,9,6
"2011","Broadland 014F","E01026513","Total",34,17,8,9,8,1,3,4,26,16,5,5
"2011","Broadland 015A","E01026569","Total",24,10,5,9,1,0,1,0,23,10,4,9
"2011","Broadland 015B","E01026570","Total",32,17,10,5,4,1,3,0,28,16,7,5
"2011","Broadland 015C","E01026571","Total",23,12,9,2,4,0,3,1,19,12,6,1
"2011","Broadland 015D","E01026572","Total",24,10,10,4,4,0,2,2,20,10,8,2
"2011","Broadland 015E","E01026573","Total",33,14,9,10,2,0,1,1,31,14,8,9
"2011","Broadland 016A","E01026574","Total",64,28,21,15,4,0,4,0,60,28,17,15
"2011","Broadland 016B","E01026575","Total",48,18,14,16,4,1,3,0,44,17,11,16
"2011","Broadland 016C","E01026576","Total",66,32,19,15,5,0,4,1,61,32,15,14
"2011","Broadland 016D","E01026577","Total",37,16,7,14,3,0,1,2,34,16,6,12
"2011","Broadland 017A","E01026508","Total",36,11,12,13,8,1,6,1,28,10,6,12
"2011","Broadland 017B","E01026509","Total",17,11,5,1,1,0,1,0,16,11,4,1
"2011","Broadland 017C","E01026510","Total",22,12,5,5,5,1,2,2,17,11,3,3
"2011","Broadland 017D","E01026511","Total",29,15,6,8,2,1,1,0,27,14,5,8
"2011","Broadland 018A","E01026497","Total",27,8,8,11,4,0,4,0,23,8,4,11
"2011","Broadland 018B","E01026498","Total",38,13,10,15,8,0,3,5,30,13,7,10
"2011","Broadland 018C","E01026538","Total",34,7,10,17,5,0,3,2,29,7,7,15
"2011","Broadland 018D","E01026539","Total",30,10,8,12,2,0,2,0,28,10,6,12
"2011","Great Yarmouth 001A","E01026605","Total",27,10,4,13,6,0,1,5,21,10,3,8
"2011","Great Yarmouth 001B","E01026606","Total",33,10,10,13,6,0,5,1,27,10,5,12
"2011","Great Yarmouth 001C","E01026607","Total",41,21,10,10,3,1,2,0,38,20,8,10
"2011","Great Yarmouth 001D","E01026627","Total",21,6,10,5,6,2,4,0,15,4,6,5
"2011","Great Yarmouth 001E","E01026628","Total",26,10,9,7,2,0,2,0,24,10,7,7
"2011","Great Yarmouth 001F","E01026629","Total",31,12,11,8,0,0,0,0,31,12,11,8
"2011","Great Yarmouth 002A","E01026608","Total",18,11,2,5,5,2,1,2,13,9,1,3
"2011","Great Yarmouth 002B","E01026609","Total",22,9,6,7,5,1,2,2,17,8,4,5
"2011","Great Yarmouth 002C","E01026636","Total",24,7,9,8,3,0,2,1,21,7,7,7
"2011","Great Yarmouth 002D","E01026637","Total",29,10,10,9,5,1,2,2,24,9,8,7
"2011","Great Yarmouth 002E","E01026638","Total",53,26,10,17,1,0,0,1,52,26,10,16
"2011","Great Yarmouth 003A","E01026589","Total",43,17,12,14,1,0,1,0,42,17,11,14
"2011","Great Yarmouth 003B","E01026590","Total",30,16,6,8,3,1,2,0,27,15,4,8
"2011","Great Yarmouth 003C","E01026591","Total",32,12,9,11,1,0,0,1,31,12,9,10
"2011","Great Yarmouth 003D","E01026592","Total",35,11,5,19,5,3,1,1,30,8,4,18
"2011","Great Yarmouth 003E","E01026593","Total",17,10,2,5,1,0,1,0,16,10,1,5
"2011","Great Yarmouth 003F","E01026594","Total",63,28,14,21,4,0,3,1,59,28,11,20
"2011","Great Yarmouth 004A","E01026599","Total",43,17,8,18,3,0,0,3,40,17,8,15
"2011","Great Yarmouth 004B","E01026639","Total",34,14,8,12,2,1,1,0,32,13,7,12
"2011","Great Yarmouth 004C","E01026640","Total",33,9,7,17,2,0,2,0,31,9,5,17
"2011","Great Yarmouth 004D","E01026641","Total",86,22,18,46,15,1,7,7,71,21,11,39
"2011","Great Yarmouth 005A","E01026595","Total",82,25,16,41,10,0,7,3,72,25,9,38
"2011","Great Yarmouth 005B","E01026596","Total",46,19,16,11,3,0,2,1,43,19,14,10
"2011","Great Yarmouth 005C","E01026597","Total",104,30,19,55,15,2,3,10,89,28,16,45
"2011","Great Yarmouth 005D","E01026598","Total",74,27,17,30,16,3,6,7,58,24,11,23
"2011","Great Yarmouth 006A","E01026622","Total",100,19,8,73,13,3,2,8,87,16,6,65
"2011","Great Yarmouth 006B","E01026623","Total",49,13,9,27,5,1,1,3,44,12,8,24
"2011","Great Yarmouth 006C","E01026624","Total",87,25,15,47,15,3,6,6,72,22,9,41
"2011","Great Yarmouth 006D","E01026625","Total",118,16,18,84,15,2,2,11,103,14,16,73
"2011","Great Yarmouth 006E","E01026626","Total",86,28,9,49,13,1,3,9,73,27,6,40
"2011","Great Yarmouth 007A","E01026600","Total",58,21,9,28,8,2,1,5,50,19,8,23
"2011","Great Yarmouth 007B","E01026633","Total",83,33,13,37,4,1,1,2,79,32,12,35
"2011","Great Yarmouth 007C","E01026634","Total",77,26,11,40,11,2,3,6,66,24,8,34
"2011","Great Yarmouth 007D","E01026635","Total",117,46,19,52,13,2,7,4,104,44,12,48
"2011","Great Yarmouth 008A","E01026581","Total",44,24,16,4,12,0,11,1,32,24,5,3
"2011","Great Yarmouth 008B","E01026582","Total",43,18,14,11,4,0,4,0,39,18,10,11
"2011","Great Yarmouth 008C","E01026583","Total",33,17,9,7,2,0,2,0,31,17,7,7
"2011","Great Yarmouth 008D","E01026584","Total",30,15,8,7,4,2,2,0,26,13,6,7
"2011","Great Yarmouth 009A","E01026601","Total",79,28,20,31,8,0,7,1,71,28,13,30
"2011","Great Yarmouth 009B","E01026602","Total",47,21,10,16,3,1,2,0,44,20,8,16
"2011","Great Yarmouth 009C","E01026603","Total",129,39,17,73,22,1,6,15,107,38,11,58
"2011","Great Yarmouth 009D","E01026604","Total",90,25,9,56,12,1,4,7,78,24,5,49
"2011","Great Yarmouth 009E","E01026632","Total",74,33,18,23,7,1,3,3,67,32,15,20
"2011","Great Yarmouth 010A","E01026610","Total",65,28,18,19,8,0,6,2,57,28,12,17
"2011","Great Yarmouth 010B","E01026611","Total",16,9,5,2,4,1,3,0,12,8,2,2
"2011","Great Yarmouth 010C","E01026612","Total",66,26,18,22,5,1,3,1,61,25,15,21
"2011","Great Yarmouth 010D","E01026630","Total",93,40,18,35,11,1,8,2,82,39,10,33
"2011","Great Yarmouth 010E","E01026631","Total",83,30,13,40,5,0,4,1,78,30,9,39
"2011","Great Yarmouth 011A","E01026617","Total",39,16,11,12,3,0,2,1,36,16,9,11
"2011","Great Yarmouth 011B","E01026618","Total",34,11,10,13,3,0,2,1,31,11,8,12
"2011","Great Yarmouth 011C","E01026619","Total",81,26,15,40,9,2,3,4,72,24,12,36
"2011","Great Yarmouth 011D","E01026620","Total",50,17,6,27,6,0,2,4,44,17,4,23
"2011","Great Yarmouth 011E","E01026621","Total",44,17,4,23,6,0,1,5,38,17,3,18
"2011","Great Yarmouth 012A","E01026613","Total",11,7,2,2,0,0,0,0,11,7,2,2
"2011","Great Yarmouth 012B","E01026614","Total",21,11,5,5,2,0,2,0,19,11,3,5
"2011","Great Yarmouth 012C","E01026615","Total",26,14,9,3,2,0,2,0,24,14,7,3
"2011","Great Yarmouth 012D","E01026616","Total",35,17,6,12,7,3,2,2,28,14,4,10
"2011","Great Yarmouth 013A","E01026585","Total",30,15,7,8,1,0,0,1,29,15,7,7
"2011","Great Yarmouth 013B","E01026586","Total",36,14,12,10,6,2,3,1,30,12,9,9
"2011","Great Yarmouth 013C","E01026587","Total",30,14,6,10,3,0,2,1,27,14,4,9
"2011","Great Yarmouth 013D","E01026588","Total",52,34,8,10,8,2,5,1,44,32,3,9
"2011","King's Lynn and West Norfolk 001A","E01026680","Total",24,8,6,10,4,1,2,1,20,7,4,9
"2011","King's Lynn and West Norfolk 001B","E01026681","Total",24,7,8,9,2,0,2,0,22,7,6,9
"2011","King's Lynn and West Norfolk 001C","E01026682","Total",19,9,7,3,2,2,0,0,17,7,7,3
"2011","King's Lynn and West Norfolk 001D","E01026683","Total",34,13,6,15,1,1,0,0,33,12,6,15
"2011","King's Lynn and West Norfolk 002A","E01026645","Total",10,7,2,1,0,0,0,0,10,7,2,1
"2011","King's Lynn and West Norfolk 002B","E01026646","Total",30,11,7,12,2,0,1,1,28,11,6,11
"2011","King's Lynn and West Norfolk 002C","E01026656","Total",34,16,4,14,2,1,0,1,32,15,4,13
"2011","King's Lynn and West Norfolk 002D","E01026695","Total",35,19,7,9,6,2,2,2,29,17,5,7
"2011","King's Lynn and West Norfolk 003A","E01026676","Total",27,13,4,10,2,1,1,0,25,12,3,10
"2011","King's Lynn and West Norfolk 003B","E01026677","Total",33,14,5,14,4,0,2,2,29,14,3,12
"2011","King's Lynn and West Norfolk 003C","E01026678","Total",23,18,3,2,2,0,2,0,21,18,1,2
"2011","King's Lynn and West Norfolk 003D","E01026701","Total",27,15,5,7,3,0,2,1,24,15,3,6
"2011","King's Lynn and West Norfolk 003E","E01026702","Total",30,18,5,7,1,0,1,0,29,18,4,7
"2011","King's Lynn and West Norfolk 003F","E01026703","Total",24,9,8,7,3,1,2,0,21,8,6,7
"2011","King's Lynn and West Norfolk 004A","E01026653","Total",24,11,7,6,3,2,1,0,21,9,6,6
"2011","King's Lynn and West Norfolk 004B","E01026654","Total",45,22,10,13,7,0,5,2,38,22,5,11
"2011","King's Lynn and West Norfolk 004C","E01026655","Total",24,13,4,7,1,0,0,1,23,13,4,6
"2011","King's Lynn and West Norfolk 004D","E01026718","Total",34,12,12,10,2,0,1,1,32,12,11,9
"2011","King's Lynn and West Norfolk 005A","E01026691","Total",20,5,8,7,5,0,3,2,15,5,5,5
"2011","King's Lynn and West Norfolk 005B","E01026692","Total",31,17,9,5,2,1,1,0,29,16,8,5
"2011","King's Lynn and West Norfolk 005C","E01026708","Total",25,11,9,5,2,0,2,0,23,11,7,5
"2011","King's Lynn and West Norfolk 005D","E01026709","Total",43,20,13,10,4,2,2,0,39,18,11,10
"2011","King's Lynn and West Norfolk 005E","E01026710","Total",12,7,2,3,1,0,1,0,11,7,1,3
"2011","King's Lynn and West Norfolk 006A","E01026669","Total",33,13,17,3,8,1,7,0,25,12,10,3
"2011","King's Lynn and West Norfolk 006B","E01026670","Total",57,21,19,17,10,1,6,3,47,20,13,14
"2011","King's Lynn and West Norfolk 006C","E01026671","Total",24,13,7,4,1,0,1,0,23,13,6,4
"2011","King's Lynn and West Norfolk 006D","E01026672","Total",25,13,7,5,2,0,1,1,23,13,6,4
"2011","King's Lynn and West Norfolk 006E","E01026673","Total",38,18,11,9,1,0,1,0,37,18,10,9
"2011","King's Lynn and West Norfolk 007A","E01026687","Total",76,24,15,37,3,0,2,1,73,24,13,36
"2011","King's Lynn and West Norfolk 007B","E01026688","Total",81,25,13,43,5,0,3,2,76,25,10,41
"2011","King's Lynn and West Norfolk 007C","E01026689","Total",49,18,14,17,5,0,5,0,44,18,9,17
"2011","King's Lynn and West Norfolk 007D","E01026690","Total",69,20,10,39,6,0,2,4,63,20,8,35
"2011","King's Lynn and West Norfolk 008A","E01026647","Total",34,15,7,12,2,1,0,1,32,14,7,11
"2011","King's Lynn and West Norfolk 008B","E01026711","Total",46,12,5,29,6,0,3,3,40,12,2,26
"2011","King's Lynn and West Norfolk 008C","E01026712","Total",33,15,10,8,8,0,8,0,25,15,2,8
"2011","King's Lynn and West Norfolk 008D","E01026713","Total",18,12,4,2,1,0,1,0,17,12,3,2
"2011","King's Lynn and West Norfolk 009A","E01026666","Total",60,16,20,24,4,1,2,1,56,15,18,23
"2011","King's Lynn and West Norfolk 009B","E01026667","Total",39,20,12,7,1,0,1,0,38,20,11,7
"2011","King's Lynn and West Norfolk 009C","E01026668","Total",32,7,15,10,8,1,5,2,24,6,10,8
"2011","King's Lynn and West Norfolk 009D","E01026693","Total",38,16,12,10,5,0,4,1,33,16,8,9
"2011","King's Lynn and West Norfolk 010A","E01026662","Total",116,33,16,67,5,0,2,3,111,33,14,64
"2011","King's Lynn and West Norfolk 010B","E01026663","Total",77,28,19,30,5,1,3,1,72,27,16,29
"2011","King's Lynn and West Norfolk 010C","E01026664","Total",63,32,14,17,6,0,4,2,57,32,10,15
"2011","King's Lynn and West Norfolk 010D","E01026714","Total",32,12,14,6,2,0,2,0,30,12,12,6
"2011","King's Lynn and West Norfolk 011A","E01026698","Total",34,11,8,15,0,0,0,0,34,11,8,15
"2011","King's Lynn and West Norfolk 011B","E01026699","Total",34,11,11,12,2,1,1,0,32,10,10,12
"2011","King's Lynn and West Norfolk 011C","E01026700","Total",39,9,12,18,4,0,0,4,35,9,12,14
"2011","King's Lynn and West Norfolk 011D","E01026704","Total",72,21,13,38,5,0,3,2,67,21,10,36
"2011","King's Lynn and West Norfolk 011E","E01026705","Total",30,10,9,11,1,0,1,0,29,10,8,11
"2011","King's Lynn and West Norfolk 011F","E01026706","Total",43,21,12,10,4,0,3,1,39,21,9,9
"2011","King's Lynn and West Norfolk 012A","E01026665","Total",41,16,12,13,4,0,4,0,37,16,8,13
"2011","King's Lynn and West Norfolk 012B","E01026674","Total",15,6,5,4,0,0,0,0,15,6,5,4
"2011","King's Lynn and West Norfolk 012C","E01026675","Total",22,8,9,5,1,0,1,0,21,8,8,5
"2011","King's Lynn and West Norfolk 012D","E01026694","Total",36,17,10,9,4,0,3,1,32,17,7,8
"2011","King's Lynn and West Norfolk 013A","E01026684","Total",19,6,6,7,2,0,1,1,17,6,5,6
"2011","King's Lynn and West Norfolk 013B","E01026685","Total",26,7,10,9,4,1,3,0,22,6,7,9
"2011","King's Lynn and West Norfolk 013C","E01026719","Total",39,11,11,17,5,0,4,1,34,11,7,16
"2011","King's Lynn and West Norfolk 013D","E01026720","Total",18,10,5,3,5,1,4,0,13,9,1,3
"2011","King's Lynn and West Norfolk 013E","E01026721","Total",25,12,4,9,3,0,1,2,22,12,3,7
"2011","King's Lynn and West Norfolk 014A","E01026642","Total",18,7,6,5,1,0,1,0,17,7,5,5
"2011","King's Lynn and West Norfolk 014B","E01026643","Total",22,11,5,6,3,0,3,0,19,11,2,6
"2011","King's Lynn and West Norfolk 014C","E01026644","Total",17,3,12,2,3,0,3,0,14,3,9,2
"2011","King's Lynn and West Norfolk 014D","E01026723","Total",25,11,8,6,2,0,0,2,23,11,8,4
"2011","King's Lynn and West Norfolk 014E","E01026724","Total",27,11,6,10,2,0,2,0,25,11,4,10
"2011","King's Lynn and West Norfolk 014F","E01026725","Total",27,10,7,10,5,0,4,1,22,10,3,9
"2011","King's Lynn and West Norfolk 015A","E01026696","Total",28,13,4,11,3,1,0,2,25,12,4,9
"2011","King's Lynn and West Norfolk 015B","E01026697","Total",19,4,8,7,4,2,2,0,15,2,6,7
"2011","King's Lynn and West Norfolk 015C","E01026722","Total",61,29,15,17,2,1,0,1,59,28,15,16
"2011","King's Lynn and West Norfolk 015D","E01026726","Total",34,16,8,10,5,1,2,2,29,15,6,8
"2011","King's Lynn and West Norfolk 016A","E01026659","Total",29,14,3,12,5,1,1,3,24,13,2,9
"2011","King's Lynn and West Norfolk 016B","E01026660","Total",35,14,13,8,2,0,2,0,33,14,11,8
"2011","King's Lynn and West Norfolk 016C","E01026661","Total",21,11,4,6,5,3,2,0,16,8,2,6
"2011","King's Lynn and West Norfolk 016D","E01026715","Total",21,6,6,9,3,0,3,0,18,6,3,9
"2011","King's Lynn and West Norfolk 016E","E01026716","Total",38,14,8,16,6,0,5,1,32,14,3,15
"2011","King's Lynn and West Norfolk 016F","E01026717","Total",21,4,4,13,5,0,0,5,16,4,4,8
"2011","King's Lynn and West Norfolk 017C","E01026686","Total",40,20,9,11,11,3,4,4,29,17,5,7
"2011","King's Lynn and West Norfolk 017D","E01026707","Total",7,4,2,1,1,0,1,0,6,4,1,1
"2011","King's Lynn and West Norfolk 017E","E01033036","Total",45,21,6,18,2,0,2,0,43,21,4,18
"2011","King's Lynn and West Norfolk 017F","E01033037","Total",65,27,11,27,7,3,4,0,58,24,7,27
"2011","King's Lynn and West Norfolk 017G","E01033038","Total",63,17,18,28,11,3,4,4,52,14,14,24
"2011","King's Lynn and West Norfolk 017H","E01033039","Total",15,4,7,4,5,1,3,1,10,3,4,3
"2011","King's Lynn and West Norfolk 018A","E01026679","Total",30,13,4,13,2,0,2,0,28,13,2,13
"2011","King's Lynn and West Norfolk 018B","E01026727","Total",35,13,11,11,2,0,2,0,33,13,9,11
"2011","King's Lynn and West Norfolk 018C","E01026728","Total",37,12,14,11,7,2,3,2,30,10,11,9
"2011","King's Lynn and West Norfolk 019A","E01026648","Total",33,9,12,12,7,1,1,5,26,8,11,7
"2011","King's Lynn and West Norfolk 019B","E01026649","Total",27,10,7,10,3,0,3,0,24,10,4,10
"2011","King's Lynn and West Norfolk 019C","E01026650","Total",17,5,5,7,1,0,1,0,16,5,4,7
"2011","King's Lynn and West Norfolk 019D","E01026651","Total",36,14,7,15,8,2,4,2,28,12,3,13
"2011","King's Lynn and West Norfolk 019E","E01026652","Total",26,10,7,9,2,0,2,0,24,10,5,9
"2011","North Norfolk 001A","E01026770","Total",28,13,4,11,1,0,0,1,27,13,4,10
"2011","North Norfolk 001B","E01026771","Total",35,10,7,18,6,1,4,1,29,9,3,17
"2011","North Norfolk 001C","E01026772","Total",30,16,8,6,5,2,3,0,25,14,5,6
"2011","North Norfolk 001D","E01026773","Total",41,18,9,14,3,1,1,1,38,17,8,13
"2011","North Norfolk 002A","E01026739","Total",28,16,5,7,4,2,2,0,24,14,3,7
"2011","North Norfolk 002B","E01026763","Total",47,19,7,21,8,2,4,2,39,17,3,19
"2011","North Norfolk 002C","E01026764","Total",19,8,6,5,2,0,1,1,17,8,5,4
"2011","North Norfolk 002D","E01026765","Total",20,11,5,4,2,0,1,1,18,11,4,3
"2011","North Norfolk 003A","E01026734","Total",20,9,2,9,1,0,0,1,19,9,2,8
"2011","North Norfolk 003B","E01026735","Total",24,8,4,12,0,0,0,0,24,8,4,12
"2011","North Norfolk 003C","E01026736","Total",28,11,2,15,3,1,0,2,25,10,2,13
"2011","North Norfolk 003D","E01026777","Total",18,10,2,6,0,0,0,0,18,10,2,6
"2011","North Norfolk 003E","E01026778","Total",18,8,4,6,2,1,0,1,16,7,4,5
"2011","North Norfolk 003F","E01026779","Total",51,24,12,15,7,1,4,2,44,23,8,13
"2011","North Norfolk 004A","E01026741","Total",23,6,4,13,1,0,0,1,22,6,4,12
"2011","North Norfolk 004B","E01026742","Total",19,9,3,7,2,1,1,0,17,8,2,7
"2011","North Norfolk 004C","E01026743","Total",41,11,8,22,7,0,2,5,34,11,6,17
"2011","North Norfolk 005A","E01026762","Total",32,8,9,15,6,0,4,2,26,8,5,13
"2011","North Norfolk 005B","E01026766","Total",35,10,16,9,6,1,5,0,29,9,11,9
"2011","North Norfolk 005C","E01026781","Total",23,9,7,7,1,0,1,0,22,9,6,7
"2011","North Norfolk 006A","E01026731","Total",10,3,4,3,1,0,1,0,9,3,3,3
"2011","North Norfolk 006B","E01026732","Total",25,17,4,4,5,1,3,1,20,16,1,3
"2011","North Norfolk 006C","E01026733","Total",49,21,6,22,6,1,3,2,43,20,3,20
"2011","North Norfolk 006D","E01026737","Total",40,22,9,9,7,3,3,1,33,19,6,8
"2011","North Norfolk 007A","E01026738","Total",36,12,14,10,5,0,4,1,31,12,10,9
"2011","North Norfolk 007B","E01026750","Total",30,17,7,6,3,2,0,1,27,15,7,5
"2011","North Norfolk 007C","E01026751","Total",35,15,4,16,10,5,2,3,25,10,2,13
"2011","North Norfolk 007D","E01026752","Total",19,7,2,10,2,0,0,2,17,7,2,8
"2011","North Norfolk 008A","E01026729","Total",46,22,13,11,6,2,3,1,40,20,10,10
"2011","North Norfolk 008B","E01026730","Total",50,19,14,17,9,1,6,2,41,18,8,15
"2011","North Norfolk 008C","E01026788","Total",27,14,5,8,3,0,2,1,24,14,3,7
"2011","North Norfolk 009A","E01026780","Total",48,18,11,19,7,2,4,1,41,16,7,18
"2011","North Norfolk 009B","E01026782","Total",37,13,10,14,6,0,4,2,31,13,6,12
"2011","North Norfolk 009C","E01026787","Total",25,7,4,14,3,0,3,0,22,7,1,14
"2011","North Norfolk 010A","E01026753","Total",57,13,20,24,13,1,9,3,44,12,11,21
"2011","North Norfolk 010B","E01026754","Total",57,22,15,20,12,0,8,4,45,22,7,16
"2011","North Norfolk 010C","E01026755","Total",6,1,3,2,0,0,0,0,6,1,3,2
"2011","North Norfolk 010D","E01026756","Total",59,15,10,34,8,2,4,2,51,13,6,32
"2011","North Norfolk 010E","E01026757","Total",38,17,12,9,1,0,1,0,37,17,11,9
"2011","North Norfolk 010F","E01026758","Total",28,10,6,12,5,0,2,3,23,10,4,9
"2011","North Norfolk 010G","E01026759","Total",40,21,3,16,2,1,1,0,38,20,2,16
"2011","North Norfolk 010H","E01026760","Total",26,9,10,7,0,0,0,0,26,9,10,7
"2011","North Norfolk 010I","E01026761","Total",36,12,8,16,8,1,4,3,28,11,4,13
"2011","North Norfolk 011A","E01026745","Total",36,14,11,11,5,0,3,2,31,14,8,9
"2011","North Norfolk 011B","E01026746","Total",25,15,7,3,0,0,0,0,25,15,7,3
"2011","North Norfolk 011C","E01026747","Total",43,13,18,12,12,2,7,3,31,11,11,9
"2011","North Norfolk 011D","E01026748","Total",23,10,12,1,3,0,3,0,20,10,9,1
"2011","North Norfolk 011E","E01026749","Total",59,20,13,26,7,1,4,2,52,19,9,24
"2011","North Norfolk 012A","E01026740","Total",42,13,13,16,4,1,2,1,38,12,11,15
"2011","North Norfolk 012B","E01026767","Total",11,6,2,3,2,0,2,0,9,6,0,3
"2011","North Norfolk 012C","E01026768","Total",43,15,19,9,5,0,5,0,38,15,14,9
"2011","North Norfolk 012D","E01026789","Total",15,3,4,8,1,0,1,0,14,3,3,8
"2011","North Norfolk 012E","E01026790","Total",25,10,5,10,8,1,2,5,17,9,3,5
"2011","North Norfolk 013A","E01026774","Total",32,9,12,11,3,1,2,0,29,8,10,11
"2011","North Norfolk 013B","E01026775","Total",41,12,7,22,7,1,4,2,34,11,3,20
"2011","North Norfolk 013C","E01026776","Total",36,13,7,16,9,3,3,3,27,10,4,13
"2011","North Norfolk 013D","E01026786","Total",38,17,10,11,4,1,3,0,34,16,7,11
"2011","North Norfolk 014A","E01026744","Total",17,4,6,7,2,1,1,0,15,3,5,7
"2011","North Norfolk 014B","E01026769","Total",27,11,8,8,5,0,5,0,22,11,3,8
"2011","North Norfolk 014C","E01026783","Total",15,5,3,7,4,0,3,1,11,5,0,6
"2011","North Norfolk 014D","E01026784","Total",29,9,5,15,5,0,3,2,24,9,2,13
"2011","North Norfolk 014E","E01026785","Total",12,3,6,3,2,0,2,0,10,3,4,3
"2011","Norwich 001A","E01026797","Total",72,21,20,31,10,2,5,3,62,19,15,28
"2011","Norwich 001B","E01026798","Total",74,22,15,37,4,1,2,1,70,21,13,36
"2011","Norwich 001C","E01026799","Total",60,13,12,35,9,2,4,3,51,11,8,32
"2011","Norwich 001D","E01026800","Total",104,31,14,59,25,3,3,19,79,28,11,40
"2011","Norwich 001E","E01026801","Total",30,14,10,6,6,1,4,1,24,13,6,5
"2011","Norwich 001F","E01026802","Total",57,26,12,19,5,0,1,4,52,26,11,15
"2011","Norwich 002A","E01026828","Total",90,29,17,44,7,0,4,3,83,29,13,41
"2011","Norwich 002B","E01026829","Total",91,23,10,58,6,0,3,3,85,23,7,55
"2011","Norwich 002C","E01026830","Total",62,16,17,29,9,2,4,3,53,14,13,26
"2011","Norwich 002D","E01026831","Total",29,11,11,7,1,0,1,0,28,11,10,7
"2011","Norwich 002E","E01026832","Total",66,22,6,38,5,1,1,3,61,21,5,35
"2011","Norwich 002F","E01026833","Total",78,16,19,43,13,1,9,3,65,15,10,40
"2011","Norwich 002G","E01026834","Total",77,26,14,37,11,2,5,4,66,24,9,33
"2011","Norwich 003A","E01026841","Total",40,20,6,14,4,1,1,2,36,19,5,12
"2011","Norwich 003B","E01026842","Total",25,6,9,10,1,0,0,1,24,6,9,9
"2011","Norwich 003C","E01026843","Total",76,18,15,43,6,1,2,3,70,17,13,40
"2011","Norwich 003D","E01026844","Total",92,26,14,52,8,1,5,2,84,25,9,50
"2011","Norwich 003E","E01026845","Total",49,18,14,17,2,1,1,0,47,17,13,17
"2011","Norwich 003F","E01026846","Total",51,25,10,16,6,2,3,1,45,23,7,15
"2011","Norwich 004A","E01026803","Total",59,16,7,36,2,1,1,0,57,15,6,36
"2011","Norwich 004B","E01026804","Total",43,19,6,18,3,1,1,1,40,18,5,17
"2011","Norwich 004C","E01026805","Total",67,26,12,29,6,0,2,4,61,26,10,25
"2011","Norwich 004D","E01026806","Total",21,6,9,6,2,0,2,0,19,6,7,6
"2011","Norwich 004E","E01026807","Total",41,11,17,13,4,0,4,0,37,11,13,13
"2011","Norwich 004F","E01026808","Total",85,25,13,47,8,0,2,6,77,25,11,41
"2011","Norwich 004G","E01026809","Total",59,16,6,37,6,1,2,3,53,15,4,34
"2011","Norwich 005A","E01026791","Total",82,21,7,54,6,0,2,4,76,21,5,50
"2011","Norwich 005B","E01026792","Total",47,10,7,30,2,0,1,1,45,10,6,29
"2011","Norwich 005C","E01026793","Total",84,20,10,54,9,1,5,3,75,19,5,51
"2011","Norwich 005D","E01026794","Total",60,28,7,25,5,3,1,1,55,25,6,24
"2011","Norwich 005F","E01026796","Total",61,14,6,41,6,1,3,2,55,13,3,39
"2011","Norwich 005G","E01033435","Total",57,20,13,24,6,0,2,4,51,20,11,20
"2011","Norwich 005H","E01033436","Total",60,21,8,31,3,1,2,0,57,20,6,31
"2011","Norwich 006A","E01026863","Total",46,10,14,22,9,0,8,1,37,10,6,21
"2011","Norwich 006B","E01026864","Total",69,16,24,29,9,0,8,1,60,16,16,28
"2011","Norwich 006C","E01026865","Total",98,29,13,56,13,3,5,5,85,26,8,51
"2011","Norwich 006D","E01026866","Total",47,20,9,18,5,1,3,1,42,19,6,17
"2011","Norwich 006E","E01026867","Total",68,21,5,42,5,0,2,3,63,21,3,39
"2011","Norwich 006F","E01026868","Total",79,16,9,54,6,0,3,3,73,16,6,51
"2011","Norwich 006G","E01026869","Total",77,26,7,44,5,1,0,4,72,25,7,40
"2011","Norwich 007A","E01026822","Total",53,17,11,25,6,1,3,2,47,16,8,23
"2011","Norwich 007B","E01026823","Total",37,12,13,12,4,3,1,0,33,9,12,12
"2011","Norwich 007C","E01026824","Total",47,17,4,26,4,0,0,4,43,17,4,22
"2011","Norwich 007D","E01026825","Total",37,13,9,15,7,0,5,2,30,13,4,13
"2011","Norwich 007E","E01026826","Total",56,22,8,26,8,2,3,3,48,20,5,23
"2011","Norwich 007F","E01026827","Total",71,21,3,47,5,1,0,4,66,20,3,43
"2011","Norwich 009A","E01026835","Total",48,17,14,17,3,0,1,2,45,17,13,15
"2011","Norwich 009B","E01026836","Total",43,21,19,3,6,0,5,1,37,21,14,2
"2011","Norwich 009C","E01026837","Total",22,7,6,9,4,1,2,1,18,6,4,8
"2011","Norwich 009D","E01026838","Total",29,10,11,8,3,0,3,0,26,10,8,8
"2011","Norwich 009E","E01026839","Total",31,18,4,9,4,2,2,0,27,16,2,9
"2011","Norwich 009F","E01026840","Total",50,20,12,18,5,2,0,3,45,18,12,15
"2011","Norwich 010A","E01026858","Total",63,23,10,30,10,2,2,6,53,21,8,24
"2011","Norwich 010B","E01026859","Total",86,25,12,49,5,0,3,2,81,25,9,47
"2011","Norwich 010C","E01026860","Total",19,8,0,11,2,0,0,2,17,8,0,9
"2011","Norwich 010D","E01026861","Total",65,23,4,38,8,0,0,8,57,23,4,30
"2011","Norwich 010E","E01026862","Total",39,11,9,19,4,1,2,1,35,10,7,18
"2011","Norwich 011A","E01026852","Total",14,8,6,0,3,0,3,0,11,8,3,0
"2011","Norwich 011B","E01026853","Total",58,15,16,27,10,0,6,4,48,15,10,23
"2011","Norwich 011D","E01026855","Total",27,12,8,7,8,1,4,3,19,11,4,4
"2011","Norwich 011E","E01026856","Total",46,19,13,14,3,0,2,1,43,19,11,13
"2011","Norwich 011F","E01026857","Total",28,10,8,10,1,0,0,1,27,10,8,9
"2011","Norwich 011G","E01033434","Total",23,7,11,5,5,0,5,0,18,7,6,5
"2011","Norwich 011H","E01033437","Total",59,16,11,32,6,0,1,5,53,16,10,27
"2011","Norwich 012A","E01026810","Total",23,7,7,9,2,0,2,0,21,7,5,9
"2011","Norwich 012B","E01026811","Total",10,2,6,2,3,0,3,0,7,2,3,2
"2011","Norwich 012C","E01026812","Total",17,2,11,4,2,0,2,0,15,2,9,4
"2011","Norwich 012D","E01026813","Total",11,4,1,6,0,0,0,0,11,4,1,6
"2011","Norwich 012E","E01026814","Total",37,12,6,19,6,3,2,1,31,9,4,18
"2011","Norwich 012F","E01026815","Total",31,18,9,4,6,4,2,0,25,14,7,4
"2011","Norwich 013A","E01026816","Total",57,20,14,23,5,0,5,0,52,20,9,23
"2011","Norwich 013B","E01026817","Total",47,14,8,25,2,0,1,1,45,14,7,24
"2011","Norwich 013C","E01026818","Total",76,25,12,39,7,2,2,3,69,23,10,36
"2011","Norwich 013D","E01026819","Total",87,32,22,33,10,0,5,5,77,32,17,28
"2011","Norwich 013E","E01026820","Total",73,21,9,43,10,0,4,6,63,21,5,37
"2011","Norwich 013F","E01026821","Total",57,25,6,26,5,0,1,4,52,25,5,22
"2011","Norwich 014A","E01033438","Total",16,3,6,7,3,0,3,0,13,3,3,7
"2011","Norwich 014B","E01033439","Total",22,4,8,10,5,0,0,5,17,4,8,5
"2011","Norwich 014C","E01033440","Total",22,10,5,7,4,1,2,1,18,9,3,6
"2011","Norwich 014D","E01033441","Total",24,4,4,16,1,0,1,0,23,4,3,16
"2011","Norwich 015A","E01026848","Total",110,23,19,68,19,3,3,13,91,20,16,55
"2011","Norwich 015B","E01026849","Total",23,12,5,6,2,1,1,0,21,11,4,6
"2011","Norwich 015C","E01026850","Total",51,16,14,21,7,0,6,1,44,16,8,20
"2011","South Norfolk 001A","E01026916","Total",22,8,6,8,2,0,1,1,20,8,5,7
"2011","South Norfolk 001B","E01026917","Total",20,11,4,5,2,0,2,0,18,11,2,5
"2011","South Norfolk 001C","E01026918","Total",30,16,5,9,1,1,0,0,29,15,5,9
"2011","South Norfolk 001E","E01026924","Total",34,13,10,11,3,1,2,0,31,12,8,11
"2011","South Norfolk 001F","E01026925","Total",96,35,19,42,9,1,6,2,87,34,13,40
"2011","South Norfolk 001G","E01033538","Total",71,19,22,30,2,0,2,0,69,19,20,30
"2011","South Norfolk 001H","E01033540","Total",26,11,4,11,4,2,1,1,22,9,3,10
"2011","South Norfolk 002A","E01026881","Total",27,8,9,10,3,0,2,1,24,8,7,9
"2011","South Norfolk 002B","E01026882","Total",39,13,15,11,3,1,2,0,36,12,13,11
"2011","South Norfolk 002C","E01026883","Total",26,12,7,7,3,0,3,0,23,12,4,7
"2011","South Norfolk 002D","E01026895","Total",25,10,6,9,4,0,3,1,21,10,3,8
"2011","South Norfolk 002E","E01026896","Total",16,7,6,3,1,0,1,0,15,7,5,3
"2011","South Norfolk 003A","E01026905","Total",19,4,4,11,2,0,2,0,17,4,2,11
"2011","South Norfolk 003B","E01026906","Total",16,8,3,5,3,1,0,2,13,7,3,3
"2011","South Norfolk 003C","E01026907","Total",44,15,18,11,5,1,2,2,39,14,16,9
"2011","South Norfolk 003D","E01026908","Total",56,26,13,17,4,0,2,2,52,26,11,15
"2011","South Norfolk 004A","E01026909","Total",33,16,5,12,5,0,1,4,28,16,4,8
"2011","South Norfolk 004B","E01026910","Total",21,10,7,4,4,0,2,2,17,10,5,2
"2011","South Norfolk 004C","E01026947","Total",13,4,3,6,1,0,1,0,12,4,2,6
"2011","South Norfolk 004D","E01026948","Total",20,5,8,7,4,0,4,0,16,5,4,7
"2011","South Norfolk 005A","E01026870","Total",49,23,15,11,9,3,4,2,40,20,11,9
"2011","South Norfolk 005B","E01026871","Total",19,12,6,1,2,1,1,0,17,11,5,1
"2011","South Norfolk 005C","E01026921","Total",24,7,9,8,4,0,2,2,20,7,7,6
"2011","South Norfolk 005D","E01026922","Total",51,18,13,20,2,0,1,1,49,18,12,19
"2011","South Norfolk 006A","E01026875","Total",10,4,3,3,2,0,2,0,8,4,1,3
"2011","South Norfolk 006B","E01026876","Total",22,11,4,7,4,0,3,1,18,11,1,6
"2011","South Norfolk 006C","E01026926","Total",27,10,13,4,9,3,5,1,18,7,8,3
"2011","South Norfolk 006D","E01026927","Total",30,13,12,5,3,0,3,0,27,13,9,5
"2011","South Norfolk 006E","E01026928","Total",33,12,11,10,4,2,2,0,29,10,9,10
"2011","South Norfolk 006F","E01026936","Total",35,18,7,10,2,0,2,0,33,18,5,10
"2011","South Norfolk 006G","E01026937","Total",44,17,13,14,6,0,5,1,38,17,8,13
"2011","South Norfolk 007A","E01026884","Total",38,15,2,21,5,1,0,4,33,14,2,17
"2011","South Norfolk 007B","E01026885","Total",28,16,5,7,3,1,1,1,25,15,4,6
"2011","South Norfolk 007C","E01026933","Total",78,32,23,23,7,1,5,1,71,31,18,22
"2011","South Norfolk 007D","E01026945","Total",73,32,26,15,9,0,9,0,64,32,17,15
"2011","South Norfolk 007E","E01026946","Total",18,6,7,5,1,0,0,1,17,6,7,4
"2011","South Norfolk 008A","E01026879","Total",34,10,11,13,6,0,5,1,28,10,6,12
"2011","South Norfolk 008B","E01026880","Total",19,7,10,2,5,0,5,0,14,7,5,2
"2011","South Norfolk 008C","E01026911","Total",37,20,8,9,7,2,4,1,30,18,4,8
"2011","South Norfolk 008D","E01026912","Total",44,18,10,16,4,1,2,1,40,17,8,15
"2011","South Norfolk 008E","E01026929","Total",19,6,9,4,5,0,5,0,14,6,4,4
"2011","South Norfolk 008F","E01026930","Total",21,7,4,10,6,1,2,3,15,6,2,7
"2011","South Norfolk 009A","E01026913","Total",35,14,11,10,6,1,5,0,29,13,6,10
"2011","South Norfolk 009B","E01026914","Total",26,12,8,6,2,0,1,1,24,12,7,5
"2011","South Norfolk 009C","E01026915","Total",43,20,14,9,2,0,2,0,41,20,12,9
"2011","South Norfolk 009D","E01026919","Total",49,17,8,24,3,0,3,0,46,17,5,24
"2011","South Norfolk 009E","E01026920","Total",16,12,3,1,2,1,1,0,14,11,2,1
"2011","South Norfolk 009F","E01026941","Total",17,8,6,3,2,0,2,0,15,8,4,3
"2011","South Norfolk 009G","E01026942","Total",19,4,10,5,2,0,2,0,17,4,8,5
"2011","South Norfolk 010A","E01026898","Total",20,7,5,8,1,0,1,0,19,7,4,8
"2011","South Norfolk 010B","E01026899","Total",20,9,5,6,1,1,0,0,19,8,5,6
"2011","South Norfolk 010C","E01026943","Total",20,11,3,6,3,1,1,1,17,10,2,5
"2011","South Norfolk 010D","E01026944","Total",16,6,2,8,1,1,0,0,15,5,2,8
"2011","South Norfolk 011A","E01026877","Total",18,8,3,7,3,0,1,2,15,8,2,5
"2011","South Norfolk 011B","E01026878","Total",33,13,10,10,7,1,5,1,26,12,5,9
"2011","South Norfolk 011C","E01026897","Total",33,13,13,7,4,2,1,1,29,11,12,6
"2011","South Norfolk 011D","E01026938","Total",51,21,19,11,6,1,2,3,45,20,17,8
"2011","South Norfolk 011E","E01026939","Total",36,16,10,10,7,1,3,3,29,15,7,7
"2011","South Norfolk 011F","E01026940","Total",56,27,10,19,4,0,3,1,52,27,7,18
"2011","South Norfolk 012A","E01026892","Total",31,12,6,13,3,0,0,3,28,12,6,10
"2011","South Norfolk 012B","E01026893","Total",17,9,3,5,3,2,1,0,14,7,2,5
"2011","South Norfolk 012C","E01026894","Total",42,19,12,11,8,3,4,1,34,16,8,10
"2011","South Norfolk 012D","E01026903","Total",9,2,3,4,0,0,0,0,9,2,3,4
"2011","South Norfolk 012E","E01026904","Total",25,7,7,11,3,0,3,0,22,7,4,11
"2011","South Norfolk 013A","E01026872","Total",52,13,16,23,7,1,3,3,45,12,13,20
"2011","South Norfolk 013B","E01026900","Total",27,8,7,12,3,0,1,2,24,8,6,10
"2011","South Norfolk 013C","E01026901","Total",32,15,6,11,1,0,1,0,31,15,5,11
"2011","South Norfolk 013D","E01026902","Total",42,16,10,16,8,4,4,0,34,12,6,16
"2011","South Norfolk 014A","E01026873","Total",13,5,2,6,2,0,2,0,11,5,0,6
"2011","South Norfolk 014B","E01026874","Total",20,6,3,11,1,0,0,1,19,6,3,10
"2011","South Norfolk 014C","E01026886","Total",14,7,6,1,3,0,3,0,11,7,3,1
"2011","South Norfolk 014D","E01026887","Total",23,10,7,6,0,0,0,0,23,10,7,6
"2011","South Norfolk 014E","E01026934","Total",20,8,3,9,4,0,1,3,16,8,2,6
"2011","South Norfolk 014F","E01026935","Total",16,5,7,4,3,0,2,1,13,5,5,3
"2011","South Norfolk 015A","E01026888","Total",40,15,5,20,4,1,1,2,36,14,4,18
"2011","South Norfolk 015B","E01026889","Total",23,9,8,6,2,0,1,1,21,9,7,5
"2011","South Norfolk 015D","E01026891","Total",56,20,10,26,9,3,1,5,47,17,9,21
"2011","South Norfolk 015E","E01026931","Total",18,9,7,2,2,1,1,0,16,8,6,2
"2011","South Norfolk 015F","E01026932","Total",30,14,9,7,2,1,1,0,28,13,8,7
"2011","South Norfolk 015G","E01033539","Total",52,21,16,15,3,0,3,0,49,21,13,15
"2011","South Norfolk 015H","E01033541","Total",38,13,18,7,3,0,3,0,35,13,15,7
"2011","Babergh 001A","E01029876","Total",39,17,6,16,2,0,2,0,37,17,4,16
"2011","Babergh 001B","E01029898","Total",32,13,8,11,3,0,3,0,29,13,5,11
"2011","Babergh 001C","E01029907","Total",28,11,9,8,0,0,0,0,28,11,9,8
"2011","Babergh 002A","E01029881","Total",40,11,15,14,7,0,4,3,33,11,11,11
"2011","Babergh 002B","E01029884","Total",48,18,12,18,6,1,2,3,42,17,10,15
"2011","Babergh 002C","E01029885","Total",38,16,9,13,12,6,6,0,26,10,3,13
"2011","Babergh 003A","E01029900","Total",19,12,2,5,0,0,0,0,19,12,2,5
"2011","Babergh 003B","E01029901","Total",43,22,14,7,5,1,4,0,38,21,10,7
"2011","Babergh 003C","E01029917","Total",42,20,12,10,1,0,1,0,41,20,11,10
"2011","Babergh 004A","E01029892","Total",78,24,16,38,4,0,3,1,74,24,13,37
"2011","Babergh 004B","E01029893","Total",49,16,15,18,9,0,7,2,40,16,8,16
"2011","Babergh 004C","E01029894","Total",31,14,13,4,2,0,2,0,29,14,11,4
"2011","Babergh 004D","E01029895","Total",21,8,8,5,3,1,1,1,18,7,7,4
"2011","Babergh 004E","E01029896","Total",32,14,9,9,2,0,1,1,30,14,8,8
"2011","Babergh 004F","E01029911","Total",23,16,6,1,7,2,4,1,16,14,2,0
"2011","Babergh 005A","E01029877","Total",12,4,5,3,1,0,1,0,11,4,4,3
"2011","Babergh 005B","E01029878","Total",12,6,3,3,2,0,2,0,10,6,1,3
"2011","Babergh 005C","E01029879","Total",20,8,10,2,3,0,2,1,17,8,8,1
"2011","Babergh 005D","E01029908","Total",28,13,10,5,5,0,4,1,23,13,6,4
"2011","Babergh 005E","E01029909","Total",52,24,13,15,5,1,4,0,47,23,9,15
"2011","Babergh 005F","E01029910","Total",63,26,6,31,5,3,1,1,58,23,5,30
"2011","Babergh 006A","E01029880","Total",37,14,15,8,8,2,5,1,29,12,10,7
"2011","Babergh 006B","E01029921","Total",22,10,5,7,2,0,0,2,20,10,5,5
"2011","Babergh 006C","E01029922","Total",29,10,7,12,7,1,3,3,22,9,4,9
"2011","Babergh 006D","E01029923","Total",30,8,11,11,5,0,5,0,25,8,6,11
"2011","Babergh 007A","E01029912","Total",60,20,9,31,7,0,5,2,53,20,4,29
"2011","Babergh 007B","E01029913","Total",11,6,3,2,2,0,2,0,9,6,1,2
"2011","Babergh 007C","E01029914","Total",77,29,15,33,5,0,0,5,72,29,15,28
"2011","Babergh 007D","E01029915","Total",23,8,9,6,4,0,4,0,19,8,5,6
"2011","Babergh 007E","E01029916","Total",56,21,7,28,8,3,1,4,48,18,6,24
"2011","Babergh 007F","E01029918","Total",28,8,6,14,4,0,2,2,24,8,4,12
"2011","Babergh 007G","E01029919","Total",30,8,9,13,3,0,2,1,27,8,7,12
"2011","Babergh 007H","E01029920","Total",59,20,19,20,13,0,10,3,46,20,9,17
"2011","Babergh 008A","E01029886","Total",26,9,8,9,0,0,0,0,26,9,8,9
"2011","Babergh 008B","E01029887","Total",52,23,18,11,15,3,10,2,37,20,8,9
"2011","Babergh 008C","E01029888","Total",44,11,12,21,11,1,5,5,33,10,7,16
"2011","Babergh 008D","E01029889","Total",69,18,16,35,10,1,5,4,59,17,11,31
"2011","Babergh 008E","E01029890","Total",31,17,5,9,3,2,0,1,28,15,5,8
"2011","Babergh 008F","E01029891","Total",39,16,8,15,6,2,4,0,33,14,4,15
"2011","Babergh 009A","E01029875","Total",27,12,6,9,1,1,0,0,26,11,6,9
"2011","Babergh 009B","E01029899","Total",19,10,3,6,3,0,2,1,16,10,1,5
"2011","Babergh 009C","E01029902","Total",24,11,8,5,4,1,2,1,20,10,6,4
"2011","Babergh 009D","E01029906","Total",41,17,10,14,5,0,5,0,36,17,5,14
"2011","Babergh 010A","E01029870","Total",36,16,5,15,3,0,2,1,33,16,3,14
"2011","Babergh 010B","E01029872","Total",11,4,5,2,0,0,0,0,11,4,5,2
"2011","Babergh 010C","E01029882","Total",22,9,10,3,2,0,1,1,20,9,9,2
"2011","Babergh 010D","E01029883","Total",39,20,12,7,9,0,8,1,30,20,4,6
"2011","Babergh 010E","E01029903","Total",18,12,3,3,1,1,0,0,17,11,3,3
"2011","Babergh 010F","E01029904","Total",29,18,6,5,4,3,1,0,25,15,5,5
"2011","Babergh 010G","E01029905","Total",14,7,6,1,2,0,2,0,12,7,4,1
"2011","Babergh 011A","E01029871","Total",12,1,6,5,2,0,2,0,10,1,4,5
"2011","Babergh 011B","E01029873","Total",49,15,14,20,4,0,3,1,45,15,11,19
"2011","Babergh 011C","E01029874","Total",45,19,17,9,6,1,5,0,39,18,12,9
"2011","Babergh 011D","E01029897","Total",40,19,19,2,10,0,10,0,30,19,9,2
"2011","Forest Heath 001A","E01029926","Total",13,6,3,4,1,0,1,0,12,6,2,4
"2011","Forest Heath 001B","E01029927","Total",87,28,24,35,14,2,6,6,73,26,18,29
"2011","Forest Heath 001C","E01029928","Total",58,19,23,16,11,2,6,3,47,17,17,13
"2011","Forest Heath 001D","E01029929","Total",62,19,22,21,12,0,8,4,50,19,14,17
"2011","Forest Heath 001E","E01029930","Total",25,8,8,9,5,0,4,1,20,8,4,8
"2011","Forest Heath 002C","E01029942","Total",28,12,8,8,3,1,0,2,25,11,8,6
"2011","Forest Heath 002E","E01029944","Total",44,17,11,16,3,0,2,1,41,17,9,15
"2011","Forest Heath 002F","E01033453","Total",48,10,20,18,5,0,4,1,43,10,16,17
"2011","Forest Heath 003E","E01029945","Total",26,6,12,8,4,0,4,0,22,6,8,8
"2011","Forest Heath 003F","E01032523","Total",12,0,6,6,2,0,2,0,10,0,4,6
"2011","Forest Heath 003G","E01032524","Total",15,4,6,5,1,0,1,0,14,4,5,5
"2011","Forest Heath 003H","E01032525","Total",50,12,24,14,4,0,3,1,46,12,21,13
"2011","Forest Heath 003I","E01032526","Total",26,13,8,5,6,1,4,1,20,12,4,4
"2011","Forest Heath 004A","E01029938","Total",77,16,19,42,13,1,7,5,64,15,12,37
"2011","Forest Heath 004B","E01029939","Total",29,13,8,8,5,2,3,0,24,11,5,8
"2011","Forest Heath 004C","E01029940","Total",69,14,30,25,7,0,7,0,62,14,23,25
"2011","Forest Heath 004D","E01029946","Total",97,25,31,41,11,0,9,2,86,25,22,39
"2011","Forest Heath 004E","E01029947","Total",31,11,11,9,3,0,3,0,28,11,8,9
"2011","Forest Heath 005A","E01029941","Total",27,13,8,6,5,1,4,0,22,12,4,6
"2011","Forest Heath 005C","E01029957","Total",26,9,8,9,3,0,3,0,23,9,5,9
"2011","Forest Heath 005D","E01033451","Total",47,16,15,16,3,0,2,1,44,16,13,15
"2011","Forest Heath 005E","E01033452","Total",33,14,15,4,3,0,2,1,30,14,13,3
"2011","Forest Heath 005F","E01033454","Total",38,10,15,13,4,0,2,2,34,10,13,11
"2011","Forest Heath 006A","E01029937","Total",38,15,14,9,4,0,4,0,34,15,10,9
"2011","Forest Heath 006B","E01029953","Total",52,20,15,17,5,1,3,1,47,19,12,16
"2011","Forest Heath 006C","E01029954","Total",113,44,27,42,12,0,6,6,101,44,21,36
"2011","Forest Heath 006D","E01029955","Total",46,15,19,12,3,0,3,0,43,15,16,12
"2011","Forest Heath 006E","E01029956","Total",40,15,17,8,7,0,7,0,33,15,10,8
"2011","Forest Heath 008A","E01029925","Total",32,14,11,7,5,0,5,0,27,14,6,7
"2011","Forest Heath 008B","E01029949","Total",44,18,14,12,5,0,2,3,39,18,12,9
"2011","Forest Heath 008C","E01029950","Total",83,34,16,33,7,2,3,2,76,32,13,31
"2011","Forest Heath 008D","E01029951","Total",25,8,10,7,4,1,2,1,21,7,8,6
"2011","Forest Heath 008E","E01029952","Total",32,14,11,7,1,0,1,0,31,14,10,7
"2011","Forest Heath 008F","E01032612","Total",50,23,14,13,3,1,1,1,47,22,13,12
"2011","Ipswich 001A","E01030032","Total",65,25,12,28,7,2,2,3,58,23,10,25
"2011","Ipswich 001B","E01030033","Total",18,12,3,3,5,1,3,1,13,11,0,2
"2011","Ipswich 001C","E01030034","Total",23,8,10,5,5,0,3,2,18,8,7,3
"2011","Ipswich 001D","E01030035","Total",76,26,12,38,6,1,2,3,70,25,10,35
"2011","Ipswich 001E","E01030036","Total",48,17,5,26,3,1,0,2,45,16,5,24
"2011","Ipswich 002A","E01029973","Total",9,4,3,2,1,0,1,0,8,4,2,2
"2011","Ipswich 002B","E01029974","Total",35,21,7,7,4,1,3,0,31,20,4,7
"2011","Ipswich 002C","E01029975","Total",28,15,7,6,2,0,2,0,26,15,5,6
"2011","Ipswich 002D","E01029976","Total",32,10,11,11,3,0,3,0,29,10,8,11
"2011","Ipswich 002E","E01029977","Total",26,17,5,4,3,1,2,0,23,16,3,4
"2011","Ipswich 003A","E01030027","Total",75,31,22,22,6,0,4,2,69,31,18,20
"2011","Ipswich 003B","E01030028","Total",50,22,6,22,2,1,1,0,48,21,5,22
"2011","Ipswich 003C","E01030029","Total",66,16,9,41,4,0,3,1,62,16,6,40
"2011","Ipswich 003D","E01030030","Total",94,35,19,40,11,0,8,3,83,35,11,37
"2011","Ipswich 003E","E01030031","Total",63,14,10,39,2,1,1,0,61,13,9,39
"2011","Ipswich 004A","E01029997","Total",41,18,10,13,5,1,1,3,36,17,9,10
"2011","Ipswich 004B","E01029998","Total",85,35,10,40,3,1,1,1,82,34,9,39
"2011","Ipswich 004C","E01029999","Total",30,15,10,5,8,1,5,2,22,14,5,3
"2011","Ipswich 004D","E01030000","Total",47,18,21,8,8,1,5,2,39,17,16,6
"2011","Ipswich 004E","E01030001","Total",32,16,8,8,3,1,1,1,29,15,7,7
"2011","Ipswich 005A","E01030007","Total",44,12,21,11,8,1,6,1,36,11,15,10
"2011","Ipswich 005B","E01030008","Total",17,7,9,1,0,0,0,0,17,7,9,1
"2011","Ipswich 005C","E01030009","Total",22,8,11,3,2,0,1,1,20,8,10,2
"2011","Ipswich 005D","E01030010","Total",79,40,15,24,4,0,2,2,75,40,13,22
"2011","Ipswich 005E","E01030011","Total",19,8,6,5,3,0,3,0,16,8,3,5
"2011","Ipswich 006A","E01030022","Total",69,28,14,27,9,3,2,4,60,25,12,23
"2011","Ipswich 006B","E01030023","Total",86,37,18,31,8,1,4,3,78,36,14,28
"2011","Ipswich 006C","E01030024","Total",60,22,16,22,3,0,2,1,57,22,14,21
"2011","Ipswich 006D","E01030025","Total",54,14,16,24,6,1,4,1,48,13,12,23
"2011","Ipswich 006E","E01030026","Total",84,29,14,41,10,5,2,3,74,24,12,38
"2011","Ipswich 007A","E01029958","Total",53,20,12,21,2,0,1,1,51,20,11,20
"2011","Ipswich 007C","E01029960","Total",58,23,17,18,5,2,2,1,53,21,15,17
"2011","Ipswich 007D","E01029961","Total",74,34,19,21,2,0,2,0,72,34,17,21
"2011","Ipswich 007E","E01029962","Total",57,19,10,28,3,0,1,2,54,19,9,26
"2011","Ipswich 007F","E01033124","Total",8,2,4,2,3,1,2,0,5,1,2,2
"2011","Ipswich 007G","E01033125","Total",27,3,6,18,4,0,3,1,23,3,3,17
"2011","Ipswich 007H","E01033129","Total",34,9,7,18,7,1,2,4,27,8,5,14
"2011","Ipswich 008A","E01030002","Total",53,29,11,13,2,0,2,0,51,29,9,13
"2011","Ipswich 008B","E01030003","Total",44,21,10,13,4,2,2,0,40,19,8,13
"2011","Ipswich 008C","E01030004","Total",20,13,2,5,1,1,0,0,19,12,2,5
"2011","Ipswich 008D","E01030005","Total",111,45,26,40,11,1,8,2,100,44,18,38
"2011","Ipswich 008E","E01030006","Total",75,45,9,21,3,1,2,0,72,44,7,21
"2011","Ipswich 009A","E01029963","Total",26,10,11,5,2,0,2,0,24,10,9,5
"2011","Ipswich 009B","E01029964","Total",38,15,15,8,4,0,2,2,34,15,13,6
"2011","Ipswich 009C","E01029965","Total",24,12,5,7,2,0,2,0,22,12,3,7
"2011","Ipswich 009D","E01029966","Total",18,6,6,6,3,0,1,2,15,6,5,4
"2011","Ipswich 009E","E01029967","Total",14,6,5,3,3,1,2,0,11,5,3,3
"2011","Ipswich 010A","E01029984","Total",79,25,7,47,4,1,2,1,75,24,5,46
"2011","Ipswich 010B","E01029985","Total",68,20,10,38,4,1,3,0,64,19,7,38
"2011","Ipswich 010C","E01029986","Total",89,39,11,39,8,0,2,6,81,39,9,33
"2011","Ipswich 010D","E01029987","Total",43,21,7,15,3,0,1,2,40,21,6,13
"2011","Ipswich 010E","E01029988","Total",74,29,8,37,6,1,1,4,68,28,7,33
"2011","Ipswich 011B","E01029990","Total",81,33,14,34,12,0,3,9,69,33,11,25
"2011","Ipswich 011C","E01029991","Total",21,10,7,4,3,2,1,0,18,8,6,4
"2011","Ipswich 011D","E01029992","Total",28,13,7,8,4,0,3,1,24,13,4,7
"2011","Ipswich 011E","E01033123","Total",71,24,17,30,5,0,3,2,66,24,14,28
"2011","Ipswich 011F","E01033126","Total",35,10,8,17,6,0,4,2,29,10,4,15
"2011","Ipswich 012A","E01029968","Total",67,23,15,29,6,0,1,5,61,23,14,24
"2011","Ipswich 012B","E01029969","Total",38,14,11,13,2,0,2,0,36,14,9,13
"2011","Ipswich 012C","E01029970","Total",33,13,9,11,3,0,1,2,30,13,8,9
"2011","Ipswich 012D","E01029971","Total",61,20,12,29,4,0,3,1,57,20,9,28
"2011","Ipswich 012F","E01033122","Total",106,32,13,61,11,0,3,8,95,32,10,53
"2011","Ipswich 012G","E01033130","Total",36,13,10,13,5,1,2,2,31,12,8,11
"2011","Ipswich 013A","E01030012","Total",28,7,0,21,3,1,0,2,25,6,0,19
"2011","Ipswich 013B","E01030013","Total",41,18,7,16,6,0,3,3,35,18,4,13
"2011","Ipswich 013C","E01030014","Total",33,12,10,11,3,1,2,0,30,11,8,11
"2011","Ipswich 013D","E01030015","Total",18,5,7,6,2,0,2,0,16,5,5,6
"2011","Ipswich 013E","E01030016","Total",43,16,11,16,3,0,2,1,40,16,9,15
"2011","Ipswich 014B","E01029994","Total",74,22,8,44,10,2,3,5,64,20,5,39
"2011","Ipswich 014C","E01029995","Total",28,8,15,5,3,0,2,1,25,8,13,4
"2011","Ipswich 014D","E01029996","Total",56,15,8,33,5,1,2,2,51,14,6,31
"2011","Ipswich 014E","E01033127","Total",74,24,12,38,3,0,2,1,71,24,10,37
"2011","Ipswich 014F","E01033128","Total",35,19,6,10,3,0,3,0,32,19,3,10
"2011","Ipswich 014G","E01033131","Total",76,27,12,37,6,2,3,1,70,25,9,36
"2011","Ipswich 015A","E01030017","Total",49,19,8,22,4,0,1,3,45,19,7,19
"2011","Ipswich 015B","E01030018","Total",86,23,8,55,12,3,3,6,74,20,5,49
"2011","Ipswich 015C","E01030019","Total",43,24,9,10,6,0,3,3,37,24,6,7
"2011","Ipswich 015D","E01030020","Total",31,12,9,10,2,0,1,1,29,12,8,9
"2011","Ipswich 015E","E01030021","Total",78,22,7,49,4,0,1,3,74,22,6,46
"2011","Ipswich 016A","E01029978","Total",39,11,8,20,6,0,3,3,33,11,5,17
"2011","Ipswich 016B","E01029979","Total",90,25,8,57,11,0,3,8,79,25,5,49
"2011","Ipswich 016C","E01029980","Total",122,34,12,76,5,2,1,2,117,32,11,74
"2011","Ipswich 016D","E01029981","Total",25,9,3,13,3,0,2,1,22,9,1,12
"2011","Ipswich 016E","E01029982","Total",70,18,4,48,6,2,1,3,64,16,3,45
"2011","Ipswich 016F","E01029983","Total",25,12,8,5,2,0,2,0,23,12,6,5
"2011","Mid Suffolk 001A","E01030052","Total",59,18,28,13,13,0,13,0,46,18,15,13
"2011","Mid Suffolk 001B","E01030058","Total",43,17,14,12,8,4,4,0,35,13,10,12
"2011","Mid Suffolk 001C","E01030064","Total",24,13,6,5,3,0,3,0,21,13,3,5
"2011","Mid Suffolk 001D","E01030088","Total",19,7,8,4,3,1,2,0,16,6,6,4
"2011","Mid Suffolk 002A","E01030039","Total",22,10,7,5,4,0,3,1,18,10,4,4
"2011","Mid Suffolk 002B","E01030054","Total",18,7,5,6,2,0,2,0,16,7,3,6
"2011","Mid Suffolk 002C","E01030055","Total",25,10,9,6,2,0,2,0,23,10,7,6
"2011","Mid Suffolk 002D","E01030066","Total",24,9,6,9,3,0,1,2,21,9,5,7
"2011","Mid Suffolk 002E","E01030067","Total",34,18,10,6,6,0,5,1,28,18,5,5
"2011","Mid Suffolk 002F","E01030068","Total",40,22,11,7,6,0,4,2,34,22,7,5
"2011","Mid Suffolk 003A","E01030053","Total",41,13,13,15,8,1,4,3,33,12,9,12
"2011","Mid Suffolk 003B","E01030082","Total",49,23,10,16,8,1,2,5,41,22,8,11
"2011","Mid Suffolk 003C","E01030090","Total",43,21,12,10,7,3,2,2,36,18,10,8
"2011","Mid Suffolk 004A","E01030040","Total",17,6,3,8,1,0,0,1,16,6,3,7
"2011","Mid Suffolk 004B","E01030049","Total",28,11,10,7,3,1,2,0,25,10,8,7
"2011","Mid Suffolk 004C","E01030050","Total",45,21,15,9,8,1,4,3,37,20,11,6
"2011","Mid Suffolk 004D","E01030084","Total",16,6,7,3,0,0,0,0,16,6,7,3
"2011","Mid Suffolk 004E","E01030085","Total",35,16,12,7,2,1,0,1,33,15,12,6
"2011","Mid Suffolk 005A","E01030037","Total",30,13,8,9,4,0,3,1,26,13,5,8
"2011","Mid Suffolk 005B","E01030038","Total",23,9,9,5,8,3,3,2,15,6,6,3
"2011","Mid Suffolk 005C","E01030059","Total",34,12,8,14,3,0,3,0,31,12,5,14
"2011","Mid Suffolk 005D","E01030081","Total",48,21,15,12,7,1,5,1,41,20,10,11
"2011","Mid Suffolk 006A","E01030051","Total",41,13,14,14,8,0,5,3,33,13,9,11
"2011","Mid Suffolk 006B","E01030056","Total",35,21,8,6,4,1,2,1,31,20,6,5
"2011","Mid Suffolk 006C","E01030065","Total",30,14,8,8,4,0,3,1,26,14,5,7
"2011","Mid Suffolk 006D","E01030086","Total",30,8,9,13,8,2,4,2,22,6,5,11
"2011","Mid Suffolk 006E","E01030089","Total",32,13,6,13,2,1,0,1,30,12,6,12
"2011","Mid Suffolk 007A","E01030048","Total",62,22,17,23,7,1,3,3,55,21,14,20
"2011","Mid Suffolk 007B","E01030057","Total",37,16,11,10,5,1,4,0,32,15,7,10
"2011","Mid Suffolk 007C","E01030083","Total",23,8,11,4,5,0,4,1,18,8,7,3
"2011","Mid Suffolk 007D","E01030087","Total",12,2,4,6,3,0,3,0,9,2,1,6
"2011","Mid Suffolk 008A","E01030073","Total",62,20,11,31,4,0,3,1,58,20,8,30
"2011","Mid Suffolk 008B","E01030077","Total",55,17,6,32,5,1,1,3,50,16,5,29
"2011","Mid Suffolk 008C","E01030079","Total",82,30,12,40,1,0,1,0,81,30,11,40
"2011","Mid Suffolk 008D","E01030080","Total",40,19,8,13,5,2,3,0,35,17,5,13
"2011","Mid Suffolk 009A","E01030063","Total",41,21,10,10,4,0,3,1,37,21,7,9
"2011","Mid Suffolk 009B","E01030069","Total",11,5,2,4,2,0,2,0,9,5,0,4
"2011","Mid Suffolk 009C","E01030072","Total",42,21,11,10,12,2,7,3,30,19,4,7
"2011","Mid Suffolk 009D","E01030075","Total",44,27,9,8,7,2,5,0,37,25,4,8
"2011","Mid Suffolk 010A","E01030060","Total",39,18,13,8,6,4,2,0,33,14,11,8
"2011","Mid Suffolk 010B","E01030071","Total",42,11,17,14,4,1,2,1,38,10,15,13
"2011","Mid Suffolk 010D","E01030076","Total",59,17,21,21,7,1,6,0,52,16,15,21
"2011","Mid Suffolk 010E","E01030078","Total",35,14,13,8,7,1,6,0,28,13,7,8
"2011","Mid Suffolk 010F","E01033316","Total",48,17,16,15,5,0,3,2,43,17,13,13
"2011","Mid Suffolk 010G","E01033317","Total",59,16,21,22,11,0,8,3,48,16,13,19
"2011","Mid Suffolk 010H","E01033319","Total",45,17,15,13,5,1,3,1,40,16,12,12
"2011","Mid Suffolk 011A","E01030041","Total",25,11,9,5,3,0,3,0,22,11,6,5
"2011","Mid Suffolk 011B","E01030043","Total",26,7,10,9,4,0,3,1,22,7,7,8
"2011","Mid Suffolk 011C","E01030061","Total",27,15,5,7,1,0,1,0,26,15,4,7
"2011","Mid Suffolk 011D","E01030062","Total",26,14,7,5,2,1,1,0,24,13,6,5
"2011","Mid Suffolk 011E","E01030070","Total",18,6,8,4,3,0,3,0,15,6,5,4
"2011","Mid Suffolk 012A","E01030042","Total",27,12,11,4,4,2,1,1,23,10,10,3
"2011","Mid Suffolk 012B","E01030044","Total",20,11,6,3,2,1,1,0,18,10,5,3
"2011","Mid Suffolk 012C","E01030045","Total",32,15,9,8,2,1,0,1,30,14,9,7
"2011","Mid Suffolk 012D","E01030046","Total",28,12,14,2,11,1,10,0,17,11,4,2
"2011","Mid Suffolk 012E","E01030047","Total",37,10,19,8,10,1,8,1,27,9,11,7
"2011","St Edmundsbury 001A","E01030095","Total",24,11,8,5,3,0,2,1,21,11,6,4
"2011","St Edmundsbury 001B","E01030096","Total",16,4,5,7,0,0,0,0,16,4,5,7
"2011","St Edmundsbury 001C","E01030097","Total",22,8,4,10,2,0,2,0,20,8,2,10
"2011","St Edmundsbury 001D","E01030145","Total",40,14,14,12,5,1,2,2,35,13,12,10
"2011","St Edmundsbury 001E","E01030146","Total",16,5,8,3,5,0,3,2,11,5,5,1
"2011","St Edmundsbury 002A","E01030094","Total",36,17,10,9,7,1,4,2,29,16,6,7
"2011","St Edmundsbury 002B","E01030121","Total",54,19,19,16,7,2,5,0,47,17,14,16
"2011","St Edmundsbury 002C","E01030132","Total",20,10,7,3,4,0,3,1,16,10,4,2
"2011","St Edmundsbury 002D","E01030133","Total",21,11,5,5,3,0,2,1,18,11,3,4
"2011","St Edmundsbury 003A","E01030130","Total",54,16,12,26,3,1,0,2,51,15,12,24
"2011","St Edmundsbury 003B","E01030131","Total",75,14,23,38,11,0,6,5,64,14,17,33
"2011","St Edmundsbury 003C","E01030139","Total",88,29,19,40,13,2,4,7,75,27,15,33
"2011","St Edmundsbury 003D","E01030140","Total",48,17,12,19,3,0,1,2,45,17,11,17
"2011","St Edmundsbury 003E","E01030141","Total",65,28,12,25,5,1,1,3,60,27,11,22
"2011","St Edmundsbury 004A","E01030103","Total",25,12,7,6,3,2,1,0,22,10,6,6
"2011","St Edmundsbury 004B","E01030104","Total",18,6,7,5,6,0,5,1,12,6,2,4
"2011","St Edmundsbury 004C","E01030138","Total",60,25,15,20,11,1,4,6,49,24,11,14
"2011","St Edmundsbury 005B","E01030127","Total",16,9,4,3,1,0,1,0,15,9,3,3
"2011","St Edmundsbury 005C","E01030128","Total",32,16,10,6,3,0,2,1,29,16,8,5
"2011","St Edmundsbury 005D","E01030129","Total",24,10,12,2,2,0,2,0,22,10,10,2
"2011","St Edmundsbury 005E","E01033044","Total",62,30,19,13,4,0,3,1,58,30,16,12
"2011","St Edmundsbury 005F","E01033045","Total",41,18,9,14,2,0,1,1,39,18,8,13
"2011","St Edmundsbury 005G","E01033050","Total",30,14,14,2,2,0,2,0,28,14,12,2
"2011","St Edmundsbury 006A","E01030091","Total",40,11,16,13,1,0,1,0,39,11,15,13
"2011","St Edmundsbury 006B","E01030093","Total",34,10,15,9,5,1,4,0,29,9,11,9
"2011","St Edmundsbury 006D","E01030137","Total",41,19,9,13,7,3,4,0,34,16,5,13
"2011","St Edmundsbury 006E","E01033043","Total",49,22,14,13,3,0,3,0,46,22,11,13
"2011","St Edmundsbury 006F","E01033046","Total",34,13,11,10,1,0,1,0,33,13,10,10
"2011","St Edmundsbury 006G","E01033047","Total",29,14,9,6,4,0,3,1,25,14,6,5
"2011","St Edmundsbury 007A","E01030092","Total",58,24,19,15,6,1,4,1,52,23,15,14
"2011","St Edmundsbury 007B","E01030123","Total",59,18,9,32,7,2,1,4,52,16,8,28
"2011","St Edmundsbury 007C","E01030124","Total",20,8,9,3,4,0,4,0,16,8,5,3
"2011","St Edmundsbury 007D","E01030125","Total",44,17,13,14,0,0,0,0,44,17,13,14
"2011","St Edmundsbury 007E","E01030148","Total",25,9,14,2,4,0,4,0,21,9,10,2
"2011","St Edmundsbury 007F","E01030149","Total",28,12,11,5,3,0,3,0,25,12,8,5
"2011","St Edmundsbury 008A","E01030098","Total",41,20,11,10,2,1,1,0,39,19,10,10
"2011","St Edmundsbury 008B","E01030100","Total",36,12,12,12,6,1,3,2,30,11,9,10
"2011","St Edmundsbury 008C","E01030119","Total",41,18,13,10,3,2,1,0,38,16,12,10
"2011","St Edmundsbury 008D","E01030134","Total",23,10,10,3,1,0,1,0,22,10,9,3
"2011","St Edmundsbury 008E","E01030135","Total",9,6,2,1,1,0,1,0,8,6,1,1
"2011","St Edmundsbury 009B","E01030142","Total",23,9,9,5,2,0,2,0,21,9,7,5
"2011","St Edmundsbury 009C","E01030143","Total",39,18,12,9,4,0,1,3,35,18,11,6
"2011","St Edmundsbury 009D","E01030144","Total",22,11,6,5,1,0,0,1,21,11,6,4
"2011","St Edmundsbury 009E","E01030147","Total",13,5,4,4,2,2,0,0,11,3,4,4
"2011","St Edmundsbury 009F","E01033048","Total",48,14,18,16,2,0,2,0,46,14,16,16
"2011","St Edmundsbury 009G","E01033049","Total",15,6,9,0,3,2,1,0,12,4,8,0
"2011","St Edmundsbury 010A","E01030099","Total",26,9,10,7,4,1,2,1,22,8,8,6
"2011","St Edmundsbury 010B","E01030101","Total",34,19,12,3,2,0,2,0,32,19,10,3
"2011","St Edmundsbury 010C","E01030150","Total",26,14,4,8,4,1,1,2,22,13,3,6
"2011","St Edmundsbury 011A","E01030120","Total",33,13,16,4,4,3,1,0,29,10,15,4
"2011","St Edmundsbury 011B","E01030122","Total",26,14,7,5,1,0,1,0,25,14,6,5
"2011","St Edmundsbury 011C","E01030151","Total",24,14,5,5,4,3,1,0,20,11,4,5
"2011","St Edmundsbury 012A","E01030109","Total",82,26,18,38,4,2,2,0,78,24,16,38
"2011","St Edmundsbury 012B","E01030110","Total",86,34,23,29,12,0,8,4,74,34,15,25
"2011","St Edmundsbury 012C","E01030111","Total",20,9,5,6,3,1,1,1,17,8,4,5
"2011","St Edmundsbury 012D","E01030112","Total",37,12,14,11,4,0,3,1,33,12,11,10
"2011","St Edmundsbury 013A","E01030115","Total",103,31,33,39,11,2,6,3,92,29,27,36
"2011","St Edmundsbury 013B","E01030116","Total",61,29,19,13,4,1,2,1,57,28,17,12
"2011","St Edmundsbury 013C","E01030117","Total",43,16,18,9,6,0,4,2,37,16,14,7
"2011","St Edmundsbury 013D","E01030118","Total",58,18,18,22,7,0,5,2,51,18,13,20
"2011","St Edmundsbury 014A","E01030105","Total",44,22,10,12,2,0,1,1,42,22,9,11
"2011","St Edmundsbury 014B","E01030106","Total",98,28,29,41,9,1,5,3,89,27,24,38
"2011","St Edmundsbury 014C","E01030107","Total",18,6,6,6,2,1,1,0,16,5,5,6
"2011","St Edmundsbury 014D","E01030108","Total",64,20,18,26,10,1,5,4,54,19,13,22
"2011","St Edmundsbury 014E","E01030113","Total",54,15,25,14,5,0,4,1,49,15,21,13
"2011","St Edmundsbury 014F","E01030114","Total",64,26,9,29,5,0,1,4,59,26,8,25
"2011","Suffolk Coastal 001A","E01030201","Total",31,11,8,12,3,0,3,0,28,11,5,12
"2011","Suffolk Coastal 001B","E01030219","Total",33,12,10,11,5,2,1,2,28,10,9,9
"2011","Suffolk Coastal 001C","E01030222","Total",23,8,7,8,2,0,2,0,21,8,5,8
"2011","Suffolk Coastal 002A","E01030154","Total",41,18,14,9,6,2,4,0,35,16,10,9
"2011","Suffolk Coastal 002B","E01030172","Total",29,15,9,5,2,0,2,0,27,15,7,5
"2011","Suffolk Coastal 002C","E01030173","Total",28,15,10,3,3,0,3,0,25,15,7,3
"2011","Suffolk Coastal 002D","E01030174","Total",32,12,11,9,7,1,6,0,25,11,5,9
"2011","Suffolk Coastal 002E","E01030176","Total",38,14,17,7,5,1,4,0,33,13,13,7
"2011","Suffolk Coastal 003A","E01030186","Total",23,12,5,6,2,1,1,0,21,11,4,6
"2011","Suffolk Coastal 003B","E01030208","Total",28,15,5,8,1,0,1,0,27,15,4,8
"2011","Suffolk Coastal 003C","E01030209","Total",36,17,13,6,8,2,5,1,28,15,8,5
"2011","Suffolk Coastal 003D","E01030210","Total",61,22,13,26,8,1,3,4,53,21,10,22
"2011","Suffolk Coastal 003E","E01030212","Total",30,12,11,7,5,3,2,0,25,9,9,7
"2011","Suffolk Coastal 004A","E01030152","Total",17,6,7,4,1,0,1,0,16,6,6,4
"2011","Suffolk Coastal 004B","E01030153","Total",16,7,3,6,2,0,2,0,14,7,1,6
"2011","Suffolk Coastal 004C","E01030187","Total",52,23,9,20,7,2,3,2,45,21,6,18
"2011","Suffolk Coastal 004D","E01030188","Total",45,20,10,15,9,0,6,3,36,20,4,12
"2011","Suffolk Coastal 004E","E01030189","Total",51,24,11,16,8,2,3,3,43,22,8,13
"2011","Suffolk Coastal 005A","E01030193","Total",35,16,12,7,7,1,5,1,28,15,7,6
"2011","Suffolk Coastal 005B","E01030194","Total",39,18,7,14,1,1,0,0,38,17,7,14
"2011","Suffolk Coastal 005C","E01030195","Total",23,11,4,8,2,0,1,1,21,11,3,7
"2011","Suffolk Coastal 005D","E01030220","Total",39,16,16,7,8,1,6,1,31,15,10,6
"2011","Suffolk Coastal 006A","E01030175","Total",38,15,9,14,7,0,6,1,31,15,3,13
"2011","Suffolk Coastal 006B","E01030200","Total",30,10,4,16,6,3,0,3,24,7,4,13
"2011","Suffolk Coastal 006C","E01030221","Total",18,4,9,5,2,0,2,0,16,4,7,5
"2011","Suffolk Coastal 007C","E01030199","Total",29,16,10,3,4,0,4,0,25,16,6,3
"2011","Suffolk Coastal 007F","E01033443","Total",25,10,10,5,4,1,3,0,21,9,7,5
"2011","Suffolk Coastal 007G","E01033445","Total",55,28,17,10,4,0,3,1,51,28,14,9
"2011","Suffolk Coastal 007H","E01033446","Total",21,14,6,1,4,2,2,0,17,12,4,1
"2011","Suffolk Coastal 007I","E01033448","Total",19,8,5,6,2,0,2,0,17,8,3,6
"2011","Suffolk Coastal 007J","E01033449","Total",49,28,10,11,5,3,2,0,44,25,8,11
"2011","Suffolk Coastal 008A","E01030155","Total",66,30,18,18,13,2,9,2,53,28,9,16
"2011","Suffolk Coastal 008B","E01030185","Total",92,35,11,46,4,2,1,1,88,33,10,45
"2011","Suffolk Coastal 008C","E01030203","Total",18,5,8,5,2,0,2,0,16,5,6,5
"2011","Suffolk Coastal 008D","E01030211","Total",62,19,17,26,5,1,3,1,57,18,14,25
"2011","Suffolk Coastal 009A","E01030179","Total",72,27,29,16,9,1,7,1,63,26,22,15
"2011","Suffolk Coastal 009B","E01030180","Total",27,9,9,9,1,1,0,0,26,8,9,9
"2011","Suffolk Coastal 009C","E01030183","Total",28,14,10,4,4,1,2,1,24,13,8,3
"2011","Suffolk Coastal 009D","E01030184","Total",49,18,16,15,4,0,3,1,45,18,13,14
"2011","Suffolk Coastal 009E","E01030207","Total",26,11,11,4,4,0,4,0,22,11,7,4
"2011","Suffolk Coastal 010A","E01030181","Total",38,15,18,5,4,0,3,1,34,15,15,4
"2011","Suffolk Coastal 010C","E01030190","Total",22,13,5,4,2,0,1,1,20,13,4,3
"2011","Suffolk Coastal 010D","E01030191","Total",46,19,16,11,3,0,2,1,43,19,14,10
"2011","Suffolk Coastal 010E","E01030192","Total",19,7,8,4,4,0,2,2,15,7,6,2
"2011","Suffolk Coastal 010F","E01030198","Total",12,3,5,4,4,1,3,0,8,2,2,4
"2011","Suffolk Coastal 010G","E01033442","Total",56,22,26,8,4,0,3,1,52,22,23,7
"2011","Suffolk Coastal 010H","E01033444","Total",47,18,21,8,5,0,4,1,42,18,17,7
"2011","Suffolk Coastal 010I","E01033447","Total",25,9,8,8,2,0,1,1,23,9,7,7
"2011","Suffolk Coastal 011A","E01030196","Total",27,8,14,5,3,1,2,0,24,7,12,5
"2011","Suffolk Coastal 011B","E01030197","Total",10,4,6,0,1,0,1,0,9,4,5,0
"2011","Suffolk Coastal 011C","E01030204","Total",29,11,14,4,4,0,4,0,25,11,10,4
"2011","Suffolk Coastal 011D","E01030205","Total",14,5,7,2,1,0,1,0,13,5,6,2
"2011","Suffolk Coastal 011E","E01030206","Total",8,5,3,0,0,0,0,0,8,5,3,0
"2011","Suffolk Coastal 012A","E01030171","Total",45,20,14,11,6,0,5,1,39,20,9,10
"2011","Suffolk Coastal 012B","E01030214","Total",39,12,15,12,7,1,4,2,32,11,11,10
"2011","Suffolk Coastal 012C","E01030215","Total",32,11,7,14,5,0,2,3,27,11,5,11
"2011","Suffolk Coastal 012D","E01030216","Total",21,9,6,6,3,0,2,1,18,9,4,5
"2011","Suffolk Coastal 012E","E01030217","Total",22,7,5,10,3,0,2,1,19,7,3,9
"2011","Suffolk Coastal 012F","E01030218","Total",35,14,9,12,4,1,2,1,31,13,7,11
"2011","Suffolk Coastal 013C","E01030158","Total",10,2,6,2,2,1,1,0,8,1,5,2
"2011","Suffolk Coastal 013D","E01030159","Total",46,27,5,14,3,0,2,1,43,27,3,13
"2011","Suffolk Coastal 013E","E01030164","Total",26,15,9,2,3,1,2,0,23,14,7,2
"2011","Suffolk Coastal 013F","E01030166","Total",18,5,9,4,4,0,3,1,14,5,6,3
"2011","Suffolk Coastal 013G","E01033450","Total",27,13,9,5,1,0,1,0,26,13,8,5
"2011","Suffolk Coastal 014A","E01030160","Total",33,15,5,13,3,0,2,1,30,15,3,12
"2011","Suffolk Coastal 014B","E01030161","Total",79,32,18,29,6,1,3,2,73,31,15,27
"2011","Suffolk Coastal 014C","E01030168","Total",66,29,12,25,4,0,4,0,62,29,8,25
"2011","Suffolk Coastal 014D","E01030169","Total",95,31,16,48,6,0,5,1,89,31,11,47
"2011","Suffolk Coastal 014E","E01030170","Total",61,13,8,40,4,0,1,3,57,13,7,37
"2011","Suffolk Coastal 015A","E01030162","Total",35,15,7,13,3,0,1,2,32,15,6,11
"2011","Suffolk Coastal 015B","E01030163","Total",66,16,16,34,6,0,5,1,60,16,11,33
"2011","Suffolk Coastal 015C","E01030165","Total",44,15,13,16,8,0,4,4,36,15,9,12
"2011","Suffolk Coastal 015D","E01030167","Total",25,12,7,6,1,0,1,0,24,12,6,6
"2011","Waveney 001A","E01030240","Total",12,7,2,3,0,0,0,0,12,7,2,3
"2011","Waveney 001B","E01030241","Total",18,9,5,4,5,0,3,2,13,9,2,2
"2011","Waveney 001C","E01030242","Total",13,5,6,2,2,0,2,0,11,5,4,2
"2011","Waveney 001D","E01030259","Total",13,8,4,1,3,0,3,0,10,8,1,1
"2011","Waveney 001E","E01030260","Total",21,9,7,5,6,0,4,2,15,9,3,3
"2011","Waveney 002A","E01030261","Total",71,22,10,39,10,1,5,4,61,21,5,35
"2011","Waveney 002B","E01030262","Total",42,18,6,18,5,1,3,1,37,17,3,17
"2011","Waveney 002C","E01030277","Total",47,12,8,27,2,1,1,0,45,11,7,27
"2011","Waveney 002D","E01030279","Total",75,17,11,47,8,0,1,7,67,17,10,40
"2011","Waveney 002E","E01030281","Total",72,32,8,32,8,2,2,4,64,30,6,28
"2011","Waveney 003A","E01030266","Total",52,24,9,19,7,1,5,1,45,23,4,18
"2011","Waveney 003B","E01030267","Total",38,11,10,17,3,0,2,1,35,11,8,16
"2011","Waveney 003C","E01030271","Total",17,6,6,5,2,0,2,0,15,6,4,5
"2011","Waveney 003D","E01030278","Total",32,7,5,20,6,0,3,3,26,7,2,17
"2011","Waveney 003E","E01030280","Total",17,9,3,5,4,1,1,2,13,8,2,3
"2011","Waveney 004A","E01030246","Total",73,28,22,23,9,1,5,3,64,27,17,20
"2011","Waveney 004B","E01030248","Total",65,24,8,33,5,0,2,3,60,24,6,30
"2011","Waveney 004C","E01030249","Total",89,31,14,44,5,1,2,2,84,30,12,42
"2011","Waveney 004D","E01030250","Total",103,27,17,59,12,1,5,6,91,26,12,53
"2011","Waveney 004E","E01030264","Total",56,13,12,31,4,0,0,4,52,13,12,27
"2011","Waveney 004F","E01030265","Total",70,30,8,32,5,1,2,2,65,29,6,30
"2011","Waveney 005A","E01030255","Total",36,11,5,20,8,1,3,4,28,10,2,16
"2011","Waveney 005B","E01030263","Total",26,7,9,10,5,1,3,1,21,6,6,9
"2011","Waveney 005C","E01030270","Total",63,26,20,17,8,2,6,0,55,24,14,17
"2011","Waveney 005D","E01030289","Total",39,15,6,18,4,1,1,2,35,14,5,16
"2011","Waveney 005E","E01030290","Total",27,9,2,16,4,1,0,3,23,8,2,13
"2011","Waveney 006A","E01030233","Total",17,8,8,1,1,0,1,0,16,8,7,1
"2011","Waveney 006B","E01030235","Total",12,7,3,2,3,1,2,0,9,6,1,2
"2011","Waveney 006C","E01030268","Total",21,10,6,5,2,0,1,1,19,10,5,4
"2011","Waveney 006D","E01030269","Total",24,13,7,4,1,0,1,0,23,13,6,4
"2011","Waveney 006E","E01030288","Total",13,6,3,4,1,0,1,0,12,6,2,4
"2011","Waveney 007A","E01030247","Total",54,12,8,34,4,0,3,1,50,12,5,33
"2011","Waveney 007B","E01030254","Total",79,31,10,38,7,3,2,2,72,28,8,36
"2011","Waveney 007C","E01030256","Total",35,14,8,13,4,0,3,1,31,14,5,12
"2011","Waveney 007D","E01030258","Total",51,13,7,31,10,2,1,7,41,11,6,24
"2011","Waveney 007E","E01030276","Total",54,23,16,15,5,0,4,1,49,23,12,14
"2011","Waveney 008A","E01030257","Total",50,25,9,16,3,1,2,0,47,24,7,16
"2011","Waveney 008B","E01030274","Total",37,17,6,14,4,1,3,0,33,16,3,14
"2011","Waveney 008C","E01030275","Total",17,6,4,7,2,0,0,2,15,6,4,5
"2011","Waveney 008D","E01030287","Total",39,11,8,20,6,0,3,3,33,11,5,17
"2011","Waveney 008E","E01030291","Total",73,15,12,46,1,0,1,0,72,15,11,46
"2011","Waveney 009A","E01030234","Total",103,37,14,52,5,2,2,1,98,35,12,51
"2011","Waveney 009B","E01030236","Total",59,24,16,19,4,2,2,0,55,22,14,19
"2011","Waveney 009C","E01030237","Total",62,29,26,7,6,1,5,0,56,28,21,7
"2011","Waveney 009D","E01030238","Total",48,15,20,13,7,0,7,0,41,15,13,13
"2011","Waveney 010A","E01030223","Total",52,19,12,21,5,0,3,2,47,19,9,19
"2011","Waveney 010B","E01030224","Total",35,7,11,17,4,1,3,0,31,6,8,17
"2011","Waveney 010C","E01030225","Total",63,29,6,28,5,2,3,0,58,27,3,28
"2011","Waveney 010D","E01030227","Total",54,17,8,29,8,2,2,4,46,15,6,25
"2011","Waveney 010E","E01030228","Total",37,11,13,13,6,0,4,2,31,11,9,11
"2011","Waveney 011A","E01030226","Total",80,37,15,28,4,1,3,0,76,36,12,28
"2011","Waveney 011B","E01030286","Total",32,14,8,10,3,1,1,1,29,13,7,9
"2011","Waveney 011C","E01030292","Total",27,13,6,8,4,1,2,1,23,12,4,7
"2011","Waveney 011D","E01030293","Total",26,10,12,4,4,0,3,1,22,10,9,3
"2011","Waveney 011E","E01030294","Total",38,13,11,14,3,0,2,1,35,13,9,13
"2011","Waveney 012A","E01030239","Total",50,19,15,16,7,1,5,1,43,18,10,15
"2011","Waveney 012B","E01030251","Total",48,22,8,18,2,0,1,1,46,22,7,17
"2011","Waveney 012C","E01030252","Total",34,19,1,14,2,1,0,1,32,18,1,13
"2011","Waveney 012D","E01030253","Total",51,19,13,19,6,2,2,2,45,17,11,17
"2011","Waveney 012E","E01030272","Total",40,18,10,12,4,0,2,2,36,18,8,10
"2011","Waveney 012F","E01030273","Total",19,8,4,7,1,0,1,0,18,8,3,7
"2011","Waveney 013A","E01030230","Total",38,14,8,16,4,1,3,0,34,13,5,16
"2011","Waveney 013B","E01030231","Total",58,20,13,25,12,2,7,3,46,18,6,22
"2011","Waveney 013C","E01030232","Total",48,22,9,17,4,0,3,1,44,22,6,16
"2011","Waveney 013D","E01030285","Total",25,15,5,5,3,0,3,0,22,15,2,5
"2011","Waveney 014A","E01030282","Total",19,9,4,6,0,0,0,0,19,9,4,6
"2011","Waveney 014B","E01030283","Total",35,10,14,11,6,0,5,1,29,10,9,10
"2011","Waveney 014C","E01030284","Total",12,6,2,4,1,1,0,0,11,5,2,4
"2011","Waveney 014D","E01030295","Total",57,22,15,20,10,2,4,4,47,20,11,16
"2011","Waveney 015A","E01030229","Total",46,18,12,16,4,1,2,1,42,17,10,15
"2011","Waveney 015B","E01030243","Total",44,16,13,15,5,0,2,3,39,16,11,12
"2011","Waveney 015C","E01030244","Total",20,6,5,9,0,0,0,0,20,6,5,9
"2011","Waveney 015D","E01030245","Total",20,9,8,3,3,0,3,0,17,9,5,3
"2011","Camden 001A","E01000907","Total",92,20,21,51,6,1,2,3,86,19,19,48
"2011","Camden 001B","E01000908","Total",70,25,11,34,5,2,1,2,65,23,10,32
"2011","Camden 001C","E01000909","Total",22,3,6,13,1,0,0,1,21,3,6,12
"2011","Camden 001D","E01000912","Total",63,21,12,30,4,2,1,1,59,19,11,29
"2011","Camden 001E","E01000913","Total",16,7,7,2,2,0,2,0,14,7,5,2
"2011","Camden 002A","E01000893","Total",22,7,7,8,5,2,2,1,17,5,5,7
"2011","Camden 002B","E01000894","Total",12,5,4,3,1,1,0,0,11,4,4,3
"2011","Camden 002C","E01000895","Total",28,11,10,7,4,1,3,0,24,10,7,7
"2011","Camden 002D","E01000896","Total",11,4,3,4,3,1,1,1,8,3,2,3
"2011","Camden 002E","E01000899","Total",18,2,9,7,5,1,3,1,13,1,6,6
"2011","Camden 003A","E01000910","Total",12,5,4,3,0,0,0,0,12,5,4,3
"2011","Camden 003B","E01000911","Total",52,17,13,22,5,1,3,1,47,16,10,21
"2011","Camden 003C","E01000921","Total",53,6,12,35,4,0,1,3,49,6,11,32
"2011","Camden 003D","E01000923","Total",49,15,17,17,4,1,3,0,45,14,14,17
"2011","Camden 003E","E01000928","Total",56,19,8,29,1,0,0,1,55,19,8,28
"2011","Camden 004A","E01000878","Total",19,5,4,10,1,0,1,0,18,5,3,10
"2011","Camden 004B","E01000879","Total",17,7,5,5,2,0,2,0,15,7,3,5
"2011","Camden 004C","E01000880","Total",20,7,6,7,2,1,1,0,18,6,5,7
"2011","Camden 004D","E01000884","Total",21,6,7,8,1,0,1,0,20,6,6,8
"2011","Camden 004E","E01000885","Total",22,7,7,8,5,0,2,3,17,7,5,5
"2011","Camden 005A","E01000871","Total",22,3,6,13,3,0,2,1,19,3,4,12
"2011","Camden 005B","E01000872","Total",45,10,13,22,3,1,2,0,42,9,11,22
"2011","Camden 005C","E01000873","Total",43,14,17,12,1,0,0,1,42,14,17,11
"2011","Camden 005D","E01000874","Total",20,6,9,5,1,0,1,0,19,6,8,5
"2011","Camden 005E","E01000877","Total",28,5,16,7,1,0,0,1,27,5,16,6
"2011","Camden 006A","E01000886","Total",45,13,9,23,6,0,0,6,39,13,9,17
"2011","Camden 006B","E01000887","Total",33,5,9,19,4,0,1,3,29,5,8,16
"2011","Camden 006C","E01000888","Total",36,8,12,16,1,0,0,1,35,8,12,15
"2011","Camden 006D","E01000892","Total",57,7,16,34,2,0,1,1,55,7,15,33
"2011","Camden 006E","E01000903","Total",26,5,8,13,3,0,1,2,23,5,7,11
"2011","Camden 007A","E01000889","Total",87,21,18,48,6,1,4,1,81,20,14,47
"2011","Camden 007B","E01000890","Total",89,18,16,55,6,2,0,4,83,16,16,51
"2011","Camden 007C","E01000891","Total",102,19,20,63,10,5,2,3,92,14,18,60
"2011","Camden 007D","E01000901","Total",116,24,25,67,7,1,4,2,109,23,21,65
"2011","Camden 007E","E01000922","Total",49,7,9,33,6,0,4,2,43,7,5,31
"2011","Camden 007F","E01000927","Total",44,7,7,30,1,0,0,1,43,7,7,29
"2011","Camden 008A","E01000881","Total",18,5,3,10,1,0,1,0,17,5,2,10
"2011","Camden 008B","E01000882","Total",15,5,6,4,0,0,0,0,15,5,6,4
"2011","Camden 008C","E01000883","Total",15,5,1,9,0,0,0,0,15,5,1,9
"2011","Camden 008D","E01000897","Total",7,0,4,3,2,0,2,0,5,0,2,3
"2011","Camden 008E","E01000898","Total",29,5,13,11,4,0,3,1,25,5,10,10
"2011","Camden 009A","E01000866","Total",64,14,20,30,3,0,2,1,61,14,18,29
"2011","Camden 009B","E01000870","Total",63,14,15,34,2,0,1,1,61,14,14,33
"2011","Camden 009C","E01000924","Total",36,12,10,14,2,0,2,0,34,12,8,14
"2011","Camden 009D","E01000925","Total",83,16,17,50,5,1,3,1,78,15,14,49
"2011","Camden 009E","E01000926","Total",55,19,11,25,4,3,0,1,51,16,11,24
"2011","Camden 010A","E01000969","Total",32,4,18,10,0,0,0,0,32,4,18,10
"2011","Camden 010B","E01000970","Total",17,5,6,6,1,0,0,1,16,5,6,5
"2011","Camden 010C","E01000971","Total",19,4,7,8,0,0,0,0,19,4,7,8
"2011","Camden 010D","E01000972","Total",88,19,19,50,4,1,2,1,84,18,17,49
"2011","Camden 010E","E01000973","Total",58,14,15,29,3,0,1,2,55,14,14,27
"2011","Camden 011A","E01000842","Total",18,8,5,5,4,3,1,0,14,5,4,5
"2011","Camden 011B","E01000844","Total",17,2,8,7,0,0,0,0,17,2,8,7
"2011","Camden 011C","E01000848","Total",8,2,6,0,0,0,0,0,8,2,6,0
"2011","Camden 011D","E01000849","Total",26,8,8,10,1,0,1,0,25,8,7,10
"2011","Camden 012A","E01000900","Total",67,14,12,41,6,0,2,4,61,14,10,37
"2011","Camden 012B","E01000902","Total",82,20,16,46,5,1,0,4,77,19,16,42
"2011","Camden 012C","E01000904","Total",86,27,16,43,3,0,0,3,83,27,16,40
"2011","Camden 012D","E01000905","Total",120,18,20,82,3,0,1,2,117,18,19,80
"2011","Camden 012E","E01000906","Total",21,4,6,11,3,0,2,1,18,4,4,10
"2011","Camden 013A","E01000875","Total",65,20,18,27,5,2,1,2,60,18,17,25
"2011","Camden 013B","E01000876","Total",67,10,12,45,4,0,3,1,63,10,9,44
"2011","Camden 013C","E01000931","Total",86,23,17,46,7,1,2,4,79,22,15,42
"2011","Camden 013D","E01000932","Total",56,19,9,28,10,6,3,1,46,13,6,27
"2011","Camden 013E","E01000974","Total",66,33,6,27,1,0,0,1,65,33,6,26
"2011","Camden 014A","E01000843","Total",70,15,7,48,3,1,0,2,67,14,7,46
"2011","Camden 014B","E01000845","Total",26,8,8,10,0,0,0,0,26,8,8,10
"2011","Camden 014C","E01000846","Total",81,25,11,45,5,2,0,3,76,23,11,42
"2011","Camden 014D","E01000847","Total",65,18,8,39,3,0,1,2,62,18,7,37
"2011","Camden 015A","E01000864","Total",48,15,12,21,3,0,1,2,45,15,11,19
"2011","Camden 015B","E01000865","Total",12,4,4,4,2,1,0,1,10,3,4,3
"2011","Camden 015C","E01000867","Total",56,17,12,27,7,5,2,0,49,12,10,27
"2011","Camden 015D","E01000868","Total",79,24,16,39,2,0,1,1,77,24,15,38
"2011","Camden 015E","E01000869","Total",60,19,15,26,3,1,0,2,57,18,15,24
"2011","Camden 016A","E01000962","Total",22,3,4,15,0,0,0,0,22,3,4,15
"2011","Camden 016B","E01000964","Total",46,8,12,26,3,0,2,1,43,8,10,25
"2011","Camden 016C","E01000965","Total",35,6,10,19,0,0,0,0,35,6,10,19
"2011","Camden 016D","E01000966","Total",9,1,4,4,1,1,0,0,8,0,4,4
"2011","Camden 016E","E01000968","Total",22,5,2,15,1,1,0,0,21,4,2,15
"2011","Camden 017A","E01000960","Total",38,12,5,21,1,0,0,1,37,12,5,20
"2011","Camden 017B","E01000961","Total",72,8,16,48,5,0,3,2,67,8,13,46
"2011","Camden 017C","E01000963","Total",28,3,10,15,0,0,0,0,28,3,10,15
"2011","Camden 017D","E01000967","Total",20,4,6,10,0,0,0,0,20,4,6,10
"2011","Camden 018A","E01000857","Total",19,5,3,11,2,1,0,1,17,4,3,10
"2011","Camden 018B","E01000858","Total",89,21,18,50,5,1,2,2,84,20,16,48
"2011","Camden 018C","E01000859","Total",16,3,4,9,0,0,0,0,16,3,4,9
"2011","Camden 018D","E01000860","Total",23,6,9,8,1,0,1,0,22,6,8,8
"2011","Camden 018E","E01000862","Total",20,4,5,11,0,0,0,0,20,4,5,11
"2011","Camden 019A","E01000856","Total",50,14,7,29,3,2,1,0,47,12,6,29
"2011","Camden 019B","E01000861","Total",51,17,16,18,4,1,2,1,47,16,14,17
"2011","Camden 019C","E01000957","Total",70,16,11,43,12,1,3,8,58,15,8,35
"2011","Camden 019D","E01000958","Total",95,24,20,51,4,0,2,2,91,24,18,49
"2011","Camden 019E","E01000959","Total",63,16,9,38,3,1,0,2,60,15,9,36
"2011","Camden 020A","E01000929","Total",81,19,16,46,1,1,0,0,80,18,16,46
"2011","Camden 020B","E01000930","Total",80,23,12,45,1,0,0,1,79,23,12,44
"2011","Camden 020C","E01000933","Total",28,4,7,17,3,1,1,1,25,3,6,16
"2011","Camden 020D","E01000934","Total",65,14,10,41,1,1,0,0,64,13,10,41
"2011","Camden 020E","E01000935","Total",86,22,17,47,5,2,1,2,81,20,16,45
"2011","Camden 021A","E01000863","Total",31,5,11,15,2,2,0,0,29,3,11,15
"2011","Camden 021B","E01000946","Total",46,11,10,25,1,0,0,1,45,11,10,24
"2011","Camden 021C","E01000947","Total",31,5,8,18,1,0,1,0,30,5,7,18
"2011","Camden 021D","E01000948","Total",47,14,11,22,4,1,1,2,43,13,10,20
"2011","Camden 022A","E01000952","Total",73,28,12,33,2,0,0,2,71,28,12,31
"2011","Camden 022B","E01000953","Total",50,12,11,27,4,1,1,2,46,11,10,25
"2011","Camden 022C","E01000954","Total",110,19,16,75,7,1,2,4,103,18,14,71
"2011","Camden 022D","E01000955","Total",72,16,15,41,6,1,1,4,66,15,14,37
"2011","Camden 022E","E01000956","Total",57,10,12,35,3,1,1,1,54,9,11,34
"2011","Camden 023A","E01000944","Total",55,15,14,26,4,0,3,1,51,15,11,25
"2011","Camden 023B","E01000945","Total",48,29,9,10,2,0,0,2,46,29,9,8
"2011","Camden 023C","E01000949","Total",75,18,22,35,7,0,4,3,68,18,18,32
"2011","Camden 023D","E01000950","Total",59,12,9,38,2,0,0,2,57,12,9,36
"2011","Camden 023E","E01000951","Total",59,20,11,28,5,0,2,3,54,20,9,25
"2011","Camden 024A","E01000936","Total",78,31,8,39,4,1,2,1,74,30,6,38
"2011","Camden 024B","E01000938","Total",101,70,4,27,0,0,0,0,101,70,4,27
"2011","Camden 024C","E01000939","Total",42,18,2,22,3,1,0,2,39,17,2,20
"2011","Camden 024D","E01000940","Total",37,7,9,21,4,0,2,2,33,7,7,19
"2011","Camden 025A","E01000853","Total",69,28,24,17,1,0,0,1,68,28,24,16
"2011","Camden 025B","E01000937","Total",28,17,6,5,0,0,0,0,28,17,6,5
"2011","Camden 025C","E01000941","Total",61,16,15,30,8,2,0,6,53,14,15,24
"2011","Camden 025D","E01000942","Total",22,4,4,14,4,0,2,2,18,4,2,12
"2011","Camden 025E","E01000943","Total",23,7,7,9,1,0,1,0,22,7,6,9
"2011","Camden 026A","E01000850","Total",14,3,4,7,1,0,0,1,13,3,4,6
"2011","Camden 026B","E01000851","Total",19,10,6,3,0,0,0,0,19,10,6,3
"2011","Camden 026C","E01000852","Total",10,3,1,6,1,0,1,0,9,3,0,6
"2011","Camden 026D","E01000854","Total",44,25,10,9,3,1,0,2,41,24,10,7
"2011","Camden 027A","E01000915","Total",50,6,9,35,2,0,1,1,48,6,8,34
"2011","Camden 027B","E01000916","Total",57,19,16,22,10,1,4,5,47,18,12,17
"2011","Camden 027C","E01000917","Total",88,11,15,62,4,0,1,3,84,11,14,59
"2011","Camden 027D","E01000920","Total",47,8,17,22,7,0,4,3,40,8,13,19
"2011","Camden 028A","E01000855","Total",7,1,2,4,0,0,0,0,7,1,2,4
"2011","Camden 028B","E01000914","Total",22,7,7,8,1,0,1,0,21,7,6,8
"2011","Camden 028C","E01000918","Total",39,5,14,20,3,0,2,1,36,5,12,19
"2011","Camden 028D","E01000919","Total",31,7,11,13,4,0,3,1,27,7,8,12
"2011","City of London 001A","E01000001","Total",9,1,7,1,2,0,2,0,7,1,5,1
"2011","City of London 001B","E01000002","Total",13,3,8,2,5,3,1,1,8,0,7,1
"2011","City of London 001C","E01000003","Total",33,9,14,10,6,1,4,1,27,8,10,9
"2011","City of London 001E","E01000005","Total",28,8,14,6,3,3,0,0,25,5,14,6
"2011","City of London 001F","E01032739","Total",8,1,4,3,4,0,3,1,4,1,1,2
"2011","City of London 001G","E01032740","Total",0,0,0,0,0,0,0,0,0,0,0,0
"2011","Hackney 001A","E01001808","Total",16,2,2,12,0,0,0,0,16,2,2,12
"2011","Hackney 001B","E01001809","Total",36,11,10,15,7,2,3,2,29,9,7,13
"2011","Hackney 001C","E01001814","Total",33,11,9,13,3,1,2,0,30,10,7,13
"2011","Hackney 001D","E01001823","Total",55,17,10,28,3,0,0,3,52,17,10,25
"2011","Hackney 001E","E01001825","Total",15,11,1,3,2,1,1,0,13,10,0,3
"2011","Hackney 002A","E01001714","Total",90,25,18,47,10,1,2,7,80,24,16,40
"2011","Hackney 002D","E01001811","Total",88,35,17,36,4,3,0,1,84,32,17,35
"2011","Hackney 002E","E01001813","Total",87,19,13,55,11,2,0,9,76,17,13,46
"2011","Hackney 002F","E01033701","Total",115,27,16,72,10,5,2,3,105,22,14,69
"2011","Hackney 003A","E01001799","Total",18,11,4,3,2,1,0,1,16,10,4,2
"2011","Hackney 003B","E01001802","Total",47,13,9,25,8,4,3,1,39,9,6,24
"2011","Hackney 003C","E01001804","Total",23,4,6,13,4,0,1,3,19,4,5,10
"2011","Hackney 003D","E01001807","Total",54,14,13,27,4,1,0,3,50,13,13,24
"2011","Hackney 003E","E01001812","Total",52,12,8,32,6,4,2,0,46,8,6,32
"2011","Hackney 004A","E01001725","Total",41,16,5,20,6,1,1,4,35,15,4,16
"2011","Hackney 004B","E01001726","Total",81,17,20,44,12,2,5,5,69,15,15,39
"2011","Hackney 004C","E01001800","Total",77,21,20,36,4,0,1,3,73,21,19,33
"2011","Hackney 004D","E01001824","Total",73,17,21,35,6,3,0,3,67,14,21,32
"2011","Hackney 004E","E01001826","Total",67,19,9,39,7,2,1,4,60,17,8,35
"2011","Hackney 006A","E01001723","Total",36,10,12,14,0,0,0,0,36,10,12,14
"2011","Hackney 006B","E01001724","Total",61,20,17,24,7,2,4,1,54,18,13,23
"2011","Hackney 006C","E01001727","Total",26,6,8,12,6,2,3,1,20,4,5,11
"2011","Hackney 006D","E01001768","Total",62,21,14,27,1,0,0,1,61,21,14,26
"2011","Hackney 006E","E01001769","Total",44,13,15,16,2,0,2,0,42,13,13,16
"2011","Hackney 007A","E01001715","Total",31,6,5,20,3,0,0,3,28,6,5,17
"2011","Hackney 007B","E01001716","Total",48,9,11,28,2,0,0,2,46,9,11,26
"2011","Hackney 007C","E01001717","Total",49,11,13,25,4,0,1,3,45,11,12,22
"2011","Hackney 007D","E01001718","Total",16,4,6,6,2,1,0,1,14,3,6,5
"2011","Hackney 007E","E01001719","Total",37,6,14,17,1,0,1,0,36,6,13,17
"2011","Hackney 007F","E01001720","Total",29,5,8,16,2,0,0,2,27,5,8,14
"2011","Hackney 008A","E01001742","Total",98,29,24,45,10,3,0,7,88,26,24,38
"2011","Hackney 008B","E01001801","Total",46,16,13,17,6,3,0,3,40,13,13,14
"2011","Hackney 008C","E01001803","Total",57,17,15,25,9,1,6,2,48,16,9,23
"2011","Hackney 008D","E01001806","Total",80,23,19,38,10,4,3,3,70,19,16,35
"2011","Hackney 009A","E01001741","Total",34,7,14,13,1,0,1,0,33,7,13,13
"2011","Hackney 009B","E01001805","Total",31,10,11,10,2,0,1,1,29,10,10,9
"2011","Hackney 009C","E01001829","Total",34,3,15,16,4,0,2,2,30,3,13,14
"2011","Hackney 009D","E01001831","Total",36,9,11,16,4,0,0,4,32,9,11,12
"2011","Hackney 009E","E01001832","Total",38,11,9,18,2,0,1,1,36,11,8,17
"2011","Hackney 010A","E01001764","Total",55,10,11,34,2,0,0,2,53,10,11,32
"2011","Hackney 010B","E01001765","Total",108,27,19,62,11,2,4,5,97,25,15,57
"2011","Hackney 010D","E01001767","Total",77,29,8,40,5,1,0,4,72,28,8,36
"2011","Hackney 010E","E01001770","Total",98,29,15,54,4,2,1,1,94,27,14,53
"2011","Hackney 010F","E01033703","Total",62,19,9,34,2,1,0,1,60,18,9,33
"2011","Hackney 010G","E01033713","Total",72,14,20,38,3,1,0,2,69,13,20,36
"2011","Hackney 011A","E01001792","Total",57,15,15,27,5,1,3,1,52,14,12,26
"2011","Hackney 011B","E01001793","Total",56,10,19,27,2,0,2,0,54,10,17,27
"2011","Hackney 011C","E01001794","Total",38,11,14,13,4,1,3,0,34,10,11,13
"2011","Hackney 011D","E01001795","Total",43,15,9,19,1,0,0,1,42,15,9,18
"2011","Hackney 011E","E01001796","Total",64,19,9,36,10,2,2,6,54,17,7,30
"2011","Hackney 012A","E01001736","Total",51,13,12,26,3,0,2,1,48,13,10,25
"2011","Hackney 012B","E01001737","Total",53,19,16,18,8,2,3,3,45,17,13,15
"2011","Hackney 012C","E01001738","Total",51,20,13,18,4,2,1,1,47,18,12,17
"2011","Hackney 012D","E01001739","Total",66,15,27,24,2,0,0,2,64,15,27,22
"2011","Hackney 013A","E01001786","Total",141,33,29,79,10,2,5,3,131,31,24,76
"2011","Hackney 013B","E01001787","Total",106,29,18,59,6,1,3,2,100,28,15,57
"2011","Hackney 013C","E01001788","Total",112,22,32,58,2,0,1,1,110,22,31,57
"2011","Hackney 013D","E01001790","Total",95,24,24,47,6,1,2,3,89,23,22,44
"2011","Hackney 014A","E01001740","Total",108,21,20,67,9,4,3,2,99,17,17,65
"2011","Hackney 014B","E01001747","Total",69,17,13,39,4,1,2,1,65,16,11,38
"2011","Hackney 014C","E01001830","Total",76,9,20,47,4,0,0,4,72,9,20,43
"2011","Hackney 014D","E01001833","Total",115,25,33,57,8,0,2,6,107,25,31,51
"2011","Hackney 014E","E01001834","Total",70,17,20,33,5,0,3,2,65,17,17,31
"2011","Hackney 014F","E01001835","Total",24,7,8,9,2,0,1,1,22,7,7,8
"2011","Hackney 015A","E01001733","Total",56,15,9,32,6,0,1,5,50,15,8,27
"2011","Hackney 015B","E01001785","Total",66,14,16,36,9,0,3,6,57,14,13,30
"2011","Hackney 015C","E01001789","Total",66,18,12,36,4,0,1,3,62,18,11,33
"2011","Hackney 015D","E01001791","Total",76,19,17,40,5,1,2,2,71,18,15,38
"2011","Hackney 016A","E01001745","Total",129,35,27,67,9,4,2,3,120,31,25,64
"2011","Hackney 016B","E01001746","Total",146,47,30,69,9,2,2,5,137,45,28,64
"2011","Hackney 016C","E01001757","Total",117,27,33,57,6,0,3,3,111,27,30,54
"2011","Hackney 016D","E01001758","Total",122,27,33,62,16,4,4,8,106,23,29,54
"2011","Hackney 016E","E01001759","Total",65,14,12,39,5,0,1,4,60,14,11,35
"2011","Hackney 016F","E01001761","Total",86,21,20,45,12,2,4,6,74,19,16,39
"2011","Hackney 017A","E01001731","Total",122,32,29,61,6,1,1,4,116,31,28,57
"2011","Hackney 017B","E01001734","Total",88,24,19,45,7,3,1,3,81,21,18,42
"2011","Hackney 017C","E01001760","Total",79,18,20,41,6,0,2,4,73,18,18,37
"2011","Hackney 017D","E01001762","Total",63,14,16,33,6,1,3,2,57,13,13,31
"2011","Hackney 018A","E01001846","Total",73,17,23,33,9,1,6,2,64,16,17,31
"2011","Hackney 018B","E01001847","Total",65,20,11,34,5,2,3,0,60,18,8,34
"2011","Hackney 018C","E01001848","Total",74,15,13,46,4,0,3,1,70,15,10,45
"2011","Hackney 018D","E01001849","Total",146,26,29,91,9,2,2,5,137,24,27,86
"2011","Hackney 019A","E01001729","Total",141,30,34,77,9,3,4,2,132,27,30,75
"2011","Hackney 019B","E01001730","Total",129,21,28,80,8,1,3,4,121,20,25,76
"2011","Hackney 019C","E01001732","Total",139,20,39,80,14,2,6,6,125,18,33,74
"2011","Hackney 019D","E01001735","Total",69,22,12,35,2,0,1,1,67,22,11,34
"2011","Hackney 019E","E01001838","Total",132,31,23,78,3,0,2,1,129,31,21,77
"2011","Hackney 019F","E01001850","Total",151,41,25,85,4,2,2,0,147,39,23,85
"2011","Hackney 020A","E01001748","Total",88,20,30,38,5,1,3,1,83,19,27,37
"2011","Hackney 020B","E01001749","Total",55,19,13,23,1,0,0,1,54,19,13,22
"2011","Hackney 020C","E01001763","Total",78,12,25,41,3,0,2,1,75,12,23,40
"2011","Hackney 020D","E01001816","Total",73,22,16,35,1,0,0,1,72,22,16,34
"2011","Hackney 020E","E01001819","Total",54,13,14,27,5,0,1,4,49,13,13,23
"2011","Hackney 021B","E01001744","Total",67,18,11,38,2,0,1,1,65,18,10,37
"2011","Hackney 021C","E01001750","Total",67,15,18,34,5,1,3,1,62,14,15,33
"2011","Hackney 021D","E01001751","Total",21,3,9,9,3,0,1,2,18,3,8,7
"2011","Hackney 021E","E01001756","Total",43,7,12,24,3,0,1,2,40,7,11,22
"2011","Hackney 021F","E01033698","Total",68,14,13,41,4,1,1,2,64,13,12,39
"2011","Hackney 021G","E01033699","Total",30,7,11,12,7,2,2,3,23,5,9,9
"2011","Hackney 021H","E01033700","Total",32,6,4,22,4,0,2,2,28,6,2,20
"2011","Hackney 021I","E01033707","Total",38,15,9,14,1,1,0,0,37,14,9,14
"2011","Hackney 022A","E01001836","Total",89,22,24,43,9,1,3,5,80,21,21,38
"2011","Hackney 022B","E01001840","Total",100,27,23,50,7,1,3,3,93,26,20,47
"2011","Hackney 022C","E01001841","Total",50,11,14,25,6,2,2,2,44,9,12,23
"2011","Hackney 022D","E01001844","Total",61,7,14,40,4,0,2,2,57,7,12,38
"2011","Hackney 022E","E01001845","Total",109,31,21,57,9,0,5,4,100,31,16,53
"2011","Hackney 023B","E01001837","Total",39,12,10,17,1,0,0,1,38,12,10,16
"2011","Hackney 023C","E01001839","Total",108,32,24,52,10,0,4,6,98,32,20,46
"2011","Hackney 023D","E01001842","Total",114,35,23,56,3,1,1,1,111,34,22,55
"2011","Hackney 023E","E01001843","Total",76,18,23,35,3,0,2,1,73,18,21,34
"2011","Hackney 023F","E01033704","Total",55,18,11,26,5,2,2,1,50,16,9,25
"2011","Hackney 023G","E01033712","Total",82,28,11,43,3,2,0,1,79,26,11,42
"2011","Hackney 024A","E01001772","Total",66,19,11,36,4,3,0,1,62,16,11,35
"2011","Hackney 024B","E01001774","Total",116,29,20,67,6,0,3,3,110,29,17,64
"2011","Hackney 024C","E01001775","Total",102,26,19,57,8,1,1,6,94,25,18,51
"2011","Hackney 024D","E01001815","Total",77,10,17,50,3,0,1,2,74,10,16,48
"2011","Hackney 024E","E01001820","Total",69,18,12,39,7,1,3,3,62,17,9,36
"2011","Hackney 024F","E01001821","Total",73,17,11,45,2,0,1,1,71,17,10,44
"2011","Hackney 025A","E01001752","Total",91,24,25,42,13,2,6,5,78,22,19,37
"2011","Hackney 025B","E01001753","Total",99,20,15,64,10,0,2,8,89,20,13,56
"2011","Hackney 025C","E01001754","Total",117,24,22,71,13,3,2,8,104,21,20,63
"2011","Hackney 025D","E01001755","Total",117,33,23,61,9,1,0,8,108,32,23,53
"2011","Hackney 025E","E01001773","Total",90,18,20,52,6,1,2,3,84,17,18,49
"2011","Hackney 025F","E01001776","Total",52,13,10,29,3,0,2,1,49,13,8,28
"2011","Hackney 026A","E01001779","Total",105,15,29,61,8,0,3,5,97,15,26,56
"2011","Hackney 026B","E01001781","Total",104,26,21,57,13,2,3,8,91,24,18,49
"2011","Hackney 026C","E01001782","Total",93,22,19,52,5,0,1,4,88,22,18,48
"2011","Hackney 026D","E01001783","Total",145,36,41,68,17,3,7,7,128,33,34,61
"2011","Hackney 027B","E01001777","Total",116,26,27,63,18,5,6,7,98,21,21,56
"2011","Hackney 027D","E01001780","Total",92,23,20,49,5,1,0,4,87,22,20,45
"2011","Hackney 027E","E01001784","Total",94,22,24,48,5,0,2,3,89,22,22,45
"2011","Hackney 027F","E01033706","Total",47,12,14,21,5,0,2,3,42,12,12,18
"2011","Hackney 027G","E01033708","Total",7,2,3,2,0,0,0,0,7,2,3,2
"2011","Hackney 027H","E01033709","Total",81,15,33,33,8,1,6,1,73,14,27,32
"2011","Hackney 027I","E01033711","Total",23,3,11,9,2,0,2,0,21,3,9,9
"2011","Hackney 028A","E01001798","Total",104,29,22,53,8,3,2,3,96,26,20,50
"2011","Hackney 028B","E01001828","Total",159,49,38,72,14,7,4,3,145,42,34,69
"2011","Hackney 028C","E01033702","Total",58,13,14,31,3,0,2,1,55,13,12,30
"2011","Hackney 028D","E01033705","Total",100,32,11,57,10,6,0,4,90,26,11,53
"2011","Hackney 028E","E01033710","Total",87,29,11,47,9,6,2,1,78,23,9,46
"2011","Hackney 029A","E01001722","Total",99,27,19,53,8,1,0,7,91,26,19,46
"2011","Hackney 029B","E01001728","Total",79,21,17,41,5,1,2,2,74,20,15,39
"2011","Hackney 029C","E01001822","Total",111,27,28,56,7,1,3,3,104,26,25,53
"2011","Hackney 029D","E01001827","Total",104,27,21,56,11,2,4,5,93,25,17,51
"2011","Hammersmith and Fulham 001A","E01001874","Total",81,19,22,40,2,0,1,1,79,19,21,39
"2011","Hammersmith and Fulham 001B","E01001875","Total",108,27,21,60,4,2,1,1,104,25,20,59
"2011","Hammersmith and Fulham 001C","E01001876","Total",102,18,21,63,8,1,2,5,94,17,19,58
"2011","Hammersmith and Fulham 001D","E01001877","Total",60,16,18,26,3,1,0,2,57,15,18,24
"2011","Hammersmith and Fulham 001E","E01001878","Total",110,33,17,60,3,1,1,1,107,32,16,59
"2011","Hammersmith and Fulham 002A","E01001955","Total",122,23,25,74,1,0,0,1,121,23,25,73
"2011","Hammersmith and Fulham 002B","E01001957","Total",120,26,28,66,8,2,2,4,112,24,26,62
"2011","Hammersmith and Fulham 002C","E01001958","Total",137,32,34,71,5,0,4,1,132,32,30,70
"2011","Hammersmith and Fulham 002D","E01001961","Total",105,30,18,57,4,2,2,0,101,28,16,57
"2011","Hammersmith and Fulham 003A","E01001954","Total",65,21,10,34,3,0,2,1,62,21,8,33
"2011","Hammersmith and Fulham 003B","E01001956","Total",66,16,16,34,3,0,2,1,63,16,14,33
"2011","Hammersmith and Fulham 003C","E01001959","Total",72,16,12,44,6,2,2,2,66,14,10,42
"2011","Hammersmith and Fulham 003D","E01001960","Total",57,11,18,28,4,0,4,0,53,11,14,28
"2011","Hammersmith and Fulham 004A","E01001943","Total",60,9,14,37,4,0,1,3,56,9,13,34
"2011","Hammersmith and Fulham 004B","E01001944","Total",100,23,21,56,5,1,2,2,95,22,19,54
"2011","Hammersmith and Fulham 004C","E01001945","Total",63,19,19,25,8,1,4,3,55,18,15,22
"2011","Hammersmith and Fulham 004D","E01001946","Total",54,9,18,27,2,0,0,2,52,9,18,25
"2011","Hammersmith and Fulham 005A","E01001862","Total",71,14,22,35,3,0,3,0,68,14,19,35
"2011","Hammersmith and Fulham 005B","E01001940","Total",68,18,16,34,5,0,3,2,63,18,13,32
"2011","Hammersmith and Fulham 005C","E01001941","Total",38,5,12,21,2,0,1,1,36,5,11,20
"2011","Hammersmith and Fulham 005D","E01001942","Total",51,16,20,15,6,2,2,2,45,14,18,13
"2011","Hammersmith and Fulham 006A","E01001858","Total",61,13,19,29,5,0,2,3,56,13,17,26
"2011","Hammersmith and Fulham 006B","E01001860","Total",82,24,14,44,1,0,0,1,81,24,14,43
"2011","Hammersmith and Fulham 006C","E01001861","Total",59,14,18,27,3,1,2,0,56,13,16,27
"2011","Hammersmith and Fulham 006D","E01001863","Total",42,12,10,20,1,0,1,0,41,12,9,20
"2011","Hammersmith and Fulham 006E","E01001864","Total",45,12,15,18,5,2,2,1,40,10,13,17
"2011","Hammersmith and Fulham 007A","E01001852","Total",33,9,8,16,0,0,0,0,33,9,8,16
"2011","Hammersmith and Fulham 007B","E01001853","Total",29,10,7,12,1,1,0,0,28,9,7,12
"2011","Hammersmith and Fulham 007C","E01001854","Total",48,11,14,23,1,0,0,1,47,11,14,22
"2011","Hammersmith and Fulham 007D","E01001857","Total",69,25,11,33,2,1,0,1,67,24,11,32
"2011","Hammersmith and Fulham 008A","E01001859","Total",131,31,31,69,3,0,1,2,128,31,30,67
"2011","Hammersmith and Fulham 008B","E01001865","Total",40,4,16,20,4,0,2,2,36,4,14,18
"2011","Hammersmith and Fulham 008C","E01001927","Total",17,2,7,8,2,0,1,1,15,2,6,7
"2011","Hammersmith and Fulham 008D","E01001930","Total",48,14,13,21,0,0,0,0,48,14,13,21
"2011","Hammersmith and Fulham 009A","E01001895","Total",41,9,14,18,2,0,1,1,39,9,13,17
"2011","Hammersmith and Fulham 009B","E01001896","Total",43,4,13,26,1,0,1,0,42,4,12,26
"2011","Hammersmith and Fulham 009C","E01001897","Total",38,6,15,17,4,0,3,1,34,6,12,16
"2011","Hammersmith and Fulham 009D","E01001929","Total",24,7,10,7,4,0,4,0,20,7,6,7
"2011","Hammersmith and Fulham 010A","E01001851","Total",26,7,7,12,3,0,3,0,23,7,4,12
"2011","Hammersmith and Fulham 010B","E01001855","Total",42,15,9,18,0,0,0,0,42,15,9,18
"2011","Hammersmith and Fulham 010C","E01001856","Total",66,19,21,26,12,2,3,7,54,17,18,19
"2011","Hammersmith and Fulham 010D","E01001869","Total",15,5,5,5,0,0,0,0,15,5,5,5
"2011","Hammersmith and Fulham 010E","E01001873","Total",63,21,14,28,3,1,1,1,60,20,13,27
"2011","Hammersmith and Fulham 011A","E01001928","Total",52,17,15,20,3,0,0,3,49,17,15,17
"2011","Hammersmith and Fulham 011B","E01001931","Total",66,20,5,41,6,0,1,5,60,20,4,36
"2011","Hammersmith and Fulham 011C","E01001932","Total",39,8,7,24,3,0,1,2,36,8,6,22
"2011","Hammersmith and Fulham 011D","E01001933","Total",32,8,6,18,3,0,2,1,29,8,4,17
"2011","Hammersmith and Fulham 012A","E01001866","Total",25,3,13,9,3,0,3,0,22,3,10,9
"2011","Hammersmith and Fulham 012B","E01001867","Total",16,6,5,5,1,0,0,1,15,6,5,4
"2011","Hammersmith and Fulham 012C","E01001868","Total",82,30,18,34,5,0,3,2,77,30,15,32
"2011","Hammersmith and Fulham 012D","E01001870","Total",45,10,16,19,5,2,1,2,40,8,15,17
"2011","Hammersmith and Fulham 012E","E01001871","Total",25,3,10,12,4,0,2,2,21,3,8,10
"2011","Hammersmith and Fulham 012F","E01001872","Total",24,5,7,12,1,0,0,1,23,5,7,11
"2011","Hammersmith and Fulham 013A","E01001893","Total",75,22,14,39,1,0,0,1,74,22,14,38
"2011","Hammersmith and Fulham 013B","E01001894","Total",46,13,8,25,3,1,0,2,43,12,8,23
"2011","Hammersmith and Fulham 013C","E01001898","Total",31,12,6,13,1,0,0,1,30,12,6,12
"2011","Hammersmith and Fulham 013D","E01001899","Total",74,18,14,42,4,2,0,2,70,16,14,40
"2011","Hammersmith and Fulham 013E","E01001900","Total",68,19,18,31,12,1,5,6,56,18,13,25
"2011","Hammersmith and Fulham 014A","E01001889","Total",20,4,6,10,0,0,0,0,20,4,6,10
"2011","Hammersmith and Fulham 014B","E01001910","Total",26,12,3,11,6,2,1,3,20,10,2,8
"2011","Hammersmith and Fulham 014C","E01001913","Total",14,4,4,6,3,1,1,1,11,3,3,5
"2011","Hammersmith and Fulham 014D","E01001914","Total",28,8,5,15,0,0,0,0,28,8,5,15
"2011","Hammersmith and Fulham 015A","E01001885","Total",89,23,23,43,4,0,2,2,85,23,21,41
"2011","Hammersmith and Fulham 015B","E01001908","Total",34,5,13,16,2,0,1,1,32,5,12,15
"2011","Hammersmith and Fulham 015C","E01001909","Total",47,7,22,18,2,0,2,0,45,7,20,18
"2011","Hammersmith and Fulham 015D","E01001911","Total",111,31,22,58,6,2,2,2,105,29,20,56
"2011","Hammersmith and Fulham 015E","E01001912","Total",85,23,17,45,3,0,1,2,82,23,16,43
"2011","Hammersmith and Fulham 016A","E01001886","Total",69,18,12,39,2,1,0,1,67,17,12,38
"2011","Hammersmith and Fulham 016B","E01001887","Total",39,12,8,19,2,0,1,1,37,12,7,18
"2011","Hammersmith and Fulham 016C","E01001890","Total",28,7,9,12,6,1,3,2,22,6,6,10
"2011","Hammersmith and Fulham 016D","E01001892","Total",70,19,14,37,3,0,2,1,67,19,12,36
"2011","Hammersmith and Fulham 017A","E01001880","Total",43,12,13,18,2,0,1,1,41,12,12,17
"2011","Hammersmith and Fulham 017B","E01001881","Total",30,7,12,11,0,0,0,0,30,7,12,11
"2011","Hammersmith and Fulham 017C","E01001882","Total",24,6,8,10,0,0,0,0,24,6,8,10
"2011","Hammersmith and Fulham 017D","E01001883","Total",42,8,6,28,1,0,0,1,41,8,6,27
"2011","Hammersmith and Fulham 017E","E01001884","Total",57,5,26,26,8,0,6,2,49,5,20,24
"2011","Hammersmith and Fulham 018A","E01001888","Total",21,5,8,8,4,2,1,1,17,3,7,7
"2011","Hammersmith and Fulham 018B","E01001891","Total",24,6,8,10,0,0,0,0,24,6,8,10
"2011","Hammersmith and Fulham 018C","E01001917","Total",28,11,9,8,4,2,1,1,24,9,8,7
"2011","Hammersmith and Fulham 018D","E01001918","Total",28,6,9,13,0,0,0,0,28,6,9,13
"2011","Hammersmith and Fulham 018E","E01001919","Total",27,13,7,7,0,0,0,0,27,13,7,7
"2011","Hammersmith and Fulham 019A","E01001879","Total",45,17,8,20,2,0,1,1,43,17,7,19
"2011","Hammersmith and Fulham 019B","E01001901","Total",36,9,10,17,2,1,0,1,34,8,10,16
"2011","Hammersmith and Fulham 019C","E01001902","Total",36,10,6,20,5,0,3,2,31,10,3,18
"2011","Hammersmith and Fulham 019D","E01001903","Total",62,17,16,29,8,2,4,2,54,15,12,27
"2011","Hammersmith and Fulham 020A","E01001920","Total",40,9,6,25,2,0,1,1,38,9,5,24
"2011","Hammersmith and Fulham 020B","E01001921","Total",30,4,9,17,5,0,4,1,25,4,5,16
"2011","Hammersmith and Fulham 020C","E01001922","Total",25,8,4,13,0,0,0,0,25,8,4,13
"2011","Hammersmith and Fulham 020D","E01001923","Total",37,6,9,22,0,0,0,0,37,6,9,22
"2011","Hammersmith and Fulham 020E","E01001924","Total",15,4,6,5,1,0,1,0,14,4,5,5
"2011","Hammersmith and Fulham 021A","E01001947","Total",115,26,28,61,3,0,3,0,112,26,25,61
"2011","Hammersmith and Fulham 021B","E01001948","Total",52,10,12,30,4,0,1,3,48,10,11,27
"2011","Hammersmith and Fulham 021C","E01001949","Total",24,3,6,15,2,0,1,1,22,3,5,14
"2011","Hammersmith and Fulham 021D","E01001950","Total",14,2,6,6,1,0,1,0,13,2,5,6
"2011","Hammersmith and Fulham 021E","E01001951","Total",31,7,6,18,3,0,1,2,28,7,5,16
"2011","Hammersmith and Fulham 021F","E01001953","Total",43,6,16,21,1,0,0,1,42,6,16,20
"2011","Hammersmith and Fulham 022A","E01001904","Total",16,3,5,8,2,0,1,1,14,3,4,7
"2011","Hammersmith and Fulham 022B","E01001905","Total",22,8,7,7,1,0,1,0,21,8,6,7
"2011","Hammersmith and Fulham 022C","E01001906","Total",17,1,4,12,2,0,2,0,15,1,2,12
"2011","Hammersmith and Fulham 022D","E01001907","Total",21,4,7,10,1,0,0,1,20,4,7,9
"2011","Hammersmith and Fulham 023A","E01001935","Total",59,17,18,24,4,0,3,1,55,17,15,23
"2011","Hammersmith and Fulham 023C","E01001939","Total",101,28,26,47,6,2,4,0,95,26,22,47
"2011","Hammersmith and Fulham 023D","E01032788","Total",67,22,22,23,2,0,2,0,65,22,20,23
"2011","Hammersmith and Fulham 023E","E01032789","Total",59,18,16,25,3,0,2,1,56,18,14,24
"2011","Hammersmith and Fulham 023F","E01032790","Total",64,21,7,36,3,0,2,1,61,21,5,35
"2011","Hammersmith and Fulham 024A","E01001915","Total",23,7,7,9,5,1,3,1,18,6,4,8
"2011","Hammersmith and Fulham 024B","E01001916","Total",11,0,5,6,2,0,2,0,9,0,3,6
"2011","Hammersmith and Fulham 024C","E01001926","Total",12,3,2,7,1,0,0,1,11,3,2,6
"2011","Hammersmith and Fulham 024D","E01001952","Total",26,4,9,13,1,0,1,0,25,4,8,13
"2011","Hammersmith and Fulham 025A","E01001925","Total",13,2,3,8,0,0,0,0,13,2,3,8
"2011","Hammersmith and Fulham 025B","E01001934","Total",88,32,17,39,5,1,3,1,83,31,14,38
"2011","Hammersmith and Fulham 025C","E01001937","Total",27,4,7,16,0,0,0,0,27,4,7,16
"2011","Hammersmith and Fulham 025D","E01001938","Total",78,19,13,46,3,0,0,3,75,19,13,43
"2011","Haringey 001A","E01001969","Total",84,13,27,44,5,0,2,3,79,13,25,41
"2011","Haringey 001B","E01001971","Total",131,38,29,64,9,0,4,5,122,38,25,59
"2011","Haringey 001C","E01001974","Total",56,17,16,23,7,0,3,4,49,17,13,19
"2011","Haringey 001D","E01001975","Total",53,21,14,18,2,0,2,0,51,21,12,18
"2011","Haringey 002A","E01002036","Total",113,28,24,61,10,3,4,3,103,25,20,58
"2011","Haringey 002B","E01002037","Total",107,31,18,58,14,1,4,9,93,30,14,49
"2011","Haringey 002C","E01002039","Total",170,35,24,111,10,1,2,7,160,34,22,104
"2011","Haringey 002D","E01002040","Total",117,29,27,61,7,1,2,4,110,28,25,57
"2011","Haringey 004A","E01001962","Total",54,17,20,17,5,0,5,0,49,17,15,17
"2011","Haringey 004B","E01001970","Total",128,35,30,63,7,2,3,2,121,33,27,61
"2011","Haringey 004C","E01001972","Total",75,22,15,38,7,1,0,6,68,21,15,32
"2011","Haringey 004D","E01001973","Total",89,22,24,43,9,5,1,3,80,17,23,40
"2011","Haringey 005A","E01002090","Total",69,20,21,28,1,0,0,1,68,20,21,27
"2011","Haringey 005B","E01002093","Total",110,36,17,57,2,1,0,1,108,35,17,56
"2011","Haringey 005C","E01002096","Total",104,27,19,58,8,1,1,6,96,26,18,52
"2011","Haringey 005D","E01002097","Total",148,40,29,79,9,2,3,4,139,38,26,75
"2011","Haringey 006A","E01002091","Total",107,21,22,64,7,0,2,5,100,21,20,59
"2011","Haringey 006B","E01002092","Total",135,40,22,73,6,1,1,4,129,39,21,69
"2011","Haringey 006C","E01002094","Total",137,42,27,68,9,3,2,4,128,39,25,64
"2011","Haringey 006D","E01002095","Total",138,29,35,74,8,1,2,5,130,28,33,69
"2011","Haringey 007A","E01002098","Total",42,13,8,21,4,0,3,1,38,13,5,20
"2011","Haringey 007B","E01002101","Total",57,19,8,30,2,0,0,2,55,19,8,28
"2011","Haringey 007C","E01002102","Total",78,22,18,38,1,0,1,0,77,22,17,38
"2011","Haringey 007D","E01002105","Total",78,21,18,39,5,0,3,2,73,21,15,37
"2011","Haringey 008A","E01002099","Total",132,34,19,79,11,3,1,7,121,31,18,72
"2011","Haringey 008B","E01002100","Total",94,21,20,53,5,1,1,3,89,20,19,50
"2011","Haringey 008C","E01002103","Total",64,15,11,38,5,1,1,3,59,14,10,35
"2011","Haringey 008D","E01002104","Total",52,10,10,32,1,1,0,0,51,9,10,32
"2011","Haringey 009A","E01001963","Total",32,6,6,20,15,4,1,10,17,2,5,10
"2011","Haringey 009B","E01001964","Total",46,16,17,13,4,1,1,2,42,15,16,11
"2011","Haringey 009C","E01001965","Total",33,10,10,13,1,0,0,1,32,10,10,12
"2011","Haringey 009D","E01001966","Total",23,6,10,7,3,1,2,0,20,5,8,7
"2011","Haringey 010A","E01002027","Total",64,16,12,36,1,0,0,1,63,16,12,35
"2011","Haringey 010B","E01002028","Total",79,16,14,49,3,1,0,2,76,15,14,47
"2011","Haringey 010C","E01002032","Total",136,32,33,71,5,1,2,2,131,31,31,69
"2011","Haringey 010D","E01002033","Total",125,27,19,79,7,0,2,5,118,27,17,74
"2011","Haringey 011A","E01001976","Total",105,36,27,42,8,2,3,3,97,34,24,39
"2011","Haringey 011B","E01001977","Total",85,23,19,43,5,2,2,1,80,21,17,42
"2011","Haringey 011C","E01001978","Total",135,37,43,55,11,1,5,5,124,36,38,50
"2011","Haringey 011D","E01001979","Total",124,33,20,71,9,2,1,6,115,31,19,65
"2011","Haringey 012A","E01002074","Total",172,53,48,71,26,7,14,5,146,46,34,66
"2011","Haringey 012B","E01002077","Total",173,52,32,89,22,6,5,11,151,46,27,78
"2011","Haringey 012C","E01002079","Total",83,21,17,45,3,0,1,2,80,21,16,43
"2011","Haringey 012D","E01002081","Total",91,24,12,55,5,2,0,3,86,22,12,52
"2011","Haringey 013A","E01002082","Total",134,40,33,61,7,0,4,3,127,40,29,58
"2011","Haringey 013B","E01002086","Total",67,17,14,36,6,1,3,2,61,16,11,34
"2011","Haringey 013C","E01002088","Total",62,18,8,36,7,0,2,5,55,18,6,31
"2011","Haringey 013D","E01002089","Total",133,41,30,62,10,1,5,4,123,40,25,58
"2011","Haringey 014A","E01001967","Total",29,8,13,8,1,0,1,0,28,8,12,8
"2011","Haringey 014B","E01001968","Total",43,9,25,9,3,0,1,2,40,9,24,7
"2011","Haringey 014C","E01001996","Total",30,12,10,8,3,0,3,0,27,12,7,8
"2011","Haringey 014D","E01001997","Total",29,9,11,9,5,1,4,0,24,8,7,9
"2011","Haringey 015A","E01002075","Total",137,37,33,67,8,3,4,1,129,34,29,66
"2011","Haringey 015B","E01002076","Total",118,27,31,60,1,0,0,1,117,27,31,59
"2011","Haringey 015C","E01002078","Total",129,36,28,65,16,2,4,10,113,34,24,55
"2011","Haringey 015D","E01002080","Total",54,14,15,25,5,3,2,0,49,11,13,25
"2011","Haringey 016A","E01002026","Total",110,27,28,55,12,2,5,5,98,25,23,50
"2011","Haringey 016B","E01002029","Total",99,34,13,52,3,1,1,1,96,33,12,51
"2011","Haringey 016C","E01002030","Total",58,16,13,29,4,0,0,4,54,16,13,25
"2011","Haringey 016D","E01002031","Total",68,28,9,31,5,1,0,4,63,27,9,27
"2011","Haringey 017A","E01001991","Total",60,17,24,19,7,0,6,1,53,17,18,18
"2011","Haringey 017B","E01001992","Total",15,6,7,2,2,0,2,0,13,6,5,2
"2011","Haringey 017C","E01001993","Total",17,4,9,4,4,1,3,0,13,3,6,4
"2011","Haringey 017D","E01001995","Total",119,37,30,52,4,1,2,1,115,36,28,51
"2011","Haringey 018A","E01001980","Total",94,30,19,45,11,3,5,3,83,27,14,42
"2011","Haringey 018B","E01001981","Total",73,23,13,37,3,0,1,2,70,23,12,35
"2011","Haringey 018C","E01001982","Total",76,19,19,38,2,0,2,0,74,19,17,38
"2011","Haringey 018D","E01001983","Total",84,36,21,27,5,2,2,1,79,34,19,26
"2011","Haringey 019A","E01002083","Total",20,5,5,10,2,1,1,0,18,4,4,10
"2011","Haringey 019B","E01002084","Total",40,13,9,18,9,1,4,4,31,12,5,14
"2011","Haringey 019C","E01002085","Total",83,15,18,50,2,0,0,2,81,15,18,48
"2011","Haringey 019D","E01002087","Total",67,19,17,31,5,1,1,3,62,18,16,28
"2011","Haringey 020B","E01002014","Total",53,10,18,25,5,1,3,1,48,9,15,24
"2011","Haringey 020C","E01002015","Total",56,11,15,30,2,0,2,0,54,11,13,30
"2011","Haringey 020D","E01002018","Total",75,16,23,36,6,0,3,3,69,16,20,33
"2011","Haringey 020E","E01033085","Total",89,28,16,45,9,4,1,4,80,24,15,41
"2011","Haringey 020F","E01033086","Total",85,19,15,51,11,6,4,1,74,13,11,50
"2011","Haringey 021A","E01002020","Total",54,17,16,21,2,0,2,0,52,17,14,21
"2011","Haringey 021B","E01002022","Total",33,10,15,8,3,0,3,0,30,10,12,8
"2011","Haringey 021C","E01002023","Total",30,6,15,9,1,0,0,1,29,6,15,8
"2011","Haringey 021D","E01002025","Total",30,6,16,8,4,1,1,2,26,5,15,6
"2011","Haringey 022A","E01002013","Total",38,7,13,18,2,0,1,1,36,7,12,17
"2011","Haringey 022B","E01002019","Total",18,6,7,5,3,1,1,1,15,5,6,4
"2011","Haringey 022C","E01002021","Total",28,7,11,10,1,0,1,0,27,7,10,10
"2011","Haringey 022D","E01002024","Total",26,7,11,8,2,1,0,1,24,6,11,7
"2011","Haringey 023A","E01001998","Total",39,6,14,19,4,1,2,1,35,5,12,18
"2011","Haringey 023B","E01001999","Total",48,16,5,27,6,1,2,3,42,15,3,24
"2011","Haringey 023C","E01002003","Total",114,37,19,58,10,1,3,6,104,36,16,52
"2011","Haringey 023D","E01002004","Total",48,23,8,17,2,1,0,1,46,22,8,16
"2011","Haringey 024A","E01002067","Total",85,24,15,46,6,1,2,3,79,23,13,43
"2011","Haringey 024B","E01002069","Total",75,28,23,24,5,1,4,0,70,27,19,24
"2011","Haringey 024C","E01002070","Total",92,20,24,48,8,2,2,4,84,18,22,44
"2011","Haringey 024D","E01002073","Total",89,28,18,43,1,0,1,0,88,28,17,43
"2011","Haringey 025A","E01002066","Total",153,42,43,68,9,2,4,3,144,40,39,65
"2011","Haringey 025B","E01002068","Total",69,22,16,31,2,0,0,2,67,22,16,29
"2011","Haringey 025C","E01002071","Total",123,30,17,76,6,1,1,4,117,29,16,72
"2011","Haringey 025D","E01002072","Total",83,26,11,46,5,3,1,1,78,23,10,45
"2011","Haringey 026A","E01002043","Total",68,25,16,27,9,1,1,7,59,24,15,20
"2011","Haringey 026B","E01002045","Total",107,28,31,48,5,1,1,3,102,27,30,45
"2011","Haringey 026C","E01002046","Total",85,30,18,37,7,3,1,3,78,27,17,34
"2011","Haringey 026D","E01002049","Total",91,25,21,45,9,2,4,3,82,23,17,42
"2011","Haringey 027A","E01002042","Total",25,8,8,9,5,0,3,2,20,8,5,7
"2011","Haringey 027B","E01002044","Total",39,14,11,14,5,0,3,2,34,14,8,12
"2011","Haringey 027C","E01002047","Total",35,9,12,14,2,1,1,0,33,8,11,14
"2011","Haringey 027D","E01002048","Total",68,15,15,38,4,1,2,1,64,14,13,37
"2011","Haringey 028A","E01002016","Total",91,19,33,39,2,0,1,1,89,19,32,38
"2011","Haringey 028B","E01002017","Total",51,21,18,12,5,2,2,1,46,19,16,11
"2011","Haringey 028C","E01002059","Total",71,13,21,37,5,2,3,0,66,11,18,37
"2011","Haringey 028D","E01002060","Total",39,10,16,13,2,1,1,0,37,9,15,13
"2011","Haringey 029A","E01002050","Total",31,9,7,15,4,0,1,3,27,9,6,12
"2011","Haringey 029B","E01002051","Total",77,30,15,32,4,3,1,0,73,27,14,32
"2011","Haringey 029C","E01002052","Total",34,3,8,23,6,0,3,3,28,3,5,20
"2011","Haringey 029D","E01002055","Total",25,6,7,12,2,0,1,1,23,6,6,11
"2011","Haringey 030A","E01001994","Total",36,15,10,11,2,0,1,1,34,15,9,10
"2011","Haringey 030B","E01002008","Total",23,4,7,12,0,0,0,0,23,4,7,12
"2011","Haringey 030C","E01002010","Total",59,17,18,24,9,2,5,2,50,15,13,22
"2011","Haringey 030D","E01002011","Total",32,6,9,17,2,0,2,0,30,6,7,17
"2011","Haringey 031A","E01002000","Total",53,14,22,17,6,0,6,0,47,14,16,17
"2011","Haringey 031B","E01002001","Total",26,10,5,11,1,0,1,0,25,10,4,11
"2011","Haringey 031C","E01002002","Total",62,16,14,32,5,1,0,4,57,15,14,28
"2011","Haringey 031D","E01002058","Total",49,7,13,29,1,0,1,0,48,7,12,29
"2011","Haringey 032A","E01002053","Total",85,27,10,48,8,2,3,3,77,25,7,45
"2011","Haringey 032B","E01002054","Total",125,30,25,70,8,2,4,2,117,28,21,68
"2011","Haringey 032C","E01002056","Total",88,27,16,45,7,1,3,3,81,26,13,42
"2011","Haringey 032D","E01002057","Total",60,9,17,34,4,0,1,3,56,9,16,31
"2011","Haringey 033A","E01001984","Total",30,5,18,7,3,0,2,1,27,5,16,6
"2011","Haringey 033B","E01001985","Total",19,3,9,7,0,0,0,0,19,3,9,7
"2011","Haringey 033C","E01001987","Total",23,8,10,5,2,0,1,1,21,8,9,4
"2011","Haringey 033D","E01001989","Total",34,16,12,6,0,0,0,0,34,16,12,6
"2011","Haringey 034A","E01001986","Total",32,7,16,9,2,0,2,0,30,7,14,9
"2011","Haringey 034B","E01001988","Total",38,7,18,13,4,1,2,1,34,6,16,12
"2011","Haringey 034C","E01001990","Total",43,16,15,12,5,1,2,2,38,15,13,10
"2011","Haringey 034D","E01002062","Total",33,13,10,10,3,0,1,2,30,13,9,8
"2011","Haringey 035A","E01002005","Total",33,11,9,13,3,0,1,2,30,11,8,11
"2011","Haringey 035B","E01002006","Total",38,11,12,15,5,1,1,3,33,10,11,12
"2011","Haringey 035C","E01002007","Total",22,4,9,9,0,0,0,0,22,4,9,9
"2011","Haringey 035D","E01002009","Total",27,4,17,6,8,0,6,2,19,4,11,4
"2011","Haringey 036A","E01002061","Total",31,4,15,12,0,0,0,0,31,4,15,12
"2011","Haringey 036B","E01002063","Total",57,11,21,25,6,0,1,5,51,11,20,20
"2011","Haringey 036C","E01002064","Total",71,15,17,39,3,0,1,2,68,15,16,37
"2011","Haringey 036D","E01002065","Total",34,11,9,14,1,1,0,0,33,10,9,14
"2011","Haringey 037A","E01002034","Total",150,39,23,88,5,0,2,3,145,39,21,85
"2011","Haringey 037B","E01002038","Total",140,38,12,90,9,3,1,5,131,35,11,85
"2011","Haringey 037C","E01002041","Total",113,24,23,66,9,1,0,8,104,23,23,58
"2011","Haringey 037D","E01032575","Total",135,40,23,72,9,0,1,8,126,40,22,64
"2011","Islington 001A","E01002755","Total",81,15,15,51,6,0,0,6,75,15,15,45
"2011","Islington 001B","E01002756","Total",45,13,13,19,6,1,4,1,39,12,9,18
"2011","Islington 001C","E01002758","Total",111,17,15,79,6,2,0,4,105,15,15,75
"2011","Islington 001D","E01002804","Total",117,35,22,60,24,17,3,4,93,18,19,56
"2011","Islington 001E","E01002807","Total",106,30,25,51,6,1,3,2,100,29,22,49
"2011","Islington 001F","E01002811","Total",99,24,17,58,4,1,1,2,95,23,16,56
"2011","Islington 002A","E01002753","Total",56,16,11,29,3,1,1,1,53,15,10,28
"2011","Islington 002B","E01002754","Total",36,2,12,22,4,0,3,1,32,2,9,21
"2011","Islington 002C","E01002757","Total",96,23,18,55,0,0,0,0,96,23,18,55
"2011","Islington 002D","E01002759","Total",39,12,7,20,4,0,1,3,35,12,6,17
"2011","Islington 002E","E01002760","Total",99,16,19,64,1,0,0,1,98,16,19,63
"2011","Islington 002F","E01002772","Total",80,18,18,44,5,0,2,3,75,18,16,41
"2011","Islington 003A","E01002735","Total",75,12,29,34,2,0,2,0,73,12,27,34
"2011","Islington 003B","E01002805","Total",64,24,13,27,2,1,1,0,62,23,12,27
"2011","Islington 003C","E01002806","Total",55,13,15,27,2,0,1,1,53,13,14,26
"2011","Islington 003D","E01002808","Total",89,10,34,45,6,1,4,1,83,9,30,44
"2011","Islington 003E","E01002809","Total",69,18,13,38,8,0,5,3,61,18,8,35
"2011","Islington 003F","E01002810","Total",77,18,18,41,6,1,1,4,71,17,17,37
"2011","Islington 004A","E01002768","Total",72,19,15,38,8,1,4,3,64,18,11,35
"2011","Islington 004B","E01002770","Total",53,6,9,38,2,0,0,2,51,6,9,36
"2011","Islington 004C","E01002771","Total",78,17,20,41,4,1,1,2,74,16,19,39
"2011","Islington 004D","E01002773","Total",67,23,5,39,2,0,0,2,65,23,5,37
"2011","Islington 004E","E01002774","Total",93,28,23,42,7,1,2,4,86,27,21,38
"2011","Islington 005A","E01002732","Total",105,31,22,52,16,3,7,6,89,28,15,46
"2011","Islington 005B","E01002734","Total",139,34,32,73,8,2,1,5,131,32,31,68
"2011","Islington 005C","E01002736","Total",81,10,17,54,6,0,0,6,75,10,17,48
"2011","Islington 005D","E01002737","Total",140,28,17,95,8,1,4,3,132,27,13,92
"2011","Islington 005E","E01002751","Total",103,31,17,55,6,0,3,3,97,31,14,52
"2011","Islington 006A","E01002742","Total",31,7,7,17,1,0,1,0,30,7,6,17
"2011","Islington 006B","E01002747","Total",41,12,13,16,3,1,2,0,38,11,11,16
"2011","Islington 006C","E01002748","Total",71,16,13,42,1,0,0,1,70,16,13,41
"2011","Islington 006D","E01002749","Total",85,15,24,46,2,0,2,0,83,15,22,46
"2011","Islington 006F","E01033493","Total",10,0,7,3,3,0,3,0,7,0,4,3
"2011","Islington 006G","E01033494","Total",21,5,8,8,3,0,1,2,18,5,7,6
"2011","Islington 007A","E01002730","Total",60,13,15,32,7,1,1,5,53,12,14,27
"2011","Islington 007B","E01002731","Total",71,14,16,41,4,0,3,1,67,14,13,40
"2011","Islington 007C","E01002733","Total",39,13,9,17,2,0,1,1,37,13,8,16
"2011","Islington 007D","E01002763","Total",25,12,2,11,2,1,1,0,23,11,1,11
"2011","Islington 008A","E01002769","Total",36,8,7,21,4,1,2,1,32,7,5,20
"2011","Islington 008B","E01002785","Total",66,16,14,36,2,1,1,0,64,15,13,36
"2011","Islington 008C","E01002788","Total",59,12,23,24,4,0,1,3,55,12,22,21
"2011","Islington 008D","E01002789","Total",38,9,15,14,4,0,2,2,34,9,13,12
"2011","Islington 009A","E01002738","Total",56,10,16,30,3,0,3,0,53,10,13,30
"2011","Islington 009B","E01002741","Total",91,26,16,49,3,2,0,1,88,24,16,48
"2011","Islington 009C","E01002743","Total",67,17,15,35,4,0,1,3,63,17,14,32
"2011","Islington 009D","E01002744","Total",26,10,8,8,2,0,1,1,24,10,7,7
"2011","Islington 009E","E01002752","Total",67,19,12,36,3,0,0,3,64,19,12,33
"2011","Islington 010A","E01002764","Total",89,25,16,48,11,2,1,8,78,23,15,40
"2011","Islington 010B","E01002783","Total",79,21,12,46,2,0,1,1,77,21,11,45
"2011","Islington 010C","E01002784","Total",90,19,15,56,5,1,2,2,85,18,13,54
"2011","Islington 010D","E01002786","Total",80,19,13,48,6,0,1,5,74,19,12,43
"2011","Islington 010E","E01002787","Total",68,15,19,34,3,2,0,1,65,13,19,33
"2011","Islington 011C","E01002762","Total",54,14,14,26,4,3,0,1,50,11,14,25
"2011","Islington 011D","E01002767","Total",128,44,20,64,17,5,3,9,111,39,17,55
"2011","Islington 011E","E01033486","Total",49,9,8,32,2,0,0,2,47,9,8,30
"2011","Islington 011F","E01033487","Total",38,9,7,22,2,1,0,1,36,8,7,21
"2011","Islington 011G","E01033488","Total",51,13,9,29,4,0,0,4,47,13,9,25
"2011","Islington 011H","E01033491","Total",56,12,11,33,6,3,1,2,50,9,10,31
"2011","Islington 011I","E01033492","Total",42,5,14,23,3,1,1,1,39,4,13,22
"2011","Islington 012A","E01002777","Total",47,15,14,18,1,0,1,0,46,15,13,18
"2011","Islington 012B","E01002778","Total",137,20,17,100,6,0,2,4,131,20,15,96
"2011","Islington 012C","E01002779","Total",65,18,18,29,1,0,1,0,64,18,17,29
"2011","Islington 012D","E01002781","Total",65,11,16,38,8,2,4,2,57,9,12,36
"2011","Islington 012E","E01002782","Total",112,24,14,74,17,3,2,12,95,21,12,62
"2011","Islington 013A","E01002739","Total",44,14,13,17,6,1,3,2,38,13,10,15
"2011","Islington 013B","E01002740","Total",34,7,12,15,4,0,3,1,30,7,9,14
"2011","Islington 013C","E01002745","Total",41,11,11,19,2,1,1,0,39,10,10,19
"2011","Islington 013D","E01002795","Total",73,22,13,38,3,0,1,2,70,22,12,36
"2011","Islington 013E","E01002796","Total",20,3,6,11,3,1,1,1,17,2,5,10
"2011","Islington 014A","E01002716","Total",164,25,34,105,8,0,5,3,156,25,29,102
"2011","Islington 014B","E01002718","Total",29,8,8,13,3,0,3,0,26,8,5,13
"2011","Islington 014C","E01002721","Total",88,23,14,51,3,1,0,2,85,22,14,49
"2011","Islington 014D","E01002775","Total",40,13,6,21,3,0,2,1,37,13,4,20
"2011","Islington 014E","E01002776","Total",104,16,19,69,4,0,3,1,100,16,16,68
"2011","Islington 014F","E01002780","Total",62,9,14,39,5,0,2,3,57,9,12,36
"2011","Islington 015A","E01002708","Total",91,21,11,59,6,0,3,3,85,21,8,56
"2011","Islington 015B","E01002712","Total",52,15,10,27,5,2,3,0,47,13,7,27
"2011","Islington 015C","E01002713","Total",78,16,22,40,6,1,2,3,72,15,20,37
"2011","Islington 015D","E01002765","Total",145,26,26,93,12,0,5,7,133,26,21,86
"2011","Islington 015E","E01002766","Total",94,19,15,60,2,0,0,2,92,19,15,58
"2011","Islington 016A","E01002717","Total",41,11,11,19,6,0,3,3,35,11,8,16
"2011","Islington 016B","E01002719","Total",44,19,3,22,1,0,0,1,43,19,3,21
"2011","Islington 016C","E01002720","Total",207,51,26,130,9,1,2,6,198,50,24,124
"2011","Islington 016D","E01002790","Total",79,15,16,48,6,0,3,3,73,15,13,45
"2011","Islington 016E","E01002791","Total",44,13,9,22,5,1,3,1,39,12,6,21
"2011","Islington 016F","E01002793","Total",108,33,15,60,4,0,1,3,104,33,14,57
"2011","Islington 017A","E01002698","Total",77,17,19,41,6,2,4,0,71,15,15,41
"2011","Islington 017B","E01002699","Total",45,11,10,24,7,1,3,3,38,10,7,21
"2011","Islington 017C","E01002700","Total",21,2,8,11,2,0,1,1,19,2,7,10
"2011","Islington 017D","E01002714","Total",46,12,17,17,5,1,4,0,41,11,13,17
"2011","Islington 017E","E01002792","Total",46,14,14,18,0,0,0,0,46,14,14,18
"2011","Islington 018A","E01002722","Total",84,21,16,47,9,1,3,5,75,20,13,42
"2011","Islington 018B","E01002797","Total",83,17,14,52,6,0,1,5,77,17,13,47
"2011","Islington 018C","E01002798","Total",35,4,9,22,4,0,1,3,31,4,8,19
"2011","Islington 018D","E01002799","Total",119,22,16,81,6,0,4,2,113,22,12,79
"2011","Islington 018E","E01002800","Total",81,16,12,53,0,0,0,0,81,16,12,53
"2011","Islington 019A","E01002694","Total",125,34,14,77,6,2,1,3,119,32,13,74
"2011","Islington 019B","E01002697","Total",87,34,15,38,6,2,4,0,81,32,11,38
"2011","Islington 019C","E01002709","Total",74,18,11,45,6,1,0,5,68,17,11,40
"2011","Islington 019D","E01002710","Total",70,18,15,37,3,3,0,0,67,15,15,37
"2011","Islington 019E","E01002715","Total",93,21,15,57,3,1,0,2,90,20,15,55
"2011","Islington 020A","E01002696","Total",57,13,12,32,5,1,3,1,52,12,9,31
"2011","Islington 020B","E01002794","Total",40,10,13,17,3,0,3,0,37,10,10,17
"2011","Islington 020C","E01002801","Total",39,11,4,24,0,0,0,0,39,11,4,24
"2011","Islington 020D","E01002802","Total",42,5,16,21,1,0,1,0,41,5,15,21
"2011","Islington 020E","E01002803","Total",56,11,16,29,10,6,2,2,46,5,14,27
"2011","Islington 021A","E01002695","Total",34,2,9,23,0,0,0,0,34,2,9,23
"2011","Islington 021B","E01002711","Total",61,12,19,30,2,0,1,1,59,12,18,29
"2011","Islington 021C","E01002727","Total",65,21,8,36,4,2,0,2,61,19,8,34
"2011","Islington 021D","E01002728","Total",38,5,6,27,5,0,2,3,33,5,4,24
"2011","Islington 021E","E01002729","Total",32,2,9,21,2,1,0,1,30,1,9,20
"2011","Islington 022B","E01002707","Total",52,12,6,34,3,2,1,0,49,10,5,34
"2011","Islington 022C","E01002723","Total",65,14,19,32,2,0,0,2,63,14,19,30
"2011","Islington 022D","E01002724","Total",24,11,2,11,0,0,0,0,24,11,2,11
"2011","Islington 022E","E01002725","Total",62,23,6,33,5,3,0,2,57,20,6,31
"2011","Islington 022F","E01002726","Total",74,17,11,46,7,0,0,7,67,17,11,39
"2011","Islington 022G","E01033489","Total",20,4,4,12,0,0,0,0,20,4,4,12
"2011","Islington 022H","E01033490","Total",54,7,13,34,3,0,2,1,51,7,11,33
"2011","Islington 023A","E01002701","Total",65,11,16,38,1,0,0,1,64,11,16,37
"2011","Islington 023B","E01002702","Total",114,21,27,66,8,1,3,4,106,20,24,62
"2011","Islington 023C","E01002703","Total",87,18,14,55,5,0,3,2,82,18,11,53
"2011","Islington 023D","E01002704","Total",78,20,19,39,5,2,2,1,73,18,17,38
"2011","Islington 023E","E01002706","Total",106,20,24,62,9,1,6,2,97,19,18,60
"2011","Kensington and Chelsea 001A","E01002852","Total",106,28,15,63,4,0,2,2,102,28,13,61
"2011","Kensington and Chelsea 001B","E01002853","Total",66,13,12,41,6,2,1,3,60,11,11,38
"2011","Kensington and Chelsea 001C","E01002854","Total",66,18,16,32,6,0,3,3,60,18,13,29
"2011","Kensington and Chelsea 001D","E01002855","Total",85,19,17,49,1,1,0,0,84,18,17,49
"2011","Kensington and Chelsea 001E","E01002857","Total",89,23,16,50,2,0,1,1,87,23,15,49
"2011","Kensington and Chelsea 002A","E01002904","Total",88,29,16,43,4,2,0,2,84,27,16,41
"2011","Kensington and Chelsea 002B","E01002905","Total",73,16,11,46,1,0,0,1,72,16,11,45
"2011","Kensington and Chelsea 002C","E01002906","Total",73,19,18,36,6,0,1,5,67,19,17,31
"2011","Kensington and Chelsea 002D","E01002907","Total",114,36,12,66,3,0,2,1,111,36,10,65
"2011","Kensington and Chelsea 003A","E01002876","Total",48,13,13,22,3,0,1,2,45,13,12,20
"2011","Kensington and Chelsea 003B","E01002877","Total",124,24,23,77,9,1,6,2,115,23,17,75
"2011","Kensington and Chelsea 003C","E01002878","Total",59,15,17,27,2,0,0,2,57,15,17,25
"2011","Kensington and Chelsea 003D","E01002908","Total",44,12,8,24,2,0,0,2,42,12,8,22
"2011","Kensington and Chelsea 003E","E01002909","Total",63,23,13,27,5,2,1,2,58,21,12,25
"2011","Kensington and Chelsea 004A","E01002829","Total",57,12,15,30,2,0,1,1,55,12,14,29
"2011","Kensington and Chelsea 004B","E01002830","Total",67,19,19,29,2,0,1,1,65,19,18,28
"2011","Kensington and Chelsea 004C","E01002831","Total",67,12,21,34,1,0,1,0,66,12,20,34
"2011","Kensington and Chelsea 004D","E01002832","Total",101,22,26,53,3,1,1,1,98,21,25,52
"2011","Kensington and Chelsea 004E","E01002856","Total",65,17,15,33,6,1,1,4,59,16,14,29
"2011","Kensington and Chelsea 005A","E01002870","Total",70,11,15,44,5,0,1,4,65,11,14,40
"2011","Kensington and Chelsea 005B","E01002872","Total",48,14,8,26,1,0,1,0,47,14,7,26
"2011","Kensington and Chelsea 005C","E01002879","Total",86,23,17,46,2,0,0,2,84,23,17,44
"2011","Kensington and Chelsea 005D","E01002880","Total",96,17,19,60,4,1,1,2,92,16,18,58
"2011","Kensington and Chelsea 005E","E01002881","Total",68,17,16,35,2,0,2,0,66,17,14,35
"2011","Kensington and Chelsea 006A","E01002882","Total",34,10,9,15,1,0,1,0,33,10,8,15
"2011","Kensington and Chelsea 006B","E01002883","Total",28,2,6,20,0,0,0,0,28,2,6,20
"2011","Kensington and Chelsea 006C","E01002884","Total",13,4,6,3,3,0,2,1,10,4,4,2
"2011","Kensington and Chelsea 006D","E01002885","Total",31,5,9,17,4,1,2,1,27,4,7,16
"2011","Kensington and Chelsea 006E","E01002886","Total",11,5,3,3,3,0,2,1,8,5,1,2
"2011","Kensington and Chelsea 007A","E01002833","Total",32,8,16,8,3,1,2,0,29,7,14,8
"2011","Kensington and Chelsea 007B","E01002871","Total",21,5,4,12,0,0,0,0,21,5,4,12
"2011","Kensington and Chelsea 007C","E01002873","Total",26,9,5,12,1,0,0,1,25,9,5,11
"2011","Kensington and Chelsea 007D","E01002874","Total",38,10,9,19,1,0,1,0,37,10,8,19
"2011","Kensington and Chelsea 007E","E01002875","Total",18,6,3,9,1,0,1,0,17,6,2,9
"2011","Kensington and Chelsea 008A","E01002824","Total",7,2,3,2,1,0,1,0,6,2,2,2
"2011","Kensington and Chelsea 008B","E01002825","Total",25,6,7,12,2,1,1,0,23,5,6,12
"2011","Kensington and Chelsea 008C","E01002826","Total",20,3,3,14,1,0,0,1,19,3,3,13
"2011","Kensington and Chelsea 008D","E01002827","Total",14,5,5,4,0,0,0,0,14,5,5,4
"2011","Kensington and Chelsea 008E","E01002828","Total",13,3,3,7,3,2,1,0,10,1,2,7
"2011","Kensington and Chelsea 009A","E01002864","Total",24,6,4,14,1,0,0,1,23,6,4,13
"2011","Kensington and Chelsea 009B","E01002866","Total",61,11,11,39,4,0,3,1,57,11,8,38
"2011","Kensington and Chelsea 009C","E01002867","Total",66,13,12,41,8,4,3,1,58,9,9,40
"2011","Kensington and Chelsea 009D","E01002868","Total",10,2,2,6,0,0,0,0,10,2,2,6
"2011","Kensington and Chelsea 009E","E01002869","Total",35,3,4,28,2,0,1,1,33,3,3,27
"2011","Kensington and Chelsea 010A","E01002887","Total",5,1,4,0,0,0,0,0,5,1,4,0
"2011","Kensington and Chelsea 010B","E01002889","Total",6,3,3,0,1,0,1,0,5,3,2,0
"2011","Kensington and Chelsea 010C","E01002890","Total",17,3,8,6,0,0,0,0,17,3,8,6
"2011","Kensington and Chelsea 010D","E01002891","Total",23,3,6,14,3,1,0,2,20,2,6,12
"2011","Kensington and Chelsea 010E","E01002892","Total",20,5,5,10,0,0,0,0,20,5,5,10
"2011","Kensington and Chelsea 011A","E01002813","Total",8,0,1,7,2,0,1,1,6,0,0,6
"2011","Kensington and Chelsea 011B","E01002815","Total",25,6,7,12,0,0,0,0,25,6,7,12
"2011","Kensington and Chelsea 011C","E01002816","Total",10,2,6,2,0,0,0,0,10,2,6,2
"2011","Kensington and Chelsea 011D","E01002817","Total",29,4,6,19,3,0,3,0,26,4,3,19
"2011","Kensington and Chelsea 011E","E01002865","Total",23,5,6,12,3,1,2,0,20,4,4,12
"2011","Kensington and Chelsea 012A","E01002818","Total",19,5,5,9,0,0,0,0,19,5,5,9
"2011","Kensington and Chelsea 012B","E01002819","Total",10,1,6,3,1,0,1,0,9,1,5,3
"2011","Kensington and Chelsea 012C","E01002859","Total",21,7,3,11,1,0,1,0,20,7,2,11
"2011","Kensington and Chelsea 012D","E01002860","Total",12,2,5,5,2,0,2,0,10,2,3,5
"2011","Kensington and Chelsea 012E","E01002863","Total",14,4,7,3,3,0,3,0,11,4,4,3
"2011","Kensington and Chelsea 013A","E01002812","Total",34,9,13,12,0,0,0,0,34,9,13,12
"2011","Kensington and Chelsea 013B","E01002834","Total",14,2,2,10,1,0,0,1,13,2,2,9
"2011","Kensington and Chelsea 013C","E01002839","Total",24,8,5,11,2,0,2,0,22,8,3,11
"2011","Kensington and Chelsea 013D","E01002850","Total",28,10,6,12,2,1,0,1,26,9,6,11
"2011","Kensington and Chelsea 013E","E01002888","Total",12,3,1,8,0,0,0,0,12,3,1,8
"2011","Kensington and Chelsea 014A","E01002821","Total",16,2,5,9,0,0,0,0,16,2,5,9
"2011","Kensington and Chelsea 014B","E01002823","Total",35,12,7,16,0,0,0,0,35,12,7,16
"2011","Kensington and Chelsea 014C","E01002858","Total",39,8,2,29,1,0,0,1,38,8,2,28
"2011","Kensington and Chelsea 014D","E01002861","Total",19,2,7,10,4,0,2,2,15,2,5,8
"2011","Kensington and Chelsea 014E","E01002862","Total",62,24,10,28,2,0,1,1,60,24,9,27
"2011","Kensington and Chelsea 015A","E01002814","Total",73,18,17,38,6,0,6,0,67,18,11,38
"2011","Kensington and Chelsea 015B","E01002847","Total",30,8,14,8,0,0,0,0,30,8,14,8
"2011","Kensington and Chelsea 015C","E01002848","Total",34,9,8,17,1,0,0,1,33,9,8,16
"2011","Kensington and Chelsea 015D","E01002851","Total",39,17,8,14,2,1,1,0,37,16,7,14
"2011","Kensington and Chelsea 016A","E01002820","Total",8,2,2,4,0,0,0,0,8,2,2,4
"2011","Kensington and Chelsea 016B","E01002822","Total",7,2,2,3,0,0,0,0,7,2,2,3
"2011","Kensington and Chelsea 016C","E01002835","Total",14,2,4,8,1,0,1,0,13,2,3,8
"2011","Kensington and Chelsea 016D","E01002836","Total",15,4,6,5,0,0,0,0,15,4,6,5
"2011","Kensington and Chelsea 016E","E01002837","Total",10,4,2,4,0,0,0,0,10,4,2,4
"2011","Kensington and Chelsea 017A","E01002846","Total",38,15,4,19,2,1,0,1,36,14,4,18
"2011","Kensington and Chelsea 017B","E01002849","Total",30,5,11,14,0,0,0,0,30,5,11,14
"2011","Kensington and Chelsea 017C","E01002893","Total",34,4,9,21,4,0,4,0,30,4,5,21
"2011","Kensington and Chelsea 017D","E01002894","Total",28,11,10,7,3,1,2,0,25,10,8,7
"2011","Kensington and Chelsea 017E","E01002898","Total",21,4,8,9,3,0,0,3,18,4,8,6
"2011","Kensington and Chelsea 018A","E01002899","Total",27,9,7,11,0,0,0,0,27,9,7,11
"2011","Kensington and Chelsea 018B","E01002900","Total",16,0,3,13,0,0,0,0,16,0,3,13
"2011","Kensington and Chelsea 018C","E01002901","Total",13,2,4,7,0,0,0,0,13,2,4,7
"2011","Kensington and Chelsea 018D","E01002902","Total",28,7,9,12,0,0,0,0,28,7,9,12
"2011","Kensington and Chelsea 018E","E01002903","Total",7,1,4,2,0,0,0,0,7,1,4,2
"2011","Kensington and Chelsea 019A","E01002844","Total",14,2,7,5,1,0,1,0,13,2,6,5
"2011","Kensington and Chelsea 019B","E01002845","Total",21,7,2,12,2,0,0,2,19,7,2,10
"2011","Kensington and Chelsea 019C","E01002910","Total",20,4,4,12,1,0,1,0,19,4,3,12
"2011","Kensington and Chelsea 019D","E01002911","Total",20,2,5,13,0,0,0,0,20,2,5,13
"2011","Kensington and Chelsea 019E","E01002914","Total",22,4,12,6,3,0,3,0,19,4,9,6
"2011","Kensington and Chelsea 020A","E01002838","Total",12,2,4,6,4,1,2,1,8,1,2,5
"2011","Kensington and Chelsea 020B","E01002895","Total",21,3,9,9,4,1,1,2,17,2,8,7
"2011","Kensington and Chelsea 020C","E01002896","Total",12,4,7,1,0,0,0,0,12,4,7,1
"2011","Kensington and Chelsea 020D","E01002897","Total",29,6,8,15,1,0,1,0,28,6,7,15
"2011","Kensington and Chelsea 020E","E01002912","Total",30,7,10,13,2,0,2,0,28,7,8,13
"2011","Kensington and Chelsea 021A","E01002840","Total",53,13,5,35,2,0,0,2,51,13,5,33
"2011","Kensington and Chelsea 021B","E01002841","Total",33,9,5,19,0,0,0,0,33,9,5,19
"2011","Kensington and Chelsea 021C","E01002842","Total",49,15,7,27,2,0,0,2,47,15,7,25
"2011","Kensington and Chelsea 021D","E01002843","Total",65,29,5,31,1,0,0,1,64,29,5,30
"2011","Kensington and Chelsea 021E","E01002913","Total",44,12,10,22,4,1,2,1,40,11,8,21
"2011","Lambeth 002A","E01003015","Total",89,27,16,46,7,1,1,5,82,26,15,41
"2011","Lambeth 002B","E01003108","Total",94,23,28,43,5,0,0,5,89,23,28,38
"2011","Lambeth 002C","E01003110","Total",66,13,20,33,5,0,2,3,61,13,18,30
"2011","Lambeth 002D","E01003111","Total",91,31,19,41,9,4,3,2,82,27,16,39
"2011","Lambeth 002E","E01003112","Total",75,22,12,41,2,2,0,0,73,20,12,41
"2011","Lambeth 003A","E01003101","Total",89,31,26,32,4,0,3,1,85,31,23,31
"2011","Lambeth 003B","E01003105","Total",106,30,27,49,6,1,1,4,100,29,26,45
"2011","Lambeth 003C","E01003106","Total",108,27,41,40,6,0,4,2,102,27,37,38
"2011","Lambeth 003D","E01003107","Total",71,15,23,33,5,1,2,2,66,14,21,31
"2011","Lambeth 003E","E01003109","Total",124,26,28,70,11,4,1,6,113,22,27,64
"2011","Lambeth 004A","E01003102","Total",44,8,14,22,5,0,4,1,39,8,10,21
"2011","Lambeth 004C","E01003104","Total",46,14,11,21,2,0,2,0,44,14,9,21
"2011","Lambeth 004D","E01003122","Total",80,21,16,43,5,0,4,1,75,21,12,42
"2011","Lambeth 004E","E01003129","Total",66,13,19,34,3,0,3,0,63,13,16,34
"2011","Lambeth 004F","E01033207","Total",64,17,13,34,6,0,2,4,58,17,11,30
"2011","Lambeth 004G","E01033208","Total",62,16,9,37,3,1,1,1,59,15,8,36
"2011","Lambeth 005A","E01003098","Total",56,16,11,29,9,1,1,7,47,15,10,22
"2011","Lambeth 005B","E01003099","Total",76,27,11,38,5,2,2,1,71,25,9,37
"2011","Lambeth 005C","E01003100","Total",29,8,10,11,5,2,3,0,24,6,7,11
"2011","Lambeth 005D","E01003180","Total",71,19,24,28,6,2,3,1,65,17,21,27
"2011","Lambeth 005E","E01003183","Total",72,16,18,38,7,1,1,5,65,15,17,33
"2011","Lambeth 006A","E01003097","Total",80,20,27,33,5,0,2,3,75,20,25,30
"2011","Lambeth 006B","E01003121","Total",112,42,22,48,2,0,1,1,110,42,21,47
"2011","Lambeth 006C","E01003123","Total",43,13,17,13,4,0,4,0,39,13,13,13
"2011","Lambeth 006D","E01003124","Total",60,12,11,37,3,0,0,3,57,12,11,34
"2011","Lambeth 006E","E01003125","Total",136,27,32,77,4,0,2,2,132,27,30,75
"2011","Lambeth 007A","E01003181","Total",81,20,15,46,4,0,1,3,77,20,14,43
"2011","Lambeth 007B","E01003184","Total",128,27,35,66,8,1,3,4,120,26,32,62
"2011","Lambeth 007C","E01003185","Total",69,28,18,23,7,5,1,1,62,23,17,22
"2011","Lambeth 007D","E01003186","Total",73,24,27,22,3,0,3,0,70,24,24,22
"2011","Lambeth 007E","E01003187","Total",78,27,18,33,5,0,3,2,73,27,15,31
"2011","Lambeth 008A","E01003089","Total",122,38,36,48,12,2,6,4,110,36,30,44
"2011","Lambeth 008B","E01003091","Total",102,21,24,57,6,1,1,4,96,20,23,53
"2011","Lambeth 008C","E01003092","Total",117,18,28,71,17,1,8,8,100,17,20,63
"2011","Lambeth 008D","E01003126","Total",97,30,24,43,8,4,2,2,89,26,22,41
"2011","Lambeth 008E","E01003128","Total",97,23,24,50,4,0,1,3,93,23,23,47
"2011","Lambeth 009A","E01003046","Total",143,38,33,72,6,2,1,3,137,36,32,69
"2011","Lambeth 009B","E01003048","Total",149,47,20,82,17,3,2,12,132,44,18,70
"2011","Lambeth 009C","E01003075","Total",132,32,31,69,7,1,3,3,125,31,28,66
"2011","Lambeth 009D","E01003182","Total",74,19,20,35,10,0,2,8,64,19,18,27
"2011","Lambeth 009E","E01003188","Total",86,18,22,46,5,1,1,3,81,17,21,43
"2011","Lambeth 010A","E01003088","Total",89,27,28,34,8,1,2,5,81,26,26,29
"2011","Lambeth 010B","E01003093","Total",209,43,48,118,6,0,0,6,203,43,48,112
"2011","Lambeth 010C","E01003094","Total",47,9,17,21,5,0,3,2,42,9,14,19
"2011","Lambeth 010D","E01003096","Total",27,4,7,16,3,0,0,3,24,4,7,13
"2011","Lambeth 010E","E01003127","Total",62,24,11,27,4,0,2,2,58,24,9,25
"2011","Lambeth 011A","E01003045","Total",141,29,32,80,11,2,4,5,130,27,28,75
"2011","Lambeth 011B","E01003047","Total",89,18,29,42,7,1,4,2,82,17,25,40
"2011","Lambeth 011C","E01003049","Total",113,29,27,57,5,3,0,2,108,26,27,55
"2011","Lambeth 011D","E01003059","Total",85,32,13,40,3,1,0,2,82,31,13,38
"2011","Lambeth 011E","E01003060","Total",96,26,19,51,6,0,3,3,90,26,16,48
"2011","Lambeth 011F","E01003061","Total",50,18,9,23,7,0,4,3,43,18,5,20
"2011","Lambeth 012A","E01003034","Total",61,23,13,25,3,3,0,0,58,20,13,25
"2011","Lambeth 012B","E01003035","Total",40,9,9,22,1,0,0,1,39,9,9,21
"2011","Lambeth 012C","E01003036","Total",67,11,21,35,7,1,4,2,60,10,17,33
"2011","Lambeth 012D","E01003090","Total",42,10,12,20,1,0,0,1,41,10,12,19
"2011","Lambeth 012E","E01003095","Total",54,13,18,23,4,1,3,0,50,12,15,23
"2011","Lambeth 013A","E01003037","Total",64,15,11,38,2,1,1,0,62,14,10,38
"2011","Lambeth 013B","E01003038","Total",15,5,6,4,2,0,2,0,13,5,4,4
"2011","Lambeth 013C","E01003039","Total",37,12,9,16,0,0,0,0,37,12,9,16
"2011","Lambeth 013D","E01003040","Total",34,8,12,14,0,0,0,0,34,8,12,14
"2011","Lambeth 013E","E01003042","Total",43,13,9,21,2,0,0,2,41,13,9,19
"2011","Lambeth 014A","E01003072","Total",44,17,11,16,7,3,4,0,37,14,7,16
"2011","Lambeth 014B","E01003073","Total",84,22,19,43,4,0,1,3,80,22,18,40
"2011","Lambeth 014C","E01003076","Total",72,18,22,32,4,2,1,1,68,16,21,31
"2011","Lambeth 014D","E01003077","Total",52,18,16,18,2,0,1,1,50,18,15,17
"2011","Lambeth 014E","E01003078","Total",33,7,12,14,0,0,0,0,33,7,12,14
"2011","Lambeth 015A","E01003019","Total",53,14,21,18,4,0,2,2,49,14,19,16
"2011","Lambeth 015B","E01003053","Total",25,5,8,12,3,0,3,0,22,5,5,12
"2011","Lambeth 015C","E01003054","Total",33,6,10,17,4,0,3,1,29,6,7,16
"2011","Lambeth 015D","E01003056","Total",69,13,16,40,20,0,4,16,49,13,12,24
"2011","Lambeth 015E","E01003058","Total",53,13,11,29,9,3,2,4,44,10,9,25
"2011","Lambeth 016A","E01003020","Total",78,15,28,35,3,1,1,1,75,14,27,34
"2011","Lambeth 016B","E01003050","Total",49,10,8,31,2,0,1,1,47,10,7,30
"2011","Lambeth 016C","E01003052","Total",133,30,30,73,11,2,3,6,122,28,27,67
"2011","Lambeth 016D","E01003055","Total",37,9,15,13,2,0,2,0,35,9,13,13
"2011","Lambeth 016E","E01003176","Total",152,49,27,76,9,1,5,3,143,48,22,73
"2011","Lambeth 017A","E01003029","Total",41,10,8,23,3,0,0,3,38,10,8,20
"2011","Lambeth 017B","E01003032","Total",79,18,19,42,9,0,3,6,70,18,16,36
"2011","Lambeth 017C","E01003041","Total",90,19,22,49,9,0,1,8,81,19,21,41
"2011","Lambeth 017D","E01003057","Total",94,16,22,56,4,0,1,3,90,16,21,53
"2011","Lambeth 018A","E01003043","Total",56,23,19,14,1,0,1,0,55,23,18,14
"2011","Lambeth 018B","E01003044","Total",91,22,21,48,7,1,2,4,84,21,19,44
"2011","Lambeth 018C","E01003051","Total",116,30,27,59,6,0,3,3,110,30,24,56
"2011","Lambeth 018D","E01003071","Total",71,21,24,26,3,1,2,0,68,20,22,26
"2011","Lambeth 018E","E01003074","Total",99,17,36,46,12,2,6,4,87,15,30,42
"2011","Lambeth 019A","E01003026","Total",16,4,3,9,0,0,0,0,16,4,3,9
"2011","Lambeth 019B","E01003027","Total",15,5,6,4,1,1,0,0,14,4,6,4
"2011","Lambeth 019C","E01003028","Total",39,6,7,26,6,0,2,4,33,6,5,22
"2011","Lambeth 019D","E01003030","Total",28,7,10,11,3,1,1,1,25,6,9,10
"2011","Lambeth 019E","E01003033","Total",32,6,9,17,1,0,0,1,31,6,9,16
"2011","Lambeth 020A","E01003018","Total",51,11,24,16,4,0,0,4,47,11,24,12
"2011","Lambeth 020B","E01003171","Total",80,15,17,48,5,1,2,2,75,14,15,46
"2011","Lambeth 020C","E01003173","Total",30,7,12,11,2,1,0,1,28,6,12,10
"2011","Lambeth 020D","E01003177","Total",77,19,14,44,4,0,2,2,73,19,12,42
"2011","Lambeth 020E","E01003178","Total",35,14,11,10,2,0,1,1,33,14,10,9
"2011","Lambeth 021A","E01003021","Total",72,17,19,36,5,3,0,2,67,14,19,34
"2011","Lambeth 021B","E01003022","Total",56,19,12,25,2,1,0,1,54,18,12,24
"2011","Lambeth 021C","E01003023","Total",87,28,23,36,3,0,1,2,84,28,22,34
"2011","Lambeth 021D","E01003024","Total",147,49,36,62,4,0,3,1,143,49,33,61
"2011","Lambeth 021E","E01003025","Total",107,33,34,40,6,2,3,1,101,31,31,39
"2011","Lambeth 022A","E01003136","Total",69,18,19,32,8,1,1,6,61,17,18,26
"2011","Lambeth 022B","E01003137","Total",102,27,16,59,13,2,0,11,89,25,16,48
"2011","Lambeth 022C","E01003159","Total",78,16,24,38,6,0,4,2,72,16,20,36
"2011","Lambeth 022D","E01003160","Total",118,33,25,60,9,2,1,6,109,31,24,54
"2011","Lambeth 022E","E01003162","Total",175,54,35,86,12,4,4,4,163,50,31,82
"2011","Lambeth 023A","E01003031","Total",62,19,15,28,0,0,0,0,62,19,15,28
"2011","Lambeth 023B","E01003156","Total",54,18,14,22,2,0,2,0,52,18,12,22
"2011","Lambeth 023C","E01003157","Total",30,6,6,18,0,0,0,0,30,6,6,18
"2011","Lambeth 023D","E01003158","Total",17,4,8,5,0,0,0,0,17,4,8,5
"2011","Lambeth 023E","E01003161","Total",50,15,9,26,3,0,1,2,47,15,8,24
"2011","Lambeth 023F","E01003163","Total",51,12,18,21,2,0,0,2,49,12,18,19
"2011","Lambeth 024A","E01003132","Total",86,14,23,49,3,0,0,3,83,14,23,46
"2011","Lambeth 024B","E01003172","Total",124,37,28,59,16,1,4,11,108,36,24,48
"2011","Lambeth 024C","E01003174","Total",198,58,40,100,11,2,4,5,187,56,36,95
"2011","Lambeth 024D","E01003175","Total",134,39,36,59,6,0,0,6,128,39,36,53
"2011","Lambeth 024E","E01003179","Total",149,42,37,70,14,2,7,5,135,40,30,65
"2011","Lambeth 025A","E01003164","Total",109,23,38,48,10,2,5,3,99,21,33,45
"2011","Lambeth 025B","E01003165","Total",76,20,16,40,3,1,2,0,73,19,14,40
"2011","Lambeth 025C","E01003168","Total",107,31,17,59,6,0,3,3,101,31,14,56
"2011","Lambeth 025D","E01003169","Total",104,24,29,51,8,0,5,3,96,24,24,48
"2011","Lambeth 025E","E01003170","Total",35,13,16,6,0,0,0,0,35,13,16,6
"2011","Lambeth 026A","E01003130","Total",46,14,15,17,5,1,4,0,41,13,11,17
"2011","Lambeth 026B","E01003131","Total",44,14,15,15,5,0,3,2,39,14,12,13
"2011","Lambeth 026C","E01003135","Total",65,24,12,29,2,1,0,1,63,23,12,28
"2011","Lambeth 026D","E01003138","Total",24,6,13,5,1,0,1,0,23,6,12,5
"2011","Lambeth 026E","E01003151","Total",169,43,43,83,7,1,2,4,162,42,41,79
"2011","Lambeth 027A","E01003079","Total",123,39,27,57,3,0,0,3,120,39,27,54
"2011","Lambeth 027B","E01003080","Total",51,9,22,20,5,0,0,5,46,9,22,15
"2011","Lambeth 027C","E01003133","Total",76,25,26,25,13,4,4,5,63,21,22,20
"2011","Lambeth 027D","E01003134","Total",52,14,19,19,4,2,1,1,48,12,18,18
"2011","Lambeth 027E","E01003152","Total",71,29,20,22,6,1,3,2,65,28,17,20
"2011","Lambeth 028A","E01003064","Total",45,13,8,24,6,1,1,4,39,12,7,20
"2011","Lambeth 028B","E01003066","Total",111,27,35,49,5,1,3,1,106,26,32,48
"2011","Lambeth 028C","E01003081","Total",91,32,24,35,5,0,4,1,86,32,20,34
"2011","Lambeth 028D","E01003166","Total",118,44,22,52,5,0,3,2,113,44,19,50
"2011","Lambeth 028E","E01003167","Total",40,12,15,13,5,2,3,0,35,10,12,13
"2011","Lambeth 029A","E01003116","Total",45,12,13,20,6,1,0,5,39,11,13,15
"2011","Lambeth 029B","E01003117","Total",59,12,13,34,5,3,1,1,54,9,12,33
"2011","Lambeth 029C","E01003118","Total",33,13,12,8,5,1,3,1,28,12,9,7
"2011","Lambeth 029D","E01003153","Total",48,15,17,16,3,0,3,0,45,15,14,16
"2011","Lambeth 029E","E01003155","Total",31,9,9,13,1,0,1,0,30,9,8,13
"2011","Lambeth 030A","E01003083","Total",40,12,11,17,2,0,0,2,38,12,11,15
"2011","Lambeth 030B","E01003084","Total",51,12,14,25,4,1,1,2,47,11,13,23
"2011","Lambeth 030C","E01003085","Total",64,18,19,27,3,0,2,1,61,18,17,26
"2011","Lambeth 030D","E01003149","Total",57,12,27,18,6,0,3,3,51,12,24,15
"2011","Lambeth 030E","E01003154","Total",99,22,27,50,4,1,2,1,95,21,25,49
"2011","Lambeth 031A","E01003065","Total",126,37,19,70,4,1,1,2,122,36,18,68
"2011","Lambeth 031B","E01003068","Total",126,28,38,60,10,0,6,4,116,28,32,56
"2011","Lambeth 031C","E01003082","Total",84,22,24,38,6,1,4,1,78,21,20,37
"2011","Lambeth 031D","E01003086","Total",130,39,20,71,10,0,1,9,120,39,19,62
"2011","Lambeth 031E","E01003087","Total",147,35,39,73,11,1,7,3,136,34,32,70
"2011","Lambeth 032A","E01003113","Total",77,17,17,43,5,0,2,3,72,17,15,40
"2011","Lambeth 032B","E01003114","Total",74,17,23,34,8,2,4,2,66,15,19,32
"2011","Lambeth 032C","E01003119","Total",54,17,17,20,3,0,1,2,51,17,16,18
"2011","Lambeth 032D","E01003120","Total",82,28,22,32,7,2,2,3,75,26,20,29
"2011","Lambeth 032E","E01003148","Total",54,15,11,28,5,2,1,2,49,13,10,26
"2011","Lambeth 032F","E01003150","Total",112,32,32,48,7,0,7,0,105,32,25,48
"2011","Lambeth 033A","E01003062","Total",83,28,24,31,4,1,3,0,79,27,21,31
"2011","Lambeth 033B","E01003063","Total",101,24,25,52,4,0,2,2,97,24,23,50
"2011","Lambeth 033C","E01003067","Total",74,19,25,30,7,3,4,0,67,16,21,30
"2011","Lambeth 033D","E01003069","Total",81,21,24,36,2,0,1,1,79,21,23,35
"2011","Lambeth 033E","E01003070","Total",114,19,35,60,16,1,11,4,98,18,24,56
"2011","Lambeth 034A","E01003115","Total",82,21,22,39,3,0,2,1,79,21,20,38
"2011","Lambeth 034B","E01003141","Total",85,28,22,35,9,5,1,3,76,23,21,32
"2011","Lambeth 034C","E01003144","Total",22,11,3,8,1,1,0,0,21,10,3,8
"2011","Lambeth 034D","E01003145","Total",64,15,18,31,9,0,3,6,55,15,15,25
"2011","Lambeth 034E","E01003147","Total",72,30,20,22,12,5,4,3,60,25,16,19
"2011","Lambeth 035A","E01003139","Total",59,16,21,22,7,0,1,6,52,16,20,16
"2011","Lambeth 035B","E01003140","Total",50,12,20,18,5,0,4,1,45,12,16,17
"2011","Lambeth 035C","E01003142","Total",43,11,7,25,6,1,1,4,37,10,6,21
"2011","Lambeth 035D","E01003143","Total",58,16,14,28,2,0,1,1,56,16,13,27
"2011","Lambeth 035E","E01003146","Total",82,18,33,31,6,2,4,0,76,16,29,31
"2011","Lambeth 036A","E01003013","Total",18,6,9,3,5,2,3,0,13,4,6,3
"2011","Lambeth 036B","E01003014","Total",42,9,16,17,0,0,0,0,42,9,16,17
"2011","Lambeth 036C","E01003016","Total",22,4,9,9,0,0,0,0,22,4,9,9
"2011","Lambeth 036D","E01003017","Total",54,18,11,25,2,0,0,2,52,18,11,23
"2011","Lambeth 036E","E01032582","Total",60,13,13,34,2,0,1,1,58,13,12,33
"2011","Lewisham 001A","E01003244","Total",136,42,27,67,21,8,4,9,115,34,23,58
"2011","Lewisham 001B","E01003245","Total",156,49,24,83,12,1,3,8,144,48,21,75
"2011","Lewisham 001C","E01003247","Total",29,6,8,15,1,0,1,0,28,6,7,15
"2011","Lewisham 001D","E01003249","Total",104,19,34,51,9,1,3,5,95,18,31,46
"2011","Lewisham 001E","E01003250","Total",95,25,27,43,7,2,3,2,88,23,24,41
"2011","Lewisham 002A","E01003246","Total",91,27,14,50,12,6,1,5,79,21,13,45
"2011","Lewisham 002B","E01003248","Total",112,26,24,62,7,2,2,3,105,24,22,59
"2011","Lewisham 002C","E01003251","Total",166,51,35,80,10,2,3,5,156,49,32,75
"2011","Lewisham 002D","E01003252","Total",161,47,36,78,21,3,4,14,140,44,32,64
"2011","Lewisham 002E","E01003253","Total",82,19,14,49,15,1,3,11,67,18,11,38
"2011","Lewisham 003A","E01003297","Total",107,31,22,54,3,1,1,1,104,30,21,53
"2011","Lewisham 003B","E01003299","Total",80,24,17,39,8,2,3,3,72,22,14,36
"2011","Lewisham 003C","E01003301","Total",61,16,19,26,2,0,1,1,59,16,18,25
"2011","Lewisham 003D","E01003302","Total",106,38,18,50,18,13,2,3,88,25,16,47
"2011","Lewisham 003E","E01003305","Total",72,22,21,29,2,1,0,1,70,21,21,28
"2011","Lewisham 005A","E01003207","Total",86,29,18,39,13,4,3,6,73,25,15,33
"2011","Lewisham 005B","E01003209","Total",102,30,35,37,12,3,5,4,90,27,30,33
"2011","Lewisham 005C","E01003210","Total",71,26,22,23,5,0,3,2,66,26,19,21
"2011","Lewisham 005D","E01003212","Total",65,13,22,30,8,2,2,4,57,11,20,26
"2011","Lewisham 005E","E01003215","Total",53,21,10,22,4,0,4,0,49,21,6,22
"2011","Lewisham 006A","E01003338","Total",97,28,20,49,5,1,3,1,92,27,17,48
"2011","Lewisham 006B","E01003339","Total",58,16,15,27,6,2,1,3,52,14,14,24
"2011","Lewisham 006C","E01003340","Total",47,12,11,24,6,2,3,1,41,10,8,23
"2011","Lewisham 006D","E01003341","Total",53,18,14,21,13,9,3,1,40,9,11,20
"2011","Lewisham 006E","E01003343","Total",58,15,17,26,7,0,0,7,51,15,17,19
"2011","Lewisham 007A","E01003199","Total",50,18,13,19,3,1,1,1,47,17,12,18
"2011","Lewisham 007B","E01003201","Total",87,26,21,40,3,0,2,1,84,26,19,39
"2011","Lewisham 007C","E01003204","Total",57,17,13,27,7,2,0,5,50,15,13,22
"2011","Lewisham 007D","E01003205","Total",129,54,28,47,5,1,1,3,124,53,27,44
"2011","Lewisham 007E","E01003206","Total",35,10,9,16,9,1,2,6,26,9,7,10
"2011","Lewisham 008B","E01003211","Total",47,14,9,24,2,0,0,2,45,14,9,22
"2011","Lewisham 008C","E01003213","Total",62,21,24,17,3,1,2,0,59,20,22,17
"2011","Lewisham 008D","E01003214","Total",99,32,31,36,5,1,1,3,94,31,30,33
"2011","Lewisham 008E","E01033324","Total",51,14,12,25,1,0,1,0,50,14,11,25
"2011","Lewisham 008F","E01033325","Total",5,1,3,1,1,0,0,1,4,1,3,0
"2011","Lewisham 009A","E01003198","Total",50,12,11,27,5,2,1,2,45,10,10,25
"2011","Lewisham 009B","E01003200","Total",17,6,7,4,1,0,1,0,16,6,6,4
"2011","Lewisham 009C","E01003202","Total",15,5,9,1,0,0,0,0,15,5,9,1
"2011","Lewisham 009D","E01003203","Total",68,20,23,25,10,1,9,0,58,19,14,25
"2011","Lewisham 010A","E01003336","Total",112,40,27,45,20,9,6,5,92,31,21,40
"2011","Lewisham 010B","E01003337","Total",122,38,37,47,7,1,4,2,115,37,33,45
"2011","Lewisham 010C","E01003342","Total",69,21,20,28,2,0,1,1,67,21,19,27
"2011","Lewisham 010D","E01003344","Total",60,19,26,15,3,0,2,1,57,19,24,14
"2011","Lewisham 010E","E01003345","Total",53,14,23,16,2,0,0,2,51,14,23,14
"2011","Lewisham 011A","E01003273","Total",58,19,18,21,5,0,4,1,53,19,14,20
"2011","Lewisham 011B","E01003277","Total",88,29,25,34,7,1,2,4,81,28,23,30
"2011","Lewisham 011C","E01003278","Total",66,18,24,24,4,0,4,0,62,18,20,24
"2011","Lewisham 011D","E01003279","Total",45,15,16,14,5,0,3,2,40,15,13,12
"2011","Lewisham 012A","E01003288","Total",100,31,31,38,17,9,7,1,83,22,24,37
"2011","Lewisham 012C","E01003290","Total",74,13,25,36,1,0,1,0,73,13,24,36
"2011","Lewisham 012D","E01003291","Total",129,26,35,68,11,0,3,8,118,26,32,60
"2011","Lewisham 012E","E01003296","Total",89,20,20,49,6,3,3,0,83,17,17,49
"2011","Lewisham 012F","E01033327","Total",39,9,10,20,2,1,0,1,37,8,10,19
"2011","Lewisham 012G","E01033341","Total",101,20,13,68,14,5,0,9,87,15,13,59
"2011","Lewisham 013A","E01003282","Total",82,23,23,36,6,0,2,4,76,23,21,32
"2011","Lewisham 013B","E01003283","Total",30,6,17,7,2,0,1,1,28,6,16,6
"2011","Lewisham 013C","E01003284","Total",54,20,14,20,6,5,0,1,48,15,14,19
"2011","Lewisham 013D","E01003286","Total",95,34,22,39,10,0,6,4,85,34,16,35
"2011","Lewisham 014A","E01003272","Total",53,15,19,19,6,1,0,5,47,14,19,14
"2011","Lewisham 014B","E01003274","Total",65,21,17,27,3,1,1,1,62,20,16,26
"2011","Lewisham 014C","E01003275","Total",90,19,31,40,5,0,5,0,85,19,26,40
"2011","Lewisham 014D","E01003276","Total",85,21,30,34,11,0,3,8,74,21,27,26
"2011","Lewisham 015A","E01003225","Total",40,12,18,10,1,1,0,0,39,11,18,10
"2011","Lewisham 015B","E01003231","Total",61,26,17,18,6,2,3,1,55,24,14,17
"2011","Lewisham 015C","E01003232","Total",42,14,16,12,3,0,2,1,39,14,14,11
"2011","Lewisham 015D","E01003233","Total",37,8,10,19,4,0,2,2,33,8,8,17
"2011","Lewisham 016A","E01003280","Total",101,28,25,48,27,16,7,4,74,12,18,44
"2011","Lewisham 016B","E01003281","Total",32,7,12,13,5,0,1,4,27,7,11,9
"2011","Lewisham 016C","E01003285","Total",53,19,15,19,5,2,2,1,48,17,13,18
"2011","Lewisham 016D","E01003287","Total",36,4,20,12,5,0,2,3,31,4,18,9
"2011","Lewisham 017A","E01003292","Total",58,15,22,21,3,1,2,0,55,14,20,21
"2011","Lewisham 017B","E01003293","Total",83,15,28,40,9,1,2,6,74,14,26,34
"2011","Lewisham 017D","E01003295","Total",68,19,14,35,2,0,0,2,66,19,14,33
"2011","Lewisham 017E","E01033320","Total",54,9,17,28,1,0,0,1,53,9,17,27
"2011","Lewisham 017F","E01033322","Total",46,13,11,22,1,0,0,1,45,13,11,21
"2011","Lewisham 018A","E01003319","Total",86,20,23,43,6,1,3,2,80,19,20,41
"2011","Lewisham 018B","E01003320","Total",101,28,33,40,4,2,1,1,97,26,32,39
"2011","Lewisham 018C","E01003323","Total",70,21,16,33,3,0,2,1,67,21,14,32
"2011","Lewisham 018D","E01003325","Total",120,22,27,71,14,3,8,3,106,19,19,68
"2011","Lewisham 019A","E01003226","Total",36,12,9,15,3,1,0,2,33,11,9,13
"2011","Lewisham 019B","E01003227","Total",27,8,11,8,0,0,0,0,27,8,11,8
"2011","Lewisham 019C","E01003228","Total",37,16,9,12,2,0,1,1,35,16,8,11
"2011","Lewisham 019D","E01003229","Total",87,16,28,43,8,2,2,4,79,14,26,39
"2011","Lewisham 019E","E01003230","Total",120,24,41,55,10,1,4,5,110,23,37,50
"2011","Lewisham 020A","E01003317","Total",54,19,12,23,6,0,2,4,48,19,10,19
"2011","Lewisham 020B","E01003318","Total",109,20,45,44,29,1,8,20,80,19,37,24
"2011","Lewisham 020C","E01003321","Total",77,15,29,33,3,0,3,0,74,15,26,33
"2011","Lewisham 020D","E01003322","Total",59,18,14,27,6,1,0,5,53,17,14,22
"2011","Lewisham 020E","E01003324","Total",86,19,26,41,8,2,0,6,78,17,26,35
"2011","Lewisham 021A","E01003254","Total",20,7,6,7,1,0,1,0,19,7,5,7
"2011","Lewisham 021B","E01003255","Total",57,17,12,28,3,1,1,1,54,16,11,27
"2011","Lewisham 021C","E01003260","Total",109,69,23,17,5,0,2,3,104,69,21,14
"2011","Lewisham 021D","E01003261","Total",65,12,19,34,16,1,1,14,49,11,18,20
"2011","Lewisham 021E","E01003262","Total",71,18,19,34,6,2,1,3,65,16,18,31
"2011","Lewisham 022A","E01003217","Total",64,11,26,27,9,2,5,2,55,9,21,25
"2011","Lewisham 022B","E01003218","Total",54,8,24,22,9,0,3,6,45,8,21,16
"2011","Lewisham 022C","E01003220","Total",60,21,13,26,2,0,1,1,58,21,12,25
"2011","Lewisham 022D","E01003222","Total",78,25,26,27,5,2,2,1,73,23,24,26
"2011","Lewisham 022E","E01003224","Total",81,22,31,28,8,0,3,5,73,22,28,23
"2011","Lewisham 023A","E01003263","Total",101,34,20,47,3,2,0,1,98,32,20,46
"2011","Lewisham 023B","E01003268","Total",59,17,21,21,5,2,2,1,54,15,19,20
"2011","Lewisham 023C","E01003269","Total",78,17,24,37,5,1,2,2,73,16,22,35
"2011","Lewisham 023D","E01003270","Total",45,11,22,12,4,0,3,1,41,11,19,11
"2011","Lewisham 023E","E01003271","Total",40,17,17,6,3,2,1,0,37,15,16,6
"2011","Lewisham 024A","E01003307","Total",62,24,11,27,5,2,3,0,57,22,8,27
"2011","Lewisham 024B","E01003308","Total",75,18,17,40,6,2,3,1,69,16,14,39
"2011","Lewisham 024C","E01003314","Total",63,15,19,29,4,1,1,2,59,14,18,27
"2011","Lewisham 024D","E01003315","Total",44,11,11,22,6,1,1,4,38,10,10,18
"2011","Lewisham 024E","E01003316","Total",45,15,14,16,3,2,0,1,42,13,14,15
"2011","Lewisham 025A","E01003216","Total",53,19,14,20,5,1,2,2,48,18,12,18
"2011","Lewisham 025B","E01003219","Total",45,10,26,9,4,1,2,1,41,9,24,8
"2011","Lewisham 025C","E01003221","Total",93,30,30,33,19,10,6,3,74,20,24,30
"2011","Lewisham 025D","E01003223","Total",40,10,15,15,1,0,1,0,39,10,14,15
"2011","Lewisham 026A","E01003346","Total",98,23,29,46,5,0,4,1,93,23,25,45
"2011","Lewisham 026B","E01003349","Total",110,34,23,53,7,2,1,4,103,32,22,49
"2011","Lewisham 026C","E01003351","Total",113,34,30,49,2,0,0,2,111,34,30,47
"2011","Lewisham 026D","E01003354","Total",81,19,37,25,5,2,3,0,76,17,34,25
"2011","Lewisham 027A","E01003309","Total",106,26,22,58,7,1,2,4,99,25,20,54
"2011","Lewisham 027B","E01003310","Total",90,20,20,50,3,1,2,0,87,19,18,50
"2011","Lewisham 027C","E01003311","Total",33,9,7,17,1,0,0,1,32,9,7,16
"2011","Lewisham 027D","E01003312","Total",75,22,25,28,3,1,1,1,72,21,24,27
"2011","Lewisham 027E","E01003313","Total",141,37,42,62,22,13,7,2,119,24,35,60
"2011","Lewisham 028A","E01003256","Total",122,39,33,50,6,2,1,3,116,37,32,47
"2011","Lewisham 028B","E01003257","Total",81,24,20,37,8,1,3,4,73,23,17,33
"2011","Lewisham 028C","E01003258","Total",133,32,35,66,15,2,5,8,118,30,30,58
"2011","Lewisham 028D","E01003259","Total",65,13,29,23,8,1,6,1,57,12,23,22
"2011","Lewisham 029A","E01003193","Total",66,18,24,24,3,1,1,1,63,17,23,23
"2011","Lewisham 029B","E01003194","Total",98,30,25,43,5,0,2,3,93,30,23,40
"2011","Lewisham 029C","E01003195","Total",67,13,22,32,7,0,2,5,60,13,20,27
"2011","Lewisham 029D","E01003196","Total",102,31,25,46,6,2,2,2,96,29,23,44
"2011","Lewisham 029E","E01003197","Total",103,29,27,47,4,1,3,0,99,28,24,47
"2011","Lewisham 030A","E01003347","Total",192,41,49,102,9,0,3,6,183,41,46,96
"2011","Lewisham 030B","E01003348","Total",55,18,23,14,5,1,4,0,50,17,19,14
"2011","Lewisham 030C","E01003350","Total",93,26,24,43,12,2,8,2,81,24,16,41
"2011","Lewisham 030D","E01003352","Total",82,30,16,36,4,0,0,4,78,30,16,32
"2011","Lewisham 030E","E01003353","Total",35,7,11,17,1,0,1,0,34,7,10,17
"2011","Lewisham 031A","E01003264","Total",81,24,15,42,5,1,4,0,76,23,11,42
"2011","Lewisham 031B","E01003265","Total",125,27,28,70,6,1,2,3,119,26,26,67
"2011","Lewisham 031C","E01003266","Total",93,22,24,47,2,1,0,1,91,21,24,46
"2011","Lewisham 031D","E01003267","Total",83,18,17,48,7,1,2,4,76,17,15,44
"2011","Lewisham 033A","E01003329","Total",88,28,27,33,2,0,2,0,86,28,25,33
"2011","Lewisham 033B","E01003330","Total",136,31,30,75,10,2,7,1,126,29,23,74
"2011","Lewisham 033C","E01003331","Total",63,16,17,30,4,0,3,1,59,16,14,29
"2011","Lewisham 033D","E01003332","Total",63,14,26,23,4,1,0,3,59,13,26,20
"2011","Lewisham 033E","E01003334","Total",79,21,30,28,1,0,0,1,78,21,30,27
"2011","Lewisham 034A","E01003189","Total",117,23,28,66,6,0,2,4,111,23,26,62
"2011","Lewisham 034B","E01003190","Total",170,52,39,79,13,1,1,11,157,51,38,68
"2011","Lewisham 034C","E01003191","Total",132,36,40,56,18,3,13,2,114,33,27,54
"2011","Lewisham 034D","E01003192","Total",112,33,23,56,7,0,2,5,105,33,21,51
"2011","Lewisham 035A","E01003326","Total",70,18,31,21,6,0,5,1,64,18,26,20
"2011","Lewisham 035B","E01003327","Total",61,14,17,30,5,1,3,1,56,13,14,29
"2011","Lewisham 035C","E01003328","Total",71,19,21,31,4,0,2,2,67,19,19,29
"2011","Lewisham 035D","E01003333","Total",66,21,28,17,1,0,1,0,65,21,27,17
"2011","Lewisham 035E","E01003335","Total",94,36,24,34,12,2,5,5,82,34,19,29
"2011","Lewisham 037A","E01003236","Total",131,26,32,73,11,0,4,7,120,26,28,66
"2011","Lewisham 037B","E01003237","Total",120,29,30,61,4,0,3,1,116,29,27,60
"2011","Lewisham 037C","E01003238","Total",104,28,25,51,6,0,5,1,98,28,20,50
"2011","Lewisham 037D","E01003239","Total",94,26,25,43,8,2,5,1,86,24,20,42
"2011","Lewisham 037E","E01032564","Total",91,24,21,46,4,0,3,1,87,24,18,45
"2011","Lewisham 038A","E01003235","Total",47,11,10,26,1,0,1,0,46,11,9,26
"2011","Lewisham 038B","E01003240","Total",126,40,31,55,7,1,4,2,119,39,27,53
"2011","Lewisham 038C","E01003241","Total",52,18,14,20,7,4,2,1,45,14,12,19
"2011","Lewisham 038D","E01003243","Total",77,23,14,40,4,0,0,4,73,23,14,36
"2011","Lewisham 038E","E01032565","Total",82,20,22,40,6,1,2,3,76,19,20,37
"2011","Lewisham 039A","E01003298","Total",69,17,12,40,2,0,0,2,67,17,12,38
"2011","Lewisham 039B","E01003300","Total",95,30,20,45,9,3,2,4,86,27,18,41
"2011","Lewisham 039C","E01003303","Total",71,10,34,27,28,3,21,4,43,7,13,23
"2011","Lewisham 039D","E01003304","Total",79,24,15,40,6,1,3,2,73,23,12,38
"2011","Lewisham 039E","E01032579","Total",95,31,21,43,9,3,1,5,86,28,20,38
"2011","Newham 001A","E01003543","Total",76,23,26,27,3,2,1,0,73,21,25,27
"2011","Newham 001B","E01003544","Total",75,16,20,39,6,0,4,2,69,16,16,37
"2011","Newham 001C","E01003546","Total",87,22,21,44,4,2,2,0,83,20,19,44
"2011","Newham 001D","E01003550","Total",58,13,15,30,7,1,2,4,51,12,13,26
"2011","Newham 002A","E01003576","Total",95,14,27,54,3,0,2,1,92,14,25,53
"2011","Newham 002B","E01003581","Total",55,13,11,31,2,0,1,1,53,13,10,30
"2011","Newham 002C","E01003582","Total",64,12,9,43,5,0,4,1,59,12,5,42
"2011","Newham 002D","E01003583","Total",59,17,9,33,9,1,2,6,50,16,7,27
"2011","Newham 003A","E01003578","Total",74,29,10,35,2,1,0,1,72,28,10,34
"2011","Newham 003B","E01003584","Total",66,16,20,30,8,1,1,6,58,15,19,24
"2011","Newham 003C","E01003586","Total",42,13,12,17,3,1,2,0,39,12,10,17
"2011","Newham 003D","E01003590","Total",64,17,16,31,0,0,0,0,64,17,16,31
"2011","Newham 004A","E01003579","Total",45,15,8,22,5,2,0,3,40,13,8,19
"2011","Newham 004B","E01003585","Total",27,6,7,14,5,1,4,0,22,5,3,14
"2011","Newham 004C","E01003587","Total",86,26,16,44,4,1,2,1,82,25,14,43
"2011","Newham 004D","E01003591","Total",78,16,15,47,5,2,2,1,73,14,13,46
"2011","Newham 005A","E01003528","Total",49,14,13,22,0,0,0,0,49,14,13,22
"2011","Newham 005B","E01003575","Total",60,18,8,34,9,3,0,6,51,15,8,28
"2011","Newham 005C","E01003577","Total",118,23,23,72,10,0,5,5,108,23,18,67
"2011","Newham 005D","E01003580","Total",85,27,15,43,11,3,4,4,74,24,11,39
"2011","Newham 006A","E01003545","Total",86,29,25,32,3,1,1,1,83,28,24,31
"2011","Newham 006B","E01003548","Total",76,27,20,29,3,0,1,2,73,27,19,27
"2011","Newham 006C","E01003549","Total",72,20,22,30,1,0,1,0,71,20,21,30
"2011","Newham 006D","E01003557","Total",48,15,15,18,5,1,2,2,43,14,13,16
"2011","Newham 007A","E01003547","Total",50,19,13,18,6,1,2,3,44,18,11,15
"2011","Newham 007B","E01003555","Total",23,7,9,7,1,0,1,0,22,7,8,7
"2011","Newham 007C","E01003561","Total",36,13,8,15,2,1,1,0,34,12,7,15
"2011","Newham 007D","E01003567","Total",50,15,7,28,3,2,1,0,47,13,6,28
"2011","Newham 008A","E01003556","Total",56,13,18,25,5,2,2,1,51,11,16,24
"2011","Newham 008B","E01003558","Total",38,11,7,20,5,1,2,2,33,10,5,18
"2011","Newham 008C","E01003570","Total",30,6,5,19,5,0,0,5,25,6,5,14
"2011","Newham 008D","E01003571","Total",37,6,8,23,4,0,2,2,33,6,6,21
"2011","Newham 008E","E01003572","Total",34,12,8,14,1,1,0,0,33,11,8,14
"2011","Newham 009A","E01003551","Total",64,21,15,28,6,0,2,4,58,21,13,24
"2011","Newham 009B","E01003553","Total",99,30,16,53,9,3,5,1,90,27,11,52
"2011","Newham 009C","E01003554","Total",40,12,16,12,1,0,1,0,39,12,15,12
"2011","Newham 009D","E01003559","Total",85,25,24,36,4,1,2,1,81,24,22,35
"2011","Newham 010A","E01003529","Total",37,10,12,15,3,0,3,0,34,10,9,15
"2011","Newham 010B","E01003530","Total",25,9,4,12,1,0,0,1,24,9,4,11
"2011","Newham 010C","E01003531","Total",24,8,6,10,2,0,1,1,22,8,5,9
"2011","Newham 010D","E01003532","Total",19,4,4,11,0,0,0,0,19,4,4,11
"2011","Newham 010E","E01003534","Total",44,10,7,27,5,0,0,5,39,10,7,22
"2011","Newham 011A","E01003533","Total",33,5,7,21,5,0,1,4,28,5,6,17
"2011","Newham 011B","E01003560","Total",30,3,4,23,3,1,0,2,27,2,4,21
"2011","Newham 011C","E01003563","Total",35,11,6,18,4,3,0,1,31,8,6,17
"2011","Newham 011D","E01003588","Total",32,4,7,21,2,1,1,0,30,3,6,21
"2011","Newham 011E","E01003589","Total",29,7,7,15,4,0,1,3,25,7,6,12
"2011","Newham 012A","E01003616","Total",55,14,16,25,3,2,1,0,52,12,15,25
"2011","Newham 012B","E01003617","Total",74,21,29,24,4,2,2,0,70,19,27,24
"2011","Newham 012C","E01003618","Total",51,18,15,18,0,0,0,0,51,18,15,18
"2011","Newham 012D","E01003619","Total",87,19,24,44,3,0,2,1,84,19,22,43
"2011","Newham 013C","E01003615","Total",46,12,7,27,1,0,0,1,45,12,7,26
"2011","Newham 013E","E01033578","Total",56,17,13,26,7,2,2,3,49,15,11,23
"2011","Newham 013F","E01033579","Total",33,10,11,12,1,0,1,0,32,10,10,12
"2011","Newham 013G","E01033583","Total",91,25,25,41,4,0,2,2,87,25,23,39
"2011","Newham 013H","E01033586","Total",56,14,17,25,7,1,3,3,49,13,14,22
"2011","Newham 014A","E01003562","Total",22,3,3,16,0,0,0,0,22,3,3,16
"2011","Newham 014B","E01003564","Total",43,11,13,19,7,1,4,2,36,10,9,17
"2011","Newham 014C","E01003565","Total",23,7,4,12,2,0,2,0,21,7,2,12
"2011","Newham 014D","E01003566","Total",48,10,11,27,4,1,2,1,44,9,9,26
"2011","Newham 015A","E01003625","Total",52,8,13,31,9,3,2,4,43,5,11,27
"2011","Newham 015B","E01003626","Total",29,16,4,9,3,2,1,0,26,14,3,9
"2011","Newham 015C","E01003627","Total",24,5,2,17,1,0,0,1,23,5,2,16
"2011","Newham 015D","E01003628","Total",26,14,5,7,3,2,0,1,23,12,5,6
"2011","Newham 015E","E01003629","Total",26,4,7,15,3,2,0,1,23,2,7,14
"2011","Newham 016A","E01003552","Total",61,13,14,34,5,0,1,4,56,13,13,30
"2011","Newham 016B","E01003596","Total",52,14,11,27,2,1,1,0,50,13,10,27
"2011","Newham 016C","E01003597","Total",27,7,9,11,6,2,3,1,21,5,6,10
"2011","Newham 016D","E01003635","Total",41,11,19,11,1,0,1,0,40,11,18,11
"2011","Newham 017A","E01003568","Total",30,10,4,16,1,0,0,1,29,10,4,15
"2011","Newham 017B","E01003569","Total",31,5,4,22,5,0,2,3,26,5,2,19
"2011","Newham 017C","E01003573","Total",32,7,8,17,2,1,0,1,30,6,8,16
"2011","Newham 017D","E01003574","Total",46,10,7,29,4,0,2,2,42,10,5,27
"2011","Newham 018A","E01003520","Total",39,12,5,22,4,2,1,1,35,10,4,21
"2011","Newham 018B","E01003521","Total",28,8,4,16,2,0,1,1,26,8,3,15
"2011","Newham 018C","E01003522","Total",41,8,9,24,3,0,0,3,38,8,9,21
"2011","Newham 018D","E01003525","Total",21,5,3,13,0,0,0,0,21,5,3,13
"2011","Newham 018E","E01003526","Total",31,7,7,17,2,0,1,1,29,7,6,16
"2011","Newham 019A","E01003488","Total",74,10,16,48,6,1,1,4,68,9,15,44
"2011","Newham 019B","E01003489","Total",68,12,11,45,6,1,1,4,62,11,10,41
"2011","Newham 019C","E01003490","Total",48,14,10,24,7,3,3,1,41,11,7,23
"2011","Newham 019D","E01003524","Total",40,6,9,25,2,0,1,1,38,6,8,24
"2011","Newham 020A","E01003631","Total",62,17,19,26,3,0,1,2,59,17,18,24
"2011","Newham 020B","E01003632","Total",71,11,18,42,4,1,1,2,67,10,17,40
"2011","Newham 020C","E01003633","Total",89,26,18,45,8,3,2,3,81,23,16,42
"2011","Newham 020D","E01003634","Total",86,18,24,44,3,0,3,0,83,18,21,44
"2011","Newham 020E","E01003636","Total",93,21,26,46,3,0,2,1,90,21,24,45
"2011","Newham 021A","E01003598","Total",106,18,30,58,11,0,5,6,95,18,25,52
"2011","Newham 021B","E01003600","Total",80,10,22,48,2,0,1,1,78,10,21,47
"2011","Newham 021C","E01003630","Total",72,26,25,21,2,1,1,0,70,25,24,21
"2011","Newham 021D","E01003637","Total",38,11,8,19,5,2,2,1,33,9,6,18
"2011","Newham 022A","E01003491","Total",34,7,4,23,3,1,1,1,31,6,3,22
"2011","Newham 022B","E01003592","Total",46,14,7,25,1,1,0,0,45,13,7,25
"2011","Newham 022C","E01003599","Total",47,7,5,35,6,0,1,5,41,7,4,30
"2011","Newham 022D","E01003606","Total",60,22,7,31,5,2,2,1,55,20,5,30
"2011","Newham 023A","E01003535","Total",84,18,14,52,10,2,4,4,74,16,10,48
"2011","Newham 023B","E01003536","Total",92,27,28,37,3,1,1,1,89,26,27,36
"2011","Newham 023C","E01003621","Total",32,12,5,15,2,1,0,1,30,11,5,14
"2011","Newham 023D","E01003622","Total",47,10,12,25,5,1,3,1,42,9,9,24
"2011","Newham 023E","E01003623","Total",64,14,11,39,5,0,0,5,59,14,11,34
"2011","Newham 024A","E01003523","Total",45,12,9,24,5,0,1,4,40,12,8,20
"2011","Newham 024B","E01003527","Total",49,15,17,17,3,0,3,0,46,15,14,17
"2011","Newham 024C","E01003537","Total",67,22,15,30,8,1,3,4,59,21,12,26
"2011","Newham 024D","E01003542","Total",105,37,24,44,8,2,5,1,97,35,19,43
"2011","Newham 024E","E01003624","Total",59,10,17,32,1,0,1,0,58,10,16,32
"2011","Newham 025A","E01003492","Total",35,5,8,22,3,0,1,2,32,5,7,20
"2011","Newham 025B","E01003493","Total",34,9,8,17,4,1,1,2,30,8,7,15
"2011","Newham 025C","E01003494","Total",68,17,11,40,5,1,2,2,63,16,9,38
"2011","Newham 025D","E01003495","Total",53,23,12,18,4,4,0,0,49,19,12,18
"2011","Newham 026A","E01003594","Total",64,18,14,32,3,1,1,1,61,17,13,31
"2011","Newham 026B","E01003595","Total",50,11,9,30,5,0,2,3,45,11,7,27
"2011","Newham 026C","E01003602","Total",60,20,16,24,4,1,2,1,56,19,14,23
"2011","Newham 026D","E01003607","Total",97,21,32,44,6,1,4,1,91,20,28,43
"2011","Newham 027A","E01003496","Total",61,17,14,30,2,1,1,0,59,16,13,30
"2011","Newham 027B","E01003498","Total",88,15,25,48,6,1,5,0,82,14,20,48
"2011","Newham 027C","E01003500","Total",109,20,30,59,5,0,2,3,104,20,28,56
"2011","Newham 027D","E01003593","Total",81,24,19,38,6,2,3,1,75,22,16,37
"2011","Newham 028A","E01003601","Total",101,27,18,56,3,0,1,2,98,27,17,54
"2011","Newham 028B","E01003603","Total",88,15,32,41,3,1,2,0,85,14,30,41
"2011","Newham 028C","E01003605","Total",61,12,16,33,5,0,4,1,56,12,12,32
"2011","Newham 028D","E01003608","Total",76,17,23,36,3,1,2,0,73,16,21,36
"2011","Newham 029A","E01003538","Total",76,17,16,43,8,4,1,3,68,13,15,40
"2011","Newham 029B","E01003539","Total",75,19,13,43,5,0,2,3,70,19,11,40
"2011","Newham 029C","E01003540","Total",82,19,31,32,3,0,1,2,79,19,30,30
"2011","Newham 029D","E01003541","Total",67,22,11,34,4,0,1,3,63,22,10,31
"2011","Newham 030A","E01003499","Total",132,31,27,74,16,4,4,8,116,27,23,66
"2011","Newham 030B","E01003501","Total",95,16,31,48,4,0,3,1,91,16,28,47
"2011","Newham 030C","E01003502","Total",78,22,19,37,5,0,1,4,73,22,18,33
"2011","Newham 030D","E01003503","Total",91,25,19,47,5,1,2,2,86,24,17,45
"2011","Newham 031A","E01003507","Total",84,24,22,38,10,0,6,4,74,24,16,34
"2011","Newham 031B","E01003508","Total",81,26,17,38,2,0,1,1,79,26,16,37
"2011","Newham 031C","E01003509","Total",131,37,27,67,7,1,4,2,124,36,23,65
"2011","Newham 031D","E01003604","Total",118,30,28,60,6,0,2,4,112,30,26,56
"2011","Newham 032A","E01003483","Total",90,22,26,42,5,2,2,1,85,20,24,41
"2011","Newham 032B","E01003484","Total",66,23,23,20,4,0,3,1,62,23,20,19
"2011","Newham 032C","E01003516","Total",116,28,28,60,8,3,4,1,108,25,24,59
"2011","Newham 032D","E01003518","Total",45,14,15,16,0,0,0,0,45,14,15,16
"2011","Newham 032E","E01003519","Total",55,21,13,21,5,2,1,2,50,19,12,19
"2011","Newham 033A","E01003480","Total",63,23,15,25,1,0,0,1,62,23,15,24
"2011","Newham 033B","E01003482","Total",120,41,32,47,6,0,4,2,114,41,28,45
"2011","Newham 033C","E01003486","Total",99,30,21,48,2,0,0,2,97,30,21,46
"2011","Newham 033D","E01003487","Total",59,14,14,31,3,0,2,1,56,14,12,30
"2011","Newham 034A","E01003497","Total",90,26,17,47,5,2,0,3,85,24,17,44
"2011","Newham 034D","E01003506","Total",64,18,15,31,5,3,0,2,59,15,15,29
"2011","Newham 034F","E01033574","Total",1,0,0,1,0,0,0,0,1,0,0,1
"2011","Newham 034G","E01033575","Total",6,2,2,2,0,0,0,0,6,2,2,2
"2011","Newham 034H","E01033576","Total",32,12,8,12,5,1,2,2,27,11,6,10
"2011","Newham 034I","E01033584","Total",90,20,18,52,3,0,1,2,87,20,17,50
"2011","Newham 034J","E01033585","Total",98,17,28,53,14,0,4,10,84,17,24,43
"2011","Newham 035A","E01003479","Total",75,25,21,29,3,1,2,0,72,24,19,29
"2011","Newham 035B","E01003481","Total",60,24,12,24,3,0,1,2,57,24,11,22
"2011","Newham 035C","E01003485","Total",71,26,17,28,8,2,2,4,63,24,15,24
"2011","Newham 035D","E01003513","Total",66,13,25,28,3,0,3,0,63,13,22,28
"2011","Newham 036A","E01003511","Total",109,26,27,56,8,0,5,3,101,26,22,53
"2011","Newham 036B","E01003512","Total",102,32,28,42,5,1,4,0,97,31,24,42
"2011","Newham 036C","E01003514","Total",80,18,22,40,7,3,2,2,73,15,20,38
"2011","Newham 036D","E01003515","Total",97,22,26,49,7,2,2,3,90,20,24,46
"2011","Newham 036E","E01003517","Total",98,33,26,39,4,3,1,0,94,30,25,39
"2011","Newham 037A","E01003609","Total",152,29,43,80,10,0,6,4,142,29,37,76
"2011","Newham 037C","E01003611","Total",139,28,37,74,9,2,4,3,130,26,33,71
"2011","Newham 037E","E01033577","Total",54,20,16,18,3,0,1,2,51,20,15,16
"2011","Newham 037F","E01033580","Total",15,1,9,5,3,1,2,0,12,0,7,5
"2011","Newham 037G","E01033581","Total",90,24,27,39,13,5,5,3,77,19,22,36
"2011","Newham 037H","E01033582","Total",34,12,12,10,1,0,0,1,33,12,12,9
"2011","Southwark 001A","E01004029","Total",61,17,20,24,6,0,5,1,55,17,15,23
"2011","Southwark 001B","E01004032","Total",20,7,6,7,3,0,2,1,17,7,4,6
"2011","Southwark 001C","E01004053","Total",31,8,9,14,2,0,1,1,29,8,8,13
"2011","Southwark 001D","E01004054","Total",22,4,12,6,2,0,2,0,20,4,10,6
"2011","Southwark 001E","E01004055","Total",65,19,14,32,4,0,1,3,61,19,13,29
"2011","Southwark 002A","E01003927","Total",70,16,25,29,10,1,8,1,60,15,17,28
"2011","Southwark 002B","E01003929","Total",40,9,6,25,1,0,0,1,39,9,6,24
"2011","Southwark 002C","E01003934","Total",42,10,16,16,0,0,0,0,42,10,16,16
"2011","Southwark 002D","E01003935","Total",35,6,13,16,3,1,1,1,32,5,12,15
"2011","Southwark 002E","E01003939","Total",41,14,4,23,2,1,0,1,39,13,4,22
"2011","Southwark 003A","E01003976","Total",88,16,30,42,8,0,5,3,80,16,25,39
"2011","Southwark 003E","E01004027","Total",78,18,15,45,7,1,0,6,71,17,15,39
"2011","Southwark 003F","E01032637","Total",8,4,3,1,0,0,0,0,8,4,3,1
"2011","Southwark 003G","E01032638","Total",2,0,1,1,1,0,1,0,1,0,0,1
"2011","Southwark 003H","E01032640","Total",1,0,1,0,0,0,0,0,1,0,1,0
"2011","Southwark 003I","E01032646","Total",18,7,1,10,2,2,0,0,16,5,1,10
"2011","Southwark 003J","E01032803","Total",28,8,7,13,1,1,0,0,27,7,7,13
"2011","Southwark 003K","E01032834","Total",6,0,5,1,0,0,0,0,6,0,5,1
"2011","Southwark 004A","E01003975","Total",116,23,26,67,3,0,1,2,113,23,25,65
"2011","Southwark 004B","E01003978","Total",82,21,18,43,7,1,1,5,75,20,17,38
"2011","Southwark 004C","E01004022","Total",118,25,30,63,9,0,4,5,109,25,26,58
"2011","Southwark 004D","E01004023","Total",69,21,12,36,6,1,2,3,63,20,10,33
"2011","Southwark 004E","E01004028","Total",76,25,17,34,4,1,1,2,72,24,16,32
"2011","Southwark 006A","E01003938","Total",73,22,17,34,4,1,1,2,69,21,16,32
"2011","Southwark 006B","E01003940","Total",83,19,26,38,4,1,1,2,79,18,25,36
"2011","Southwark 006C","E01003941","Total",49,13,16,20,2,0,2,0,47,13,14,20
"2011","Southwark 006D","E01003942","Total",76,17,16,43,10,1,3,6,66,16,13,37
"2011","Southwark 006E","E01003979","Total",67,24,23,20,4,1,1,2,63,23,22,18
"2011","Southwark 006F","E01003981","Total",48,15,12,21,3,3,0,0,45,12,12,21
"2011","Southwark 007A","E01004030","Total",53,14,8,31,1,0,0,1,52,14,8,30
"2011","Southwark 007B","E01004031","Total",77,23,20,34,2,1,1,0,75,22,19,34
"2011","Southwark 007C","E01004033","Total",79,24,17,38,3,0,1,2,76,24,16,36
"2011","Southwark 007D","E01004034","Total",103,32,15,56,3,2,0,1,100,30,15,55
"2011","Southwark 007E","E01004036","Total",143,30,38,75,7,0,4,3,136,30,34,72
"2011","Southwark 008A","E01004056","Total",77,26,18,33,2,2,0,0,75,24,18,33
"2011","Southwark 008B","E01004057","Total",70,25,17,28,4,0,2,2,66,25,15,26
"2011","Southwark 008C","E01004058","Total",12,4,5,3,1,0,1,0,11,4,4,3
"2011","Southwark 008D","E01004059","Total",9,2,3,4,0,0,0,0,9,2,3,4
"2011","Southwark 008E","E01004060","Total",95,36,23,36,2,0,1,1,93,36,22,35
"2011","Southwark 009A","E01003936","Total",7,1,3,3,1,0,1,0,6,1,2,3
"2011","Southwark 009B","E01003937","Total",28,6,12,10,3,1,1,1,25,5,11,9
"2011","Southwark 009C","E01003943","Total",77,25,20,32,7,3,3,1,70,22,17,31
"2011","Southwark 009F","E01032720","Total",68,26,14,28,3,0,1,2,65,26,13,26
"2011","Southwark 010A","E01003977","Total",76,18,10,48,5,1,3,1,71,17,7,47
"2011","Southwark 010B","E01004037","Total",98,30,24,44,8,0,2,6,90,30,22,38
"2011","Southwark 010C","E01004038","Total",154,44,43,67,7,1,3,3,147,43,40,64
"2011","Southwark 010D","E01004042","Total",83,22,15,46,4,0,0,4,79,22,15,42
"2011","Southwark 010E","E01004043","Total",40,12,9,19,7,0,2,5,33,12,7,14
"2011","Southwark 011A","E01003986","Total",86,25,22,39,2,0,0,2,84,25,22,37
"2011","Southwark 011B","E01003987","Total",91,25,18,48,9,1,2,6,82,24,16,42
"2011","Southwark 011C","E01004024","Total",100,22,21,57,3,1,0,2,97,21,21,55
"2011","Southwark 011D","E01004035","Total",107,34,15,58,6,1,2,3,101,33,13,55
"2011","Southwark 012A","E01003960","Total",80,25,21,34,8,4,2,2,72,21,19,32
"2011","Southwark 012B","E01003961","Total",97,45,18,34,8,6,1,1,89,39,17,33
"2011","Southwark 012E","E01003994","Total",49,22,5,22,2,2,0,0,47,20,5,22
"2011","Southwark 012F","E01032722","Total",89,20,33,36,4,1,2,1,85,19,31,35
"2011","Southwark 013A","E01003980","Total",70,25,19,26,3,2,1,0,67,23,18,26
"2011","Southwark 013B","E01004039","Total",50,12,8,30,1,0,0,1,49,12,8,29
"2011","Southwark 013C","E01004040","Total",101,32,19,50,8,4,2,2,93,28,17,48
"2011","Southwark 013D","E01004041","Total",79,19,19,41,3,1,0,2,76,18,19,39
"2011","Southwark 013E","E01004044","Total",83,24,21,38,4,1,1,2,79,23,20,36
"2011","Southwark 014A","E01003992","Total",109,33,24,52,4,1,1,2,105,32,23,50
"2011","Southwark 014B","E01003995","Total",87,28,22,37,7,1,4,2,80,27,18,35
"2011","Southwark 014D","E01003998","Total",27,12,2,13,2,0,0,2,25,12,2,11
"2011","Southwark 014E","E01003999","Total",70,21,25,24,2,0,1,1,68,21,24,23
"2011","Southwark 014F","E01032639","Total",51,15,5,31,5,1,2,2,46,14,3,29
"2011","Southwark 014G","E01032719","Total",39,14,8,17,7,0,2,5,32,14,6,12
"2011","Southwark 015A","E01003964","Total",81,25,18,38,12,2,0,10,69,23,18,28
"2011","Southwark 015B","E01003966","Total",103,37,23,43,8,5,2,1,95,32,21,42
"2011","Southwark 015C","E01003968","Total",69,21,17,31,3,0,3,0,66,21,14,31
"2011","Southwark 015D","E01003971","Total",119,48,19,52,8,1,0,7,111,47,19,45
"2011","Southwark 015E","E01003974","Total",65,22,16,27,3,0,3,0,62,22,13,27
"2011","Southwark 016A","E01003963","Total",104,35,18,51,3,0,2,1,101,35,16,50
"2011","Southwark 016B","E01003967","Total",98,30,25,43,5,0,3,2,93,30,22,41
"2011","Southwark 016C","E01003970","Total",82,23,17,42,4,1,3,0,78,22,14,42
"2011","Southwark 016D","E01003972","Total",79,33,15,31,5,2,3,0,74,31,12,31
"2011","Southwark 016E","E01003973","Total",108,37,22,49,7,1,1,5,101,36,21,44
"2011","Southwark 017A","E01003923","Total",58,17,16,25,5,0,2,3,53,17,14,22
"2011","Southwark 017B","E01003969","Total",75,19,23,33,9,3,4,2,66,16,19,31
"2011","Southwark 017C","E01003991","Total",63,20,13,30,3,0,2,1,60,20,11,29
"2011","Southwark 017D","E01003993","Total",105,36,26,43,13,1,4,8,92,35,22,35
"2011","Southwark 017E","E01003997","Total",55,15,14,26,1,0,1,0,54,15,13,26
"2011","Southwark 018A","E01003983","Total",117,33,30,54,9,0,6,3,108,33,24,51
"2011","Southwark 018B","E01003988","Total",99,24,21,54,7,0,4,3,92,24,17,51
"2011","Southwark 018C","E01003989","Total",148,48,38,62,13,3,4,6,135,45,34,56
"2011","Southwark 018D","E01003990","Total",118,25,36,57,12,3,5,4,106,22,31,53
"2011","Southwark 018E","E01004007","Total",84,20,21,43,4,0,2,2,80,20,19,41
"2011","Southwark 019A","E01003912","Total",123,36,28,59,14,2,4,8,109,34,24,51
"2011","Southwark 019B","E01004011","Total",154,44,46,64,16,3,7,6,138,41,39,58
"2011","Southwark 019C","E01004012","Total",151,40,50,61,12,1,7,4,139,39,43,57
"2011","Southwark 019D","E01004013","Total",113,21,32,60,3,1,0,2,110,20,32,58
"2011","Southwark 019E","E01004014","Total",107,27,26,54,14,1,6,7,93,26,20,47
"2011","Southwark 020A","E01003911","Total",111,36,26,49,12,6,4,2,99,30,22,47
"2011","Southwark 020B","E01003916","Total",88,33,33,22,12,4,6,2,76,29,27,20
"2011","Southwark 020C","E01003917","Total",57,17,16,24,2,0,2,0,55,17,14,24
"2011","Southwark 020D","E01003918","Total",88,28,27,33,3,0,2,1,85,28,25,32
"2011","Southwark 020E","E01003925","Total",70,22,18,30,2,1,1,0,68,21,17,30
"2011","Southwark 021A","E01003919","Total",64,18,26,20,4,1,2,1,60,17,24,19
"2011","Southwark 021B","E01003920","Total",121,36,35,50,9,2,4,3,112,34,31,47
"2011","Southwark 021C","E01003921","Total",61,18,26,17,5,0,4,1,56,18,22,16
"2011","Southwark 021D","E01003922","Total",132,49,36,47,17,6,6,5,115,43,30,42
"2011","Southwark 021E","E01003924","Total",105,32,33,40,6,0,2,4,99,32,31,36
"2011","Southwark 021F","E01003926","Total",78,21,23,34,6,1,1,4,72,20,22,30
"2011","Southwark 022B","E01004008","Total",132,31,41,60,13,1,5,7,119,30,36,53
"2011","Southwark 022D","E01004010","Total",88,16,25,47,13,2,6,5,75,14,19,42
"2011","Southwark 022E","E01004067","Total",96,26,14,56,0,0,0,0,96,26,14,56
"2011","Southwark 022F","E01032805","Total",131,35,33,63,13,1,6,6,118,34,27,57
"2011","Southwark 023A","E01003984","Total",63,15,28,20,12,0,12,0,51,15,16,20
"2011","Southwark 023B","E01004003","Total",93,24,33,36,3,0,0,3,90,24,33,33
"2011","Southwark 023C","E01004004","Total",104,35,20,49,4,1,1,2,100,34,19,47
"2011","Southwark 023D","E01004005","Total",134,32,35,67,13,2,2,9,121,30,33,58
"2011","Southwark 023E","E01004006","Total",84,25,21,38,6,1,3,2,78,24,18,36
"2011","Southwark 024A","E01003913","Total",54,21,17,16,7,2,1,4,47,19,16,12
"2011","Southwark 024B","E01003914","Total",47,7,12,28,3,0,0,3,44,7,12,25
"2011","Southwark 024C","E01003915","Total",79,16,30,33,18,4,8,6,61,12,22,27
"2011","Southwark 024D","E01004050","Total",32,5,6,21,1,0,1,0,31,5,5,21
"2011","Southwark 024E","E01004052","Total",35,6,18,11,5,1,2,2,30,5,16,9
"2011","Southwark 025A","E01004061","Total",38,11,14,13,2,1,1,0,36,10,13,13
"2011","Southwark 025B","E01004062","Total",97,26,28,43,7,2,5,0,90,24,23,43
"2011","Southwark 025C","E01004063","Total",60,17,19,24,7,1,4,2,53,16,15,22
"2011","Southwark 025D","E01004065","Total",40,11,11,18,1,0,1,0,39,11,10,18
"2011","Southwark 025E","E01004066","Total",116,34,31,51,8,2,3,3,108,32,28,48
"2011","Southwark 026A","E01004000","Total",72,31,8,33,5,2,1,2,67,29,7,31
"2011","Southwark 026B","E01004001","Total",95,30,21,44,2,0,0,2,93,30,21,42
"2011","Southwark 026C","E01004019","Total",120,27,44,49,10,2,4,4,110,25,40,45
"2011","Southwark 026D","E01004064","Total",106,24,29,53,5,0,2,3,101,24,27,50
"2011","Southwark 026E","E01004068","Total",103,24,26,53,4,0,2,2,99,24,24,51
"2011","Southwark 027A","E01004045","Total",129,39,39,51,8,0,7,1,121,39,32,50
"2011","Southwark 027B","E01004047","Total",107,38,22,47,4,1,2,1,103,37,20,46
"2011","Southwark 027C","E01004048","Total",63,18,18,27,3,0,1,2,60,18,17,25
"2011","Southwark 027D","E01004049","Total",102,38,33,31,7,2,2,3,95,36,31,28
"2011","Southwark 027E","E01004051","Total",29,7,10,12,2,0,1,1,27,7,9,11
"2011","Southwark 028A","E01003953","Total",45,14,11,20,4,2,1,1,41,12,10,19
"2011","Southwark 028B","E01003955","Total",34,10,11,13,1,0,1,0,33,10,10,13
"2011","Southwark 028C","E01004015","Total",44,13,15,16,2,1,1,0,42,12,14,16
"2011","Southwark 028D","E01004021","Total",51,12,16,23,1,1,0,0,50,11,16,23
"2011","Southwark 028E","E01004046","Total",43,14,15,14,3,0,2,1,40,14,13,13
"2011","Southwark 029A","E01004002","Total",54,13,21,20,4,0,2,2,50,13,19,18
"2011","Southwark 029B","E01004016","Total",92,25,23,44,3,0,2,1,89,25,21,43
"2011","Southwark 029C","E01004017","Total",49,10,23,16,7,0,6,1,42,10,17,15
"2011","Southwark 029D","E01004020","Total",127,24,33,70,13,0,5,8,114,24,28,62
"2011","Southwark 030A","E01003952","Total",31,2,17,12,3,0,2,1,28,2,15,11
"2011","Southwark 030B","E01003954","Total",26,11,4,11,0,0,0,0,26,11,4,11
"2011","Southwark 030C","E01003956","Total",37,7,15,15,3,0,2,1,34,7,13,14
"2011","Southwark 030D","E01004071","Total",57,21,18,18,8,1,3,4,49,20,15,14
"2011","Southwark 030E","E01004072","Total",23,8,12,3,2,0,2,0,21,8,10,3
"2011","Southwark 031A","E01004069","Total",18,4,10,4,3,1,2,0,15,3,8,4
"2011","Southwark 031B","E01004070","Total",43,16,12,15,2,1,1,0,41,15,11,15
"2011","Southwark 031C","E01004073","Total",39,11,16,12,4,1,3,0,35,10,13,12
"2011","Southwark 031D","E01004074","Total",21,6,5,10,0,0,0,0,21,6,5,10
"2011","Southwark 031E","E01004075","Total",30,11,11,8,1,0,1,0,29,11,10,8
"2011","Southwark 032A","E01003949","Total",55,12,18,25,6,0,2,4,49,12,16,21
"2011","Southwark 032B","E01003950","Total",114,24,29,61,11,1,2,8,103,23,27,53
"2011","Southwark 032C","E01003957","Total",50,16,16,18,4,1,2,1,46,15,14,17
"2011","Southwark 032D","E01003958","Total",37,14,13,10,1,0,1,0,36,14,12,10
"2011","Southwark 032E","E01004018","Total",42,16,14,12,2,0,1,1,40,16,13,11
"2011","Southwark 033A","E01003945","Total",50,19,15,16,2,0,1,1,48,19,14,15
"2011","Southwark 033B","E01003946","Total",58,8,17,33,2,0,1,1,56,8,16,32
"2011","Southwark 033C","E01003947","Total",138,37,30,71,4,0,1,3,134,37,29,68
"2011","Southwark 033D","E01003948","Total",47,13,10,24,3,3,0,0,44,10,10,24
"2011","Southwark 033E","E01003951","Total",41,10,15,16,4,2,2,0,37,8,13,16
"2011","Southwark 034A","E01003930","Total",22,5,8,9,3,1,1,1,19,4,7,8
"2011","Southwark 034B","E01003932","Total",58,17,18,23,3,0,1,2,55,17,17,21
"2011","Southwark 034C","E01003933","Total",32,5,7,20,2,0,0,2,30,5,7,18
"2011","Southwark 034D","E01032583","Total",41,5,16,20,5,0,3,2,36,5,13,18
"2011","Southwark 034E","E01032584","Total",67,24,24,19,2,0,2,0,65,24,22,19
"2011","Tower Hamlets 001A","E01004222","Total",108,24,13,71,7,0,3,4,101,24,10,67
"2011","Tower Hamlets 001B","E01004223","Total",119,39,22,58,9,0,4,5,110,39,18,53
"2011","Tower Hamlets 001C","E01004224","Total",66,10,15,41,5,2,2,1,61,8,13,40
"2011","Tower Hamlets 001D","E01004226","Total",83,21,12,50,3,0,0,3,80,21,12,47
"2011","Tower Hamlets 002A","E01004197","Total",62,10,13,39,6,0,2,4,56,10,11,35
"2011","Tower Hamlets 002B","E01004198","Total",40,4,8,28,0,0,0,0,40,4,8,28
"2011","Tower Hamlets 002C","E01004199","Total",70,12,7,51,5,0,2,3,65,12,5,48
"2011","Tower Hamlets 002D","E01004201","Total",50,12,16,22,2,0,2,0,48,12,14,22
"2011","Tower Hamlets 003A","E01004228","Total",51,17,8,26,6,2,4,0,45,15,4,26
"2011","Tower Hamlets 003B","E01004230","Total",77,22,16,39,16,4,2,10,61,18,14,29
"2011","Tower Hamlets 003C","E01004232","Total",21,6,5,10,0,0,0,0,21,6,5,10
"2011","Tower Hamlets 003D","E01004233","Total",57,21,3,33,3,3,0,0,54,18,3,33
"2011","Tower Hamlets 003E","E01004234","Total",69,15,20,34,0,0,0,0,69,15,20,34
"2011","Tower Hamlets 004A","E01004225","Total",41,10,5,26,3,2,0,1,38,8,5,25
"2011","Tower Hamlets 004C","E01004229","Total",48,13,6,29,2,0,1,1,46,13,5,28
"2011","Tower Hamlets 004D","E01004231","Total",102,28,14,60,4,0,3,1,98,28,11,59
"2011","Tower Hamlets 004E","E01032764","Total",46,15,5,26,4,0,2,2,42,15,3,24
"2011","Tower Hamlets 004F","E01032765","Total",68,16,12,40,3,0,3,0,65,16,9,40
"2011","Tower Hamlets 004G","E01032784","Total",55,11,12,32,7,0,4,3,48,11,8,29
"2011","Tower Hamlets 005A","E01004200","Total",12,3,3,6,0,0,0,0,12,3,3,6
"2011","Tower Hamlets 005B","E01004202","Total",42,3,4,35,3,0,1,2,39,3,3,33
"2011","Tower Hamlets 005C","E01004203","Total",41,11,5,25,3,2,1,0,38,9,4,25
"2011","Tower Hamlets 005D","E01004204","Total",37,6,5,26,6,2,0,4,31,4,5,22
"2011","Tower Hamlets 006A","E01004311","Total",44,9,7,28,2,0,0,2,42,9,7,26
"2011","Tower Hamlets 006B","E01004314","Total",17,3,6,8,4,1,3,0,13,2,3,8
"2011","Tower Hamlets 006C","E01004315","Total",23,4,7,12,0,0,0,0,23,4,7,12
"2011","Tower Hamlets 006D","E01004318","Total",75,16,15,44,5,0,2,3,70,16,13,41
"2011","Tower Hamlets 007A","E01004259","Total",54,14,11,29,1,1,0,0,53,13,11,29
"2011","Tower Hamlets 007B","E01004260","Total",59,13,6,40,3,1,0,2,56,12,6,38
"2011","Tower Hamlets 007C","E01004263","Total",59,15,12,32,3,0,3,0,56,15,9,32
"2011","Tower Hamlets 007D","E01004266","Total",45,12,10,23,4,0,1,3,41,12,9,20
"2011","Tower Hamlets 008A","E01004235","Total",70,19,16,35,3,0,3,0,67,19,13,35
"2011","Tower Hamlets 008B","E01004236","Total",59,9,6,44,2,0,1,1,57,9,5,43
"2011","Tower Hamlets 008C","E01004237","Total",54,5,7,42,3,0,0,3,51,5,7,39
"2011","Tower Hamlets 008D","E01004238","Total",97,16,14,67,0,0,0,0,97,16,14,67
"2011","Tower Hamlets 008E","E01004239","Total",56,15,10,31,5,1,1,3,51,14,9,28
"2011","Tower Hamlets 009A","E01004312","Total",38,8,3,27,1,0,0,1,37,8,3,26
"2011","Tower Hamlets 009B","E01004313","Total",79,10,12,57,2,0,1,1,77,10,11,56
"2011","Tower Hamlets 009C","E01004316","Total",41,8,7,26,4,0,1,3,37,8,6,23
"2011","Tower Hamlets 009D","E01004317","Total",45,13,6,26,4,1,1,2,41,12,5,24
"2011","Tower Hamlets 010A","E01004261","Total",29,6,3,20,1,0,0,1,28,6,3,19
"2011","Tower Hamlets 010B","E01004262","Total",24,4,2,18,0,0,0,0,24,4,2,18
"2011","Tower Hamlets 010C","E01004264","Total",40,9,2,29,5,1,0,4,35,8,2,25
"2011","Tower Hamlets 010E","E01032785","Total",39,5,4,30,1,0,1,0,38,5,3,30
"2011","Tower Hamlets 010F","E01032786","Total",56,18,10,28,4,1,1,2,52,17,9,26
"2011","Tower Hamlets 011A","E01004207","Total",42,9,8,25,3,0,2,1,39,9,6,24
"2011","Tower Hamlets 011B","E01004209","Total",45,8,5,32,2,1,0,1,43,7,5,31
"2011","Tower Hamlets 011D","E01004212","Total",43,8,2,33,2,0,1,1,41,8,1,32
"2011","Tower Hamlets 011F","E01032787","Total",65,14,12,39,1,0,0,1,64,14,12,38
"2011","Tower Hamlets 012A","E01004240","Total",69,14,12,43,1,0,1,0,68,14,11,43
"2011","Tower Hamlets 012B","E01004241","Total",61,13,11,37,2,1,0,1,59,12,11,36
"2011","Tower Hamlets 012C","E01004242","Total",86,21,9,56,8,3,1,4,78,18,8,52
"2011","Tower Hamlets 012D","E01004267","Total",50,9,2,39,1,0,1,0,49,9,1,39
"2011","Tower Hamlets 012E","E01004268","Total",54,10,6,38,8,1,1,6,46,9,5,32
"2011","Tower Hamlets 013A","E01004205","Total",58,4,5,49,7,0,0,7,51,4,5,42
"2011","Tower Hamlets 013B","E01004206","Total",47,5,5,37,0,0,0,0,47,5,5,37
"2011","Tower Hamlets 013C","E01004208","Total",14,4,3,7,0,0,0,0,14,4,3,7
"2011","Tower Hamlets 013D","E01004211","Total",18,2,2,14,1,0,0,1,17,2,2,13
"2011","Tower Hamlets 014A","E01004269","Total",52,12,9,31,2,0,0,2,50,12,9,29
"2011","Tower Hamlets 014B","E01004270","Total",48,12,10,26,2,0,1,1,46,12,9,25
"2011","Tower Hamlets 014C","E01004271","Total",61,16,12,33,1,0,1,0,60,16,11,33
"2011","Tower Hamlets 014D","E01004272","Total",77,16,10,51,7,1,3,3,70,15,7,48
"2011","Tower Hamlets 014E","E01004273","Total",77,17,12,48,12,2,4,6,65,15,8,42
"2011","Tower Hamlets 015A","E01004306","Total",19,2,2,15,1,0,1,0,18,2,1,15
"2011","Tower Hamlets 015B","E01004307","Total",20,5,4,11,3,0,3,0,17,5,1,11
"2011","Tower Hamlets 015C","E01004308","Total",16,1,2,13,1,0,0,1,15,1,2,12
"2011","Tower Hamlets 015D","E01004309","Total",46,7,2,37,6,0,0,6,40,7,2,31
"2011","Tower Hamlets 015E","E01004310","Total",18,0,4,14,3,0,1,2,15,0,3,12
"2011","Tower Hamlets 016A","E01004283","Total",60,14,11,35,2,1,0,1,58,13,11,34
"2011","Tower Hamlets 016B","E01004287","Total",56,13,6,37,1,0,0,1,55,13,6,36
"2011","Tower Hamlets 016C","E01004289","Total",38,6,8,24,9,0,6,3,29,6,2,21
"2011","Tower Hamlets 016D","E01004290","Total",21,3,1,17,2,0,0,2,19,3,1,15
"2011","Tower Hamlets 017A","E01004322","Total",28,7,4,17,0,0,0,0,28,7,4,17
"2011","Tower Hamlets 017B","E01004323","Total",16,4,4,8,1,0,0,1,15,4,4,7
"2011","Tower Hamlets 017C","E01004324","Total",32,6,5,21,0,0,0,0,32,6,5,21
"2011","Tower Hamlets 017D","E01004326","Total",33,6,3,24,4,0,0,4,29,6,3,20
"2011","Tower Hamlets 018A","E01004245","Total",68,11,5,52,2,0,0,2,66,11,5,50
"2011","Tower Hamlets 018B","E01004246","Total",59,18,8,33,3,1,1,1,56,17,7,32
"2011","Tower Hamlets 018C","E01004248","Total",77,17,11,49,2,0,1,1,75,17,10,48
"2011","Tower Hamlets 018D","E01004249","Total",97,20,12,65,2,0,0,2,95,20,12,63
"2011","Tower Hamlets 019A","E01004284","Total",50,13,8,29,4,1,0,3,46,12,8,26
"2011","Tower Hamlets 019B","E01004285","Total",53,9,8,36,4,1,1,2,49,8,7,34
"2011","Tower Hamlets 019C","E01004286","Total",79,12,10,57,3,0,0,3,76,12,10,54
"2011","Tower Hamlets 019D","E01004288","Total",63,11,13,39,2,2,0,0,61,9,13,39
"2011","Tower Hamlets 020A","E01004243","Total",77,11,12,54,7,0,6,1,70,11,6,53
"2011","Tower Hamlets 020B","E01004244","Total",83,20,14,49,7,2,0,5,76,18,14,44
"2011","Tower Hamlets 020C","E01004247","Total",85,23,9,53,4,0,2,2,81,23,7,51
"2011","Tower Hamlets 020D","E01004250","Total",121,33,15,73,5,1,3,1,116,32,12,72
"2011","Tower Hamlets 021A","E01004319","Total",37,7,2,28,5,0,1,4,32,7,1,24
"2011","Tower Hamlets 021C","E01004321","Total",29,4,2,23,1,0,1,0,28,4,1,23
"2011","Tower Hamlets 021D","E01004325","Total",37,5,9,23,2,0,1,1,35,5,8,22
"2011","Tower Hamlets 021E","E01032766","Total",28,3,2,23,3,0,0,3,25,3,2,20
"2011","Tower Hamlets 021F","E01032767","Total",10,1,2,7,0,0,0,0,10,1,2,7
"2011","Tower Hamlets 022A","E01004298","Total",56,8,4,44,3,1,0,2,53,7,4,42
"2011","Tower Hamlets 022B","E01004300","Total",48,12,8,28,3,0,0,3,45,12,8,25
"2011","Tower Hamlets 022C","E01004304","Total",53,10,11,32,4,2,1,1,49,8,10,31
"2011","Tower Hamlets 022D","E01004305","Total",77,19,4,54,1,0,0,1,76,19,4,53
"2011","Tower Hamlets 023A","E01004251","Total",73,17,11,45,5,1,1,3,68,16,10,42
"2011","Tower Hamlets 023B","E01004254","Total",26,5,7,14,1,0,1,0,25,5,6,14
"2011","Tower Hamlets 023C","E01004255","Total",43,11,5,27,0,0,0,0,43,11,5,27
"2011","Tower Hamlets 023D","E01004258","Total",26,4,5,17,3,0,3,0,23,4,2,17
"2011","Tower Hamlets 024A","E01004252","Total",106,25,9,72,4,1,1,2,102,24,8,70
"2011","Tower Hamlets 024B","E01004253","Total",123,23,21,79,6,4,1,1,117,19,20,78
"2011","Tower Hamlets 024C","E01004256","Total",74,14,15,45,3,0,1,2,71,14,14,43
"2011","Tower Hamlets 024D","E01004257","Total",105,33,15,57,4,0,2,2,101,33,13,55
"2011","Tower Hamlets 025B","E01004301","Total",22,1,1,20,0,0,0,0,22,1,1,20
"2011","Tower Hamlets 025C","E01004302","Total",56,16,8,32,2,0,2,0,54,16,6,32
"2011","Tower Hamlets 025D","E01004303","Total",75,13,16,46,1,0,1,0,74,13,15,46
"2011","Tower Hamlets 025E","E01032768","Total",14,4,4,6,0,0,0,0,14,4,4,6
"2011","Tower Hamlets 025F","E01032769","Total",25,4,10,11,2,0,1,1,23,4,9,10
"2011","Tower Hamlets 026A","E01004292","Total",14,4,2,8,1,1,0,0,13,3,2,8
"2011","Tower Hamlets 026B","E01004294","Total",23,7,8,8,4,0,4,0,19,7,4,8
"2011","Tower Hamlets 026C","E01004295","Total",36,7,3,26,2,1,0,1,34,6,3,25
"2011","Tower Hamlets 026D","E01004296","Total",39,10,8,21,1,1,0,0,38,9,8,21
"2011","Tower Hamlets 027A","E01004291","Total",27,2,9,16,2,0,1,1,25,2,8,15
"2011","Tower Hamlets 027B","E01004293","Total",16,5,9,2,2,0,2,0,14,5,7,2
"2011","Tower Hamlets 027C","E01004297","Total",21,3,10,8,2,0,2,0,19,3,8,8
"2011","Tower Hamlets 028A","E01004215","Total",108,25,19,64,3,0,1,2,105,25,18,62
"2011","Tower Hamlets 028B","E01004219","Total",83,25,9,49,8,1,4,3,75,24,5,46
"2011","Tower Hamlets 028D","E01004221","Total",52,10,9,33,2,0,1,1,50,10,8,32
"2011","Tower Hamlets 028E","E01032776","Total",17,2,4,11,1,0,0,1,16,2,4,10
"2011","Tower Hamlets 028F","E01032777","Total",34,9,8,17,1,0,0,1,33,9,8,16
"2011","Tower Hamlets 028G","E01032778","Total",33,10,4,19,0,0,0,0,33,10,4,19
"2011","Tower Hamlets 028H","E01032779","Total",50,20,3,27,1,0,0,1,49,20,3,26
"2011","Tower Hamlets 028I","E01032780","Total",8,2,2,4,0,0,0,0,8,2,2,4
"2011","Tower Hamlets 030A","E01004214","Total",97,21,15,61,4,0,2,2,93,21,13,59
"2011","Tower Hamlets 030B","E01004216","Total",46,11,7,28,4,2,0,2,42,9,7,26
"2011","Tower Hamlets 030C","E01004217","Total",58,17,11,30,4,0,3,1,54,17,8,29
"2011","Tower Hamlets 030D","E01004218","Total",41,9,10,22,2,1,1,0,39,8,9,22
"2011","Tower Hamlets 031A","E01004274","Total",72,17,16,39,8,0,6,2,64,17,10,37
"2011","Tower Hamlets 031B","E01004275","Total",49,11,10,28,4,0,3,1,45,11,7,27
"2011","Tower Hamlets 031C","E01004276","Total",19,2,5,12,4,1,1,2,15,1,4,10
"2011","Tower Hamlets 031D","E01004281","Total",38,9,5,24,4,1,1,2,34,8,4,22
"2011","Tower Hamlets 031F","E01032775","Total",18,1,3,14,6,1,3,2,12,0,0,12
"2011","Tower Hamlets 031G","E01032783","Total",29,8,6,15,2,0,1,1,27,8,5,14
"2011","Tower Hamlets 032A","E01004280","Total",62,21,9,32,5,0,4,1,57,21,5,31
"2011","Tower Hamlets 032B","E01032770","Total",31,7,5,19,1,0,1,0,30,7,4,19
"2011","Tower Hamlets 032C","E01032772","Total",21,6,4,11,3,0,0,3,18,6,4,8
"2011","Tower Hamlets 032D","E01032773","Total",65,13,9,43,4,1,1,2,61,12,8,41
"2011","Tower Hamlets 032E","E01032774","Total",74,19,11,44,2,2,0,0,72,17,11,44
"2011","Tower Hamlets 033A","E01004277","Total",7,2,2,3,2,1,1,0,5,1,1,3
"2011","Tower Hamlets 033B","E01032771","Total",30,1,5,24,2,0,1,1,28,1,4,23
"2011","Tower Hamlets 033C","E01032781","Total",22,2,13,7,6,0,6,0,16,2,7,7
"2011","Tower Hamlets 033D","E01032782","Total",57,21,2,34,6,5,0,1,51,16,2,33
"2011","Wandsworth 001A","E01004560","Total",42,10,16,16,1,1,0,0,41,9,16,16
"2011","Wandsworth 001B","E01004566","Total",19,5,9,5,1,0,1,0,18,5,8,5
"2011","Wandsworth 001C","E01004582","Total",46,14,15,17,2,0,2,0,44,14,13,17
"2011","Wandsworth 001D","E01004583","Total",55,11,22,22,8,1,5,2,47,10,17,20
"2011","Wandsworth 002B","E01004562","Total",71,22,18,31,4,1,1,2,67,21,17,29
"2011","Wandsworth 002C","E01004563","Total",113,22,26,65,8,1,5,2,105,21,21,63
"2011","Wandsworth 002D","E01004564","Total",38,9,10,19,2,1,1,0,36,8,9,19
"2011","Wandsworth 002E","E01004567","Total",157,43,29,85,4,1,1,2,153,42,28,83
"2011","Wandsworth 002F","E01033098","Total",13,5,1,7,1,0,1,0,12,5,0,7
"2011","Wandsworth 002G","E01033100","Total",41,11,13,17,7,0,2,5,34,11,11,12
"2011","Wandsworth 002H","E01033132","Total",49,15,7,27,4,1,1,2,45,14,6,25
"2011","Wandsworth 003A","E01004539","Total",161,35,40,86,10,2,4,4,151,33,36,82
"2011","Wandsworth 003B","E01004540","Total",84,23,19,42,12,1,1,10,72,22,18,32
"2011","Wandsworth 003C","E01004577","Total",39,7,9,23,6,0,2,4,33,7,7,19
"2011","Wandsworth 003D","E01004584","Total",147,45,39,63,12,0,9,3,135,45,30,60
"2011","Wandsworth 004B","E01004579","Total",49,16,10,23,2,0,1,1,47,16,9,22
"2011","Wandsworth 004C","E01004580","Total",50,12,9,29,1,1,0,0,49,11,9,29
"2011","Wandsworth 004D","E01004581","Total",39,14,10,15,1,1,0,0,38,13,10,15
"2011","Wandsworth 004E","E01033099","Total",43,13,7,23,3,1,0,2,40,12,7,21
"2011","Wandsworth 004F","E01033101","Total",10,3,4,3,2,0,1,1,8,3,3,2
"2011","Wandsworth 004G","E01033133","Total",32,5,9,18,6,0,4,2,26,5,5,16
"2011","Wandsworth 005A","E01004565","Total",55,10,11,34,4,1,1,2,51,9,10,32
"2011","Wandsworth 005B","E01004590","Total",67,19,9,39,3,1,1,1,64,18,8,38
"2011","Wandsworth 005C","E01004591","Total",32,9,9,14,3,1,0,2,29,8,9,12
"2011","Wandsworth 005D","E01004592","Total",72,16,19,37,3,1,1,1,69,15,18,36
"2011","Wandsworth 006A","E01004604","Total",13,5,5,3,1,0,1,0,12,5,4,3
"2011","Wandsworth 006B","E01004605","Total",38,8,15,15,1,0,1,0,37,8,14,15
"2011","Wandsworth 006C","E01004606","Total",13,3,6,4,2,0,2,0,11,3,4,4
"2011","Wandsworth 006D","E01004607","Total",11,1,4,6,0,0,0,0,11,1,4,6
"2011","Wandsworth 006E","E01004608","Total",28,9,6,13,1,0,1,0,27,9,5,13
"2011","Wandsworth 007A","E01004535","Total",160,45,29,86,6,0,0,6,154,45,29,80
"2011","Wandsworth 007B","E01004537","Total",104,29,27,48,5,0,2,3,99,29,25,45
"2011","Wandsworth 007C","E01004538","Total",112,37,22,53,10,2,3,5,102,35,19,48
"2011","Wandsworth 007D","E01004541","Total",79,25,16,38,3,0,0,3,76,25,16,35
"2011","Wandsworth 008A","E01004534","Total",27,7,7,13,0,0,0,0,27,7,7,13
"2011","Wandsworth 008B","E01004536","Total",93,26,21,46,15,3,1,11,78,23,20,35
"2011","Wandsworth 008C","E01004552","Total",9,1,4,4,0,0,0,0,9,1,4,4
"2011","Wandsworth 008D","E01004585","Total",32,12,10,10,3,0,3,0,29,12,7,10
"2011","Wandsworth 008E","E01004588","Total",24,5,6,13,1,0,1,0,23,5,5,13
"2011","Wandsworth 009A","E01004554","Total",18,3,7,8,4,0,4,0,14,3,3,8
"2011","Wandsworth 009B","E01004556","Total",9,6,2,1,0,0,0,0,9,6,2,1
"2011","Wandsworth 009C","E01004586","Total",18,6,4,8,1,0,0,1,17,6,4,7
"2011","Wandsworth 009D","E01004587","Total",16,3,7,6,1,0,1,0,15,3,6,6
"2011","Wandsworth 009E","E01004589","Total",10,5,4,1,0,0,0,0,10,5,4,1
"2011","Wandsworth 010A","E01004509","Total",34,10,3,21,0,0,0,0,34,10,3,21
"2011","Wandsworth 010B","E01004511","Total",20,6,9,5,0,0,0,0,20,6,9,5
"2011","Wandsworth 010C","E01004602","Total",13,4,5,4,0,0,0,0,13,4,5,4
"2011","Wandsworth 010E","E01004609","Total",12,3,5,4,0,0,0,0,12,3,5,4
"2011","Wandsworth 010F","E01033093","Total",13,4,4,5,0,0,0,0,13,4,4,5
"2011","Wandsworth 010G","E01033135","Total",6,1,1,4,0,0,0,0,6,1,1,4
"2011","Wandsworth 011A","E01004506","Total",15,4,2,9,0,0,0,0,15,4,2,9
"2011","Wandsworth 011B","E01004638","Total",14,4,5,5,0,0,0,0,14,4,5,5
"2011","Wandsworth 011C","E01004639","Total",27,8,9,10,5,0,3,2,22,8,6,8
"2011","Wandsworth 011D","E01004640","Total",18,4,4,10,2,0,1,1,16,4,3,9
"2011","Wandsworth 011E","E01004641","Total",41,16,7,18,4,2,0,2,37,14,7,16
"2011","Wandsworth 012A","E01004508","Total",32,7,12,13,1,0,1,0,31,7,11,13
"2011","Wandsworth 012B","E01004510","Total",34,4,19,11,0,0,0,0,34,4,19,11
"2011","Wandsworth 012C","E01004514","Total",20,5,7,8,1,1,0,0,19,4,7,8
"2011","Wandsworth 012D","E01004515","Total",43,17,9,17,2,0,1,1,41,17,8,16
"2011","Wandsworth 012E","E01004551","Total",68,11,28,29,4,0,4,0,64,11,24,29
"2011","Wandsworth 013A","E01004568","Total",91,28,15,48,5,2,1,2,86,26,14,46
"2011","Wandsworth 013B","E01004574","Total",165,36,35,94,13,1,4,8,152,35,31,86
"2011","Wandsworth 013C","E01004575","Total",82,21,11,50,3,2,1,0,79,19,10,50
"2011","Wandsworth 013D","E01004576","Total",56,13,9,34,3,0,1,2,53,13,8,32
"2011","Wandsworth 014A","E01004500","Total",20,4,7,9,2,0,1,1,18,4,6,8
"2011","Wandsworth 014B","E01004501","Total",47,11,8,28,2,1,0,1,45,10,8,27
"2011","Wandsworth 014C","E01004503","Total",24,12,1,11,1,1,0,0,23,11,1,11
"2011","Wandsworth 014D","E01004505","Total",18,5,5,8,1,0,0,1,17,5,5,7
"2011","Wandsworth 014E","E01004507","Total",20,3,4,13,1,0,1,0,19,3,3,13
"2011","Wandsworth 015A","E01004553","Total",24,6,5,13,0,0,0,0,24,6,5,13
"2011","Wandsworth 015B","E01004557","Total",15,6,5,4,1,0,1,0,14,6,4,4
"2011","Wandsworth 015C","E01004558","Total",24,8,8,8,2,1,0,1,22,7,8,7
"2011","Wandsworth 015D","E01004559","Total",22,8,6,8,1,0,1,0,21,8,5,8
"2011","Wandsworth 015E","E01004619","Total",16,6,5,5,1,0,1,0,15,6,4,5
"2011","Wandsworth 016A","E01004572","Total",69,22,10,37,6,0,3,3,63,22,7,34
"2011","Wandsworth 016B","E01004642","Total",63,23,10,30,4,0,3,1,59,23,7,29
"2011","Wandsworth 016C","E01004643","Total",83,28,14,41,5,0,2,3,78,28,12,38
"2011","Wandsworth 016D","E01004644","Total",57,14,15,28,4,0,1,3,53,14,14,25
"2011","Wandsworth 016E","E01004645","Total",121,29,21,71,6,0,0,6,115,29,21,65
"2011","Wandsworth 017A","E01004477","Total",16,5,6,5,2,0,1,1,14,5,5,4
"2011","Wandsworth 017B","E01004478","Total",7,3,2,2,1,0,1,0,6,3,1,2
"2011","Wandsworth 017C","E01004479","Total",21,7,4,10,1,0,0,1,20,7,4,9
"2011","Wandsworth 017D","E01004550","Total",63,13,11,39,4,0,3,1,59,13,8,38
"2011","Wandsworth 017E","E01004555","Total",17,3,7,7,3,0,3,0,14,3,4,7
"2011","Wandsworth 018A","E01004494","Total",49,14,5,30,0,0,0,0,49,14,5,30
"2011","Wandsworth 018B","E01004513","Total",64,21,17,26,3,0,2,1,61,21,15,25
"2011","Wandsworth 018C","E01004600","Total",141,33,33,75,7,1,1,5,134,32,32,70
"2011","Wandsworth 018D","E01004601","Total",58,11,19,28,5,1,4,0,53,10,15,28
"2011","Wandsworth 019A","E01004493","Total",31,5,9,17,0,0,0,0,31,5,9,17
"2011","Wandsworth 019B","E01004512","Total",25,8,3,14,1,0,1,0,24,8,2,14
"2011","Wandsworth 019C","E01004620","Total",33,8,18,7,1,0,1,0,32,8,17,7
"2011","Wandsworth 019D","E01004621","Total",17,6,6,5,4,4,0,0,13,2,6,5
"2011","Wandsworth 019E","E01004623","Total",23,8,5,10,1,0,1,0,22,8,4,10
"2011","Wandsworth 019F","E01004627","Total",22,5,4,13,5,2,1,2,17,3,3,11
"2011","Wandsworth 020A","E01004499","Total",32,7,11,14,0,0,0,0,32,7,11,14
"2011","Wandsworth 020B","E01004502","Total",9,3,3,3,1,0,0,1,8,3,3,2
"2011","Wandsworth 020C","E01004504","Total",5,4,0,1,0,0,0,0,5,4,0,1
"2011","Wandsworth 020D","E01004594","Total",18,7,6,5,1,0,0,1,17,7,6,4
"2011","Wandsworth 020E","E01004596","Total",20,6,11,3,0,0,0,0,20,6,11,3
"2011","Wandsworth 020F","E01004629","Total",33,9,10,14,4,0,2,2,29,9,8,12
"2011","Wandsworth 021A","E01004472","Total",19,6,8,5,0,0,0,0,19,6,8,5
"2011","Wandsworth 021B","E01004474","Total",25,13,3,9,2,0,1,1,23,13,2,8
"2011","Wandsworth 021C","E01004476","Total",21,6,5,10,3,1,2,0,18,5,3,10
"2011","Wandsworth 021D","E01004542","Total",18,4,8,6,0,0,0,0,18,4,8,6
"2011","Wandsworth 021E","E01004544","Total",26,5,10,11,2,0,1,1,24,5,9,10
"2011","Wandsworth 022A","E01004628","Total",63,24,14,25,2,0,1,1,61,24,13,24
"2011","Wandsworth 022B","E01004630","Total",104,28,17,59,2,0,2,0,102,28,15,59
"2011","Wandsworth 022C","E01004631","Total",55,12,18,25,3,0,1,2,52,12,17,23
"2011","Wandsworth 022D","E01004633","Total",108,35,24,49,9,5,3,1,99,30,21,48
"2011","Wandsworth 023A","E01004569","Total",82,26,17,39,8,0,4,4,74,26,13,35
"2011","Wandsworth 023B","E01004570","Total",96,35,15,46,2,0,0,2,94,35,15,44
"2011","Wandsworth 023C","E01004571","Total",71,22,13,36,5,1,2,2,66,21,11,34
"2011","Wandsworth 023D","E01004573","Total",46,11,14,21,2,0,2,0,44,11,12,21
"2011","Wandsworth 024A","E01004495","Total",54,17,6,31,3,0,0,3,51,17,6,28
"2011","Wandsworth 024B","E01004496","Total",21,6,6,9,2,1,0,1,19,5,6,8
"2011","Wandsworth 024C","E01004497","Total",31,5,14,12,1,0,1,0,30,5,13,12
"2011","Wandsworth 024D","E01004622","Total",31,8,8,15,1,0,0,1,30,8,8,14
"2011","Wandsworth 024E","E01004624","Total",38,13,10,15,2,0,2,0,36,13,8,15
"2011","Wandsworth 025A","E01004593","Total",31,9,15,7,4,2,2,0,27,7,13,7
"2011","Wandsworth 025B","E01004595","Total",30,7,11,12,2,0,0,2,28,7,11,10
"2011","Wandsworth 025C","E01004597","Total",39,5,14,20,2,0,2,0,37,5,12,20
"2011","Wandsworth 025D","E01004598","Total",19,2,10,7,1,0,1,0,18,2,9,7
"2011","Wandsworth 025E","E01004599","Total",14,5,4,5,1,1,0,0,13,4,4,5
"2011","Wandsworth 026A","E01004473","Total",23,8,7,8,1,1,0,0,22,7,7,8
"2011","Wandsworth 026B","E01004475","Total",21,5,6,10,0,0,0,0,21,5,6,10
"2011","Wandsworth 026C","E01004480","Total",17,2,9,6,4,0,4,0,13,2,5,6
"2011","Wandsworth 026D","E01004483","Total",55,6,22,27,2,0,0,2,53,6,22,25
"2011","Wandsworth 026E","E01004484","Total",33,6,9,18,2,0,2,0,31,6,7,18
"2011","Wandsworth 026F","E01004486","Total",28,7,7,14,0,0,0,0,28,7,7,14
"2011","Wandsworth 027A","E01004543","Total",32,13,7,12,2,0,1,1,30,13,6,11
"2011","Wandsworth 027B","E01004545","Total",13,5,4,4,2,2,0,0,11,3,4,4
"2011","Wandsworth 027C","E01004546","Total",23,8,9,6,1,1,0,0,22,7,9,6
"2011","Wandsworth 027D","E01004549","Total",17,6,6,5,1,0,1,0,16,6,5,5
"2011","Wandsworth 027E","E01004625","Total",6,2,3,1,0,0,0,0,6,2,3,1
"2011","Wandsworth 027F","E01004626","Total",18,6,6,6,1,0,1,0,17,6,5,6
"2011","Wandsworth 028A","E01004632","Total",29,6,11,12,2,0,2,0,27,6,9,12
"2011","Wandsworth 028B","E01004634","Total",41,6,14,21,6,0,6,0,35,6,8,21
"2011","Wandsworth 028C","E01004635","Total",37,7,10,20,4,0,2,2,33,7,8,18
"2011","Wandsworth 028D","E01004636","Total",51,20,10,21,4,3,1,0,47,17,9,21
"2011","Wandsworth 028E","E01004637","Total",31,7,11,13,8,2,4,2,23,5,7,11
"2011","Wandsworth 029A","E01004481","Total",36,11,11,14,2,0,1,1,34,11,10,13
"2011","Wandsworth 029B","E01004488","Total",32,5,11,16,1,0,1,0,31,5,10,16
"2011","Wandsworth 029C","E01004547","Total",23,6,9,8,0,0,0,0,23,6,9,8
"2011","Wandsworth 029D","E01004548","Total",45,14,10,21,3,1,2,0,42,13,8,21
"2011","Wandsworth 030A","E01004482","Total",41,7,5,29,1,1,0,0,40,6,5,29
"2011","Wandsworth 030B","E01004485","Total",24,5,8,11,2,0,1,1,22,5,7,10
"2011","Wandsworth 030C","E01004487","Total",35,10,11,14,4,0,3,1,31,10,8,13
"2011","Wandsworth 030D","E01004489","Total",31,10,9,12,3,1,1,1,28,9,8,11
"2011","Wandsworth 031A","E01004490","Total",10,3,4,3,0,0,0,0,10,3,4,3
"2011","Wandsworth 031B","E01004491","Total",56,12,22,22,0,0,0,0,56,12,22,22
"2011","Wandsworth 031C","E01004492","Total",42,18,12,12,2,1,1,0,40,17,11,12
"2011","Wandsworth 031D","E01004498","Total",16,4,3,9,1,1,0,0,15,3,3,9
"2011","Wandsworth 032A","E01004532","Total",40,9,6,25,1,0,1,0,39,9,5,25
"2011","Wandsworth 032B","E01004611","Total",36,11,5,20,5,1,1,3,31,10,4,17
"2011","Wandsworth 032C","E01004612","Total",37,11,5,21,3,0,2,1,34,11,3,20
"2011","Wandsworth 032D","E01004618","Total",14,3,4,7,0,0,0,0,14,3,4,7
"2011","Wandsworth 033A","E01004531","Total",74,22,15,37,3,2,0,1,71,20,15,36
"2011","Wandsworth 033B","E01004533","Total",89,26,20,43,5,1,1,3,84,25,19,40
"2011","Wandsworth 033C","E01004610","Total",28,6,6,16,2,0,2,0,26,6,4,16
"2011","Wandsworth 033D","E01004613","Total",70,18,9,43,0,0,0,0,70,18,9,43
"2011","Wandsworth 034A","E01004614","Total",54,13,9,32,5,1,1,3,49,12,8,29
"2011","Wandsworth 034B","E01004615","Total",132,37,23,72,18,2,12,4,114,35,11,68
"2011","Wandsworth 034C","E01004616","Total",47,18,3,26,0,0,0,0,47,18,3,26
"2011","Wandsworth 034D","E01004617","Total",39,9,9,21,3,1,0,2,36,8,9,19
"2011","Wandsworth 035A","E01004525","Total",42,9,8,25,4,0,3,1,38,9,5,24
"2011","Wandsworth 035B","E01004526","Total",34,11,6,17,2,0,1,1,32,11,5,16
"2011","Wandsworth 035C","E01004527","Total",34,13,5,16,3,1,1,1,31,12,4,15
"2011","Wandsworth 035D","E01004528","Total",88,31,17,40,9,2,3,4,79,29,14,36
"2011","Wandsworth 035E","E01004529","Total",64,17,5,42,4,1,0,3,60,16,5,39
"2011","Wandsworth 035F","E01004530","Total",37,13,4,20,10,4,1,5,27,9,3,15
"2011","Wandsworth 036A","E01004516","Total",28,8,8,12,2,0,0,2,26,8,8,10
"2011","Wandsworth 036B","E01004518","Total",55,25,15,15,5,3,1,1,50,22,14,14
"2011","Wandsworth 036C","E01004519","Total",58,14,19,25,5,1,4,0,53,13,15,25
"2011","Wandsworth 036D","E01004520","Total",51,14,17,20,6,0,4,2,45,14,13,18
"2011","Wandsworth 036E","E01004523","Total",40,10,11,19,3,0,2,1,37,10,9,18
"2011","Wandsworth 037A","E01004517","Total",71,25,16,30,11,3,6,2,60,22,10,28
"2011","Wandsworth 037B","E01004521","Total",76,19,22,35,13,3,2,8,63,16,20,27
"2011","Wandsworth 037C","E01004522","Total",72,25,14,33,6,2,1,3,66,23,13,30
"2011","Wandsworth 037D","E01004524","Total",90,22,12,56,4,0,0,4,86,22,12,52
"2011","Westminster 001A","E01004647","Total",24,4,8,12,1,0,0,1,23,4,8,11
"2011","Westminster 001B","E01004649","Total",28,9,4,15,4,3,1,0,24,6,3,15
"2011","Westminster 001C","E01004724","Total",37,9,11,17,4,0,3,1,33,9,8,16
"2011","Westminster 001D","E01004730","Total",32,8,8,16,4,1,2,1,28,7,6,15
"2011","Westminster 002A","E01004646","Total",40,2,8,30,7,1,5,1,33,1,3,29
"2011","Westminster 002B","E01004648","Total",48,10,10,28,7,1,4,2,41,9,6,26
"2011","Westminster 002C","E01004650","Total",21,6,3,12,3,1,0,2,18,5,3,10
"2011","Westminster 002D","E01004710","Total",90,23,11,56,6,0,3,3,84,23,8,53
"2011","Westminster 002E","E01004711","Total",112,36,14,62,3,1,1,1,109,35,13,61
"2011","Westminster 003A","E01004651","Total",26,6,8,12,9,3,3,3,17,3,5,9
"2011","Westminster 003B","E01004725","Total",64,10,13,41,9,3,4,2,55,7,9,39
"2011","Westminster 003C","E01004726","Total",30,8,6,16,3,2,1,0,27,6,5,16
"2011","Westminster 003D","E01004728","Total",32,9,5,18,4,0,2,2,28,9,3,16
"2011","Westminster 003E","E01004729","Total",49,11,12,26,6,1,2,3,43,10,10,23
"2011","Westminster 004A","E01004718","Total",115,26,25,64,7,0,4,3,108,26,21,61
"2011","Westminster 004B","E01004719","Total",104,28,21,55,1,0,1,0,103,28,20,55
"2011","Westminster 004C","E01004720","Total",88,23,17,48,8,1,1,6,80,22,16,42
"2011","Westminster 004D","E01004721","Total",98,25,20,53,8,2,3,3,90,23,17,50
"2011","Westminster 004E","E01004722","Total",136,30,20,86,4,0,1,3,132,30,19,83
"2011","Westminster 005A","E01004674","Total",101,21,26,54,9,1,6,2,92,20,20,52
"2011","Westminster 005B","E01004675","Total",117,28,13,76,8,3,0,5,109,25,13,71
"2011","Westminster 005C","E01004677","Total",63,9,17,37,3,1,1,1,60,8,16,36
"2011","Westminster 005D","E01004678","Total",82,24,11,47,4,0,1,3,78,24,10,44
"2011","Westminster 005E","E01004679","Total",139,42,29,68,9,1,0,8,130,41,29,60
"2011","Westminster 005F","E01004723","Total",112,30,17,65,7,1,1,5,105,29,16,60
"2011","Westminster 006A","E01004676","Total",81,19,11,51,7,2,1,4,74,17,10,47
"2011","Westminster 006B","E01004706","Total",38,6,13,19,3,1,2,0,35,5,11,19
"2011","Westminster 006C","E01004707","Total",32,6,6,20,3,0,1,2,29,6,5,18
"2011","Westminster 006D","E01004708","Total",48,10,15,23,3,0,1,2,45,10,14,21
"2011","Westminster 006E","E01004756","Total",68,14,15,39,2,1,1,0,66,13,14,39
"2011","Westminster 007A","E01004701","Total",13,7,2,4,0,0,0,0,13,7,2,4
"2011","Westminster 007B","E01004703","Total",33,7,2,24,2,1,0,1,31,6,2,23
"2011","Westminster 007D","E01004705","Total",21,4,10,7,1,0,1,0,20,4,9,7
"2011","Westminster 007E","E01004709","Total",63,16,9,38,3,1,1,1,60,15,8,37
"2011","Westminster 007F","E01033600","Total",17,5,7,5,1,0,1,0,16,5,6,5
"2011","Westminster 007G","E01033608","Total",24,8,7,9,4,0,2,2,20,8,5,7
"2011","Westminster 008A","E01004659","Total",17,6,3,8,3,1,2,0,14,5,1,8
"2011","Westminster 008B","E01004660","Total",24,2,6,16,1,0,1,0,23,2,5,16
"2011","Westminster 008C","E01004712","Total",16,3,3,10,1,0,0,1,15,3,3,9
"2011","Westminster 008D","E01004727","Total",25,6,5,14,2,1,0,1,23,5,5,13
"2011","Westminster 009A","E01004670","Total",145,19,18,108,5,0,2,3,140,19,16,105
"2011","Westminster 009E","E01004702","Total",138,24,22,92,13,4,4,5,125,20,18,87
"2011","Westminster 009F","E01033598","Total",61,11,7,43,3,0,1,2,58,11,6,41
"2011","Westminster 009G","E01033601","Total",62,12,9,41,5,0,0,5,57,12,9,36
"2011","Westminster 009H","E01033602","Total",112,27,12,73,7,0,1,6,105,27,11,67
"2011","Westminster 009I","E01033603","Total",59,22,7,30,3,1,0,2,56,21,7,28
"2011","Westminster 009J","E01033604","Total",48,8,6,34,4,0,0,4,44,8,6,30
"2011","Westminster 009K","E01033605","Total",98,23,9,66,7,2,3,2,91,21,6,64
"2011","Westminster 010A","E01004754","Total",87,26,8,53,9,0,3,6,78,26,5,47
"2011","Westminster 010B","E01004755","Total",113,31,19,63,5,3,0,2,108,28,19,61
"2011","Westminster 010C","E01004757","Total",89,19,11,59,9,3,2,4,80,16,9,55
"2011","Westminster 010F","E01032512","Total",155,35,20,100,9,3,1,5,146,32,19,95
"2011","Westminster 010G","E01032513","Total",66,15,8,43,4,2,0,2,62,13,8,41
"2011","Westminster 011A","E01004713","Total",10,1,7,2,3,0,3,0,7,1,4,2
"2011","Westminster 011B","E01004714","Total",28,7,6,15,1,0,1,0,27,7,5,15
"2011","Westminster 011C","E01004716","Total",8,4,3,1,1,0,1,0,7,4,2,1
"2011","Westminster 011D","E01004717","Total",17,2,9,6,6,0,5,1,11,2,4,5
"2011","Westminster 011E","E01004762","Total",29,10,6,13,3,2,0,1,26,8,6,12
"2011","Westminster 012A","E01004657","Total",11,2,2,7,0,0,0,0,11,2,2,7
"2011","Westminster 012B","E01004658","Total",39,13,3,23,5,1,0,4,34,12,3,19
"2011","Westminster 012C","E01004661","Total",45,8,10,27,7,0,1,6,38,8,9,21
"2011","Westminster 012D","E01004662","Total",18,5,3,10,1,1,0,0,17,4,3,10
"2011","Westminster 012E","E01004663","Total",32,10,8,14,1,0,1,0,31,10,7,14
"2011","Westminster 013A","E01004715","Total",20,1,8,11,0,0,0,0,20,1,8,11
"2011","Westminster 013B","E01004763","Total",9,3,2,4,2,1,1,0,7,2,1,4
"2011","Westminster 013D","E01004765","Total",38,9,8,21,4,0,0,4,34,9,8,17
"2011","Westminster 013E","E01033595","Total",16,4,3,9,2,0,1,1,14,4,2,8
"2011","Westminster 013F","E01033596","Total",27,4,5,18,0,0,0,0,27,4,5,18
"2011","Westminster 014A","E01004653","Total",26,7,7,12,3,0,0,3,23,7,7,9
"2011","Westminster 014B","E01004654","Total",37,9,9,19,6,1,2,3,31,8,7,16
"2011","Westminster 014D","E01004656","Total",36,7,7,22,3,0,1,2,33,7,6,20
"2011","Westminster 014E","E01004760","Total",67,16,15,36,6,0,0,6,61,16,15,30
"2011","Westminster 014F","E01033606","Total",21,3,4,14,3,0,1,2,18,3,3,12
"2011","Westminster 014G","E01033607","Total",20,4,7,9,2,0,1,1,18,4,6,8
"2011","Westminster 015A","E01004680","Total",20,7,1,12,0,0,0,0,20,7,1,12
"2011","Westminster 015B","E01004683","Total",14,1,4,9,0,0,0,0,14,1,4,9
"2011","Westminster 015C","E01004684","Total",44,12,1,31,6,1,0,5,38,11,1,26
"2011","Westminster 015E","E01004686","Total",40,14,3,23,11,5,1,5,29,9,2,18
"2011","Westminster 015F","E01033593","Total",61,17,3,41,6,4,1,1,55,13,2,40
"2011","Westminster 015G","E01033594","Total",38,6,5,27,6,1,3,2,32,5,2,25
"2011","Westminster 016A","E01004681","Total",37,7,7,23,3,0,1,2,34,7,6,21
"2011","Westminster 016B","E01004682","Total",13,4,3,6,1,0,1,0,12,4,2,6
"2011","Westminster 016C","E01004694","Total",20,5,8,7,3,0,1,2,17,5,7,5
"2011","Westminster 016D","E01004697","Total",26,7,4,15,2,1,0,1,24,6,4,14
"2011","Westminster 016E","E01004700","Total",33,7,6,20,2,0,2,0,31,7,4,20
"2011","Westminster 017A","E01004652","Total",27,6,4,17,6,1,3,2,21,5,1,15
"2011","Westminster 017B","E01004693","Total",6,2,3,1,0,0,0,0,6,2,3,1
"2011","Westminster 017C","E01004695","Total",18,4,5,9,0,0,0,0,18,4,5,9
"2011","Westminster 017D","E01004696","Total",70,15,11,44,5,1,1,3,65,14,10,41
"2011","Westminster 017E","E01004698","Total",34,13,7,14,8,2,3,3,26,11,4,11
"2011","Westminster 017F","E01004699","Total",40,12,4,24,1,1,0,0,39,11,4,24
"2011","Westminster 018A","E01004734","Total",31,8,6,17,4,0,2,2,27,8,4,15
"2011","Westminster 018B","E01004735","Total",21,8,6,7,3,0,3,0,18,8,3,7
"2011","Westminster 018C","E01004736","Total",5,0,4,1,2,0,2,0,3,0,2,1
"2011","Westminster 018D","E01004761","Total",22,2,10,10,6,1,5,0,16,1,5,10
"2011","Westminster 019A","E01004687","Total",17,4,7,6,2,0,2,0,15,4,5,6
"2011","Westminster 019B","E01004688","Total",14,5,7,2,3,1,2,0,11,4,5,2
"2011","Westminster 019C","E01004689","Total",10,1,2,7,0,0,0,0,10,1,2,7
"2011","Westminster 019D","E01004690","Total",28,6,7,15,6,2,3,1,22,4,4,14
"2011","Westminster 019E","E01004691","Total",23,8,3,12,1,0,0,1,22,8,3,11
"2011","Westminster 019F","E01004692","Total",18,1,3,14,2,0,1,1,16,1,2,13
"2011","Westminster 020A","E01004731","Total",18,5,3,10,1,1,0,0,17,4,3,10
"2011","Westminster 020B","E01004732","Total",57,18,14,25,9,1,4,4,48,17,10,21
"2011","Westminster 020C","E01004733","Total",30,11,7,12,1,0,1,0,29,11,6,12
"2011","Westminster 020D","E01004744","Total",34,3,14,17,5,0,3,2,29,3,11,15
"2011","Westminster 020E","E01004748","Total",23,4,8,11,0,0,0,0,23,4,8,11
"2011","Westminster 021A","E01004740","Total",37,7,5,25,2,0,0,2,35,7,5,23
"2011","Westminster 021B","E01004743","Total",55,11,10,34,3,1,1,1,52,10,9,33
"2011","Westminster 021C","E01004745","Total",56,12,20,24,3,0,2,1,53,12,18,23
"2011","Westminster 021D","E01004746","Total",59,12,12,35,6,0,1,5,53,12,11,30
"2011","Westminster 021E","E01004747","Total",67,15,13,39,0,0,0,0,67,15,13,39
"2011","Westminster 022A","E01004742","Total",15,4,6,5,6,1,4,1,9,3,2,4
"2011","Westminster 022B","E01004749","Total",55,14,12,29,4,1,1,2,51,13,11,27
"2011","Westminster 022C","E01004751","Total",23,5,8,10,1,1,0,0,22,4,8,10
"2011","Westminster 022D","E01004752","Total",29,10,8,11,1,0,1,0,28,10,7,11
"2011","Westminster 022E","E01004753","Total",22,5,5,12,1,0,1,0,21,5,4,12
"2011","Westminster 023B","E01004666","Total",28,7,6,15,2,0,1,1,26,7,5,14
"2011","Westminster 023C","E01004667","Total",48,13,11,24,4,2,1,1,44,11,10,23
"2011","Westminster 023D","E01004668","Total",51,16,5,30,2,0,2,0,49,16,3,30
"2011","Westminster 023E","E01004750","Total",35,10,5,20,1,0,1,0,34,10,4,20
"2011","Westminster 023F","E01033597","Total",29,8,4,17,5,0,1,4,24,8,3,13
"2011","Westminster 023G","E01033599","Total",127,25,13,89,5,1,1,3,122,24,12,86
"2011","Westminster 024A","E01004665","Total",74,15,9,50,7,0,2,5,67,15,7,45
"2011","Westminster 024B","E01004669","Total",69,15,11,43,1,1,0,0,68,14,11,43
"2011","Westminster 024C","E01004737","Total",51,8,20,23,6,0,3,3,45,8,17,20
"2011","Westminster 024D","E01004738","Total",15,3,4,8,1,1,0,0,14,2,4,8
"2011","Westminster 024E","E01004739","Total",8,2,3,3,0,0,0,0,8,2,3,3
"2011","Westminster 024F","E01004741","Total",42,14,11,17,1,0,0,1,41,14,11,16
"2011","Barking and Dagenham 001A","E01000027","Total",115,31,21,63,4,0,4,0,111,31,17,63
"2011","Barking and Dagenham 001B","E01000028","Total",115,29,23,63,9,1,5,3,106,28,18,60
"2011","Barking and Dagenham 001C","E01000029","Total",45,9,17,19,7,1,3,3,38,8,14,16
"2011","Barking and Dagenham 001D","E01000030","Total",170,34,32,104,9,2,4,3,161,32,28,101
"2011","Barking and Dagenham 002A","E01000031","Total",51,4,20,27,4,0,1,3,47,4,19,24
"2011","Barking and Dagenham 002B","E01000032","Total",67,20,12,35,8,0,4,4,59,20,8,31
"2011","Barking and Dagenham 002C","E01000110","Total",48,17,15,16,5,1,2,2,43,16,13,14
"2011","Barking and Dagenham 002D","E01000111","Total",89,25,18,46,6,0,3,3,83,25,15,43
"2011","Barking and Dagenham 002E","E01000112","Total",88,22,25,41,4,2,1,1,84,20,24,40
"2011","Barking and Dagenham 002F","E01000113","Total",65,17,14,34,3,1,1,1,62,16,13,33
"2011","Barking and Dagenham 003A","E01000034","Total",71,19,19,33,6,0,3,3,65,19,16,30
"2011","Barking and Dagenham 003B","E01000037","Total",28,6,12,10,7,0,6,1,21,6,6,9
"2011","Barking and Dagenham 003C","E01000038","Total",41,12,12,17,4,0,2,2,37,12,10,15
"2011","Barking and Dagenham 003D","E01000039","Total",66,27,12,27,6,1,2,3,60,26,10,24
"2011","Barking and Dagenham 004A","E01000063","Total",97,22,17,58,5,1,3,1,92,21,14,57
"2011","Barking and Dagenham 004B","E01000100","Total",90,20,24,46,6,0,5,1,84,20,19,45
"2011","Barking and Dagenham 004C","E01000101","Total",71,14,17,40,5,0,1,4,66,14,16,36
"2011","Barking and Dagenham 004D","E01000109","Total",78,19,19,40,7,0,4,3,71,19,15,37
"2011","Barking and Dagenham 004E","E01000114","Total",106,23,36,47,10,1,7,2,96,22,29,45
"2011","Barking and Dagenham 006A","E01000033","Total",78,15,16,47,7,2,3,2,71,13,13,45
"2011","Barking and Dagenham 006B","E01000060","Total",112,25,26,61,6,0,4,2,106,25,22,59
"2011","Barking and Dagenham 006C","E01000061","Total",195,33,42,120,17,1,9,7,178,32,33,113
"2011","Barking and Dagenham 006D","E01000062","Total",104,23,26,55,5,1,2,2,99,22,24,53
"2011","Barking and Dagenham 006E","E01000064","Total",113,31,20,62,8,4,3,1,105,27,17,61
"2011","Barking and Dagenham 007A","E01000065","Total",90,26,26,38,18,1,7,10,72,25,19,28
"2011","Barking and Dagenham 007B","E01000078","Total",113,12,16,85,5,0,1,4,108,12,15,81
"2011","Barking and Dagenham 007C","E01000080","Total",94,30,16,48,4,3,1,0,90,27,15,48
"2011","Barking and Dagenham 007D","E01000081","Total",96,25,18,53,7,3,2,2,89,22,16,51
"2011","Barking and Dagenham 007E","E01000082","Total",85,25,17,43,6,0,4,2,79,25,13,41
"2011","Barking and Dagenham 007F","E01000083","Total",100,25,20,55,13,2,2,9,87,23,18,46
"2011","Barking and Dagenham 007G","E01000102","Total",92,26,20,46,1,0,1,0,91,26,19,46
"2011","Barking and Dagenham 008A","E01000021","Total",87,20,22,45,6,0,2,4,81,20,20,41
"2011","Barking and Dagenham 008B","E01000022","Total",79,21,16,42,5,2,2,1,74,19,14,41
"2011","Barking and Dagenham 008C","E01000023","Total",55,16,14,25,9,3,2,4,46,13,12,21
"2011","Barking and Dagenham 008D","E01000024","Total",73,24,13,36,5,2,1,2,68,22,12,34
"2011","Barking and Dagenham 008E","E01000025","Total",107,28,24,55,7,1,4,2,100,27,20,53
"2011","Barking and Dagenham 008F","E01000077","Total",89,22,20,47,11,5,2,4,78,17,18,43
"2011","Barking and Dagenham 009A","E01000015","Total",187,39,30,118,13,2,4,7,174,37,26,111
"2011","Barking and Dagenham 009B","E01000016","Total",86,22,13,51,5,0,2,3,81,22,11,48
"2011","Barking and Dagenham 009C","E01000017","Total",74,19,12,43,5,0,3,2,69,19,9,41
"2011","Barking and Dagenham 009D","E01000018","Total",100,22,13,65,5,1,1,3,95,21,12,62
"2011","Barking and Dagenham 009E","E01000079","Total",72,18,11,43,5,0,1,4,67,18,10,39
"2011","Barking and Dagenham 010A","E01000035","Total",71,13,20,38,5,0,3,2,66,13,17,36
"2011","Barking and Dagenham 010B","E01000036","Total",29,9,5,15,2,0,1,1,27,9,4,14
"2011","Barking and Dagenham 010C","E01000107","Total",75,21,17,37,12,2,4,6,63,19,13,31
"2011","Barking and Dagenham 010D","E01000108","Total",88,26,25,37,7,2,1,4,81,24,24,33
"2011","Barking and Dagenham 011A","E01000066","Total",59,17,14,28,2,0,1,1,57,17,13,27
"2011","Barking and Dagenham 011B","E01000067","Total",58,15,16,27,3,0,2,1,55,15,14,26
"2011","Barking and Dagenham 011C","E01000069","Total",29,10,10,9,3,2,0,1,26,8,10,8
"2011","Barking and Dagenham 011D","E01000070","Total",25,2,11,12,0,0,0,0,25,2,11,12
"2011","Barking and Dagenham 011E","E01000071","Total",63,18,14,31,4,3,1,0,59,15,13,31
"2011","Barking and Dagenham 012A","E01000057","Total",102,25,21,56,2,1,0,1,100,24,21,55
"2011","Barking and Dagenham 012B","E01000073","Total",90,26,22,42,4,1,2,1,86,25,20,41
"2011","Barking and Dagenham 012C","E01000074","Total",102,35,13,54,7,2,1,4,95,33,12,50
"2011","Barking and Dagenham 012D","E01000075","Total",60,18,9,33,3,0,1,2,57,18,8,31
"2011","Barking and Dagenham 012E","E01000076","Total",108,25,25,58,9,0,4,5,99,25,21,53
"2011","Barking and Dagenham 013A","E01000013","Total",94,24,14,56,6,2,2,2,88,22,12,54
"2011","Barking and Dagenham 013B","E01000014","Total",82,18,17,47,5,0,3,2,77,18,14,45
"2011","Barking and Dagenham 013C","E01000059","Total",99,14,22,63,9,1,4,4,90,13,18,59
"2011","Barking and Dagenham 013D","E01000084","Total",74,18,15,41,4,0,3,1,70,18,12,40
"2011","Barking and Dagenham 013E","E01000085","Total",93,29,16,48,11,1,3,7,82,28,13,41
"2011","Barking and Dagenham 013F","E01000086","Total",68,12,16,40,5,1,0,4,63,11,16,36
"2011","Barking and Dagenham 014A","E01000103","Total",113,18,25,70,7,0,4,3,106,18,21,67
"2011","Barking and Dagenham 014B","E01000104","Total",124,29,27,68,13,2,5,6,111,27,22,62
"2011","Barking and Dagenham 014C","E01000105","Total",140,48,24,68,12,3,4,5,128,45,20,63
"2011","Barking and Dagenham 014D","E01000106","Total",148,30,28,90,14,1,6,7,134,29,22,83
"2011","Barking and Dagenham 015A","E01000007","Total",63,19,11,33,8,1,2,5,55,18,9,28
"2011","Barking and Dagenham 015B","E01000008","Total",92,25,16,51,9,2,4,3,83,23,12,48
"2011","Barking and Dagenham 015C","E01000010","Total",109,22,24,63,10,1,6,3,99,21,18,60
"2011","Barking and Dagenham 015D","E01000012","Total",127,37,21,69,8,0,3,5,119,37,18,64
"2011","Barking and Dagenham 016A","E01000006","Total",33,12,4,17,6,3,0,3,27,9,4,14
"2011","Barking and Dagenham 016B","E01000009","Total",43,11,7,25,8,3,1,4,35,8,6,21
"2011","Barking and Dagenham 016C","E01000011","Total",32,4,10,18,7,2,2,3,25,2,8,15
"2011","Barking and Dagenham 016D","E01000044","Total",63,21,17,25,8,2,2,4,55,19,15,21
"2011","Barking and Dagenham 016E","E01000068","Total",22,7,8,7,2,0,1,1,20,7,7,6
"2011","Barking and Dagenham 017A","E01000041","Total",81,20,18,43,6,0,3,3,75,20,15,40
"2011","Barking and Dagenham 017B","E01000042","Total",117,11,27,79,7,0,2,5,110,11,25,74
"2011","Barking and Dagenham 017C","E01000045","Total",106,29,18,59,7,0,5,2,99,29,13,57
"2011","Barking and Dagenham 017D","E01000046","Total",109,41,17,51,10,1,5,4,99,40,12,47
"2011","Barking and Dagenham 017E","E01000072","Total",145,34,23,88,6,0,1,5,139,34,22,83
"2011","Barking and Dagenham 018A","E01000054","Total",81,26,12,43,4,0,2,2,77,26,10,41
"2011","Barking and Dagenham 018B","E01000055","Total",79,11,19,49,4,1,2,1,75,10,17,48
"2011","Barking and Dagenham 018C","E01000056","Total",103,26,23,54,9,1,3,5,94,25,20,49
"2011","Barking and Dagenham 018D","E01000058","Total",110,31,17,62,2,0,1,1,108,31,16,61
"2011","Barking and Dagenham 018E","E01000095","Total",79,18,25,36,7,0,6,1,72,18,19,35
"2011","Barking and Dagenham 019A","E01000040","Total",97,26,24,47,7,0,3,4,90,26,21,43
"2011","Barking and Dagenham 019B","E01000043","Total",37,10,11,16,3,2,1,0,34,8,10,16
"2011","Barking and Dagenham 019C","E01000050","Total",79,22,18,39,7,2,4,1,72,20,14,38
"2011","Barking and Dagenham 019D","E01000052","Total",101,26,25,50,4,0,2,2,97,26,23,48
"2011","Barking and Dagenham 019E","E01000092","Total",129,26,31,72,10,0,2,8,119,26,29,64
"2011","Barking and Dagenham 020A","E01000053","Total",80,18,14,48,7,3,1,3,73,15,13,45
"2011","Barking and Dagenham 020B","E01000087","Total",76,22,17,37,7,2,0,5,69,20,17,32
"2011","Barking and Dagenham 020C","E01000088","Total",88,23,22,43,12,0,8,4,76,23,14,39
"2011","Barking and Dagenham 020D","E01000089","Total",110,32,23,55,5,1,2,2,105,31,21,53
"2011","Barking and Dagenham 020E","E01000090","Total",87,25,21,41,9,1,6,2,78,24,15,39
"2011","Barking and Dagenham 021B","E01000048","Total",147,42,17,88,17,4,2,11,130,38,15,77
"2011","Barking and Dagenham 021C","E01000049","Total",137,28,19,90,35,1,2,32,102,27,17,58
"2011","Barking and Dagenham 021D","E01000051","Total",162,32,21,109,21,0,6,15,141,32,15,94
"2011","Barking and Dagenham 021E","E01033587","Total",113,25,31,57,8,0,6,2,105,25,25,55
"2011","Barking and Dagenham 021F","E01033588","Total",139,28,42,69,16,3,7,6,123,25,35,63
"2011","Barking and Dagenham 022A","E01000091","Total",113,17,26,70,13,2,6,5,100,15,20,65
"2011","Barking and Dagenham 022B","E01000093","Total",99,24,21,54,7,3,2,2,92,21,19,52
"2011","Barking and Dagenham 022C","E01000094","Total",97,22,23,52,5,0,2,3,92,22,21,49
"2011","Barking and Dagenham 022D","E01000096","Total",158,34,21,103,11,1,4,6,147,33,17,97
"2011","Barking and Dagenham 023A","E01000019","Total",83,26,12,45,6,0,1,5,77,26,11,40
"2011","Barking and Dagenham 023B","E01000020","Total",90,24,22,44,7,1,3,3,83,23,19,41
"2011","Barking and Dagenham 023C","E01000097","Total",90,25,21,44,5,0,3,2,85,25,18,42
"2011","Barking and Dagenham 023D","E01000098","Total",106,31,27,48,6,1,3,2,100,30,24,46
"2011","Barking and Dagenham 023E","E01000099","Total",89,29,16,44,3,1,1,1,86,28,15,43
"2011","Barking and Dagenham 023F","E01032580","Total",88,26,13,49,5,0,3,2,83,26,10,47
"2011","Barnet 001A","E01000248","Total",32,14,13,5,2,1,1,0,30,13,12,5
"2011","Barnet 001B","E01000249","Total",22,8,8,6,4,1,3,0,18,7,5,6
"2011","Barnet 001C","E01000250","Total",58,16,24,18,8,3,5,0,50,13,19,18
"2011","Barnet 001D","E01000254","Total",28,11,8,9,2,2,0,0,26,9,8,9
"2011","Barnet 001E","E01000292","Total",34,9,14,11,6,2,3,1,28,7,11,10
"2011","Barnet 001F","E01000293","Total",28,9,9,10,1,0,1,0,27,9,8,10
"2011","Barnet 002A","E01000167","Total",63,18,15,30,1,0,1,0,62,18,14,30
"2011","Barnet 002B","E01000246","Total",25,7,7,11,2,1,1,0,23,6,6,11
"2011","Barnet 002C","E01000247","Total",52,11,25,16,3,0,1,2,49,11,24,14
"2011","Barnet 002D","E01000251","Total",65,13,16,36,5,0,4,1,60,13,12,35
"2011","Barnet 002E","E01000252","Total",50,12,11,27,3,0,3,0,47,12,8,27
"2011","Barnet 003A","E01000166","Total",46,17,13,16,0,0,0,0,46,17,13,16
"2011","Barnet 003B","E01000168","Total",16,5,8,3,2,0,1,1,14,5,7,2
"2011","Barnet 003C","E01000169","Total",40,14,15,11,3,2,1,0,37,12,14,11
"2011","Barnet 003D","E01000172","Total",20,7,8,5,0,0,0,0,20,7,8,5
"2011","Barnet 004A","E01000285","Total",48,10,11,27,2,0,0,2,46,10,11,25
"2011","Barnet 004B","E01000287","Total",80,19,21,40,4,0,1,3,76,19,20,37
"2011","Barnet 004C","E01000288","Total",37,15,12,10,3,0,3,0,34,15,9,10
"2011","Barnet 004D","E01000289","Total",118,45,16,57,4,0,1,3,114,45,15,54
"2011","Barnet 004E","E01000291","Total",107,38,19,50,4,1,1,2,103,37,18,48
"2011","Barnet 004F","E01000294","Total",38,8,11,19,3,0,2,1,35,8,9,18
"2011","Barnet 005A","E01000267","Total",22,5,1,16,0,0,0,0,22,5,1,16
"2011","Barnet 005B","E01000268","Total",95,20,15,60,4,0,2,2,91,20,13,58
"2011","Barnet 005C","E01000269","Total",34,8,14,12,3,1,2,0,31,7,12,12
"2011","Barnet 005D","E01000270","Total",33,8,11,14,3,0,1,2,30,8,10,12
"2011","Barnet 006A","E01000170","Total",63,13,19,31,6,1,1,4,57,12,18,27
"2011","Barnet 006B","E01000171","Total",121,25,30,66,6,1,2,3,115,24,28,63
"2011","Barnet 006C","E01000173","Total",37,15,9,13,5,2,3,0,32,13,6,13
"2011","Barnet 006D","E01000174","Total",73,27,16,30,6,1,3,2,67,26,13,28
"2011","Barnet 006E","E01000175","Total",26,6,8,12,3,0,3,0,23,6,5,12
"2011","Barnet 007A","E01000228","Total",36,10,12,14,4,0,3,1,32,10,9,13
"2011","Barnet 007B","E01000253","Total",22,9,5,8,2,0,2,0,20,9,3,8
"2011","Barnet 007C","E01000279","Total",16,3,8,5,4,0,4,0,12,3,4,5
"2011","Barnet 007D","E01000280","Total",12,3,2,7,1,0,0,1,11,3,2,6
"2011","Barnet 007E","E01000286","Total",83,18,22,43,5,1,2,2,78,17,20,41
"2011","Barnet 007F","E01000290","Total",46,12,13,21,2,0,1,1,44,12,12,20
"2011","Barnet 008A","E01000271","Total",12,4,2,6,1,0,1,0,11,4,1,6
"2011","Barnet 008B","E01000272","Total",6,2,3,1,2,1,1,0,4,1,2,1
"2011","Barnet 008C","E01000273","Total",36,11,10,15,6,0,4,2,30,11,6,13
"2011","Barnet 008D","E01000281","Total",47,10,9,28,5,2,1,2,42,8,8,26
"2011","Barnet 008E","E01000282","Total",20,5,8,7,1,0,1,0,19,5,7,7
"2011","Barnet 009A","E01000115","Total",21,13,4,4,2,2,0,0,19,11,4,4
"2011","Barnet 009B","E01000116","Total",28,9,10,9,1,0,1,0,27,9,9,9
"2011","Barnet 009C","E01000119","Total",29,8,7,14,4,1,2,1,25,7,5,13
"2011","Barnet 009D","E01000120","Total",23,2,17,4,7,0,5,2,16,2,12,2
"2011","Barnet 009E","E01000122","Total",23,6,10,7,7,3,4,0,16,3,6,7
"2011","Barnet 010A","E01000117","Total",42,12,9,21,3,1,1,1,39,11,8,20
"2011","Barnet 010B","E01000118","Total",47,12,14,21,3,0,3,0,44,12,11,21
"2011","Barnet 010C","E01000121","Total",94,22,16,56,6,0,2,4,88,22,14,52
"2011","Barnet 010D","E01000123","Total",54,17,18,19,9,0,5,4,45,17,13,15
"2011","Barnet 010E","E01000124","Total",68,27,9,32,0,0,0,0,68,27,9,32
"2011","Barnet 011A","E01000265","Total",89,30,15,44,9,2,4,3,80,28,11,41
"2011","Barnet 011B","E01000266","Total",23,10,6,7,2,0,1,1,21,10,5,6
"2011","Barnet 011C","E01000274","Total",84,28,20,36,3,0,2,1,81,28,18,35
"2011","Barnet 011D","E01000320","Total",31,3,15,13,6,0,4,2,25,3,11,11
"2011","Barnet 011E","E01000322","Total",81,24,27,30,3,1,1,1,78,23,26,29
"2011","Barnet 012A","E01000275","Total",26,5,8,13,2,0,2,0,24,5,6,13
"2011","Barnet 012B","E01000277","Total",34,7,8,19,2,0,1,1,32,7,7,18
"2011","Barnet 012C","E01000283","Total",7,2,3,2,2,1,1,0,5,1,2,2
"2011","Barnet 012D","E01000284","Total",67,13,22,32,12,1,7,4,55,12,15,28
"2011","Barnet 012E","E01000321","Total",35,13,8,14,1,1,0,0,34,12,8,14
"2011","Barnet 013A","E01000195","Total",104,30,22,52,10,3,4,3,94,27,18,49
"2011","Barnet 013B","E01000229","Total",71,18,22,31,6,0,5,1,65,18,17,30
"2011","Barnet 013C","E01000230","Total",29,7,10,12,3,0,2,1,26,7,8,11
"2011","Barnet 013D","E01000231","Total",70,26,17,27,3,1,1,1,67,25,16,26
"2011","Barnet 013E","E01000232","Total",26,8,8,10,3,1,1,1,23,7,7,9
"2011","Barnet 013F","E01000233","Total",51,21,12,18,4,1,3,0,47,20,9,18
"2011","Barnet 014A","E01000186","Total",16,8,4,4,0,0,0,0,16,8,4,4
"2011","Barnet 014B","E01000187","Total",46,13,7,26,2,1,1,0,44,12,6,26
"2011","Barnet 014C","E01000188","Total",19,3,7,9,3,0,1,2,16,3,6,7
"2011","Barnet 014D","E01000189","Total",169,56,41,72,12,4,4,4,157,52,37,68
"2011","Barnet 014E","E01000190","Total",30,6,9,15,0,0,0,0,30,6,9,15
"2011","Barnet 014F","E01000191","Total",14,1,8,5,1,0,0,1,13,1,8,4
"2011","Barnet 015A","E01000158","Total",65,20,15,30,6,2,0,4,59,18,15,26
"2011","Barnet 015B","E01000159","Total",58,15,8,35,4,1,3,0,54,14,5,35
"2011","Barnet 015C","E01000160","Total",69,20,17,32,6,0,3,3,63,20,14,29
"2011","Barnet 015D","E01000161","Total",47,12,18,17,7,1,6,0,40,11,12,17
"2011","Barnet 015E","E01000162","Total",41,8,10,23,3,0,3,0,38,8,7,23
"2011","Barnet 015F","E01000324","Total",43,17,14,12,4,2,2,0,39,15,12,12
"2011","Barnet 016A","E01000256","Total",40,13,14,13,3,2,1,0,37,11,13,13
"2011","Barnet 016B","E01000258","Total",49,15,17,17,2,0,2,0,47,15,15,17
"2011","Barnet 016C","E01000263","Total",10,3,3,4,1,0,1,0,9,3,2,4
"2011","Barnet 016D","E01000264","Total",52,23,8,21,3,2,0,1,49,21,8,20
"2011","Barnet 017A","E01000255","Total",43,12,16,15,6,2,3,1,37,10,13,14
"2011","Barnet 017B","E01000257","Total",121,32,23,66,5,0,3,2,116,32,20,64
"2011","Barnet 017C","E01000261","Total",19,9,8,2,2,1,1,0,17,8,7,2
"2011","Barnet 017D","E01000262","Total",73,16,13,44,4,0,2,2,69,16,11,42
"2011","Barnet 018A","E01000192","Total",33,10,9,14,2,0,2,0,31,10,7,14
"2011","Barnet 018B","E01000193","Total",35,15,7,13,4,0,3,1,31,15,4,12
"2011","Barnet 018C","E01000194","Total",52,13,12,27,8,3,0,5,44,10,12,22
"2011","Barnet 018D","E01000226","Total",86,24,19,43,5,1,2,2,81,23,17,41
"2011","Barnet 018E","E01000227","Total",45,9,25,11,4,0,2,2,41,9,23,9
"2011","Barnet 019A","E01000299","Total",42,15,12,15,3,0,3,0,39,15,9,15
"2011","Barnet 019B","E01000300","Total",24,9,6,9,0,0,0,0,24,9,6,9
"2011","Barnet 019C","E01000302","Total",42,13,8,21,4,1,1,2,38,12,7,19
"2011","Barnet 019D","E01000317","Total",38,15,10,13,3,2,0,1,35,13,10,12
"2011","Barnet 019E","E01000318","Total",38,7,13,18,4,0,2,2,34,7,11,16
"2011","Barnet 019F","E01000323","Total",43,15,6,22,2,1,1,0,41,14,5,22
"2011","Barnet 020A","E01000276","Total",10,3,5,2,1,0,1,0,9,3,4,2
"2011","Barnet 020B","E01000278","Total",12,3,6,3,1,0,1,0,11,3,5,3
"2011","Barnet 020C","E01000301","Total",18,5,5,8,2,2,0,0,16,3,5,8
"2011","Barnet 020D","E01000303","Total",22,5,11,6,4,0,2,2,18,5,9,4
"2011","Barnet 020E","E01000304","Total",43,14,14,15,3,0,1,2,40,14,13,13
"2011","Barnet 021A","E01000130","Total",89,22,17,50,4,1,2,1,85,21,15,49
"2011","Barnet 021B","E01000132","Total",92,28,26,38,2,1,1,0,90,27,25,38
"2011","Barnet 021C","E01000133","Total",85,15,26,44,2,2,0,0,83,13,26,44
"2011","Barnet 021D","E01000234","Total",45,15,10,20,2,0,1,1,43,15,9,19
"2011","Barnet 021E","E01000235","Total",91,31,21,39,7,3,4,0,84,28,17,39
"2011","Barnet 022A","E01000156","Total",60,19,21,20,7,2,4,1,53,17,17,19
"2011","Barnet 022B","E01000157","Total",67,11,16,40,3,0,2,1,64,11,14,39
"2011","Barnet 022C","E01000163","Total",102,21,31,50,6,1,3,2,96,20,28,48
"2011","Barnet 022D","E01000164","Total",91,25,15,51,4,0,1,3,87,25,14,48
"2011","Barnet 022E","E01000165","Total",53,17,12,24,3,0,1,2,50,17,11,22
"2011","Barnet 022F","E01000315","Total",116,36,27,53,13,2,8,3,103,34,19,50
"2011","Barnet 023A","E01000197","Total",37,14,8,15,6,3,2,1,31,11,6,14
"2011","Barnet 023B","E01000295","Total",20,8,6,6,2,0,1,1,18,8,5,5
"2011","Barnet 023C","E01000296","Total",49,11,17,21,5,1,2,2,44,10,15,19
"2011","Barnet 023D","E01000298","Total",40,14,5,21,3,2,0,1,37,12,5,20
"2011","Barnet 024A","E01000125","Total",134,38,24,72,4,2,1,1,130,36,23,71
"2011","Barnet 024B","E01000127","Total",77,18,21,38,2,0,2,0,75,18,19,38
"2011","Barnet 024C","E01000128","Total",95,19,29,47,9,0,6,3,86,19,23,44
"2011","Barnet 024D","E01000129","Total",88,28,14,46,3,1,0,2,85,27,14,44
"2011","Barnet 024E","E01000131","Total",48,18,13,17,1,0,0,1,47,18,13,16
"2011","Barnet 024F","E01000134","Total",80,28,17,35,5,0,4,1,75,28,13,34
"2011","Barnet 025A","E01000198","Total",31,9,7,15,3,2,1,0,28,7,6,15
"2011","Barnet 025B","E01000199","Total",17,6,4,7,1,0,0,1,16,6,4,6
"2011","Barnet 025C","E01000204","Total",23,7,9,7,2,1,1,0,21,6,8,7
"2011","Barnet 025D","E01000259","Total",68,19,12,37,5,1,2,2,63,18,10,35
"2011","Barnet 025E","E01000260","Total",70,22,14,34,4,2,0,2,66,20,14,32
"2011","Barnet 026A","E01000126","Total",120,40,31,49,8,1,3,4,112,39,28,45
"2011","Barnet 026B","E01000151","Total",118,36,19,63,5,2,1,2,113,34,18,61
"2011","Barnet 026C","E01000152","Total",153,53,27,73,11,4,4,3,142,49,23,70
"2011","Barnet 026D","E01000153","Total",101,30,21,50,6,1,0,5,95,29,21,45
"2011","Barnet 026E","E01000154","Total",73,28,12,33,9,3,1,5,64,25,11,28
"2011","Barnet 027A","E01000176","Total",70,23,18,29,4,1,1,2,66,22,17,27
"2011","Barnet 027B","E01000178","Total",29,8,10,11,3,0,3,0,26,8,7,11
"2011","Barnet 027C","E01000184","Total",64,8,17,39,5,0,2,3,59,8,15,36
"2011","Barnet 027D","E01000297","Total",24,11,5,8,0,0,0,0,24,11,5,8
"2011","Barnet 027E","E01000316","Total",96,25,21,50,6,1,3,2,90,24,18,48
"2011","Barnet 027F","E01000319","Total",29,7,11,11,2,0,1,1,27,7,10,10
"2011","Barnet 028A","E01000196","Total",45,15,10,20,3,0,2,1,42,15,8,19
"2011","Barnet 028B","E01000200","Total",33,10,12,11,1,0,1,0,32,10,11,11
"2011","Barnet 028C","E01000201","Total",10,6,3,1,2,0,2,0,8,6,1,1
"2011","Barnet 028D","E01000202","Total",21,7,6,8,4,0,2,2,17,7,4,6
"2011","Barnet 028E","E01000203","Total",60,18,13,29,3,1,0,2,57,17,13,27
"2011","Barnet 029A","E01000177","Total",25,11,6,8,2,0,2,0,23,11,4,8
"2011","Barnet 029B","E01000179","Total",30,9,8,13,2,0,1,1,28,9,7,12
"2011","Barnet 029C","E01000180","Total",47,11,13,23,2,0,1,1,45,11,12,22
"2011","Barnet 029D","E01000181","Total",26,8,8,10,2,0,2,0,24,8,6,10
"2011","Barnet 029E","E01000182","Total",21,10,6,5,1,0,1,0,20,10,5,5
"2011","Barnet 029F","E01000185","Total",82,17,16,49,6,0,2,4,76,17,14,45
"2011","Barnet 030A","E01000147","Total",14,1,7,6,3,0,1,2,11,1,6,4
"2011","Barnet 030B","E01000148","Total",62,13,11,38,7,0,4,3,55,13,7,35
"2011","Barnet 030D","E01000155","Total",63,16,13,34,2,0,2,0,61,16,11,34
"2011","Barnet 030E","E01033572","Total",33,7,10,16,1,0,1,0,32,7,9,16
"2011","Barnet 030F","E01033573","Total",55,20,12,23,4,1,1,2,51,19,11,21
"2011","Barnet 031A","E01000239","Total",49,13,9,27,4,1,1,2,45,12,8,25
"2011","Barnet 031B","E01000240","Total",39,17,8,14,5,0,4,1,34,17,4,13
"2011","Barnet 031C","E01000241","Total",26,8,5,13,1,0,0,1,25,8,5,12
"2011","Barnet 031D","E01000309","Total",30,8,8,14,2,1,1,0,28,7,7,14
"2011","Barnet 032A","E01000237","Total",23,10,6,7,5,2,1,2,18,8,5,5
"2011","Barnet 032B","E01000242","Total",30,11,6,13,2,0,0,2,28,11,6,11
"2011","Barnet 032C","E01000243","Total",34,16,10,8,3,1,1,1,31,15,9,7
"2011","Barnet 032D","E01000244","Total",26,11,5,10,3,1,1,1,23,10,4,9
"2011","Barnet 032E","E01000245","Total",80,27,19,34,8,5,1,2,72,22,18,32
"2011","Barnet 032F","E01000314","Total",21,5,7,9,2,0,1,1,19,5,6,8
"2011","Barnet 033A","E01000183","Total",20,5,8,7,2,0,2,0,18,5,6,7
"2011","Barnet 033B","E01000206","Total",19,8,2,9,1,1,0,0,18,7,2,9
"2011","Barnet 033C","E01000207","Total",27,2,9,16,2,0,1,1,25,2,8,15
"2011","Barnet 033D","E01000208","Total",17,7,5,5,0,0,0,0,17,7,5,5
"2011","Barnet 033E","E01000210","Total",39,11,12,16,3,0,3,0,36,11,9,16
"2011","Barnet 033F","E01000213","Total",18,6,7,5,2,0,2,0,16,6,5,5
"2011","Barnet 034A","E01000236","Total",27,8,8,11,1,1,0,0,26,7,8,11
"2011","Barnet 034B","E01000238","Total",36,13,9,14,4,2,1,1,32,11,8,13
"2011","Barnet 034C","E01000310","Total",25,12,3,10,0,0,0,0,25,12,3,10
"2011","Barnet 034D","E01000311","Total",9,5,1,3,0,0,0,0,9,5,1,3
"2011","Barnet 035A","E01000205","Total",36,9,13,14,0,0,0,0,36,9,13,14
"2011","Barnet 035B","E01000209","Total",32,7,18,7,2,0,2,0,30,7,16,7
"2011","Barnet 035C","E01000211","Total",54,11,13,30,4,0,1,3,50,11,12,27
"2011","Barnet 035D","E01000212","Total",16,2,5,9,0,0,0,0,16,2,5,9
"2011","Barnet 035E","E01000216","Total",17,5,3,9,0,0,0,0,17,5,3,9
"2011","Barnet 035F","E01000217","Total",15,6,3,6,2,0,1,1,13,6,2,5
"2011","Barnet 036A","E01000150","Total",45,20,9,16,0,0,0,0,45,20,9,16
"2011","Barnet 036B","E01000305","Total",45,15,8,22,0,0,0,0,45,15,8,22
"2011","Barnet 036C","E01000306","Total",26,7,7,12,4,0,2,2,22,7,5,10
"2011","Barnet 036D","E01000308","Total",96,32,11,53,5,1,0,4,91,31,11,49
"2011","Barnet 036E","E01000312","Total",67,27,16,24,1,0,1,0,66,27,15,24
"2011","Barnet 036F","E01000313","Total",35,14,4,17,5,2,0,3,30,12,4,14
"2011","Barnet 037A","E01000145","Total",20,4,3,13,1,1,0,0,19,3,3,13
"2011","Barnet 037B","E01000215","Total",22,5,3,14,3,1,1,1,19,4,2,13
"2011","Barnet 037C","E01000218","Total",17,6,2,9,0,0,0,0,17,6,2,9
"2011","Barnet 037D","E01000219","Total",31,12,4,15,2,2,0,0,29,10,4,15
"2011","Barnet 037E","E01000220","Total",10,4,1,5,1,0,0,1,9,4,1,4
"2011","Barnet 037F","E01000225","Total",23,9,3,11,4,0,2,2,19,9,1,9
"2011","Barnet 038A","E01000135","Total",11,4,3,4,2,0,2,0,9,4,1,4
"2011","Barnet 038B","E01000136","Total",24,5,9,10,3,0,3,0,21,5,6,10
"2011","Barnet 038C","E01000144","Total",22,9,8,5,3,0,2,1,19,9,6,4
"2011","Barnet 038D","E01000146","Total",37,11,5,21,2,0,1,1,35,11,4,20
"2011","Barnet 038E","E01000214","Total",29,9,11,9,4,1,2,1,25,8,9,8
"2011","Barnet 039A","E01000141","Total",98,34,14,50,4,2,1,1,94,32,13,49
"2011","Barnet 039B","E01000221","Total",81,14,17,50,4,1,2,1,77,13,15,49
"2011","Barnet 039C","E01000223","Total",62,13,13,36,5,2,2,1,57,11,11,35
"2011","Barnet 039D","E01000307","Total",40,10,14,16,4,0,4,0,36,10,10,16
"2011","Barnet 040A","E01000138","Total",39,10,10,19,5,1,1,3,34,9,9,16
"2011","Barnet 040B","E01000142","Total",87,27,20,40,11,3,5,3,76,24,15,37
"2011","Barnet 040C","E01000222","Total",52,7,7,38,7,0,2,5,45,7,5,33
"2011","Barnet 040D","E01000224","Total",34,9,8,17,6,1,4,1,28,8,4,16
"2011","Barnet 041A","E01000137","Total",93,26,16,51,4,0,2,2,89,26,14,49
"2011","Barnet 041B","E01000139","Total",24,8,5,11,3,0,2,1,21,8,3,10
"2011","Barnet 041C","E01000140","Total",40,9,7,24,5,1,1,3,35,8,6,21
"2011","Barnet 041D","E01000143","Total",68,17,14,37,3,0,0,3,65,17,14,34
"2011","Bexley 001A","E01000466","Total",89,24,23,42,10,3,5,2,79,21,18,40
"2011","Bexley 001B","E01000467","Total",74,17,16,41,7,3,2,2,67,14,14,39
"2011","Bexley 001C","E01000468","Total",149,47,40,62,12,3,7,2,137,44,33,60
"2011","Bexley 001D","E01000469","Total",77,18,31,28,12,2,5,5,65,16,26,23
"2011","Bexley 002A","E01000416","Total",66,19,20,27,5,0,2,3,61,19,18,24
"2011","Bexley 002B","E01000418","Total",77,26,17,34,6,2,0,4,71,24,17,30
"2011","Bexley 002C","E01000422","Total",137,33,35,69,11,2,7,2,126,31,28,67
"2011","Bexley 002D","E01000464","Total",73,24,13,36,4,1,2,1,69,23,11,35
"2011","Bexley 002E","E01000465","Total",83,16,22,45,11,0,6,5,72,16,16,40
"2011","Bexley 002F","E01000470","Total",118,31,33,54,14,2,6,6,104,29,27,48
"2011","Bexley 003A","E01000333","Total",93,23,31,39,6,0,5,1,87,23,26,38
"2011","Bexley 003B","E01000335","Total",105,29,22,54,3,0,2,1,102,29,20,53
"2011","Bexley 003C","E01000336","Total",120,41,18,61,4,0,2,2,116,41,16,59
"2011","Bexley 003D","E01000337","Total",81,28,20,33,5,1,3,1,76,27,17,32
"2011","Bexley 003E","E01000338","Total",75,20,28,27,6,0,3,3,69,20,25,24
"2011","Bexley 004A","E01000403","Total",124,29,22,73,5,1,1,3,119,28,21,70
"2011","Bexley 004B","E01000404","Total",161,39,24,98,7,3,2,2,154,36,22,96
"2011","Bexley 004C","E01000405","Total",61,12,18,31,8,3,5,0,53,9,13,31
"2011","Bexley 004D","E01000408","Total",74,21,19,34,4,1,3,0,70,20,16,34
"2011","Bexley 005A","E01000332","Total",40,12,16,12,6,0,6,0,34,12,10,12
"2011","Bexley 005B","E01000402","Total",78,19,20,39,5,0,3,2,73,19,17,37
"2011","Bexley 005C","E01000406","Total",84,24,20,40,8,1,4,3,76,23,16,37
"2011","Bexley 005D","E01000407","Total",33,10,8,15,1,0,0,1,32,10,8,14
"2011","Bexley 006A","E01000334","Total",45,14,19,12,1,0,1,0,44,14,18,12
"2011","Bexley 006B","E01000417","Total",44,13,13,18,3,0,1,2,41,13,12,16
"2011","Bexley 006C","E01000419","Total",28,13,8,7,2,0,2,0,26,13,6,7
"2011","Bexley 006D","E01000420","Total",38,19,10,9,3,0,3,0,35,19,7,9
"2011","Bexley 006E","E01000442","Total",39,17,8,14,5,1,1,3,34,16,7,11
"2011","Bexley 007A","E01000437","Total",36,15,8,13,1,0,1,0,35,15,7,13
"2011","Bexley 007B","E01000438","Total",57,21,16,20,5,1,4,0,52,20,12,20
"2011","Bexley 007C","E01000439","Total",57,16,22,19,9,1,6,2,48,15,16,17
"2011","Bexley 007D","E01000440","Total",23,8,7,8,3,0,1,2,20,8,6,6
"2011","Bexley 007E","E01000441","Total",102,25,24,53,10,1,7,2,92,24,17,51
"2011","Bexley 008A","E01000373","Total",159,33,22,104,10,5,1,4,149,28,21,100
"2011","Bexley 008B","E01000429","Total",124,31,31,62,7,0,5,2,117,31,26,60
"2011","Bexley 008C","E01000430","Total",98,17,36,45,11,0,7,4,87,17,29,41
"2011","Bexley 008D","E01000431","Total",130,33,17,80,6,1,1,4,124,32,16,76
"2011","Bexley 008E","E01000432","Total",79,18,9,52,11,1,3,7,68,17,6,45
"2011","Bexley 008F","E01000433","Total",137,24,32,81,7,0,1,6,130,24,31,75
"2011","Bexley 008G","E01000434","Total",122,45,25,52,10,0,6,4,112,45,19,48
"2011","Bexley 009A","E01000356","Total",21,8,6,7,4,3,1,0,17,5,5,7
"2011","Bexley 009B","E01000357","Total",17,8,4,5,2,0,1,1,15,8,3,4
"2011","Bexley 009C","E01000359","Total",24,7,13,4,7,0,6,1,17,7,7,3
"2011","Bexley 009D","E01000421","Total",19,4,12,3,2,0,2,0,17,4,10,3
"2011","Bexley 009E","E01000450","Total",41,9,15,17,3,0,3,0,38,9,12,17
"2011","Bexley 009F","E01000451","Total",48,21,12,15,6,2,1,3,42,19,11,12
"2011","Bexley 009G","E01000452","Total",36,14,11,11,5,0,5,0,31,14,6,11
"2011","Bexley 010A","E01000367","Total",66,19,10,37,2,0,1,1,64,19,9,36
"2011","Bexley 010B","E01000368","Total",106,30,27,49,3,1,1,1,103,29,26,48
"2011","Bexley 010C","E01000372","Total",62,14,12,36,4,0,1,3,58,14,11,33
"2011","Bexley 010D","E01000380","Total",61,19,15,27,7,0,3,4,54,19,12,23
"2011","Bexley 010E","E01000435","Total",85,24,17,44,8,1,6,1,77,23,11,43
"2011","Bexley 011A","E01000353","Total",13,3,4,6,1,0,1,0,12,3,3,6
"2011","Bexley 011B","E01000354","Total",46,16,10,20,3,0,3,0,43,16,7,20
"2011","Bexley 011C","E01000355","Total",21,8,6,7,1,0,1,0,20,8,5,7
"2011","Bexley 011D","E01000358","Total",34,12,11,11,2,0,1,1,32,12,10,10
"2011","Bexley 011E","E01000436","Total",18,4,8,6,1,0,1,0,17,4,7,6
"2011","Bexley 013A","E01000401","Total",61,27,19,15,3,1,1,1,58,26,18,14
"2011","Bexley 013B","E01000453","Total",27,6,13,8,6,0,6,0,21,6,7,8
"2011","Bexley 013C","E01000454","Total",36,15,10,11,4,2,2,0,32,13,8,11
"2011","Bexley 013D","E01000455","Total",31,6,14,11,1,0,1,0,30,6,13,11
"2011","Bexley 013E","E01000456","Total",31,13,11,7,2,0,1,1,29,13,10,6
"2011","Bexley 014A","E01000325","Total",34,13,10,11,1,0,0,1,33,13,10,10
"2011","Bexley 014B","E01000326","Total",51,13,15,23,5,0,5,0,46,13,10,23
"2011","Bexley 014C","E01000369","Total",43,22,9,12,7,2,3,2,36,20,6,10
"2011","Bexley 014D","E01000370","Total",23,7,8,8,3,0,3,0,20,7,5,8
"2011","Bexley 014E","E01000371","Total",32,9,14,9,3,0,3,0,29,9,11,9
"2011","Bexley 015A","E01000360","Total",66,22,23,21,14,6,6,2,52,16,17,19
"2011","Bexley 015B","E01000362","Total",30,6,15,9,3,0,2,1,27,6,13,8
"2011","Bexley 015C","E01000365","Total",44,13,13,18,4,0,4,0,40,13,9,18
"2011","Bexley 015D","E01000366","Total",38,14,17,7,4,0,3,1,34,14,14,6
"2011","Bexley 015E","E01000394","Total",23,6,11,6,2,0,2,0,21,6,9,6
"2011","Bexley 016A","E01000388","Total",26,7,12,7,5,0,4,1,21,7,8,6
"2011","Bexley 016B","E01000392","Total",110,33,24,53,10,0,4,6,100,33,20,47
"2011","Bexley 016C","E01000409","Total",32,11,15,6,2,0,1,1,30,11,14,5
"2011","Bexley 016D","E01000411","Total",29,9,9,11,1,0,1,0,28,9,8,11
"2011","Bexley 016E","E01000414","Total",42,9,16,17,6,0,5,1,36,9,11,16
"2011","Bexley 016F","E01000415","Total",15,7,4,4,1,0,0,1,14,7,4,3
"2011","Bexley 017A","E01000327","Total",27,11,7,9,4,0,1,3,23,11,6,6
"2011","Bexley 017B","E01000328","Total",27,13,7,7,2,0,1,1,25,13,6,6
"2011","Bexley 017C","E01000329","Total",47,15,16,16,7,2,3,2,40,13,13,14
"2011","Bexley 017D","E01000330","Total",48,10,13,25,2,0,2,0,46,10,11,25
"2011","Bexley 017E","E01000331","Total",58,14,24,20,2,0,2,0,56,14,22,20
"2011","Bexley 018A","E01000340","Total",31,13,12,6,4,0,4,0,27,13,8,6
"2011","Bexley 018B","E01000395","Total",19,9,9,1,3,1,2,0,16,8,7,1
"2011","Bexley 018C","E01000396","Total",25,10,6,9,0,0,0,0,25,10,6,9
"2011","Bexley 018D","E01000410","Total",34,11,14,9,4,0,2,2,30,11,12,7
"2011","Bexley 018E","E01000412","Total",45,11,23,11,4,0,4,0,41,11,19,11
"2011","Bexley 018F","E01000413","Total",38,21,11,6,4,0,3,1,34,21,8,5
"2011","Bexley 019A","E01000374","Total",92,25,22,45,11,0,10,1,81,25,12,44
"2011","Bexley 019B","E01000375","Total",57,15,17,25,9,1,6,2,48,14,11,23
"2011","Bexley 019C","E01000376","Total",46,17,15,14,9,2,7,0,37,15,8,14
"2011","Bexley 019D","E01000377","Total",32,15,8,9,2,0,1,1,30,15,7,8
"2011","Bexley 019E","E01000378","Total",58,21,15,22,9,4,3,2,49,17,12,20
"2011","Bexley 019F","E01000379","Total",58,19,11,28,7,4,0,3,51,15,11,25
"2011","Bexley 020A","E01000348","Total",12,5,4,3,1,1,0,0,11,4,4,3
"2011","Bexley 020B","E01000349","Total",27,8,13,6,3,2,0,1,24,6,13,5
"2011","Bexley 020C","E01000361","Total",41,14,14,13,2,0,2,0,39,14,12,13
"2011","Bexley 020D","E01000363","Total",27,6,11,10,1,0,1,0,26,6,10,10
"2011","Bexley 020E","E01000389","Total",52,20,15,17,7,1,5,1,45,19,10,16
"2011","Bexley 020F","E01000390","Total",20,7,8,5,2,1,1,0,18,6,7,5
"2011","Bexley 020G","E01000393","Total",47,23,11,13,1,0,1,0,46,23,10,13
"2011","Bexley 021A","E01000346","Total",40,16,14,10,2,1,1,0,38,15,13,10
"2011","Bexley 021B","E01000347","Total",61,21,27,13,6,2,3,1,55,19,24,12
"2011","Bexley 021C","E01000350","Total",38,17,12,9,7,0,5,2,31,17,7,7
"2011","Bexley 021D","E01000352","Total",60,11,26,23,7,0,7,0,53,11,19,23
"2011","Bexley 021E","E01000391","Total",61,25,20,16,6,2,4,0,55,23,16,16
"2011","Bexley 022A","E01000341","Total",32,10,9,13,3,1,2,0,29,9,7,13
"2011","Bexley 022B","E01000342","Total",45,14,21,10,0,0,0,0,45,14,21,10
"2011","Bexley 022C","E01000343","Total",29,11,11,7,2,0,2,0,27,11,9,7
"2011","Bexley 022D","E01000345","Total",38,13,17,8,3,0,2,1,35,13,15,7
"2011","Bexley 022E","E01000460","Total",16,10,3,3,1,0,1,0,15,10,2,3
"2011","Bexley 023A","E01000364","Total",35,13,6,16,6,4,2,0,29,9,4,16
"2011","Bexley 023B","E01000444","Total",20,11,5,4,1,0,1,0,19,11,4,4
"2011","Bexley 023C","E01000447","Total",43,12,14,17,2,0,1,1,41,12,13,16
"2011","Bexley 023D","E01000448","Total",12,4,3,5,1,1,0,0,11,3,3,5
"2011","Bexley 023E","E01000449","Total",18,5,10,3,4,0,4,0,14,5,6,3
"2011","Bexley 024A","E01000351","Total",30,7,11,12,3,0,1,2,27,7,10,10
"2011","Bexley 024B","E01000443","Total",31,13,9,9,5,0,3,2,26,13,6,7
"2011","Bexley 024C","E01000445","Total",26,9,9,8,0,0,0,0,26,9,9,8
"2011","Bexley 024D","E01000446","Total",37,14,13,10,4,0,3,1,33,14,10,9
"2011","Bexley 024E","E01000461","Total",25,14,9,2,4,2,2,0,21,12,7,2
"2011","Bexley 025A","E01000339","Total",41,17,11,13,1,0,1,0,40,17,10,13
"2011","Bexley 025B","E01000344","Total",31,13,9,9,1,1,0,0,30,12,9,9
"2011","Bexley 025C","E01000423","Total",18,6,8,4,0,0,0,0,18,6,8,4
"2011","Bexley 025D","E01000425","Total",23,9,10,4,1,0,1,0,22,9,9,4
"2011","Bexley 025E","E01000463","Total",19,5,9,5,1,0,1,0,18,5,8,5
"2011","Bexley 026A","E01000424","Total",16,2,5,9,1,0,1,0,15,2,4,9
"2011","Bexley 026B","E01000426","Total",42,14,16,12,3,0,2,1,39,14,14,11
"2011","Bexley 026C","E01000427","Total",63,18,18,27,4,1,3,0,59,17,15,27
"2011","Bexley 026D","E01000457","Total",50,11,20,19,3,0,3,0,47,11,17,19
"2011","Bexley 026E","E01000462","Total",45,8,18,19,3,0,2,1,42,8,16,18
"2011","Bexley 027A","E01000382","Total",23,9,8,6,1,0,1,0,22,9,7,6
"2011","Bexley 027B","E01000384","Total",52,13,16,23,2,0,2,0,50,13,14,23
"2011","Bexley 027C","E01000387","Total",40,13,10,17,4,0,3,1,36,13,7,16
"2011","Bexley 027D","E01000428","Total",64,18,18,28,5,0,1,4,59,18,17,24
"2011","Bexley 027E","E01000458","Total",17,9,5,3,1,0,1,0,16,9,4,3
"2011","Bexley 027F","E01000459","Total",38,4,19,15,8,0,6,2,30,4,13,13
"2011","Bexley 028A","E01000381","Total",56,18,12,26,2,0,1,1,54,18,11,25
"2011","Bexley 028B","E01000383","Total",41,11,15,15,2,0,1,1,39,11,14,14
"2011","Bexley 028C","E01000385","Total",121,33,19,69,4,0,1,3,117,33,18,66
"2011","Bexley 028D","E01000386","Total",95,21,19,55,10,0,1,9,85,21,18,46
"2011","Bexley 029A","E01000398","Total",52,18,13,21,3,0,1,2,49,18,12,19
"2011","Bexley 029B","E01000399","Total",34,11,13,10,2,2,0,0,32,9,13,10
"2011","Bexley 029C","E01000400","Total",38,13,12,13,5,0,2,3,33,13,10,10
"2011","Bexley 029D","E01032566","Total",77,19,21,37,4,0,4,0,73,19,17,37
"2011","Brent 001A","E01000587","Total",20,6,2,12,4,3,1,0,16,3,1,12
"2011","Brent 001B","E01000589","Total",35,13,7,15,2,1,0,1,33,12,7,14
"2011","Brent 001C","E01000590","Total",33,11,8,14,1,1,0,0,32,10,8,14
"2011","Brent 001D","E01000592","Total",32,3,9,20,2,0,1,1,30,3,8,19
"2011","Brent 001E","E01000593","Total",72,19,13,40,1,0,0,1,71,19,13,39
"2011","Brent 001F","E01000594","Total",28,10,5,13,0,0,0,0,28,10,5,13
"2011","Brent 002A","E01000513","Total",23,9,4,10,2,1,0,1,21,8,4,9
"2011","Brent 002B","E01000514","Total",38,14,13,11,2,0,1,1,36,14,12,10
"2011","Brent 002C","E01000516","Total",27,13,6,8,5,3,2,0,22,10,4,8
"2011","Brent 002D","E01000520","Total",39,13,10,16,9,1,4,4,30,12,6,12
"2011","Brent 002E","E01000588","Total",98,23,21,54,6,1,3,2,92,22,18,52
"2011","Brent 003A","E01000515","Total",58,10,16,32,4,1,2,1,54,9,14,31
"2011","Brent 003B","E01000517","Total",15,5,3,7,2,0,1,1,13,5,2,6
"2011","Brent 003E","E01000543","Total",28,4,9,15,2,0,0,2,26,4,9,13
"2011","Brent 003F","E01000591","Total",33,8,11,14,2,1,0,1,31,7,11,13
"2011","Brent 003G","E01033463","Total",42,16,11,15,7,2,4,1,35,14,7,14
"2011","Brent 004A","E01000536","Total",22,9,4,9,2,0,2,0,20,9,2,9
"2011","Brent 004B","E01000538","Total",10,1,7,2,0,0,0,0,10,1,7,2
"2011","Brent 004C","E01000539","Total",17,9,2,6,1,1,0,0,16,8,2,6
"2011","Brent 004D","E01000540","Total",14,6,2,6,0,0,0,0,14,6,2,6
"2011","Brent 004E","E01000541","Total",21,7,10,4,2,1,1,0,19,6,9,4
"2011","Brent 005A","E01000518","Total",41,7,14,20,2,0,2,0,39,7,12,20
"2011","Brent 005B","E01000519","Total",37,7,7,23,0,0,0,0,37,7,7,23
"2011","Brent 005C","E01000623","Total",26,10,6,10,1,0,1,0,25,10,5,10
"2011","Brent 005D","E01000624","Total",28,16,6,6,0,0,0,0,28,16,6,6
"2011","Brent 005E","E01000629","Total",30,13,6,11,2,1,0,1,28,12,6,10
"2011","Brent 006A","E01000480","Total",22,6,10,6,3,1,0,2,19,5,10,4
"2011","Brent 006B","E01000484","Total",58,19,18,21,4,0,0,4,54,19,18,17
"2011","Brent 006C","E01000485","Total",28,12,6,10,4,0,0,4,24,12,6,6
"2011","Brent 006D","E01000486","Total",22,5,11,6,5,0,4,1,17,5,7,5
"2011","Brent 006E","E01000487","Total",32,8,5,19,2,0,0,2,30,8,5,17
"2011","Brent 007A","E01000572","Total",31,14,7,10,2,1,1,0,29,13,6,10
"2011","Brent 007B","E01000573","Total",20,8,6,6,1,0,1,0,19,8,5,6
"2011","Brent 007C","E01000574","Total",37,12,10,15,2,0,2,0,35,12,8,15
"2011","Brent 007D","E01000575","Total",36,7,16,13,2,0,1,1,34,7,15,12
"2011","Brent 007E","E01000577","Total",110,32,25,53,6,1,2,3,104,31,23,50
"2011","Brent 008A","E01000562","Total",23,2,14,7,4,0,4,0,19,2,10,7
"2011","Brent 008B","E01000563","Total",17,6,5,6,3,2,1,0,14,4,4,6
"2011","Brent 008C","E01000566","Total",21,5,7,9,6,1,5,0,15,4,2,9
"2011","Brent 008D","E01000568","Total",16,3,12,1,0,0,0,0,16,3,12,1
"2011","Brent 008E","E01000569","Total",13,3,7,3,0,0,0,0,13,3,7,3
"2011","Brent 009A","E01000479","Total",17,5,4,8,4,0,2,2,13,5,2,6
"2011","Brent 009B","E01000481","Total",74,17,14,43,9,2,0,7,65,15,14,36
"2011","Brent 009C","E01000482","Total",133,49,25,59,15,4,1,10,118,45,24,49
"2011","Brent 009D","E01000483","Total",95,34,19,42,16,2,6,8,79,32,13,34
"2011","Brent 009E","E01000625","Total",37,9,16,12,3,0,3,0,34,9,13,12
"2011","Brent 010B","E01000498","Total",45,6,9,30,2,1,1,0,43,5,8,30
"2011","Brent 010D","E01000622","Total",56,21,16,19,3,3,0,0,53,18,16,19
"2011","Brent 010E","E01000626","Total",104,21,45,38,9,0,5,4,95,21,40,34
"2011","Brent 010F","E01033464","Total",72,11,10,51,6,1,0,5,66,10,10,46
"2011","Brent 011A","E01000497","Total",57,16,14,27,2,0,0,2,55,16,14,25
"2011","Brent 011B","E01000499","Total",62,21,10,31,1,0,0,1,61,21,10,30
"2011","Brent 011C","E01000501","Total",111,33,34,44,6,1,3,2,105,32,31,42
"2011","Brent 011D","E01000502","Total",46,8,10,28,3,0,1,2,43,8,9,26
"2011","Brent 011E","E01000503","Total",66,23,13,30,4,1,3,0,62,22,10,30
"2011","Brent 012A","E01000570","Total",53,23,8,22,1,0,1,0,52,23,7,22
"2011","Brent 012B","E01000571","Total",30,11,3,16,2,1,0,1,28,10,3,15
"2011","Brent 012C","E01000576","Total",17,1,9,7,0,0,0,0,17,1,9,7
"2011","Brent 012D","E01000578","Total",42,8,21,13,7,2,2,3,35,6,19,10
"2011","Brent 013A","E01000564","Total",27,7,5,15,0,0,0,0,27,7,5,15
"2011","Brent 013B","E01000565","Total",29,11,3,15,1,0,0,1,28,11,3,14
"2011","Brent 013C","E01000607","Total",44,17,14,13,4,1,2,1,40,16,12,12
"2011","Brent 013D","E01000608","Total",57,16,13,28,4,0,2,2,53,16,11,26
"2011","Brent 013E","E01000613","Total",59,21,21,17,6,1,4,1,53,20,17,16
"2011","Brent 014A","E01000506","Total",78,15,15,48,5,0,0,5,73,15,15,43
"2011","Brent 014B","E01000509","Total",33,6,7,20,4,1,0,3,29,5,7,17
"2011","Brent 014C","E01000510","Total",68,26,12,30,9,3,3,3,59,23,9,27
"2011","Brent 014D","E01000511","Total",66,22,8,36,4,3,0,1,62,19,8,35
"2011","Brent 014E","E01000627","Total",78,23,19,36,7,2,3,2,71,21,16,34
"2011","Brent 014F","E01000628","Total",62,9,10,43,2,1,1,0,60,8,9,43
"2011","Brent 015A","E01000553","Total",66,23,12,31,2,1,0,1,64,22,12,30
"2011","Brent 015B","E01000554","Total",71,27,10,34,1,1,0,0,70,26,10,34
"2011","Brent 015C","E01000555","Total",24,3,9,12,1,0,1,0,23,3,8,12
"2011","Brent 015D","E01000556","Total",79,29,17,33,9,2,2,5,70,27,15,28
"2011","Brent 015E","E01000557","Total",42,18,7,17,1,1,0,0,41,17,7,17
"2011","Brent 015F","E01000558","Total",35,10,6,19,2,1,0,1,33,9,6,18
"2011","Brent 016A","E01000567","Total",31,13,9,9,1,0,1,0,30,13,8,9
"2011","Brent 016B","E01000606","Total",38,14,6,18,3,0,1,2,35,14,5,16
"2011","Brent 016C","E01000609","Total",51,15,11,25,5,0,3,2,46,15,8,23
"2011","Brent 016D","E01000611","Total",33,8,8,17,5,0,2,3,28,8,6,14
"2011","Brent 017B","E01000615","Total",49,14,16,19,6,1,2,3,43,13,14,16
"2011","Brent 017C","E01000617","Total",17,3,8,6,3,0,1,2,14,3,7,4
"2011","Brent 017D","E01000618","Total",35,5,7,23,4,2,1,1,31,3,6,22
"2011","Brent 017E","E01000619","Total",31,7,13,11,0,0,0,0,31,7,13,11
"2011","Brent 017F","E01033424","Total",57,10,16,31,3,0,3,0,54,10,13,31
"2011","Brent 017G","E01033457","Total",25,6,14,5,2,0,2,0,23,6,12,5
"2011","Brent 018A","E01000504","Total",40,7,13,20,8,0,3,5,32,7,10,15
"2011","Brent 018B","E01000505","Total",54,16,13,25,3,1,1,1,51,15,12,24
"2011","Brent 018C","E01000507","Total",41,18,3,20,7,0,0,7,34,18,3,13
"2011","Brent 018D","E01000512","Total",45,10,18,17,3,0,2,1,42,10,16,16
"2011","Brent 018E","E01000559","Total",35,11,9,15,1,1,0,0,34,10,9,15
"2011","Brent 019A","E01000610","Total",37,9,13,15,2,0,2,0,35,9,11,15
"2011","Brent 019B","E01000612","Total",26,4,10,12,0,0,0,0,26,4,10,12
"2011","Brent 019C","E01000631","Total",20,3,4,13,0,0,0,0,20,3,4,13
"2011","Brent 019D","E01000633","Total",11,4,3,4,1,0,0,1,10,4,3,3
"2011","Brent 019E","E01000634","Total",68,23,18,27,3,1,1,1,65,22,17,26
"2011","Brent 020A","E01000616","Total",22,5,4,13,2,0,2,0,20,5,2,13
"2011","Brent 020B","E01000620","Total",26,9,6,11,3,1,1,1,23,8,5,10
"2011","Brent 020C","E01000621","Total",35,13,10,12,7,4,2,1,28,9,8,11
"2011","Brent 020D","E01000635","Total",62,22,16,24,5,1,3,1,57,21,13,23
"2011","Brent 020E","E01000636","Total",25,8,7,10,5,2,1,2,20,6,6,8
"2011","Brent 021A","E01000596","Total",144,36,32,76,7,2,1,4,137,34,31,72
"2011","Brent 021B","E01000601","Total",104,33,18,53,4,1,1,2,100,32,17,51
"2011","Brent 021C","E01000602","Total",80,24,20,36,5,0,2,3,75,24,18,33
"2011","Brent 021D","E01000603","Total",112,30,18,64,4,1,3,0,108,29,15,64
"2011","Brent 021E","E01000604","Total",90,18,24,48,4,0,1,3,86,18,23,45
"2011","Brent 021F","E01000605","Total",110,29,26,55,11,1,2,8,99,28,24,47
"2011","Brent 022A","E01000488","Total",46,15,12,19,6,3,3,0,40,12,9,19
"2011","Brent 022B","E01000637","Total",54,15,12,27,4,2,2,0,50,13,10,27
"2011","Brent 022C","E01000639","Total",39,8,18,13,4,1,2,1,35,7,16,12
"2011","Brent 022D","E01000642","Total",50,15,14,21,3,0,0,3,47,15,14,18
"2011","Brent 022E","E01000644","Total",65,17,13,35,6,2,3,1,59,15,10,34
"2011","Brent 023A","E01000490","Total",43,16,5,22,1,0,0,1,42,16,5,21
"2011","Brent 023B","E01000494","Total",34,7,16,11,4,1,3,0,30,6,13,11
"2011","Brent 023C","E01000495","Total",41,14,11,16,7,2,4,1,34,12,7,15
"2011","Brent 023D","E01000560","Total",34,10,13,11,4,1,3,0,30,9,10,11
"2011","Brent 023E","E01000561","Total",55,11,18,26,4,0,3,1,51,11,15,25
"2011","Brent 024A","E01000638","Total",99,31,23,45,13,2,4,7,86,29,19,38
"2011","Brent 024B","E01000640","Total",84,28,19,37,7,3,2,2,77,25,17,35
"2011","Brent 024C","E01000641","Total",99,28,25,46,3,1,1,1,96,27,24,45
"2011","Brent 024D","E01000643","Total",127,38,32,57,2,0,0,2,125,38,32,55
"2011","Brent 025A","E01000508","Total",80,26,12,42,6,1,2,3,74,25,10,39
"2011","Brent 025B","E01000521","Total",142,54,20,68,11,5,3,3,131,49,17,65
"2011","Brent 025C","E01000522","Total",128,35,38,55,7,2,0,5,121,33,38,50
"2011","Brent 025D","E01000526","Total",162,53,37,72,4,1,2,1,158,52,35,71
"2011","Brent 025E","E01000527","Total",141,49,20,72,12,6,2,4,129,43,18,68
"2011","Brent 025F","E01000528","Total",101,42,18,41,2,0,1,1,99,42,17,40
"2011","Brent 026A","E01000471","Total",33,8,12,13,1,0,1,0,32,8,11,13
"2011","Brent 026B","E01000474","Total",28,6,6,16,2,0,1,1,26,6,5,15
"2011","Brent 026C","E01000476","Total",23,12,5,6,2,1,1,0,21,11,4,6
"2011","Brent 026D","E01000477","Total",58,14,19,25,7,2,5,0,51,12,14,25
"2011","Brent 026E","E01000630","Total",72,17,18,37,3,1,0,2,69,16,18,35
"2011","Brent 027A","E01000595","Total",111,25,28,58,13,5,6,2,98,20,22,56
"2011","Brent 027D","E01000599","Total",68,20,23,25,9,2,5,2,59,18,18,23
"2011","Brent 027E","E01000600","Total",123,44,25,54,14,8,3,3,109,36,22,51
"2011","Brent 027F","E01033456","Total",122,35,24,63,4,2,0,2,118,33,24,61
"2011","Brent 028A","E01000545","Total",46,10,14,22,6,0,5,1,40,10,9,21
"2011","Brent 028B","E01000546","Total",51,8,13,30,3,0,2,1,48,8,11,29
"2011","Brent 028C","E01000547","Total",53,13,15,25,3,1,0,2,50,12,15,23
"2011","Brent 028D","E01000548","Total",51,14,18,19,3,0,0,3,48,14,18,16
"2011","Brent 028E","E01000549","Total",50,15,16,19,0,0,0,0,50,15,16,19
"2011","Brent 029A","E01000472","Total",31,8,3,20,6,0,2,4,25,8,1,16
"2011","Brent 029B","E01000473","Total",28,7,7,14,3,0,1,2,25,7,6,12
"2011","Brent 029C","E01000475","Total",39,8,9,22,2,1,1,0,37,7,8,22
"2011","Brent 029D","E01000478","Total",23,8,6,9,3,1,2,0,20,7,4,9
"2011","Brent 029E","E01000632","Total",15,5,4,6,1,0,1,0,14,5,3,6
"2011","Brent 030A","E01000489","Total",30,8,4,18,2,0,2,0,28,8,2,18
"2011","Brent 030B","E01000491","Total",54,17,9,28,3,3,0,0,51,14,9,28
"2011","Brent 030C","E01000492","Total",22,11,7,4,1,0,0,1,21,11,7,3
"2011","Brent 030D","E01000493","Total",33,10,13,10,2,0,2,0,31,10,11,10
"2011","Brent 030E","E01000581","Total",58,18,25,15,1,0,1,0,57,18,24,15
"2011","Brent 031A","E01000523","Total",142,44,33,65,21,3,7,11,121,41,26,54
"2011","Brent 031B","E01000524","Total",187,61,31,95,10,5,3,2,177,56,28,93
"2011","Brent 031C","E01000525","Total",135,46,25,64,3,1,1,1,132,45,24,63
"2011","Brent 031E","E01000533","Total",130,35,29,66,15,6,3,6,115,29,26,60
"2011","Brent 031F","E01000535","Total",83,28,27,28,7,2,2,3,76,26,25,25
"2011","Brent 031G","E01033455","Total",58,20,8,30,6,2,2,2,52,18,6,28
"2011","Brent 031H","E01033485","Total",116,25,22,69,11,3,3,5,105,22,19,64
"2011","Brent 032A","E01000579","Total",72,20,22,30,10,1,4,5,62,19,18,25
"2011","Brent 032B","E01000580","Total",53,17,22,14,9,2,6,1,44,15,16,13
"2011","Brent 032C","E01000582","Total",44,14,14,16,9,1,5,3,35,13,9,13
"2011","Brent 032D","E01000583","Total",60,22,15,23,3,1,0,2,57,21,15,21
"2011","Brent 032E","E01000586","Total",99,25,22,52,7,1,1,5,92,24,21,47
"2011","Brent 033A","E01000530","Total",58,16,16,26,6,3,3,0,52,13,13,26
"2011","Brent 033B","E01000531","Total",85,22,24,39,5,0,3,2,80,22,21,37
"2011","Brent 033C","E01000532","Total",44,12,10,22,6,1,2,3,38,11,8,19
"2011","Brent 033D","E01000534","Total",55,24,13,18,6,1,4,1,49,23,9,17
"2011","Brent 033E","E01000584","Total",46,15,12,19,3,1,0,2,43,14,12,17
"2011","Brent 033F","E01000585","Total",48,20,8,20,5,1,2,2,43,19,6,18
"2011","Brent 034A","E01000544","Total",73,16,16,41,10,2,5,3,63,14,11,38
"2011","Brent 034B","E01000550","Total",99,27,25,47,9,0,3,6,90,27,22,41
"2011","Brent 034C","E01000551","Total",152,50,34,68,8,1,4,3,144,49,30,65
"2011","Brent 034D","E01000552","Total",104,25,30,49,9,0,5,4,95,25,25,45
"2011","Bromley 001A","E01000779","Total",22,6,3,13,0,0,0,0,22,6,3,13
"2011","Bromley 001B","E01000780","Total",82,30,15,37,4,0,0,4,78,30,15,33
"2011","Bromley 001C","E01000781","Total",106,32,15,59,2,0,1,1,104,32,14,58
"2011","Bromley 001D","E01000782","Total",101,20,21,60,6,0,2,4,95,20,19,56
"2011","Bromley 001E","E01000783","Total",113,32,23,58,8,1,4,3,105,31,19,55
"2011","Bromley 001F","E01000785","Total",78,26,12,40,1,1,0,0,77,25,12,40
"2011","Bromley 002A","E01000689","Total",46,10,8,28,3,1,1,1,43,9,7,27
"2011","Bromley 002B","E01000690","Total",30,17,7,6,2,1,1,0,28,16,6,6
"2011","Bromley 002C","E01000691","Total",46,16,11,19,1,0,1,0,45,16,10,19
"2011","Bromley 002D","E01000692","Total",51,17,15,19,3,1,2,0,48,16,13,19
"2011","Bromley 002E","E01000784","Total",36,14,13,9,3,0,3,0,33,14,10,9
"2011","Bromley 004A","E01000799","Total",76,20,34,22,5,1,4,0,71,19,30,22
"2011","Bromley 004B","E01000802","Total",50,18,10,22,4,1,1,2,46,17,9,20
"2011","Bromley 004C","E01000803","Total",68,18,26,24,10,3,5,2,58,15,21,22
"2011","Bromley 004D","E01000804","Total",22,4,11,7,2,0,2,0,20,4,9,7
"2011","Bromley 004E","E01000805","Total",72,22,25,25,1,0,1,0,71,22,24,25
"2011","Bromley 005A","E01000740","Total",88,32,22,34,9,2,5,2,79,30,17,32
"2011","Bromley 005B","E01000741","Total",76,21,19,36,3,0,0,3,73,21,19,33
"2011","Bromley 005C","E01000742","Total",118,29,28,61,10,2,3,5,108,27,25,56
"2011","Bromley 005D","E01000745","Total",94,22,32,40,9,0,4,5,85,22,28,35
"2011","Bromley 005E","E01000746","Total",91,31,19,41,1,0,1,0,90,31,18,41
"2011","Bromley 006A","E01000709","Total",27,7,9,11,1,0,0,1,26,7,9,10
"2011","Bromley 006B","E01000710","Total",39,7,8,24,5,0,2,3,34,7,6,21
"2011","Bromley 006C","E01000711","Total",26,8,10,8,2,0,1,1,24,8,9,7
"2011","Bromley 006D","E01000714","Total",56,13,24,19,7,1,4,2,49,12,20,17
"2011","Bromley 006E","E01000718","Total",125,25,26,74,5,0,3,2,120,25,23,72
"2011","Bromley 007A","E01000645","Total",12,4,5,3,0,0,0,0,12,4,5,3
"2011","Bromley 007B","E01000649","Total",38,12,9,17,0,0,0,0,38,12,9,17
"2011","Bromley 007C","E01000694","Total",12,5,4,3,0,0,0,0,12,5,4,3
"2011","Bromley 007D","E01000695","Total",31,9,10,12,3,0,3,0,28,9,7,12
"2011","Bromley 007E","E01000696","Total",24,8,8,8,3,0,2,1,21,8,6,7
"2011","Bromley 007F","E01000697","Total",20,7,9,4,7,3,4,0,13,4,5,4
"2011","Bromley 008A","E01000674","Total",36,7,9,20,2,0,2,0,34,7,7,20
"2011","Bromley 008B","E01000676","Total",87,29,21,37,8,1,3,4,79,28,18,33
"2011","Bromley 008C","E01000820","Total",42,7,18,17,4,0,2,2,38,7,16,15
"2011","Bromley 008D","E01000822","Total",61,22,15,24,6,4,2,0,55,18,13,24
"2011","Bromley 008E","E01000823","Total",41,15,12,14,4,2,1,1,37,13,11,13
"2011","Bromley 008F","E01000824","Total",32,12,8,12,2,0,0,2,30,12,8,10
"2011","Bromley 008G","E01000825","Total",56,14,18,24,4,1,1,2,52,13,17,22
"2011","Bromley 009A","E01000743","Total",139,29,32,78,12,2,5,5,127,27,27,73
"2011","Bromley 009B","E01000744","Total",114,34,26,54,8,1,3,4,106,33,23,50
"2011","Bromley 009C","E01000796","Total",146,34,50,62,11,2,4,5,135,32,46,57
"2011","Bromley 009D","E01000798","Total",113,29,18,66,9,0,1,8,104,29,17,58
"2011","Bromley 009E","E01000800","Total",100,21,31,48,10,1,4,5,90,20,27,43
"2011","Bromley 009F","E01000806","Total",119,46,23,50,9,0,1,8,110,46,22,42
"2011","Bromley 010A","E01000693","Total",15,3,5,7,1,0,1,0,14,3,4,7
"2011","Bromley 010B","E01000698","Total",18,6,5,7,4,0,2,2,14,6,3,5
"2011","Bromley 010C","E01000736","Total",70,15,11,44,6,1,1,4,64,14,10,40
"2011","Bromley 010D","E01000737","Total",66,16,14,36,6,2,1,3,60,14,13,33
"2011","Bromley 011A","E01000672","Total",34,6,12,16,4,0,3,1,30,6,9,15
"2011","Bromley 011B","E01000673","Total",31,11,6,14,1,0,1,0,30,11,5,14
"2011","Bromley 011C","E01000716","Total",25,12,7,6,3,1,2,0,22,11,5,6
"2011","Bromley 011D","E01000717","Total",47,11,18,18,2,0,2,0,45,11,16,18
"2011","Bromley 011E","E01000828","Total",34,8,13,13,3,0,3,0,31,8,10,13
"2011","Bromley 012A","E01000712","Total",28,11,12,5,4,1,3,0,24,10,9,5
"2011","Bromley 012B","E01000713","Total",42,17,10,15,2,0,2,0,40,17,8,15
"2011","Bromley 012C","E01000715","Total",20,3,8,9,1,0,1,0,19,3,7,9
"2011","Bromley 012D","E01000770","Total",9,4,4,1,1,0,1,0,8,4,3,1
"2011","Bromley 012E","E01000772","Total",17,10,4,3,0,0,0,0,17,10,4,3
"2011","Bromley 013A","E01000700","Total",68,13,28,27,5,1,2,2,63,12,26,25
"2011","Bromley 013B","E01000702","Total",27,5,13,9,2,0,1,1,25,5,12,8
"2011","Bromley 013C","E01000703","Total",47,13,19,15,4,1,3,0,43,12,16,15
"2011","Bromley 013D","E01000706","Total",40,14,10,16,4,0,2,2,36,14,8,14
"2011","Bromley 013E","E01000797","Total",26,6,12,8,3,2,1,0,23,4,11,8
"2011","Bromley 014A","E01000729","Total",121,44,17,60,3,1,2,0,118,43,15,60
"2011","Bromley 014B","E01000730","Total",137,39,27,71,7,0,4,3,130,39,23,68
"2011","Bromley 014C","E01000735","Total",61,17,12,32,3,0,2,1,58,17,10,31
"2011","Bromley 014D","E01000738","Total",58,19,14,25,3,1,2,0,55,18,12,25
"2011","Bromley 014E","E01000739","Total",101,18,14,69,3,0,0,3,98,18,14,66
"2011","Bromley 015A","E01000699","Total",79,17,27,35,7,0,3,4,72,17,24,31
"2011","Bromley 015B","E01000701","Total",37,8,17,12,4,0,3,1,33,8,14,11
"2011","Bromley 015C","E01000704","Total",45,10,20,15,1,1,0,0,44,9,20,15
"2011","Bromley 015D","E01000705","Total",55,18,17,20,3,1,2,0,52,17,15,20
"2011","Bromley 015E","E01000801","Total",65,23,17,25,3,0,1,2,62,23,16,23
"2011","Bromley 016A","E01000646","Total",35,10,7,18,2,1,0,1,33,9,7,17
"2011","Bromley 016B","E01000647","Total",54,14,21,19,3,0,3,0,51,14,18,19
"2011","Bromley 016C","E01000648","Total",35,15,7,13,2,2,0,0,33,13,7,13
"2011","Bromley 016D","E01000653","Total",16,7,3,6,1,0,1,0,15,7,2,6
"2011","Bromley 016E","E01000678","Total",39,16,13,10,2,1,1,0,37,15,12,10
"2011","Bromley 018A","E01000670","Total",47,11,20,16,5,0,3,2,42,11,17,14
"2011","Bromley 018B","E01000675","Total",36,15,11,10,9,4,3,2,27,11,8,8
"2011","Bromley 018C","E01000677","Total",66,24,15,27,2,0,1,1,64,24,14,26
"2011","Bromley 018D","E01000762","Total",29,12,10,7,0,0,0,0,29,12,10,7
"2011","Bromley 018E","E01000829","Total",38,18,12,8,6,1,3,2,32,17,9,6
"2011","Bromley 019A","E01000719","Total",129,29,34,66,5,1,3,1,124,28,31,65
"2011","Bromley 019B","E01000720","Total",112,25,19,68,11,0,3,8,101,25,16,60
"2011","Bromley 019C","E01000721","Total",100,24,12,64,7,2,2,3,93,22,10,61
"2011","Bromley 019D","E01000724","Total",133,35,27,71,26,2,8,16,107,33,19,55
"2011","Bromley 019E","E01000728","Total",72,20,17,35,8,0,5,3,64,20,12,32
"2011","Bromley 020A","E01000651","Total",25,10,11,4,2,0,2,0,23,10,9,4
"2011","Bromley 020B","E01000668","Total",46,17,19,10,3,0,3,0,43,17,16,10
"2011","Bromley 020C","E01000669","Total",65,25,32,8,6,0,4,2,59,25,28,6
"2011","Bromley 020D","E01000671","Total",37,11,17,9,1,0,1,0,36,11,16,9
"2011","Bromley 020E","E01000679","Total",54,15,26,13,6,1,4,1,48,14,22,12
"2011","Bromley 021A","E01000826","Total",10,4,2,4,0,0,0,0,10,4,2,4
"2011","Bromley 021B","E01000827","Total",35,10,13,12,5,0,4,1,30,10,9,11
"2011","Bromley 021C","E01000830","Total",21,7,11,3,5,0,5,0,16,7,6,3
"2011","Bromley 021D","E01000831","Total",24,6,14,4,2,1,1,0,22,5,13,4
"2011","Bromley 021E","E01000833","Total",25,11,7,7,2,0,1,1,23,11,6,6
"2011","Bromley 022A","E01000650","Total",31,11,8,12,2,1,1,0,29,10,7,12
"2011","Bromley 022B","E01000652","Total",32,10,15,7,0,0,0,0,32,10,15,7
"2011","Bromley 022C","E01000807","Total",44,12,18,14,10,0,8,2,34,12,10,12
"2011","Bromley 022D","E01000809","Total",23,11,7,5,3,1,2,0,20,10,5,5
"2011","Bromley 023A","E01000722","Total",72,22,13,37,7,2,3,2,65,20,10,35
"2011","Bromley 023B","E01000725","Total",97,28,17,52,10,1,8,1,87,27,9,51
"2011","Bromley 023C","E01000731","Total",88,31,18,39,11,0,7,4,77,31,11,35
"2011","Bromley 023D","E01000732","Total",41,19,7,15,3,1,1,1,38,18,6,14
"2011","Bromley 023E","E01000733","Total",62,18,16,28,5,0,2,3,57,18,14,25
"2011","Bromley 024A","E01000769","Total",28,9,7,12,1,0,1,0,27,9,6,12
"2011","Bromley 024B","E01000773","Total",33,13,12,8,4,0,3,1,29,13,9,7
"2011","Bromley 024C","E01000775","Total",53,17,23,13,4,0,4,0,49,17,19,13
"2011","Bromley 024D","E01000777","Total",35,14,12,9,4,1,3,0,31,13,9,9
"2011","Bromley 024E","E01000778","Total",47,12,18,17,4,0,3,1,43,12,15,16
"2011","Bromley 025A","E01000808","Total",29,10,8,11,0,0,0,0,29,10,8,11
"2011","Bromley 025B","E01000810","Total",18,8,8,2,3,1,2,0,15,7,6,2
"2011","Bromley 025C","E01000811","Total",34,9,15,10,1,0,1,0,33,9,14,10
"2011","Bromley 025D","E01000813","Total",22,8,9,5,4,1,2,1,18,7,7,4
"2011","Bromley 025E","E01000815","Total",13,4,7,2,3,1,2,0,10,3,5,2
"2011","Bromley 026A","E01000661","Total",147,37,29,81,9,1,2,6,138,36,27,75
"2011","Bromley 026B","E01000662","Total",59,22,13,24,5,1,1,3,54,21,12,21
"2011","Bromley 026C","E01000663","Total",59,15,8,36,8,0,2,6,51,15,6,30
"2011","Bromley 026D","E01000664","Total",65,18,18,29,4,1,2,1,61,17,16,28
"2011","Bromley 027A","E01000763","Total",24,8,8,8,0,0,0,0,24,8,8,8
"2011","Bromley 027B","E01000764","Total",43,20,12,11,1,0,1,0,42,20,11,11
"2011","Bromley 027C","E01000766","Total",21,7,13,1,0,0,0,0,21,7,13,1
"2011","Bromley 027D","E01000767","Total",20,4,11,5,1,0,1,0,19,4,10,5
"2011","Bromley 027E","E01000834","Total",38,12,22,4,11,0,10,1,27,12,12,3
"2011","Bromley 028A","E01000727","Total",40,14,10,16,0,0,0,0,40,14,10,16
"2011","Bromley 028B","E01000734","Total",60,18,17,25,6,0,6,0,54,18,11,25
"2011","Bromley 028C","E01000790","Total",60,23,11,26,2,0,2,0,58,23,9,26
"2011","Bromley 028D","E01000812","Total",30,9,10,11,1,1,0,0,29,8,10,11
"2011","Bromley 028E","E01000814","Total",8,1,6,1,3,0,3,0,5,1,3,1
"2011","Bromley 029A","E01000723","Total",24,8,11,5,3,2,1,0,21,6,10,5
"2011","Bromley 029B","E01000726","Total",29,16,8,5,5,2,3,0,24,14,5,5
"2011","Bromley 029C","E01000787","Total",40,16,11,13,3,0,2,1,37,16,9,12
"2011","Bromley 029D","E01000788","Total",43,16,12,15,4,0,2,2,39,16,10,13
"2011","Bromley 029E","E01000791","Total",33,14,13,6,2,0,2,0,31,14,11,6
"2011","Bromley 030A","E01000832","Total",16,7,6,3,2,0,2,0,14,7,4,3
"2011","Bromley 030B","E01000835","Total",61,20,27,14,6,0,6,0,55,20,21,14
"2011","Bromley 030C","E01000836","Total",38,12,22,4,4,0,4,0,34,12,18,4
"2011","Bromley 030D","E01000837","Total",40,13,13,14,2,0,1,1,38,13,12,13
"2011","Bromley 030E","E01000838","Total",16,8,5,3,1,0,0,1,15,8,5,2
"2011","Bromley 030F","E01000839","Total",18,12,5,1,1,0,1,0,17,12,4,1
"2011","Bromley 030G","E01000840","Total",15,7,6,2,1,0,1,0,14,7,5,2
"2011","Bromley 030H","E01000841","Total",26,10,7,9,2,0,1,1,24,10,6,8
"2011","Bromley 031A","E01000753","Total",30,10,10,10,6,2,2,2,24,8,8,8
"2011","Bromley 031B","E01000754","Total",55,25,15,15,3,1,0,2,52,24,15,13
"2011","Bromley 031C","E01000755","Total",29,14,11,4,2,0,1,1,27,14,10,3
"2011","Bromley 031D","E01000757","Total",14,7,4,3,0,0,0,0,14,7,4,3
"2011","Bromley 031E","E01000758","Total",29,12,13,4,1,0,1,0,28,12,12,4
"2011","Bromley 032A","E01000786","Total",19,5,7,7,4,0,3,1,15,5,4,6
"2011","Bromley 032B","E01000789","Total",166,40,24,102,13,2,6,5,153,38,18,97
"2011","Bromley 032C","E01000792","Total",42,13,9,20,1,0,1,0,41,13,8,20
"2011","Bromley 032D","E01000793","Total",14,5,5,4,2,0,2,0,12,5,3,4
"2011","Bromley 032E","E01000795","Total",40,12,5,23,1,1,0,0,39,11,5,23
"2011","Bromley 033A","E01000665","Total",60,27,13,20,6,2,3,1,54,25,10,19
"2011","Bromley 033B","E01000666","Total",28,14,6,8,0,0,0,0,28,14,6,8
"2011","Bromley 033C","E01000667","Total",21,8,7,6,3,0,3,0,18,8,4,6
"2011","Bromley 033D","E01000756","Total",26,10,5,11,3,0,3,0,23,10,2,11
"2011","Bromley 034A","E01000759","Total",22,10,7,5,3,2,1,0,19,8,6,5
"2011","Bromley 034B","E01000760","Total",34,12,12,10,2,2,0,0,32,10,12,10
"2011","Bromley 034C","E01000761","Total",28,9,15,4,2,0,2,0,26,9,13,4
"2011","Bromley 034D","E01000765","Total",34,10,16,8,4,0,4,0,30,10,12,8
"2011","Bromley 034E","E01000768","Total",32,10,11,11,3,1,2,0,29,9,9,11
"2011","Bromley 035A","E01000681","Total",23,9,7,7,0,0,0,0,23,9,7,7
"2011","Bromley 035B","E01000682","Total",32,15,14,3,3,0,3,0,29,15,11,3
"2011","Bromley 035C","E01000683","Total",42,11,18,13,4,2,0,2,38,9,18,11
"2011","Bromley 035D","E01000684","Total",32,10,14,8,4,1,2,1,28,9,12,7
"2011","Bromley 035E","E01000794","Total",14,8,3,3,1,0,1,0,13,8,2,3
"2011","Bromley 036A","E01000749","Total",24,15,5,4,4,3,1,0,20,12,4,4
"2011","Bromley 036B","E01000750","Total",82,27,20,35,5,0,2,3,77,27,18,32
"2011","Bromley 036C","E01000751","Total",54,15,24,15,4,0,3,1,50,15,21,14
"2011","Bromley 036D","E01000752","Total",45,17,16,12,2,0,2,0,43,17,14,12
"2011","Bromley 037A","E01000680","Total",22,12,5,5,4,1,3,0,18,11,2,5
"2011","Bromley 037B","E01000685","Total",36,17,12,7,4,2,2,0,32,15,10,7
"2011","Bromley 037C","E01000686","Total",30,11,11,8,3,0,3,0,27,11,8,8
"2011","Bromley 037D","E01000687","Total",39,17,9,13,5,1,1,3,34,16,8,10
"2011","Bromley 037E","E01000688","Total",8,4,2,2,0,0,0,0,8,4,2,2
"2011","Bromley 039A","E01000654","Total",28,11,12,5,2,0,1,1,26,11,11,4
"2011","Bromley 039B","E01000655","Total",40,16,14,10,3,0,2,1,37,16,12,9
"2011","Bromley 039C","E01000656","Total",17,9,7,1,2,0,2,0,15,9,5,1
"2011","Bromley 039D","E01000657","Total",61,24,19,18,3,0,3,0,58,24,16,18
"2011","Bromley 039E","E01000659","Total",28,11,8,9,3,0,3,0,25,11,5,9
"2011","Bromley 040A","E01000816","Total",43,14,14,15,5,1,2,2,38,13,12,13
"2011","Bromley 040B","E01000818","Total",34,15,7,12,3,0,2,1,31,15,5,11
"2011","Bromley 040C","E01000819","Total",98,32,22,44,3,0,1,2,95,32,21,42
"2011","Bromley 040D","E01032562","Total",120,35,22,63,9,2,3,4,111,33,19,59
"2011","Bromley 040E","E01032563","Total",19,5,10,4,2,0,2,0,17,5,8,4
"2011","Bromley 041A","E01000707","Total",22,5,12,5,2,1,1,0,20,4,11,5
"2011","Bromley 041B","E01000708","Total",43,15,13,15,6,1,3,2,37,14,10,13
"2011","Bromley 041C","E01000771","Total",26,6,14,6,3,1,2,0,23,5,12,6
"2011","Bromley 041D","E01000774","Total",40,18,17,5,2,0,0,2,38,18,17,3
"2011","Bromley 041E","E01032568","Total",75,23,22,30,2,0,2,0,73,23,20,30
"2011","Bromley 042A","E01000658","Total",25,8,7,10,4,2,2,0,21,6,5,10
"2011","Bromley 042B","E01000747","Total",51,18,9,24,6,2,2,2,45,16,7,22
"2011","Bromley 042C","E01000748","Total",22,5,10,7,2,1,1,0,20,4,9,7
"2011","Bromley 042D","E01032570","Total",50,19,18,13,6,0,5,1,44,19,13,12
"2011","Croydon 001A","E01001137","Total",88,35,22,31,8,2,6,0,80,33,16,31
"2011","Croydon 001B","E01001138","Total",86,29,33,24,6,0,5,1,80,29,28,23
"2011","Croydon 001C","E01001156","Total",93,28,25,40,16,5,8,3,77,23,17,37
"2011","Croydon 001D","E01001162","Total",137,48,26,63,8,1,3,4,129,47,23,59
"2011","Croydon 001E","E01001164","Total",96,34,29,33,9,6,2,1,87,28,27,32
"2011","Croydon 002A","E01001084","Total",41,8,13,20,16,0,4,12,25,8,9,8
"2011","Croydon 002B","E01001157","Total",43,10,17,16,8,1,6,1,35,9,11,15
"2011","Croydon 002C","E01001159","Total",70,18,25,27,5,0,3,2,65,18,22,25
"2011","Croydon 002D","E01001160","Total",36,7,17,12,3,1,2,0,33,6,15,12
"2011","Croydon 002E","E01001163","Total",72,19,25,28,6,1,3,2,66,18,22,26
"2011","Croydon 003A","E01001083","Total",26,8,9,9,3,0,2,1,23,8,7,8
"2011","Croydon 003B","E01001086","Total",50,10,26,14,8,1,4,3,42,9,22,11
"2011","Croydon 003C","E01001087","Total",83,19,30,34,7,3,2,2,76,16,28,32
"2011","Croydon 003D","E01001161","Total",101,27,25,49,3,0,2,1,98,27,23,48
"2011","Croydon 004A","E01001085","Total",43,9,7,27,4,1,1,2,39,8,6,25
"2011","Croydon 004B","E01001088","Total",81,21,27,33,3,0,0,3,78,21,27,30
"2011","Croydon 004C","E01001089","Total",103,32,23,48,5,2,1,2,98,30,22,46
"2011","Croydon 004D","E01001090","Total",155,33,40,82,7,2,3,2,148,31,37,80
"2011","Croydon 004E","E01001091","Total",34,7,15,12,3,0,3,0,31,7,12,12
"2011","Croydon 005A","E01001147","Total",134,34,29,71,20,0,8,12,114,34,21,59
"2011","Croydon 005B","E01001148","Total",102,22,38,42,6,0,1,5,96,22,37,37
"2011","Croydon 005C","E01001151","Total",113,42,26,45,12,5,3,4,101,37,23,41
"2011","Croydon 005D","E01001152","Total",119,39,37,43,18,3,12,3,101,36,25,40
"2011","Croydon 005E","E01001158","Total",110,25,38,47,13,3,5,5,97,22,33,42
"2011","Croydon 006A","E01001146","Total",89,29,33,27,6,1,4,1,83,28,29,26
"2011","Croydon 006B","E01001149","Total",105,25,44,36,11,0,9,2,94,25,35,34
"2011","Croydon 006C","E01001150","Total",88,21,45,22,9,3,5,1,79,18,40,21
"2011","Croydon 006D","E01001153","Total",78,17,25,36,7,0,4,3,71,17,21,33
"2011","Croydon 006E","E01001154","Total",154,46,46,62,10,2,6,2,144,44,40,60
"2011","Croydon 007A","E01001136","Total",122,35,30,57,7,0,3,4,115,35,27,53
"2011","Croydon 007B","E01001139","Total",81,25,23,33,8,1,6,1,73,24,17,32
"2011","Croydon 007C","E01001140","Total",97,31,31,35,10,5,4,1,87,26,27,34
"2011","Croydon 007D","E01001142","Total",75,14,20,41,8,2,3,3,67,12,17,38
"2011","Croydon 007E","E01001144","Total",131,30,24,77,14,0,4,10,117,30,20,67
"2011","Croydon 008A","E01001141","Total",98,25,40,33,14,4,10,0,84,21,30,33
"2011","Croydon 008B","E01001143","Total",140,34,45,61,15,3,8,4,125,31,37,57
"2011","Croydon 008C","E01001145","Total",174,51,38,85,10,0,4,6,164,51,34,79
"2011","Croydon 008D","E01001191","Total",119,27,32,60,19,1,10,8,100,26,22,52
"2011","Croydon 008E","E01001192","Total",141,39,41,61,12,2,4,6,129,37,37,55
"2011","Croydon 009A","E01000994","Total",64,17,19,28,7,2,3,2,57,15,16,26
"2011","Croydon 009B","E01000995","Total",61,8,23,30,8,2,5,1,53,6,18,29
"2011","Croydon 009C","E01000996","Total",48,14,22,12,7,4,1,2,41,10,21,10
"2011","Croydon 009D","E01000997","Total",54,13,15,26,6,2,1,3,48,11,14,23
"2011","Croydon 009E","E01000999","Total",34,7,16,11,5,1,3,1,29,6,13,10
"2011","Croydon 009F","E01001002","Total",64,28,21,15,6,1,4,1,58,27,17,14
"2011","Croydon 010A","E01000998","Total",92,30,26,36,8,6,2,0,84,24,24,36
"2011","Croydon 010B","E01001000","Total",49,12,17,20,7,3,2,2,42,9,15,18
"2011","Croydon 010C","E01001003","Total",94,17,34,43,9,3,3,3,85,14,31,40
"2011","Croydon 010D","E01001111","Total",98,28,38,32,15,1,8,6,83,27,30,26
"2011","Croydon 010E","E01001155","Total",106,31,24,51,17,1,9,7,89,30,15,44
"2011","Croydon 011A","E01001174","Total",58,13,17,28,5,1,1,3,53,12,16,25
"2011","Croydon 011B","E01001175","Total",81,23,31,27,7,1,5,1,74,22,26,26
"2011","Croydon 011C","E01001176","Total",100,40,26,34,2,0,2,0,98,40,24,34
"2011","Croydon 011D","E01001182","Total",51,12,15,24,4,0,3,1,47,12,12,23
"2011","Croydon 011E","E01001183","Total",67,14,13,40,12,0,2,10,55,14,11,30
"2011","Croydon 011F","E01001184","Total",45,12,12,21,3,0,1,2,42,12,11,19
"2011","Croydon 013A","E01001001","Total",68,17,25,26,7,1,4,2,61,16,21,24
"2011","Croydon 013B","E01001109","Total",150,51,26,73,12,3,3,6,138,48,23,67
"2011","Croydon 013C","E01001112","Total",153,39,43,71,18,1,11,6,135,38,32,65
"2011","Croydon 013D","E01001113","Total",138,26,57,55,23,0,16,7,115,26,41,48
"2011","Croydon 013E","E01001114","Total",148,36,49,63,7,1,5,1,141,35,44,62
"2011","Croydon 013F","E01001116","Total",85,27,25,33,2,1,0,1,83,26,25,32
"2011","Croydon 014A","E01000992","Total",118,35,31,52,11,1,7,3,107,34,24,49
"2011","Croydon 014B","E01001185","Total",95,29,29,37,3,1,0,2,92,28,29,35
"2011","Croydon 014C","E01001186","Total",129,32,39,58,17,0,3,14,112,32,36,44
"2011","Croydon 014D","E01001188","Total",129,37,28,64,6,2,0,4,123,35,28,60
"2011","Croydon 014E","E01001193","Total",163,41,42,80,8,1,4,3,155,40,38,77
"2011","Croydon 015A","E01001004","Total",155,47,39,69,8,3,2,3,147,44,37,66
"2011","Croydon 015B","E01001115","Total",111,28,19,64,9,1,1,7,102,27,18,57
"2011","Croydon 015C","E01001117","Total",158,44,38,76,9,3,5,1,149,41,33,75
"2011","Croydon 015D","E01001178","Total",98,18,14,66,13,1,2,10,85,17,12,56
"2011","Croydon 015E","E01001181","Total",169,49,50,70,18,5,10,3,151,44,40,67
"2011","Croydon 016A","E01001006","Total",128,42,22,64,8,0,1,7,120,42,21,57
"2011","Croydon 016B","E01001007","Total",57,18,17,22,4,1,1,2,53,17,16,20
"2011","Croydon 016C","E01001177","Total",89,31,19,39,4,1,1,2,85,30,18,37
"2011","Croydon 016D","E01001179","Total",65,16,20,29,4,0,2,2,61,16,18,27
"2011","Croydon 016E","E01001180","Total",113,42,24,47,12,3,4,5,101,39,20,42
"2011","Croydon 017A","E01000980","Total",62,15,20,27,1,0,1,0,61,15,19,27
"2011","Croydon 017B","E01000981","Total",67,23,27,17,4,0,2,2,63,23,25,15
"2011","Croydon 017C","E01000982","Total",84,26,26,32,8,0,6,2,76,26,20,30
"2011","Croydon 017D","E01000983","Total",46,22,18,6,5,1,3,1,41,21,15,5
"2011","Croydon 017E","E01001187","Total",109,25,33,51,6,1,2,3,103,24,31,48
"2011","Croydon 018A","E01000989","Total",53,22,16,15,6,1,5,0,47,21,11,15
"2011","Croydon 018B","E01000991","Total",28,9,13,6,3,0,2,1,25,9,11,5
"2011","Croydon 018C","E01001131","Total",69,21,29,19,7,1,1,5,62,20,28,14
"2011","Croydon 018D","E01001132","Total",19,7,8,4,1,0,1,0,18,7,7,4
"2011","Croydon 018E","E01001134","Total",38,10,16,12,2,1,1,0,36,9,15,12
"2011","Croydon 019A","E01001005","Total",55,22,9,24,6,1,0,5,49,21,9,19
"2011","Croydon 019B","E01001008","Total",100,28,20,52,6,0,3,3,94,28,17,49
"2011","Croydon 019C","E01001009","Total",78,22,19,37,2,2,0,0,76,20,19,37
"2011","Croydon 019D","E01001010","Total",117,35,30,52,8,2,5,1,109,33,25,51
"2011","Croydon 019E","E01001011","Total",105,26,33,46,6,2,3,1,99,24,30,45
"2011","Croydon 020A","E01001012","Total",87,11,17,59,7,3,2,2,80,8,15,57
"2011","Croydon 020B","E01001013","Total",163,28,40,95,16,0,3,13,147,28,37,82
"2011","Croydon 020C","E01001048","Total",130,48,17,65,6,0,2,4,124,48,15,61
"2011","Croydon 020D","E01001110","Total",123,41,24,58,14,1,5,8,109,40,19,50
"2011","Croydon 020E","E01001118","Total",148,35,34,79,27,1,8,18,121,34,26,61
"2011","Croydon 021A","E01000985","Total",25,11,9,5,2,0,2,0,23,11,7,5
"2011","Croydon 021B","E01000986","Total",42,11,12,19,1,0,1,0,41,11,11,19
"2011","Croydon 021C","E01000987","Total",24,15,7,2,4,2,1,1,20,13,6,1
"2011","Croydon 021D","E01000993","Total",62,26,15,21,2,0,0,2,60,26,15,19
"2011","Croydon 022A","E01000975","Total",66,15,23,28,5,3,1,1,61,12,22,27
"2011","Croydon 022B","E01000976","Total",89,18,24,47,11,3,7,1,78,15,17,46
"2011","Croydon 022C","E01000977","Total",68,24,13,31,5,0,1,4,63,24,12,27
"2011","Croydon 022D","E01000978","Total",59,10,9,40,7,0,2,5,52,10,7,35
"2011","Croydon 022E","E01000979","Total",41,6,16,19,4,0,2,2,37,6,14,17
"2011","Croydon 022F","E01000984","Total",85,20,14,51,5,0,2,3,80,20,12,48
"2011","Croydon 023A","E01001044","Total",28,14,4,10,9,9,0,0,19,5,4,10
"2011","Croydon 023B","E01001046","Total",25,12,6,7,2,0,2,0,23,12,4,7
"2011","Croydon 023C","E01001049","Total",21,7,5,9,2,2,0,0,19,5,5,9
"2011","Croydon 023D","E01001050","Total",48,13,7,28,4,1,3,0,44,12,4,28
"2011","Croydon 024A","E01001014","Total",214,61,37,116,22,7,5,10,192,54,32,106
"2011","Croydon 024B","E01001042","Total",106,33,22,51,6,2,3,1,100,31,19,50
"2011","Croydon 024C","E01001165","Total",60,22,18,20,9,2,4,3,51,20,14,17
"2011","Croydon 024D","E01001166","Total",127,31,22,74,18,3,3,12,109,28,19,62
"2011","Croydon 024E","E01001168","Total",50,11,13,26,3,1,1,1,47,10,12,25
"2011","Croydon 025A","E01001127","Total",22,9,6,7,1,1,0,0,21,8,6,7
"2011","Croydon 025B","E01001128","Total",125,38,29,58,4,0,2,2,121,38,27,56
"2011","Croydon 025C","E01001130","Total",220,61,39,120,29,3,8,18,191,58,31,102
"2011","Croydon 025D","E01001135","Total",28,9,11,8,3,0,3,0,25,9,8,8
"2011","Croydon 026A","E01001062","Total",23,8,4,11,0,0,0,0,23,8,4,11
"2011","Croydon 026B","E01001063","Total",31,12,9,10,4,1,3,0,27,11,6,10
"2011","Croydon 026C","E01001064","Total",28,16,4,8,3,3,0,0,25,13,4,8
"2011","Croydon 026D","E01001129","Total",13,4,7,2,2,0,2,0,11,4,5,2
"2011","Croydon 026E","E01001133","Total",20,10,7,3,4,0,4,0,16,10,3,3
"2011","Croydon 027A","E01001035","Total",50,23,12,15,3,2,1,0,47,21,11,15
"2011","Croydon 027B","E01001043","Total",158,43,43,72,15,4,9,2,143,39,34,70
"2011","Croydon 027C","E01001045","Total",64,28,14,22,11,1,3,7,53,27,11,15
"2011","Croydon 027D","E01001047","Total",58,18,13,27,14,2,1,11,44,16,12,16
"2011","Croydon 027E","E01001170","Total",141,51,48,42,11,2,7,2,130,49,41,40
"2011","Croydon 028A","E01001167","Total",88,25,24,39,6,3,0,3,82,22,24,36
"2011","Croydon 028B","E01001169","Total",110,35,24,51,6,1,1,4,104,34,23,47
"2011","Croydon 028C","E01001171","Total",128,30,27,71,8,0,3,5,120,30,24,66
"2011","Croydon 028D","E01001172","Total",119,30,22,67,4,0,2,2,115,30,20,65
"2011","Croydon 028E","E01001173","Total",156,40,54,62,11,4,7,0,145,36,47,62
"2011","Croydon 029A","E01001036","Total",14,6,6,2,0,0,0,0,14,6,6,2
"2011","Croydon 029B","E01001037","Total",83,23,23,37,9,0,6,3,74,23,17,34
"2011","Croydon 029C","E01001038","Total",52,12,20,20,2,0,2,0,50,12,18,20
"2011","Croydon 029D","E01001039","Total",18,6,6,6,1,0,1,0,17,6,5,6
"2011","Croydon 029E","E01001040","Total",85,19,30,36,21,2,16,3,64,17,14,33
"2011","Croydon 030A","E01001051","Total",122,42,20,60,11,4,2,5,111,38,18,55
"2011","Croydon 030B","E01001052","Total",123,46,14,63,13,8,3,2,110,38,11,61
"2011","Croydon 030C","E01001054","Total",98,27,12,59,6,1,1,4,92,26,11,55
"2011","Croydon 030D","E01001056","Total",196,60,27,109,17,2,6,9,179,58,21,100
"2011","Croydon 030E","E01001057","Total",254,71,51,132,21,2,10,9,233,69,41,123
"2011","Croydon 031A","E01001033","Total",56,18,17,21,4,2,1,1,52,16,16,20
"2011","Croydon 031B","E01001034","Total",49,10,14,25,12,0,3,9,37,10,11,16
"2011","Croydon 031C","E01001041","Total",85,16,24,45,5,0,3,2,80,16,21,43
"2011","Croydon 031D","E01001095","Total",53,16,11,26,1,1,0,0,52,15,11,26
"2011","Croydon 031E","E01001100","Total",28,11,10,7,0,0,0,0,28,11,10,7
"2011","Croydon 032A","E01001053","Total",70,29,13,28,2,1,1,0,68,28,12,28
"2011","Croydon 032B","E01001055","Total",79,24,14,41,8,2,0,6,71,22,14,35
"2011","Croydon 032C","E01001077","Total",51,15,13,23,4,1,2,1,47,14,11,22
"2011","Croydon 032D","E01001078","Total",94,35,13,46,8,2,6,0,86,33,7,46
"2011","Croydon 032E","E01001082","Total",110,34,12,64,7,1,2,4,103,33,10,60
"2011","Croydon 033A","E01001120","Total",32,12,16,4,4,1,3,0,28,11,13,4
"2011","Croydon 033B","E01001122","Total",20,4,11,5,7,0,5,2,13,4,6,3
"2011","Croydon 033C","E01001123","Total",22,9,8,5,1,0,1,0,21,9,7,5
"2011","Croydon 033D","E01001124","Total",7,2,2,3,1,0,1,0,6,2,1,3
"2011","Croydon 033E","E01001125","Total",33,5,11,17,4,0,3,1,29,5,8,16
"2011","Croydon 034A","E01001058","Total",45,18,14,13,2,1,1,0,43,17,13,13
"2011","Croydon 034B","E01001059","Total",54,21,22,11,4,1,2,1,50,20,20,10
"2011","Croydon 034C","E01001060","Total",57,19,24,14,5,0,5,0,52,19,19,14
"2011","Croydon 034D","E01001061","Total",63,16,19,28,5,1,2,2,58,15,17,26
"2011","Croydon 034E","E01001065","Total",19,5,5,9,1,0,0,1,18,5,5,8
"2011","Croydon 034F","E01001066","Total",116,35,24,57,2,0,2,0,114,35,22,57
"2011","Croydon 034G","E01001119","Total",27,9,11,7,7,0,5,2,20,9,6,5
"2011","Croydon 034H","E01001126","Total",38,15,13,10,3,0,3,0,35,15,10,10
"2011","Croydon 035A","E01001032","Total",11,5,4,2,4,0,2,2,7,5,2,0
"2011","Croydon 035B","E01001101","Total",6,0,4,2,2,0,2,0,4,0,2,2
"2011","Croydon 035C","E01001102","Total",18,7,6,5,1,0,1,0,17,7,5,5
"2011","Croydon 035D","E01001107","Total",23,5,5,13,1,0,0,1,22,5,5,12
"2011","Croydon 035E","E01001108","Total",21,3,12,6,3,0,2,1,18,3,10,5
"2011","Croydon 036A","E01001076","Total",94,31,13,50,2,0,0,2,92,31,13,48
"2011","Croydon 036B","E01001079","Total",123,46,12,65,6,2,0,4,117,44,12,61
"2011","Croydon 036C","E01001080","Total",139,52,18,69,16,2,6,8,123,50,12,61
"2011","Croydon 036D","E01001081","Total",77,21,14,42,3,0,1,2,74,21,13,40
"2011","Croydon 037A","E01001073","Total",38,12,14,12,5,0,4,1,33,12,10,11
"2011","Croydon 037B","E01001092","Total",26,2,14,10,5,0,4,1,21,2,10,9
"2011","Croydon 037C","E01001093","Total",76,20,20,36,2,0,0,2,74,20,20,34
"2011","Croydon 037D","E01001096","Total",24,8,7,9,6,2,0,4,18,6,7,5
"2011","Croydon 037E","E01001097","Total",86,20,31,35,6,0,6,0,80,20,25,35
"2011","Croydon 037F","E01001098","Total",21,7,4,10,3,0,2,1,18,7,2,9
"2011","Croydon 038A","E01001028","Total",16,2,8,6,3,0,2,1,13,2,6,5
"2011","Croydon 038B","E01001029","Total",28,6,11,11,4,0,2,2,24,6,9,9
"2011","Croydon 038C","E01001030","Total",11,4,2,5,1,0,1,0,10,4,1,5
"2011","Croydon 038D","E01001031","Total",15,3,7,5,4,1,2,1,11,2,5,4
"2011","Croydon 038E","E01001094","Total",14,2,7,5,4,0,3,1,10,2,4,4
"2011","Croydon 039A","E01001103","Total",27,9,7,11,2,0,2,0,25,9,5,11
"2011","Croydon 039B","E01001105","Total",57,20,17,20,3,0,2,1,54,20,15,19
"2011","Croydon 039C","E01001106","Total",43,11,15,17,4,0,4,0,39,11,11,17
"2011","Croydon 039D","E01001121","Total",9,2,4,3,0,0,0,0,9,2,4,3
"2011","Croydon 040A","E01001069","Total",32,16,9,7,2,1,0,1,30,15,9,6
"2011","Croydon 040B","E01001070","Total",66,22,16,28,3,1,2,0,63,21,14,28
"2011","Croydon 040C","E01001075","Total",49,15,17,17,4,0,2,2,45,15,15,15
"2011","Croydon 040D","E01001099","Total",70,20,14,36,4,2,1,1,66,18,13,35
"2011","Croydon 041A","E01001015","Total",65,14,16,35,1,0,0,1,64,14,16,34
"2011","Croydon 041B","E01001016","Total",44,12,19,13,5,0,4,1,39,12,15,12
"2011","Croydon 041C","E01001023","Total",43,21,11,11,7,3,1,3,36,18,10,8
"2011","Croydon 041D","E01001067","Total",12,4,5,3,2,0,2,0,10,4,3,3
"2011","Croydon 041E","E01001074","Total",92,37,25,30,10,1,5,4,82,36,20,26
"2011","Croydon 042A","E01001068","Total",97,29,27,41,10,0,6,4,87,29,21,37
"2011","Croydon 042B","E01001071","Total",61,20,16,25,5,1,4,0,56,19,12,25
"2011","Croydon 042C","E01001072","Total",18,7,4,7,1,0,1,0,17,7,3,7
"2011","Croydon 042D","E01001104","Total",28,5,13,10,3,0,2,1,25,5,11,9
"2011","Croydon 043A","E01001017","Total",25,12,9,4,3,1,2,0,22,11,7,4
"2011","Croydon 043B","E01001024","Total",41,18,7,16,4,0,4,0,37,18,3,16
"2011","Croydon 043C","E01001025","Total",34,14,9,11,5,0,4,1,29,14,5,10
"2011","Croydon 043D","E01001026","Total",48,20,11,17,3,1,1,1,45,19,10,16
"2011","Croydon 043E","E01001027","Total",37,9,18,10,6,0,6,0,31,9,12,10
"2011","Croydon 044A","E01001018","Total",24,9,10,5,4,1,3,0,20,8,7,5
"2011","Croydon 044B","E01001019","Total",7,3,2,2,0,0,0,0,7,3,2,2
"2011","Croydon 044C","E01001020","Total",42,18,10,14,4,1,3,0,38,17,7,14
"2011","Croydon 044D","E01001021","Total",82,34,12,36,3,2,1,0,79,32,11,36
"2011","Croydon 044E","E01001022","Total",23,11,6,6,3,1,1,1,20,10,5,5
"2011","Croydon 045A","E01000990","Total",96,26,26,44,8,2,0,6,88,24,26,38
"2011","Croydon 045B","E01001189","Total",63,21,16,26,4,2,1,1,59,19,15,25
"2011","Croydon 045C","E01001190","Total",111,35,37,39,2,2,0,0,109,33,37,39
"2011","Croydon 045D","E01001194","Total",96,29,34,33,3,2,1,0,93,27,33,33
"2011","Croydon 045E","E01032569","Total",184,62,47,75,12,1,8,3,172,61,39,72
"2011","Ealing 001A","E01001269","Total",42,13,15,14,3,0,2,1,39,13,13,13
"2011","Ealing 001B","E01001271","Total",38,15,9,14,0,0,0,0,38,15,9,14
"2011","Ealing 001C","E01001309","Total",24,6,9,9,3,0,3,0,21,6,6,9
"2011","Ealing 001D","E01001310","Total",70,17,19,34,7,1,4,2,63,16,15,32
"2011","Ealing 001E","E01001311","Total",82,18,19,45,2,0,1,1,80,18,18,44
"2011","Ealing 002A","E01001307","Total",27,10,9,8,1,0,1,0,26,10,8,8
"2011","Ealing 002B","E01001308","Total",24,8,6,10,1,1,0,0,23,7,6,10
"2011","Ealing 002C","E01001312","Total",38,12,11,15,0,0,0,0,38,12,11,15
"2011","Ealing 002D","E01001313","Total",22,8,6,8,3,3,0,0,19,5,6,8
"2011","Ealing 002E","E01001314","Total",31,16,9,6,1,0,0,1,30,16,9,5
"2011","Ealing 003A","E01001315","Total",40,6,17,17,3,0,2,1,37,6,15,16
"2011","Ealing 003B","E01001316","Total",112,24,20,68,5,1,0,4,107,23,20,64
"2011","Ealing 003C","E01001317","Total",85,24,18,43,3,0,3,0,82,24,15,43
"2011","Ealing 003D","E01001318","Total",101,22,23,56,8,1,2,5,93,21,21,51
"2011","Ealing 003E","E01001320","Total",127,34,28,65,5,0,2,3,122,34,26,62
"2011","Ealing 003F","E01001321","Total",82,22,21,39,2,0,0,2,80,22,21,37
"2011","Ealing 004A","E01001270","Total",48,11,21,16,6,0,4,2,42,11,17,14
"2011","Ealing 004B","E01001319","Total",42,9,13,20,3,0,1,2,39,9,12,18
"2011","Ealing 004C","E01001322","Total",58,15,17,26,3,0,3,0,55,15,14,26
"2011","Ealing 004D","E01001323","Total",55,17,12,26,4,3,1,0,51,14,11,26
"2011","Ealing 005A","E01001341","Total",15,3,4,8,0,0,0,0,15,3,4,8
"2011","Ealing 005B","E01001342","Total",40,8,12,20,5,0,3,2,35,8,9,18
"2011","Ealing 005C","E01001343","Total",32,9,8,15,0,0,0,0,32,9,8,15
"2011","Ealing 005D","E01001345","Total",38,15,9,14,1,1,0,0,37,14,9,14
"2011","Ealing 006A","E01001265","Total",53,9,20,24,5,0,4,1,48,9,16,23
"2011","Ealing 006B","E01001266","Total",27,7,9,11,1,0,1,0,26,7,8,11
"2011","Ealing 006C","E01001267","Total",70,22,14,34,3,1,1,1,67,21,13,33
"2011","Ealing 006D","E01001272","Total",33,13,10,10,6,3,2,1,27,10,8,9
"2011","Ealing 006E","E01001349","Total",50,13,18,19,3,1,1,1,47,12,17,18
"2011","Ealing 007A","E01001344","Total",77,20,17,40,7,0,1,6,70,20,16,34
"2011","Ealing 007B","E01001346","Total",28,10,8,10,0,0,0,0,28,10,8,10
"2011","Ealing 007C","E01001347","Total",25,12,5,8,1,0,0,1,24,12,5,7
"2011","Ealing 007D","E01001348","Total",48,15,18,15,1,1,0,0,47,14,18,15
"2011","Ealing 008A","E01001257","Total",124,30,22,72,8,1,1,6,116,29,21,66
"2011","Ealing 008B","E01001324","Total",86,21,13,52,3,2,0,1,83,19,13,51
"2011","Ealing 008C","E01001326","Total",105,20,19,66,1,1,0,0,104,19,19,66
"2011","Ealing 008D","E01001330","Total",76,20,7,49,2,1,1,0,74,19,6,49
"2011","Ealing 008E","E01001332","Total",92,16,20,56,8,1,3,4,84,15,17,52
"2011","Ealing 009A","E01001325","Total",64,17,16,31,3,1,2,0,61,16,14,31
"2011","Ealing 009B","E01001327","Total",46,13,8,25,1,0,1,0,45,13,7,25
"2011","Ealing 009C","E01001328","Total",95,22,19,54,2,0,2,0,93,22,17,54
"2011","Ealing 009D","E01001329","Total",79,41,20,18,2,0,2,0,77,41,18,18
"2011","Ealing 009E","E01001331","Total",141,32,29,80,11,1,3,7,130,31,26,73
"2011","Ealing 010B","E01001258","Total",47,18,12,17,3,0,2,1,44,18,10,16
"2011","Ealing 010C","E01001262","Total",55,16,12,27,3,0,0,3,52,16,12,24
"2011","Ealing 010D","E01001263","Total",68,14,12,42,3,2,1,0,65,12,11,42
"2011","Ealing 010E","E01001264","Total",66,16,19,31,2,0,1,1,64,16,18,30
"2011","Ealing 010F","E01032743","Total",166,39,24,103,5,0,0,5,161,39,24,98
"2011","Ealing 010G","E01032744","Total",59,12,14,33,6,0,3,3,53,12,11,30
"2011","Ealing 011A","E01001276","Total",43,11,11,21,3,0,3,0,40,11,8,21
"2011","Ealing 011B","E01001277","Total",40,8,12,20,4,0,3,1,36,8,9,19
"2011","Ealing 011C","E01001278","Total",51,9,13,29,1,0,1,0,50,9,12,29
"2011","Ealing 011D","E01001280","Total",48,7,10,31,2,0,2,0,46,7,8,31
"2011","Ealing 012A","E01001218","Total",73,22,14,37,4,0,2,2,69,22,12,35
"2011","Ealing 012B","E01001260","Total",29,9,10,10,2,0,2,0,27,9,8,10
"2011","Ealing 012C","E01001261","Total",66,25,14,27,3,0,1,2,63,25,13,25
"2011","Ealing 012D","E01001268","Total",30,7,8,15,0,0,0,0,30,7,8,15
"2011","Ealing 013A","E01001209","Total",38,15,17,6,3,1,2,0,35,14,15,6
"2011","Ealing 013B","E01001211","Total",31,7,10,14,1,0,1,0,30,7,9,14
"2011","Ealing 013C","E01001279","Total",19,6,10,3,0,0,0,0,19,6,10,3
"2011","Ealing 013D","E01001281","Total",21,7,10,4,2,0,2,0,19,7,8,4
"2011","Ealing 014A","E01001217","Total",31,4,11,16,4,0,2,2,27,4,9,14
"2011","Ealing 014B","E01001259","Total",45,11,10,24,5,1,4,0,40,10,6,24
"2011","Ealing 014C","E01001291","Total",37,8,11,18,1,0,1,0,36,8,10,18
"2011","Ealing 014D","E01001292","Total",24,9,8,7,1,0,1,0,23,9,7,7
"2011","Ealing 014E","E01001293","Total",33,8,7,18,1,0,0,1,32,8,7,17
"2011","Ealing 015A","E01001196","Total",110,23,27,60,6,0,5,1,104,23,22,59
"2011","Ealing 015B","E01001238","Total",120,28,27,65,6,1,2,3,114,27,25,62
"2011","Ealing 015C","E01001239","Total",73,23,21,29,3,1,2,0,70,22,19,29
"2011","Ealing 015D","E01001246","Total",49,13,13,23,2,0,0,2,47,13,13,21
"2011","Ealing 015E","E01001247","Total",70,14,7,49,6,3,1,2,64,11,6,47
"2011","Ealing 016A","E01001210","Total",91,24,19,48,4,2,2,0,87,22,17,48
"2011","Ealing 016B","E01001282","Total",75,15,24,36,4,1,1,2,71,14,23,34
"2011","Ealing 016C","E01001283","Total",72,17,16,39,6,1,0,5,66,16,16,34
"2011","Ealing 016D","E01001285","Total",57,22,11,24,1,0,1,0,56,22,10,24
"2011","Ealing 016E","E01001286","Total",79,25,21,33,4,0,2,2,75,25,19,31
"2011","Ealing 016F","E01001287","Total",75,26,14,35,2,0,2,0,73,26,12,35
"2011","Ealing 017A","E01001294","Total",31,10,7,14,2,0,1,1,29,10,6,13
"2011","Ealing 017B","E01001295","Total",19,7,8,4,2,0,2,0,17,7,6,4
"2011","Ealing 017C","E01001296","Total",26,5,8,13,1,0,0,1,25,5,8,12
"2011","Ealing 017D","E01001297","Total",20,6,0,14,0,0,0,0,20,6,0,14
"2011","Ealing 017E","E01001298","Total",31,7,6,18,1,0,0,1,30,7,6,17
"2011","Ealing 018A","E01001204","Total",30,7,12,11,1,0,1,0,29,7,11,11
"2011","Ealing 018B","E01001205","Total",73,22,8,43,6,1,3,2,67,21,5,41
"2011","Ealing 018C","E01001206","Total",129,20,23,86,7,0,5,2,122,20,18,84
"2011","Ealing 018D","E01001207","Total",38,13,17,8,2,0,1,1,36,13,16,7
"2011","Ealing 018E","E01001208","Total",24,12,8,4,4,0,4,0,20,12,4,4
"2011","Ealing 018F","E01001212","Total",21,6,7,8,3,1,2,0,18,5,5,8
"2011","Ealing 019A","E01001222","Total",74,24,14,36,0,0,0,0,74,24,14,36
"2011","Ealing 019B","E01001224","Total",18,6,9,3,2,0,2,0,16,6,7,3
"2011","Ealing 019C","E01001226","Total",33,7,17,9,0,0,0,0,33,7,17,9
"2011","Ealing 019D","E01001227","Total",15,2,9,4,1,0,1,0,14,2,8,4
"2011","Ealing 019E","E01001228","Total",25,6,5,14,1,0,1,0,24,6,4,14
"2011","Ealing 020A","E01001221","Total",25,4,8,13,3,0,1,2,22,4,7,11
"2011","Ealing 020B","E01001223","Total",17,1,5,11,1,0,0,1,16,1,5,10
"2011","Ealing 020C","E01001225","Total",35,10,10,15,3,0,2,1,32,10,8,14
"2011","Ealing 020D","E01001235","Total",26,4,13,9,5,0,3,2,21,4,10,7
"2011","Ealing 020E","E01001236","Total",32,11,3,18,0,0,0,0,32,11,3,18
"2011","Ealing 020F","E01001273","Total",15,5,3,7,0,0,0,0,15,5,3,7
"2011","Ealing 020G","E01001274","Total",37,12,13,12,5,0,5,0,32,12,8,12
"2011","Ealing 020H","E01001275","Total",30,6,11,13,4,0,2,2,26,6,9,11
"2011","Ealing 021A","E01001195","Total",32,8,5,19,2,1,0,1,30,7,5,18
"2011","Ealing 021B","E01001197","Total",42,10,11,21,0,0,0,0,42,10,11,21
"2011","Ealing 021C","E01001198","Total",40,10,7,23,2,1,1,0,38,9,6,23
"2011","Ealing 021D","E01001199","Total",80,19,23,38,6,1,1,4,74,18,22,34
"2011","Ealing 022A","E01001284","Total",40,13,12,15,2,0,1,1,38,13,11,14
"2011","Ealing 022B","E01001288","Total",51,14,17,20,4,1,3,0,47,13,14,20
"2011","Ealing 022C","E01001289","Total",33,9,7,17,4,0,1,3,29,9,6,14
"2011","Ealing 022D","E01001290","Total",41,14,14,13,0,0,0,0,41,14,14,13
"2011","Ealing 023A","E01001213","Total",28,10,4,14,1,0,0,1,27,10,4,13
"2011","Ealing 023B","E01001214","Total",18,2,6,10,2,0,2,0,16,2,4,10
"2011","Ealing 023C","E01001215","Total",36,6,8,22,4,2,1,1,32,4,7,21
"2011","Ealing 023D","E01001216","Total",25,8,9,8,1,0,0,1,24,8,9,7
"2011","Ealing 023E","E01001361","Total",38,8,8,22,6,0,3,3,32,8,5,19
"2011","Ealing 024A","E01001240","Total",40,9,7,24,1,1,0,0,39,8,7,24
"2011","Ealing 024B","E01001241","Total",33,8,8,17,1,0,1,0,32,8,7,17
"2011","Ealing 024C","E01001242","Total",50,13,15,22,2,1,0,1,48,12,15,21
"2011","Ealing 024D","E01001243","Total",81,26,14,41,6,2,2,2,75,24,12,39
"2011","Ealing 024E","E01001244","Total",110,24,20,66,11,2,2,7,99,22,18,59
"2011","Ealing 024F","E01001245","Total",59,8,21,30,4,0,4,0,55,8,17,30
"2011","Ealing 025A","E01001200","Total",32,9,11,12,2,0,2,0,30,9,9,12
"2011","Ealing 025B","E01001201","Total",49,17,19,13,6,1,3,2,43,16,16,11
"2011","Ealing 025C","E01001202","Total",93,25,20,48,6,3,1,2,87,22,19,46
"2011","Ealing 025D","E01001203","Total",62,22,14,26,8,3,3,2,54,19,11,24
"2011","Ealing 025E","E01001351","Total",59,23,11,25,3,1,2,0,56,22,9,25
"2011","Ealing 026A","E01001359","Total",31,6,8,17,2,0,2,0,29,6,6,17
"2011","Ealing 026B","E01001360","Total",21,2,6,13,3,0,3,0,18,2,3,13
"2011","Ealing 026C","E01001362","Total",21,7,6,8,3,0,3,0,18,7,3,8
"2011","Ealing 026D","E01001363","Total",33,6,8,19,1,1,0,0,32,5,8,19
"2011","Ealing 026E","E01001364","Total",48,11,10,27,2,1,0,1,46,10,10,26
"2011","Ealing 026F","E01001365","Total",35,7,7,21,5,1,1,3,30,6,6,18
"2011","Ealing 027A","E01001231","Total",31,10,10,11,3,1,1,1,28,9,9,10
"2011","Ealing 027B","E01001234","Total",31,6,4,21,2,1,0,1,29,5,4,20
"2011","Ealing 027C","E01001350","Total",27,6,8,13,3,1,1,1,24,5,7,12
"2011","Ealing 027D","E01001352","Total",26,6,9,11,4,0,4,0,22,6,5,11
"2011","Ealing 027E","E01001354","Total",20,5,4,11,0,0,0,0,20,5,4,11
"2011","Ealing 028A","E01001249","Total",128,36,27,65,7,1,1,5,121,35,26,60
"2011","Ealing 028B","E01001250","Total",95,26,23,46,5,0,3,2,90,26,20,44
"2011","Ealing 028C","E01001255","Total",28,5,10,13,2,0,2,0,26,5,8,13
"2011","Ealing 028D","E01001383","Total",26,4,9,13,5,0,3,2,21,4,6,11
"2011","Ealing 028E","E01001388","Total",67,17,13,37,3,0,2,1,64,17,11,36
"2011","Ealing 028F","E01001389","Total",26,6,9,11,0,0,0,0,26,6,9,11
"2011","Ealing 029A","E01001219","Total",104,29,20,55,8,2,2,4,96,27,18,51
"2011","Ealing 029B","E01001220","Total",73,17,9,47,4,1,1,2,69,16,8,45
"2011","Ealing 029C","E01001334","Total",60,15,8,37,7,1,2,4,53,14,6,33
"2011","Ealing 029D","E01001337","Total",43,5,15,23,6,0,3,3,37,5,12,20
"2011","Ealing 029E","E01001338","Total",40,10,8,22,2,0,1,1,38,10,7,21
"2011","Ealing 029F","E01001339","Total",89,18,20,51,3,0,1,2,86,18,19,49
"2011","Ealing 029G","E01001340","Total",80,19,27,34,7,1,2,4,73,18,25,30
"2011","Ealing 030A","E01001251","Total",42,17,11,14,4,1,2,1,38,16,9,13
"2011","Ealing 030B","E01001252","Total",60,25,14,21,2,0,0,2,58,25,14,19
"2011","Ealing 030C","E01001253","Total",58,17,18,23,1,0,1,0,57,17,17,23
"2011","Ealing 030D","E01001254","Total",37,10,15,12,3,0,1,2,34,10,14,10
"2011","Ealing 031A","E01001229","Total",74,22,11,41,1,0,0,1,73,22,11,40
"2011","Ealing 031B","E01001230","Total",23,9,6,8,1,0,1,0,22,9,5,8
"2011","Ealing 031C","E01001232","Total",49,14,10,25,6,1,2,3,43,13,8,22
"2011","Ealing 031D","E01001233","Total",28,7,5,16,0,0,0,0,28,7,5,16
"2011","Ealing 031E","E01001237","Total",22,9,6,7,2,1,1,0,20,8,5,7
"2011","Ealing 031F","E01001386","Total",20,4,8,8,1,0,0,1,19,4,8,7
"2011","Ealing 032A","E01001303","Total",29,4,16,9,4,0,4,0,25,4,12,9
"2011","Ealing 032B","E01001382","Total",13,3,7,3,5,0,4,1,8,3,3,2
"2011","Ealing 032C","E01001384","Total",22,4,9,9,0,0,0,0,22,4,9,9
"2011","Ealing 032D","E01001385","Total",20,4,10,6,2,0,1,1,18,4,9,5
"2011","Ealing 032E","E01001387","Total",30,7,9,14,4,0,3,1,26,7,6,13
"2011","Ealing 033A","E01001353","Total",53,9,10,34,3,0,0,3,50,9,10,31
"2011","Ealing 033B","E01001355","Total",48,13,8,27,6,3,0,3,42,10,8,24
"2011","Ealing 033C","E01001356","Total",104,19,19,66,5,0,0,5,99,19,19,61
"2011","Ealing 033D","E01001357","Total",65,19,15,31,6,2,2,2,59,17,13,29
"2011","Ealing 033E","E01001358","Total",114,33,17,64,7,1,2,4,107,32,15,60
"2011","Ealing 034A","E01001375","Total",22,6,8,8,1,0,0,1,21,6,8,7
"2011","Ealing 034B","E01001377","Total",24,3,12,9,6,0,5,1,18,3,7,8
"2011","Ealing 034C","E01001379","Total",27,4,14,9,4,0,4,0,23,4,10,9
"2011","Ealing 034D","E01001381","Total",32,9,6,17,2,1,1,0,30,8,5,17
"2011","Ealing 035A","E01001248","Total",39,9,11,19,2,0,1,1,37,9,10,18
"2011","Ealing 035B","E01001299","Total",19,5,7,7,3,0,3,0,16,5,4,7
"2011","Ealing 035C","E01001305","Total",30,7,16,7,4,0,3,1,26,7,13,6
"2011","Ealing 035D","E01001306","Total",24,6,14,4,4,2,2,0,20,4,12,4
"2011","Ealing 037A","E01001366","Total",50,16,6,28,5,2,0,3,45,14,6,25
"2011","Ealing 037B","E01001367","Total",37,6,6,25,4,0,1,3,33,6,5,22
"2011","Ealing 037C","E01001368","Total",41,5,9,27,4,1,2,1,37,4,7,26
"2011","Ealing 037D","E01001370","Total",33,7,8,18,3,0,3,0,30,7,5,18
"2011","Ealing 037E","E01001371","Total",79,17,11,51,4,1,3,0,75,16,8,51
"2011","Ealing 037F","E01001372","Total",40,9,8,23,1,0,1,0,39,9,7,23
"2011","Ealing 037G","E01001373","Total",26,7,6,13,1,0,1,0,25,7,5,13
"2011","Ealing 038A","E01001333","Total",51,8,11,32,3,0,3,0,48,8,8,32
"2011","Ealing 038B","E01001335","Total",14,6,4,4,2,0,2,0,12,6,2,4
"2011","Ealing 038C","E01001336","Total",26,6,5,15,1,0,1,0,25,6,4,15
"2011","Ealing 038D","E01001369","Total",38,6,5,27,3,0,1,2,35,6,4,25
"2011","Ealing 039A","E01001300","Total",28,5,17,6,5,0,5,0,23,5,12,6
"2011","Ealing 039B","E01001301","Total",27,7,13,7,5,0,4,1,22,7,9,6
"2011","Ealing 039C","E01001302","Total",25,6,4,15,1,0,1,0,24,6,3,15
"2011","Ealing 039D","E01001304","Total",25,10,5,10,0,0,0,0,25,10,5,10
"2011","Ealing 040A","E01001374","Total",47,11,11,25,4,0,4,0,43,11,7,25
"2011","Ealing 040B","E01001376","Total",54,12,20,22,2,0,1,1,52,12,19,21
"2011","Ealing 040C","E01001380","Total",23,5,11,7,1,0,0,1,22,5,11,6
"2011","Ealing 040D","E01032572","Total",28,9,7,12,2,0,2,0,26,9,5,12
"2011","Enfield 001A","E01001444","Total",79,16,14,49,5,1,2,2,74,15,12,47
"2011","Enfield 001B","E01001446","Total",96,17,27,52,9,1,5,3,87,16,22,49
"2011","Enfield 001C","E01001546","Total",99,20,17,62,1,0,1,0,98,20,16,62
"2011","Enfield 001D","E01001552","Total",60,18,11,31,2,1,1,0,58,17,10,31
"2011","Enfield 002A","E01001442","Total",174,40,22,112,15,7,3,5,159,33,19,107
"2011","Enfield 002B","E01001545","Total",144,37,21,86,7,1,1,5,137,36,20,81
"2011","Enfield 002C","E01001547","Total",75,16,18,41,5,2,2,1,70,14,16,40
"2011","Enfield 002D","E01001548","Total",115,26,16,73,10,6,1,3,105,20,15,70
"2011","Enfield 002E","E01001551","Total",103,20,16,67,4,0,1,3,99,20,15,64
"2011","Enfield 003B","E01001445","Total",170,30,34,106,13,0,6,7,157,30,28,99
"2011","Enfield 003C","E01001447","Total",112,19,23,70,6,0,0,6,106,19,23,64
"2011","Enfield 003D","E01001448","Total",96,20,16,60,11,3,2,6,85,17,14,54
"2011","Enfield 003E","E01001449","Total",95,14,17,64,8,1,3,4,87,13,14,60
"2011","Enfield 003F","E01033148","Total",165,38,34,93,7,2,4,1,158,36,30,92
"2011","Enfield 003G","E01033150","Total",163,39,28,96,7,1,1,5,156,38,27,91
"2011","Enfield 004A","E01001408","Total",64,12,23,29,5,0,4,1,59,12,19,28
"2011","Enfield 004B","E01001411","Total",69,15,17,37,3,2,0,1,66,13,17,36
"2011","Enfield 004C","E01001412","Total",59,12,15,32,2,0,2,0,57,12,13,32
"2011","Enfield 004D","E01001413","Total",21,5,10,6,4,0,4,0,17,5,6,6
"2011","Enfield 004E","E01001414","Total",98,25,19,54,6,1,2,3,92,24,17,51
"2011","Enfield 005A","E01001407","Total",59,14,13,32,4,0,4,0,55,14,9,32
"2011","Enfield 005B","E01001409","Total",113,30,14,69,5,0,2,3,108,30,12,66
"2011","Enfield 005C","E01001410","Total",139,34,20,85,5,0,2,3,134,34,18,82
"2011","Enfield 005D","E01001516","Total",83,23,8,52,6,1,1,4,77,22,7,48
"2011","Enfield 005E","E01001537","Total",73,23,14,36,4,1,3,0,69,22,11,36
"2011","Enfield 006A","E01001439","Total",183,42,16,125,8,1,6,1,175,41,10,124
"2011","Enfield 006B","E01001441","Total",104,23,11,70,8,4,1,3,96,19,10,67
"2011","Enfield 006C","E01001517","Total",123,31,15,77,6,2,0,4,117,29,15,73
"2011","Enfield 006D","E01001549","Total",192,47,22,123,16,6,3,7,176,41,19,116
"2011","Enfield 006E","E01001550","Total",102,24,23,55,1,0,1,0,101,24,22,55
"2011","Enfield 007A","E01001433","Total",125,38,18,69,1,0,1,0,124,38,17,69
"2011","Enfield 007B","E01001434","Total",70,11,21,38,6,1,4,1,64,10,17,37
"2011","Enfield 007C","E01001435","Total",67,17,14,36,4,0,1,3,63,17,13,33
"2011","Enfield 007D","E01001436","Total",88,17,22,49,5,0,2,3,83,17,20,46
"2011","Enfield 007E","E01001438","Total",96,16,20,60,5,0,4,1,91,16,16,59
"2011","Enfield 008A","E01001469","Total",49,18,14,17,4,1,1,2,45,17,13,15
"2011","Enfield 008B","E01001536","Total",47,8,13,26,3,0,2,1,44,8,11,25
"2011","Enfield 008C","E01001540","Total",67,17,14,36,5,2,2,1,62,15,12,35
"2011","Enfield 008D","E01001541","Total",38,15,12,11,2,0,2,0,36,15,10,11
"2011","Enfield 008E","E01001542","Total",73,17,19,37,5,0,3,2,68,17,16,35
"2011","Enfield 009A","E01001538","Total",38,11,15,12,5,1,4,0,33,10,11,12
"2011","Enfield 009B","E01001539","Total",43,14,10,19,3,1,1,1,40,13,9,18
"2011","Enfield 009C","E01001543","Total",31,8,11,12,5,0,2,3,26,8,9,9
"2011","Enfield 009D","E01001544","Total",20,8,4,8,3,2,0,1,17,6,4,7
"2011","Enfield 010A","E01001457","Total",35,12,8,15,3,1,1,1,32,11,7,14
"2011","Enfield 010B","E01001468","Total",22,9,9,4,3,2,1,0,19,7,8,4
"2011","Enfield 010C","E01001471","Total",41,15,12,14,4,0,4,0,37,15,8,14
"2011","Enfield 010D","E01001472","Total",43,16,8,19,3,1,1,1,40,15,7,18
"2011","Enfield 010E","E01001474","Total",27,7,12,8,7,1,4,2,20,6,8,6
"2011","Enfield 011A","E01001415","Total",34,10,6,18,4,1,2,1,30,9,4,17
"2011","Enfield 011B","E01001417","Total",15,4,8,3,2,0,2,0,13,4,6,3
"2011","Enfield 011C","E01001418","Total",49,15,10,24,1,0,0,1,48,15,10,23
"2011","Enfield 011D","E01001422","Total",18,3,7,8,6,0,6,0,12,3,1,8
"2011","Enfield 012A","E01001440","Total",70,17,13,40,5,0,1,4,65,17,12,36
"2011","Enfield 012B","E01001504","Total",66,15,15,36,3,0,3,0,63,15,12,36
"2011","Enfield 012C","E01001505","Total",83,20,18,45,5,2,1,2,78,18,17,43
"2011","Enfield 012D","E01001507","Total",106,17,31,58,7,1,5,1,99,16,26,57
"2011","Enfield 012E","E01001508","Total",116,26,25,65,9,2,4,3,107,24,21,62
"2011","Enfield 012F","E01001513","Total",98,14,18,66,8,0,3,5,90,14,15,61
"2011","Enfield 013A","E01001416","Total",15,2,8,5,1,0,0,1,14,2,8,4
"2011","Enfield 013B","E01001470","Total",37,13,11,13,3,1,2,0,34,12,9,13
"2011","Enfield 013C","E01001473","Total",49,17,13,19,1,0,0,1,48,17,13,18
"2011","Enfield 013D","E01001475","Total",23,6,8,9,1,0,1,0,22,6,7,9
"2011","Enfield 014A","E01001437","Total",195,43,36,116,13,1,5,7,182,42,31,109
"2011","Enfield 014B","E01001506","Total",107,20,27,60,9,2,5,2,98,18,22,58
"2011","Enfield 014C","E01001509","Total",124,32,29,63,6,1,3,2,118,31,26,61
"2011","Enfield 014D","E01001510","Total",163,46,20,97,14,5,4,5,149,41,16,92
"2011","Enfield 015A","E01001405","Total",36,8,9,19,2,1,0,1,34,7,9,18
"2011","Enfield 015B","E01001406","Total",77,19,23,35,11,0,3,8,66,19,20,27
"2011","Enfield 015C","E01001450","Total",83,23,15,45,4,1,2,1,79,22,13,44
"2011","Enfield 015D","E01001512","Total",80,29,10,41,4,1,1,2,76,28,9,39
"2011","Enfield 015E","E01001515","Total",142,21,32,89,12,2,8,2,130,19,24,87
"2011","Enfield 016A","E01001401","Total",31,9,9,13,0,0,0,0,31,9,9,13
"2011","Enfield 016B","E01001478","Total",71,18,12,41,2,0,1,1,69,18,11,40
"2011","Enfield 016C","E01001484","Total",61,18,13,30,4,1,2,1,57,17,11,29
"2011","Enfield 016D","E01001511","Total",77,20,23,34,3,0,2,1,74,20,21,33
"2011","Enfield 016E","E01001514","Total",91,30,21,40,6,1,2,3,85,29,19,37
"2011","Enfield 016F","E01001518","Total",68,20,18,30,8,0,3,5,60,20,15,25
"2011","Enfield 017A","E01001451","Total",36,7,13,16,8,1,5,2,28,6,8,14
"2011","Enfield 017B","E01001452","Total",26,7,9,10,1,0,1,0,25,7,8,10
"2011","Enfield 017C","E01001453","Total",23,7,7,9,2,0,2,0,21,7,5,9
"2011","Enfield 017D","E01001454","Total",34,12,8,14,3,1,1,1,31,11,7,13
"2011","Enfield 018A","E01001476","Total",67,14,12,41,0,0,0,0,67,14,12,41
"2011","Enfield 018B","E01001477","Total",83,18,18,47,3,2,0,1,80,16,18,46
"2011","Enfield 018C","E01001481","Total",57,13,8,36,3,2,1,0,54,11,7,36
"2011","Enfield 018D","E01001502","Total",83,19,24,40,3,0,3,0,80,19,21,40
"2011","Enfield 018E","E01001503","Total",92,18,23,51,7,1,0,6,85,17,23,45
"2011","Enfield 019A","E01001520","Total",63,16,19,28,7,1,4,2,56,15,15,26
"2011","Enfield 019B","E01001522","Total",112,36,33,43,6,1,3,2,106,35,30,41
"2011","Enfield 019C","E01001523","Total",40,10,10,20,7,0,4,3,33,10,6,17
"2011","Enfield 019D","E01001524","Total",55,16,13,26,4,0,3,1,51,16,10,25
"2011","Enfield 019E","E01001526","Total",28,8,13,7,5,1,4,0,23,7,9,7
"2011","Enfield 020A","E01001419","Total",46,16,11,19,4,0,3,1,42,16,8,18
"2011","Enfield 020B","E01001420","Total",59,17,9,33,1,0,0,1,58,17,9,32
"2011","Enfield 020C","E01001421","Total",80,24,13,43,5,1,1,3,75,23,12,40
"2011","Enfield 020D","E01001519","Total",93,22,17,54,7,0,2,5,86,22,15,49
"2011","Enfield 020E","E01001525","Total",52,14,17,21,3,0,2,1,49,14,15,20
"2011","Enfield 021A","E01001398","Total",30,12,9,9,3,1,1,1,27,11,8,8
"2011","Enfield 021B","E01001399","Total",21,4,8,9,5,0,3,2,16,4,5,7
"2011","Enfield 021C","E01001400","Total",35,9,14,12,4,0,3,1,31,9,11,11
"2011","Enfield 021D","E01001402","Total",28,7,13,8,3,1,2,0,25,6,11,8
"2011","Enfield 021E","E01001403","Total",38,9,14,15,5,0,3,2,33,9,11,13
"2011","Enfield 021F","E01001455","Total",34,15,8,11,5,1,1,3,29,14,7,8
"2011","Enfield 022A","E01001456","Total",16,4,5,7,5,1,1,3,11,3,4,4
"2011","Enfield 022B","E01001564","Total",32,10,14,8,3,1,2,0,29,9,12,8
"2011","Enfield 022C","E01001567","Total",17,8,7,2,3,2,1,0,14,6,6,2
"2011","Enfield 022D","E01001568","Total",20,3,10,7,5,0,5,0,15,3,5,7
"2011","Enfield 022E","E01001569","Total",40,18,11,11,2,0,2,0,38,18,9,11
"2011","Enfield 023A","E01001479","Total",84,23,19,42,5,1,1,3,79,22,18,39
"2011","Enfield 023B","E01001482","Total",94,29,20,45,11,3,1,7,83,26,19,38
"2011","Enfield 023C","E01001487","Total",112,29,21,62,8,1,1,6,104,28,20,56
"2011","Enfield 023D","E01001489","Total",110,31,23,56,7,4,0,3,103,27,23,53
"2011","Enfield 023E","E01001491","Total",140,39,31,70,8,1,5,2,132,38,26,68
"2011","Enfield 024A","E01001459","Total",60,11,18,31,8,1,2,5,52,10,16,26
"2011","Enfield 024B","E01001460","Total",113,36,18,59,7,3,3,1,106,33,15,58
"2011","Enfield 024C","E01001462","Total",93,20,12,61,5,0,1,4,88,20,11,57
"2011","Enfield 024D","E01001480","Total",52,15,15,22,3,1,2,0,49,14,13,22
"2011","Enfield 024E","E01001488","Total",116,28,22,66,7,0,4,3,109,28,18,63
"2011","Enfield 025A","E01001483","Total",88,31,18,39,12,7,0,5,76,24,18,34
"2011","Enfield 025B","E01001485","Total",117,36,25,56,5,4,1,0,112,32,24,56
"2011","Enfield 025C","E01001486","Total",154,32,35,87,6,1,2,3,148,31,33,84
"2011","Enfield 025E","E01001492","Total",119,30,22,67,9,2,4,3,110,28,18,64
"2011","Enfield 025F","E01033146","Total",127,31,31,65,14,2,2,10,113,29,29,55
"2011","Enfield 025G","E01033151","Total",132,32,24,76,7,1,4,2,125,31,20,74
"2011","Enfield 026A","E01001404","Total",53,20,13,20,4,0,1,3,49,20,12,17
"2011","Enfield 026B","E01001493","Total",58,20,16,22,9,1,2,6,49,19,14,16
"2011","Enfield 026C","E01001494","Total",29,8,11,10,3,0,3,0,26,8,8,10
"2011","Enfield 026D","E01001496","Total",40,7,16,17,7,2,5,0,33,5,11,17
"2011","Enfield 026E","E01001570","Total",86,21,31,34,7,1,4,2,79,20,27,32
"2011","Enfield 027A","E01001423","Total",76,20,12,44,6,2,3,1,70,18,9,43
"2011","Enfield 027B","E01001425","Total",162,40,25,97,10,1,4,5,152,39,21,92
"2011","Enfield 027C","E01001428","Total",106,24,16,66,10,1,2,7,96,23,14,59
"2011","Enfield 027D","E01001461","Total",127,30,21,76,6,1,2,3,121,29,19,73
"2011","Enfield 027E","E01001464","Total",57,13,14,30,7,2,2,3,50,11,12,27
"2011","Enfield 028A","E01001521","Total",38,12,15,11,4,0,4,0,34,12,11,11
"2011","Enfield 028B","E01001531","Total",20,6,6,8,4,2,2,0,16,4,4,8
"2011","Enfield 028C","E01001532","Total",30,8,10,12,3,0,1,2,27,8,9,10
"2011","Enfield 028D","E01001533","Total",19,7,8,4,1,0,1,0,18,7,7,4
"2011","Enfield 028E","E01001535","Total",23,10,8,5,1,1,0,0,22,9,8,5
"2011","Enfield 029A","E01001495","Total",40,19,13,8,5,3,2,0,35,16,11,8
"2011","Enfield 029B","E01001498","Total",57,20,19,18,3,2,1,0,54,18,18,18
"2011","Enfield 029C","E01001563","Total",33,12,9,12,4,2,2,0,29,10,7,12
"2011","Enfield 029D","E01001565","Total",43,7,15,21,7,0,4,3,36,7,11,18
"2011","Enfield 029E","E01001566","Total",20,6,7,7,4,1,3,0,16,5,4,7
"2011","Enfield 030A","E01001424","Total",107,28,19,60,6,2,2,2,101,26,17,58
"2011","Enfield 030B","E01001426","Total",107,30,15,62,9,1,1,7,98,29,14,55
"2011","Enfield 030C","E01001427","Total",140,39,20,81,11,3,1,7,129,36,19,74
"2011","Enfield 030D","E01001429","Total",174,48,34,92,8,0,3,5,166,48,31,87
"2011","Enfield 030E","E01001430","Total",158,32,22,104,7,2,1,4,151,30,21,100
"2011","Enfield 031A","E01001463","Total",62,25,14,23,4,2,2,0,58,23,12,23
"2011","Enfield 031B","E01001465","Total",57,16,12,29,3,1,2,0,54,15,10,29
"2011","Enfield 031C","E01001466","Total",102,27,19,56,9,5,0,4,93,22,19,52
"2011","Enfield 031D","E01001467","Total",104,23,16,65,12,3,2,7,92,20,14,58
"2011","Enfield 031E","E01001497","Total",58,18,7,33,3,1,0,2,55,17,7,31
"2011","Enfield 031F","E01001499","Total",30,5,10,15,2,0,2,0,28,5,8,15
"2011","Enfield 032A","E01001392","Total",29,8,8,13,8,4,2,2,21,4,6,11
"2011","Enfield 032B","E01001528","Total",102,26,12,64,7,2,2,3,95,24,10,61
"2011","Enfield 032C","E01001529","Total",80,20,16,44,2,2,0,0,78,18,16,44
"2011","Enfield 032D","E01001530","Total",26,15,3,8,0,0,0,0,26,15,3,8
"2011","Enfield 032E","E01001534","Total",27,8,4,15,3,1,1,1,24,7,3,14
"2011","Enfield 033A","E01001431","Total",117,28,26,63,8,2,2,4,109,26,24,59
"2011","Enfield 033B","E01001432","Total",127,31,20,76,14,1,0,13,113,30,20,63
"2011","Enfield 033C","E01001555","Total",85,28,16,41,4,1,1,2,81,27,15,39
"2011","Enfield 033D","E01001557","Total",93,25,20,48,4,2,0,2,89,23,20,46
"2011","Enfield 033E","E01001558","Total",131,35,21,75,11,0,6,5,120,35,15,70
"2011","Enfield 033F","E01001559","Total",143,40,28,75,12,3,2,7,131,37,26,68
"2011","Enfield 035A","E01001394","Total",55,23,10,22,3,1,1,1,52,22,9,21
"2011","Enfield 035B","E01001395","Total",123,43,26,54,8,2,4,2,115,41,22,52
"2011","Enfield 035C","E01001397","Total",79,26,15,38,4,0,2,2,75,26,13,36
"2011","Enfield 035D","E01001500","Total",41,16,9,16,1,1,0,0,40,15,9,16
"2011","Enfield 035E","E01001556","Total",43,10,9,24,2,1,0,1,41,9,9,23
"2011","Enfield 035F","E01001560","Total",72,19,14,39,9,2,3,4,63,17,11,35
"2011","Enfield 036A","E01001390","Total",40,19,7,14,2,0,0,2,38,19,7,12
"2011","Enfield 036B","E01001391","Total",46,21,12,13,1,1,0,0,45,20,12,13
"2011","Enfield 036C","E01001393","Total",54,24,11,19,3,1,1,1,51,23,10,18
"2011","Enfield 036D","E01001396","Total",46,11,14,21,2,0,0,2,44,11,14,19
"2011","Enfield 036E","E01001501","Total",67,15,19,33,3,0,3,0,64,15,16,33
"2011","Enfield 036F","E01001527","Total",36,15,8,13,3,1,0,2,33,14,8,11
"2011","Enfield 037A","E01001458","Total",123,31,19,73,13,2,5,6,110,29,14,67
"2011","Enfield 037B","E01001553","Total",101,20,19,62,5,1,3,1,96,19,16,61
"2011","Enfield 037C","E01001554","Total",141,27,25,89,10,0,5,5,131,27,20,84
"2011","Enfield 037D","E01001562","Total",136,31,31,74,6,0,2,4,130,31,29,70
"2011","Enfield 037E","E01032574","Total",122,30,18,74,3,1,0,2,119,29,18,72
"2011","Greenwich 001A","E01001690","Total",106,20,30,56,10,2,7,1,96,18,23,55
"2011","Greenwich 001B","E01001692","Total",92,24,24,44,3,0,1,2,89,24,23,42
"2011","Greenwich 001C","E01001693","Total",118,30,30,58,18,3,9,6,100,27,21,52
"2011","Greenwich 001D","E01001694","Total",62,18,15,29,4,0,2,2,58,18,13,27
"2011","Greenwich 002A","E01001687","Total",54,9,17,28,10,1,6,3,44,8,11,25
"2011","Greenwich 002B","E01001688","Total",179,47,34,98,16,2,6,8,163,45,28,90
"2011","Greenwich 002E","E01033739","Total",86,20,25,41,7,2,2,3,79,18,23,38
"2011","Greenwich 002F","E01033740","Total",82,26,18,38,5,1,4,0,77,25,14,38
"2011","Greenwich 002G","E01033741","Total",97,21,26,50,6,0,5,1,91,21,21,49
"2011","Greenwich 002H","E01033743","Total",150,47,37,66,8,1,7,0,142,46,30,66
"2011","Greenwich 002I","E01033745","Total",110,33,18,59,10,7,2,1,100,26,16,58
"2011","Greenwich 003A","E01001575","Total",110,35,21,54,9,2,7,0,101,33,14,54
"2011","Greenwich 003B","E01001576","Total",118,25,22,71,3,1,1,1,115,24,21,70
"2011","Greenwich 003C","E01001577","Total",110,27,25,58,6,1,3,2,104,26,22,56
"2011","Greenwich 003D","E01001578","Total",100,25,24,51,6,1,2,3,94,24,22,48
"2011","Greenwich 003E","E01001579","Total",97,19,25,53,9,2,5,2,88,17,20,51
"2011","Greenwich 004B","E01001709","Total",58,14,14,30,7,3,2,2,51,11,12,28
"2011","Greenwich 004C","E01001711","Total",50,7,19,24,5,0,4,1,45,7,15,23
"2011","Greenwich 004D","E01001712","Total",147,31,35,81,18,3,8,7,129,28,27,74
"2011","Greenwich 004E","E01033731","Total",45,12,21,12,2,0,2,0,43,12,19,12
"2011","Greenwich 004F","E01033734","Total",52,11,11,30,3,0,3,0,49,11,8,30
"2011","Greenwich 004G","E01033735","Total",37,12,9,16,5,3,1,1,32,9,8,15
"2011","Greenwich 004H","E01033736","Total",19,0,12,7,4,0,3,1,15,0,9,6
"2011","Greenwich 004I","E01033737","Total",92,27,19,46,12,2,5,5,80,25,14,41
"2011","Greenwich 005A","E01001705","Total",141,32,25,84,14,0,2,12,127,32,23,72
"2011","Greenwich 005B","E01001706","Total",74,14,23,37,10,2,4,4,64,12,19,33
"2011","Greenwich 005C","E01001708","Total",56,12,14,30,8,2,2,4,48,10,12,26
"2011","Greenwich 005D","E01001710","Total",130,36,22,72,14,4,2,8,116,32,20,64
"2011","Greenwich 005E","E01001713","Total",122,31,22,69,14,2,5,7,108,29,17,62
"2011","Greenwich 006A","E01001672","Total",74,17,24,33,4,0,3,1,70,17,21,32
"2011","Greenwich 006B","E01001673","Total",55,10,14,31,4,3,0,1,51,7,14,30
"2011","Greenwich 006C","E01001674","Total",64,20,16,28,2,0,0,2,62,20,16,26
"2011","Greenwich 006D","E01001675","Total",72,20,18,34,9,0,5,4,63,20,13,30
"2011","Greenwich 006E","E01001677","Total",88,22,23,43,5,3,1,1,83,19,22,42
"2011","Greenwich 007B","E01001631","Total",131,32,31,68,14,2,8,4,117,30,23,64
"2011","Greenwich 007C","E01001632","Total",61,22,15,24,4,2,2,0,57,20,13,24
"2011","Greenwich 007D","E01001635","Total",72,22,17,33,10,4,3,3,62,18,14,30
"2011","Greenwich 007E","E01001636","Total",41,12,13,16,3,1,1,1,38,11,12,15
"2011","Greenwich 007F","E01033742","Total",46,9,17,20,4,0,2,2,42,9,15,18
"2011","Greenwich 007G","E01033744","Total",97,28,21,48,6,1,2,3,91,27,19,45
"2011","Greenwich 008A","E01001571","Total",85,27,24,34,7,1,4,2,78,26,20,32
"2011","Greenwich 008B","E01001572","Total",63,24,18,21,5,0,4,1,58,24,14,20
"2011","Greenwich 008C","E01001573","Total",55,20,14,21,1,0,0,1,54,20,14,20
"2011","Greenwich 008D","E01001574","Total",131,22,27,82,11,1,4,6,120,21,23,76
"2011","Greenwich 009A","E01001629","Total",126,39,30,57,10,1,4,5,116,38,26,52
"2011","Greenwich 009B","E01001633","Total",84,23,16,45,10,1,4,5,74,22,12,40
"2011","Greenwich 009C","E01001634","Total",116,34,16,66,12,1,6,5,104,33,10,61
"2011","Greenwich 009D","E01001637","Total",67,19,11,37,5,1,1,3,62,18,10,34
"2011","Greenwich 011A","E01001695","Total",64,19,16,29,11,1,6,4,53,18,10,25
"2011","Greenwich 011B","E01001696","Total",85,22,20,43,7,1,4,2,78,21,16,41
"2011","Greenwich 011C","E01001697","Total",121,44,22,55,7,4,1,2,114,40,21,53
"2011","Greenwich 011D","E01001700","Total",109,37,23,49,13,0,7,6,96,37,16,43
"2011","Greenwich 011E","E01001703","Total",118,30,22,66,10,2,2,6,108,28,20,60
"2011","Greenwich 011F","E01001704","Total",64,13,27,24,5,0,4,1,59,13,23,23
"2011","Greenwich 012A","E01001588","Total",58,12,20,26,3,0,1,2,55,12,19,24
"2011","Greenwich 012B","E01001589","Total",51,16,10,25,3,0,0,3,48,16,10,22
"2011","Greenwich 012C","E01001591","Total",121,32,27,62,12,1,6,5,109,31,21,57
"2011","Greenwich 012D","E01001595","Total",116,31,19,66,14,0,2,12,102,31,17,54
"2011","Greenwich 014A","E01001590","Total",61,10,20,31,4,0,2,2,57,10,18,29
"2011","Greenwich 014B","E01001592","Total",49,15,15,19,3,0,2,1,46,15,13,18
"2011","Greenwich 014C","E01001593","Total",29,8,6,15,2,0,0,2,27,8,6,13
"2011","Greenwich 014D","E01001594","Total",136,34,25,77,9,2,3,4,127,32,22,73
"2011","Greenwich 015A","E01001698","Total",115,30,27,58,10,1,5,4,105,29,22,54
"2011","Greenwich 015B","E01001699","Total",75,18,15,42,6,1,4,1,69,17,11,41
"2011","Greenwich 015C","E01001701","Total",52,14,12,26,4,0,1,3,48,14,11,23
"2011","Greenwich 015D","E01001702","Total",105,32,13,60,7,1,1,5,98,31,12,55
"2011","Greenwich 016A","E01001581","Total",25,5,6,14,1,0,1,0,24,5,5,14
"2011","Greenwich 016B","E01001585","Total",24,7,10,7,1,1,0,0,23,6,10,7
"2011","Greenwich 016C","E01001586","Total",47,13,11,23,4,2,1,1,43,11,10,22
"2011","Greenwich 016D","E01001587","Total",44,17,13,14,3,0,3,0,41,17,10,14
"2011","Greenwich 017A","E01001678","Total",49,20,17,12,3,0,3,0,46,20,14,12
"2011","Greenwich 017B","E01001683","Total",50,15,17,18,5,0,2,3,45,15,15,15
"2011","Greenwich 017C","E01001684","Total",70,21,12,37,4,1,2,1,66,20,10,36
"2011","Greenwich 017D","E01001685","Total",58,15,20,23,5,0,4,1,53,15,16,22
"2011","Greenwich 019A","E01001646","Total",152,37,38,77,12,3,3,6,140,34,35,71
"2011","Greenwich 019B","E01001650","Total",72,17,13,42,4,0,2,2,68,17,11,40
"2011","Greenwich 019C","E01001651","Total",82,15,27,40,5,0,3,2,77,15,24,38
"2011","Greenwich 019D","E01001652","Total",26,3,9,14,1,0,1,0,25,3,8,14
"2011","Greenwich 020A","E01001679","Total",31,7,14,10,3,0,1,2,28,7,13,8
"2011","Greenwich 020B","E01001680","Total",30,12,14,4,13,9,4,0,17,3,10,4
"2011","Greenwich 020C","E01001681","Total",37,8,8,21,3,1,0,2,34,7,8,19
"2011","Greenwich 020D","E01001682","Total",45,5,22,18,8,0,5,3,37,5,17,15
"2011","Greenwich 020E","E01001686","Total",100,31,19,50,11,3,4,4,89,28,15,46
"2011","Greenwich 021A","E01001580","Total",29,6,8,15,2,0,1,1,27,6,7,14
"2011","Greenwich 021B","E01001582","Total",44,7,13,24,6,0,4,2,38,7,9,22
"2011","Greenwich 021C","E01001583","Total",26,6,10,10,4,0,2,2,22,6,8,8
"2011","Greenwich 021D","E01001584","Total",17,5,8,4,4,1,3,0,13,4,5,4
"2011","Greenwich 022A","E01001645","Total",74,21,21,32,6,2,3,1,68,19,18,31
"2011","Greenwich 022B","E01001647","Total",44,13,18,13,4,0,3,1,40,13,15,12
"2011","Greenwich 022C","E01001648","Total",46,11,13,22,3,0,2,1,43,11,11,21
"2011","Greenwich 022D","E01001649","Total",59,15,15,29,1,0,0,1,58,15,15,28
"2011","Greenwich 023A","E01001605","Total",16,5,8,3,0,0,0,0,16,5,8,3
"2011","Greenwich 023B","E01001606","Total",37,7,18,12,3,1,1,1,34,6,17,11
"2011","Greenwich 023C","E01001610","Total",39,10,11,18,5,1,4,0,34,9,7,18
"2011","Greenwich 023D","E01001611","Total",44,16,15,13,4,2,0,2,40,14,15,11
"2011","Greenwich 025A","E01001620","Total",47,13,11,23,2,0,2,0,45,13,9,23
"2011","Greenwich 025B","E01001621","Total",52,15,12,25,3,1,2,0,49,14,10,25
"2011","Greenwich 025C","E01001623","Total",71,17,22,32,5,1,3,1,66,16,19,31
"2011","Greenwich 025D","E01001624","Total",51,22,9,20,4,1,1,2,47,21,8,18
"2011","Greenwich 025E","E01001625","Total",58,22,7,29,4,1,2,1,54,21,5,28
"2011","Greenwich 027A","E01001604","Total",19,6,8,5,1,0,1,0,18,6,7,5
"2011","Greenwich 027B","E01001607","Total",42,9,12,21,0,0,0,0,42,9,12,21
"2011","Greenwich 027C","E01001608","Total",18,5,9,4,2,0,2,0,16,5,7,4
"2011","Greenwich 027D","E01001609","Total",30,9,3,18,3,1,0,2,27,8,3,16
"2011","Greenwich 028A","E01001613","Total",37,12,5,20,2,1,0,1,35,11,5,19
"2011","Greenwich 028B","E01001614","Total",13,2,4,7,1,0,1,0,12,2,3,7
"2011","Greenwich 028C","E01001615","Total",38,13,9,16,8,1,3,4,30,12,6,12
"2011","Greenwich 028D","E01001617","Total",30,7,13,10,3,0,2,1,27,7,11,9
"2011","Greenwich 029A","E01001653","Total",97,29,19,49,3,1,1,1,94,28,18,48
"2011","Greenwich 029B","E01001654","Total",77,19,13,45,2,0,1,1,75,19,12,44
"2011","Greenwich 029C","E01001655","Total",100,27,19,54,9,0,6,3,91,27,13,51
"2011","Greenwich 029D","E01001660","Total",80,22,12,46,7,3,2,2,73,19,10,44
"2011","Greenwich 029E","E01001661","Total",57,23,9,25,4,2,2,0,53,21,7,25
"2011","Greenwich 030C","E01001618","Total",64,14,14,36,3,0,1,2,61,14,13,34
"2011","Greenwich 030D","E01001619","Total",67,21,19,27,2,0,2,0,65,21,17,27
"2011","Greenwich 030E","E01033729","Total",115,31,18,66,8,1,2,5,107,30,16,61
"2011","Greenwich 031A","E01001597","Total",31,11,8,12,5,2,3,0,26,9,5,12
"2011","Greenwich 031B","E01001598","Total",30,7,16,7,4,0,4,0,26,7,12,7
"2011","Greenwich 031C","E01001602","Total",84,20,23,41,7,1,4,2,77,19,19,39
"2011","Greenwich 031D","E01001603","Total",84,21,15,48,7,1,3,3,77,20,12,45
"2011","Greenwich 032A","E01001596","Total",26,10,9,7,4,1,3,0,22,9,6,7
"2011","Greenwich 032B","E01001599","Total",31,13,8,10,6,1,3,2,25,12,5,8
"2011","Greenwich 032C","E01001600","Total",32,10,5,17,1,0,0,1,31,10,5,16
"2011","Greenwich 032D","E01001601","Total",24,7,14,3,9,1,8,0,15,6,6,3
"2011","Greenwich 033A","E01001669","Total",94,21,25,48,6,1,3,2,88,20,22,46
"2011","Greenwich 033B","E01001671","Total",61,12,23,26,1,1,0,0,60,11,23,26
"2011","Greenwich 033C","E01001676","Total",111,32,24,55,9,3,1,5,102,29,23,50
"2011","Greenwich 033D","E01032567","Total",63,13,25,25,5,0,3,2,58,13,22,23
"2011","Greenwich 034A","E01001656","Total",43,5,17,21,5,0,3,2,38,5,14,19
"2011","Greenwich 034B","E01001657","Total",38,10,13,15,6,3,3,0,32,7,10,15
"2011","Greenwich 034C","E01001658","Total",53,9,17,27,5,1,1,3,48,8,16,24
"2011","Greenwich 034D","E01001659","Total",24,4,9,11,1,0,0,1,23,4,9,10
"2011","Greenwich 034E","E01033726","Total",123,31,22,70,9,0,6,3,114,31,16,67
"2011","Greenwich 035A","E01001640","Total",145,36,30,79,10,1,2,7,135,35,28,72
"2011","Greenwich 035B","E01033727","Total",130,38,34,58,13,2,8,3,117,36,26,55
"2011","Greenwich 035C","E01033728","Total",21,3,4,14,3,1,1,1,18,2,3,13
"2011","Greenwich 035D","E01033730","Total",53,10,18,25,3,0,1,2,50,10,17,23
"2011","Greenwich 036A","E01001666","Total",34,11,8,15,1,0,1,0,33,11,7,15
"2011","Greenwich 036B","E01001667","Total",85,23,20,42,9,1,2,6,76,22,18,36
"2011","Greenwich 036C","E01001668","Total",114,27,27,60,7,0,4,3,107,27,23,57
"2011","Greenwich 036D","E01033732","Total",55,10,8,37,0,0,0,0,55,10,8,37
"2011","Greenwich 036E","E01033733","Total",19,2,8,9,4,0,4,0,15,2,4,9
"2011","Greenwich 037A","E01001662","Total",39,16,10,13,2,0,2,0,37,16,8,13
"2011","Greenwich 037B","E01001664","Total",28,5,9,14,2,0,2,0,26,5,7,14
"2011","Greenwich 037C","E01001665","Total",33,6,10,17,1,0,0,1,32,6,10,16
"2011","Greenwich 037D","E01033738","Total",18,3,4,11,3,0,1,2,15,3,3,9
"2011","Greenwich 038A","E01001638","Total",129,38,37,54,12,4,4,4,117,34,33,50
"2011","Greenwich 038B","E01001641","Total",48,11,19,18,7,1,5,1,41,10,14,17
"2011","Greenwich 038C","E01001642","Total",30,10,12,8,3,1,2,0,27,9,10,8
"2011","Greenwich 038D","E01001644","Total",55,11,18,26,6,1,3,2,49,10,15,24
"2011","Greenwich 038E","E01033746","Total",30,10,6,14,2,0,2,0,28,10,4,14
"2011","Harrow 001A","E01002112","Total",22,3,6,13,3,0,3,0,19,3,3,13
"2011","Harrow 001B","E01002114","Total",46,13,16,17,6,2,4,0,40,11,12,17
"2011","Harrow 001C","E01002225","Total",9,1,1,7,0,0,0,0,9,1,1,7
"2011","Harrow 001D","E01002226","Total",59,21,18,20,2,0,1,1,57,21,17,19
"2011","Harrow 002A","E01002113","Total",27,5,5,17,2,0,1,1,25,5,4,16
"2011","Harrow 002B","E01002115","Total",23,9,4,10,1,1,0,0,22,8,4,10
"2011","Harrow 002C","E01002116","Total",28,11,5,12,5,3,1,1,23,8,4,11
"2011","Harrow 002D","E01002117","Total",46,14,7,25,0,0,0,0,46,14,7,25
"2011","Harrow 002E","E01002118","Total",56,14,21,21,4,0,3,1,52,14,18,20
"2011","Harrow 003A","E01002227","Total",67,12,15,40,2,0,2,0,65,12,13,40
"2011","Harrow 003B","E01002228","Total",43,7,10,26,3,0,2,1,40,7,8,25
"2011","Harrow 003C","E01002229","Total",48,14,10,24,4,0,3,1,44,14,7,23
"2011","Harrow 003D","E01002230","Total",28,6,12,10,8,0,8,0,20,6,4,10
"2011","Harrow 004A","E01002144","Total",27,15,6,6,1,0,1,0,26,15,5,6
"2011","Harrow 004B","E01002146","Total",11,4,6,1,2,0,2,0,9,4,4,1
"2011","Harrow 004C","E01002147","Total",9,3,1,5,1,0,0,1,8,3,1,4
"2011","Harrow 004D","E01002149","Total",9,4,3,2,3,0,3,0,6,4,0,2
"2011","Harrow 005A","E01002140","Total",60,23,14,23,6,2,3,1,54,21,11,22
"2011","Harrow 005B","E01002141","Total",47,9,21,17,3,0,3,0,44,9,18,17
"2011","Harrow 005C","E01002142","Total",33,10,10,13,6,3,2,1,27,7,8,12
"2011","Harrow 005D","E01002143","Total",57,18,12,27,2,0,1,1,55,18,11,26
"2011","Harrow 005E","E01002145","Total",36,9,13,14,2,1,0,1,34,8,13,13
"2011","Harrow 006A","E01002139","Total",91,19,22,50,4,0,2,2,87,19,20,48
"2011","Harrow 006B","E01002148","Total",24,6,7,11,3,1,1,1,21,5,6,10
"2011","Harrow 006C","E01002150","Total",53,19,19,15,4,1,3,0,49,18,16,15
"2011","Harrow 006D","E01002151","Total",52,11,13,28,1,0,1,0,51,11,12,28
"2011","Harrow 006E","E01002152","Total",24,6,7,11,5,1,3,1,19,5,4,10
"2011","Harrow 007A","E01002119","Total",50,12,12,26,3,1,1,1,47,11,11,25
"2011","Harrow 007B","E01002120","Total",42,9,8,25,3,0,1,2,39,9,7,23
"2011","Harrow 007C","E01002121","Total",26,10,8,8,4,1,2,1,22,9,6,7
"2011","Harrow 007D","E01002122","Total",31,10,5,16,3,2,1,0,28,8,4,16
"2011","Harrow 007E","E01002123","Total",30,7,8,15,1,1,0,0,29,6,8,15
"2011","Harrow 008A","E01002106","Total",35,14,13,8,3,1,2,0,32,13,11,8
"2011","Harrow 008B","E01002108","Total",30,6,15,9,9,2,6,1,21,4,9,8
"2011","Harrow 008C","E01002109","Total",27,10,8,9,2,1,1,0,25,9,7,9
"2011","Harrow 008D","E01002110","Total",29,8,11,10,4,1,2,1,25,7,9,9
"2011","Harrow 008E","E01002111","Total",55,23,14,18,6,2,3,1,49,21,11,17
"2011","Harrow 009A","E01002185","Total",108,31,29,48,15,1,3,11,93,30,26,37
"2011","Harrow 009B","E01002186","Total",52,15,13,24,3,0,2,1,49,15,11,23
"2011","Harrow 009C","E01002187","Total",38,8,12,18,5,2,2,1,33,6,10,17
"2011","Harrow 009D","E01002190","Total",14,7,5,2,1,0,1,0,13,7,4,2
"2011","Harrow 010A","E01002124","Total",40,12,9,19,5,1,2,2,35,11,7,17
"2011","Harrow 010B","E01002125","Total",34,10,8,16,6,1,3,2,28,9,5,14
"2011","Harrow 010C","E01002198","Total",41,21,8,12,2,0,1,1,39,21,7,11
"2011","Harrow 010D","E01002200","Total",28,6,7,15,2,0,2,0,26,6,5,15
"2011","Harrow 010E","E01002203","Total",41,16,11,14,2,0,1,1,39,16,10,13
"2011","Harrow 011A","E01002232","Total",61,20,15,26,7,1,5,1,54,19,10,25
"2011","Harrow 011B","E01002233","Total",87,25,18,44,5,0,2,3,82,25,16,41
"2011","Harrow 011C","E01002234","Total",53,16,14,23,3,1,2,0,50,15,12,23
"2011","Harrow 011D","E01002235","Total",62,19,13,30,5,0,2,3,57,19,11,27
"2011","Harrow 011E","E01002236","Total",49,19,10,20,2,1,1,0,47,18,9,20
"2011","Harrow 012A","E01002107","Total",30,9,9,12,4,3,1,0,26,6,8,12
"2011","Harrow 012B","E01002197","Total",17,7,4,6,2,0,1,1,15,7,3,5
"2011","Harrow 012C","E01002199","Total",23,9,3,11,3,0,2,1,20,9,1,10
"2011","Harrow 012D","E01002201","Total",20,7,11,2,0,0,0,0,20,7,11,2
"2011","Harrow 012E","E01002202","Total",89,21,21,47,6,2,2,2,83,19,19,45
"2011","Harrow 013A","E01002179","Total",105,27,12,66,7,2,1,4,98,25,11,62
"2011","Harrow 013B","E01002180","Total",104,20,27,57,11,0,5,6,93,20,22,51
"2011","Harrow 013C","E01002183","Total",52,22,15,15,2,1,1,0,50,21,14,15
"2011","Harrow 013D","E01002184","Total",65,17,24,24,2,0,0,2,63,17,24,22
"2011","Harrow 013E","E01002231","Total",87,23,20,44,8,1,6,1,79,22,14,43
"2011","Harrow 015A","E01002154","Total",51,15,12,24,2,0,2,0,49,15,10,24
"2011","Harrow 015B","E01002156","Total",15,4,4,7,0,0,0,0,15,4,4,7
"2011","Harrow 015C","E01002162","Total",67,21,14,32,3,0,0,3,64,21,14,29
"2011","Harrow 015D","E01002163","Total",25,5,7,13,2,1,1,0,23,4,6,13
"2011","Harrow 016A","E01002188","Total",15,1,7,7,1,0,1,0,14,1,6,7
"2011","Harrow 016B","E01002189","Total",25,6,10,9,1,0,0,1,24,6,10,8
"2011","Harrow 016C","E01002192","Total",15,6,3,6,2,0,1,1,13,6,2,5
"2011","Harrow 016D","E01002193","Total",70,18,27,25,12,1,7,4,58,17,20,21
"2011","Harrow 017A","E01002165","Total",27,12,2,13,5,2,0,3,22,10,2,10
"2011","Harrow 017B","E01002166","Total",20,5,4,11,1,0,0,1,19,5,4,10
"2011","Harrow 017C","E01002167","Total",40,13,10,17,3,0,1,2,37,13,9,15
"2011","Harrow 017D","E01002168","Total",69,25,18,26,5,2,3,0,64,23,15,26
"2011","Harrow 017E","E01002169","Total",42,10,9,23,2,0,0,2,40,10,9,21
"2011","Harrow 019A","E01002153","Total",12,4,6,2,1,0,1,0,11,4,5,2
"2011","Harrow 019B","E01002155","Total",19,3,7,9,2,1,1,0,17,2,6,9
"2011","Harrow 019C","E01002157","Total",31,10,13,8,4,1,1,2,27,9,12,6
"2011","Harrow 019D","E01002158","Total",19,7,8,4,2,0,1,1,17,7,7,3
"2011","Harrow 020A","E01002128","Total",33,11,11,11,2,0,2,0,31,11,9,11
"2011","Harrow 020B","E01002130","Total",86,26,14,46,6,1,3,2,80,25,11,44
"2011","Harrow 020C","E01002181","Total",24,8,6,10,2,0,1,1,22,8,5,9
"2011","Harrow 020D","E01002182","Total",37,13,11,13,3,1,2,0,34,12,9,13
"2011","Harrow 021A","E01002159","Total",30,10,8,12,3,0,2,1,27,10,6,11
"2011","Harrow 021B","E01002160","Total",49,14,13,22,4,1,0,3,45,13,13,19
"2011","Harrow 021C","E01002161","Total",47,17,9,21,1,0,0,1,46,17,9,20
"2011","Harrow 021D","E01002164","Total",45,14,14,17,4,2,2,0,41,12,12,17
"2011","Harrow 022A","E01002191","Total",38,18,11,9,1,1,0,0,37,17,11,9
"2011","Harrow 022B","E01002194","Total",28,6,15,7,0,0,0,0,28,6,15,7
"2011","Harrow 022C","E01002195","Total",34,11,8,15,2,1,1,0,32,10,7,15
"2011","Harrow 022D","E01002196","Total",15,6,5,4,0,0,0,0,15,6,5,4
"2011","Harrow 023A","E01002126","Total",41,13,11,17,6,1,2,3,35,12,9,14
"2011","Harrow 023B","E01002127","Total",38,6,14,18,2,0,2,0,36,6,12,18
"2011","Harrow 023C","E01002129","Total",61,12,18,31,7,2,2,3,54,10,16,28
"2011","Harrow 023D","E01002131","Total",58,16,13,29,3,1,0,2,55,15,13,27
"2011","Harrow 024A","E01002237","Total",50,7,17,26,7,0,5,2,43,7,12,24
"2011","Harrow 024B","E01002238","Total",39,9,9,21,2,0,0,2,37,9,9,19
"2011","Harrow 024C","E01002240","Total",41,9,13,19,4,0,2,2,37,9,11,17
"2011","Harrow 024D","E01002242","Total",29,16,5,8,3,0,1,2,26,16,4,6
"2011","Harrow 025A","E01002208","Total",11,5,5,1,2,0,2,0,9,5,3,1
"2011","Harrow 025B","E01002209","Total",18,5,7,6,3,1,1,1,15,4,6,5
"2011","Harrow 025C","E01002239","Total",30,10,11,9,3,0,2,1,27,10,9,8
"2011","Harrow 025D","E01002241","Total",34,15,6,13,1,0,0,1,33,15,6,12
"2011","Harrow 027A","E01002133","Total",87,25,20,42,4,0,2,2,83,25,18,40
"2011","Harrow 027B","E01002136","Total",40,11,13,16,3,1,2,0,37,10,11,16
"2011","Harrow 027C","E01002138","Total",41,15,10,16,3,1,1,1,38,14,9,15
"2011","Harrow 027D","E01002213","Total",122,41,20,61,9,3,3,3,113,38,17,58
"2011","Harrow 028A","E01002211","Total",73,20,15,38,4,1,1,2,69,19,14,36
"2011","Harrow 028B","E01002212","Total",56,21,13,22,4,0,1,3,52,21,12,19
"2011","Harrow 028C","E01002216","Total",25,3,8,14,2,0,1,1,23,3,7,13
"2011","Harrow 028D","E01002217","Total",95,22,30,43,1,0,1,0,94,22,29,43
"2011","Harrow 029A","E01002132","Total",24,2,12,10,1,0,1,0,23,2,11,10
"2011","Harrow 029B","E01002134","Total",24,6,6,12,1,0,0,1,23,6,6,11
"2011","Harrow 029C","E01002135","Total",44,9,15,20,4,1,1,2,40,8,14,18
"2011","Harrow 029D","E01002137","Total",7,2,4,1,0,0,0,0,7,2,4,1
"2011","Harrow 030A","E01002218","Total",39,9,14,16,6,1,4,1,33,8,10,15
"2011","Harrow 030B","E01002219","Total",35,16,6,13,0,0,0,0,35,16,6,13
"2011","Harrow 030C","E01002221","Total",29,13,2,14,1,1,0,0,28,12,2,14
"2011","Harrow 030D","E01002222","Total",31,4,14,13,3,1,2,0,28,3,12,13
"2011","Harrow 031A","E01002214","Total",57,12,16,29,2,0,1,1,55,12,15,28
"2011","Harrow 031B","E01002215","Total",72,24,9,39,3,0,2,1,69,24,7,38
"2011","Harrow 031C","E01002220","Total",35,12,11,12,2,0,1,1,33,12,10,11
"2011","Harrow 031D","E01002223","Total",37,10,13,14,3,0,3,0,34,10,10,14
"2011","Harrow 031E","E01002224","Total",66,15,17,34,3,0,2,1,63,15,15,33
"2011","Harrow 032A","E01002204","Total",39,13,10,16,4,1,3,0,35,12,7,16
"2011","Harrow 032B","E01002206","Total",19,7,4,8,5,0,1,4,14,7,3,4
"2011","Harrow 032C","E01002207","Total",21,7,6,8,1,0,1,0,20,7,5,8
"2011","Harrow 032D","E01002210","Total",19,5,5,9,0,0,0,0,19,5,5,9
"2011","Harrow 032E","E01032576","Total",21,4,12,5,4,1,3,0,17,3,9,5
"2011","Harrow 033A","E01002170","Total",30,11,13,6,1,1,0,0,29,10,13,6
"2011","Harrow 033B","E01002171","Total",35,16,10,9,3,0,3,0,32,16,7,9
"2011","Harrow 033C","E01002172","Total",35,11,16,8,6,1,4,1,29,10,12,7
"2011","Harrow 033D","E01002173","Total",15,5,7,3,1,0,1,0,14,5,6,3
"2011","Harrow 033E","E01002174","Total",17,5,6,6,1,0,1,0,16,5,5,6
"2011","Harrow 033F","E01002175","Total",7,0,3,4,0,0,0,0,7,0,3,4
"2011","Harrow 033G","E01002176","Total",16,4,6,6,1,0,1,0,15,4,5,6
"2011","Harrow 033H","E01002177","Total",27,10,9,8,0,0,0,0,27,10,9,8
"2011","Harrow 033I","E01002178","Total",19,4,9,6,1,0,1,0,18,4,8,6
"2011","Havering 001A","E01002276","Total",60,20,12,28,7,3,2,2,53,17,10,26
"2011","Havering 001B","E01002278","Total",97,27,20,50,5,2,3,0,92,25,17,50
"2011","Havering 001C","E01002312","Total",39,12,7,20,2,0,1,1,37,12,6,19
"2011","Havering 001D","E01002313","Total",56,15,8,33,3,2,0,1,53,13,8,32
"2011","Havering 002A","E01002277","Total",56,14,10,32,9,1,3,5,47,13,7,27
"2011","Havering 002B","E01002279","Total",79,21,18,40,8,2,3,3,71,19,15,37
"2011","Havering 002C","E01002281","Total",92,23,10,59,4,0,2,2,88,23,8,57
"2011","Havering 002D","E01002283","Total",55,19,7,29,1,0,0,1,54,19,7,28
"2011","Havering 002E","E01002299","Total",58,20,12,26,1,0,1,0,57,20,11,26
"2011","Havering 003A","E01002301","Total",33,12,9,12,2,0,0,2,31,12,9,10
"2011","Havering 003B","E01002303","Total",116,32,33,51,6,1,5,0,110,31,28,51
"2011","Havering 003C","E01002304","Total",26,5,5,16,2,0,1,1,24,5,4,15
"2011","Havering 003D","E01002306","Total",113,31,23,59,8,4,2,2,105,27,21,57
"2011","Havering 003E","E01002307","Total",81,17,20,44,3,1,1,1,78,16,19,43
"2011","Havering 004A","E01002280","Total",100,23,19,58,1,1,0,0,99,22,19,58
"2011","Havering 004B","E01002282","Total",91,24,15,52,7,1,3,3,84,23,12,49
"2011","Havering 004C","E01002284","Total",85,15,26,44,10,0,8,2,75,15,18,42
"2011","Havering 004D","E01002297","Total",67,16,12,39,6,1,3,2,61,15,9,37
"2011","Havering 004E","E01002314","Total",84,19,22,43,5,0,5,0,79,19,17,43
"2011","Havering 004F","E01002316","Total",83,20,17,46,6,1,3,2,77,19,14,44
"2011","Havering 005A","E01002302","Total",57,19,15,23,2,0,2,0,55,19,13,23
"2011","Havering 005B","E01002305","Total",45,17,8,20,3,1,2,0,42,16,6,20
"2011","Havering 005C","E01002308","Total",58,15,13,30,6,0,3,3,52,15,10,27
"2011","Havering 005D","E01002326","Total",59,19,9,31,3,3,0,0,56,16,9,31
"2011","Havering 005E","E01002331","Total",34,11,8,15,3,0,3,0,31,11,5,15
"2011","Havering 006A","E01002309","Total",45,14,8,23,2,1,0,1,43,13,8,22
"2011","Havering 006B","E01002310","Total",95,27,19,49,7,0,2,5,88,27,17,44
"2011","Havering 006C","E01002311","Total",77,28,14,35,7,3,2,2,70,25,12,33
"2011","Havering 006D","E01002315","Total",75,20,25,30,6,1,4,1,69,19,21,29
"2011","Havering 007A","E01002293","Total",64,21,19,24,2,0,2,0,62,21,17,24
"2011","Havering 007B","E01002294","Total",20,9,6,5,1,0,1,0,19,9,5,5
"2011","Havering 007C","E01002296","Total",22,8,7,7,7,1,5,1,15,7,2,6
"2011","Havering 007D","E01002298","Total",36,15,12,9,6,0,2,4,30,15,10,5
"2011","Havering 007E","E01002300","Total",33,10,8,15,2,0,1,1,31,10,7,14
"2011","Havering 008A","E01002333","Total",34,13,6,15,4,1,1,2,30,12,5,13
"2011","Havering 008B","E01002334","Total",27,11,8,8,5,1,4,0,22,10,4,8
"2011","Havering 008C","E01002336","Total",31,11,10,10,2,0,2,0,29,11,8,10
"2011","Havering 008D","E01002339","Total",18,6,7,5,1,0,1,0,17,6,6,5
"2011","Havering 008E","E01002341","Total",11,1,5,5,2,0,1,1,9,1,4,4
"2011","Havering 009A","E01002327","Total",42,14,15,13,2,0,1,1,40,14,14,12
"2011","Havering 009B","E01002328","Total",37,11,14,12,0,0,0,0,37,11,14,12
"2011","Havering 009C","E01002332","Total",44,14,14,16,1,0,0,1,43,14,14,15
"2011","Havering 009D","E01002335","Total",48,15,10,23,1,0,0,1,47,15,10,22
"2011","Havering 009E","E01002338","Total",21,8,6,7,3,1,0,2,18,7,6,5
"2011","Havering 009F","E01002340","Total",22,7,11,4,2,0,2,0,20,7,9,4
"2011","Havering 010A","E01002268","Total",20,7,3,10,2,2,0,0,18,5,3,10
"2011","Havering 010B","E01002269","Total",48,15,15,18,2,2,0,0,46,13,15,18
"2011","Havering 010C","E01002295","Total",44,22,9,13,3,1,2,0,41,21,7,13
"2011","Havering 010D","E01002377","Total",47,16,18,13,8,1,2,5,39,15,16,8
"2011","Havering 010E","E01002378","Total",35,13,9,13,1,0,1,0,34,13,8,13
"2011","Havering 010F","E01002383","Total",25,6,10,9,0,0,0,0,25,6,10,9
"2011","Havering 011A","E01002244","Total",68,12,23,33,3,0,2,1,65,12,21,32
"2011","Havering 011B","E01002245","Total",52,9,12,31,4,0,3,1,48,9,9,30
"2011","Havering 011C","E01002325","Total",98,32,13,53,3,0,2,1,95,32,11,52
"2011","Havering 011D","E01002329","Total",43,13,14,16,8,2,4,2,35,11,10,14
"2011","Havering 011E","E01002330","Total",69,20,15,34,0,0,0,0,69,20,15,34
"2011","Havering 012A","E01002337","Total",10,2,3,5,1,0,1,0,9,2,2,5
"2011","Havering 012B","E01002354","Total",18,12,4,2,1,0,1,0,17,12,3,2
"2011","Havering 012C","E01002376","Total",29,12,9,8,4,1,2,1,25,11,7,7
"2011","Havering 012D","E01002379","Total",38,11,6,21,1,0,1,0,37,11,5,21
"2011","Havering 012E","E01002380","Total",96,17,20,59,10,0,6,4,86,17,14,55
"2011","Havering 012F","E01002381","Total",48,13,16,19,5,1,2,2,43,12,14,17
"2011","Havering 013A","E01002243","Total",118,31,13,74,5,0,0,5,113,31,13,69
"2011","Havering 013B","E01002353","Total",39,7,5,27,1,0,1,0,38,7,4,27
"2011","Havering 013C","E01002356","Total",129,36,34,59,6,0,2,4,123,36,32,55
"2011","Havering 013E","E01032741","Total",41,7,8,26,1,0,1,0,40,7,7,26
"2011","Havering 013F","E01032742","Total",27,7,8,12,5,0,3,2,22,7,5,10
"2011","Havering 014A","E01002272","Total",28,13,8,7,5,1,3,1,23,12,5,6
"2011","Havering 014B","E01002274","Total",25,6,9,10,2,0,2,0,23,6,7,10
"2011","Havering 014C","E01002317","Total",19,8,3,8,2,0,1,1,17,8,2,7
"2011","Havering 014D","E01002318","Total",28,15,7,6,3,0,2,1,25,15,5,5
"2011","Havering 014E","E01002355","Total",19,6,7,6,1,0,1,0,18,6,6,6
"2011","Havering 014F","E01002382","Total",38,15,13,10,5,1,4,0,33,14,9,10
"2011","Havering 015A","E01002270","Total",11,5,5,1,1,0,1,0,10,5,4,1
"2011","Havering 015B","E01002271","Total",14,2,7,5,2,0,2,0,12,2,5,5
"2011","Havering 015C","E01002273","Total",22,10,7,5,2,0,2,0,20,10,5,5
"2011","Havering 015D","E01002275","Total",11,3,5,3,2,0,1,1,9,3,4,2
"2011","Havering 016A","E01002319","Total",49,12,17,20,6,0,5,1,43,12,12,19
"2011","Havering 016B","E01002350","Total",60,16,12,32,7,2,4,1,53,14,8,31
"2011","Havering 016C","E01002351","Total",53,16,21,16,4,1,3,0,49,15,18,16
"2011","Havering 016D","E01002352","Total",51,15,17,19,5,1,3,1,46,14,14,18
"2011","Havering 016E","E01002358","Total",81,31,19,31,6,3,2,1,75,28,17,30
"2011","Havering 017A","E01002246","Total",44,13,15,16,1,0,1,0,43,13,14,16
"2011","Havering 017B","E01002247","Total",80,24,24,32,6,2,2,2,74,22,22,30
"2011","Havering 017C","E01002248","Total",71,20,13,38,3,1,2,0,68,19,11,38
"2011","Havering 017D","E01002249","Total",67,20,21,26,6,2,3,1,61,18,18,25
"2011","Havering 017E","E01002250","Total",63,19,23,21,8,3,4,1,55,16,19,20
"2011","Havering 017F","E01002251","Total",68,17,12,39,6,1,3,2,62,16,9,37
"2011","Havering 018A","E01002252","Total",29,9,13,7,3,0,3,0,26,9,10,7
"2011","Havering 018B","E01002256","Total",23,7,8,8,1,0,0,1,22,7,8,7
"2011","Havering 018C","E01002258","Total",65,23,17,25,5,1,1,3,60,22,16,22
"2011","Havering 018D","E01002259","Total",42,15,17,10,4,0,4,0,38,15,13,10
"2011","Havering 018E","E01002391","Total",26,12,10,4,4,0,4,0,22,12,6,4
"2011","Havering 019A","E01002253","Total",10,3,3,4,2,0,1,1,8,3,2,3
"2011","Havering 019B","E01002254","Total",20,5,10,5,2,0,2,0,18,5,8,5
"2011","Havering 019C","E01002257","Total",25,9,4,12,2,1,1,0,23,8,3,12
"2011","Havering 019D","E01002384","Total",18,1,8,9,4,0,4,0,14,1,4,9
"2011","Havering 020A","E01002359","Total",20,3,13,4,4,0,4,0,16,3,9,4
"2011","Havering 020B","E01002360","Total",30,17,8,5,3,0,1,2,27,17,7,3
"2011","Havering 020C","E01002361","Total",57,21,14,22,2,1,0,1,55,20,14,21
"2011","Havering 020D","E01002363","Total",56,19,10,27,8,1,3,4,48,18,7,23
"2011","Havering 020E","E01002367","Total",43,18,10,15,5,0,3,2,38,18,7,13
"2011","Havering 021A","E01002320","Total",28,12,10,6,1,0,0,1,27,12,10,5
"2011","Havering 021B","E01002321","Total",23,10,7,6,3,1,2,0,20,9,5,6
"2011","Havering 021C","E01002322","Total",39,19,10,10,6,1,3,2,33,18,7,8
"2011","Havering 021D","E01002323","Total",35,14,11,10,5,1,2,2,30,13,9,8
"2011","Havering 021E","E01002324","Total",43,6,16,21,6,0,5,1,37,6,11,20
"2011","Havering 022A","E01002255","Total",43,17,14,12,2,0,2,0,41,17,12,12
"2011","Havering 022B","E01002289","Total",37,12,13,12,0,0,0,0,37,12,13,12
"2011","Havering 022C","E01002292","Total",53,16,13,24,4,1,3,0,49,15,10,24
"2011","Havering 022D","E01002362","Total",40,11,16,13,2,0,2,0,38,11,14,13
"2011","Havering 022E","E01002386","Total",53,17,21,15,7,1,5,1,46,16,16,14
"2011","Havering 023A","E01002287","Total",33,16,7,10,1,0,1,0,32,16,6,10
"2011","Havering 023B","E01002291","Total",34,7,12,15,3,0,2,1,31,7,10,14
"2011","Havering 023C","E01002364","Total",17,1,9,7,3,0,3,0,14,1,6,7
"2011","Havering 023D","E01002365","Total",46,22,12,12,3,0,1,2,43,22,11,10
"2011","Havering 023E","E01002366","Total",48,16,15,17,2,0,0,2,46,16,15,15
"2011","Havering 024A","E01002385","Total",19,8,6,5,2,0,2,0,17,8,4,5
"2011","Havering 024B","E01002387","Total",18,5,10,3,1,0,1,0,17,5,9,3
"2011","Havering 024C","E01002388","Total",19,4,10,5,3,0,3,0,16,4,7,5
"2011","Havering 024D","E01002389","Total",12,6,3,3,3,0,2,1,9,6,1,2
"2011","Havering 024E","E01002390","Total",11,7,3,1,1,0,1,0,10,7,2,1
"2011","Havering 025A","E01002265","Total",34,12,13,9,2,0,2,0,32,12,11,9
"2011","Havering 025B","E01002285","Total",14,4,5,5,1,0,1,0,13,4,4,5
"2011","Havering 025C","E01002286","Total",34,13,7,14,5,0,3,2,29,13,4,12
"2011","Havering 025D","E01002288","Total",29,12,9,8,4,0,4,0,25,12,5,8
"2011","Havering 025E","E01002290","Total",25,7,10,8,4,0,3,1,21,7,7,7
"2011","Havering 026A","E01002260","Total",54,16,17,21,8,0,4,4,46,16,13,17
"2011","Havering 026B","E01002261","Total",52,21,10,21,5,1,1,3,47,20,9,18
"2011","Havering 026C","E01002262","Total",40,11,13,16,3,0,3,0,37,11,10,16
"2011","Havering 026D","E01002263","Total",31,8,10,13,5,0,5,0,26,8,5,13
"2011","Havering 026E","E01002264","Total",86,23,12,51,4,0,0,4,82,23,12,47
"2011","Havering 027A","E01002266","Total",25,7,8,10,1,0,1,0,24,7,7,10
"2011","Havering 027B","E01002267","Total",91,32,25,34,5,2,3,0,86,30,22,34
"2011","Havering 027C","E01002372","Total",51,25,9,17,6,2,3,1,45,23,6,16
"2011","Havering 027D","E01002373","Total",53,16,13,24,3,1,2,0,50,15,11,24
"2011","Havering 027E","E01002374","Total",55,19,14,22,4,0,4,0,51,19,10,22
"2011","Havering 028A","E01002368","Total",98,26,17,55,8,2,1,5,90,24,16,50
"2011","Havering 028B","E01002369","Total",62,11,19,32,6,1,5,0,56,10,14,32
"2011","Havering 028C","E01002370","Total",78,25,16,37,5,0,3,2,73,25,13,35
"2011","Havering 028D","E01002371","Total",53,18,10,25,4,0,2,2,49,18,8,23
"2011","Havering 028E","E01002375","Total",91,31,12,48,6,2,1,3,85,29,11,45
"2011","Havering 029A","E01002343","Total",36,20,8,8,2,1,1,0,34,19,7,8
"2011","Havering 029B","E01002344","Total",48,14,12,22,9,3,3,3,39,11,9,19
"2011","Havering 029C","E01002348","Total",35,15,10,10,5,1,3,1,30,14,7,9
"2011","Havering 029D","E01002349","Total",32,10,13,9,5,0,4,1,27,10,9,8
"2011","Havering 030A","E01002342","Total",73,27,13,33,4,1,2,1,69,26,11,32
"2011","Havering 030B","E01002345","Total",140,39,23,78,7,0,2,5,133,39,21,73
"2011","Havering 030C","E01002346","Total",61,17,11,33,4,1,1,2,57,16,10,31
"2011","Havering 030D","E01002347","Total",41,15,7,19,5,1,0,4,36,14,7,15
"2011","Hillingdon 001A","E01002473","Total",17,4,4,9,4,0,2,2,13,4,2,7
"2011","Hillingdon 001B","E01002475","Total",38,12,10,16,3,1,1,1,35,11,9,15
"2011","Hillingdon 001C","E01002476","Total",19,6,5,8,1,0,1,0,18,6,4,8
"2011","Hillingdon 001D","E01002477","Total",26,9,10,7,3,0,3,0,23,9,7,7
"2011","Hillingdon 001E","E01002482","Total",14,5,4,5,0,0,0,0,14,5,4,5
"2011","Hillingdon 002A","E01002472","Total",45,11,12,22,4,0,1,3,41,11,11,19
"2011","Hillingdon 002B","E01002474","Total",32,11,7,14,4,0,1,3,28,11,6,11
"2011","Hillingdon 002C","E01002478","Total",36,10,13,13,4,0,3,1,32,10,10,12
"2011","Hillingdon 002D","E01002483","Total",42,12,12,18,3,2,1,0,39,10,11,18
"2011","Hillingdon 002E","E01002484","Total",32,9,14,9,3,0,2,1,29,9,12,8
"2011","Hillingdon 002F","E01002485","Total",58,16,16,26,1,0,0,1,57,16,16,25
"2011","Hillingdon 003A","E01002438","Total",24,11,5,8,0,0,0,0,24,11,5,8
"2011","Hillingdon 003B","E01002439","Total",45,13,15,17,4,0,2,2,41,13,13,15
"2011","Hillingdon 003C","E01002440","Total",47,13,14,20,4,1,1,2,43,12,13,18
"2011","Hillingdon 003D","E01002441","Total",52,16,13,23,3,0,3,0,49,16,10,23
"2011","Hillingdon 003E","E01002442","Total",39,12,12,15,3,1,2,0,36,11,10,15
"2011","Hillingdon 004A","E01002433","Total",62,24,15,23,13,1,6,6,49,23,9,17
"2011","Hillingdon 004B","E01002436","Total",35,11,13,11,3,0,2,1,32,11,11,10
"2011","Hillingdon 004C","E01002479","Total",57,15,25,17,3,0,3,0,54,15,22,17
"2011","Hillingdon 004D","E01002480","Total",21,9,6,6,2,0,2,0,19,9,4,6
"2011","Hillingdon 004E","E01002481","Total",49,13,16,20,3,1,1,1,46,12,15,19
"2011","Hillingdon 005A","E01002533","Total",68,27,21,20,7,1,4,2,61,26,17,18
"2011","Hillingdon 005B","E01002534","Total",29,11,9,9,4,0,4,0,25,11,5,9
"2011","Hillingdon 005C","E01002538","Total",43,15,17,11,4,0,3,1,39,15,14,10
"2011","Hillingdon 005D","E01002539","Total",30,9,11,10,5,2,2,1,25,7,9,9
"2011","Hillingdon 006A","E01002418","Total",45,15,15,15,6,1,4,1,39,14,11,14
"2011","Hillingdon 006B","E01002419","Total",28,17,4,7,1,0,1,0,27,17,3,7
"2011","Hillingdon 006C","E01002431","Total",18,5,9,4,0,0,0,0,18,5,9,4
"2011","Hillingdon 006D","E01002432","Total",20,6,10,4,4,0,4,0,16,6,6,4
"2011","Hillingdon 006E","E01002437","Total",12,5,5,2,1,0,1,0,11,5,4,2
"2011","Hillingdon 007A","E01002430","Total",13,5,5,3,3,0,2,1,10,5,3,2
"2011","Hillingdon 007B","E01002434","Total",18,4,8,6,1,0,1,0,17,4,7,6
"2011","Hillingdon 007C","E01002435","Total",12,2,6,4,4,0,3,1,8,2,3,3
"2011","Hillingdon 007D","E01002470","Total",33,11,7,15,1,0,1,0,32,11,6,15
"2011","Hillingdon 007E","E01002535","Total",24,7,10,7,2,1,0,1,22,6,10,6
"2011","Hillingdon 008A","E01002416","Total",34,14,10,10,3,0,1,2,31,14,9,8
"2011","Hillingdon 008B","E01002417","Total",22,7,7,8,2,0,2,0,20,7,5,8
"2011","Hillingdon 008C","E01002420","Total",61,22,15,24,1,0,1,0,60,22,14,24
"2011","Hillingdon 008D","E01002421","Total",43,12,17,14,5,1,3,1,38,11,14,13
"2011","Hillingdon 008E","E01002471","Total",32,12,13,7,3,0,2,1,29,12,11,6
"2011","Hillingdon 009A","E01002465","Total",69,25,22,22,6,2,4,0,63,23,18,22
"2011","Hillingdon 009B","E01002467","Total",29,6,13,10,3,1,1,1,26,5,12,9
"2011","Hillingdon 009C","E01002494","Total",55,16,21,18,11,3,5,3,44,13,16,15
"2011","Hillingdon 009D","E01002536","Total",38,12,17,9,2,0,2,0,36,12,15,9
"2011","Hillingdon 009E","E01002537","Total",27,7,10,10,3,0,2,1,24,7,8,9
"2011","Hillingdon 010A","E01002415","Total",33,10,17,6,7,1,5,1,26,9,12,5
"2011","Hillingdon 010B","E01002466","Total",30,10,11,9,1,0,1,0,29,10,10,9
"2011","Hillingdon 010C","E01002468","Total",36,13,12,11,2,0,1,1,34,13,11,10
"2011","Hillingdon 010D","E01002469","Total",34,14,13,7,4,1,2,1,30,13,11,6
"2011","Hillingdon 010E","E01002495","Total",62,21,15,26,3,0,2,1,59,21,13,25
"2011","Hillingdon 011A","E01002458","Total",16,6,6,4,2,0,1,1,14,6,5,3
"2011","Hillingdon 011B","E01002459","Total",17,9,7,1,3,0,3,0,14,9,4,1
"2011","Hillingdon 011C","E01002460","Total",20,8,7,5,2,0,1,1,18,8,6,4
"2011","Hillingdon 011D","E01002462","Total",19,6,9,4,3,0,3,0,16,6,6,4
"2011","Hillingdon 011E","E01002464","Total",31,11,14,6,4,0,4,0,27,11,10,6
"2011","Hillingdon 013A","E01002461","Total",10,3,2,5,0,0,0,0,10,3,2,5
"2011","Hillingdon 013B","E01002463","Total",18,7,4,7,4,1,0,3,14,6,4,4
"2011","Hillingdon 013C","E01002512","Total",12,2,8,2,3,1,2,0,9,1,6,2
"2011","Hillingdon 013D","E01002513","Total",11,3,3,5,2,0,1,1,9,3,2,4
"2011","Hillingdon 013E","E01002516","Total",9,3,3,3,1,0,1,0,8,3,2,3
"2011","Hillingdon 014A","E01002450","Total",45,12,15,18,5,0,4,1,40,12,11,17
"2011","Hillingdon 014B","E01002451","Total",34,5,16,13,6,0,3,3,28,5,13,10
"2011","Hillingdon 014C","E01002452","Total",32,9,13,10,6,2,4,0,26,7,9,10
"2011","Hillingdon 014D","E01002453","Total",46,7,23,16,2,0,1,1,44,7,22,15
"2011","Hillingdon 014E","E01002454","Total",82,23,24,35,8,0,2,6,74,23,22,29
"2011","Hillingdon 015A","E01002414","Total",25,5,14,6,0,0,0,0,25,5,14,6
"2011","Hillingdon 015C","E01002514","Total",38,6,13,19,6,0,2,4,32,6,11,15
"2011","Hillingdon 015D","E01002515","Total",67,29,16,22,3,0,2,1,64,29,14,21
"2011","Hillingdon 015F","E01033725","Total",44,11,18,15,5,2,1,2,39,9,17,13
"2011","Hillingdon 016B","E01002520","Total",66,17,16,33,10,2,3,5,56,15,13,28
"2011","Hillingdon 016C","E01002521","Total",55,15,11,29,5,1,2,2,50,14,9,27
"2011","Hillingdon 016D","E01002523","Total",33,8,11,14,6,0,4,2,27,8,7,12
"2011","Hillingdon 016F","E01033724","Total",72,18,21,33,8,1,3,4,64,17,18,29
"2011","Hillingdon 017A","E01002410","Total",51,11,17,23,3,0,2,1,48,11,15,22
"2011","Hillingdon 017B","E01002412","Total",58,13,24,21,5,1,3,1,53,12,21,20
"2011","Hillingdon 017C","E01002456","Total",62,16,20,26,5,1,4,0,57,15,16,26
"2011","Hillingdon 017D","E01002509","Total",21,6,9,6,2,0,2,0,19,6,7,6
"2011","Hillingdon 017E","E01002511","Total",47,10,16,21,6,1,5,0,41,9,11,21
"2011","Hillingdon 018A","E01002422","Total",49,9,21,19,3,0,3,0,46,9,18,19
"2011","Hillingdon 018B","E01002423","Total",35,7,14,14,0,0,0,0,35,7,14,14
"2011","Hillingdon 018C","E01002424","Total",52,13,16,23,5,1,3,1,47,12,13,22
"2011","Hillingdon 018D","E01002425","Total",70,18,19,33,3,1,0,2,67,17,19,31
"2011","Hillingdon 018E","E01002427","Total",35,7,14,14,3,0,2,1,32,7,12,13
"2011","Hillingdon 018F","E01002428","Total",36,8,14,14,1,0,1,0,35,8,13,14
"2011","Hillingdon 019A","E01002408","Total",64,21,14,29,2,0,0,2,62,21,14,27
"2011","Hillingdon 019B","E01002409","Total",75,17,15,43,4,1,2,1,71,16,13,42
"2011","Hillingdon 019C","E01002429","Total",77,23,16,38,4,0,2,2,73,23,14,36
"2011","Hillingdon 019D","E01002455","Total",54,14,19,21,5,0,4,1,49,14,15,20
"2011","Hillingdon 019E","E01002457","Total",94,22,26,46,4,0,3,1,90,22,23,45
"2011","Hillingdon 020A","E01002392","Total",128,26,27,75,9,0,4,5,119,26,23,70
"2011","Hillingdon 020B","E01002393","Total",91,13,26,52,8,1,3,4,83,12,23,48
"2011","Hillingdon 020C","E01002540","Total",67,14,18,35,4,2,2,0,63,12,16,35
"2011","Hillingdon 020D","E01002542","Total",107,15,29,63,8,0,6,2,99,15,23,61
"2011","Hillingdon 020E","E01002543","Total",116,30,28,58,10,2,6,2,106,28,22,56
"2011","Hillingdon 021A","E01002394","Total",33,8,4,21,3,0,1,2,30,8,3,19
"2011","Hillingdon 021B","E01002395","Total",29,9,7,13,3,1,1,1,26,8,6,12
"2011","Hillingdon 021C","E01002397","Total",53,9,13,31,6,1,3,2,47,8,10,29
"2011","Hillingdon 021D","E01002398","Total",22,6,9,7,0,0,0,0,22,6,9,7
"2011","Hillingdon 021E","E01002399","Total",36,14,11,11,3,0,2,1,33,14,9,10
"2011","Hillingdon 021F","E01002426","Total",72,14,19,39,2,0,2,0,70,14,17,39
"2011","Hillingdon 022A","E01002411","Total",71,27,19,25,5,2,2,1,66,25,17,24
"2011","Hillingdon 022B","E01002413","Total",73,20,17,36,8,0,1,7,65,20,16,29
"2011","Hillingdon 022C","E01002518","Total",14,3,4,7,1,0,0,1,13,3,4,6
"2011","Hillingdon 022D","E01002519","Total",46,15,10,21,2,0,2,0,44,15,8,21
"2011","Hillingdon 022E","E01002550","Total",99,28,29,42,6,2,3,1,93,26,26,41
"2011","Hillingdon 022F","E01002554","Total",114,23,32,59,10,1,4,5,104,22,28,54
"2011","Hillingdon 023A","E01002541","Total",84,28,30,26,9,2,4,3,75,26,26,23
"2011","Hillingdon 023B","E01002544","Total",41,10,19,12,3,0,3,0,38,10,16,12
"2011","Hillingdon 023C","E01002545","Total",141,37,34,70,6,1,4,1,135,36,30,69
"2011","Hillingdon 023D","E01002546","Total",22,4,8,10,1,0,1,0,21,4,7,10
"2011","Hillingdon 023E","E01002547","Total",65,13,10,42,6,0,1,5,59,13,9,37
"2011","Hillingdon 024A","E01002400","Total",52,11,11,30,3,2,1,0,49,9,10,30
"2011","Hillingdon 024B","E01002401","Total",72,22,20,30,3,0,3,0,69,22,17,30
"2011","Hillingdon 024C","E01002402","Total",59,19,17,23,3,0,0,3,56,19,17,20
"2011","Hillingdon 024D","E01002403","Total",82,17,19,46,5,0,3,2,77,17,16,44
"2011","Hillingdon 024E","E01002404","Total",117,37,24,56,7,4,0,3,110,33,24,53
"2011","Hillingdon 025A","E01002548","Total",79,18,13,48,4,0,2,2,75,18,11,46
"2011","Hillingdon 025B","E01002549","Total",56,12,18,26,4,1,2,1,52,11,16,25
"2011","Hillingdon 025C","E01002551","Total",66,9,21,36,3,0,2,1,63,9,19,35
"2011","Hillingdon 025D","E01002552","Total",80,26,17,37,4,1,2,1,76,25,15,36
"2011","Hillingdon 025E","E01002553","Total",82,23,22,37,6,2,2,2,76,21,20,35
"2011","Hillingdon 026A","E01002396","Total",58,15,14,29,7,2,3,2,51,13,11,27
"2011","Hillingdon 026B","E01002501","Total",44,11,9,24,7,0,3,4,37,11,6,20
"2011","Hillingdon 026C","E01002502","Total",41,12,8,21,2,0,2,0,39,12,6,21
"2011","Hillingdon 026D","E01002505","Total",91,20,15,56,4,1,1,2,87,19,14,54
"2011","Hillingdon 026E","E01002508","Total",83,24,5,54,6,6,0,0,77,18,5,54
"2011","Hillingdon 027A","E01002405","Total",69,14,18,37,4,0,0,4,65,14,18,33
"2011","Hillingdon 027B","E01002406","Total",94,21,14,59,7,0,2,5,87,21,12,54
"2011","Hillingdon 027C","E01002503","Total",60,17,13,30,2,0,1,1,58,17,12,29
"2011","Hillingdon 027D","E01002504","Total",91,23,27,41,6,2,2,2,85,21,25,39
"2011","Hillingdon 027E","E01002506","Total",101,32,15,54,16,1,2,13,85,31,13,41
"2011","Hillingdon 027F","E01002507","Total",39,10,6,23,2,0,1,1,37,10,5,22
"2011","Hillingdon 028A","E01002486","Total",93,19,23,51,8,0,7,1,85,19,16,50
"2011","Hillingdon 028B","E01002487","Total",52,14,13,25,4,1,2,1,48,13,11,24
"2011","Hillingdon 028C","E01002526","Total",97,34,21,42,6,0,4,2,91,34,17,40
"2011","Hillingdon 028D","E01002528","Total",64,16,11,37,3,0,3,0,61,16,8,37
"2011","Hillingdon 028E","E01002532","Total",113,31,29,53,9,1,5,3,104,30,24,50
"2011","Hillingdon 029A","E01002445","Total",126,25,26,75,11,0,3,8,115,25,23,67
"2011","Hillingdon 029B","E01002525","Total",44,17,12,15,2,0,2,0,42,17,10,15
"2011","Hillingdon 029C","E01002529","Total",100,23,33,44,9,1,8,0,91,22,25,44
"2011","Hillingdon 029D","E01002530","Total",111,21,30,60,10,1,6,3,101,20,24,57
"2011","Hillingdon 029E","E01002531","Total",34,5,14,15,0,0,0,0,34,5,14,15
"2011","Hillingdon 030A","E01002407","Total",89,24,13,52,5,0,3,2,84,24,10,50
"2011","Hillingdon 030B","E01002488","Total",49,17,11,21,2,0,1,1,47,17,10,20
"2011","Hillingdon 030C","E01002489","Total",44,12,11,21,4,0,3,1,40,12,8,20
"2011","Hillingdon 030D","E01002490","Total",55,16,18,21,2,1,0,1,53,15,18,20
"2011","Hillingdon 030E","E01002492","Total",50,17,10,23,4,1,1,2,46,16,9,21
"2011","Hillingdon 031A","E01002444","Total",28,4,5,19,2,0,2,0,26,4,3,19
"2011","Hillingdon 031B","E01002446","Total",53,17,13,23,5,0,4,1,48,17,9,22
"2011","Hillingdon 031C","E01002447","Total",72,24,15,33,8,0,3,5,64,24,12,28
"2011","Hillingdon 031D","E01002527","Total",45,12,4,29,1,0,0,1,44,12,4,28
"2011","Hillingdon 032A","E01002443","Total",42,13,14,15,4,0,3,1,38,13,11,14
"2011","Hillingdon 032B","E01002448","Total",70,21,27,22,4,1,1,2,66,20,26,20
"2011","Hillingdon 032C","E01002449","Total",58,8,18,32,2,0,1,1,56,8,17,31
"2011","Hillingdon 032D","E01002491","Total",70,17,12,41,5,2,1,2,65,15,11,39
"2011","Hillingdon 032E","E01002493","Total",119,34,15,70,6,0,1,5,113,34,14,65
"2011","Hillingdon 033A","E01002496","Total",64,20,20,24,5,1,3,1,59,19,17,23
"2011","Hillingdon 033B","E01002497","Total",75,17,22,36,6,0,4,2,69,17,18,34
"2011","Hillingdon 033C","E01002498","Total",34,7,12,15,3,0,3,0,31,7,9,15
"2011","Hillingdon 033D","E01002499","Total",55,12,15,28,1,0,1,0,54,12,14,28
"2011","Hillingdon 033E","E01032577","Total",65,27,25,13,4,2,2,0,61,25,23,13
"2011","Hounslow 001A","E01002569","Total",28,7,12,9,1,0,0,1,27,7,12,8
"2011","Hounslow 001B","E01002570","Total",29,11,7,11,4,0,3,1,25,11,4,10
"2011","Hounslow 001C","E01002573","Total",18,5,6,7,2,0,1,1,16,5,5,6
"2011","Hounslow 001D","E01002574","Total",24,7,7,10,3,2,1,0,21,5,6,10
"2011","Hounslow 001E","E01002575","Total",22,3,6,13,6,0,3,3,16,3,3,10
"2011","Hounslow 003A","E01002562","Total",40,12,5,23,3,1,0,2,37,11,5,21
"2011","Hounslow 003B","E01002564","Total",78,13,21,44,8,1,3,4,70,12,18,40
"2011","Hounslow 003C","E01002566","Total",123,31,30,62,6,2,2,2,117,29,28,60
"2011","Hounslow 003D","E01002568","Total",187,50,40,97,8,0,2,6,179,50,38,91
"2011","Hounslow 003F","E01033081","Total",68,17,15,36,6,2,3,1,62,15,12,35
"2011","Hounslow 003G","E01033082","Total",34,8,6,20,1,0,0,1,33,8,6,19
"2011","Hounslow 004A","E01002620","Total",83,14,15,54,8,1,0,7,75,13,15,47
"2011","Hounslow 004B","E01002625","Total",28,9,4,15,3,1,1,1,25,8,3,14
"2011","Hounslow 004C","E01002626","Total",26,13,3,10,0,0,0,0,26,13,3,10
"2011","Hounslow 004D","E01002627","Total",89,35,20,34,13,7,2,4,76,28,18,30
"2011","Hounslow 004E","E01002631","Total",36,6,6,24,11,0,0,11,25,6,6,13
"2011","Hounslow 005A","E01002633","Total",87,22,15,50,2,0,1,1,85,22,14,49
"2011","Hounslow 005B","E01002634","Total",91,16,15,60,2,1,1,0,89,15,14,60
"2011","Hounslow 005C","E01002637","Total",52,15,6,31,4,2,1,1,48,13,5,30
"2011","Hounslow 005D","E01002638","Total",62,18,11,33,8,0,5,3,54,18,6,30
"2011","Hounslow 006A","E01002563","Total",23,14,3,6,2,1,1,0,21,13,2,6
"2011","Hounslow 006B","E01002565","Total",58,19,17,22,9,4,5,0,49,15,12,22
"2011","Hounslow 006C","E01002567","Total",45,12,16,17,3,1,2,0,42,11,14,17
"2011","Hounslow 006D","E01002684","Total",84,21,27,36,5,0,3,2,79,21,24,34
"2011","Hounslow 006E","E01002686","Total",66,20,13,33,1,0,1,0,65,20,12,33
"2011","Hounslow 007A","E01002571","Total",29,10,13,6,4,0,3,1,25,10,10,5
"2011","Hounslow 007B","E01002572","Total",83,23,18,42,2,0,2,0,81,23,16,42
"2011","Hounslow 007C","E01002577","Total",30,11,7,12,2,1,0,1,28,10,7,11
"2011","Hounslow 007D","E01002578","Total",25,7,10,8,4,1,3,0,21,6,7,8
"2011","Hounslow 007E","E01002689","Total",49,13,15,21,3,1,1,1,46,12,14,20
"2011","Hounslow 007F","E01002690","Total",29,7,4,18,4,0,2,2,25,7,2,16
"2011","Hounslow 008A","E01002576","Total",70,28,13,29,8,1,2,5,62,27,11,24
"2011","Hounslow 008B","E01002579","Total",34,17,8,9,3,0,3,0,31,17,5,9
"2011","Hounslow 008C","E01002580","Total",36,5,10,21,1,1,0,0,35,4,10,21
"2011","Hounslow 008D","E01002581","Total",41,12,11,18,5,0,3,2,36,12,8,16
"2011","Hounslow 008E","E01002582","Total",29,9,12,8,3,0,2,1,26,9,10,7
"2011","Hounslow 009A","E01002675","Total",65,21,13,31,8,4,3,1,57,17,10,30
"2011","Hounslow 009B","E01002678","Total",30,9,7,14,1,0,1,0,29,9,6,14
"2011","Hounslow 009C","E01002679","Total",28,6,9,13,2,0,1,1,26,6,8,12
"2011","Hounslow 009D","E01002680","Total",30,15,5,10,4,0,4,0,26,15,1,10
"2011","Hounslow 010A","E01002619","Total",34,7,10,17,5,0,3,2,29,7,7,15
"2011","Hounslow 010B","E01002622","Total",33,7,10,16,5,0,2,3,28,7,8,13
"2011","Hounslow 010C","E01002632","Total",40,13,10,17,2,0,1,1,38,13,9,16
"2011","Hounslow 010D","E01002635","Total",32,7,6,19,0,0,0,0,32,7,6,19
"2011","Hounslow 010E","E01002636","Total",40,12,6,22,3,1,1,1,37,11,5,21
"2011","Hounslow 011A","E01002618","Total",34,15,8,11,1,0,0,1,33,15,8,10
"2011","Hounslow 011B","E01002621","Total",44,12,11,21,3,0,2,1,41,12,9,20
"2011","Hounslow 011C","E01002623","Total",50,14,9,27,4,0,1,3,46,14,8,24
"2011","Hounslow 011D","E01002628","Total",30,7,7,16,1,1,0,0,29,6,7,16
"2011","Hounslow 011E","E01002629","Total",62,16,12,34,3,1,2,0,59,15,10,34
"2011","Hounslow 012A","E01002630","Total",35,13,6,16,6,0,4,2,29,13,2,14
"2011","Hounslow 012B","E01002639","Total",17,6,6,5,3,0,3,0,14,6,3,5
"2011","Hounslow 012C","E01002640","Total",22,4,9,9,4,0,2,2,18,4,7,7
"2011","Hounslow 012D","E01002674","Total",26,8,14,4,2,1,1,0,24,7,13,4
"2011","Hounslow 012E","E01002676","Total",21,7,7,7,4,0,1,3,17,7,6,4
"2011","Hounslow 013A","E01002583","Total",39,13,7,19,3,0,2,1,36,13,5,18
"2011","Hounslow 013B","E01002584","Total",37,8,9,20,3,0,3,0,34,8,6,20
"2011","Hounslow 013C","E01002585","Total",51,15,11,25,3,0,2,1,48,15,9,24
"2011","Hounslow 013D","E01002586","Total",22,3,8,11,2,0,0,2,20,3,8,9
"2011","Hounslow 013E","E01002589","Total",70,23,11,36,6,1,4,1,64,22,7,35
"2011","Hounslow 014A","E01002668","Total",53,17,14,22,1,0,0,1,52,17,14,21
"2011","Hounslow 014B","E01002669","Total",101,26,22,53,8,1,3,4,93,25,19,49
"2011","Hounslow 014C","E01002681","Total",95,26,20,49,5,0,5,0,90,26,15,49
"2011","Hounslow 014D","E01002682","Total",81,18,33,30,8,2,5,1,73,16,28,29
"2011","Hounslow 014E","E01002683","Total",59,18,17,24,6,1,4,1,53,17,13,23
"2011","Hounslow 015A","E01002642","Total",43,13,8,22,3,0,0,3,40,13,8,19
"2011","Hounslow 015B","E01002643","Total",61,19,16,26,7,1,3,3,54,18,13,23
"2011","Hounslow 015C","E01002645","Total",41,10,13,18,4,1,2,1,37,9,11,17
"2011","Hounslow 015D","E01002658","Total",24,8,11,5,1,0,1,0,23,8,10,5
"2011","Hounslow 015E","E01002677","Total",41,7,10,24,4,1,1,2,37,6,9,22
"2011","Hounslow 016A","E01002587","Total",38,10,11,17,4,1,2,1,34,9,9,16
"2011","Hounslow 016B","E01002588","Total",115,29,22,64,7,0,4,3,108,29,18,61
"2011","Hounslow 016C","E01002660","Total",19,1,9,9,0,0,0,0,19,1,9,9
"2011","Hounslow 016D","E01002661","Total",14,4,7,3,3,2,0,1,11,2,7,2
"2011","Hounslow 016E","E01002665","Total",46,10,8,28,2,0,1,1,44,10,7,27
"2011","Hounslow 017A","E01002624","Total",28,7,6,15,1,0,1,0,27,7,5,15
"2011","Hounslow 017B","E01002646","Total",95,20,21,54,10,1,5,4,85,19,16,50
"2011","Hounslow 017C","E01002662","Total",28,6,7,15,4,0,3,1,24,6,4,14
"2011","Hounslow 017D","E01002663","Total",42,9,10,23,0,0,0,0,42,9,10,23
"2011","Hounslow 017E","E01002664","Total",46,13,11,22,4,1,2,1,42,12,9,21
"2011","Hounslow 018A","E01002641","Total",45,16,14,15,0,0,0,0,45,16,14,15
"2011","Hounslow 018C","E01002648","Total",77,22,9,46,2,1,0,1,75,21,9,45
"2011","Hounslow 018D","E01002649","Total",65,19,22,24,8,0,5,3,57,19,17,21
"2011","Hounslow 018E","E01002657","Total",40,12,16,12,3,2,1,0,37,10,15,12
"2011","Hounslow 018F","E01033083","Total",22,8,6,8,2,0,2,0,20,8,4,8
"2011","Hounslow 018G","E01033084","Total",69,23,12,34,8,5,2,1,61,18,10,33
"2011","Hounslow 019A","E01002653","Total",19,6,4,9,0,0,0,0,19,6,4,9
"2011","Hounslow 019B","E01002654","Total",35,16,9,10,1,1,0,0,34,15,9,10
"2011","Hounslow 019C","E01002655","Total",26,5,13,8,0,0,0,0,26,5,13,8
"2011","Hounslow 019D","E01002656","Total",32,16,10,6,2,1,1,0,30,15,9,6
"2011","Hounslow 019E","E01002659","Total",37,10,12,15,3,1,2,0,34,9,10,15
"2011","Hounslow 020A","E01002667","Total",58,17,11,30,4,0,0,4,54,17,11,26
"2011","Hounslow 020B","E01002670","Total",47,6,15,26,2,1,0,1,45,5,15,25
"2011","Hounslow 020C","E01002671","Total",44,11,19,14,0,0,0,0,44,11,19,14
"2011","Hounslow 020D","E01002672","Total",55,17,11,27,2,0,1,1,53,17,10,26
"2011","Hounslow 020E","E01002673","Total",127,32,13,82,10,2,1,7,117,30,12,75
"2011","Hounslow 021A","E01002647","Total",88,23,17,48,1,0,1,0,87,23,16,48
"2011","Hounslow 021B","E01002650","Total",97,21,17,59,12,2,3,7,85,19,14,52
"2011","Hounslow 021C","E01002651","Total",38,7,13,18,3,0,2,1,35,7,11,17
"2011","Hounslow 021D","E01002652","Total",24,3,5,16,3,0,2,1,21,3,3,15
"2011","Hounslow 021E","E01002666","Total",40,5,10,25,3,0,0,3,37,5,10,22
"2011","Hounslow 022A","E01002555","Total",48,10,12,26,10,3,3,4,38,7,9,22
"2011","Hounslow 022B","E01002556","Total",46,17,11,18,7,0,5,2,39,17,6,16
"2011","Hounslow 022C","E01002590","Total",71,19,21,31,2,0,1,1,69,19,20,30
"2011","Hounslow 022D","E01002592","Total",82,25,15,42,5,0,1,4,77,25,14,38
"2011","Hounslow 022E","E01002595","Total",68,22,10,36,7,2,0,5,61,20,10,31
"2011","Hounslow 023A","E01002557","Total",53,14,11,28,3,1,1,1,50,13,10,27
"2011","Hounslow 023B","E01002558","Total",84,18,26,40,6,0,5,1,78,18,21,39
"2011","Hounslow 023C","E01002559","Total",80,20,23,37,5,1,1,3,75,19,22,34
"2011","Hounslow 023D","E01002560","Total",49,13,12,24,4,1,3,0,45,12,9,24
"2011","Hounslow 023E","E01002561","Total",99,28,19,52,4,0,2,2,95,28,17,50
"2011","Hounslow 024A","E01002591","Total",61,16,22,23,5,1,3,1,56,15,19,22
"2011","Hounslow 024B","E01002593","Total",24,6,10,8,3,1,2,0,21,5,8,8
"2011","Hounslow 024C","E01002594","Total",62,23,14,25,11,3,4,4,51,20,10,21
"2011","Hounslow 024D","E01002611","Total",50,18,10,22,2,1,1,0,48,17,9,22
"2011","Hounslow 024E","E01002612","Total",84,22,21,41,5,0,3,2,79,22,18,39
"2011","Hounslow 024F","E01002613","Total",50,15,11,24,1,0,0,1,49,15,11,23
"2011","Hounslow 025B","E01002598","Total",78,13,20,45,3,0,1,2,75,13,19,43
"2011","Hounslow 025C","E01002599","Total",78,19,16,43,2,0,1,1,76,19,15,42
"2011","Hounslow 025D","E01002600","Total",49,13,11,25,5,1,3,1,44,12,8,24
"2011","Hounslow 025E","E01002603","Total",104,32,34,38,5,1,0,4,99,31,34,34
"2011","Hounslow 025F","E01033000","Total",116,36,22,58,10,3,3,4,106,33,19,54
"2011","Hounslow 025G","E01033030","Total",66,15,18,33,5,0,2,3,61,15,16,30
"2011","Hounslow 026A","E01002604","Total",131,32,24,75,11,2,4,5,120,30,20,70
"2011","Hounslow 026B","E01002605","Total",77,16,21,40,7,0,3,4,70,16,18,36
"2011","Hounslow 026C","E01002606","Total",89,22,17,50,5,1,3,1,84,21,14,49
"2011","Hounslow 026D","E01002607","Total",75,25,15,35,10,0,6,4,65,25,9,31
"2011","Hounslow 026E","E01002615","Total",83,24,14,45,8,1,3,4,75,23,11,41
"2011","Hounslow 027A","E01002596","Total",93,28,19,46,9,2,2,5,84,26,17,41
"2011","Hounslow 027B","E01002601","Total",65,18,17,30,7,0,5,2,58,18,12,28
"2011","Hounslow 027C","E01002602","Total",32,8,16,8,3,0,2,1,29,8,14,7
"2011","Hounslow 027D","E01002614","Total",72,16,18,38,9,1,2,6,63,15,16,32
"2011","Hounslow 027E","E01002616","Total",32,8,9,15,3,0,1,2,29,8,8,13
"2011","Hounslow 028A","E01002608","Total",90,27,17,46,5,1,3,1,85,26,14,45
"2011","Hounslow 028B","E01002609","Total",39,9,13,17,0,0,0,0,39,9,13,17
"2011","Hounslow 028C","E01002610","Total",79,20,16,43,2,0,2,0,77,20,14,43
"2011","Hounslow 028D","E01002617","Total",45,14,17,14,6,1,4,1,39,13,13,13
"2011","Hounslow 029A","E01002687","Total",24,9,6,9,0,0,0,0,24,9,6,9
"2011","Hounslow 029B","E01002691","Total",24,6,6,12,2,1,1,0,22,5,5,12
"2011","Hounslow 029C","E01002692","Total",53,9,13,31,12,0,3,9,41,9,10,22
"2011","Hounslow 029D","E01002693","Total",28,9,8,11,3,2,1,0,25,7,7,11
"2011","Hounslow 029E","E01032573","Total",17,5,9,3,3,0,3,0,14,5,6,3
"2011","Kingston upon Thames 001A","E01003006","Total",37,11,19,7,6,0,5,1,31,11,14,6
"2011","Kingston upon Thames 001B","E01003007","Total",26,11,8,7,3,0,3,0,23,11,5,7
"2011","Kingston upon Thames 001C","E01003008","Total",22,9,11,2,0,0,0,0,22,9,11,2
"2011","Kingston upon Thames 001D","E01003009","Total",49,11,18,20,2,0,1,1,47,11,17,19
"2011","Kingston upon Thames 001E","E01003010","Total",21,7,7,7,5,0,3,2,16,7,4,5
"2011","Kingston upon Thames 002A","E01002952","Total",17,4,9,4,2,0,2,0,15,4,7,4
"2011","Kingston upon Thames 002B","E01002953","Total",16,5,5,6,0,0,0,0,16,5,5,6
"2011","Kingston upon Thames 002C","E01002955","Total",21,8,4,9,4,1,3,0,17,7,1,9
"2011","Kingston upon Thames 002D","E01002956","Total",20,2,8,10,4,0,4,0,16,2,4,10
"2011","Kingston upon Thames 002E","E01002959","Total",8,2,1,5,1,1,0,0,7,1,1,5
"2011","Kingston upon Thames 003A","E01002935","Total",32,12,12,8,4,0,3,1,28,12,9,7
"2011","Kingston upon Thames 003B","E01002938","Total",36,13,13,10,3,0,1,2,33,13,12,8
"2011","Kingston upon Thames 003C","E01002951","Total",25,2,5,18,2,0,1,1,23,2,4,17
"2011","Kingston upon Thames 003D","E01002954","Total",36,9,6,21,2,0,1,1,34,9,5,20
"2011","Kingston upon Thames 003E","E01002957","Total",66,18,15,33,2,0,2,0,64,18,13,33
"2011","Kingston upon Thames 004A","E01002933","Total",58,23,15,20,3,0,3,0,55,23,12,20
"2011","Kingston upon Thames 004B","E01002934","Total",17,8,4,5,0,0,0,0,17,8,4,5
"2011","Kingston upon Thames 004D","E01002937","Total",18,3,9,6,2,1,1,0,16,2,8,6
"2011","Kingston upon Thames 004E","E01003011","Total",34,10,14,10,4,0,3,1,30,10,11,9
"2011","Kingston upon Thames 004F","E01033568","Total",68,19,17,32,5,0,4,1,63,19,13,31
"2011","Kingston upon Thames 004G","E01033569","Total",46,14,16,16,6,0,4,2,40,14,12,14
"2011","Kingston upon Thames 005A","E01002964","Total",53,10,16,27,1,0,1,0,52,10,15,27
"2011","Kingston upon Thames 005B","E01002969","Total",94,24,15,55,11,2,2,7,83,22,13,48
"2011","Kingston upon Thames 005C","E01002971","Total",29,8,7,14,3,0,3,0,26,8,4,14
"2011","Kingston upon Thames 005D","E01002972","Total",47,12,10,25,2,0,2,0,45,12,8,25
"2011","Kingston upon Thames 005E","E01002974","Total",44,11,9,24,6,2,2,2,38,9,7,22
"2011","Kingston upon Thames 006A","E01002932","Total",91,22,20,49,4,1,1,2,87,21,19,47
"2011","Kingston upon Thames 006B","E01002960","Total",25,4,13,8,3,1,2,0,22,3,11,8
"2011","Kingston upon Thames 006C","E01002962","Total",41,13,12,16,4,0,3,1,37,13,9,15
"2011","Kingston upon Thames 006D","E01002970","Total",51,15,14,22,3,0,1,2,48,15,13,20
"2011","Kingston upon Thames 006E","E01002973","Total",51,16,14,21,0,0,0,0,51,16,14,21
"2011","Kingston upon Thames 007A","E01002929","Total",22,8,6,8,2,1,1,0,20,7,5,8
"2011","Kingston upon Thames 007B","E01002930","Total",48,14,17,17,10,1,7,2,38,13,10,15
"2011","Kingston upon Thames 007C","E01002931","Total",30,6,12,12,5,0,4,1,25,6,8,11
"2011","Kingston upon Thames 007D","E01002963","Total",42,18,9,15,4,1,3,0,38,17,6,15
"2011","Kingston upon Thames 007E","E01002985","Total",37,14,11,12,5,0,4,1,32,14,7,11
"2011","Kingston upon Thames 008A","E01002927","Total",24,7,8,9,1,1,0,0,23,6,8,9
"2011","Kingston upon Thames 008B","E01002928","Total",34,12,9,13,3,2,0,1,31,10,9,12
"2011","Kingston upon Thames 008C","E01002958","Total",39,16,16,7,6,3,3,0,33,13,13,7
"2011","Kingston upon Thames 008D","E01002961","Total",22,5,9,8,1,0,1,0,21,5,8,8
"2011","Kingston upon Thames 008E","E01002986","Total",21,7,8,6,2,0,1,1,19,7,7,5
"2011","Kingston upon Thames 009A","E01002965","Total",51,10,17,24,7,1,4,2,44,9,13,22
"2011","Kingston upon Thames 009B","E01002967","Total",28,10,9,9,2,1,1,0,26,9,8,9
"2011","Kingston upon Thames 009C","E01002968","Total",26,5,11,10,5,0,5,0,21,5,6,10
"2011","Kingston upon Thames 009D","E01002990","Total",20,5,5,10,2,0,1,1,18,5,4,9
"2011","Kingston upon Thames 009E","E01002991","Total",12,3,4,5,3,0,1,2,9,3,3,3
"2011","Kingston upon Thames 010A","E01002922","Total",14,7,4,3,1,1,0,0,13,6,4,3
"2011","Kingston upon Thames 010B","E01002926","Total",26,9,9,8,3,1,2,0,23,8,7,8
"2011","Kingston upon Thames 010C","E01002966","Total",33,10,9,14,3,0,1,2,30,10,8,12
"2011","Kingston upon Thames 010D","E01002992","Total",17,8,4,5,0,0,0,0,17,8,4,5
"2011","Kingston upon Thames 011A","E01002921","Total",31,9,10,12,6,1,4,1,25,8,6,11
"2011","Kingston upon Thames 011B","E01002987","Total",22,3,6,13,1,0,0,1,21,3,6,12
"2011","Kingston upon Thames 011C","E01002988","Total",36,10,10,16,3,1,2,0,33,9,8,16
"2011","Kingston upon Thames 011D","E01002989","Total",23,5,14,4,3,0,3,0,20,5,11,4
"2011","Kingston upon Thames 012A","E01002975","Total",29,7,9,13,1,0,1,0,28,7,8,13
"2011","Kingston upon Thames 012B","E01002977","Total",73,21,18,34,6,0,6,0,67,21,12,34
"2011","Kingston upon Thames 012C","E01002980","Total",20,6,6,8,2,0,2,0,18,6,4,8
"2011","Kingston upon Thames 012D","E01002981","Total",17,5,5,7,4,3,1,0,13,2,4,7
"2011","Kingston upon Thames 012E","E01002984","Total",28,9,8,11,2,1,1,0,26,8,7,11
"2011","Kingston upon Thames 013A","E01002923","Total",72,16,23,33,7,1,5,1,65,15,18,32
"2011","Kingston upon Thames 013B","E01002925","Total",37,12,10,15,3,0,2,1,34,12,8,14
"2011","Kingston upon Thames 013C","E01002993","Total",30,8,9,13,0,0,0,0,30,8,9,13
"2011","Kingston upon Thames 013D","E01002995","Total",14,4,6,4,3,0,2,1,11,4,4,3
"2011","Kingston upon Thames 013E","E01002999","Total",34,10,8,16,1,1,0,0,33,9,8,16
"2011","Kingston upon Thames 014A","E01002915","Total",11,3,6,2,2,1,1,0,9,2,5,2
"2011","Kingston upon Thames 014B","E01002916","Total",13,5,2,6,0,0,0,0,13,5,2,6
"2011","Kingston upon Thames 014C","E01002917","Total",13,2,6,5,1,0,1,0,12,2,5,5
"2011","Kingston upon Thames 014D","E01002920","Total",15,9,3,3,1,0,0,1,14,9,3,2
"2011","Kingston upon Thames 014E","E01002924","Total",15,6,8,1,3,0,3,0,12,6,5,1
"2011","Kingston upon Thames 015A","E01002976","Total",32,16,8,8,2,0,2,0,30,16,6,8
"2011","Kingston upon Thames 015B","E01002978","Total",25,7,9,9,2,0,2,0,23,7,7,9
"2011","Kingston upon Thames 015C","E01002979","Total",33,13,9,11,2,0,0,2,31,13,9,9
"2011","Kingston upon Thames 015D","E01002982","Total",24,8,13,3,6,0,6,0,18,8,7,3
"2011","Kingston upon Thames 015E","E01002983","Total",22,5,12,5,4,0,4,0,18,5,8,5
"2011","Kingston upon Thames 016A","E01002994","Total",18,8,7,3,1,0,1,0,17,8,6,3
"2011","Kingston upon Thames 016B","E01002996","Total",27,9,11,7,3,1,0,2,24,8,11,5
"2011","Kingston upon Thames 016C","E01002997","Total",12,5,4,3,0,0,0,0,12,5,4,3
"2011","Kingston upon Thames 016D","E01002998","Total",79,25,16,38,8,0,0,8,71,25,16,30
"2011","Kingston upon Thames 016E","E01003002","Total",56,21,8,27,8,2,3,3,48,19,5,24
"2011","Kingston upon Thames 017A","E01002918","Total",67,27,23,17,2,0,2,0,65,27,21,17
"2011","Kingston upon Thames 017B","E01002919","Total",70,21,23,26,12,5,5,2,58,16,18,24
"2011","Kingston upon Thames 017C","E01003000","Total",54,16,20,18,4,0,2,2,50,16,18,16
"2011","Kingston upon Thames 017D","E01003001","Total",45,12,16,17,7,2,2,3,38,10,14,14
"2011","Kingston upon Thames 017E","E01003003","Total",45,8,20,17,5,0,4,1,40,8,16,16
"2011","Kingston upon Thames 018A","E01002939","Total",40,14,13,13,5,1,2,2,35,13,11,11
"2011","Kingston upon Thames 018B","E01002941","Total",29,14,7,8,6,4,0,2,23,10,7,6
"2011","Kingston upon Thames 018C","E01002942","Total",25,6,11,8,5,0,4,1,20,6,7,7
"2011","Kingston upon Thames 018D","E01003004","Total",39,10,17,12,2,0,2,0,37,10,15,12
"2011","Kingston upon Thames 018E","E01003005","Total",33,8,12,13,4,0,3,1,29,8,9,12
"2011","Kingston upon Thames 019A","E01002944","Total",45,11,16,18,6,0,2,4,39,11,14,14
"2011","Kingston upon Thames 019B","E01002945","Total",44,14,17,13,4,0,3,1,40,14,14,12
"2011","Kingston upon Thames 019C","E01002946","Total",44,15,15,14,1,0,1,0,43,15,14,14
"2011","Kingston upon Thames 019D","E01002947","Total",32,12,14,6,5,0,5,0,27,12,9,6
"2011","Kingston upon Thames 020A","E01002940","Total",67,30,9,28,7,3,2,2,60,27,7,26
"2011","Kingston upon Thames 020B","E01002943","Total",50,21,12,17,5,3,2,0,45,18,10,17
"2011","Kingston upon Thames 020C","E01002948","Total",79,31,19,29,2,0,2,0,77,31,17,29
"2011","Kingston upon Thames 020D","E01002949","Total",46,15,14,17,8,0,5,3,38,15,9,14
"2011","Kingston upon Thames 020E","E01002950","Total",81,21,10,50,3,1,1,1,78,20,9,49
"2011","Merton 001A","E01003472","Total",11,3,5,3,0,0,0,0,11,3,5,3
"2011","Merton 001B","E01003473","Total",14,6,5,3,1,0,1,0,13,6,4,3
"2011","Merton 001C","E01003474","Total",7,1,5,1,2,0,2,0,5,1,3,1
"2011","Merton 001D","E01003475","Total",104,28,19,57,7,0,2,5,97,28,17,52
"2011","Merton 001E","E01003478","Total",18,6,8,4,4,0,4,0,14,6,4,4
"2011","Merton 002A","E01003460","Total",25,5,5,15,0,0,0,0,25,5,5,15
"2011","Merton 002B","E01003462","Total",15,4,5,6,2,0,2,0,13,4,3,6
"2011","Merton 002C","E01003464","Total",8,1,4,3,0,0,0,0,8,1,4,3
"2011","Merton 002D","E01003465","Total",15,3,5,7,1,0,1,0,14,3,4,7
"2011","Merton 003A","E01003400","Total",15,4,3,8,1,0,1,0,14,4,2,8
"2011","Merton 003B","E01003454","Total",22,9,7,6,1,1,0,0,21,8,7,6
"2011","Merton 003C","E01003456","Total",18,7,5,6,0,0,0,0,18,7,5,6
"2011","Merton 003D","E01003476","Total",40,14,10,16,3,1,0,2,37,13,10,14
"2011","Merton 003E","E01003477","Total",24,10,7,7,2,0,1,1,22,10,6,6
"2011","Merton 004A","E01003401","Total",11,6,2,3,3,2,1,0,8,4,1,3
"2011","Merton 004B","E01003402","Total",14,6,5,3,1,1,0,0,13,5,5,3
"2011","Merton 004C","E01003403","Total",13,2,6,5,1,0,1,0,12,2,5,5
"2011","Merton 004D","E01003404","Total",21,5,7,9,3,0,1,2,18,5,6,7
"2011","Merton 004E","E01003461","Total",11,4,2,5,1,0,1,0,10,4,1,5
"2011","Merton 005A","E01003367","Total",30,11,12,7,0,0,0,0,30,11,12,7
"2011","Merton 005B","E01003369","Total",39,15,12,12,2,0,1,1,37,15,11,11
"2011","Merton 005C","E01003370","Total",41,14,11,16,1,1,0,0,40,13,11,16
"2011","Merton 005D","E01003371","Total",18,4,5,9,3,0,1,2,15,4,4,7
"2011","Merton 005E","E01003455","Total",40,18,10,12,2,0,1,1,38,18,9,11
"2011","Merton 006A","E01003359","Total",34,9,10,15,6,1,3,2,28,8,7,13
"2011","Merton 006B","E01003360","Total",20,5,6,9,3,1,2,0,17,4,4,9
"2011","Merton 006C","E01003457","Total",12,2,6,4,0,0,0,0,12,2,6,4
"2011","Merton 006D","E01003458","Total",17,3,10,4,1,0,1,0,16,3,9,4
"2011","Merton 006E","E01003459","Total",80,21,29,30,10,1,7,2,70,20,22,28
"2011","Merton 007A","E01003394","Total",22,8,5,9,0,0,0,0,22,8,5,9
"2011","Merton 007B","E01003395","Total",29,12,11,6,2,2,0,0,27,10,11,6
"2011","Merton 007C","E01003396","Total",27,4,10,13,3,0,0,3,24,4,10,10
"2011","Merton 007D","E01003397","Total",23,2,8,13,5,0,2,3,18,2,6,10
"2011","Merton 007E","E01003398","Total",45,15,13,17,3,2,0,1,42,13,13,16
"2011","Merton 008A","E01003368","Total",33,10,11,12,1,0,1,0,32,10,10,12
"2011","Merton 008B","E01003372","Total",64,24,13,27,1,0,0,1,63,24,13,26
"2011","Merton 008C","E01003393","Total",37,15,9,13,5,3,1,1,32,12,8,12
"2011","Merton 008D","E01003406","Total",94,32,26,36,3,0,1,2,91,32,25,34
"2011","Merton 008E","E01003407","Total",35,10,14,11,4,0,2,2,31,10,12,9
"2011","Merton 009A","E01003355","Total",21,4,7,10,5,1,4,0,16,3,3,10
"2011","Merton 009B","E01003356","Total",23,5,9,9,1,0,1,0,22,5,8,9
"2011","Merton 009C","E01003358","Total",18,5,5,8,1,0,1,0,17,5,4,8
"2011","Merton 009D","E01003383","Total",12,3,6,3,3,0,3,0,9,3,3,3
"2011","Merton 009E","E01003384","Total",19,4,7,8,1,0,1,0,18,4,6,8
"2011","Merton 010A","E01003442","Total",22,6,7,9,2,0,1,1,20,6,6,8
"2011","Merton 010B","E01003443","Total",21,4,8,9,1,0,0,1,20,4,8,8
"2011","Merton 010C","E01003444","Total",19,9,4,6,4,1,2,1,15,8,2,5
"2011","Merton 010D","E01003445","Total",24,10,8,6,0,0,0,0,24,10,8,6
"2011","Merton 010E","E01003463","Total",14,4,2,8,3,1,0,2,11,3,2,6
"2011","Merton 011A","E01003380","Total",24,7,10,7,0,0,0,0,24,7,10,7
"2011","Merton 011B","E01003382","Total",16,5,7,4,0,0,0,0,16,5,7,4
"2011","Merton 011C","E01003385","Total",12,6,4,2,3,1,2,0,9,5,2,2
"2011","Merton 011D","E01003399","Total",19,7,10,2,2,0,2,0,17,7,8,2
"2011","Merton 011E","E01003423","Total",21,5,8,8,2,0,2,0,19,5,6,8
"2011","Merton 012A","E01003357","Total",83,35,12,36,2,0,2,0,81,35,10,36
"2011","Merton 012B","E01003376","Total",68,19,20,29,4,0,2,2,64,19,18,27
"2011","Merton 012C","E01003377","Total",98,30,22,46,3,1,1,1,95,29,21,45
"2011","Merton 012D","E01003408","Total",47,14,13,20,3,1,1,1,44,13,12,19
"2011","Merton 012E","E01003410","Total",65,29,13,23,2,2,0,0,63,27,13,23
"2011","Merton 013A","E01003386","Total",95,37,24,34,7,1,4,2,88,36,20,32
"2011","Merton 013B","E01003388","Total",64,13,19,32,1,0,1,0,63,13,18,32
"2011","Merton 013C","E01003389","Total",70,23,17,30,3,0,2,1,67,23,15,29
"2011","Merton 013D","E01003392","Total",34,12,10,12,3,0,2,1,31,12,8,11
"2011","Merton 013E","E01003409","Total",61,17,16,28,4,1,3,0,57,16,13,28
"2011","Merton 014A","E01003387","Total",80,22,29,29,3,0,2,1,77,22,27,28
"2011","Merton 014B","E01003391","Total",91,24,18,49,4,1,1,2,87,23,17,47
"2011","Merton 014C","E01003411","Total",81,26,24,31,7,2,4,1,74,24,20,30
"2011","Merton 014D","E01003412","Total",74,17,32,25,5,2,2,1,69,15,30,24
"2011","Merton 014E","E01003435","Total",38,12,17,9,1,0,1,0,37,12,16,9
"2011","Merton 015A","E01003361","Total",30,8,11,11,6,2,3,1,24,6,8,10
"2011","Merton 015B","E01003424","Total",22,6,8,8,1,0,0,1,21,6,8,7
"2011","Merton 015C","E01003425","Total",12,5,3,4,0,0,0,0,12,5,3,4
"2011","Merton 015D","E01003426","Total",26,14,5,7,2,0,1,1,24,14,4,6
"2011","Merton 015E","E01003428","Total",15,4,5,6,2,0,1,1,13,4,4,5
"2011","Merton 016A","E01003366","Total",22,8,7,7,3,0,1,2,19,8,6,5
"2011","Merton 016B","E01003381","Total",10,2,3,5,0,0,0,0,10,2,3,5
"2011","Merton 016C","E01003446","Total",29,10,10,9,5,0,5,0,24,10,5,9
"2011","Merton 016D","E01003447","Total",60,19,12,29,1,0,1,0,59,19,11,29
"2011","Merton 016E","E01003471","Total",21,7,7,7,1,0,0,1,20,7,7,6
"2011","Merton 017A","E01003413","Total",82,18,30,34,5,2,1,2,77,16,29,32
"2011","Merton 017B","E01003414","Total",50,16,21,13,7,0,5,2,43,16,16,11
"2011","Merton 017C","E01003415","Total",55,15,21,19,3,0,3,0,52,15,18,19
"2011","Merton 017D","E01003416","Total",35,12,16,7,3,1,2,0,32,11,14,7
"2011","Merton 017E","E01003434","Total",53,20,23,10,2,0,1,1,51,20,22,9
"2011","Merton 018A","E01003373","Total",100,27,21,52,4,1,1,2,96,26,20,50
"2011","Merton 018B","E01003378","Total",92,26,30,36,8,1,4,3,84,25,26,33
"2011","Merton 018C","E01003379","Total",83,23,23,37,1,0,1,0,82,23,22,37
"2011","Merton 018D","E01003390","Total",93,33,20,40,2,0,0,2,91,33,20,38
"2011","Merton 018E","E01003405","Total",60,14,28,18,5,0,3,2,55,14,25,16
"2011","Merton 019A","E01003429","Total",53,19,21,13,3,2,1,0,50,17,20,13
"2011","Merton 019B","E01003430","Total",100,41,18,41,5,0,3,2,95,41,15,39
"2011","Merton 019C","E01003431","Total",98,31,25,42,4,0,2,2,94,31,23,40
"2011","Merton 019D","E01003432","Total",109,27,28,54,8,0,7,1,101,27,21,53
"2011","Merton 019E","E01003433","Total",61,17,19,25,1,0,1,0,60,17,18,25
"2011","Merton 020A","E01003466","Total",26,8,8,10,2,0,1,1,24,8,7,9
"2011","Merton 020B","E01003467","Total",20,7,6,7,2,0,1,1,18,7,5,6
"2011","Merton 020C","E01003468","Total",27,9,7,11,3,0,1,2,24,9,6,9
"2011","Merton 020D","E01003469","Total",46,11,11,24,5,0,2,3,41,11,9,21
"2011","Merton 020E","E01003470","Total",29,11,12,6,1,0,1,0,28,11,11,6
"2011","Merton 021A","E01003362","Total",14,5,5,4,1,1,0,0,13,4,5,4
"2011","Merton 021B","E01003363","Total",25,6,11,8,4,1,3,0,21,5,8,8
"2011","Merton 021C","E01003364","Total",17,3,7,7,3,1,2,0,14,2,5,7
"2011","Merton 021D","E01003365","Total",18,6,9,3,1,0,1,0,17,6,8,3
"2011","Merton 021E","E01003421","Total",26,11,6,9,4,2,1,1,22,9,5,8
"2011","Merton 022A","E01003374","Total",74,15,28,31,8,0,7,1,66,15,21,30
"2011","Merton 022B","E01003375","Total",40,9,18,13,1,0,1,0,39,9,17,13
"2011","Merton 022C","E01003437","Total",36,15,11,10,1,0,1,0,35,15,10,10
"2011","Merton 022D","E01003440","Total",57,21,17,19,3,0,2,1,54,21,15,18
"2011","Merton 022E","E01003441","Total",70,13,24,33,0,0,0,0,70,13,24,33
"2011","Merton 023A","E01003427","Total",35,9,12,14,4,0,2,2,31,9,10,12
"2011","Merton 023B","E01003436","Total",55,12,19,24,2,0,2,0,53,12,17,24
"2011","Merton 023C","E01003439","Total",57,19,11,27,1,0,0,1,56,19,11,26
"2011","Merton 023D","E01003448","Total",74,22,16,36,5,1,1,3,69,21,15,33
"2011","Merton 023E","E01003453","Total",51,18,10,23,1,0,0,1,50,18,10,22
"2011","Merton 024A","E01003438","Total",69,27,9,33,6,1,1,4,63,26,8,29
"2011","Merton 024B","E01003449","Total",41,10,6,25,3,1,0,2,38,9,6,23
"2011","Merton 024C","E01003450","Total",65,18,22,25,0,0,0,0,65,18,22,25
"2011","Merton 024D","E01003451","Total",20,9,4,7,1,0,0,1,19,9,4,6
"2011","Merton 024E","E01003452","Total",72,22,18,32,4,1,2,1,68,21,16,31
"2011","Merton 025A","E01003417","Total",39,13,17,9,4,0,3,1,35,13,14,8
"2011","Merton 025B","E01003418","Total",23,3,11,9,2,0,2,0,21,3,9,9
"2011","Merton 025C","E01003419","Total",46,16,16,14,2,0,2,0,44,16,14,14
"2011","Merton 025D","E01003420","Total",27,6,11,10,4,0,2,2,23,6,9,8
"2011","Merton 025E","E01003422","Total",22,9,8,5,1,0,1,0,21,9,7,5
"2011","Redbridge 001A","E01003744","Total",19,3,12,4,2,0,1,1,17,3,11,3
"2011","Redbridge 001B","E01003745","Total",12,5,6,1,1,0,1,0,11,5,5,1
"2011","Redbridge 001C","E01003746","Total",10,4,2,4,0,0,0,0,10,4,2,4
"2011","Redbridge 001D","E01003747","Total",15,3,8,4,4,0,4,0,11,3,4,4
"2011","Redbridge 001E","E01003748","Total",15,5,7,3,3,0,2,1,12,5,5,2
"2011","Redbridge 001F","E01003749","Total",32,8,13,11,3,0,2,1,29,8,11,10
"2011","Redbridge 001G","E01003750","Total",30,12,10,8,1,0,0,1,29,12,10,7
"2011","Redbridge 002A","E01003720","Total",96,28,21,47,5,1,2,2,91,27,19,45
"2011","Redbridge 002B","E01003722","Total",82,21,20,41,9,0,2,7,73,21,18,34
"2011","Redbridge 002C","E01003723","Total",85,26,20,39,7,2,3,2,78,24,17,37
"2011","Redbridge 002D","E01003726","Total",103,25,20,58,10,1,0,9,93,24,20,49
"2011","Redbridge 003A","E01003721","Total",56,17,10,29,2,1,1,0,54,16,9,29
"2011","Redbridge 003B","E01003724","Total",58,19,17,22,2,0,1,1,56,19,16,21
"2011","Redbridge 003C","E01003725","Total",109,33,20,56,7,2,2,3,102,31,18,53
"2011","Redbridge 003D","E01003727","Total",72,15,22,35,2,0,2,0,70,15,20,35
"2011","Redbridge 004A","E01003654","Total",55,20,10,25,2,1,1,0,53,19,9,25
"2011","Redbridge 004B","E01003655","Total",40,8,12,20,4,0,2,2,36,8,10,18
"2011","Redbridge 004C","E01003658","Total",86,18,22,46,6,1,3,2,80,17,19,44
"2011","Redbridge 004D","E01003660","Total",40,13,14,13,6,0,4,2,34,13,10,11
"2011","Redbridge 005A","E01003656","Total",64,18,18,28,4,0,1,3,60,18,17,25
"2011","Redbridge 005B","E01003657","Total",79,22,23,34,5,1,2,2,74,21,21,32
"2011","Redbridge 005C","E01003659","Total",59,17,25,17,9,1,6,2,50,16,19,15
"2011","Redbridge 006A","E01003698","Total",39,11,7,21,3,0,2,1,36,11,5,20
"2011","Redbridge 006B","E01003699","Total",50,18,11,21,3,2,1,0,47,16,10,21
"2011","Redbridge 006C","E01003700","Total",65,20,12,33,4,1,2,1,61,19,10,32
"2011","Redbridge 006D","E01003701","Total",49,19,8,22,3,1,2,0,46,18,6,22
"2011","Redbridge 006E","E01003702","Total",61,26,14,21,3,0,0,3,58,26,14,18
"2011","Redbridge 006F","E01003703","Total",76,26,20,30,9,1,6,2,67,25,14,28
"2011","Redbridge 006G","E01003704","Total",91,14,15,62,1,0,1,0,90,14,14,62
"2011","Redbridge 007A","E01003668","Total",18,3,7,8,1,0,1,0,17,3,6,8
"2011","Redbridge 007B","E01003669","Total",22,8,9,5,4,2,1,1,18,6,8,4
"2011","Redbridge 007C","E01003670","Total",29,8,12,9,1,0,1,0,28,8,11,9
"2011","Redbridge 007D","E01003671","Total",24,9,12,3,5,1,4,0,19,8,8,3
"2011","Redbridge 007E","E01003672","Total",60,13,13,34,0,0,0,0,60,13,13,34
"2011","Redbridge 007F","E01003673","Total",35,12,10,13,2,1,1,0,33,11,9,13
"2011","Redbridge 007G","E01003674","Total",35,11,8,16,5,1,2,2,30,10,6,14
"2011","Redbridge 008A","E01003707","Total",27,11,7,9,3,1,2,0,24,10,5,9
"2011","Redbridge 008B","E01003708","Total",92,32,11,49,5,1,0,4,87,31,11,45
"2011","Redbridge 008C","E01003709","Total",35,7,14,14,2,1,0,1,33,6,14,13
"2011","Redbridge 008D","E01003710","Total",19,10,4,5,3,1,2,0,16,9,2,5
"2011","Redbridge 009A","E01003759","Total",17,8,5,4,1,0,1,0,16,8,4,4
"2011","Redbridge 009B","E01003760","Total",69,20,24,25,5,2,3,0,64,18,21,25
"2011","Redbridge 009C","E01003761","Total",121,29,27,65,9,2,2,5,112,27,25,60
"2011","Redbridge 009D","E01003762","Total",55,19,23,13,6,0,6,0,49,19,17,13
"2011","Redbridge 009E","E01003763","Total",45,17,10,18,2,0,1,1,43,17,9,17
"2011","Redbridge 009F","E01003764","Total",47,14,14,19,1,0,1,0,46,14,13,19
"2011","Redbridge 009G","E01003765","Total",34,10,15,9,0,0,0,0,34,10,15,9
"2011","Redbridge 010A","E01003705","Total",76,26,13,37,7,3,4,0,69,23,9,37
"2011","Redbridge 010B","E01003706","Total",64,16,12,36,5,0,3,2,59,16,9,34
"2011","Redbridge 010C","E01003711","Total",33,12,8,13,3,1,2,0,30,11,6,13
"2011","Redbridge 010D","E01003712","Total",61,11,13,37,4,0,1,3,57,11,12,34
"2011","Redbridge 012A","E01003646","Total",26,9,9,8,1,0,0,1,25,9,9,7
"2011","Redbridge 012B","E01003648","Total",5,2,0,3,0,0,0,0,5,2,0,3
"2011","Redbridge 012C","E01003649","Total",33,6,12,15,3,0,2,1,30,6,10,14
"2011","Redbridge 012D","E01003651","Total",14,5,4,5,0,0,0,0,14,5,4,5
"2011","Redbridge 013A","E01003639","Total",60,15,22,23,4,2,2,0,56,13,20,23
"2011","Redbridge 013B","E01003640","Total",44,11,18,15,5,0,5,0,39,11,13,15
"2011","Redbridge 013C","E01003641","Total",44,15,11,18,5,2,3,0,39,13,8,18
"2011","Redbridge 013D","E01003642","Total",60,17,10,33,2,0,0,2,58,17,10,31
"2011","Redbridge 014A","E01003774","Total",23,8,5,10,1,0,0,1,22,8,5,9
"2011","Redbridge 014B","E01003775","Total",28,9,11,8,3,0,3,0,25,9,8,8
"2011","Redbridge 014C","E01003776","Total",69,22,19,28,1,0,0,1,68,22,19,27
"2011","Redbridge 014D","E01003777","Total",21,6,9,6,4,0,3,1,17,6,6,5
"2011","Redbridge 014E","E01003778","Total",33,11,12,10,2,0,2,0,31,11,10,10
"2011","Redbridge 014F","E01003779","Total",19,5,10,4,2,0,2,0,17,5,8,4
"2011","Redbridge 014G","E01003780","Total",11,2,4,5,2,0,2,0,9,2,2,5
"2011","Redbridge 015A","E01003647","Total",25,8,7,10,1,0,1,0,24,8,6,10
"2011","Redbridge 015B","E01003650","Total",43,11,13,19,3,0,2,1,40,11,11,18
"2011","Redbridge 015C","E01003652","Total",28,6,8,14,1,0,1,0,27,6,7,14
"2011","Redbridge 015D","E01003653","Total",46,11,18,17,1,0,1,0,45,11,17,17
"2011","Redbridge 017A","E01003638","Total",42,11,10,21,4,1,3,0,38,10,7,21
"2011","Redbridge 017B","E01003643","Total",39,10,12,17,2,0,1,1,37,10,11,16
"2011","Redbridge 017C","E01003644","Total",33,11,7,15,0,0,0,0,33,11,7,15
"2011","Redbridge 017D","E01003645","Total",90,30,25,35,8,2,2,4,82,28,23,31
"2011","Redbridge 018A","E01003789","Total",13,2,9,2,0,0,0,0,13,2,9,2
"2011","Redbridge 018B","E01003794","Total",40,8,18,14,4,1,3,0,36,7,15,14
"2011","Redbridge 018C","E01003795","Total",26,10,9,7,3,2,0,1,23,8,9,6
"2011","Redbridge 018D","E01003796","Total",40,18,15,7,7,3,4,0,33,15,11,7
"2011","Redbridge 019A","E01003661","Total",59,12,20,27,3,0,2,1,56,12,18,26
"2011","Redbridge 019B","E01003662","Total",80,18,14,48,3,0,0,3,77,18,14,45
"2011","Redbridge 019C","E01003663","Total",41,14,13,14,1,0,1,0,40,14,12,14
"2011","Redbridge 019D","E01003664","Total",37,8,12,17,2,0,2,0,35,8,10,17
"2011","Redbridge 019E","E01003665","Total",46,10,19,17,3,0,1,2,43,10,18,15
"2011","Redbridge 019F","E01003666","Total",161,36,35,90,9,2,5,2,152,34,30,88
"2011","Redbridge 019H","E01033590","Total",80,21,16,43,1,1,0,0,79,20,16,43
"2011","Redbridge 019I","E01033592","Total",67,14,25,28,6,1,5,0,61,13,20,28
"2011","Redbridge 020A","E01003751","Total",42,14,9,19,1,1,0,0,41,13,9,19
"2011","Redbridge 020B","E01003753","Total",52,11,13,28,4,1,3,0,48,10,10,28
"2011","Redbridge 020C","E01003754","Total",28,8,7,13,0,0,0,0,28,8,7,13
"2011","Redbridge 020D","E01003757","Total",91,44,14,33,9,1,5,3,82,43,9,30
"2011","Redbridge 022A","E01003769","Total",64,7,10,47,7,0,2,5,57,7,8,42
"2011","Redbridge 022B","E01003770","Total",66,21,16,29,3,1,2,0,63,20,14,29
"2011","Redbridge 022C","E01003771","Total",83,18,14,51,4,2,1,1,79,16,13,50
"2011","Redbridge 022D","E01003773","Total",52,14,14,24,7,0,4,3,45,14,10,21
"2011","Redbridge 023A","E01003752","Total",44,15,9,20,1,0,0,1,43,15,9,19
"2011","Redbridge 023B","E01003755","Total",34,12,10,12,2,0,2,0,32,12,8,12
"2011","Redbridge 023C","E01003756","Total",36,11,9,16,1,0,0,1,35,11,9,15
"2011","Redbridge 023D","E01003758","Total",151,28,37,86,5,1,0,4,146,27,37,82
"2011","Redbridge 024A","E01003766","Total",35,9,4,22,2,0,0,2,33,9,4,20
"2011","Redbridge 024B","E01003767","Total",51,14,9,28,5,1,3,1,46,13,6,27
"2011","Redbridge 024C","E01003768","Total",60,9,7,44,3,0,0,3,57,9,7,41
"2011","Redbridge 024D","E01003772","Total",44,12,5,27,0,0,0,0,44,12,5,27
"2011","Redbridge 026A","E01003781","Total",42,6,11,25,4,0,2,2,38,6,9,23
"2011","Redbridge 026B","E01003782","Total",39,9,8,22,2,0,1,1,37,9,7,21
"2011","Redbridge 026C","E01003786","Total",27,2,10,15,2,0,0,2,25,2,10,13
"2011","Redbridge 026D","E01003787","Total",34,10,8,16,2,1,1,0,32,9,7,16
"2011","Redbridge 027A","E01003790","Total",33,9,12,12,0,0,0,0,33,9,12,12
"2011","Redbridge 027B","E01003791","Total",23,5,13,5,4,0,3,1,19,5,10,4
"2011","Redbridge 027C","E01003792","Total",24,5,14,5,4,0,4,0,20,5,10,5
"2011","Redbridge 027D","E01003793","Total",69,17,21,31,6,1,3,2,63,16,18,29
"2011","Redbridge 029A","E01003783","Total",87,20,11,56,5,2,1,2,82,18,10,54
"2011","Redbridge 029B","E01003784","Total",52,14,20,18,15,1,11,3,37,13,9,15
"2011","Redbridge 029C","E01003785","Total",76,14,32,30,17,5,11,1,59,9,21,29
"2011","Redbridge 029D","E01003788","Total",63,10,9,44,6,1,3,2,57,9,6,42
"2011","Redbridge 030A","E01003683","Total",77,11,5,61,1,1,0,0,76,10,5,61
"2011","Redbridge 030B","E01003684","Total",51,17,7,27,1,0,0,1,50,17,7,26
"2011","Redbridge 030C","E01003685","Total",48,13,4,31,9,6,1,2,39,7,3,29
"2011","Redbridge 030D","E01003686","Total",66,23,9,34,10,0,1,9,56,23,8,25
"2011","Redbridge 030F","E01003688","Total",45,8,2,35,7,3,2,2,38,5,0,33
"2011","Redbridge 030G","E01003689","Total",35,4,1,30,0,0,0,0,35,4,1,30
"2011","Redbridge 030H","E01033589","Total",53,12,9,32,6,0,3,3,47,12,6,29
"2011","Redbridge 030I","E01033591","Total",64,21,8,35,4,2,1,1,60,19,7,34
"2011","Redbridge 031A","E01003737","Total",38,10,6,22,2,0,1,1,36,10,5,21
"2011","Redbridge 031B","E01003738","Total",46,13,15,18,5,1,2,2,41,12,13,16
"2011","Redbridge 031C","E01003739","Total",69,26,19,24,5,3,1,1,64,23,18,23
"2011","Redbridge 031D","E01003740","Total",44,15,13,16,4,3,1,0,40,12,12,16
"2011","Redbridge 031E","E01003741","Total",38,7,15,16,6,0,4,2,32,7,11,14
"2011","Redbridge 031F","E01003742","Total",91,16,36,39,33,0,22,11,58,16,14,28
"2011","Redbridge 031G","E01003743","Total",49,9,14,26,8,1,5,2,41,8,9,24
"2011","Redbridge 032A","E01003728","Total",91,21,30,40,9,1,5,3,82,20,25,37
"2011","Redbridge 032B","E01003729","Total",49,6,4,39,3,1,1,1,46,5,3,38
"2011","Redbridge 032C","E01003730","Total",49,6,8,35,2,0,1,1,47,6,7,34
"2011","Redbridge 032D","E01003732","Total",178,31,21,126,6,3,0,3,172,28,21,123
"2011","Redbridge 032E","E01003733","Total",57,16,1,40,3,2,0,1,54,14,1,39
"2011","Redbridge 033A","E01003731","Total",68,14,15,39,2,0,0,2,66,14,15,37
"2011","Redbridge 033B","E01003734","Total",42,12,8,22,4,1,0,3,38,11,8,19
"2011","Redbridge 033C","E01003735","Total",222,27,33,162,8,1,5,2,214,26,28,160
"2011","Redbridge 033D","E01003736","Total",85,10,16,59,6,0,2,4,79,10,14,55
"2011","Redbridge 034A","E01003713","Total",37,9,10,18,2,0,2,0,35,9,8,18
"2011","Redbridge 034B","E01003714","Total",63,31,10,22,1,1,0,0,62,30,10,22
"2011","Redbridge 034C","E01003715","Total",54,13,5,36,1,0,0,1,53,13,5,35
"2011","Redbridge 034D","E01003716","Total",37,12,9,16,2,1,1,0,35,11,8,16
"2011","Redbridge 034E","E01003718","Total",46,9,8,29,2,0,0,2,44,9,8,27
"2011","Redbridge 034F","E01003719","Total",58,12,11,35,2,0,1,1,56,12,10,34
"2011","Redbridge 034G","E01032581","Total",92,20,24,48,4,0,1,3,88,20,23,45
"2011","Redbridge 035A","E01003690","Total",33,11,5,17,3,0,1,2,30,11,4,15
"2011","Redbridge 035B","E01003691","Total",32,13,9,10,6,1,3,2,26,12,6,8
"2011","Redbridge 035C","E01003692","Total",37,9,6,22,9,6,2,1,28,3,4,21
"2011","Redbridge 035D","E01003693","Total",15,2,7,6,1,0,1,0,14,2,6,6
"2011","Redbridge 035E","E01003694","Total",23,8,3,12,2,0,1,1,21,8,2,11
"2011","Redbridge 035F","E01003695","Total",30,14,5,11,4,3,1,0,26,11,4,11
"2011","Redbridge 035G","E01003696","Total",30,8,6,16,3,0,1,2,27,8,5,14
"2011","Redbridge 035H","E01003697","Total",22,7,5,10,0,0,0,0,22,7,5,10
"2011","Redbridge 036A","E01003675","Total",22,5,4,13,1,0,1,0,21,5,3,13
"2011","Redbridge 036B","E01003676","Total",24,13,6,5,4,1,3,0,20,12,3,5
"2011","Redbridge 036C","E01003677","Total",13,3,5,5,0,0,0,0,13,3,5,5
"2011","Redbridge 036D","E01003678","Total",34,8,13,13,3,0,3,0,31,8,10,13
"2011","Redbridge 036E","E01003679","Total",20,6,8,6,3,0,3,0,17,6,5,6
"2011","Redbridge 036F","E01003680","Total",33,9,11,13,3,1,2,0,30,8,9,13
"2011","Redbridge 036G","E01003681","Total",52,15,10,27,3,0,3,0,49,15,7,27
"2011","Redbridge 036H","E01003682","Total",25,5,11,9,1,0,1,0,24,5,10,9
"2011","Richmond upon Thames 001A","E01003797","Total",13,3,6,4,3,0,3,0,10,3,3,4
"2011","Richmond upon Thames 001B","E01003798","Total",28,14,9,5,1,0,1,0,27,14,8,5
"2011","Richmond upon Thames 001C","E01003799","Total",18,7,2,9,4,2,1,1,14,5,1,8
"2011","Richmond upon Thames 001D","E01003800","Total",49,16,4,29,1,0,0,1,48,16,4,28
"2011","Richmond upon Thames 001E","E01003801","Total",13,5,4,4,2,0,1,1,11,5,3,3
"2011","Richmond upon Thames 001F","E01003802","Total",25,8,7,10,2,1,0,1,23,7,7,9
"2011","Richmond upon Thames 001G","E01003803","Total",68,21,18,29,7,1,1,5,61,20,17,24
"2011","Richmond upon Thames 002A","E01003846","Total",26,9,13,4,0,0,0,0,26,9,13,4
"2011","Richmond upon Thames 002B","E01003847","Total",15,4,7,4,2,0,2,0,13,4,5,4
"2011","Richmond upon Thames 002C","E01003849","Total",15,2,6,7,1,0,1,0,14,2,5,7
"2011","Richmond upon Thames 002D","E01003851","Total",23,4,11,8,4,1,3,0,19,3,8,8
"2011","Richmond upon Thames 002E","E01003860","Total",14,3,3,8,2,0,0,2,12,3,3,6
"2011","Richmond upon Thames 002F","E01003864","Total",13,5,3,5,1,0,1,0,12,5,2,5
"2011","Richmond upon Thames 003A","E01003852","Total",28,6,7,15,2,0,1,1,26,6,6,14
"2011","Richmond upon Thames 003B","E01003853","Total",37,13,9,15,2,0,2,0,35,13,7,15
"2011","Richmond upon Thames 003C","E01003854","Total",24,12,4,8,2,0,1,1,22,12,3,7
"2011","Richmond upon Thames 003D","E01003855","Total",70,25,17,28,2,0,1,1,68,25,16,27
"2011","Richmond upon Thames 003E","E01003856","Total",46,20,10,16,3,1,2,0,43,19,8,16
"2011","Richmond upon Thames 003F","E01003857","Total",40,12,12,16,4,2,2,0,36,10,10,16
"2011","Richmond upon Thames 003G","E01003858","Total",34,11,12,11,4,1,3,0,30,10,9,11
"2011","Richmond upon Thames 004A","E01003848","Total",50,18,10,22,7,0,4,3,43,18,6,19
"2011","Richmond upon Thames 004C","E01003861","Total",35,11,7,17,4,1,1,2,31,10,6,15
"2011","Richmond upon Thames 004D","E01003862","Total",37,13,8,16,2,0,2,0,35,13,6,16
"2011","Richmond upon Thames 004E","E01003863","Total",24,4,12,8,3,0,2,1,21,4,10,7
"2011","Richmond upon Thames 004F","E01003865","Total",46,16,16,14,3,0,2,1,43,16,14,13
"2011","Richmond upon Thames 004G","E01033570","Total",49,8,12,29,5,2,1,2,44,6,11,27
"2011","Richmond upon Thames 004H","E01033571","Total",30,7,10,13,4,1,3,0,26,6,7,13
"2011","Richmond upon Thames 005A","E01003804","Total",46,13,18,15,1,0,0,1,45,13,18,14
"2011","Richmond upon Thames 005B","E01003807","Total",40,13,17,10,5,1,4,0,35,12,13,10
"2011","Richmond upon Thames 005C","E01003808","Total",40,15,10,15,3,2,1,0,37,13,9,15
"2011","Richmond upon Thames 005D","E01003809","Total",20,4,7,9,3,1,2,0,17,3,5,9
"2011","Richmond upon Thames 005E","E01003859","Total",31,13,14,4,5,5,0,0,26,8,14,4
"2011","Richmond upon Thames 006A","E01003873","Total",24,8,9,7,3,0,3,0,21,8,6,7
"2011","Richmond upon Thames 006B","E01003874","Total",15,8,4,3,0,0,0,0,15,8,4,3
"2011","Richmond upon Thames 006C","E01003875","Total",25,8,6,11,0,0,0,0,25,8,6,11
"2011","Richmond upon Thames 006D","E01003878","Total",45,9,20,16,6,1,2,3,39,8,18,13
"2011","Richmond upon Thames 007A","E01003866","Total",26,10,12,4,4,1,3,0,22,9,9,4
"2011","Richmond upon Thames 007B","E01003868","Total",15,3,8,4,1,0,0,1,14,3,8,3
"2011","Richmond upon Thames 007C","E01003871","Total",48,17,13,18,2,0,2,0,46,17,11,18
"2011","Richmond upon Thames 007D","E01003872","Total",20,8,6,6,0,0,0,0,20,8,6,6
"2011","Richmond upon Thames 008A","E01003821","Total",30,7,10,13,3,0,2,1,27,7,8,12
"2011","Richmond upon Thames 008B","E01003876","Total",14,4,5,5,0,0,0,0,14,4,5,5
"2011","Richmond upon Thames 008C","E01003877","Total",15,3,8,4,5,1,4,0,10,2,4,4
"2011","Richmond upon Thames 008D","E01003879","Total",21,8,10,3,2,0,2,0,19,8,8,3
"2011","Richmond upon Thames 009A","E01003892","Total",20,9,2,9,1,0,0,1,19,9,2,8
"2011","Richmond upon Thames 009B","E01003893","Total",16,3,7,6,3,0,3,0,13,3,4,6
"2011","Richmond upon Thames 009C","E01003894","Total",14,3,7,4,2,0,2,0,12,3,5,4
"2011","Richmond upon Thames 009D","E01003895","Total",31,13,7,11,2,1,0,1,29,12,7,10
"2011","Richmond upon Thames 010A","E01003905","Total",24,5,10,9,2,0,1,1,22,5,9,8
"2011","Richmond upon Thames 010B","E01003906","Total",35,7,11,17,1,0,1,0,34,7,10,17
"2011","Richmond upon Thames 010C","E01003907","Total",43,11,13,19,1,0,0,1,42,11,13,18
"2011","Richmond upon Thames 010D","E01003908","Total",23,8,12,3,2,0,2,0,21,8,10,3
"2011","Richmond upon Thames 010E","E01003909","Total",35,8,12,15,4,0,3,1,31,8,9,14
"2011","Richmond upon Thames 011A","E01003867","Total",23,2,12,9,2,0,1,1,21,2,11,8
"2011","Richmond upon Thames 011B","E01003869","Total",20,3,9,8,2,0,2,0,18,3,7,8
"2011","Richmond upon Thames 011C","E01003870","Total",21,6,7,8,2,1,1,0,19,5,6,8
"2011","Richmond upon Thames 011D","E01003910","Total",21,8,11,2,2,0,1,1,19,8,10,1
"2011","Richmond upon Thames 012A","E01003805","Total",19,8,4,7,1,1,0,0,18,7,4,7
"2011","Richmond upon Thames 012B","E01003806","Total",24,9,7,8,8,4,4,0,16,5,3,8
"2011","Richmond upon Thames 012C","E01003816","Total",39,9,17,13,10,0,9,1,29,9,8,12
"2011","Richmond upon Thames 012D","E01003817","Total",28,7,10,11,1,0,1,0,27,7,9,11
"2011","Richmond upon Thames 013A","E01003840","Total",55,14,19,22,4,2,1,1,51,12,18,21
"2011","Richmond upon Thames 013B","E01003841","Total",109,28,25,56,11,1,6,4,98,27,19,52
"2011","Richmond upon Thames 013C","E01003842","Total",54,12,12,30,9,1,3,5,45,11,9,25
"2011","Richmond upon Thames 013D","E01003843","Total",53,16,14,23,4,0,3,1,49,16,11,22
"2011","Richmond upon Thames 013E","E01003844","Total",22,5,6,11,3,0,3,0,19,5,3,11
"2011","Richmond upon Thames 013F","E01003845","Total",18,6,6,6,5,1,4,0,13,5,2,6
"2011","Richmond upon Thames 014A","E01003882","Total",31,7,14,10,4,1,3,0,27,6,11,10
"2011","Richmond upon Thames 014B","E01003883","Total",17,1,11,5,0,0,0,0,17,1,11,5
"2011","Richmond upon Thames 014C","E01003896","Total",20,9,5,6,2,0,2,0,18,9,3,6
"2011","Richmond upon Thames 014D","E01003897","Total",35,11,8,16,6,3,3,0,29,8,5,16
"2011","Richmond upon Thames 015A","E01003898","Total",35,13,16,6,4,2,1,1,31,11,15,5
"2011","Richmond upon Thames 015B","E01003899","Total",21,3,15,3,5,0,5,0,16,3,10,3
"2011","Richmond upon Thames 015C","E01003900","Total",49,20,9,20,2,0,2,0,47,20,7,20
"2011","Richmond upon Thames 015D","E01003901","Total",22,5,11,6,2,0,2,0,20,5,9,6
"2011","Richmond upon Thames 015E","E01003902","Total",23,6,11,6,1,0,1,0,22,6,10,6
"2011","Richmond upon Thames 015F","E01003903","Total",61,15,26,20,6,2,4,0,55,13,22,20
"2011","Richmond upon Thames 015G","E01003904","Total",38,11,19,8,6,2,3,1,32,9,16,7
"2011","Richmond upon Thames 016A","E01003880","Total",22,7,9,6,3,0,3,0,19,7,6,6
"2011","Richmond upon Thames 016B","E01003881","Total",17,1,13,3,4,0,3,1,13,1,10,2
"2011","Richmond upon Thames 016C","E01003884","Total",25,9,11,5,3,2,1,0,22,7,10,5
"2011","Richmond upon Thames 016D","E01003885","Total",39,9,11,19,8,0,3,5,31,9,8,14
"2011","Richmond upon Thames 017A","E01003818","Total",46,16,17,13,4,2,2,0,42,14,15,13
"2011","Richmond upon Thames 017B","E01003819","Total",77,23,13,41,3,0,1,2,74,23,12,39
"2011","Richmond upon Thames 017C","E01003820","Total",54,13,16,25,4,0,2,2,50,13,14,23
"2011","Richmond upon Thames 018A","E01003811","Total",27,12,12,3,1,0,1,0,26,12,11,3
"2011","Richmond upon Thames 018B","E01003812","Total",46,7,22,17,3,1,2,0,43,6,20,17
"2011","Richmond upon Thames 018C","E01003890","Total",25,4,13,8,3,0,2,1,22,4,11,7
"2011","Richmond upon Thames 018D","E01003891","Total",18,10,6,2,0,0,0,0,18,10,6,2
"2011","Richmond upon Thames 019A","E01003810","Total",24,13,7,4,1,0,1,0,23,13,6,4
"2011","Richmond upon Thames 019B","E01003813","Total",26,8,15,3,4,0,4,0,22,8,11,3
"2011","Richmond upon Thames 019C","E01003814","Total",33,14,10,9,2,0,2,0,31,14,8,9
"2011","Richmond upon Thames 019D","E01003815","Total",59,23,18,18,2,0,2,0,57,23,16,18
"2011","Richmond upon Thames 020A","E01003828","Total",38,13,11,14,2,1,0,1,36,12,11,13
"2011","Richmond upon Thames 020B","E01003829","Total",69,29,14,26,11,0,3,8,58,29,11,18
"2011","Richmond upon Thames 020C","E01003830","Total",49,9,23,17,9,1,7,1,40,8,16,16
"2011","Richmond upon Thames 020D","E01003831","Total",56,17,17,22,2,0,1,1,54,17,16,21
"2011","Richmond upon Thames 020E","E01003832","Total",60,17,11,32,2,0,1,1,58,17,10,31
"2011","Richmond upon Thames 020F","E01003833","Total",42,13,12,17,2,0,1,1,40,13,11,16
"2011","Richmond upon Thames 021A","E01003886","Total",30,11,12,7,4,0,4,0,26,11,8,7
"2011","Richmond upon Thames 021B","E01003887","Total",27,12,10,5,4,0,3,1,23,12,7,4
"2011","Richmond upon Thames 021C","E01003888","Total",41,10,15,16,4,0,3,1,37,10,12,15
"2011","Richmond upon Thames 021D","E01003889","Total",14,6,6,2,3,1,1,1,11,5,5,1
"2011","Richmond upon Thames 022A","E01003834","Total",23,5,11,7,3,0,3,0,20,5,8,7
"2011","Richmond upon Thames 022B","E01003835","Total",19,9,4,6,3,0,3,0,16,9,1,6
"2011","Richmond upon Thames 022C","E01003836","Total",24,7,7,10,0,0,0,0,24,7,7,10
"2011","Richmond upon Thames 022D","E01003837","Total",45,12,18,15,7,2,3,2,38,10,15,13
"2011","Richmond upon Thames 022E","E01003838","Total",42,11,16,15,5,1,0,4,37,10,16,11
"2011","Richmond upon Thames 022F","E01003839","Total",77,19,12,46,4,0,2,2,73,19,10,44
"2011","Richmond upon Thames 023A","E01003822","Total",11,4,4,3,1,0,1,0,10,4,3,3
"2011","Richmond upon Thames 023B","E01003823","Total",31,10,6,15,2,0,1,1,29,10,5,14
"2011","Richmond upon Thames 023C","E01003824","Total",32,11,9,12,3,0,3,0,29,11,6,12
"2011","Richmond upon Thames 023D","E01003825","Total",26,8,10,8,3,2,1,0,23,6,9,8
"2011","Richmond upon Thames 023E","E01003826","Total",83,28,19,36,3,0,2,1,80,28,17,35
"2011","Richmond upon Thames 023F","E01003827","Total",47,16,15,16,3,0,3,0,44,16,12,16
"2011","Sutton 001A","E01004125","Total",67,22,19,26,3,0,1,2,64,22,18,24
"2011","Sutton 001B","E01004183","Total",87,29,22,36,3,2,1,0,84,27,21,36
"2011","Sutton 001C","E01004184","Total",99,22,15,62,5,1,1,3,94,21,14,59
"2011","Sutton 001D","E01004185","Total",106,40,16,50,4,0,1,3,102,40,15,47
"2011","Sutton 001E","E01004189","Total",98,33,20,45,6,0,4,2,92,33,16,43
"2011","Sutton 002A","E01004123","Total",119,29,35,55,13,4,6,3,106,25,29,52
"2011","Sutton 002B","E01004124","Total",81,27,18,36,8,0,2,6,73,27,16,30
"2011","Sutton 002C","E01004126","Total",98,29,21,48,6,0,1,5,92,29,20,43
"2011","Sutton 002D","E01004128","Total",69,18,18,33,8,0,5,3,61,18,13,30
"2011","Sutton 002E","E01004129","Total",83,17,22,44,6,2,3,1,77,15,19,43
"2011","Sutton 003A","E01004130","Total",44,12,14,18,5,2,3,0,39,10,11,18
"2011","Sutton 003B","E01004131","Total",44,17,12,15,3,0,3,0,41,17,9,15
"2011","Sutton 003C","E01004134","Total",31,11,9,11,5,3,1,1,26,8,8,10
"2011","Sutton 003D","E01004135","Total",28,6,14,8,2,0,2,0,26,6,12,8
"2011","Sutton 003E","E01004136","Total",23,9,7,7,2,0,2,0,21,9,5,7
"2011","Sutton 004A","E01004164","Total",22,6,8,8,5,0,3,2,17,6,5,6
"2011","Sutton 004B","E01004166","Total",33,10,14,9,3,2,1,0,30,8,13,9
"2011","Sutton 004C","E01004169","Total",52,13,15,24,2,0,1,1,50,13,14,23
"2011","Sutton 004D","E01004186","Total",71,19,27,25,9,2,7,0,62,17,20,25
"2011","Sutton 004E","E01004188","Total",81,20,18,43,6,2,3,1,75,18,15,42
"2011","Sutton 005A","E01004127","Total",70,23,21,26,8,1,6,1,62,22,15,25
"2011","Sutton 005B","E01004163","Total",37,10,12,15,5,0,2,3,32,10,10,12
"2011","Sutton 005C","E01004165","Total",62,18,23,21,8,0,7,1,54,18,16,20
"2011","Sutton 005D","E01004167","Total",56,18,16,22,1,1,0,0,55,17,16,22
"2011","Sutton 005E","E01004187","Total",71,25,24,22,8,2,4,2,63,23,20,20
"2011","Sutton 006A","E01004117","Total",23,10,11,2,2,0,2,0,21,10,9,2
"2011","Sutton 006B","E01004121","Total",20,8,5,7,1,0,1,0,19,8,4,7
"2011","Sutton 006C","E01004192","Total",67,31,13,23,3,0,1,2,64,31,12,21
"2011","Sutton 006D","E01004193","Total",89,30,20,39,6,2,3,1,83,28,17,38
"2011","Sutton 006E","E01004195","Total",32,16,8,8,3,1,2,0,29,15,6,8
"2011","Sutton 007A","E01004144","Total",33,11,7,15,3,0,0,3,30,11,7,12
"2011","Sutton 007B","E01004145","Total",53,20,18,15,7,2,3,2,46,18,15,13
"2011","Sutton 007C","E01004146","Total",55,18,13,24,6,0,2,4,49,18,11,20
"2011","Sutton 007D","E01004147","Total",26,12,7,7,0,0,0,0,26,12,7,7
"2011","Sutton 008A","E01004116","Total",13,4,5,4,3,0,3,0,10,4,2,4
"2011","Sutton 008B","E01004122","Total",14,5,6,3,4,0,3,1,10,5,3,2
"2011","Sutton 008C","E01004190","Total",17,6,6,5,0,0,0,0,17,6,6,5
"2011","Sutton 008D","E01004191","Total",32,7,12,13,2,0,2,0,30,7,10,13
"2011","Sutton 008E","E01004194","Total",37,11,15,11,3,0,2,1,34,11,13,10
"2011","Sutton 008F","E01004196","Total",29,8,11,10,2,0,2,0,27,8,9,10
"2011","Sutton 009A","E01004115","Total",43,14,19,10,4,1,2,1,39,13,17,9
"2011","Sutton 009B","E01004118","Total",38,8,11,19,4,1,3,0,34,7,8,19
"2011","Sutton 009C","E01004119","Total",23,10,10,3,4,0,4,0,19,10,6,3
"2011","Sutton 009D","E01004132","Total",28,13,11,4,1,0,1,0,27,13,10,4
"2011","Sutton 009E","E01004133","Total",35,10,19,6,4,0,3,1,31,10,16,5
"2011","Sutton 010A","E01004171","Total",27,9,12,6,5,0,5,0,22,9,7,6
"2011","Sutton 010B","E01004172","Total",97,34,14,49,3,0,0,3,94,34,14,46
"2011","Sutton 010C","E01004173","Total",29,8,8,13,5,3,2,0,24,5,6,13
"2011","Sutton 010D","E01004175","Total",47,13,11,23,2,0,1,1,45,13,10,22
"2011","Sutton 010E","E01004176","Total",52,18,18,16,8,1,3,4,44,17,15,12
"2011","Sutton 011A","E01004076","Total",52,18,15,19,5,1,1,3,47,17,14,16
"2011","Sutton 011B","E01004077","Total",38,7,16,15,3,0,3,0,35,7,13,15
"2011","Sutton 011C","E01004078","Total",65,18,22,25,3,1,2,0,62,17,20,25
"2011","Sutton 011D","E01004079","Total",14,8,6,0,2,0,2,0,12,8,4,0
"2011","Sutton 011E","E01004080","Total",22,6,11,5,2,0,2,0,20,6,9,5
"2011","Sutton 011F","E01004081","Total",38,15,13,10,2,0,2,0,36,15,11,10
"2011","Sutton 011G","E01004082","Total",26,6,15,5,2,0,2,0,24,6,13,5
"2011","Sutton 012A","E01004137","Total",42,13,11,18,3,2,0,1,39,11,11,17
"2011","Sutton 012B","E01004140","Total",64,12,19,33,6,2,3,1,58,10,16,32
"2011","Sutton 012C","E01004141","Total",65,13,11,41,0,0,0,0,65,13,11,41
"2011","Sutton 012D","E01004142","Total",97,29,18,50,8,2,3,3,89,27,15,47
"2011","Sutton 012E","E01004149","Total",47,11,10,26,1,0,1,0,46,11,9,26
"2011","Sutton 013A","E01004101","Total",25,10,9,6,3,0,3,0,22,10,6,6
"2011","Sutton 013B","E01004103","Total",46,16,14,16,2,0,1,1,44,16,13,15
"2011","Sutton 013C","E01004138","Total",59,13,23,23,5,1,1,3,54,12,22,20
"2011","Sutton 013D","E01004139","Total",38,10,13,15,2,0,1,1,36,10,12,14
"2011","Sutton 013E","E01004168","Total",23,8,10,5,3,1,1,1,20,7,9,4
"2011","Sutton 014A","E01004143","Total",57,18,22,17,4,0,4,0,53,18,18,17
"2011","Sutton 014B","E01004148","Total",68,21,11,36,2,0,1,1,66,21,10,35
"2011","Sutton 014C","E01004159","Total",38,8,17,13,5,0,4,1,33,8,13,12
"2011","Sutton 014D","E01004160","Total",38,11,14,13,8,0,7,1,30,11,7,12
"2011","Sutton 014E","E01004161","Total",31,4,19,8,2,0,2,0,29,4,17,8
"2011","Sutton 015A","E01004097","Total",33,11,11,11,4,0,4,0,29,11,7,11
"2011","Sutton 015B","E01004098","Total",24,7,2,15,2,0,0,2,22,7,2,13
"2011","Sutton 015C","E01004099","Total",54,21,13,20,3,1,0,2,51,20,13,18
"2011","Sutton 015D","E01004100","Total",31,15,7,9,1,0,1,0,30,15,6,9
"2011","Sutton 015E","E01004102","Total",16,5,4,7,2,1,1,0,14,4,3,7
"2011","Sutton 016A","E01004110","Total",53,15,23,15,5,0,5,0,48,15,18,15
"2011","Sutton 016B","E01004111","Total",21,5,5,11,2,0,1,1,19,5,4,10
"2011","Sutton 016C","E01004112","Total",24,13,6,5,3,0,3,0,21,13,3,5
"2011","Sutton 016D","E01004120","Total",20,7,7,6,2,0,2,0,18,7,5,6
"2011","Sutton 016E","E01004157","Total",11,6,4,1,1,0,0,1,10,6,4,0
"2011","Sutton 017A","E01004087","Total",16,8,6,2,4,2,2,0,12,6,4,2
"2011","Sutton 017B","E01004170","Total",36,10,14,12,2,0,2,0,34,10,12,12
"2011","Sutton 017C","E01004174","Total",49,13,23,13,4,1,2,1,45,12,21,12
"2011","Sutton 017D","E01004178","Total",69,23,25,21,14,6,7,1,55,17,18,20
"2011","Sutton 017E","E01004179","Total",19,6,6,7,3,2,1,0,16,4,5,7
"2011","Sutton 018A","E01004152","Total",63,13,21,29,3,0,2,1,60,13,19,28
"2011","Sutton 018B","E01004155","Total",28,8,9,11,2,0,2,0,26,8,7,11
"2011","Sutton 018C","E01004156","Total",37,11,12,14,2,0,2,0,35,11,10,14
"2011","Sutton 018D","E01004158","Total",27,9,13,5,2,0,2,0,25,9,11,5
"2011","Sutton 018E","E01004162","Total",32,9,6,17,3,2,1,0,29,7,5,17
"2011","Sutton 019A","E01004083","Total",85,26,15,44,6,0,2,4,79,26,13,40
"2011","Sutton 019B","E01004086","Total",45,12,16,17,3,0,3,0,42,12,13,17
"2011","Sutton 019C","E01004088","Total",142,40,26,76,6,0,1,5,136,40,25,71
"2011","Sutton 019D","E01004089","Total",106,30,16,60,7,4,2,1,99,26,14,59
"2011","Sutton 019E","E01004182","Total",105,26,24,55,5,1,2,2,100,25,22,53
"2011","Sutton 020A","E01004104","Total",23,13,7,3,1,0,1,0,22,13,6,3
"2011","Sutton 020B","E01004107","Total",58,18,19,21,7,1,3,3,51,17,16,18
"2011","Sutton 020C","E01004177","Total",74,15,15,44,3,1,2,0,71,14,13,44
"2011","Sutton 020D","E01004180","Total",18,3,8,7,3,1,2,0,15,2,6,7
"2011","Sutton 020E","E01004181","Total",49,13,14,22,4,0,4,0,45,13,10,22
"2011","Sutton 021A","E01004090","Total",63,14,11,38,2,1,1,0,61,13,10,38
"2011","Sutton 021B","E01004096","Total",42,11,13,18,2,0,1,1,40,11,12,17
"2011","Sutton 021C","E01004150","Total",55,17,23,15,7,0,7,0,48,17,16,15
"2011","Sutton 021D","E01004151","Total",42,13,13,16,3,1,2,0,39,12,11,16
"2011","Sutton 021E","E01004153","Total",50,18,11,21,2,0,2,0,48,18,9,21
"2011","Sutton 022A","E01004091","Total",21,9,8,4,5,0,3,2,16,9,5,2
"2011","Sutton 022B","E01004092","Total",17,8,6,3,0,0,0,0,17,8,6,3
"2011","Sutton 022C","E01004105","Total",37,10,13,14,3,0,3,0,34,10,10,14
"2011","Sutton 022D","E01004106","Total",12,6,4,2,1,1,0,0,11,5,4,2
"2011","Sutton 022E","E01004154","Total",12,8,2,2,1,1,0,0,11,7,2,2
"2011","Sutton 024A","E01004084","Total",15,6,7,2,2,0,2,0,13,6,5,2
"2011","Sutton 024B","E01004085","Total",20,3,11,6,3,0,3,0,17,3,8,6
"2011","Sutton 024C","E01004108","Total",39,9,13,17,3,0,2,1,36,9,11,16
"2011","Sutton 024D","E01004109","Total",59,16,21,22,5,0,4,1,54,16,17,21
"2011","Sutton 025A","E01004093","Total",23,10,9,4,4,3,1,0,19,7,8,4
"2011","Sutton 025B","E01004094","Total",46,18,18,10,3,1,2,0,43,17,16,10
"2011","Sutton 025C","E01004095","Total",17,5,6,6,2,0,2,0,15,5,4,6
"2011","Sutton 025D","E01004114","Total",12,4,3,5,2,1,0,1,10,3,3,4
"2011","Sutton 025E","E01032623","Total",11,6,2,3,2,0,2,0,9,6,0,3
"2011","Waltham Forest 001A","E01004349","Total",63,18,19,26,3,0,1,2,60,18,18,24
"2011","Waltham Forest 001B","E01004350","Total",55,11,11,33,5,0,1,4,50,11,10,29
"2011","Waltham Forest 001C","E01004351","Total",53,17,17,19,0,0,0,0,53,17,17,19
"2011","Waltham Forest 001D","E01004356","Total",66,16,17,33,7,2,4,1,59,14,13,32
"2011","Waltham Forest 001E","E01004357","Total",34,7,13,14,1,0,0,1,33,7,13,13
"2011","Waltham Forest 002A","E01004352","Total",23,4,12,7,3,0,1,2,20,4,11,5
"2011","Waltham Forest 002B","E01004353","Total",48,15,12,21,4,3,1,0,44,12,11,21
"2011","Waltham Forest 002C","E01004354","Total",62,14,27,21,6,1,5,0,56,13,22,21
"2011","Waltham Forest 002D","E01004358","Total",69,23,15,31,3,0,3,0,66,23,12,31
"2011","Waltham Forest 002E","E01004359","Total",28,7,10,11,1,0,0,1,27,7,10,10
"2011","Waltham Forest 003A","E01004384","Total",95,31,20,44,4,1,3,0,91,30,17,44
"2011","Waltham Forest 003B","E01004385","Total",65,11,12,42,9,2,2,5,56,9,10,37
"2011","Waltham Forest 003C","E01004386","Total",32,14,11,7,0,0,0,0,32,14,11,7
"2011","Waltham Forest 003D","E01004389","Total",81,22,20,39,4,0,2,2,77,22,18,37
"2011","Waltham Forest 003E","E01004390","Total",78,16,21,41,6,0,3,3,72,16,18,38
"2011","Waltham Forest 004A","E01004355","Total",67,16,15,36,1,0,0,1,66,16,15,35
"2011","Waltham Forest 004B","E01004360","Total",31,8,9,14,4,1,2,1,27,7,7,13
"2011","Waltham Forest 004C","E01004413","Total",88,22,19,47,5,2,2,1,83,20,17,46
"2011","Waltham Forest 004D","E01004415","Total",59,18,15,26,2,0,0,2,57,18,15,24
"2011","Waltham Forest 004E","E01004416","Total",61,20,17,24,3,0,2,1,58,20,15,23
"2011","Waltham Forest 005A","E01004361","Total",27,9,14,4,1,0,1,0,26,9,13,4
"2011","Waltham Forest 005B","E01004414","Total",55,12,22,21,4,1,3,0,51,11,19,21
"2011","Waltham Forest 005C","E01004417","Total",57,20,14,23,11,4,5,2,46,16,9,21
"2011","Waltham Forest 005D","E01004451","Total",53,16,20,17,1,0,1,0,52,16,19,17
"2011","Waltham Forest 005E","E01004452","Total",66,20,18,28,7,4,3,0,59,16,15,28
"2011","Waltham Forest 006A","E01004450","Total",47,16,16,15,3,2,1,0,44,14,15,15
"2011","Waltham Forest 006B","E01004453","Total",63,14,11,38,1,0,1,0,62,14,10,38
"2011","Waltham Forest 006C","E01004454","Total",66,18,18,30,4,1,1,2,62,17,17,28
"2011","Waltham Forest 006D","E01004455","Total",67,20,17,30,2,0,1,1,65,20,16,29
"2011","Waltham Forest 006E","E01004456","Total",90,23,15,52,2,2,0,0,88,21,15,52
"2011","Waltham Forest 007A","E01004379","Total",38,12,19,7,4,0,3,1,34,12,16,6
"2011","Waltham Forest 007B","E01004380","Total",50,13,16,21,1,0,1,0,49,13,15,21
"2011","Waltham Forest 007C","E01004381","Total",46,18,13,15,6,2,4,0,40,16,9,15
"2011","Waltham Forest 007D","E01004383","Total",40,11,11,18,2,1,1,0,38,10,10,18
"2011","Waltham Forest 007E","E01004387","Total",23,8,9,6,0,0,0,0,23,8,9,6
"2011","Waltham Forest 007F","E01004388","Total",44,9,16,19,5,1,3,1,39,8,13,18
"2011","Waltham Forest 008A","E01004343","Total",45,8,23,14,2,0,1,1,43,8,22,13
"2011","Waltham Forest 008B","E01004344","Total",83,22,25,36,2,0,2,0,81,22,23,36
"2011","Waltham Forest 008C","E01004382","Total",82,14,19,49,2,0,2,0,80,14,17,49
"2011","Waltham Forest 008D","E01004418","Total",82,20,25,37,5,0,4,1,77,20,21,36
"2011","Waltham Forest 008E","E01004419","Total",49,10,15,24,6,1,4,1,43,9,11,23
"2011","Waltham Forest 009A","E01004398","Total",96,22,16,58,5,1,1,3,91,21,15,55
"2011","Waltham Forest 009B","E01004399","Total",133,33,24,76,7,2,2,3,126,31,22,73
"2011","Waltham Forest 009C","E01004400","Total",59,17,18,24,2,1,1,0,57,16,17,24
"2011","Waltham Forest 009D","E01004402","Total",63,14,13,36,7,1,0,6,56,13,13,30
"2011","Waltham Forest 009E","E01004403","Total",68,14,16,38,4,1,1,2,64,13,15,36
"2011","Waltham Forest 010A","E01004345","Total",84,14,33,37,8,3,4,1,76,11,29,36
"2011","Waltham Forest 010B","E01004348","Total",101,23,30,48,8,1,3,4,93,22,27,44
"2011","Waltham Forest 010C","E01004377","Total",48,14,13,21,5,2,3,0,43,12,10,21
"2011","Waltham Forest 010D","E01004378","Total",71,19,15,37,5,0,3,2,66,19,12,35
"2011","Waltham Forest 011A","E01004342","Total",79,21,24,34,5,1,2,2,74,20,22,32
"2011","Waltham Forest 011B","E01004346","Total",63,10,21,32,5,1,3,1,58,9,18,31
"2011","Waltham Forest 011C","E01004347","Total",72,17,19,36,2,0,2,0,70,17,17,36
"2011","Waltham Forest 011D","E01004460","Total",70,24,15,31,3,0,0,3,67,24,15,28
"2011","Waltham Forest 011E","E01004462","Total",39,7,11,21,4,0,1,3,35,7,10,18
"2011","Waltham Forest 012A","E01004396","Total",37,6,13,18,2,0,2,0,35,6,11,18
"2011","Waltham Forest 012B","E01004457","Total",64,19,13,32,2,0,0,2,62,19,13,30
"2011","Waltham Forest 012C","E01004458","Total",63,25,13,25,5,0,2,3,58,25,11,22
"2011","Waltham Forest 012D","E01004459","Total",120,29,27,64,13,3,6,4,107,26,21,60
"2011","Waltham Forest 012E","E01004463","Total",74,22,18,34,2,1,1,0,72,21,17,34
"2011","Waltham Forest 013A","E01004407","Total",73,17,12,44,6,1,2,3,67,16,10,41
"2011","Waltham Forest 013B","E01004410","Total",103,24,28,51,5,1,1,3,98,23,27,48
"2011","Waltham Forest 013C","E01004464","Total",91,28,19,44,8,1,5,2,83,27,14,42
"2011","Waltham Forest 013D","E01004469","Total",77,16,12,49,3,1,1,1,74,15,11,48
"2011","Waltham Forest 013E","E01004470","Total",49,19,3,27,2,0,0,2,47,19,3,25
"2011","Waltham Forest 013F","E01004471","Total",87,23,21,43,6,0,4,2,81,23,17,41
"2011","Waltham Forest 014A","E01004391","Total",59,14,15,30,3,1,0,2,56,13,15,28
"2011","Waltham Forest 014B","E01004393","Total",63,14,16,33,6,0,3,3,57,14,13,30
"2011","Waltham Forest 014C","E01004401","Total",76,18,24,34,4,1,1,2,72,17,23,32
"2011","Waltham Forest 014D","E01004404","Total",79,25,22,32,5,0,4,1,74,25,18,31
"2011","Waltham Forest 014E","E01004461","Total",51,10,22,19,4,0,3,1,47,10,19,18
"2011","Waltham Forest 015A","E01004412","Total",46,10,12,24,1,0,0,1,45,10,12,23
"2011","Waltham Forest 015B","E01004465","Total",26,7,13,6,1,0,0,1,25,7,13,5
"2011","Waltham Forest 015C","E01004466","Total",35,9,9,17,1,0,0,1,34,9,9,16
"2011","Waltham Forest 015D","E01004467","Total",87,19,27,41,5,1,3,1,82,18,24,40
"2011","Waltham Forest 015E","E01004468","Total",35,9,17,9,4,1,3,0,31,8,14,9
"2011","Waltham Forest 016A","E01004406","Total",48,13,9,26,4,2,2,0,44,11,7,26
"2011","Waltham Forest 016B","E01004408","Total",60,15,17,28,2,0,2,0,58,15,15,28
"2011","Waltham Forest 016C","E01004409","Total",42,7,12,23,3,0,1,2,39,7,11,21
"2011","Waltham Forest 016D","E01004411","Total",35,5,12,18,4,1,1,2,31,4,11,16
"2011","Waltham Forest 016E","E01004443","Total",47,8,13,26,4,0,2,2,43,8,11,24
"2011","Waltham Forest 016F","E01004447","Total",35,10,8,17,4,2,1,1,31,8,7,16
"2011","Waltham Forest 017A","E01004392","Total",80,20,17,43,7,1,4,2,73,19,13,41
"2011","Waltham Forest 017B","E01004394","Total",75,24,12,39,4,1,0,3,71,23,12,36
"2011","Waltham Forest 017C","E01004397","Total",53,18,15,20,4,1,2,1,49,17,13,19
"2011","Waltham Forest 017D","E01004444","Total",97,24,19,54,8,1,2,5,89,23,17,49
"2011","Waltham Forest 017E","E01004446","Total",63,17,19,27,5,1,1,3,58,16,18,24
"2011","Waltham Forest 018A","E01004395","Total",39,5,18,16,4,0,2,2,35,5,16,14
"2011","Waltham Forest 018B","E01004421","Total",41,11,10,20,2,0,1,1,39,11,9,19
"2011","Waltham Forest 018C","E01004445","Total",34,5,8,21,5,0,2,3,29,5,6,18
"2011","Waltham Forest 018D","E01004448","Total",99,35,36,28,3,1,0,2,96,34,36,26
"2011","Waltham Forest 018E","E01004449","Total",79,11,17,51,5,1,2,2,74,10,15,49
"2011","Waltham Forest 019A","E01004363","Total",25,10,5,10,3,2,0,1,22,8,5,9
"2011","Waltham Forest 019B","E01004364","Total",66,9,14,43,4,0,2,2,62,9,12,41
"2011","Waltham Forest 019C","E01004366","Total",34,9,10,15,4,2,2,0,30,7,8,15
"2011","Waltham Forest 019D","E01004367","Total",40,13,6,21,11,7,2,2,29,6,4,19
"2011","Waltham Forest 019E","E01004368","Total",42,8,22,12,3,2,0,1,39,6,22,11
"2011","Waltham Forest 020A","E01004365","Total",51,13,8,30,2,0,0,2,49,13,8,28
"2011","Waltham Forest 020B","E01004405","Total",52,15,12,25,5,1,3,1,47,14,9,24
"2011","Waltham Forest 020C","E01004420","Total",50,10,15,25,6,1,2,3,44,9,13,22
"2011","Waltham Forest 020D","E01004423","Total",61,13,17,31,8,0,6,2,53,13,11,29
"2011","Waltham Forest 020G","E01033153","Total",165,32,30,103,9,3,2,4,156,29,28,99
"2011","Waltham Forest 021A","E01004362","Total",38,6,12,20,5,0,1,4,33,6,11,16
"2011","Waltham Forest 021B","E01004436","Total",42,14,11,17,9,1,7,1,33,13,4,16
"2011","Waltham Forest 021C","E01004437","Total",58,17,9,32,2,0,0,2,56,17,9,30
"2011","Waltham Forest 021D","E01004439","Total",60,17,20,23,4,1,2,1,56,16,18,22
"2011","Waltham Forest 021E","E01004442","Total",36,2,20,14,13,0,13,0,23,2,7,14
"2011","Waltham Forest 022A","E01004422","Total",54,12,18,24,4,1,3,0,50,11,15,24
"2011","Waltham Forest 022B","E01004424","Total",81,24,21,36,14,5,4,5,67,19,17,31
"2011","Waltham Forest 022C","E01004425","Total",116,29,29,58,6,1,3,2,110,28,26,56
"2011","Waltham Forest 022D","E01004426","Total",54,12,19,23,7,1,5,1,47,11,14,22
"2011","Waltham Forest 022E","E01004427","Total",104,29,29,46,7,0,5,2,97,29,24,44
"2011","Waltham Forest 023A","E01004369","Total",63,21,16,26,7,3,3,1,56,18,13,25
"2011","Waltham Forest 023B","E01004370","Total",23,8,7,8,4,2,1,1,19,6,6,7
"2011","Waltham Forest 023C","E01004372","Total",36,12,12,12,2,0,0,2,34,12,12,10
"2011","Waltham Forest 023D","E01004432","Total",62,25,14,23,8,4,1,3,54,21,13,20
"2011","Waltham Forest 023E","E01004435","Total",104,19,56,29,8,2,2,4,96,17,54,25
"2011","Waltham Forest 024A","E01004333","Total",82,20,18,44,11,3,5,3,71,17,13,41
"2011","Waltham Forest 024B","E01004334","Total",92,24,15,53,5,1,1,3,87,23,14,50
"2011","Waltham Forest 024C","E01004438","Total",39,11,11,17,4,1,0,3,35,10,11,14
"2011","Waltham Forest 024D","E01004440","Total",43,16,11,16,3,0,1,2,40,16,10,14
"2011","Waltham Forest 024E","E01004441","Total",35,8,13,14,3,2,0,1,32,6,13,13
"2011","Waltham Forest 025A","E01004371","Total",37,9,14,14,7,1,6,0,30,8,8,14
"2011","Waltham Forest 025B","E01004373","Total",28,9,8,11,2,0,1,1,26,9,7,10
"2011","Waltham Forest 025C","E01004374","Total",38,5,15,18,2,0,2,0,36,5,13,18
"2011","Waltham Forest 025D","E01004375","Total",47,12,11,24,6,1,2,3,41,11,9,21
"2011","Waltham Forest 025E","E01004376","Total",27,5,8,14,3,0,1,2,24,5,7,12
"2011","Waltham Forest 026A","E01004336","Total",37,10,9,18,5,2,2,1,32,8,7,17
"2011","Waltham Forest 026B","E01004428","Total",123,32,32,59,11,3,5,3,112,29,27,56
"2011","Waltham Forest 026C","E01004429","Total",87,19,29,39,4,1,1,2,83,18,28,37
"2011","Waltham Forest 026D","E01004430","Total",51,14,13,24,4,2,1,1,47,12,12,23
"2011","Waltham Forest 026E","E01004434","Total",75,12,11,52,4,0,2,2,71,12,9,50
"2011","Waltham Forest 027A","E01004335","Total",153,32,27,94,8,3,2,3,145,29,25,91
"2011","Waltham Forest 027B","E01004337","Total",69,14,18,37,5,0,1,4,64,14,17,33
"2011","Waltham Forest 027C","E01004338","Total",35,10,12,13,2,1,0,1,33,9,12,12
"2011","Waltham Forest 027D","E01004339","Total",65,13,17,35,9,1,4,4,56,12,13,31
"2011","Waltham Forest 027E","E01004340","Total",93,23,19,51,4,2,2,0,89,21,17,51
"2011","Waltham Forest 027F","E01004341","Total",81,19,19,43,1,0,0,1,80,19,19,42
"2011","Waltham Forest 028A","E01004327","Total",33,7,10,16,1,0,1,0,32,7,9,16
"2011","Waltham Forest 028B","E01004328","Total",53,11,19,23,5,1,3,1,48,10,16,22
"2011","Waltham Forest 028C","E01004329","Total",76,31,20,25,7,1,5,1,69,30,15,24
"2011","Waltham Forest 028D","E01004330","Total",42,11,13,18,0,0,0,0,42,11,13,18
"2011","Waltham Forest 028E","E01004331","Total",72,21,22,29,1,0,1,0,71,21,21,29
"2011","Waltham Forest 028F","E01004332","Total",56,22,8,26,4,2,1,1,52,20,7,25
"2011","Bracknell Forest 001C","E01016252","Total",26,10,9,7,5,2,2,1,21,8,7,6
"2011","Bracknell Forest 001D","E01016253","Total",28,6,15,7,0,0,0,0,28,6,15,7
"2011","Bracknell Forest 001E","E01032727","Total",37,15,15,7,4,1,3,0,33,14,12,7
"2011","Bracknell Forest 002A","E01016184","Total",53,8,21,24,6,0,4,2,47,8,17,22
"2011","Bracknell Forest 002B","E01016185","Total",35,11,18,6,7,1,5,1,28,10,13,5
"2011","Bracknell Forest 002C","E01016186","Total",34,10,12,12,2,1,1,0,32,9,11,12
"2011","Bracknell Forest 002D","E01016187","Total",25,10,12,3,1,0,1,0,24,10,11,3
"2011","Bracknell Forest 002E","E01016188","Total",37,16,13,8,3,0,3,0,34,16,10,8
"2011","Bracknell Forest 003A","E01016190","Total",36,15,6,15,3,1,2,0,33,14,4,15
"2011","Bracknell Forest 003B","E01016238","Total",28,13,11,4,4,0,4,0,24,13,7,4
"2011","Bracknell Forest 003C","E01016243","Total",35,12,11,12,6,2,4,0,29,10,7,12
"2011","Bracknell Forest 003D","E01016245","Total",43,15,18,10,4,0,4,0,39,15,14,10
"2011","Bracknell Forest 003E","E01016246","Total",31,17,12,2,3,0,3,0,28,17,9,2
"2011","Bracknell Forest 003F","E01016247","Total",39,11,15,13,5,1,4,0,34,10,11,13
"2011","Bracknell Forest 004A","E01016239","Total",44,17,11,16,5,0,5,0,39,17,6,16
"2011","Bracknell Forest 004B","E01016240","Total",58,20,17,21,1,0,1,0,57,20,16,21
"2011","Bracknell Forest 004C","E01016241","Total",59,27,19,13,3,0,3,0,56,27,16,13
"2011","Bracknell Forest 004D","E01016242","Total",90,31,22,37,10,0,5,5,80,31,17,32
"2011","Bracknell Forest 005A","E01016180","Total",31,14,7,10,1,0,0,1,30,14,7,9
"2011","Bracknell Forest 005B","E01016181","Total",27,13,8,6,2,0,1,1,25,13,7,5
"2011","Bracknell Forest 005C","E01016182","Total",43,12,21,10,2,1,1,0,41,11,20,10
"2011","Bracknell Forest 005D","E01016183","Total",46,20,17,9,5,0,2,3,41,20,15,6
"2011","Bracknell Forest 005E","E01016222","Total",17,6,5,6,0,0,0,0,17,6,5,6
"2011","Bracknell Forest 006B","E01016191","Total",36,15,11,10,1,0,1,0,35,15,10,10
"2011","Bracknell Forest 006C","E01016223","Total",39,13,13,13,4,1,3,0,35,12,10,13
"2011","Bracknell Forest 006D","E01016224","Total",86,30,17,39,9,2,4,3,77,28,13,36
"2011","Bracknell Forest 006E","E01016226","Total",38,14,7,17,3,0,1,2,35,14,6,15
"2011","Bracknell Forest 006F","E01032724","Total",73,12,16,45,3,0,3,0,70,12,13,45
"2011","Bracknell Forest 006G","E01032728","Total",39,11,16,12,1,1,0,0,38,10,16,12
"2011","Bracknell Forest 007A","E01016225","Total",82,22,18,42,5,0,3,2,77,22,15,40
"2011","Bracknell Forest 007B","E01016233","Total",106,42,26,38,13,1,6,6,93,41,20,32
"2011","Bracknell Forest 007C","E01016248","Total",38,13,8,17,2,0,2,0,36,13,6,17
"2011","Bracknell Forest 007D","E01016249","Total",60,16,10,34,5,0,2,3,55,16,8,31
"2011","Bracknell Forest 007E","E01016250","Total",42,15,12,15,6,1,4,1,36,14,8,14
"2011","Bracknell Forest 008A","E01016200","Total",43,16,18,9,4,0,4,0,39,16,14,9
"2011","Bracknell Forest 008B","E01016201","Total",36,12,12,12,5,0,4,1,31,12,8,11
"2011","Bracknell Forest 008C","E01016202","Total",27,12,10,5,2,0,1,1,25,12,9,4
"2011","Bracknell Forest 008D","E01016203","Total",52,16,11,25,2,0,1,1,50,16,10,24
"2011","Bracknell Forest 008E","E01016204","Total",37,12,12,13,2,0,1,1,35,12,11,12
"2011","Bracknell Forest 009A","E01016209","Total",40,17,9,14,4,1,3,0,36,16,6,14
"2011","Bracknell Forest 009B","E01016210","Total",70,24,11,35,6,0,2,4,64,24,9,31
"2011","Bracknell Forest 009D","E01016213","Total",25,7,5,13,4,0,1,3,21,7,4,10
"2011","Bracknell Forest 009E","E01016214","Total",9,5,4,0,0,0,0,0,9,5,4,0
"2011","Bracknell Forest 009F","E01016215","Total",52,13,16,23,6,0,4,2,46,13,12,21
"2011","Bracknell Forest 009G","E01032725","Total",66,18,17,31,3,0,3,0,63,18,14,31
"2011","Bracknell Forest 009H","E01032726","Total",57,18,18,21,4,1,2,1,53,17,16,20
"2011","Bracknell Forest 010A","E01016205","Total",24,5,10,9,2,0,1,1,22,5,9,8
"2011","Bracknell Forest 010B","E01016217","Total",34,11,8,15,0,0,0,0,34,11,8,15
"2011","Bracknell Forest 010C","E01016218","Total",41,20,7,14,2,0,2,0,39,20,5,14
"2011","Bracknell Forest 010D","E01016231","Total",72,25,24,23,12,0,9,3,60,25,15,20
"2011","Bracknell Forest 010E","E01016232","Total",43,11,18,14,8,0,4,4,35,11,14,10
"2011","Bracknell Forest 011A","E01016212","Total",65,21,14,30,4,1,3,0,61,20,11,30
"2011","Bracknell Forest 011B","E01016216","Total",30,14,10,6,4,0,4,0,26,14,6,6
"2011","Bracknell Forest 011C","E01016219","Total",29,9,10,10,3,0,2,1,26,9,8,9
"2011","Bracknell Forest 011D","E01016220","Total",58,15,20,23,10,1,6,3,48,14,14,20
"2011","Bracknell Forest 011E","E01016221","Total",32,13,11,8,2,0,2,0,30,13,9,8
"2011","Bracknell Forest 012A","E01016206","Total",36,14,14,8,5,1,4,0,31,13,10,8
"2011","Bracknell Forest 012B","E01016208","Total",30,9,16,5,6,1,5,0,24,8,11,5
"2011","Bracknell Forest 012C","E01016229","Total",22,15,5,2,4,1,3,0,18,14,2,2
"2011","Bracknell Forest 012D","E01016230","Total",12,3,8,1,0,0,0,0,12,3,8,1
"2011","Bracknell Forest 013A","E01016207","Total",41,16,15,10,4,1,2,1,37,15,13,9
"2011","Bracknell Forest 013B","E01016234","Total",21,6,9,6,3,0,2,1,18,6,7,5
"2011","Bracknell Forest 013C","E01016235","Total",23,11,8,4,3,0,2,1,20,11,6,3
"2011","Bracknell Forest 013D","E01016236","Total",65,24,11,30,6,0,4,2,59,24,7,28
"2011","Bracknell Forest 013E","E01016237","Total",29,10,10,9,4,0,4,0,25,10,6,9
"2011","Bracknell Forest 014A","E01016192","Total",30,10,12,8,4,0,4,0,26,10,8,8
"2011","Bracknell Forest 014B","E01016194","Total",12,5,6,1,1,0,1,0,11,5,5,1
"2011","Bracknell Forest 014C","E01016195","Total",33,10,15,8,6,1,5,0,27,9,10,8
"2011","Bracknell Forest 014D","E01016227","Total",29,10,13,6,7,0,7,0,22,10,6,6
"2011","Bracknell Forest 014E","E01016228","Total",24,4,12,8,4,0,4,0,20,4,8,8
"2011","Bracknell Forest 015A","E01016193","Total",31,11,14,6,3,0,3,0,28,11,11,6
"2011","Bracknell Forest 015B","E01016196","Total",30,11,12,7,3,1,2,0,27,10,10,7
"2011","Bracknell Forest 015C","E01016197","Total",49,14,16,19,3,2,0,1,46,12,16,18
"2011","Bracknell Forest 015D","E01016198","Total",19,6,7,6,1,0,1,0,18,6,6,6
"2011","Bracknell Forest 015E","E01016199","Total",18,8,4,6,1,0,1,0,17,8,3,6
"2011","Brighton and Hove 001A","E01016924","Total",36,20,10,6,1,0,1,0,35,20,9,6
"2011","Brighton and Hove 001B","E01016926","Total",98,30,16,52,12,2,2,8,86,28,14,44
"2011","Brighton and Hove 001C","E01016927","Total",54,17,19,18,12,2,8,2,42,15,11,16
"2011","Brighton and Hove 001D","E01016929","Total",50,20,12,18,8,0,5,3,42,20,7,15
"2011","Brighton and Hove 001E","E01016931","Total",34,16,8,10,0,0,0,0,34,16,8,10
"2011","Brighton and Hove 002A","E01016898","Total",48,20,8,20,5,1,2,2,43,19,6,18
"2011","Brighton and Hove 002B","E01016899","Total",21,8,1,12,2,0,1,1,19,8,0,11
"2011","Brighton and Hove 002C","E01016914","Total",86,20,13,53,12,2,3,7,74,18,10,46
"2011","Brighton and Hove 002D","E01016915","Total",73,12,7,54,10,2,3,5,63,10,4,49
"2011","Brighton and Hove 003A","E01016923","Total",38,12,10,16,8,0,4,4,30,12,6,12
"2011","Brighton and Hove 003B","E01016928","Total",40,17,12,11,4,1,2,1,36,16,10,10
"2011","Brighton and Hove 003C","E01016998","Total",28,12,13,3,5,0,3,2,23,12,10,1
"2011","Brighton and Hove 003D","E01016999","Total",20,13,5,2,4,0,4,0,16,13,1,2
"2011","Brighton and Hove 003E","E01017000","Total",51,21,20,10,11,3,6,2,40,18,14,8
"2011","Brighton and Hove 004A","E01016925","Total",58,20,18,20,8,1,4,3,50,19,14,17
"2011","Brighton and Hove 004B","E01016930","Total",42,27,8,7,0,0,0,0,42,27,8,7
"2011","Brighton and Hove 004C","E01017001","Total",27,9,13,5,4,1,2,1,23,8,11,4
"2011","Brighton and Hove 004D","E01017003","Total",53,23,18,12,8,0,6,2,45,23,12,10
"2011","Brighton and Hove 005A","E01016916","Total",29,10,13,6,5,0,4,1,24,10,9,5
"2011","Brighton and Hove 005B","E01016917","Total",50,22,13,15,5,0,5,0,45,22,8,15
"2011","Brighton and Hove 005C","E01016918","Total",72,21,14,37,5,1,2,2,67,20,12,35
"2011","Brighton and Hove 005D","E01016919","Total",70,29,16,25,6,1,2,3,64,28,14,22
"2011","Brighton and Hove 005E","E01016920","Total",75,33,23,19,6,0,5,1,69,33,18,18
"2011","Brighton and Hove 006A","E01016882","Total",71,23,15,33,7,0,5,2,64,23,10,31
"2011","Brighton and Hove 006B","E01016883","Total",29,11,6,12,2,0,0,2,27,11,6,10
"2011","Brighton and Hove 006C","E01016884","Total",42,14,14,14,3,0,1,2,39,14,13,12
"2011","Brighton and Hove 006D","E01016885","Total",103,39,13,51,4,0,3,1,99,39,10,50
"2011","Brighton and Hove 006E","E01016886","Total",47,21,11,15,6,0,4,2,41,21,7,13
"2011","Brighton and Hove 007A","E01016980","Total",31,11,6,14,3,1,2,0,28,10,4,14
"2011","Brighton and Hove 007B","E01016982","Total",23,14,6,3,3,2,1,0,20,12,5,3
"2011","Brighton and Hove 007C","E01016983","Total",29,11,7,11,3,1,2,0,26,10,5,11
"2011","Brighton and Hove 007D","E01016984","Total",24,6,9,9,3,2,1,0,21,4,8,9
"2011","Brighton and Hove 007E","E01016985","Total",57,23,21,13,12,2,9,1,45,21,12,12
"2011","Brighton and Hove 008A","E01016900","Total",120,23,12,85,11,0,3,8,109,23,9,77
"2011","Brighton and Hove 008B","E01016902","Total",69,27,12,30,7,2,4,1,62,25,8,29
"2011","Brighton and Hove 008C","E01016904","Total",128,28,11,89,7,1,0,6,121,27,11,83
"2011","Brighton and Hove 008D","E01016905","Total",68,18,20,30,2,2,0,0,66,16,20,30
"2011","Brighton and Hove 008E","E01016909","Total",69,22,11,36,4,2,2,0,65,20,9,36
"2011","Brighton and Hove 009A","E01016906","Total",93,24,23,46,9,0,5,4,84,24,18,42
"2011","Brighton and Hove 009B","E01016907","Total",40,8,10,22,2,0,2,0,38,8,8,22
"2011","Brighton and Hove 009C","E01016908","Total",94,35,11,48,9,1,1,7,85,34,10,41
"2011","Brighton and Hove 009D","E01016910","Total",106,34,19,53,11,0,2,9,95,34,17,44
"2011","Brighton and Hove 009E","E01016911","Total",58,19,12,27,2,0,1,1,56,19,11,26
"2011","Brighton and Hove 010A","E01016901","Total",62,27,19,16,11,3,7,1,51,24,12,15
"2011","Brighton and Hove 010B","E01016903","Total",76,23,33,20,15,2,7,6,61,21,26,14
"2011","Brighton and Hove 010C","E01016934","Total",28,15,10,3,3,1,2,0,25,14,8,3
"2011","Brighton and Hove 010D","E01016939","Total",47,22,22,3,3,0,3,0,44,22,19,3
"2011","Brighton and Hove 010E","E01016940","Total",37,18,16,3,5,1,4,0,32,17,12,3
"2011","Brighton and Hove 011A","E01016981","Total",31,16,6,9,6,3,3,0,25,13,3,9
"2011","Brighton and Hove 011B","E01017002","Total",38,14,13,11,8,0,6,2,30,14,7,9
"2011","Brighton and Hove 011C","E01017004","Total",62,28,20,14,12,7,4,1,50,21,16,13
"2011","Brighton and Hove 011D","E01017005","Total",43,18,19,6,3,0,2,1,40,18,17,5
"2011","Brighton and Hove 011E","E01017006","Total",52,18,20,14,4,0,4,0,48,18,16,14
"2011","Brighton and Hove 012A","E01016921","Total",75,15,21,39,8,1,4,3,67,14,17,36
"2011","Brighton and Hove 012B","E01016922","Total",61,26,9,26,7,2,3,2,54,24,6,24
"2011","Brighton and Hove 012C","E01016973","Total",68,17,19,32,13,0,5,8,55,17,14,24
"2011","Brighton and Hove 012D","E01016977","Total",64,32,17,15,6,2,4,0,58,30,13,15
"2011","Brighton and Hove 012E","E01016978","Total",79,25,22,32,13,1,6,6,66,24,16,26
"2011","Brighton and Hove 013A","E01016879","Total",64,22,11,31,10,1,2,7,54,21,9,24
"2011","Brighton and Hove 013B","E01016880","Total",88,32,8,48,6,0,0,6,82,32,8,42
"2011","Brighton and Hove 013C","E01016881","Total",55,23,15,17,7,2,3,2,48,21,12,15
"2011","Brighton and Hove 013D","E01016887","Total",44,18,13,13,5,0,2,3,39,18,11,10
"2011","Brighton and Hove 013E","E01016888","Total",34,15,8,11,1,0,1,0,33,15,7,11
"2011","Brighton and Hove 013F","E01016976","Total",42,16,12,14,4,1,2,1,38,15,10,13
"2011","Brighton and Hove 014A","E01016932","Total",39,15,13,11,5,0,3,2,34,15,10,9
"2011","Brighton and Hove 014B","E01016933","Total",35,11,8,16,5,0,1,4,30,11,7,12
"2011","Brighton and Hove 014C","E01016935","Total",58,23,18,17,7,1,5,1,51,22,13,16
"2011","Brighton and Hove 014D","E01016936","Total",42,12,23,7,11,1,9,1,31,11,14,6
"2011","Brighton and Hove 014E","E01016937","Total",51,20,8,23,3,1,1,1,48,19,7,22
"2011","Brighton and Hove 015A","E01016890","Total",40,16,10,14,8,3,2,3,32,13,8,11
"2011","Brighton and Hove 015B","E01016966","Total",44,11,12,21,7,2,3,2,37,9,9,19
"2011","Brighton and Hove 015C","E01016970","Total",56,20,21,15,8,0,4,4,48,20,17,11
"2011","Brighton and Hove 015D","E01016971","Total",32,13,7,12,8,2,4,2,24,11,3,10
"2011","Brighton and Hove 015E","E01016972","Total",52,24,13,15,6,1,4,1,46,23,9,14
"2011","Brighton and Hove 016A","E01016979","Total",58,21,22,15,4,1,3,0,54,20,19,15
"2011","Brighton and Hove 016B","E01016990","Total",95,44,28,23,11,5,5,1,84,39,23,22
"2011","Brighton and Hove 016C","E01016991","Total",80,28,22,30,9,2,2,5,71,26,20,25
"2011","Brighton and Hove 016D","E01016996","Total",67,39,15,13,3,1,2,0,64,38,13,13
"2011","Brighton and Hove 017A","E01017007","Total",84,27,18,39,12,2,7,3,72,25,11,36
"2011","Brighton and Hove 017B","E01017008","Total",41,22,7,12,9,1,4,4,32,21,3,8
"2011","Brighton and Hove 017C","E01017009","Total",47,16,14,17,10,1,7,2,37,15,7,15
"2011","Brighton and Hove 017D","E01017010","Total",49,21,11,17,3,0,3,0,46,21,8,17
"2011","Brighton and Hove 017E","E01017011","Total",81,32,13,36,6,1,4,1,75,31,9,35
"2011","Brighton and Hove 017F","E01017012","Total",55,25,11,19,6,2,3,1,49,23,8,18
"2011","Brighton and Hove 018A","E01016892","Total",57,21,17,19,15,3,7,5,42,18,10,14
"2011","Brighton and Hove 018B","E01016893","Total",46,24,12,10,4,0,2,2,42,24,10,8
"2011","Brighton and Hove 018C","E01016912","Total",50,25,11,14,1,0,1,0,49,25,10,14
"2011","Brighton and Hove 018D","E01016913","Total",40,21,9,10,6,2,2,2,34,19,7,8
"2011","Brighton and Hove 018E","E01016946","Total",48,21,18,9,5,3,1,1,43,18,17,8
"2011","Brighton and Hove 019A","E01016860","Total",62,18,21,23,13,3,4,6,49,15,17,17
"2011","Brighton and Hove 019B","E01016871","Total",65,22,19,24,14,1,9,4,51,21,10,20
"2011","Brighton and Hove 019C","E01016872","Total",54,18,17,19,11,3,6,2,43,15,11,17
"2011","Brighton and Hove 019D","E01016873","Total",32,15,6,11,3,0,3,0,29,15,3,11
"2011","Brighton and Hove 019E","E01016878","Total",57,28,11,18,4,1,3,0,53,27,8,18
"2011","Brighton and Hove 020A","E01016870","Total",49,24,12,13,6,2,4,0,43,22,8,13
"2011","Brighton and Hove 020B","E01016874","Total",44,18,15,11,1,1,0,0,43,17,15,11
"2011","Brighton and Hove 020C","E01016875","Total",28,14,6,8,4,0,2,2,24,14,4,6
"2011","Brighton and Hove 020D","E01016876","Total",46,19,11,16,1,0,0,1,45,19,11,15
"2011","Brighton and Hove 020E","E01016877","Total",56,25,7,24,3,1,2,0,53,24,5,24
"2011","Brighton and Hove 021A","E01016974","Total",61,28,14,19,3,2,0,1,58,26,14,18
"2011","Brighton and Hove 021B","E01016975","Total",73,25,15,33,4,0,2,2,69,25,13,31
"2011","Brighton and Hove 021C","E01016992","Total",25,11,8,6,1,0,0,1,24,11,8,5
"2011","Brighton and Hove 021D","E01016994","Total",62,20,15,27,8,3,3,2,54,17,12,25
"2011","Brighton and Hove 021E","E01016997","Total",32,15,8,9,3,1,2,0,29,14,6,9
"2011","Brighton and Hove 022A","E01016889","Total",29,12,7,10,5,2,1,2,24,10,6,8
"2011","Brighton and Hove 022B","E01016891","Total",52,14,18,20,11,0,8,3,41,14,10,17
"2011","Brighton and Hove 022C","E01016894","Total",69,23,15,31,10,2,3,5,59,21,12,26
"2011","Brighton and Hove 022D","E01016896","Total",53,18,18,17,10,2,5,3,43,16,13,14
"2011","Brighton and Hove 022E","E01016897","Total",51,18,10,23,7,0,5,2,44,18,5,21
"2011","Brighton and Hove 023A","E01016987","Total",39,11,13,15,6,2,3,1,33,9,10,14
"2011","Brighton and Hove 023B","E01016989","Total",35,15,7,13,2,0,2,0,33,15,5,13
"2011","Brighton and Hove 023C","E01016993","Total",48,11,13,24,4,1,1,2,44,10,12,22
"2011","Brighton and Hove 023D","E01016995","Total",31,17,7,7,0,0,0,0,31,17,7,7
"2011","Brighton and Hove 024A","E01016938","Total",41,14,20,7,3,0,3,0,38,14,17,7
"2011","Brighton and Hove 024B","E01016950","Total",43,23,10,10,10,4,3,3,33,19,7,7
"2011","Brighton and Hove 024C","E01016951","Total",26,9,10,7,7,0,4,3,19,9,6,4
"2011","Brighton and Hove 024D","E01016967","Total",38,14,13,11,1,0,1,0,37,14,12,11
"2011","Brighton and Hove 024E","E01016968","Total",29,9,8,12,6,0,2,4,23,9,6,8
"2011","Brighton and Hove 025A","E01016864","Total",66,20,12,34,4,0,2,2,62,20,10,32
"2011","Brighton and Hove 025B","E01016865","Total",122,35,13,74,14,4,4,6,108,31,9,68
"2011","Brighton and Hove 025C","E01016866","Total",101,25,13,63,10,1,6,3,91,24,7,60
"2011","Brighton and Hove 025D","E01016867","Total",96,28,14,54,7,2,4,1,89,26,10,53
"2011","Brighton and Hove 025E","E01016868","Total",112,24,15,73,21,3,7,11,91,21,8,62
"2011","Brighton and Hove 025F","E01016895","Total",92,19,18,55,15,1,5,9,77,18,13,46
"2011","Brighton and Hove 026A","E01016849","Total",32,14,7,11,2,0,2,0,30,14,5,11
"2011","Brighton and Hove 026B","E01016852","Total",35,22,2,11,2,2,0,0,33,20,2,11
"2011","Brighton and Hove 026C","E01016853","Total",58,24,13,21,10,5,5,0,48,19,8,21
"2011","Brighton and Hove 026D","E01016855","Total",37,19,7,11,0,0,0,0,37,19,7,11
"2011","Brighton and Hove 026E","E01016856","Total",29,8,10,11,2,1,1,0,27,7,9,11
"2011","Brighton and Hove 027A","E01016952","Total",28,5,11,12,4,0,3,1,24,5,8,11
"2011","Brighton and Hove 027B","E01016953","Total",29,8,9,12,2,0,2,0,27,8,7,12
"2011","Brighton and Hove 027C","E01016964","Total",51,18,6,27,2,0,1,1,49,18,5,26
"2011","Brighton and Hove 027E","E01016969","Total",66,17,13,36,5,0,2,3,61,17,11,33
"2011","Brighton and Hove 027F","E01033328","Total",36,12,7,17,3,1,2,0,33,11,5,17
"2011","Brighton and Hove 027G","E01033329","Total",60,19,8,33,3,3,0,0,57,16,8,33
"2011","Brighton and Hove 028A","E01016857","Total",37,15,8,14,3,0,2,1,34,15,6,13
"2011","Brighton and Hove 028B","E01016858","Total",32,11,9,12,4,0,0,4,28,11,9,8
"2011","Brighton and Hove 028C","E01016859","Total",25,6,12,7,6,0,4,2,19,6,8,5
"2011","Brighton and Hove 028D","E01016986","Total",36,21,1,14,2,0,0,2,34,21,1,12
"2011","Brighton and Hove 028E","E01016988","Total",30,12,8,10,1,0,1,0,29,12,7,10
"2011","Brighton and Hove 029A","E01016850","Total",46,15,19,12,7,4,3,0,39,11,16,12
"2011","Brighton and Hove 029B","E01016851","Total",31,13,8,10,7,2,2,3,24,11,6,7
"2011","Brighton and Hove 029C","E01016854","Total",61,21,15,25,10,4,6,0,51,17,9,25
"2011","Brighton and Hove 029D","E01016954","Total",28,12,8,8,3,0,2,1,25,12,6,7
"2011","Brighton and Hove 029E","E01016955","Total",33,23,9,1,8,4,4,0,25,19,5,1
"2011","Brighton and Hove 030A","E01016941","Total",39,9,5,25,7,2,0,5,32,7,5,20
"2011","Brighton and Hove 030B","E01016945","Total",33,14,5,14,10,1,2,7,23,13,3,7
"2011","Brighton and Hove 030C","E01016947","Total",95,34,17,44,14,1,7,6,81,33,10,38
"2011","Brighton and Hove 030D","E01016948","Total",87,29,20,38,9,2,2,5,78,27,18,33
"2011","Brighton and Hove 030E","E01016949","Total",47,12,14,21,1,0,0,1,46,12,14,20
"2011","Brighton and Hove 031A","E01016861","Total",25,10,7,8,2,0,2,0,23,10,5,8
"2011","Brighton and Hove 031B","E01016862","Total",22,5,9,8,4,1,2,1,18,4,7,7
"2011","Brighton and Hove 031C","E01016942","Total",30,8,6,16,5,2,1,2,25,6,5,14
"2011","Brighton and Hove 031D","E01016943","Total",52,23,16,13,4,0,4,0,48,23,12,13
"2011","Brighton and Hove 031E","E01016944","Total",24,10,2,12,3,1,0,2,21,9,2,10
"2011","Brighton and Hove 032A","E01016863","Total",78,26,9,43,7,4,1,2,71,22,8,41
"2011","Brighton and Hove 032B","E01016869","Total",63,19,14,30,6,0,6,0,57,19,8,30
"2011","Brighton and Hove 032C","E01016957","Total",27,6,6,15,6,1,1,4,21,5,5,11
"2011","Brighton and Hove 032D","E01016963","Total",61,23,15,23,11,2,5,4,50,21,10,19
"2011","Brighton and Hove 033A","E01016956","Total",45,15,16,14,2,0,2,0,43,15,14,14
"2011","Brighton and Hove 033B","E01016958","Total",38,21,9,8,4,1,2,1,34,20,7,7
"2011","Brighton and Hove 033C","E01016959","Total",15,5,5,5,2,0,2,0,13,5,3,5
"2011","Brighton and Hove 033D","E01016960","Total",60,26,19,15,11,0,8,3,49,26,11,12
"2011","Brighton and Hove 033E","E01016961","Total",36,13,14,9,1,0,1,0,35,13,13,9
"2011","Brighton and Hove 033F","E01016962","Total",37,15,16,6,6,1,5,0,31,14,11,6
"2011","Isle of Wight 001A","E01017300","Total",52,17,20,15,9,3,4,2,43,14,16,13
"2011","Isle of Wight 001B","E01017303","Total",30,14,7,9,3,0,2,1,27,14,5,8
"2011","Isle of Wight 001C","E01017305","Total",65,23,17,25,6,1,2,3,59,22,15,22
"2011","Isle of Wight 001D","E01017306","Total",65,29,21,15,8,0,8,0,57,29,13,15
"2011","Isle of Wight 001E","E01017309","Total",60,26,20,14,11,2,8,1,49,24,12,13
"2011","Isle of Wight 002A","E01017301","Total",18,9,7,2,3,0,3,0,15,9,4,2
"2011","Isle of Wight 002B","E01017302","Total",35,17,14,4,5,1,2,2,30,16,12,2
"2011","Isle of Wight 002C","E01017304","Total",49,27,8,14,3,0,1,2,46,27,7,12
"2011","Isle of Wight 002D","E01017316","Total",30,14,9,7,4,1,2,1,26,13,7,6
"2011","Isle of Wight 002E","E01017329","Total",38,16,16,6,6,4,2,0,32,12,14,6
"2011","Isle of Wight 003A","E01017307","Total",33,9,10,14,6,2,2,2,27,7,8,12
"2011","Isle of Wight 003B","E01017308","Total",65,25,19,21,12,4,6,2,53,21,13,19
"2011","Isle of Wight 003D","E01033229","Total",23,7,7,9,2,1,1,0,21,6,6,9
"2011","Isle of Wight 003E","E01033237","Total",66,18,9,39,2,1,1,0,64,17,8,39
"2011","Isle of Wight 004A","E01017335","Total",62,21,13,28,10,0,4,6,52,21,9,22
"2011","Isle of Wight 004B","E01017336","Total",80,24,17,39,13,1,6,6,67,23,11,33
"2011","Isle of Wight 004C","E01017337","Total",44,10,11,23,12,1,3,8,32,9,8,15
"2011","Isle of Wight 004D","E01017346","Total",65,28,19,18,9,2,6,1,56,26,13,17
"2011","Isle of Wight 005A","E01017286","Total",16,4,3,9,1,0,1,0,15,4,2,9
"2011","Isle of Wight 005B","E01017287","Total",35,20,8,7,5,1,3,1,30,19,5,6
"2011","Isle of Wight 005C","E01017367","Total",30,12,9,9,4,0,3,1,26,12,6,8
"2011","Isle of Wight 005D","E01017368","Total",41,14,16,11,6,2,2,2,35,12,14,9
"2011","Isle of Wight 006A","E01017282","Total",53,20,14,19,2,0,0,2,51,20,14,17
"2011","Isle of Wight 006B","E01017283","Total",36,15,14,7,6,0,5,1,30,15,9,6
"2011","Isle of Wight 006C","E01017338","Total",40,12,17,11,5,0,3,2,35,12,14,9
"2011","Isle of Wight 006D","E01017341","Total",58,23,13,22,1,0,0,1,57,23,13,21
"2011","Isle of Wight 006E","E01017342","Total",82,30,17,35,11,3,7,1,71,27,10,34
"2011","Isle of Wight 007A","E01017339","Total",60,21,14,25,7,1,1,5,53,20,13,20
"2011","Isle of Wight 007B","E01017340","Total",94,36,14,44,12,3,3,6,82,33,11,38
"2011","Isle of Wight 007C","E01017343","Total",46,16,10,20,5,1,4,0,41,15,6,20
"2011","Isle of Wight 007D","E01017344","Total",28,11,11,6,7,1,5,1,21,10,6,5
"2011","Isle of Wight 007E","E01017345","Total",158,46,21,91,19,5,2,12,139,41,19,79
"2011","Isle of Wight 008A","E01017310","Total",17,5,6,6,1,1,0,0,16,4,6,6
"2011","Isle of Wight 008B","E01017311","Total",51,14,15,22,3,0,2,1,48,14,13,21
"2011","Isle of Wight 008C","E01017331","Total",70,20,10,40,6,1,2,3,64,19,8,37
"2011","Isle of Wight 008D","E01017332","Total",48,16,11,21,2,0,1,1,46,16,10,20
"2011","Isle of Wight 008E","E01017334","Total",30,17,8,5,2,1,1,0,28,16,7,5
"2011","Isle of Wight 009A","E01017295","Total",60,26,14,20,2,1,1,0,58,25,13,20
"2011","Isle of Wight 009B","E01017325","Total",57,20,11,26,5,0,1,4,52,20,10,22
"2011","Isle of Wight 009C","E01017326","Total",98,37,20,41,20,3,7,10,78,34,13,31
"2011","Isle of Wight 009D","E01017328","Total",84,30,18,36,4,0,2,2,80,30,16,34
"2011","Isle of Wight 009E","E01017333","Total",51,22,10,19,4,0,2,2,47,22,8,17
"2011","Isle of Wight 010A","E01017284","Total",37,15,10,12,2,1,0,1,35,14,10,11
"2011","Isle of Wight 010B","E01017285","Total",26,14,7,5,2,1,1,0,24,13,6,5
"2011","Isle of Wight 010C","E01017288","Total",25,13,10,2,5,0,5,0,20,13,5,2
"2011","Isle of Wight 010D","E01017351","Total",28,12,6,10,5,0,3,2,23,12,3,8
"2011","Isle of Wight 010E","E01017352","Total",13,6,4,3,2,0,2,0,11,6,2,3
"2011","Isle of Wight 011A","E01017292","Total",68,21,17,30,8,2,2,4,60,19,15,26
"2011","Isle of Wight 011B","E01017293","Total",64,22,28,14,9,0,7,2,55,22,21,12
"2011","Isle of Wight 011C","E01017296","Total",18,7,5,6,2,1,1,0,16,6,4,6
"2011","Isle of Wight 011D","E01017321","Total",20,6,4,10,2,1,1,0,18,5,3,10
"2011","Isle of Wight 011E","E01017322","Total",75,21,16,38,15,2,7,6,60,19,9,32
"2011","Isle of Wight 011F","E01017327","Total",52,20,15,17,9,3,3,3,43,17,12,14
"2011","Isle of Wight 012A","E01017312","Total",45,20,11,14,5,1,4,0,40,19,7,14
"2011","Isle of Wight 012D","E01017315","Total",52,18,12,22,9,0,4,5,43,18,8,17
"2011","Isle of Wight 012E","E01017354","Total",29,17,4,8,7,4,2,1,22,13,2,7
"2011","Isle of Wight 012F","E01017361","Total",30,12,9,9,1,0,1,0,29,12,8,9
"2011","Isle of Wight 012G","E01017362","Total",48,21,4,23,9,2,2,5,39,19,2,18
"2011","Isle of Wight 012H","E01033239","Total",43,10,17,16,6,1,3,2,37,9,14,14
"2011","Isle of Wight 013A","E01017290","Total",16,8,3,5,2,1,1,0,14,7,2,5
"2011","Isle of Wight 013B","E01017291","Total",15,6,6,3,2,0,2,0,13,6,4,3
"2011","Isle of Wight 013C","E01017294","Total",37,13,18,6,9,1,7,1,28,12,11,5
"2011","Isle of Wight 013D","E01017353","Total",15,13,0,2,0,0,0,0,15,13,0,2
"2011","Isle of Wight 014A","E01017289","Total",50,22,9,19,4,1,2,1,46,21,7,18
"2011","Isle of Wight 014B","E01017347","Total",61,28,12,21,4,1,1,2,57,27,11,19
"2011","Isle of Wight 014C","E01017348","Total",48,16,18,14,10,4,5,1,38,12,13,13
"2011","Isle of Wight 014D","E01017349","Total",83,33,20,30,16,6,5,5,67,27,15,25
"2011","Isle of Wight 014E","E01017350","Total",96,44,9,43,2,0,1,1,94,44,8,42
"2011","Isle of Wight 015A","E01017317","Total",50,19,12,19,7,0,4,3,43,19,8,16
"2011","Isle of Wight 015B","E01017320","Total",26,12,8,6,3,0,2,1,23,12,6,5
"2011","Isle of Wight 015C","E01017323","Total",7,3,2,2,0,0,0,0,7,3,2,2
"2011","Isle of Wight 015D","E01017324","Total",39,13,7,19,3,0,1,2,36,13,6,17
"2011","Isle of Wight 015E","E01017355","Total",44,20,6,18,1,0,0,1,43,20,6,17
"2011","Isle of Wight 015F","E01017358","Total",32,13,7,12,2,0,1,1,30,13,6,11
"2011","Isle of Wight 016A","E01017318","Total",63,18,14,31,6,0,2,4,57,18,12,27
"2011","Isle of Wight 016B","E01017319","Total",32,8,12,12,3,1,2,0,29,7,10,12
"2011","Isle of Wight 016C","E01017356","Total",65,22,11,32,3,0,2,1,62,22,9,31
"2011","Isle of Wight 016D","E01017357","Total",47,15,10,22,6,1,2,3,41,14,8,19
"2011","Isle of Wight 016E","E01017359","Total",24,9,5,10,3,0,2,1,21,9,3,9
"2011","Isle of Wight 016F","E01017360","Total",70,28,21,21,11,2,4,5,59,26,17,16
"2011","Isle of Wight 017A","E01017297","Total",33,14,8,11,3,1,2,0,30,13,6,11
"2011","Isle of Wight 017B","E01017298","Total",14,7,4,3,3,1,2,0,11,6,2,3
"2011","Isle of Wight 017C","E01017299","Total",31,12,8,11,7,1,4,2,24,11,4,9
"2011","Isle of Wight 017D","E01017369","Total",22,11,5,6,6,1,4,1,16,10,1,5
"2011","Isle of Wight 018A","E01017363","Total",67,22,11,34,12,2,2,8,55,20,9,26
"2011","Isle of Wight 018B","E01017364","Total",29,11,9,9,1,0,1,0,28,11,8,9
"2011","Isle of Wight 018C","E01017365","Total",10,4,2,4,1,0,1,0,9,4,1,4
"2011","Isle of Wight 018D","E01017366","Total",78,26,16,36,6,1,2,3,72,25,14,33
"2011","Isle of Wight 018E","E01017370","Total",44,17,7,20,3,0,2,1,41,17,5,19
"2011","Medway 001A","E01016070","Total",35,11,6,18,1,0,1,0,34,11,5,18
"2011","Medway 001B","E01016071","Total",43,7,17,19,7,0,4,3,36,7,13,16
"2011","Medway 001C","E01016072","Total",30,10,5,15,3,1,2,0,27,9,3,15
"2011","Medway 001D","E01016074","Total",29,8,11,10,4,0,2,2,25,8,9,8
"2011","Medway 002A","E01016142","Total",20,9,6,5,3,0,2,1,17,9,4,4
"2011","Medway 002B","E01016144","Total",20,4,7,9,5,0,2,3,15,4,5,6
"2011","Medway 002C","E01016145","Total",33,14,15,4,3,0,2,1,30,14,13,3
"2011","Medway 002D","E01016149","Total",47,24,7,16,2,0,1,1,45,24,6,15
"2011","Medway 003A","E01016073","Total",34,9,16,9,6,1,4,1,28,8,12,8
"2011","Medway 003B","E01016075","Total",27,10,8,9,3,1,1,1,24,9,7,8
"2011","Medway 003C","E01016076","Total",57,20,18,19,5,2,3,0,52,18,15,19
"2011","Medway 003D","E01016077","Total",44,15,11,18,3,0,3,0,41,15,8,18
"2011","Medway 003E","E01016143","Total",90,40,16,34,3,0,3,0,87,40,13,34
"2011","Medway 004A","E01016146","Total",70,20,18,32,6,1,2,3,64,19,16,29
"2011","Medway 004B","E01016147","Total",24,11,9,4,4,0,3,1,20,11,6,3
"2011","Medway 004C","E01016148","Total",33,14,12,7,0,0,0,0,33,14,12,7
"2011","Medway 005A","E01016133","Total",10,2,6,2,1,0,1,0,9,2,5,2
"2011","Medway 005B","E01016134","Total",40,12,10,18,2,0,1,1,38,12,9,17
"2011","Medway 005C","E01016138","Total",24,13,4,7,1,0,0,1,23,13,4,6
"2011","Medway 005D","E01016139","Total",38,14,10,14,3,2,1,0,35,12,9,14
"2011","Medway 006A","E01016135","Total",65,21,14,30,10,2,3,5,55,19,11,25
"2011","Medway 006B","E01016136","Total",78,23,19,36,4,0,1,3,74,23,18,33
"2011","Medway 006C","E01016137","Total",57,24,8,25,3,1,1,1,54,23,7,24
"2011","Medway 006D","E01016140","Total",49,13,15,21,7,1,5,1,42,12,10,20
"2011","Medway 006E","E01016141","Total",83,32,17,34,8,2,5,1,75,30,12,33
"2011","Medway 007A","E01016035","Total",110,34,10,66,7,0,4,3,103,34,6,63
"2011","Medway 007D","E01016112","Total",72,33,26,13,7,0,6,1,65,33,20,12
"2011","Medway 007E","E01032798","Total",88,24,23,41,10,2,4,4,78,22,19,37
"2011","Medway 008A","E01016151","Total",36,12,12,12,4,0,3,1,32,12,9,11
"2011","Medway 008B","E01016152","Total",48,14,1,33,4,0,0,4,44,14,1,29
"2011","Medway 008C","E01016153","Total",75,20,10,45,6,1,2,3,69,19,8,42
"2011","Medway 008D","E01016155","Total",61,20,9,32,4,0,1,3,57,20,8,29
"2011","Medway 009A","E01016033","Total",48,9,9,30,6,0,5,1,42,9,4,29
"2011","Medway 009B","E01016036","Total",62,19,13,30,5,1,4,0,57,18,9,30
"2011","Medway 009C","E01016037","Total",84,27,10,47,13,3,5,5,71,24,5,42
"2011","Medway 009D","E01016039","Total",71,26,12,33,9,3,3,3,62,23,9,30
"2011","Medway 010A","E01016030","Total",100,28,25,47,8,1,4,3,92,27,21,44
"2011","Medway 010B","E01016032","Total",99,28,12,59,2,1,0,1,97,27,12,58
"2011","Medway 010C","E01016034","Total",81,33,25,23,14,2,9,3,67,31,16,20
"2011","Medway 010D","E01016038","Total",75,23,26,26,5,1,4,0,70,22,22,26
"2011","Medway 011A","E01016150","Total",79,16,15,48,6,0,3,3,73,16,12,45
"2011","Medway 011B","E01016154","Total",48,16,12,20,5,2,3,0,43,14,9,20
"2011","Medway 011C","E01016156","Total",75,23,20,32,4,0,4,0,71,23,16,32
"2011","Medway 011D","E01016157","Total",76,23,29,24,12,1,9,2,64,22,20,22
"2011","Medway 011E","E01016158","Total",78,30,22,26,5,0,2,3,73,30,20,23
"2011","Medway 012A","E01016031","Total",119,35,13,71,9,0,2,7,110,35,11,64
"2011","Medway 012B","E01016041","Total",79,22,17,40,11,2,4,5,68,20,13,35
"2011","Medway 012C","E01016045","Total",55,21,10,24,5,0,1,4,50,21,9,20
"2011","Medway 012D","E01016049","Total",104,27,15,62,12,1,6,5,92,26,9,57
"2011","Medway 013A","E01016040","Total",68,18,23,27,9,1,5,3,59,17,18,24
"2011","Medway 013B","E01016042","Total",72,19,14,39,7,0,4,3,65,19,10,36
"2011","Medway 013C","E01016043","Total",38,11,13,14,7,1,6,0,31,10,7,14
"2011","Medway 013D","E01016177","Total",65,25,8,32,4,2,0,2,61,23,8,30
"2011","Medway 013E","E01016178","Total",44,20,7,17,1,1,0,0,43,19,7,17
"2011","Medway 014A","E01016117","Total",80,16,11,53,3,0,1,2,77,16,10,51
"2011","Medway 014B","E01016129","Total",97,31,11,55,5,0,3,2,92,31,8,53
"2011","Medway 014C","E01016130","Total",39,15,10,14,4,1,2,1,35,14,8,13
"2011","Medway 014D","E01016131","Total",36,14,13,9,5,0,4,1,31,14,9,8
"2011","Medway 015A","E01016016","Total",46,10,9,27,8,0,4,4,38,10,5,23
"2011","Medway 015B","E01016017","Total",37,14,6,17,5,1,2,2,32,13,4,15
"2011","Medway 015C","E01016019","Total",84,25,9,50,5,0,1,4,79,25,8,46
"2011","Medway 015D","E01016110","Total",56,11,14,31,4,1,1,2,52,10,13,29
"2011","Medway 015E","E01016111","Total",31,5,8,18,3,0,2,1,28,5,6,17
"2011","Medway 016A","E01016044","Total",70,22,11,37,6,1,4,1,64,21,7,36
"2011","Medway 016B","E01016046","Total",52,18,7,27,2,0,1,1,50,18,6,26
"2011","Medway 016C","E01016047","Total",65,23,16,26,9,1,6,2,56,22,10,24
"2011","Medway 016D","E01016048","Total",67,22,22,23,8,0,5,3,59,22,17,20
"2011","Medway 017A","E01016113","Total",40,15,10,15,2,0,1,1,38,15,9,14
"2011","Medway 017B","E01016114","Total",73,31,18,24,8,3,3,2,65,28,15,22
"2011","Medway 017C","E01016115","Total",99,36,24,39,9,0,6,3,90,36,18,36
"2011","Medway 017D","E01016118","Total",59,21,11,27,3,2,1,0,56,19,10,27
"2011","Medway 018A","E01016160","Total",53,14,13,26,7,1,2,4,46,13,11,22
"2011","Medway 018B","E01016161","Total",66,22,17,27,4,0,4,0,62,22,13,27
"2011","Medway 018C","E01016162","Total",43,14,13,16,4,2,1,1,39,12,12,15
"2011","Medway 018D","E01016163","Total",39,11,13,15,6,1,3,2,33,10,10,13
"2011","Medway 018E","E01016164","Total",67,14,13,40,8,1,4,3,59,13,9,37
"2011","Medway 018F","E01016165","Total",34,9,15,10,3,0,3,0,31,9,12,10
"2011","Medway 019A","E01016159","Total",89,27,9,53,2,0,0,2,87,27,9,51
"2011","Medway 019B","E01016174","Total",26,5,6,15,3,0,3,0,23,5,3,15
"2011","Medway 019C","E01016175","Total",28,9,9,10,3,0,3,0,25,9,6,10
"2011","Medway 019D","E01016179","Total",24,10,7,7,2,0,2,0,22,10,5,7
"2011","Medway 020A","E01016061","Total",68,22,8,38,11,2,2,7,57,20,6,31
"2011","Medway 020B","E01016063","Total",75,11,16,48,12,0,10,2,63,11,6,46
"2011","Medway 020C","E01016064","Total",81,15,15,51,7,0,1,6,74,15,14,45
"2011","Medway 020D","E01016069","Total",66,19,14,33,7,0,3,4,59,19,11,29
"2011","Medway 021A","E01016020","Total",41,9,13,19,4,0,4,0,37,9,9,19
"2011","Medway 021B","E01016021","Total",49,15,12,22,5,0,5,0,44,15,7,22
"2011","Medway 021C","E01016022","Total",51,15,19,17,4,0,4,0,47,15,15,17
"2011","Medway 021D","E01016125","Total",45,19,11,15,4,1,2,1,41,18,9,14
"2011","Medway 022A","E01016018","Total",95,28,16,51,8,1,1,6,87,27,15,45
"2011","Medway 022B","E01016023","Total",114,33,12,69,11,2,3,6,103,31,9,63
"2011","Medway 022C","E01016024","Total",108,22,22,64,14,0,8,6,94,22,14,58
"2011","Medway 022D","E01016062","Total",70,17,11,42,8,0,4,4,62,17,7,38
"2011","Medway 023A","E01016093","Total",15,5,8,2,3,0,2,1,12,5,6,1
"2011","Medway 023B","E01016096","Total",25,12,8,5,0,0,0,0,25,12,8,5
"2011","Medway 023C","E01016166","Total",28,11,6,11,3,0,1,2,25,11,5,9
"2011","Medway 023D","E01016167","Total",44,14,17,13,6,1,5,0,38,13,12,13
"2011","Medway 024A","E01016116","Total",61,20,16,25,10,1,4,5,51,19,12,20
"2011","Medway 024B","E01016127","Total",57,30,8,19,5,2,1,2,52,28,7,17
"2011","Medway 024C","E01016128","Total",46,10,17,19,10,1,7,2,36,9,10,17
"2011","Medway 024D","E01016132","Total",37,13,12,12,7,1,5,1,30,12,7,11
"2011","Medway 025A","E01016094","Total",38,16,15,7,5,0,2,3,33,16,13,4
"2011","Medway 025B","E01016095","Total",43,16,15,12,4,0,3,1,39,16,12,11
"2011","Medway 025C","E01016097","Total",53,17,13,23,2,0,2,0,51,17,11,23
"2011","Medway 025D","E01016098","Total",70,17,18,35,5,0,3,2,65,17,15,33
"2011","Medway 025E","E01016102","Total",72,19,16,37,8,1,4,3,64,18,12,34
"2011","Medway 026A","E01016119","Total",22,7,7,8,2,0,2,0,20,7,5,8
"2011","Medway 026B","E01016120","Total",46,7,14,25,6,0,5,1,40,7,9,24
"2011","Medway 026C","E01016124","Total",42,14,16,12,1,0,1,0,41,14,15,12
"2011","Medway 026D","E01016126","Total",42,12,22,8,3,0,3,0,39,12,19,8
"2011","Medway 027A","E01016025","Total",48,11,12,25,8,1,7,0,40,10,5,25
"2011","Medway 027B","E01016065","Total",24,11,5,8,1,0,1,0,23,11,4,8
"2011","Medway 027C","E01016066","Total",51,15,10,26,2,0,0,2,49,15,10,24
"2011","Medway 027D","E01016067","Total",53,21,7,25,8,0,3,5,45,21,4,20
"2011","Medway 027E","E01016068","Total",95,21,10,64,12,0,5,7,83,21,5,57
"2011","Medway 028A","E01016026","Total",27,10,9,8,1,0,1,0,26,10,8,8
"2011","Medway 028B","E01016027","Total",17,7,5,5,2,0,2,0,15,7,3,5
"2011","Medway 028C","E01016028","Total",19,9,3,7,3,2,0,1,16,7,3,6
"2011","Medway 028D","E01016029","Total",40,9,16,15,1,0,1,0,39,9,15,15
"2011","Medway 029A","E01016087","Total",32,12,14,6,6,1,4,1,26,11,10,5
"2011","Medway 029B","E01016088","Total",39,13,7,19,3,0,3,0,36,13,4,19
"2011","Medway 029C","E01016089","Total",28,16,6,6,4,0,4,0,24,16,2,6
"2011","Medway 029D","E01016090","Total",29,14,11,4,3,0,2,1,26,14,9,3
"2011","Medway 030A","E01016085","Total",16,8,5,3,3,0,1,2,13,8,4,1
"2011","Medway 030B","E01016086","Total",11,4,5,2,3,0,3,0,8,4,2,2
"2011","Medway 030C","E01016091","Total",23,6,8,9,3,0,3,0,20,6,5,9
"2011","Medway 030D","E01016176","Total",21,8,9,4,3,0,3,0,18,8,6,4
"2011","Medway 031A","E01016058","Total",31,7,12,12,4,1,2,1,27,6,10,11
"2011","Medway 031B","E01016059","Total",44,11,10,23,3,0,3,0,41,11,7,23
"2011","Medway 031C","E01016079","Total",24,6,7,11,4,0,2,2,20,6,5,9
"2011","Medway 031D","E01016083","Total",76,15,18,43,7,1,3,3,69,14,15,40
"2011","Medway 031E","E01016084","Total",58,25,10,23,5,0,2,3,53,25,8,20
"2011","Medway 032A","E01016101","Total",47,17,17,13,4,0,3,1,43,17,14,12
"2011","Medway 032B","E01016103","Total",37,18,15,4,4,1,2,1,33,17,13,3
"2011","Medway 032C","E01016104","Total",38,13,13,12,5,2,3,0,33,11,10,12
"2011","Medway 032D","E01016107","Total",36,10,17,9,4,0,4,0,32,10,13,9
"2011","Medway 033A","E01016121","Total",33,11,10,12,1,0,1,0,32,11,9,12
"2011","Medway 033B","E01016122","Total",35,13,15,7,7,0,6,1,28,13,9,6
"2011","Medway 033C","E01016123","Total",36,18,8,10,4,0,4,0,32,18,4,10
"2011","Medway 033D","E01016173","Total",55,8,10,37,3,0,3,0,52,8,7,37
"2011","Medway 034A","E01016078","Total",58,19,17,22,1,0,1,0,57,19,16,22
"2011","Medway 034B","E01016080","Total",53,18,14,21,4,0,3,1,49,18,11,20
"2011","Medway 034C","E01016081","Total",46,15,19,12,4,0,4,0,42,15,15,12
"2011","Medway 034D","E01016082","Total",40,10,12,18,6,1,5,0,34,9,7,18
"2011","Medway 035A","E01016050","Total",18,12,3,3,2,1,0,1,16,11,3,2
"2011","Medway 035B","E01016051","Total",29,17,8,4,4,1,3,0,25,16,5,4
"2011","Medway 035C","E01016052","Total",19,4,11,4,1,0,1,0,18,4,10,4
"2011","Medway 035D","E01016053","Total",20,8,6,6,3,0,3,0,17,8,3,6
"2011","Medway 035E","E01016054","Total",21,10,7,4,2,1,1,0,19,9,6,4
"2011","Medway 036A","E01016092","Total",30,13,11,6,4,0,3,1,26,13,8,5
"2011","Medway 036B","E01016099","Total",62,26,16,20,3,0,2,1,59,26,14,19
"2011","Medway 036C","E01016100","Total",57,22,7,28,2,0,1,1,55,22,6,27
"2011","Medway 036D","E01016105","Total",24,10,6,8,3,0,2,1,21,10,4,7
"2011","Medway 036E","E01016106","Total",54,15,26,13,6,0,5,1,48,15,21,12
"2011","Medway 037A","E01016168","Total",41,13,6,22,3,0,1,2,38,13,5,20
"2011","Medway 037B","E01016169","Total",40,14,17,9,6,0,4,2,34,14,13,7
"2011","Medway 037C","E01016171","Total",73,25,11,37,1,0,1,0,72,25,10,37
"2011","Medway 037D","E01016172","Total",30,16,10,4,3,0,2,1,27,16,8,3
"2011","Medway 038A","E01016055","Total",45,15,10,20,5,0,2,3,40,15,8,17
"2011","Medway 038B","E01016056","Total",64,17,22,25,6,0,5,1,58,17,17,24
"2011","Medway 038C","E01016057","Total",63,17,18,28,9,1,6,2,54,16,12,26
"2011","Medway 038D","E01016060","Total",20,6,9,5,2,0,1,1,18,6,8,4
"2011","Medway 038E","E01016170","Total",65,22,14,29,8,2,3,3,57,20,11,26
"2011","Milton Keynes 001A","E01016796","Total",26,6,15,5,4,1,3,0,22,5,12,5
"2011","Milton Keynes 001B","E01016797","Total",28,10,10,8,5,0,3,2,23,10,7,6
"2011","Milton Keynes 001C","E01016798","Total",41,16,21,4,4,0,4,0,37,16,17,4
"2011","Milton Keynes 001D","E01016799","Total",29,13,11,5,4,1,3,0,25,12,8,5
"2011","Milton Keynes 001E","E01016800","Total",28,9,13,6,5,0,4,1,23,9,9,5
"2011","Milton Keynes 002A","E01016759","Total",33,8,11,14,2,0,2,0,31,8,9,14
"2011","Milton Keynes 002B","E01016760","Total",62,18,14,30,5,2,2,1,57,16,12,29
"2011","Milton Keynes 002C","E01016761","Total",22,8,9,5,4,1,1,2,18,7,8,3
"2011","Milton Keynes 002D","E01016801","Total",25,6,10,9,4,2,2,0,21,4,8,9
"2011","Milton Keynes 002E","E01016802","Total",23,7,11,5,4,1,3,0,19,6,8,5
"2011","Milton Keynes 002F","E01016803","Total",17,3,9,5,3,0,3,0,14,3,6,5
"2011","Milton Keynes 003A","E01016786","Total",26,10,11,5,0,0,0,0,26,10,11,5
"2011","Milton Keynes 003B","E01016787","Total",53,13,21,19,6,0,5,1,47,13,16,18
"2011","Milton Keynes 003C","E01016788","Total",42,17,19,6,5,2,3,0,37,15,16,6
"2011","Milton Keynes 003D","E01016789","Total",39,17,11,11,1,0,1,0,38,17,10,11
"2011","Milton Keynes 003E","E01016790","Total",22,6,13,3,2,0,2,0,20,6,11,3
"2011","Milton Keynes 004A","E01016791","Total",34,14,10,10,3,1,2,0,31,13,8,10
"2011","Milton Keynes 004B","E01016792","Total",37,14,18,5,4,0,2,2,33,14,16,3
"2011","Milton Keynes 004C","E01016793","Total",41,17,14,10,3,0,2,1,38,17,12,9
"2011","Milton Keynes 004D","E01016794","Total",42,16,18,8,11,0,7,4,31,16,11,4
"2011","Milton Keynes 004E","E01016795","Total",41,17,12,12,4,0,3,1,37,17,9,11
"2011","Milton Keynes 005A","E01016762","Total",38,9,8,21,7,3,3,1,31,6,5,20
"2011","Milton Keynes 005B","E01016764","Total",22,7,9,6,3,0,2,1,19,7,7,5
"2011","Milton Keynes 005C","E01016766","Total",41,16,8,17,2,1,0,1,39,15,8,16
"2011","Milton Keynes 005D","E01016767","Total",22,9,9,4,0,0,0,0,22,9,9,4
"2011","Milton Keynes 005E","E01016771","Total",40,14,14,12,2,0,1,1,38,14,13,11
"2011","Milton Keynes 006A","E01016806","Total",85,19,21,45,8,1,4,3,77,18,17,42
"2011","Milton Keynes 006B","E01016807","Total",55,20,12,23,9,1,4,4,46,19,8,19
"2011","Milton Keynes 006C","E01016809","Total",73,32,10,31,5,0,1,4,68,32,9,27
"2011","Milton Keynes 006D","E01016835","Total",96,25,16,55,6,0,2,4,90,25,14,51
"2011","Milton Keynes 007A","E01016763","Total",21,10,7,4,2,1,1,0,19,9,6,4
"2011","Milton Keynes 007B","E01016769","Total",25,10,13,2,5,1,4,0,20,9,9,2
"2011","Milton Keynes 007C","E01016770","Total",39,12,12,15,5,1,3,1,34,11,9,14
"2011","Milton Keynes 007D","E01016773","Total",25,6,14,5,4,0,4,0,21,6,10,5
"2011","Milton Keynes 008A","E01016836","Total",43,9,18,16,0,0,0,0,43,9,18,16
"2011","Milton Keynes 008B","E01016837","Total",51,14,19,18,7,1,4,2,44,13,15,16
"2011","Milton Keynes 008C","E01016838","Total",42,16,11,15,4,1,2,1,38,15,9,14
"2011","Milton Keynes 008D","E01016841","Total",78,14,22,42,10,1,4,5,68,13,18,37
"2011","Milton Keynes 009A","E01016721","Total",59,14,19,26,8,0,5,3,51,14,14,23
"2011","Milton Keynes 009B","E01016765","Total",39,16,6,17,1,0,1,0,38,16,5,17
"2011","Milton Keynes 009C","E01016772","Total",64,21,15,28,8,1,5,2,56,20,10,26
"2011","Milton Keynes 009D","E01016804","Total",86,33,19,34,8,1,3,4,78,32,16,30
"2011","Milton Keynes 010A","E01016812","Total",23,13,5,5,3,1,2,0,20,12,3,5
"2011","Milton Keynes 010B","E01016817","Total",39,11,12,16,2,0,2,0,37,11,10,16
"2011","Milton Keynes 010C","E01016818","Total",26,6,12,8,1,0,1,0,25,6,11,8
"2011","Milton Keynes 010D","E01016840","Total",54,13,20,21,6,0,5,1,48,13,15,20
"2011","Milton Keynes 011A","E01016719","Total",44,14,14,16,3,1,1,1,41,13,13,15
"2011","Milton Keynes 011B","E01016722","Total",34,9,16,9,3,0,2,1,31,9,14,8
"2011","Milton Keynes 011C","E01016805","Total",24,8,6,10,1,0,1,0,23,8,5,10
"2011","Milton Keynes 011D","E01016808","Total",41,14,12,15,4,0,3,1,37,14,9,14
"2011","Milton Keynes 012A","E01016810","Total",63,14,16,33,8,1,3,4,55,13,13,29
"2011","Milton Keynes 012B","E01016811","Total",118,30,16,72,12,1,4,7,106,29,12,65
"2011","Milton Keynes 012C","E01016819","Total",51,16,7,28,4,1,1,2,47,15,6,26
"2011","Milton Keynes 012D","E01016839","Total",134,44,18,72,2,1,0,1,132,43,18,71
"2011","Milton Keynes 013A","E01016717","Total",39,11,14,14,3,1,1,1,36,10,13,13
"2011","Milton Keynes 013B","E01016720","Total",81,22,20,39,5,0,1,4,76,22,19,35
"2011","Milton Keynes 013C","E01016723","Total",39,18,11,10,5,2,2,1,34,16,9,9
"2011","Milton Keynes 013D","E01016724","Total",50,16,10,24,8,3,4,1,42,13,6,23
"2011","Milton Keynes 014A","E01016718","Total",99,24,27,48,8,1,4,3,91,23,23,45
"2011","Milton Keynes 014B","E01016729","Total",102,29,13,60,11,2,3,6,91,27,10,54
"2011","Milton Keynes 014D","E01016768","Total",66,20,23,23,7,1,6,0,59,19,17,23
"2011","Milton Keynes 014E","E01033499","Total",34,10,10,14,2,0,0,2,32,10,10,12
"2011","Milton Keynes 014F","E01033500","Total",21,8,6,7,6,0,4,2,15,8,2,5
"2011","Milton Keynes 015A","E01016776","Total",38,10,23,5,0,0,0,0,38,10,23,5
"2011","Milton Keynes 015B","E01016813","Total",40,14,17,9,1,0,1,0,39,14,16,9
"2011","Milton Keynes 015C","E01016815","Total",42,16,18,8,8,0,7,1,34,16,11,7
"2011","Milton Keynes 015D","E01016816","Total",21,8,11,2,3,0,2,1,18,8,9,1
"2011","Milton Keynes 016A","E01016731","Total",43,11,13,19,6,1,4,1,37,10,9,18
"2011","Milton Keynes 016B","E01016732","Total",34,8,9,17,2,0,1,1,32,8,8,16
"2011","Milton Keynes 016D","E01016784","Total",58,19,10,29,4,0,2,2,54,19,8,27
"2011","Milton Keynes 016E","E01033501","Total",84,23,34,27,9,0,6,3,75,23,28,24
"2011","Milton Keynes 016F","E01033506","Total",54,21,23,10,5,1,2,2,49,20,21,8
"2011","Milton Keynes 017A","E01016783","Total",85,32,32,21,7,0,5,2,78,32,27,19
"2011","Milton Keynes 017C","E01016820","Total",46,12,9,25,1,0,0,1,45,12,9,24
"2011","Milton Keynes 017D","E01016821","Total",44,12,19,13,4,1,3,0,40,11,16,13
"2011","Milton Keynes 017E","E01016823","Total",76,18,35,23,12,0,7,5,64,18,28,18
"2011","Milton Keynes 017F","E01033503","Total",34,14,14,6,5,0,2,3,29,14,12,3
"2011","Milton Keynes 017G","E01033508","Total",51,15,15,21,3,1,2,0,48,14,13,21
"2011","Milton Keynes 017H","E01033509","Total",65,7,24,34,8,0,5,3,57,7,19,31
"2011","Milton Keynes 017I","E01033511","Total",57,13,21,23,6,1,5,0,51,12,16,23
"2011","Milton Keynes 017J","E01033512","Total",42,16,20,6,4,1,3,0,38,15,17,6
"2011","Milton Keynes 018A","E01016726","Total",106,30,25,51,11,3,6,2,95,27,19,49
"2011","Milton Keynes 018B","E01016733","Total",89,21,17,51,10,3,3,4,79,18,14,47
"2011","Milton Keynes 018C","E01016845","Total",121,32,23,66,9,1,4,4,112,31,19,62
"2011","Milton Keynes 018D","E01016846","Total",69,27,17,25,10,1,5,4,59,26,12,21
"2011","Milton Keynes 018E","E01016848","Total",47,9,8,30,6,0,1,5,41,9,7,25
"2011","Milton Keynes 019B","E01016780","Total",37,10,13,14,2,0,1,1,35,10,12,13
"2011","Milton Keynes 019C","E01016781","Total",23,8,11,4,3,1,1,1,20,7,10,3
"2011","Milton Keynes 019D","E01016814","Total",22,7,12,3,1,0,1,0,21,7,11,3
"2011","Milton Keynes 019E","E01033505","Total",37,10,21,6,10,0,9,1,27,10,12,5
"2011","Milton Keynes 019F","E01033522","Total",49,14,22,13,3,1,2,0,46,13,20,13
"2011","Milton Keynes 019G","E01033523","Total",56,23,18,15,8,0,7,1,48,23,11,14
"2011","Milton Keynes 019H","E01033525","Total",87,29,30,28,6,0,4,2,81,29,26,26
"2011","Milton Keynes 020A","E01016774","Total",30,13,11,6,1,0,1,0,29,13,10,6
"2011","Milton Keynes 020B","E01016775","Total",59,24,16,19,4,0,3,1,55,24,13,18
"2011","Milton Keynes 020C","E01016777","Total",41,15,19,7,5,1,3,1,36,14,16,6
"2011","Milton Keynes 020D","E01016778","Total",55,17,22,16,7,2,4,1,48,15,18,15
"2011","Milton Keynes 021A","E01016725","Total",62,21,8,33,4,1,1,2,58,20,7,31
"2011","Milton Keynes 021B","E01016727","Total",52,18,13,21,4,0,3,1,48,18,10,20
"2011","Milton Keynes 021C","E01016728","Total",52,13,17,22,4,0,2,2,48,13,15,20
"2011","Milton Keynes 021D","E01016847","Total",102,42,17,43,13,4,4,5,89,38,13,38
"2011","Milton Keynes 022A","E01016822","Total",75,24,21,30,5,0,4,1,70,24,17,29
"2011","Milton Keynes 022B","E01016824","Total",69,30,23,16,7,0,6,1,62,30,17,15
"2011","Milton Keynes 022C","E01016825","Total",55,23,18,14,3,0,2,1,52,23,16,13
"2011","Milton Keynes 022D","E01016827","Total",80,21,34,25,5,1,4,0,75,20,30,25
"2011","Milton Keynes 022E","E01016828","Total",38,14,16,8,3,0,3,0,35,14,13,8
"2011","Milton Keynes 023B","E01016842","Total",81,19,14,48,7,1,4,2,74,18,10,46
"2011","Milton Keynes 023C","E01016843","Total",103,30,13,60,12,1,2,9,91,29,11,51
"2011","Milton Keynes 023D","E01016844","Total",67,14,14,39,2,0,1,1,65,14,13,38
"2011","Milton Keynes 023E","E01033497","Total",51,15,14,22,7,0,4,3,44,15,10,19
"2011","Milton Keynes 023F","E01033498","Total",47,12,17,18,6,0,4,2,41,12,13,16
"2011","Milton Keynes 024A","E01016734","Total",24,10,9,5,2,0,2,0,22,10,7,5
"2011","Milton Keynes 024B","E01016735","Total",46,20,19,7,1,0,1,0,45,20,18,7
"2011","Milton Keynes 024C","E01016736","Total",27,10,13,4,0,0,0,0,27,10,13,4
"2011","Milton Keynes 024D","E01016826","Total",28,12,10,6,4,2,2,0,24,10,8,6
"2011","Milton Keynes 025B","E01016752","Total",77,21,31,25,3,0,2,1,74,21,29,24
"2011","Milton Keynes 025C","E01016753","Total",96,30,29,37,12,1,8,3,84,29,21,34
"2011","Milton Keynes 025D","E01016755","Total",63,16,27,20,9,0,9,0,54,16,18,20
"2011","Milton Keynes 025E","E01033514","Total",45,14,27,4,7,0,7,0,38,14,20,4
"2011","Milton Keynes 025F","E01033515","Total",54,22,21,11,4,0,2,2,50,22,19,9
"2011","Milton Keynes 025G","E01033517","Total",39,16,15,8,2,0,2,0,37,16,13,8
"2011","Milton Keynes 026A","E01016754","Total",48,18,19,11,6,0,6,0,42,18,13,11
"2011","Milton Keynes 026B","E01016756","Total",101,39,22,40,1,0,0,1,100,39,22,39
"2011","Milton Keynes 026C","E01016757","Total",38,11,15,12,5,0,4,1,33,11,11,11
"2011","Milton Keynes 026D","E01016758","Total",62,17,24,21,7,1,4,2,55,16,20,19
"2011","Milton Keynes 027A","E01016737","Total",64,21,24,19,5,0,3,2,59,21,21,17
"2011","Milton Keynes 027B","E01016738","Total",111,44,22,45,3,0,3,0,108,44,19,45
"2011","Milton Keynes 027C","E01016739","Total",44,14,17,13,6,0,6,0,38,14,11,13
"2011","Milton Keynes 027D","E01016740","Total",32,13,8,11,5,1,2,2,27,12,6,9
"2011","Milton Keynes 027E","E01016741","Total",79,26,24,29,11,2,7,2,68,24,17,27
"2011","Milton Keynes 028A","E01016748","Total",77,42,18,17,3,0,2,1,74,42,16,16
"2011","Milton Keynes 028C","E01016750","Total",36,12,15,9,4,0,2,2,32,12,13,7
"2011","Milton Keynes 028D","E01016751","Total",56,19,24,13,6,1,5,0,50,18,19,13
"2011","Milton Keynes 028E","E01033519","Total",60,22,20,18,4,0,3,1,56,22,17,17
"2011","Milton Keynes 028F","E01033520","Total",49,19,24,6,4,0,3,1,45,19,21,5
"2011","Milton Keynes 029A","E01016829","Total",66,20,11,35,6,0,3,3,60,20,8,32
"2011","Milton Keynes 029B","E01016831","Total",51,20,12,19,4,0,2,2,47,20,10,17
"2011","Milton Keynes 029C","E01016832","Total",45,17,16,12,3,1,2,0,42,16,14,12
"2011","Milton Keynes 029D","E01016833","Total",12,1,6,5,2,0,2,0,10,1,4,5
"2011","Milton Keynes 029E","E01016834","Total",74,23,16,35,2,0,2,0,72,23,14,35
"2011","Milton Keynes 030A","E01016710","Total",50,11,16,23,6,0,4,2,44,11,12,21
"2011","Milton Keynes 030B","E01016714","Total",76,18,13,45,3,2,0,1,73,16,13,44
"2011","Milton Keynes 030C","E01016716","Total",56,19,16,21,8,2,4,2,48,17,12,19
"2011","Milton Keynes 030D","E01016745","Total",34,16,5,13,0,0,0,0,34,16,5,13
"2011","Milton Keynes 031A","E01016711","Total",58,19,16,23,5,1,3,1,53,18,13,22
"2011","Milton Keynes 031B","E01016713","Total",48,17,10,21,5,1,2,2,43,16,8,19
"2011","Milton Keynes 031C","E01016715","Total",59,18,13,28,3,0,1,2,56,18,12,26
"2011","Milton Keynes 031D","E01016830","Total",32,16,10,6,5,1,3,1,27,15,7,5
"2011","Milton Keynes 032A","E01016742","Total",128,32,19,77,11,1,3,7,117,31,16,70
"2011","Milton Keynes 032B","E01016743","Total",145,52,26,67,11,3,3,5,134,49,23,62
"2011","Milton Keynes 032C","E01016744","Total",96,31,14,51,8,0,2,6,88,31,12,45
"2011","Milton Keynes 032D","E01016746","Total",48,15,6,27,3,1,1,1,45,14,5,26
"2011","Portsmouth 001A","E01017112","Total",99,28,16,55,8,0,7,1,91,28,9,54
"2011","Portsmouth 001B","E01017115","Total",69,23,15,31,7,1,3,3,62,22,12,28
"2011","Portsmouth 001C","E01017117","Total",97,35,20,42,8,2,5,1,89,33,15,41
"2011","Portsmouth 001D","E01017119","Total",74,35,9,30,7,0,4,3,67,35,5,27
"2011","Portsmouth 001E","E01017120","Total",71,31,10,30,9,1,5,3,62,30,5,27
"2011","Portsmouth 002A","E01017051","Total",128,36,24,68,14,0,9,5,114,36,15,63
"2011","Portsmouth 002B","E01017052","Total",72,32,14,26,3,0,2,1,69,32,12,25
"2011","Portsmouth 002C","E01017053","Total",86,29,7,50,8,0,1,7,78,29,6,43
"2011","Portsmouth 002D","E01017118","Total",108,34,15,59,4,0,2,2,104,34,13,57
"2011","Portsmouth 003A","E01017050","Total",31,13,7,11,1,1,0,0,30,12,7,11
"2011","Portsmouth 003B","E01017061","Total",20,3,14,3,5,0,5,0,15,3,9,3
"2011","Portsmouth 003C","E01017063","Total",27,12,10,5,5,3,2,0,22,9,8,5
"2011","Portsmouth 003D","E01017064","Total",26,8,11,7,2,1,1,0,24,7,10,7
"2011","Portsmouth 004A","E01017054","Total",48,18,16,14,6,0,5,1,42,18,11,13
"2011","Portsmouth 004B","E01017113","Total",59,20,13,26,5,1,4,0,54,19,9,26
"2011","Portsmouth 004C","E01017114","Total",23,5,12,6,4,0,3,1,19,5,9,5
"2011","Portsmouth 004D","E01017116","Total",111,37,21,53,12,2,5,5,99,35,16,48
"2011","Portsmouth 006A","E01017055","Total",56,20,24,12,6,1,4,1,50,19,20,11
"2011","Portsmouth 006B","E01017056","Total",38,18,12,8,6,0,5,1,32,18,7,7
"2011","Portsmouth 006C","E01017057","Total",27,11,11,5,2,1,1,0,25,10,10,5
"2011","Portsmouth 006D","E01017058","Total",99,30,30,39,17,2,9,6,82,28,21,33
"2011","Portsmouth 006E","E01017060","Total",49,29,11,9,2,0,2,0,47,29,9,9
"2011","Portsmouth 007A","E01017086","Total",27,17,5,5,2,1,0,1,25,16,5,4
"2011","Portsmouth 007B","E01017089","Total",82,29,13,40,1,0,0,1,81,29,13,39
"2011","Portsmouth 007C","E01017090","Total",57,21,12,24,5,1,3,1,52,20,9,23
"2011","Portsmouth 007D","E01017091","Total",73,27,18,28,7,2,3,2,66,25,15,26
"2011","Portsmouth 007E","E01017092","Total",34,12,12,10,3,0,3,0,31,12,9,10
"2011","Portsmouth 008A","E01017014","Total",60,22,17,21,8,1,6,1,52,21,11,20
"2011","Portsmouth 008B","E01017046","Total",27,13,10,4,5,1,4,0,22,12,6,4
"2011","Portsmouth 008C","E01017047","Total",58,27,14,17,4,1,2,1,54,26,12,16
"2011","Portsmouth 008D","E01017048","Total",46,19,13,14,7,0,6,1,39,19,7,13
"2011","Portsmouth 008E","E01017085","Total",37,17,13,7,2,0,2,0,35,17,11,7
"2011","Portsmouth 009A","E01017084","Total",35,13,18,4,7,1,5,1,28,12,13,3
"2011","Portsmouth 009B","E01017087","Total",41,20,13,8,4,1,1,2,37,19,12,6
"2011","Portsmouth 009C","E01017088","Total",37,13,11,13,1,0,1,0,36,13,10,13
"2011","Portsmouth 009D","E01017105","Total",54,19,15,20,5,0,3,2,49,19,12,18
"2011","Portsmouth 009E","E01017107","Total",65,14,20,31,5,0,4,1,60,14,16,30
"2011","Portsmouth 010A","E01017104","Total",35,11,5,19,4,1,1,2,31,10,4,17
"2011","Portsmouth 010B","E01017106","Total",66,28,15,23,4,0,3,1,62,28,12,22
"2011","Portsmouth 010C","E01017108","Total",83,31,12,40,11,3,2,6,72,28,10,34
"2011","Portsmouth 010D","E01017109","Total",89,25,18,46,5,1,4,0,84,24,14,46
"2011","Portsmouth 011A","E01017041","Total",33,10,10,13,0,0,0,0,33,10,10,13
"2011","Portsmouth 011B","E01017043","Total",45,15,15,15,5,0,4,1,40,15,11,14
"2011","Portsmouth 011C","E01017044","Total",51,25,13,13,3,1,2,0,48,24,11,13
"2011","Portsmouth 011D","E01017049","Total",25,13,8,4,5,1,4,0,20,12,4,4
"2011","Portsmouth 011E","E01017110","Total",58,14,16,28,6,0,3,3,52,14,13,25
"2011","Portsmouth 011F","E01017111","Total",75,16,24,35,9,0,4,5,66,16,20,30
"2011","Portsmouth 012A","E01017013","Total",82,37,17,28,7,1,4,2,75,36,13,26
"2011","Portsmouth 012B","E01017042","Total",73,25,18,30,11,1,7,3,62,24,11,27
"2011","Portsmouth 012C","E01017045","Total",57,20,18,19,3,2,1,0,54,18,17,19
"2011","Portsmouth 012D","E01017075","Total",118,41,26,51,15,2,6,7,103,39,20,44
"2011","Portsmouth 012E","E01017082","Total",72,21,21,30,15,3,6,6,57,18,15,24
"2011","Portsmouth 012F","E01017083","Total",98,34,32,32,13,2,7,4,85,32,25,28
"2011","Portsmouth 013A","E01017036","Total",117,42,17,58,11,2,2,7,106,40,15,51
"2011","Portsmouth 013B","E01017037","Total",134,36,13,85,14,2,9,3,120,34,4,82
"2011","Portsmouth 013C","E01017038","Total",93,26,13,54,3,0,2,1,90,26,11,53
"2011","Portsmouth 013D","E01017102","Total",66,25,9,32,9,2,3,4,57,23,6,28
"2011","Portsmouth 013E","E01017103","Total",113,32,12,69,12,4,2,6,101,28,10,63
"2011","Portsmouth 014A","E01017015","Total",54,17,18,19,9,2,7,0,45,15,11,19
"2011","Portsmouth 014B","E01017016","Total",63,33,15,15,3,0,3,0,60,33,12,15
"2011","Portsmouth 014C","E01017017","Total",23,13,3,7,2,0,2,0,21,13,1,7
"2011","Portsmouth 014D","E01017018","Total",41,13,13,15,5,0,3,2,36,13,10,13
"2011","Portsmouth 014E","E01017019","Total",84,39,15,30,9,2,6,1,75,37,9,29
"2011","Portsmouth 014F","E01017020","Total",105,39,20,46,6,0,4,2,99,39,16,44
"2011","Portsmouth 015A","E01017076","Total",91,25,31,35,14,2,9,3,77,23,22,32
"2011","Portsmouth 015B","E01017077","Total",87,24,16,47,10,6,2,2,77,18,14,45
"2011","Portsmouth 015C","E01017078","Total",65,25,11,29,8,2,4,2,57,23,7,27
"2011","Portsmouth 015D","E01017079","Total",62,16,12,34,3,0,1,2,59,16,11,32
"2011","Portsmouth 015E","E01017080","Total",73,32,9,32,3,0,3,0,70,32,6,32
"2011","Portsmouth 015F","E01017081","Total",69,27,11,31,6,0,3,3,63,27,8,28
"2011","Portsmouth 016A","E01017031","Total",100,33,13,54,9,3,2,4,91,30,11,50
"2011","Portsmouth 016B","E01017032","Total",50,11,8,31,4,2,2,0,46,9,6,31
"2011","Portsmouth 016D","E01017034","Total",68,24,7,37,5,2,3,0,63,22,4,37
"2011","Portsmouth 016E","E01017039","Total",82,23,11,48,3,0,1,2,79,23,10,46
"2011","Portsmouth 016F","E01017040","Total",109,24,15,70,14,1,5,8,95,23,10,62
"2011","Portsmouth 016G","E01033381","Total",46,15,8,23,4,1,1,2,42,14,7,21
"2011","Portsmouth 016H","E01033383","Total",69,20,7,42,4,0,1,3,65,20,6,39
"2011","Portsmouth 017A","E01017021","Total",25,10,9,6,3,0,3,0,22,10,6,6
"2011","Portsmouth 017B","E01017093","Total",33,11,9,13,2,0,2,0,31,11,7,13
"2011","Portsmouth 017C","E01017096","Total",53,24,19,10,8,0,8,0,45,24,11,10
"2011","Portsmouth 017D","E01017099","Total",67,29,16,22,7,3,4,0,60,26,12,22
"2011","Portsmouth 017E","E01017100","Total",47,24,14,9,4,1,1,2,43,23,13,7
"2011","Portsmouth 017F","E01017101","Total",78,24,25,29,8,0,7,1,70,24,18,28
"2011","Portsmouth 018A","E01017035","Total",99,19,20,60,10,1,3,6,89,18,17,54
"2011","Portsmouth 018B","E01017128","Total",19,6,4,9,2,1,0,1,17,5,4,8
"2011","Portsmouth 018C","E01017129","Total",29,8,5,16,4,0,1,3,25,8,4,13
"2011","Portsmouth 018D","E01017130","Total",109,37,10,62,10,2,1,7,99,35,9,55
"2011","Portsmouth 018E","E01017132","Total",103,29,10,64,5,0,3,2,98,29,7,62
"2011","Portsmouth 018F","E01017133","Total",52,10,5,37,7,1,0,6,45,9,5,31
"2011","Portsmouth 019A","E01017023","Total",52,15,17,20,7,0,7,0,45,15,10,20
"2011","Portsmouth 019B","E01017025","Total",60,16,17,27,9,0,4,5,51,16,13,22
"2011","Portsmouth 019C","E01017026","Total",47,18,15,14,3,0,1,2,44,18,14,12
"2011","Portsmouth 019D","E01017029","Total",44,11,14,19,5,0,3,2,39,11,11,17
"2011","Portsmouth 019E","E01017030","Total",54,24,9,21,4,1,3,0,50,23,6,21
"2011","Portsmouth 020A","E01017022","Total",26,4,13,9,5,1,4,0,21,3,9,9
"2011","Portsmouth 020B","E01017024","Total",30,12,9,9,2,0,1,1,28,12,8,8
"2011","Portsmouth 020C","E01017027","Total",26,6,9,11,1,0,1,0,25,6,8,11
"2011","Portsmouth 020D","E01017028","Total",27,10,5,12,3,0,0,3,24,10,5,9
"2011","Portsmouth 020E","E01017124","Total",28,10,4,14,2,1,0,1,26,9,4,13
"2011","Portsmouth 021A","E01017094","Total",41,13,13,15,1,1,0,0,40,12,13,15
"2011","Portsmouth 021B","E01017095","Total",80,28,25,27,4,0,3,1,76,28,22,26
"2011","Portsmouth 021C","E01017097","Total",75,26,19,30,8,1,4,3,67,25,15,27
"2011","Portsmouth 021D","E01017098","Total",88,24,18,46,4,1,2,1,84,23,16,45
"2011","Portsmouth 022A","E01017122","Total",28,7,10,11,1,0,1,0,27,7,9,11
"2011","Portsmouth 022B","E01017125","Total",35,9,14,12,6,1,4,1,29,8,10,11
"2011","Portsmouth 022C","E01017127","Total",26,6,7,13,2,0,1,1,24,6,6,12
"2011","Portsmouth 022D","E01017135","Total",27,15,6,6,1,0,0,1,26,15,6,5
"2011","Portsmouth 023A","E01017067","Total",62,20,15,27,8,0,5,3,54,20,10,24
"2011","Portsmouth 023B","E01017068","Total",76,19,22,35,10,1,5,4,66,18,17,31
"2011","Portsmouth 023C","E01017069","Total",32,8,12,12,3,0,1,2,29,8,11,10
"2011","Portsmouth 023D","E01017070","Total",24,11,7,6,7,3,2,2,17,8,5,4
"2011","Portsmouth 023E","E01017074","Total",101,26,21,54,10,1,5,4,91,25,16,50
"2011","Portsmouth 024A","E01017073","Total",52,14,15,23,5,0,3,2,47,14,12,21
"2011","Portsmouth 024B","E01017123","Total",27,5,14,8,2,0,2,0,25,5,12,8
"2011","Portsmouth 024C","E01017131","Total",25,8,7,10,4,1,1,2,21,7,6,8
"2011","Portsmouth 024E","E01033380","Total",17,5,5,7,3,0,2,1,14,5,3,6
"2011","Portsmouth 024F","E01033384","Total",23,7,12,4,5,0,5,0,18,7,7,4
"2011","Portsmouth 025A","E01017071","Total",29,9,12,8,2,0,2,0,27,9,10,8
"2011","Portsmouth 025B","E01017072","Total",18,4,10,4,4,2,2,0,14,2,8,4
"2011","Portsmouth 025C","E01017121","Total",23,8,8,7,3,2,0,1,20,6,8,6
"2011","Portsmouth 025D","E01017126","Total",41,16,14,11,3,2,1,0,38,14,13,11
"2011","Portsmouth 026A","E01017059","Total",24,9,12,3,1,0,1,0,23,9,11,3
"2011","Portsmouth 026B","E01017062","Total",29,10,13,6,11,1,8,2,18,9,5,4
"2011","Portsmouth 026C","E01017066","Total",62,25,22,15,12,0,10,2,50,25,12,13
"2011","Portsmouth 026D","E01032604","Total",31,12,13,6,4,1,3,0,27,11,10,6
"2011","Reading 001A","E01016407","Total",36,9,19,8,5,0,4,1,31,9,15,7
"2011","Reading 001B","E01016408","Total",26,13,6,7,2,0,2,0,24,13,4,7
"2011","Reading 001C","E01016410","Total",24,7,8,9,3,0,3,0,21,7,5,9
"2011","Reading 001D","E01016411","Total",13,3,8,2,4,1,3,0,9,2,5,2
"2011","Reading 001E","E01016412","Total",37,13,17,7,3,2,1,0,34,11,16,7
"2011","Reading 002A","E01016386","Total",10,5,3,2,0,0,0,0,10,5,3,2
"2011","Reading 002B","E01016387","Total",14,7,6,1,2,0,2,0,12,7,4,1
"2011","Reading 002C","E01016425","Total",25,6,11,8,4,0,4,0,21,6,7,8
"2011","Reading 002D","E01016426","Total",8,3,4,1,3,0,3,0,5,3,1,1
"2011","Reading 002E","E01016430","Total",17,3,11,3,6,0,6,0,11,3,5,3
"2011","Reading 003A","E01016364","Total",16,4,10,2,2,1,1,0,14,3,9,2
"2011","Reading 003B","E01016409","Total",37,15,15,7,3,0,3,0,34,15,12,7
"2011","Reading 003C","E01016427","Total",34,8,15,11,5,0,4,1,29,8,11,10
"2011","Reading 003D","E01016428","Total",47,22,12,13,6,0,4,2,41,22,8,11
"2011","Reading 003E","E01016429","Total",20,5,12,3,3,0,3,0,17,5,9,3
"2011","Reading 004A","E01016362","Total",42,17,11,14,2,0,2,0,40,17,9,14
"2011","Reading 004B","E01016363","Total",128,41,28,59,7,3,3,1,121,38,25,58
"2011","Reading 004C","E01016365","Total",42,20,10,12,4,0,3,1,38,20,7,11
"2011","Reading 004D","E01016366","Total",42,20,7,15,5,1,2,2,37,19,5,13
"2011","Reading 004E","E01016367","Total",53,22,9,22,7,2,2,3,46,20,7,19
"2011","Reading 005A","E01016380","Total",51,23,17,11,3,0,3,0,48,23,14,11
"2011","Reading 005B","E01016383","Total",54,19,9,26,1,0,1,0,53,19,8,26
"2011","Reading 005C","E01016384","Total",25,6,11,8,4,0,4,0,21,6,7,8
"2011","Reading 005D","E01016431","Total",35,14,10,11,6,0,4,2,29,14,6,9
"2011","Reading 005E","E01016432","Total",42,10,9,23,4,0,1,3,38,10,8,20
"2011","Reading 006A","E01016381","Total",56,10,11,35,2,0,1,1,54,10,10,34
"2011","Reading 006B","E01016382","Total",93,38,19,36,4,1,2,1,89,37,17,35
"2011","Reading 006C","E01016385","Total",45,12,12,21,2,0,2,0,43,12,10,21
"2011","Reading 006D","E01016396","Total",88,26,13,49,6,0,3,3,82,26,10,46
"2011","Reading 006E","E01016397","Total",80,26,12,42,8,2,4,2,72,24,8,40
"2011","Reading 007A","E01016355","Total",32,15,6,11,2,0,2,0,30,15,4,11
"2011","Reading 007B","E01016358","Total",62,24,16,22,11,1,5,5,51,23,11,17
"2011","Reading 007C","E01016359","Total",92,31,20,41,8,2,3,3,84,29,17,38
"2011","Reading 007D","E01016360","Total",61,20,12,29,7,1,2,4,54,19,10,25
"2011","Reading 007E","E01016361","Total",96,21,25,50,9,1,3,5,87,20,22,45
"2011","Reading 008A","E01016356","Total",73,15,17,41,5,1,0,4,68,14,17,37
"2011","Reading 008B","E01016357","Total",44,7,17,20,3,0,3,0,41,7,14,20
"2011","Reading 008C","E01016395","Total",38,18,5,15,3,1,1,1,35,17,4,14
"2011","Reading 008D","E01016398","Total",75,14,16,45,3,0,1,2,72,14,15,43
"2011","Reading 008E","E01016399","Total",46,17,14,15,6,1,4,1,40,16,10,14
"2011","Reading 008F","E01016400","Total",51,22,15,14,5,0,4,1,46,22,11,13
"2011","Reading 009A","E01016394","Total",82,23,13,46,2,1,1,0,80,22,12,46
"2011","Reading 009B","E01016433","Total",36,11,10,15,1,0,1,0,35,11,9,15
"2011","Reading 009C","E01016434","Total",55,21,9,25,5,1,3,1,50,20,6,24
"2011","Reading 009D","E01016435","Total",47,15,9,23,1,0,1,0,46,15,8,23
"2011","Reading 009E","E01016436","Total",37,16,8,13,2,0,0,2,35,16,8,11
"2011","Reading 010B","E01016402","Total",65,20,18,27,6,1,4,1,59,19,14,26
"2011","Reading 010C","E01016404","Total",53,21,12,20,3,3,0,0,50,18,12,20
"2011","Reading 010D","E01016405","Total",47,11,10,26,5,0,3,2,42,11,7,24
"2011","Reading 010E","E01016406","Total",19,2,12,5,6,0,6,0,13,2,6,5
"2011","Reading 010F","E01033417","Total",15,3,5,7,3,0,0,3,12,3,5,4
"2011","Reading 010G","E01033421","Total",60,23,10,27,5,2,1,2,55,21,9,25
"2011","Reading 011B","E01016353","Total",55,20,11,24,5,1,3,1,50,19,8,23
"2011","Reading 011D","E01016378","Total",50,16,11,23,9,2,5,2,41,14,6,21
"2011","Reading 011E","E01016391","Total",90,33,14,43,11,3,4,4,79,30,10,39
"2011","Reading 011F","E01033415","Total",16,5,4,7,2,0,0,2,14,5,4,5
"2011","Reading 011G","E01033418","Total",31,8,8,15,4,0,2,2,27,8,6,13
"2011","Reading 011H","E01033420","Total",12,5,4,3,1,0,1,0,11,5,3,3
"2011","Reading 011I","E01033422","Total",30,13,7,10,2,1,0,1,28,12,7,9
"2011","Reading 011J","E01033423","Total",23,6,4,13,0,0,0,0,23,6,4,13
"2011","Reading 012A","E01016401","Total",20,6,10,4,8,1,6,1,12,5,4,3
"2011","Reading 012B","E01016403","Total",25,8,11,6,9,0,5,4,16,8,6,2
"2011","Reading 012C","E01016416","Total",21,11,6,4,3,1,1,1,18,10,5,3
"2011","Reading 012D","E01016417","Total",27,10,8,9,2,0,1,1,25,10,7,8
"2011","Reading 012E","E01016418","Total",37,8,13,16,6,0,5,1,31,8,8,15
"2011","Reading 013A","E01016388","Total",41,10,17,14,5,0,4,1,36,10,13,13
"2011","Reading 013B","E01016389","Total",128,36,38,54,22,2,14,6,106,34,24,48
"2011","Reading 013C","E01016390","Total",22,6,5,11,3,0,2,1,19,6,3,10
"2011","Reading 013D","E01016392","Total",55,22,15,18,3,1,2,0,52,21,13,18
"2011","Reading 013E","E01016393","Total",28,8,11,9,2,0,2,0,26,8,9,9
"2011","Reading 014A","E01016374","Total",42,10,11,21,4,0,2,2,38,10,9,19
"2011","Reading 014B","E01016375","Total",38,9,15,14,7,1,6,0,31,8,9,14
"2011","Reading 014C","E01016376","Total",22,7,8,7,3,1,2,0,19,6,6,7
"2011","Reading 014D","E01016379","Total",34,8,12,14,6,0,5,1,28,8,7,13
"2011","Reading 014E","E01016413","Total",8,3,4,1,2,1,0,1,6,2,4,0
"2011","Reading 014F","E01016414","Total",24,5,11,8,2,0,2,0,22,5,9,8
"2011","Reading 015A","E01016419","Total",48,14,11,23,4,0,2,2,44,14,9,21
"2011","Reading 015B","E01016420","Total",93,36,22,35,11,3,7,1,82,33,15,34
"2011","Reading 015C","E01016421","Total",27,6,12,9,1,0,1,0,26,6,11,9
"2011","Reading 015D","E01016422","Total",49,16,9,24,5,1,4,0,44,15,5,24
"2011","Reading 015E","E01016423","Total",71,22,16,33,5,0,5,0,66,22,11,33
"2011","Reading 015F","E01016424","Total",24,6,8,10,4,0,3,1,20,6,5,9
"2011","Reading 016A","E01016370","Total",44,6,9,29,6,1,2,3,38,5,7,26
"2011","Reading 016B","E01016371","Total",39,13,9,17,4,0,3,1,35,13,6,16
"2011","Reading 016C","E01016373","Total",92,28,12,52,4,1,2,1,88,27,10,51
"2011","Reading 016D","E01016415","Total",78,19,10,49,4,0,1,3,74,19,9,46
"2011","Reading 017A","E01016368","Total",79,23,8,48,8,0,2,6,71,23,6,42
"2011","Reading 017B","E01016372","Total",64,19,5,40,3,1,0,2,61,18,5,38
"2011","Reading 017C","E01016377","Total",81,28,18,35,6,0,6,0,75,28,12,35
"2011","Reading 017D","E01016438","Total",82,25,14,43,2,0,2,0,80,25,12,43
"2011","Reading 017E","E01016442","Total",122,34,22,66,13,4,3,6,109,30,19,60
"2011","Reading 017F","E01016443","Total",101,38,15,48,11,3,7,1,90,35,8,47
"2011","Reading 018A","E01016369","Total",42,13,8,21,4,0,0,4,38,13,8,17
"2011","Reading 018B","E01016437","Total",43,12,6,25,8,1,3,4,35,11,3,21
"2011","Reading 018C","E01016439","Total",57,21,9,27,6,2,1,3,51,19,8,24
"2011","Reading 018D","E01016440","Total",61,24,15,22,6,0,3,3,55,24,12,19
"2011","Reading 018E","E01016441","Total",98,34,9,55,4,0,4,0,94,34,5,55
"2011","Slough 001A","E01016450","Total",123,34,33,56,6,1,4,1,117,33,29,55
"2011","Slough 001B","E01016451","Total",119,29,24,66,9,0,2,7,110,29,22,59
"2011","Slough 001C","E01016452","Total",74,18,22,34,3,1,1,1,71,17,21,33
"2011","Slough 001D","E01016453","Total",53,14,15,24,7,1,3,3,46,13,12,21
"2011","Slough 001E","E01016454","Total",58,11,16,31,4,0,2,2,54,11,14,29
"2011","Slough 001F","E01016455","Total",86,22,24,40,7,2,3,2,79,20,21,38
"2011","Slough 002A","E01016483","Total",56,18,18,20,5,0,5,0,51,18,13,20
"2011","Slough 002B","E01016484","Total",38,12,7,19,5,1,1,3,33,11,6,16
"2011","Slough 002C","E01016485","Total",44,15,13,16,6,0,2,4,38,15,11,12
"2011","Slough 002D","E01016486","Total",77,30,15,32,4,1,2,1,73,29,13,31
"2011","Slough 002E","E01016487","Total",41,14,7,20,4,1,3,0,37,13,4,20
"2011","Slough 002F","E01016488","Total",61,14,14,33,0,0,0,0,61,14,14,33
"2011","Slough 003A","E01016493","Total",28,5,9,14,0,0,0,0,28,5,9,14
"2011","Slough 003B","E01016494","Total",77,18,23,36,6,0,4,2,71,18,19,34
"2011","Slough 003C","E01016495","Total",34,10,19,5,4,0,2,2,30,10,17,3
"2011","Slough 003D","E01016496","Total",86,27,23,36,4,1,2,1,82,26,21,35
"2011","Slough 003E","E01016497","Total",31,14,8,9,0,0,0,0,31,14,8,9
"2011","Slough 003F","E01016498","Total",82,29,14,39,5,2,3,0,77,27,11,39
"2011","Slough 003G","E01016499","Total",75,26,12,37,4,1,1,2,71,25,11,35
"2011","Slough 004A","E01016444","Total",41,11,7,23,2,0,1,1,39,11,6,22
"2011","Slough 004B","E01016445","Total",52,18,10,24,1,0,1,0,51,18,9,24
"2011","Slough 004C","E01016446","Total",33,11,1,21,0,0,0,0,33,11,1,21
"2011","Slough 004D","E01016447","Total",46,9,6,31,4,0,0,4,42,9,6,27
"2011","Slough 004E","E01016448","Total",53,15,13,25,8,2,5,1,45,13,8,24
"2011","Slough 004F","E01016449","Total",54,16,5,33,3,1,0,2,51,15,5,31
"2011","Slough 005A","E01016516","Total",38,10,12,16,1,1,0,0,37,9,12,16
"2011","Slough 005B","E01016517","Total",26,7,11,8,3,0,3,0,23,7,8,8
"2011","Slough 005C","E01016518","Total",52,13,9,30,4,0,3,1,48,13,6,29
"2011","Slough 005D","E01016519","Total",53,12,17,24,6,1,5,0,47,11,12,24
"2011","Slough 005E","E01016520","Total",96,28,20,48,13,5,5,3,83,23,15,45
"2011","Slough 005F","E01016521","Total",43,13,13,17,5,0,4,1,38,13,9,16
"2011","Slough 006A","E01016467","Total",48,19,12,17,4,0,2,2,44,19,10,15
"2011","Slough 006B","E01016468","Total",45,15,13,17,7,2,3,2,38,13,10,15
"2011","Slough 006C","E01016469","Total",47,17,6,24,3,1,1,1,44,16,5,23
"2011","Slough 006D","E01016470","Total",45,20,15,10,11,5,5,1,34,15,10,9
"2011","Slough 006E","E01016471","Total",35,8,14,13,6,0,4,2,29,8,10,11
"2011","Slough 006F","E01016472","Total",50,18,14,18,2,1,1,0,48,17,13,18
"2011","Slough 007A","E01016456","Total",44,14,6,24,2,0,0,2,42,14,6,22
"2011","Slough 007B","E01016457","Total",35,13,5,17,1,0,1,0,34,13,4,17
"2011","Slough 007C","E01016458","Total",78,27,8,43,3,0,1,2,75,27,7,41
"2011","Slough 007D","E01016459","Total",66,13,15,38,3,0,1,2,63,13,14,36
"2011","Slough 007E","E01016460","Total",35,10,6,19,3,2,1,0,32,8,5,19
"2011","Slough 007F","E01016461","Total",69,23,17,29,4,2,0,2,65,21,17,27
"2011","Slough 008A","E01016473","Total",76,23,24,29,3,0,3,0,73,23,21,29
"2011","Slough 008B","E01016474","Total",62,15,14,33,4,0,1,3,58,15,13,30
"2011","Slough 008C","E01016475","Total",54,16,9,29,2,1,1,0,52,15,8,29
"2011","Slough 008D","E01016476","Total",77,21,25,31,4,0,2,2,73,21,23,29
"2011","Slough 008E","E01016477","Total",90,18,26,46,7,0,5,2,83,18,21,44
"2011","Slough 008F","E01016478","Total",38,12,9,17,1,1,0,0,37,11,9,17
"2011","Slough 009A","E01016462","Total",60,21,12,27,6,2,0,4,54,19,12,23
"2011","Slough 009B","E01016463","Total",60,17,9,34,3,1,0,2,57,16,9,32
"2011","Slough 009C","E01016464","Total",53,10,11,32,5,1,1,3,48,9,10,29
"2011","Slough 009D","E01016465","Total",107,30,32,45,9,2,4,3,98,28,28,42
"2011","Slough 009F","E01032729","Total",68,15,20,33,4,1,3,0,64,14,17,33
"2011","Slough 009G","E01032730","Total",65,15,16,34,5,0,3,2,60,15,13,32
"2011","Slough 010A","E01016506","Total",65,17,20,28,7,1,5,1,58,16,15,27
"2011","Slough 010B","E01016507","Total",42,10,17,15,4,1,3,0,38,9,14,15
"2011","Slough 010C","E01016508","Total",53,15,16,22,5,0,3,2,48,15,13,20
"2011","Slough 010D","E01016509","Total",25,7,10,8,3,0,3,0,22,7,7,8
"2011","Slough 010E","E01016510","Total",14,2,7,5,1,0,1,0,13,2,6,5
"2011","Slough 011A","E01016511","Total",48,11,23,14,9,0,9,0,39,11,14,14
"2011","Slough 011B","E01016512","Total",58,21,19,18,7,2,4,1,51,19,15,17
"2011","Slough 011C","E01016513","Total",17,5,6,6,2,0,2,0,15,5,4,6
"2011","Slough 011D","E01016514","Total",48,9,20,19,7,1,4,2,41,8,16,17
"2011","Slough 011E","E01016515","Total",16,4,5,7,1,0,1,0,15,4,4,7
"2011","Slough 012A","E01016500","Total",57,19,18,20,2,0,1,1,55,19,17,19
"2011","Slough 012B","E01016501","Total",84,20,22,42,6,2,2,2,78,18,20,40
"2011","Slough 012C","E01016502","Total",49,19,10,20,3,0,2,1,46,19,8,19
"2011","Slough 012D","E01016503","Total",47,16,10,21,3,0,2,1,44,16,8,20
"2011","Slough 012E","E01016504","Total",17,6,8,3,1,0,1,0,16,6,7,3
"2011","Slough 012F","E01016505","Total",65,10,19,36,3,0,2,1,62,10,17,35
"2011","Slough 013B","E01016490","Total",105,40,20,45,9,1,5,3,96,39,15,42
"2011","Slough 013C","E01016491","Total",30,4,11,15,4,1,2,1,26,3,9,14
"2011","Slough 013D","E01016492","Total",54,13,13,28,1,1,0,0,53,12,13,28
"2011","Slough 013E","E01032731","Total",71,14,32,25,2,0,1,1,69,14,31,24
"2011","Slough 013F","E01032732","Total",58,13,16,29,3,1,2,0,55,12,14,29
"2011","Slough 014A","E01016479","Total",80,20,21,39,8,0,8,0,72,20,13,39
"2011","Slough 014B","E01016480","Total",61,25,11,25,6,2,1,3,55,23,10,22
"2011","Slough 014C","E01016481","Total",56,15,17,24,2,0,1,1,54,15,16,23
"2011","Slough 014D","E01016482","Total",35,8,9,18,2,1,1,0,33,7,8,18
"2011","Southampton 001A","E01017144","Total",23,7,6,10,4,0,3,1,19,7,3,9
"2011","Southampton 001B","E01017145","Total",12,8,0,4,2,1,0,1,10,7,0,3
"2011","Southampton 001C","E01017146","Total",20,6,7,7,2,0,1,1,18,6,6,6
"2011","Southampton 001D","E01017148","Total",6,2,2,2,0,0,0,0,6,2,2,2
"2011","Southampton 001E","E01017149","Total",38,16,5,17,1,0,1,0,37,16,4,17
"2011","Southampton 002A","E01017180","Total",30,19,6,5,3,0,2,1,27,19,4,4
"2011","Southampton 002B","E01017181","Total",45,14,8,23,2,0,1,1,43,14,7,22
"2011","Southampton 002C","E01017183","Total",41,19,12,10,2,0,2,0,39,19,10,10
"2011","Southampton 002D","E01017185","Total",81,29,16,36,7,0,5,2,74,29,11,34
"2011","Southampton 002E","E01017187","Total",51,18,8,25,4,0,1,3,47,18,7,22
"2011","Southampton 003A","E01017264","Total",43,10,8,25,3,0,0,3,40,10,8,22
"2011","Southampton 003B","E01017265","Total",87,31,16,40,6,1,2,3,81,30,14,37
"2011","Southampton 003C","E01017270","Total",23,10,6,7,3,2,1,0,20,8,5,7
"2011","Southampton 003D","E01017271","Total",14,9,4,1,2,0,2,0,12,9,2,1
"2011","Southampton 004A","E01017182","Total",24,14,2,8,1,0,1,0,23,14,1,8
"2011","Southampton 004B","E01017184","Total",49,16,17,16,7,1,3,3,42,15,14,13
"2011","Southampton 004C","E01017186","Total",85,37,15,33,9,5,4,0,76,32,11,33
"2011","Southampton 004D","E01017188","Total",77,23,18,36,7,0,5,2,70,23,13,34
"2011","Southampton 005A","E01017266","Total",56,22,7,27,4,0,1,3,52,22,6,24
"2011","Southampton 005B","E01017267","Total",13,3,5,5,0,0,0,0,13,3,5,5
"2011","Southampton 005E","E01017272","Total",56,12,7,37,0,0,0,0,56,12,7,37
"2011","Southampton 005F","E01032756","Total",34,10,6,18,5,0,2,3,29,10,4,15
"2011","Southampton 006A","E01017147","Total",14,8,2,4,1,1,0,0,13,7,2,4
"2011","Southampton 006B","E01017150","Total",14,5,4,5,2,0,2,0,12,5,2,5
"2011","Southampton 006C","E01017151","Total",33,13,6,14,1,0,0,1,32,13,6,13
"2011","Southampton 006D","E01017152","Total",49,23,8,18,5,1,1,3,44,22,7,15
"2011","Southampton 007A","E01017238","Total",65,21,13,31,6,1,4,1,59,20,9,30
"2011","Southampton 007B","E01017241","Total",82,23,14,45,2,0,0,2,80,23,14,43
"2011","Southampton 007C","E01017242","Total",45,18,11,16,5,0,3,2,40,18,8,14
"2011","Southampton 007D","E01017243","Total",27,15,6,6,3,1,1,1,24,14,5,5
"2011","Southampton 007E","E01017244","Total",59,20,9,30,4,0,2,2,55,20,7,28
"2011","Southampton 008A","E01017174","Total",35,17,8,10,3,0,1,2,32,17,7,8
"2011","Southampton 008B","E01017175","Total",35,19,11,5,2,0,2,0,33,19,9,5
"2011","Southampton 008C","E01017176","Total",48,13,7,28,5,0,1,4,43,13,6,24
"2011","Southampton 008D","E01017179","Total",80,29,13,38,10,0,4,6,70,29,9,32
"2011","Southampton 009A","E01017226","Total",13,1,5,7,1,0,1,0,12,1,4,7
"2011","Southampton 009D","E01017231","Total",16,8,3,5,1,0,1,0,15,8,2,5
"2011","Southampton 009E","E01017232","Total",9,6,1,2,2,1,1,0,7,5,0,2
"2011","Southampton 009F","E01032753","Total",19,4,9,6,4,1,3,0,15,3,6,6
"2011","Southampton 010A","E01017246","Total",62,28,6,28,4,2,0,2,58,26,6,26
"2011","Southampton 010B","E01017250","Total",76,31,10,35,4,2,1,1,72,29,9,34
"2011","Southampton 010C","E01017251","Total",71,26,6,39,2,0,1,1,69,26,5,38
"2011","Southampton 010D","E01017253","Total",62,26,8,28,5,1,2,2,57,25,6,26
"2011","Southampton 011A","E01017247","Total",27,15,7,5,1,1,0,0,26,14,7,5
"2011","Southampton 011B","E01017248","Total",17,5,7,5,2,0,1,1,15,5,6,4
"2011","Southampton 011C","E01017249","Total",14,6,6,2,0,0,0,0,14,6,6,2
"2011","Southampton 011D","E01017252","Total",17,2,6,9,2,0,1,1,15,2,5,8
"2011","Southampton 011E","E01017254","Total",62,32,5,25,4,0,1,3,58,32,4,22
"2011","Southampton 012A","E01017236","Total",90,26,11,53,13,1,6,6,77,25,5,47
"2011","Southampton 012B","E01017237","Total",71,18,6,47,4,0,1,3,67,18,5,44
"2011","Southampton 012C","E01017239","Total",54,28,4,22,4,2,1,1,50,26,3,21
"2011","Southampton 012D","E01017240","Total",84,26,7,51,4,1,1,2,80,25,6,49
"2011","Southampton 012E","E01017245","Total",129,43,15,71,6,2,3,1,123,41,12,70
"2011","Southampton 013A","E01017227","Total",7,2,1,4,0,0,0,0,7,2,1,4
"2011","Southampton 013B","E01017228","Total",59,18,13,28,12,3,4,5,47,15,9,23
"2011","Southampton 013C","E01017233","Total",56,16,12,28,6,1,4,1,50,15,8,27
"2011","Southampton 013D","E01017234","Total",33,8,7,18,3,0,1,2,30,8,6,16
"2011","Southampton 013E","E01017235","Total",18,8,2,8,1,1,0,0,17,7,2,8
"2011","Southampton 014A","E01017171","Total",41,17,8,16,4,1,1,2,37,16,7,14
"2011","Southampton 014B","E01017172","Total",52,21,14,17,8,0,3,5,44,21,11,12
"2011","Southampton 014C","E01017173","Total",46,12,7,27,8,1,2,5,38,11,5,22
"2011","Southampton 014D","E01017177","Total",33,11,9,13,1,0,1,0,32,11,8,13
"2011","Southampton 014E","E01017178","Total",36,11,13,12,2,1,1,0,34,10,12,12
"2011","Southampton 015A","E01017207","Total",124,36,10,78,7,0,2,5,117,36,8,73
"2011","Southampton 015B","E01017209","Total",49,17,13,19,6,0,4,2,43,17,9,17
"2011","Southampton 015C","E01017211","Total",34,14,6,14,5,4,0,1,29,10,6,13
"2011","Southampton 015D","E01017212","Total",37,16,9,12,3,1,2,0,34,15,7,12
"2011","Southampton 015E","E01017213","Total",28,15,8,5,5,2,2,1,23,13,6,4
"2011","Southampton 016A","E01017200","Total",26,11,8,7,2,0,2,0,24,11,6,7
"2011","Southampton 016B","E01017201","Total",77,27,9,41,5,3,0,2,72,24,9,39
"2011","Southampton 016C","E01017202","Total",131,29,23,79,7,0,4,3,124,29,19,76
"2011","Southampton 016D","E01017203","Total",39,8,15,16,2,0,2,0,37,8,13,16
"2011","Southampton 016E","E01017204","Total",31,12,9,10,3,0,3,0,28,12,6,10
"2011","Southampton 017A","E01017157","Total",11,4,4,3,1,0,0,1,10,4,4,2
"2011","Southampton 017B","E01017158","Total",30,7,6,17,3,0,1,2,27,7,5,15
"2011","Southampton 017C","E01017159","Total",23,5,4,14,2,0,0,2,21,5,4,12
"2011","Southampton 017D","E01017160","Total",21,9,9,3,1,1,0,0,20,8,9,3
"2011","Southampton 018A","E01017198","Total",28,7,6,15,3,0,0,3,25,7,6,12
"2011","Southampton 018B","E01017199","Total",59,19,20,20,8,0,7,1,51,19,13,19
"2011","Southampton 018C","E01017205","Total",71,23,9,39,6,0,4,2,65,23,5,37
"2011","Southampton 018D","E01017206","Total",40,12,11,17,5,2,3,0,35,10,8,17
"2011","Southampton 019A","E01017208","Total",80,28,10,42,4,0,3,1,76,28,7,41
"2011","Southampton 019B","E01017210","Total",120,47,20,53,11,1,4,6,109,46,16,47
"2011","Southampton 019C","E01017214","Total",44,17,10,17,6,3,3,0,38,14,7,17
"2011","Southampton 019D","E01017215","Total",29,8,13,8,8,1,7,0,21,7,6,8
"2011","Southampton 019E","E01017216","Total",50,19,8,23,10,2,6,2,40,17,2,21
"2011","Southampton 020A","E01017189","Total",17,13,0,4,3,1,0,2,14,12,0,2
"2011","Southampton 020B","E01017190","Total",13,6,6,1,1,1,0,0,12,5,6,1
"2011","Southampton 020C","E01017191","Total",30,13,6,11,3,0,1,2,27,13,5,9
"2011","Southampton 020D","E01017196","Total",35,15,11,9,3,0,2,1,32,15,9,8
"2011","Southampton 020E","E01017197","Total",26,10,6,10,1,0,0,1,25,10,6,9
"2011","Southampton 021A","E01017192","Total",75,27,16,32,9,3,4,2,66,24,12,30
"2011","Southampton 021B","E01017193","Total",49,18,15,16,6,0,6,0,43,18,9,16
"2011","Southampton 021C","E01017194","Total",40,14,9,17,5,1,2,2,35,13,7,15
"2011","Southampton 021D","E01017195","Total",70,19,16,35,8,0,6,2,62,19,10,33
"2011","Southampton 022A","E01017153","Total",25,8,4,13,1,0,0,1,24,8,4,12
"2011","Southampton 022B","E01017154","Total",124,39,11,74,6,1,0,5,118,38,11,69
"2011","Southampton 022C","E01017155","Total",25,5,7,13,3,0,2,1,22,5,5,12
"2011","Southampton 022D","E01017156","Total",39,14,4,21,1,0,0,1,38,14,4,20
"2011","Southampton 022F","E01032738","Total",21,5,4,12,2,0,1,1,19,5,3,11
"2011","Southampton 022G","E01032750","Total",25,6,3,16,4,0,0,4,21,6,3,12
"2011","Southampton 023A","E01017136","Total",8,3,2,3,1,0,1,0,7,3,1,3
"2011","Southampton 023B","E01017137","Total",3,1,0,2,1,0,0,1,2,1,0,1
"2011","Southampton 023C","E01017138","Total",22,8,4,10,0,0,0,0,22,8,4,10
"2011","Southampton 023D","E01017140","Total",25,6,4,15,1,0,1,0,24,6,3,15
"2011","Southampton 024A","E01017217","Total",33,10,7,16,4,0,1,3,29,10,6,13
"2011","Southampton 024B","E01017223","Total",28,19,7,2,2,1,1,0,26,18,6,2
"2011","Southampton 024C","E01017224","Total",22,7,10,5,4,0,3,1,18,7,7,4
"2011","Southampton 024D","E01017225","Total",56,20,12,24,2,0,2,0,54,20,10,24
"2011","Southampton 025A","E01017162","Total",34,11,7,16,4,0,3,1,30,11,4,15
"2011","Southampton 025B","E01017163","Total",103,24,9,70,6,0,1,5,97,24,8,65
"2011","Southampton 025C","E01017164","Total",36,11,7,18,4,0,3,1,32,11,4,17
"2011","Southampton 025D","E01017165","Total",58,19,6,33,2,0,1,1,56,19,5,32
"2011","Southampton 025E","E01017166","Total",102,35,10,57,12,3,2,7,90,32,8,50
"2011","Southampton 026A","E01017256","Total",41,19,14,8,3,2,1,0,38,17,13,8
"2011","Southampton 026B","E01017257","Total",40,16,8,16,3,0,2,1,37,16,6,15
"2011","Southampton 026C","E01017259","Total",39,17,14,8,4,1,3,0,35,16,11,8
"2011","Southampton 026D","E01017260","Total",29,14,4,11,2,0,2,0,27,14,2,11
"2011","Southampton 026E","E01017262","Total",50,24,8,18,4,1,2,1,46,23,6,17
"2011","Southampton 027A","E01017167","Total",121,30,13,78,7,0,4,3,114,30,9,75
"2011","Southampton 027B","E01017168","Total",99,28,19,52,12,0,9,3,87,28,10,49
"2011","Southampton 027C","E01017169","Total",70,21,12,37,3,0,0,3,67,21,12,34
"2011","Southampton 027D","E01017170","Total",52,24,7,21,3,0,1,2,49,24,6,19
"2011","Southampton 028A","E01017218","Total",60,19,7,34,6,3,3,0,54,16,4,34
"2011","Southampton 028B","E01017219","Total",75,22,18,35,6,1,3,2,69,21,15,33
"2011","Southampton 028C","E01017220","Total",62,25,9,28,3,0,2,1,59,25,7,27
"2011","Southampton 028D","E01017221","Total",50,16,11,23,4,2,1,1,46,14,10,22
"2011","Southampton 028E","E01017222","Total",42,21,10,11,3,0,3,0,39,21,7,11
"2011","Southampton 029A","E01017139","Total",60,15,12,33,3,2,1,0,57,13,11,33
"2011","Southampton 029C","E01017142","Total",27,10,7,10,1,1,0,0,26,9,7,10
"2011","Southampton 029E","E01032745","Total",50,13,9,28,4,0,1,3,46,13,8,25
"2011","Southampton 029F","E01032746","Total",10,2,2,6,1,0,0,1,9,2,2,5
"2011","Southampton 029G","E01032748","Total",11,1,5,5,2,0,1,1,9,1,4,4
"2011","Southampton 029H","E01032751","Total",27,11,3,13,2,2,0,0,25,9,3,13
"2011","Southampton 029I","E01032755","Total",54,13,7,34,6,0,2,4,48,13,5,30
"2011","Southampton 030A","E01017255","Total",30,11,9,10,1,0,1,0,29,11,8,10
"2011","Southampton 030B","E01017258","Total",47,16,14,17,7,2,3,2,40,14,11,15
"2011","Southampton 030C","E01017261","Total",38,14,14,10,6,1,4,1,32,13,10,9
"2011","Southampton 030D","E01017263","Total",30,9,5,16,2,0,2,0,28,9,3,16
"2011","Southampton 031A","E01017273","Total",27,18,3,6,1,0,1,0,26,18,2,6
"2011","Southampton 031B","E01017275","Total",38,9,10,19,5,1,1,3,33,8,9,16
"2011","Southampton 031C","E01017276","Total",78,19,16,43,10,0,3,7,68,19,13,36
"2011","Southampton 031D","E01017278","Total",43,17,11,15,1,0,1,0,42,17,10,15
"2011","Southampton 031E","E01017279","Total",45,13,14,18,2,0,1,1,43,13,13,17
"2011","Southampton 032A","E01017274","Total",90,28,11,51,9,0,4,5,81,28,7,46
"2011","Southampton 032B","E01017277","Total",66,23,16,27,6,1,4,1,60,22,12,26
"2011","Southampton 032C","E01017280","Total",61,17,9,35,4,1,0,3,57,16,9,32
"2011","Southampton 032D","E01017281","Total",149,37,18,94,14,1,6,7,135,36,12,87
"2011","West Berkshire 001A","E01016277","Total",12,5,5,2,2,0,2,0,10,5,3,2
"2011","West Berkshire 001B","E01016286","Total",44,17,14,13,15,3,9,3,29,14,5,10
"2011","West Berkshire 001C","E01016287","Total",28,8,11,9,7,1,4,2,21,7,7,7
"2011","West Berkshire 001D","E01016288","Total",33,11,14,8,5,1,4,0,28,10,10,8
"2011","West Berkshire 002A","E01016303","Total",17,10,2,5,1,0,1,0,16,10,1,5
"2011","West Berkshire 002B","E01016304","Total",30,9,5,16,2,0,2,0,28,9,3,16
"2011","West Berkshire 002C","E01016305","Total",12,7,4,1,2,0,2,0,10,7,2,1
"2011","West Berkshire 002D","E01016306","Total",21,5,5,11,1,0,1,0,20,5,4,11
"2011","West Berkshire 003A","E01016256","Total",18,6,8,4,4,2,1,1,14,4,7,3
"2011","West Berkshire 003B","E01016257","Total",14,5,6,3,2,0,2,0,12,5,4,3
"2011","West Berkshire 003C","E01016313","Total",37,14,9,14,3,0,1,2,34,14,8,12
"2011","West Berkshire 003D","E01016314","Total",11,2,7,2,2,0,2,0,9,2,5,2
"2011","West Berkshire 004A","E01016315","Total",20,10,6,4,3,0,2,1,17,10,4,3
"2011","West Berkshire 004B","E01016316","Total",30,13,9,8,4,0,3,1,26,13,6,7
"2011","West Berkshire 004C","E01016317","Total",29,13,8,8,2,1,0,1,27,12,8,7
"2011","West Berkshire 004D","E01016318","Total",26,12,7,7,3,0,3,0,23,12,4,7
"2011","West Berkshire 005A","E01016258","Total",23,14,4,5,1,0,1,0,22,14,3,5
"2011","West Berkshire 005B","E01016261","Total",22,8,7,7,2,0,1,1,20,8,6,6
"2011","West Berkshire 005C","E01016349","Total",18,10,8,0,3,2,1,0,15,8,7,0
"2011","West Berkshire 005D","E01016350","Total",29,12,10,7,6,2,3,1,23,10,7,6
"2011","West Berkshire 006A","E01016259","Total",42,17,15,10,1,0,1,0,41,17,14,10
"2011","West Berkshire 006B","E01016260","Total",32,11,7,14,2,0,2,0,30,11,5,14
"2011","West Berkshire 006C","E01016262","Total",28,14,7,7,2,0,2,0,26,14,5,7
"2011","West Berkshire 006D","E01016272","Total",34,7,14,13,5,0,4,1,29,7,10,12
"2011","West Berkshire 006E","E01016273","Total",71,22,12,37,9,0,5,4,62,22,7,33
"2011","West Berkshire 007A","E01016263","Total",59,19,28,12,5,0,4,1,54,19,24,11
"2011","West Berkshire 007B","E01016278","Total",17,4,8,5,3,0,2,1,14,4,6,4
"2011","West Berkshire 007C","E01016283","Total",20,7,7,6,3,0,3,0,17,7,4,6
"2011","West Berkshire 007D","E01016284","Total",18,6,3,9,4,1,2,1,14,5,1,8
"2011","West Berkshire 007E","E01016285","Total",24,8,8,8,4,0,3,1,20,8,5,7
"2011","West Berkshire 008A","E01016271","Total",42,13,9,20,1,0,0,1,41,13,9,19
"2011","West Berkshire 008B","E01016274","Total",43,16,13,14,2,2,0,0,41,14,13,14
"2011","West Berkshire 008C","E01016275","Total",51,15,16,20,3,0,1,2,48,15,15,18
"2011","West Berkshire 008D","E01016276","Total",44,16,19,9,2,0,2,0,42,16,17,9
"2011","West Berkshire 009A","E01016327","Total",22,6,6,10,3,1,1,1,19,5,5,9
"2011","West Berkshire 009B","E01016328","Total",57,26,16,15,6,1,2,3,51,25,14,12
"2011","West Berkshire 009C","E01016344","Total",57,15,20,22,8,1,6,1,49,14,14,21
"2011","West Berkshire 009D","E01016345","Total",35,12,16,7,4,1,3,0,31,11,13,7
"2011","West Berkshire 010A","E01016296","Total",44,15,15,14,6,0,4,2,38,15,11,12
"2011","West Berkshire 010B","E01016297","Total",41,16,14,11,4,0,3,1,37,16,11,10
"2011","West Berkshire 010C","E01016298","Total",22,8,7,7,4,1,3,0,18,7,4,7
"2011","West Berkshire 010D","E01016299","Total",22,12,7,3,1,0,1,0,21,12,6,3
"2011","West Berkshire 011A","E01016254","Total",18,7,6,5,1,1,0,0,17,6,6,5
"2011","West Berkshire 011B","E01016255","Total",15,10,2,3,1,1,0,0,14,9,2,3
"2011","West Berkshire 011C","E01016264","Total",19,9,8,2,3,2,1,0,16,7,7,2
"2011","West Berkshire 011D","E01016265","Total",18,14,0,4,0,0,0,0,18,14,0,4
"2011","West Berkshire 011E","E01016266","Total",21,8,5,8,1,1,0,0,20,7,5,8
"2011","West Berkshire 011F","E01016339","Total",80,26,26,28,9,1,7,1,71,25,19,27
"2011","West Berkshire 012A","E01016310","Total",42,17,12,13,2,0,2,0,40,17,10,13
"2011","West Berkshire 012B","E01016311","Total",32,11,14,7,7,1,6,0,25,10,8,7
"2011","West Berkshire 012C","E01016323","Total",22,7,9,6,4,0,2,2,18,7,7,4
"2011","West Berkshire 012D","E01016324","Total",17,4,2,11,0,0,0,0,17,4,2,11
"2011","West Berkshire 012E","E01016325","Total",71,22,9,40,8,0,4,4,63,22,5,36
"2011","West Berkshire 013A","E01016279","Total",68,26,15,27,15,3,6,6,53,23,9,21
"2011","West Berkshire 013B","E01016280","Total",75,26,16,33,2,1,1,0,73,25,15,33
"2011","West Berkshire 013C","E01016281","Total",28,10,8,10,2,0,0,2,26,10,8,8
"2011","West Berkshire 013D","E01016282","Total",39,12,13,14,2,0,2,0,37,12,11,14
"2011","West Berkshire 014A","E01016329","Total",28,10,11,7,1,0,1,0,27,10,10,7
"2011","West Berkshire 014B","E01016340","Total",36,19,8,9,3,0,2,1,33,19,6,8
"2011","West Berkshire 014C","E01016341","Total",30,12,8,10,3,0,1,2,27,12,7,8
"2011","West Berkshire 014D","E01016342","Total",53,20,23,10,5,0,5,0,48,20,18,10
"2011","West Berkshire 014E","E01016343","Total",14,7,4,3,0,0,0,0,14,7,4,3
"2011","West Berkshire 015A","E01016267","Total",23,7,5,11,3,1,2,0,20,6,3,11
"2011","West Berkshire 015B","E01016268","Total",45,16,12,17,6,2,2,2,39,14,10,15
"2011","West Berkshire 015C","E01016269","Total",15,4,8,3,2,0,2,0,13,4,6,3
"2011","West Berkshire 015D","E01016270","Total",28,7,14,7,5,0,5,0,23,7,9,7
"2011","West Berkshire 016A","E01016330","Total",39,16,14,9,4,0,2,2,35,16,12,7
"2011","West Berkshire 016B","E01016331","Total",57,22,14,21,4,2,1,1,53,20,13,20
"2011","West Berkshire 016C","E01016332","Total",41,12,14,15,6,1,1,4,35,11,13,11
"2011","West Berkshire 016D","E01016334","Total",49,12,21,16,7,0,5,2,42,12,16,14
"2011","West Berkshire 016E","E01016336","Total",67,21,11,35,4,1,2,1,63,20,9,34
"2011","West Berkshire 017A","E01016333","Total",24,10,8,6,1,1,0,0,23,9,8,6
"2011","West Berkshire 017B","E01016335","Total",21,8,6,7,2,0,2,0,19,8,4,7
"2011","West Berkshire 017C","E01016337","Total",62,25,22,15,4,1,3,0,58,24,19,15
"2011","West Berkshire 017D","E01016338","Total",34,13,12,9,7,1,4,2,27,12,8,7
"2011","West Berkshire 018A","E01016300","Total",32,15,9,8,4,1,2,1,28,14,7,7
"2011","West Berkshire 018B","E01016301","Total",21,4,7,10,5,0,4,1,16,4,3,9
"2011","West Berkshire 018C","E01016302","Total",22,8,7,7,2,0,2,0,20,8,5,7
"2011","West Berkshire 018D","E01016326","Total",21,7,9,5,3,0,2,1,18,7,7,4
"2011","West Berkshire 019A","E01016293","Total",73,24,22,27,6,2,4,0,67,22,18,27
"2011","West Berkshire 019B","E01016346","Total",40,13,11,16,5,2,2,1,35,11,9,15
"2011","West Berkshire 019C","E01016347","Total",33,8,14,11,2,0,2,0,31,8,12,11
"2011","West Berkshire 019D","E01016348","Total",42,14,16,12,6,2,3,1,36,12,13,11
"2011","West Berkshire 020A","E01016294","Total",20,9,7,4,4,0,3,1,16,9,4,3
"2011","West Berkshire 020B","E01016295","Total",97,34,10,53,8,0,4,4,89,34,6,49
"2011","West Berkshire 020C","E01016312","Total",57,15,16,26,12,2,6,4,45,13,10,22
"2011","West Berkshire 020D","E01016319","Total",30,10,13,7,6,0,6,0,24,10,7,7
"2011","West Berkshire 020E","E01016320","Total",24,7,6,11,4,0,1,3,20,7,5,8
"2011","West Berkshire 021A","E01016289","Total",10,4,4,2,1,0,1,0,9,4,3,2
"2011","West Berkshire 021B","E01016290","Total",30,11,11,8,1,0,0,1,29,11,11,7
"2011","West Berkshire 021C","E01016291","Total",30,14,12,4,2,0,2,0,28,14,10,4
"2011","West Berkshire 021D","E01016292","Total",39,10,17,12,3,0,3,0,36,10,14,12
"2011","West Berkshire 021E","E01016321","Total",32,13,10,9,4,1,2,1,28,12,8,8
"2011","West Berkshire 021F","E01016322","Total",16,7,8,1,3,0,3,0,13,7,5,1
"2011","West Berkshire 022A","E01016307","Total",34,16,7,11,4,1,2,1,30,15,5,10
"2011","West Berkshire 022B","E01016308","Total",34,13,12,9,4,1,3,0,30,12,9,9
"2011","West Berkshire 022C","E01016309","Total",58,14,11,33,6,2,1,3,52,12,10,30
"2011","Windsor and Maidenhead 001A","E01016570","Total",29,9,15,5,9,2,6,1,20,7,9,4
"2011","Windsor and Maidenhead 001B","E01016572","Total",40,13,10,17,5,0,2,3,35,13,8,14
"2011","Windsor and Maidenhead 001C","E01016582","Total",26,8,9,9,1,0,1,0,25,8,8,9
"2011","Windsor and Maidenhead 001D","E01016600","Total",17,5,8,4,4,0,4,0,13,5,4,4
"2011","Windsor and Maidenhead 002A","E01016530","Total",39,16,9,14,8,0,5,3,31,16,4,11
"2011","Windsor and Maidenhead 002B","E01016531","Total",16,4,10,2,0,0,0,0,16,4,10,2
"2011","Windsor and Maidenhead 002C","E01016532","Total",23,10,13,0,6,2,4,0,17,8,9,0
"2011","Windsor and Maidenhead 002D","E01016533","Total",36,12,15,9,6,2,2,2,30,10,13,7
"2011","Windsor and Maidenhead 002E","E01016578","Total",23,7,9,7,5,4,1,0,18,3,8,7
"2011","Windsor and Maidenhead 002F","E01016579","Total",36,16,10,10,1,0,1,0,35,16,9,10
"2011","Windsor and Maidenhead 002G","E01016581","Total",21,9,8,4,2,1,1,0,19,8,7,4
"2011","Windsor and Maidenhead 003A","E01016571","Total",27,14,6,7,6,2,3,1,21,12,3,6
"2011","Windsor and Maidenhead 003B","E01016573","Total",48,23,6,19,6,0,3,3,42,23,3,16
"2011","Windsor and Maidenhead 003C","E01016574","Total",23,5,10,8,2,1,1,0,21,4,9,8
"2011","Windsor and Maidenhead 003D","E01016599","Total",60,19,17,24,12,1,1,10,48,18,16,14
"2011","Windsor and Maidenhead 004A","E01016583","Total",13,6,6,1,1,1,0,0,12,5,6,1
"2011","Windsor and Maidenhead 004B","E01016585","Total",26,6,14,6,2,1,1,0,24,5,13,6
"2011","Windsor and Maidenhead 004C","E01016586","Total",16,4,11,1,5,0,5,0,11,4,6,1
"2011","Windsor and Maidenhead 004D","E01016591","Total",21,8,10,3,5,0,3,2,16,8,7,1
"2011","Windsor and Maidenhead 004E","E01016592","Total",25,10,11,4,5,1,3,1,20,9,8,3
"2011","Windsor and Maidenhead 005A","E01016525","Total",20,9,8,3,2,0,2,0,18,9,6,3
"2011","Windsor and Maidenhead 005B","E01016528","Total",17,5,10,2,2,1,1,0,15,4,9,2
"2011","Windsor and Maidenhead 005C","E01016529","Total",54,20,8,26,10,4,4,2,44,16,4,24
"2011","Windsor and Maidenhead 005D","E01016536","Total",34,9,9,16,3,1,1,1,31,8,8,15
"2011","Windsor and Maidenhead 005E","E01016584","Total",58,16,11,31,2,2,0,0,56,14,11,31
"2011","Windsor and Maidenhead 005G","E01032733","Total",35,3,11,21,1,0,1,0,34,3,10,21
"2011","Windsor and Maidenhead 005H","E01032734","Total",40,16,12,12,2,0,2,0,38,16,10,12
"2011","Windsor and Maidenhead 006A","E01016526","Total",36,13,18,5,7,0,7,0,29,13,11,5
"2011","Windsor and Maidenhead 006B","E01016527","Total",34,13,12,9,3,0,0,3,31,13,12,6
"2011","Windsor and Maidenhead 006C","E01016534","Total",15,8,5,2,1,1,0,0,14,7,5,2
"2011","Windsor and Maidenhead 006D","E01016598","Total",14,6,5,3,0,0,0,0,14,6,5,3
"2011","Windsor and Maidenhead 006E","E01016601","Total",38,12,16,10,0,0,0,0,38,12,16,10
"2011","Windsor and Maidenhead 006F","E01016602","Total",20,7,9,4,1,0,1,0,19,7,8,4
"2011","Windsor and Maidenhead 007A","E01016535","Total",23,4,11,8,2,1,1,0,21,3,10,8
"2011","Windsor and Maidenhead 007B","E01016537","Total",24,6,8,10,2,0,2,0,22,6,6,10
"2011","Windsor and Maidenhead 007C","E01016538","Total",40,17,13,10,1,0,0,1,39,17,13,9
"2011","Windsor and Maidenhead 007D","E01016593","Total",50,15,18,17,6,2,2,2,44,13,16,15
"2011","Windsor and Maidenhead 007E","E01016594","Total",46,16,15,15,3,0,2,1,43,16,13,14
"2011","Windsor and Maidenhead 008A","E01016559","Total",8,3,4,1,1,1,0,0,7,2,4,1
"2011","Windsor and Maidenhead 008B","E01016560","Total",53,16,15,22,0,0,0,0,53,16,15,22
"2011","Windsor and Maidenhead 008C","E01016561","Total",34,14,12,8,6,1,3,2,28,13,9,6
"2011","Windsor and Maidenhead 008D","E01016562","Total",10,5,3,2,0,0,0,0,10,5,3,2
"2011","Windsor and Maidenhead 008E","E01016563","Total",25,11,9,5,1,0,1,0,24,11,8,5
"2011","Windsor and Maidenhead 008F","E01016580","Total",49,21,7,21,9,3,2,4,40,18,5,17
"2011","Windsor and Maidenhead 009A","E01016539","Total",15,5,7,3,2,1,1,0,13,4,6,3
"2011","Windsor and Maidenhead 009B","E01016540","Total",31,16,6,9,5,2,2,1,26,14,4,8
"2011","Windsor and Maidenhead 009C","E01016541","Total",15,5,8,2,1,0,1,0,14,5,7,2
"2011","Windsor and Maidenhead 009D","E01016542","Total",29,9,12,8,1,0,1,0,28,9,11,8
"2011","Windsor and Maidenhead 009E","E01016543","Total",20,5,8,7,3,1,1,1,17,4,7,6
"2011","Windsor and Maidenhead 010A","E01016544","Total",19,5,9,5,4,1,1,2,15,4,8,3
"2011","Windsor and Maidenhead 010B","E01016567","Total",19,5,6,8,2,0,0,2,17,5,6,6
"2011","Windsor and Maidenhead 010C","E01016568","Total",35,15,10,10,5,1,3,1,30,14,7,9
"2011","Windsor and Maidenhead 010D","E01016569","Total",18,6,6,6,2,0,0,2,16,6,6,4
"2011","Windsor and Maidenhead 011A","E01016564","Total",40,10,13,17,5,2,2,1,35,8,11,16
"2011","Windsor and Maidenhead 011B","E01016565","Total",16,8,4,4,1,0,1,0,15,8,3,4
"2011","Windsor and Maidenhead 011C","E01016566","Total",50,14,14,22,3,1,0,2,47,13,14,20
"2011","Windsor and Maidenhead 011D","E01016577","Total",49,22,16,11,5,2,3,0,44,20,13,11
"2011","Windsor and Maidenhead 012A","E01016545","Total",57,20,20,17,2,0,2,0,55,20,18,17
"2011","Windsor and Maidenhead 012B","E01016547","Total",39,13,15,11,2,0,2,0,37,13,13,11
"2011","Windsor and Maidenhead 012C","E01016550","Total",21,12,4,5,2,1,1,0,19,11,3,5
"2011","Windsor and Maidenhead 012D","E01016552","Total",36,14,6,16,0,0,0,0,36,14,6,16
"2011","Windsor and Maidenhead 013A","E01016551","Total",16,3,8,5,0,0,0,0,16,3,8,5
"2011","Windsor and Maidenhead 013B","E01016553","Total",27,7,14,6,1,0,1,0,26,7,13,6
"2011","Windsor and Maidenhead 013C","E01016557","Total",63,27,25,11,3,0,3,0,60,27,22,11
"2011","Windsor and Maidenhead 013D","E01016558","Total",51,14,20,17,9,2,5,2,42,12,15,15
"2011","Windsor and Maidenhead 014A","E01016548","Total",36,7,24,5,5,0,3,2,31,7,21,3
"2011","Windsor and Maidenhead 014B","E01016549","Total",62,20,19,23,4,1,0,3,58,19,19,20
"2011","Windsor and Maidenhead 014C","E01016554","Total",70,27,15,28,2,0,2,0,68,27,13,28
"2011","Windsor and Maidenhead 014D","E01016555","Total",56,19,14,23,8,1,5,2,48,18,9,21
"2011","Windsor and Maidenhead 014E","E01016556","Total",67,25,13,29,7,2,2,3,60,23,11,26
"2011","Windsor and Maidenhead 015A","E01016546","Total",15,3,11,1,5,0,5,0,10,3,6,1
"2011","Windsor and Maidenhead 015B","E01016595","Total",45,12,14,19,2,0,2,0,43,12,12,19
"2011","Windsor and Maidenhead 015C","E01016596","Total",33,9,14,10,3,1,2,0,30,8,12,10
"2011","Windsor and Maidenhead 015D","E01016597","Total",21,7,11,3,4,1,3,0,17,6,8,3
"2011","Windsor and Maidenhead 016A","E01016575","Total",16,4,4,8,3,0,0,3,13,4,4,5
"2011","Windsor and Maidenhead 016B","E01016576","Total",22,7,8,7,3,0,3,0,19,7,5,7
"2011","Windsor and Maidenhead 016C","E01016587","Total",23,10,8,5,4,0,4,0,19,10,4,5
"2011","Windsor and Maidenhead 016D","E01016588","Total",36,15,11,10,5,1,2,2,31,14,9,8
"2011","Windsor and Maidenhead 016E","E01016589","Total",18,7,8,3,4,0,2,2,14,7,6,1
"2011","Windsor and Maidenhead 017A","E01016522","Total",20,7,10,3,2,0,2,0,18,7,8,3
"2011","Windsor and Maidenhead 017B","E01016523","Total",25,10,12,3,5,0,5,0,20,10,7,3
"2011","Windsor and Maidenhead 017C","E01016524","Total",43,12,14,17,2,0,2,0,41,12,12,17
"2011","Windsor and Maidenhead 017D","E01016609","Total",66,24,18,24,5,0,2,3,61,24,16,21
"2011","Windsor and Maidenhead 018A","E01016603","Total",25,9,9,7,2,0,0,2,23,9,9,5
"2011","Windsor and Maidenhead 018B","E01016604","Total",29,7,10,12,2,0,1,1,27,7,9,11
"2011","Windsor and Maidenhead 018C","E01016605","Total",26,13,9,4,2,0,2,0,24,13,7,4
"2011","Windsor and Maidenhead 018D","E01016606","Total",28,13,10,5,4,1,3,0,24,12,7,5
"2011","Windsor and Maidenhead 018E","E01016607","Total",20,4,10,6,1,0,1,0,19,4,9,6
"2011","Windsor and Maidenhead 018F","E01016608","Total",75,21,27,27,7,1,5,1,68,20,22,26
"2011","Wokingham 001A","E01016675","Total",16,7,5,4,3,0,1,2,13,7,4,2
"2011","Wokingham 001B","E01016676","Total",22,8,10,4,3,0,3,0,19,8,7,4
"2011","Wokingham 001C","E01016677","Total",22,12,5,5,1,0,1,0,21,12,4,5
"2011","Wokingham 001D","E01016678","Total",17,5,4,8,1,0,0,1,16,5,4,7
"2011","Wokingham 002A","E01016619","Total",15,6,8,1,1,1,0,0,14,5,8,1
"2011","Wokingham 002B","E01016620","Total",22,8,5,9,1,0,1,0,21,8,4,9
"2011","Wokingham 002C","E01016692","Total",19,8,11,0,1,0,1,0,18,8,10,0
"2011","Wokingham 002D","E01016693","Total",23,9,10,4,1,0,1,0,22,9,9,4
"2011","Wokingham 002E","E01016694","Total",22,8,11,3,3,0,2,1,19,8,9,2
"2011","Wokingham 002F","E01016695","Total",17,6,8,3,8,1,5,2,9,5,3,1
"2011","Wokingham 003A","E01016621","Total",47,16,11,20,6,0,3,3,41,16,8,17
"2011","Wokingham 003B","E01016623","Total",19,8,8,3,2,0,2,0,17,8,6,3
"2011","Wokingham 003C","E01016624","Total",19,9,5,5,2,0,1,1,17,9,4,4
"2011","Wokingham 003D","E01016684","Total",35,14,14,7,3,0,2,1,32,14,12,6
"2011","Wokingham 003E","E01016685","Total",23,8,7,8,2,1,1,0,21,7,6,8
"2011","Wokingham 004A","E01016622","Total",16,7,7,2,2,0,2,0,14,7,5,2
"2011","Wokingham 004B","E01016657","Total",28,9,9,10,0,0,0,0,28,9,9,10
"2011","Wokingham 004C","E01016658","Total",27,10,12,5,3,0,3,0,24,10,9,5
"2011","Wokingham 004D","E01016659","Total",57,20,19,18,4,0,4,0,53,20,15,18
"2011","Wokingham 004E","E01016660","Total",40,19,11,10,5,1,3,1,35,18,8,9
"2011","Wokingham 005A","E01016615","Total",30,10,7,13,2,0,0,2,28,10,7,11
"2011","Wokingham 005B","E01016616","Total",19,8,1,10,1,1,0,0,18,7,1,10
"2011","Wokingham 005C","E01016617","Total",13,2,9,2,0,0,0,0,13,2,9,2
"2011","Wokingham 005D","E01016662","Total",63,26,12,25,9,3,5,1,54,23,7,24
"2011","Wokingham 006A","E01016613","Total",33,15,8,10,4,1,2,1,29,14,6,9
"2011","Wokingham 006B","E01016614","Total",16,5,5,6,4,3,1,0,12,2,4,6
"2011","Wokingham 006C","E01016618","Total",12,3,4,5,0,0,0,0,12,3,4,5
"2011","Wokingham 006D","E01016664","Total",14,6,4,4,4,0,1,3,10,6,3,1
"2011","Wokingham 006E","E01016668","Total",32,7,11,14,6,0,3,3,26,7,8,11
"2011","Wokingham 006F","E01016669","Total",24,9,9,6,2,0,1,1,22,9,8,5
"2011","Wokingham 007A","E01016661","Total",23,9,11,3,5,0,4,1,18,9,7,2
"2011","Wokingham 007B","E01016663","Total",29,13,7,9,4,2,1,1,25,11,6,8
"2011","Wokingham 007C","E01016686","Total",28,12,8,8,2,0,1,1,26,12,7,7
"2011","Wokingham 007D","E01016687","Total",13,6,4,3,1,0,1,0,12,6,3,3
"2011","Wokingham 007E","E01016688","Total",28,14,4,10,3,1,2,0,25,13,2,10
"2011","Wokingham 007F","E01016689","Total",13,3,7,3,3,0,3,0,10,3,4,3
"2011","Wokingham 008B","E01016652","Total",27,12,11,4,4,2,2,0,23,10,9,4
"2011","Wokingham 008C","E01016653","Total",10,3,5,2,0,0,0,0,10,3,5,2
"2011","Wokingham 008D","E01016665","Total",32,14,12,6,2,0,2,0,30,14,10,6
"2011","Wokingham 008E","E01016666","Total",18,7,6,5,0,0,0,0,18,7,6,5
"2011","Wokingham 008G","E01032761","Total",18,4,8,6,2,0,0,2,16,4,8,4
"2011","Wokingham 009A","E01016647","Total",43,14,14,15,5,0,2,3,38,14,12,12
"2011","Wokingham 009B","E01016701","Total",22,9,9,4,2,0,2,0,20,9,7,4
"2011","Wokingham 009C","E01016702","Total",36,8,13,15,2,1,1,0,34,7,12,15
"2011","Wokingham 009D","E01016703","Total",40,17,8,15,4,0,4,0,36,17,4,15
"2011","Wokingham 009E","E01016704","Total",74,25,17,32,4,2,1,1,70,23,16,31
"2011","Wokingham 010A","E01016627","Total",25,6,16,3,4,0,4,0,21,6,12,3
"2011","Wokingham 010B","E01016628","Total",23,10,10,3,5,0,4,1,18,10,6,2
"2011","Wokingham 010C","E01016656","Total",20,7,5,8,4,1,1,2,16,6,4,6
"2011","Wokingham 010D","E01016700","Total",34,9,18,7,6,0,3,3,28,9,15,4
"2011","Wokingham 011A","E01016644","Total",24,9,9,6,1,1,0,0,23,8,9,6
"2011","Wokingham 011B","E01016645","Total",22,5,12,5,5,0,5,0,17,5,7,5
"2011","Wokingham 011C","E01016646","Total",22,11,7,4,0,0,0,0,22,11,7,4
"2011","Wokingham 011D","E01016648","Total",25,4,14,7,6,0,6,0,19,4,8,7
"2011","Wokingham 011E","E01016649","Total",20,7,9,4,2,0,2,0,18,7,7,4
"2011","Wokingham 012A","E01016651","Total",26,9,8,9,3,1,2,0,23,8,6,9
"2011","Wokingham 012B","E01016654","Total",25,8,13,4,2,0,2,0,23,8,11,4
"2011","Wokingham 012C","E01016655","Total",18,5,12,1,4,0,4,0,14,5,8,1
"2011","Wokingham 012D","E01016679","Total",71,27,17,27,5,0,4,1,66,27,13,26
"2011","Wokingham 012E","E01016680","Total",49,11,14,24,1,0,0,1,48,11,14,23
"2011","Wokingham 012G","E01032758","Total",50,13,16,21,4,1,2,1,46,12,14,20
"2011","Wokingham 012H","E01032759","Total",19,6,6,7,0,0,0,0,19,6,6,7
"2011","Wokingham 013A","E01016626","Total",44,14,16,14,5,0,3,2,39,14,13,12
"2011","Wokingham 013B","E01016671","Total",14,4,6,4,2,0,1,1,12,4,5,3
"2011","Wokingham 013C","E01016673","Total",75,21,18,36,12,0,7,5,63,21,11,31
"2011","Wokingham 013D","E01016674","Total",41,9,8,24,2,1,1,0,39,8,7,24
"2011","Wokingham 013E","E01016696","Total",39,15,12,12,0,0,0,0,39,15,12,12
"2011","Wokingham 014A","E01016670","Total",38,11,18,9,8,1,4,3,30,10,14,6
"2011","Wokingham 014B","E01016672","Total",22,6,11,5,2,0,2,0,20,6,9,5
"2011","Wokingham 014E","E01032763","Total",22,7,10,5,2,0,2,0,20,7,8,5
"2011","Wokingham 015A","E01016612","Total",17,6,8,3,2,0,2,0,15,6,6,3
"2011","Wokingham 015B","E01016629","Total",7,2,5,0,0,0,0,0,7,2,5,0
"2011","Wokingham 015C","E01016630","Total",29,9,18,2,5,0,5,0,24,9,13,2
"2011","Wokingham 015D","E01016635","Total",29,12,9,8,4,0,4,0,25,12,5,8
"2011","Wokingham 016A","E01016625","Total",22,12,7,3,1,0,0,1,21,12,7,2
"2011","Wokingham 016B","E01016631","Total",32,7,8,17,4,0,3,1,28,7,5,16
"2011","Wokingham 016C","E01016632","Total",14,4,9,1,3,0,3,0,11,4,6,1
"2011","Wokingham 016D","E01016634","Total",16,8,3,5,0,0,0,0,16,8,3,5
"2011","Wokingham 016E","E01016699","Total",26,11,12,3,1,0,1,0,25,11,11,3
"2011","Wokingham 017A","E01016682","Total",26,9,12,5,6,2,4,0,20,7,8,5
"2011","Wokingham 017B","E01016683","Total",26,14,7,5,1,0,0,1,25,14,7,4
"2011","Wokingham 017C","E01016690","Total",52,18,15,19,3,0,3,0,49,18,12,19
"2011","Wokingham 017D","E01016691","Total",6,4,2,0,0,0,0,0,6,4,2,0
"2011","Wokingham 018A","E01016610","Total",72,34,25,13,7,2,5,0,65,32,20,13
"2011","Wokingham 018B","E01016611","Total",23,8,10,5,1,0,1,0,22,8,9,5
"2011","Wokingham 018C","E01016641","Total",9,1,5,3,3,0,2,1,6,1,3,2
"2011","Wokingham 018D","E01016642","Total",42,13,13,16,5,2,2,1,37,11,11,15
"2011","Wokingham 019A","E01016633","Total",18,4,11,3,1,0,1,0,17,4,10,3
"2011","Wokingham 019B","E01016636","Total",11,4,5,2,1,0,1,0,10,4,4,2
"2011","Wokingham 019C","E01016637","Total",9,1,4,4,2,0,1,1,7,1,3,3
"2011","Wokingham 019D","E01016638","Total",21,8,13,0,1,0,1,0,20,8,12,0
"2011","Wokingham 019E","E01016639","Total",30,11,15,4,9,2,6,1,21,9,9,3
"2011","Wokingham 019F","E01016640","Total",12,1,5,6,3,1,2,0,9,0,3,6
"2011","Wokingham 019G","E01016643","Total",18,11,5,2,2,0,2,0,16,11,3,2
"2011","Wokingham 020A","E01016705","Total",30,16,7,7,6,3,3,0,24,13,4,7
"2011","Wokingham 020B","E01016706","Total",28,3,21,4,8,1,7,0,20,2,14,4
"2011","Wokingham 020C","E01016707","Total",28,9,17,2,3,0,3,0,25,9,14,2
"2011","Wokingham 020D","E01016708","Total",12,1,10,1,1,0,1,0,11,1,9,1
"2011","Wokingham 020E","E01016709","Total",21,11,10,0,5,1,4,0,16,10,6,0
"2011","Aylesbury Vale 001A","E01017648","Total",31,9,20,2,5,1,4,0,26,8,16,2
"2011","Aylesbury Vale 001B","E01017649","Total",60,21,20,19,4,1,1,2,56,20,19,17
"2011","Aylesbury Vale 001C","E01017650","Total",26,9,7,10,6,0,4,2,20,9,3,8
"2011","Aylesbury Vale 001F","E01032960","Total",39,19,10,10,3,1,2,0,36,18,8,10
"2011","Aylesbury Vale 002A","E01017644","Total",42,21,10,11,7,0,6,1,35,21,4,10
"2011","Aylesbury Vale 002B","E01017645","Total",44,14,13,17,5,2,2,1,39,12,11,16
"2011","Aylesbury Vale 002C","E01017646","Total",65,19,19,27,5,0,4,1,60,19,15,26
"2011","Aylesbury Vale 002D","E01017647","Total",14,3,8,3,2,0,2,0,12,3,6,3
"2011","Aylesbury Vale 003A","E01017671","Total",23,11,8,4,1,0,1,0,22,11,7,4
"2011","Aylesbury Vale 003B","E01017672","Total",16,6,8,2,5,0,4,1,11,6,4,1
"2011","Aylesbury Vale 003C","E01017695","Total",16,3,11,2,3,0,3,0,13,3,8,2
"2011","Aylesbury Vale 003D","E01017696","Total",19,9,5,5,0,0,0,0,19,9,5,5
"2011","Aylesbury Vale 004A","E01017693","Total",13,4,9,0,6,0,6,0,7,4,3,0
"2011","Aylesbury Vale 004B","E01017694","Total",31,7,12,12,8,1,5,2,23,6,7,10
"2011","Aylesbury Vale 004C","E01017713","Total",30,9,12,9,3,0,3,0,27,9,9,9
"2011","Aylesbury Vale 004D","E01017714","Total",12,4,7,1,4,0,4,0,8,4,3,1
"2011","Aylesbury Vale 004E","E01017717","Total",27,10,12,5,3,2,1,0,24,8,11,5
"2011","Aylesbury Vale 004F","E01017718","Total",23,6,13,4,1,0,1,0,22,6,12,4
"2011","Aylesbury Vale 005A","E01017735","Total",19,9,5,5,1,0,1,0,18,9,4,5
"2011","Aylesbury Vale 005B","E01017736","Total",46,20,12,14,3,0,1,2,43,20,11,12
"2011","Aylesbury Vale 005C","E01017737","Total",16,4,9,3,3,0,3,0,13,4,6,3
"2011","Aylesbury Vale 005D","E01017738","Total",31,17,10,4,2,0,2,0,29,17,8,4
"2011","Aylesbury Vale 006A","E01017669","Total",22,12,6,4,0,0,0,0,22,12,6,4
"2011","Aylesbury Vale 006B","E01017670","Total",22,12,5,5,0,0,0,0,22,12,5,5
"2011","Aylesbury Vale 006C","E01017715","Total",11,6,4,1,2,1,1,0,9,5,3,1
"2011","Aylesbury Vale 006D","E01017716","Total",19,6,9,4,5,0,4,1,14,6,5,3
"2011","Aylesbury Vale 007A","E01017641","Total",25,9,11,5,5,1,3,1,20,8,8,4
"2011","Aylesbury Vale 007B","E01017731","Total",31,15,10,6,3,0,3,0,28,15,7,6
"2011","Aylesbury Vale 007C","E01017732","Total",31,8,15,8,5,0,4,1,26,8,11,7
"2011","Aylesbury Vale 007D","E01017733","Total",20,9,4,7,4,2,2,0,16,7,2,7
"2011","Aylesbury Vale 007E","E01017734","Total",16,7,7,2,4,0,4,0,12,7,3,2
"2011","Aylesbury Vale 008A","E01017703","Total",34,11,13,10,3,1,2,0,31,10,11,10
"2011","Aylesbury Vale 008B","E01017704","Total",13,3,6,4,1,0,0,1,12,3,6,3
"2011","Aylesbury Vale 008C","E01017719","Total",30,12,15,3,5,0,5,0,25,12,10,3
"2011","Aylesbury Vale 008D","E01017720","Total",24,8,13,3,4,0,4,0,20,8,9,3
"2011","Aylesbury Vale 008F","E01032958","Total",21,9,4,8,1,1,0,0,20,8,4,8
"2011","Aylesbury Vale 008G","E01032959","Total",100,39,16,45,4,2,1,1,96,37,15,44
"2011","Aylesbury Vale 009A","E01017651","Total",25,11,13,1,5,1,4,0,20,10,9,1
"2011","Aylesbury Vale 009B","E01017652","Total",29,9,16,4,5,0,5,0,24,9,11,4
"2011","Aylesbury Vale 009C","E01017657","Total",21,8,10,3,5,1,4,0,16,7,6,3
"2011","Aylesbury Vale 009D","E01017658","Total",27,7,15,5,5,0,4,1,22,7,11,4
"2011","Aylesbury Vale 009E","E01017701","Total",55,22,19,14,5,1,1,3,50,21,18,11
"2011","Aylesbury Vale 009F","E01017702","Total",20,6,9,5,4,0,3,1,16,6,6,4
"2011","Aylesbury Vale 010A","E01017642","Total",18,8,6,4,4,0,4,0,14,8,2,4
"2011","Aylesbury Vale 010B","E01017643","Total",11,2,4,5,5,1,2,2,6,1,2,3
"2011","Aylesbury Vale 010C","E01017673","Total",15,1,10,4,3,0,3,0,12,1,7,4
"2011","Aylesbury Vale 010D","E01017674","Total",25,11,13,1,7,1,6,0,18,10,7,1
"2011","Aylesbury Vale 011A","E01017659","Total",59,21,16,22,4,1,1,2,55,20,15,20
"2011","Aylesbury Vale 011B","E01017660","Total",60,17,25,18,10,0,5,5,50,17,20,13
"2011","Aylesbury Vale 011C","E01017661","Total",61,21,15,25,1,1,0,0,60,20,15,25
"2011","Aylesbury Vale 011D","E01017664","Total",27,15,8,4,3,0,2,1,24,15,6,3
"2011","Aylesbury Vale 012A","E01017705","Total",28,7,13,8,7,0,5,2,21,7,8,6
"2011","Aylesbury Vale 012B","E01017706","Total",59,23,12,24,4,0,2,2,55,23,10,22
"2011","Aylesbury Vale 012C","E01017707","Total",81,32,13,36,6,1,1,4,75,31,12,32
"2011","Aylesbury Vale 012D","E01017708","Total",79,23,24,32,7,1,3,3,72,22,21,29
"2011","Aylesbury Vale 013A","E01017665","Total",73,27,13,33,4,2,2,0,69,25,11,33
"2011","Aylesbury Vale 013B","E01017666","Total",48,17,14,17,4,1,1,2,44,16,13,15
"2011","Aylesbury Vale 013C","E01017667","Total",75,24,20,31,9,0,5,4,66,24,15,27
"2011","Aylesbury Vale 013D","E01017668","Total",37,11,12,14,7,0,5,2,30,11,7,12
"2011","Aylesbury Vale 014A","E01017697","Total",40,17,15,8,4,1,3,0,36,16,12,8
"2011","Aylesbury Vale 014B","E01017698","Total",60,21,23,16,4,1,3,0,56,20,20,16
"2011","Aylesbury Vale 014C","E01017699","Total",26,7,10,9,2,0,1,1,24,7,9,8
"2011","Aylesbury Vale 014D","E01017700","Total",24,8,13,3,6,0,6,0,18,8,7,3
"2011","Aylesbury Vale 015B","E01017634","Total",40,9,16,15,8,0,7,1,32,9,9,14
"2011","Aylesbury Vale 015C","E01017662","Total",47,16,12,19,5,0,3,2,42,16,9,17
"2011","Aylesbury Vale 015D","E01017663","Total",36,7,6,23,6,1,1,4,30,6,5,19
"2011","Aylesbury Vale 015E","E01032955","Total",21,6,11,4,4,0,3,1,17,6,8,3
"2011","Aylesbury Vale 015F","E01032961","Total",51,10,19,22,4,0,2,2,47,10,17,20
"2011","Aylesbury Vale 016A","E01017653","Total",42,13,19,10,9,0,6,3,33,13,13,7
"2011","Aylesbury Vale 016B","E01017654","Total",55,17,16,22,3,0,0,3,52,17,16,19
"2011","Aylesbury Vale 016C","E01017655","Total",55,27,19,9,5,0,5,0,50,27,14,9
"2011","Aylesbury Vale 016E","E01032956","Total",28,11,11,6,4,0,2,2,24,11,9,4
"2011","Aylesbury Vale 016F","E01032957","Total",31,9,12,10,2,0,2,0,29,9,10,10
"2011","Aylesbury Vale 016G","E01032962","Total",41,13,13,15,7,1,3,3,34,12,10,12
"2011","Aylesbury Vale 017A","E01017635","Total",24,7,14,3,3,1,2,0,21,6,12,3
"2011","Aylesbury Vale 017B","E01017636","Total",30,11,14,5,5,0,5,0,25,11,9,5
"2011","Aylesbury Vale 017C","E01017637","Total",25,10,11,4,5,1,4,0,20,9,7,4
"2011","Aylesbury Vale 017D","E01017638","Total",6,3,2,1,2,1,0,1,4,2,2,0
"2011","Aylesbury Vale 017E","E01017639","Total",11,3,6,2,2,0,1,1,9,3,5,1
"2011","Aylesbury Vale 017F","E01017640","Total",21,6,10,5,3,0,3,0,18,6,7,5
"2011","Aylesbury Vale 018A","E01017709","Total",54,20,12,22,4,0,2,2,50,20,10,20
"2011","Aylesbury Vale 018B","E01017710","Total",47,13,16,18,8,0,6,2,39,13,10,16
"2011","Aylesbury Vale 018C","E01017711","Total",67,20,21,26,9,2,3,4,58,18,18,22
"2011","Aylesbury Vale 018D","E01017712","Total",82,24,22,36,8,1,3,4,74,23,19,32
"2011","Aylesbury Vale 019A","E01017687","Total",83,25,36,22,8,1,5,2,75,24,31,20
"2011","Aylesbury Vale 019B","E01017688","Total",28,12,10,6,4,1,2,1,24,11,8,5
"2011","Aylesbury Vale 019C","E01017689","Total",25,10,9,6,3,1,2,0,22,9,7,6
"2011","Aylesbury Vale 019D","E01017690","Total",24,6,14,4,4,1,3,0,20,5,11,4
"2011","Aylesbury Vale 019E","E01017691","Total",19,5,12,2,4,1,2,1,15,4,10,1
"2011","Aylesbury Vale 019F","E01017692","Total",40,11,20,9,8,0,6,2,32,11,14,7
"2011","Aylesbury Vale 020A","E01017721","Total",53,19,23,11,10,2,7,1,43,17,16,10
"2011","Aylesbury Vale 020B","E01017722","Total",43,18,12,13,4,0,2,2,39,18,10,11
"2011","Aylesbury Vale 020C","E01017723","Total",64,16,17,31,2,1,1,0,62,15,16,31
"2011","Aylesbury Vale 020D","E01017724","Total",72,23,18,31,9,0,4,5,63,23,14,26
"2011","Aylesbury Vale 021A","E01017627","Total",37,17,11,9,5,0,4,1,32,17,7,8
"2011","Aylesbury Vale 021B","E01017628","Total",28,7,15,6,5,0,5,0,23,7,10,6
"2011","Aylesbury Vale 021C","E01017629","Total",18,5,10,3,3,0,3,0,15,5,7,3
"2011","Aylesbury Vale 021D","E01017630","Total",22,9,7,6,3,0,3,0,19,9,4,6
"2011","Aylesbury Vale 021E","E01017631","Total",20,11,7,2,6,2,4,0,14,9,3,2
"2011","Aylesbury Vale 021F","E01017632","Total",21,12,7,2,3,1,2,0,18,11,5,2
"2011","Aylesbury Vale 022A","E01017675","Total",29,11,9,9,4,0,3,1,25,11,6,8
"2011","Aylesbury Vale 022B","E01017676","Total",9,1,4,4,2,0,1,1,7,1,3,3
"2011","Aylesbury Vale 022C","E01017677","Total",15,6,6,3,5,1,4,0,10,5,2,3
"2011","Aylesbury Vale 022D","E01017678","Total",10,5,2,3,1,1,0,0,9,4,2,3
"2011","Aylesbury Vale 022E","E01017679","Total",41,15,14,12,6,0,4,2,35,15,10,10
"2011","Aylesbury Vale 022F","E01017680","Total",19,6,10,3,2,0,1,1,17,6,9,2
"2011","Aylesbury Vale 023A","E01017681","Total",19,9,9,1,2,0,2,0,17,9,7,1
"2011","Aylesbury Vale 023B","E01017682","Total",14,3,6,5,3,0,2,1,11,3,4,4
"2011","Aylesbury Vale 023C","E01017683","Total",23,15,7,1,7,1,5,1,16,14,2,0
"2011","Aylesbury Vale 023D","E01017684","Total",10,6,3,1,1,0,1,0,9,6,2,1
"2011","Aylesbury Vale 024A","E01017726","Total",13,7,4,2,1,0,1,0,12,7,3,2
"2011","Aylesbury Vale 024B","E01017727","Total",20,7,11,2,5,0,5,0,15,7,6,2
"2011","Aylesbury Vale 024C","E01017728","Total",82,28,32,22,15,3,12,0,67,25,20,22
"2011","Aylesbury Vale 024D","E01017729","Total",37,13,18,6,8,0,7,1,29,13,11,5
"2011","Aylesbury Vale 024E","E01017730","Total",44,15,16,13,3,0,2,1,41,15,14,12
"2011","Chiltern 001A","E01017750","Total",21,7,10,4,2,0,2,0,19,7,8,4
"2011","Chiltern 001B","E01017752","Total",16,7,6,3,2,0,2,0,14,7,4,3
"2011","Chiltern 001C","E01017766","Total",18,3,11,4,5,1,4,0,13,2,7,4
"2011","Chiltern 001D","E01017778","Total",18,9,7,2,0,0,0,0,18,9,7,2
"2011","Chiltern 002A","E01017747","Total",28,13,6,9,5,1,2,2,23,12,4,7
"2011","Chiltern 002B","E01017748","Total",50,17,15,18,3,0,0,3,47,17,15,15
"2011","Chiltern 002C","E01017749","Total",13,6,4,3,0,0,0,0,13,6,4,3
"2011","Chiltern 002D","E01017789","Total",37,14,9,14,3,0,2,1,34,14,7,13
"2011","Chiltern 002E","E01017790","Total",48,17,8,23,3,1,2,0,45,16,6,23
"2011","Chiltern 002F","E01017795","Total",43,15,11,17,5,1,2,2,38,14,9,15
"2011","Chiltern 003A","E01017769","Total",15,5,4,6,3,1,0,2,12,4,4,4
"2011","Chiltern 003B","E01017771","Total",17,4,7,6,2,1,1,0,15,3,6,6
"2011","Chiltern 003C","E01017780","Total",16,8,6,2,0,0,0,0,16,8,6,2
"2011","Chiltern 003D","E01017781","Total",31,8,12,11,3,0,3,0,28,8,9,11
"2011","Chiltern 004A","E01017770","Total",42,14,23,5,7,0,6,1,35,14,17,4
"2011","Chiltern 004B","E01017791","Total",55,19,17,19,7,2,3,2,48,17,14,17
"2011","Chiltern 004C","E01017792","Total",36,14,12,10,3,0,0,3,33,14,12,7
"2011","Chiltern 004D","E01017793","Total",52,13,18,21,4,0,4,0,48,13,14,21
"2011","Chiltern 005A","E01017768","Total",31,10,12,9,5,2,3,0,26,8,9,9
"2011","Chiltern 005B","E01017779","Total",12,6,3,3,1,0,1,0,11,6,2,3
"2011","Chiltern 005C","E01017785","Total",28,10,14,4,7,1,6,0,21,9,8,4
"2011","Chiltern 005D","E01017786","Total",30,12,14,4,5,0,5,0,25,12,9,4
"2011","Chiltern 005E","E01017787","Total",23,9,8,6,1,0,1,0,22,9,7,6
"2011","Chiltern 005F","E01017788","Total",63,18,25,20,5,0,4,1,58,18,21,19
"2011","Chiltern 006A","E01017741","Total",43,17,15,11,5,0,5,0,38,17,10,11
"2011","Chiltern 006B","E01017742","Total",29,6,12,11,7,1,3,3,22,5,9,8
"2011","Chiltern 006C","E01017743","Total",61,21,18,22,4,1,2,1,57,20,16,21
"2011","Chiltern 006D","E01017763","Total",27,6,18,3,2,0,1,1,25,6,17,2
"2011","Chiltern 006E","E01017764","Total",28,10,14,4,7,0,5,2,21,10,9,2
"2011","Chiltern 006F","E01017765","Total",6,4,1,1,0,0,0,0,6,4,1,1
"2011","Chiltern 007A","E01017739","Total",16,3,7,6,1,0,1,0,15,3,6,6
"2011","Chiltern 007B","E01017740","Total",23,7,12,4,2,0,2,0,21,7,10,4
"2011","Chiltern 007C","E01017744","Total",23,11,9,3,3,0,3,0,20,11,6,3
"2011","Chiltern 007D","E01017745","Total",13,8,3,2,1,1,0,0,12,7,3,2
"2011","Chiltern 007E","E01017746","Total",28,14,11,3,5,1,4,0,23,13,7,3
"2011","Chiltern 008A","E01017762","Total",10,2,5,3,4,1,3,0,6,1,2,3
"2011","Chiltern 008B","E01017775","Total",33,15,10,8,9,3,3,3,24,12,7,5
"2011","Chiltern 008C","E01017776","Total",63,21,17,25,9,3,3,3,54,18,14,22
"2011","Chiltern 008D","E01017777","Total",16,2,10,4,2,0,1,1,14,2,9,3
"2011","Chiltern 010A","E01017759","Total",41,11,17,13,6,0,4,2,35,11,13,11
"2011","Chiltern 010B","E01017760","Total",10,4,4,2,1,0,1,0,9,4,3,2
"2011","Chiltern 010C","E01017761","Total",39,16,17,6,6,1,5,0,33,15,12,6
"2011","Chiltern 010D","E01017794","Total",32,8,15,9,5,1,4,0,27,7,11,9
"2011","Chiltern 011A","E01017754","Total",16,7,8,1,8,3,5,0,8,4,3,1
"2011","Chiltern 011B","E01017755","Total",32,12,13,7,5,0,4,1,27,12,9,6
"2011","Chiltern 011C","E01017756","Total",18,8,10,0,2,1,1,0,16,7,9,0
"2011","Chiltern 011D","E01017757","Total",24,9,10,5,3,1,2,0,21,8,8,5
"2011","Chiltern 011E","E01017758","Total",19,7,7,5,1,0,1,0,18,7,6,5
"2011","Chiltern 012A","E01017751","Total",20,9,5,6,2,0,2,0,18,9,3,6
"2011","Chiltern 012B","E01017753","Total",34,13,12,9,5,1,3,1,29,12,9,8
"2011","Chiltern 012C","E01017767","Total",56,25,14,17,5,1,2,2,51,24,12,15
"2011","Chiltern 013A","E01017773","Total",19,7,8,4,2,1,1,0,17,6,7,4
"2011","Chiltern 013B","E01017774","Total",13,3,8,2,3,0,3,0,10,3,5,2
"2011","Chiltern 013C","E01017782","Total",14,3,6,5,3,1,1,1,11,2,5,4
"2011","Chiltern 013D","E01017783","Total",20,7,6,7,1,0,1,0,19,7,5,7
"2011","Chiltern 013E","E01017784","Total",18,8,8,2,7,0,5,2,11,8,3,0
"2011","Chiltern 013F","E01032609","Total",22,8,9,5,0,0,0,0,22,8,9,5
"2011","South Bucks 001A","E01017796","Total",38,16,10,12,5,0,3,2,33,16,7,10
"2011","South Bucks 001B","E01017797","Total",10,5,3,2,5,2,2,1,5,3,1,1
"2011","South Bucks 001C","E01017798","Total",21,4,6,11,2,0,2,0,19,4,4,11
"2011","South Bucks 001D","E01017799","Total",37,10,15,12,7,1,3,3,30,9,12,9
"2011","South Bucks 001E","E01017800","Total",49,11,21,17,8,0,7,1,41,11,14,16
"2011","South Bucks 001F","E01017801","Total",14,6,5,3,2,0,2,0,12,6,3,3
"2011","South Bucks 001G","E01017802","Total",44,18,10,16,5,1,3,1,39,17,7,15
"2011","South Bucks 002A","E01017818","Total",40,16,12,12,2,0,2,0,38,16,10,12
"2011","South Bucks 002B","E01017819","Total",13,3,5,5,1,0,1,0,12,3,4,5
"2011","South Bucks 002C","E01017820","Total",10,2,5,3,1,0,0,1,9,2,5,2
"2011","South Bucks 002D","E01017821","Total",14,4,4,6,2,0,2,0,12,4,2,6
"2011","South Bucks 002E","E01017822","Total",12,3,7,2,3,0,2,1,9,3,5,1
"2011","South Bucks 003A","E01017810","Total",50,19,13,18,9,0,8,1,41,19,5,17
"2011","South Bucks 003B","E01017811","Total",16,2,8,6,7,1,6,0,9,1,2,6
"2011","South Bucks 003C","E01017812","Total",50,18,14,18,4,0,3,1,46,18,11,17
"2011","South Bucks 003D","E01017813","Total",26,12,7,7,6,0,6,0,20,12,1,7
"2011","South Bucks 004A","E01017815","Total",22,5,8,9,6,0,5,1,16,5,3,8
"2011","South Bucks 004B","E01017816","Total",26,14,9,3,3,0,3,0,23,14,6,3
"2011","South Bucks 004C","E01017817","Total",28,8,10,10,4,0,4,0,24,8,6,10
"2011","South Bucks 004D","E01017823","Total",27,8,10,9,3,1,1,1,24,7,9,8
"2011","South Bucks 005A","E01017830","Total",28,8,14,6,5,0,5,0,23,8,9,6
"2011","South Bucks 005B","E01017831","Total",19,5,10,4,2,0,2,0,17,5,8,4
"2011","South Bucks 005C","E01017832","Total",23,7,8,8,3,0,2,1,20,7,6,7
"2011","South Bucks 005D","E01017834","Total",24,7,7,10,3,2,0,1,21,5,7,9
"2011","South Bucks 005E","E01017835","Total",33,9,16,8,4,0,3,1,29,9,13,7
"2011","South Bucks 006A","E01017803","Total",16,3,6,7,2,0,2,0,14,3,4,7
"2011","South Bucks 006B","E01017806","Total",15,5,7,3,2,1,1,0,13,4,6,3
"2011","South Bucks 006C","E01017814","Total",17,4,7,6,1,0,1,0,16,4,6,6
"2011","South Bucks 006D","E01017833","Total",15,3,8,4,0,0,0,0,15,3,8,4
"2011","South Bucks 007A","E01017804","Total",29,12,11,6,4,0,4,0,25,12,7,6
"2011","South Bucks 007B","E01017805","Total",93,30,29,34,12,1,7,4,81,29,22,30
"2011","South Bucks 007C","E01017807","Total",31,8,13,10,4,1,2,1,27,7,11,9
"2011","South Bucks 007D","E01017808","Total",40,11,12,17,3,0,3,0,37,11,9,17
"2011","South Bucks 007E","E01017809","Total",49,20,12,17,4,1,3,0,45,19,9,17
"2011","South Bucks 008A","E01017824","Total",33,12,13,8,3,0,3,0,30,12,10,8
"2011","South Bucks 008B","E01017825","Total",38,8,20,10,6,1,4,1,32,7,16,9
"2011","South Bucks 008C","E01017826","Total",44,11,18,15,6,0,6,0,38,11,12,15
"2011","South Bucks 008D","E01017827","Total",26,8,7,11,3,0,3,0,23,8,4,11
"2011","South Bucks 008E","E01017828","Total",45,10,19,16,6,1,5,0,39,9,14,16
"2011","South Bucks 008F","E01017829","Total",30,8,13,9,3,1,1,1,27,7,12,8
"2011","Wycombe 001A","E01017929","Total",42,12,9,21,7,0,2,5,35,12,7,16
"2011","Wycombe 001B","E01017930","Total",22,7,8,7,2,1,1,0,20,6,7,7
"2011","Wycombe 001C","E01017931","Total",31,16,10,5,1,1,0,0,30,15,10,5
"2011","Wycombe 001D","E01017932","Total",13,5,7,1,1,1,0,0,12,4,7,1
"2011","Wycombe 001E","E01017933","Total",27,4,9,14,0,0,0,0,27,4,9,14
"2011","Wycombe 002A","E01017885","Total",27,10,9,8,2,0,2,0,25,10,7,8
"2011","Wycombe 002B","E01017886","Total",16,5,6,5,5,0,3,2,11,5,3,3
"2011","Wycombe 002C","E01017887","Total",11,4,4,3,3,1,2,0,8,3,2,3
"2011","Wycombe 002D","E01017888","Total",28,12,11,5,6,1,5,0,22,11,6,5
"2011","Wycombe 003A","E01017869","Total",16,2,9,5,8,0,6,2,8,2,3,3
"2011","Wycombe 003B","E01017870","Total",13,4,8,1,4,0,4,0,9,4,4,1
"2011","Wycombe 003C","E01017871","Total",15,1,10,4,3,0,2,1,12,1,8,3
"2011","Wycombe 003D","E01017872","Total",14,2,10,2,2,0,1,1,12,2,9,1
"2011","Wycombe 003E","E01017873","Total",17,9,4,4,2,1,1,0,15,8,3,4
"2011","Wycombe 003F","E01017874","Total",28,5,16,7,3,0,2,1,25,5,14,6
"2011","Wycombe 004A","E01017915","Total",34,12,17,5,10,0,10,0,24,12,7,5
"2011","Wycombe 004B","E01017916","Total",7,3,4,0,1,1,0,0,6,2,4,0
"2011","Wycombe 004C","E01017917","Total",42,15,16,11,5,0,4,1,37,15,12,10
"2011","Wycombe 004D","E01017918","Total",46,15,15,16,3,0,2,1,43,15,13,15
"2011","Wycombe 006A","E01017857","Total",54,16,14,24,7,1,5,1,47,15,9,23
"2011","Wycombe 006B","E01017858","Total",59,13,18,28,3,1,2,0,56,12,16,28
"2011","Wycombe 006C","E01017859","Total",23,7,9,7,4,0,2,2,19,7,7,5
"2011","Wycombe 006D","E01017860","Total",38,13,11,14,1,0,1,0,37,13,10,14
"2011","Wycombe 006E","E01017861","Total",28,10,12,6,2,1,1,0,26,9,11,6
"2011","Wycombe 006F","E01017862","Total",37,12,10,15,3,2,1,0,34,10,9,15
"2011","Wycombe 006G","E01017863","Total",19,7,9,3,2,0,2,0,17,7,7,3
"2011","Wycombe 007A","E01017842","Total",32,14,10,8,3,0,2,1,29,14,8,7
"2011","Wycombe 007B","E01017853","Total",28,12,10,6,4,0,4,0,24,12,6,6
"2011","Wycombe 007C","E01017854","Total",22,9,8,5,2,0,2,0,20,9,6,5
"2011","Wycombe 007D","E01017878","Total",26,10,7,9,7,4,3,0,19,6,4,9
"2011","Wycombe 008A","E01017920","Total",30,12,11,7,4,2,2,0,26,10,9,7
"2011","Wycombe 008B","E01017921","Total",42,10,16,16,9,3,4,2,33,7,12,14
"2011","Wycombe 008C","E01017922","Total",40,20,9,11,2,1,1,0,38,19,8,11
"2011","Wycombe 008D","E01017923","Total",42,11,17,14,4,0,3,1,38,11,14,13
"2011","Wycombe 008E","E01017924","Total",18,8,5,5,12,6,2,4,6,2,3,1
"2011","Wycombe 009A","E01017937","Total",16,6,5,5,3,1,2,0,13,5,3,5
"2011","Wycombe 009B","E01017938","Total",14,5,7,2,2,1,1,0,12,4,6,2
"2011","Wycombe 009C","E01017940","Total",29,12,10,7,2,0,2,0,27,12,8,7
"2011","Wycombe 009D","E01017942","Total",25,8,10,7,3,0,2,1,22,8,8,6
"2011","Wycombe 010A","E01017850","Total",65,21,14,30,3,0,3,0,62,21,11,30
"2011","Wycombe 010B","E01017851","Total",46,16,18,12,9,1,5,3,37,15,13,9
"2011","Wycombe 010C","E01017852","Total",39,12,13,14,7,0,6,1,32,12,7,13
"2011","Wycombe 010D","E01017919","Total",37,11,8,18,2,0,0,2,35,11,8,16
"2011","Wycombe 011A","E01017925","Total",68,15,27,26,5,0,5,0,63,15,22,26
"2011","Wycombe 011B","E01017926","Total",101,26,22,53,11,3,3,5,90,23,19,48
"2011","Wycombe 011C","E01017927","Total",21,8,8,5,3,0,3,0,18,8,5,5
"2011","Wycombe 011D","E01017928","Total",23,8,5,10,1,0,0,1,22,8,5,9
"2011","Wycombe 012A","E01017911","Total",67,25,19,23,2,1,1,0,65,24,18,23
"2011","Wycombe 012B","E01017912","Total",17,6,7,4,1,0,1,0,16,6,6,4
"2011","Wycombe 012C","E01017913","Total",49,13,20,16,7,1,6,0,42,12,14,16
"2011","Wycombe 012D","E01017914","Total",23,8,8,7,0,0,0,0,23,8,8,7
"2011","Wycombe 013A","E01017903","Total",38,12,8,18,4,1,0,3,34,11,8,15
"2011","Wycombe 013B","E01017904","Total",49,11,11,27,5,2,1,2,44,9,10,25
"2011","Wycombe 013C","E01017905","Total",62,27,10,25,9,1,3,5,53,26,7,20
"2011","Wycombe 013D","E01017906","Total",55,12,8,35,6,3,3,0,49,9,5,35
"2011","Wycombe 013E","E01017907","Total",53,18,9,26,6,1,3,2,47,17,6,24
"2011","Wycombe 014A","E01017899","Total",55,14,11,30,4,1,0,3,51,13,11,27
"2011","Wycombe 014B","E01017900","Total",74,26,15,33,7,0,5,2,67,26,10,31
"2011","Wycombe 014C","E01017901","Total",63,22,17,24,4,0,1,3,59,22,16,21
"2011","Wycombe 014D","E01017902","Total",103,32,21,50,12,2,5,5,91,30,16,45
"2011","Wycombe 015A","E01017836","Total",17,4,7,6,0,0,0,0,17,4,7,6
"2011","Wycombe 015B","E01017837","Total",72,20,21,31,3,1,2,0,69,19,19,31
"2011","Wycombe 015C","E01017838","Total",28,6,15,7,4,0,4,0,24,6,11,7
"2011","Wycombe 015D","E01017839","Total",10,4,5,1,1,1,0,0,9,3,5,1
"2011","Wycombe 015E","E01017840","Total",28,6,11,11,2,0,1,1,26,6,10,10
"2011","Wycombe 015F","E01017841","Total",14,2,7,5,2,0,2,0,12,2,5,5
"2011","Wycombe 016A","E01017908","Total",107,36,26,45,3,0,3,0,104,36,23,45
"2011","Wycombe 016B","E01017909","Total",106,39,27,40,10,2,4,4,96,37,23,36
"2011","Wycombe 016C","E01017910","Total",40,8,15,17,4,0,4,0,36,8,11,17
"2011","Wycombe 016D","E01017941","Total",41,22,9,10,4,0,3,1,37,22,6,9
"2011","Wycombe 017A","E01017843","Total",19,8,8,3,0,0,0,0,19,8,8,3
"2011","Wycombe 017B","E01017844","Total",33,8,8,17,2,0,2,0,31,8,6,17
"2011","Wycombe 017C","E01017845","Total",37,9,13,15,3,1,2,0,34,8,11,15
"2011","Wycombe 017D","E01017855","Total",36,9,20,7,4,0,3,1,32,9,17,6
"2011","Wycombe 017E","E01017856","Total",45,19,5,21,4,1,3,0,41,18,2,21
"2011","Wycombe 018A","E01017864","Total",13,7,6,0,2,0,2,0,11,7,4,0
"2011","Wycombe 018B","E01017865","Total",13,7,5,1,0,0,0,0,13,7,5,1
"2011","Wycombe 018C","E01017867","Total",54,18,11,25,2,0,2,0,52,18,9,25
"2011","Wycombe 018D","E01017868","Total",25,6,11,8,7,0,5,2,18,6,6,6
"2011","Wycombe 019A","E01017934","Total",70,31,14,25,3,1,1,1,67,30,13,24
"2011","Wycombe 019B","E01017935","Total",54,25,15,14,7,2,5,0,47,23,10,14
"2011","Wycombe 019C","E01017936","Total",30,8,13,9,4,0,3,1,26,8,10,8
"2011","Wycombe 019D","E01017939","Total",40,15,19,6,5,1,4,0,35,14,15,6
"2011","Wycombe 020A","E01017866","Total",6,3,1,2,0,0,0,0,6,3,1,2
"2011","Wycombe 020B","E01017875","Total",15,7,4,4,3,1,2,0,12,6,2,4
"2011","Wycombe 020C","E01017876","Total",20,7,11,2,0,0,0,0,20,7,11,2
"2011","Wycombe 020D","E01017877","Total",32,16,10,6,5,2,2,1,27,14,8,5
"2011","Wycombe 021A","E01017846","Total",45,18,8,19,1,0,1,0,44,18,7,19
"2011","Wycombe 021B","E01017847","Total",31,11,17,3,4,0,4,0,27,11,13,3
"2011","Wycombe 021C","E01017848","Total",13,3,5,5,4,0,3,1,9,3,2,4
"2011","Wycombe 021D","E01017849","Total",24,11,5,8,2,0,2,0,22,11,3,8
"2011","Wycombe 022A","E01017889","Total",28,9,12,7,2,0,2,0,26,9,10,7
"2011","Wycombe 022B","E01017890","Total",14,5,8,1,2,0,2,0,12,5,6,1
"2011","Wycombe 022C","E01017891","Total",26,9,12,5,4,0,4,0,22,9,8,5
"2011","Wycombe 022D","E01017892","Total",16,3,7,6,4,2,2,0,12,1,5,6
"2011","Wycombe 022E","E01017893","Total",51,22,19,10,8,0,6,2,43,22,13,8
"2011","Wycombe 022F","E01017894","Total",31,18,10,3,3,1,2,0,28,17,8,3
"2011","Wycombe 023A","E01017895","Total",25,8,7,10,2,0,1,1,23,8,6,9
"2011","Wycombe 023B","E01017896","Total",24,6,15,3,2,0,2,0,22,6,13,3
"2011","Wycombe 023C","E01017897","Total",29,12,10,7,4,1,3,0,25,11,7,7
"2011","Wycombe 023D","E01017898","Total",50,26,12,12,2,0,2,0,48,26,10,12
"2011","Wycombe 024A","E01017880","Total",15,8,4,3,0,0,0,0,15,8,4,3
"2011","Wycombe 024B","E01017881","Total",23,10,4,9,4,2,2,0,19,8,2,9
"2011","Wycombe 024C","E01017882","Total",28,13,9,6,5,1,4,0,23,12,5,6
"2011","Wycombe 024D","E01017883","Total",34,16,13,5,4,1,3,0,30,15,10,5
"2011","Wycombe 024E","E01017884","Total",29,13,12,4,2,0,2,0,27,13,10,4
"2011","Wycombe 024F","E01032610","Total",31,17,13,1,3,0,3,0,28,17,10,1
"2011","Eastbourne 001A","E01020924","Total",50,21,13,16,7,1,4,2,43,20,9,14
"2011","Eastbourne 001B","E01020925","Total",93,34,19,40,5,2,2,1,88,32,17,39
"2011","Eastbourne 001C","E01020927","Total",67,24,13,30,4,3,1,0,63,21,12,30
"2011","Eastbourne 001D","E01020928","Total",46,20,10,16,4,2,1,1,42,18,9,15
"2011","Eastbourne 001E","E01020930","Total",95,33,18,44,8,0,4,4,87,33,14,40
"2011","Eastbourne 002A","E01020917","Total",93,40,15,38,10,0,6,4,83,40,9,34
"2011","Eastbourne 002B","E01020918","Total",89,36,16,37,11,2,4,5,78,34,12,32
"2011","Eastbourne 002C","E01020919","Total",68,29,12,27,8,0,6,2,60,29,6,25
"2011","Eastbourne 002D","E01020923","Total",71,29,14,28,6,2,2,2,65,27,12,26
"2011","Eastbourne 002E","E01020949","Total",49,20,12,17,9,2,6,1,40,18,6,16
"2011","Eastbourne 003A","E01020926","Total",52,19,15,18,6,2,1,3,46,17,14,15
"2011","Eastbourne 003B","E01020929","Total",73,17,17,39,8,0,5,3,65,17,12,36
"2011","Eastbourne 003C","E01020955","Total",73,30,9,34,7,0,1,6,66,30,8,28
"2011","Eastbourne 003D","E01020956","Total",21,11,4,6,1,1,0,0,20,10,4,6
"2011","Eastbourne 003E","E01020957","Total",62,30,10,22,3,1,1,1,59,29,9,21
"2011","Eastbourne 004A","E01020920","Total",65,31,13,21,9,2,6,1,56,29,7,20
"2011","Eastbourne 004B","E01020921","Total",55,22,13,20,8,2,5,1,47,20,8,19
"2011","Eastbourne 004C","E01020922","Total",75,22,21,32,10,1,7,2,65,21,14,30
"2011","Eastbourne 004D","E01020945","Total",28,8,11,9,3,0,2,1,25,8,9,8
"2011","Eastbourne 004E","E01020950","Total",35,12,11,12,2,1,1,0,33,11,10,12
"2011","Eastbourne 006A","E01020940","Total",16,4,8,4,0,0,0,0,16,4,8,4
"2011","Eastbourne 006B","E01020941","Total",86,38,21,27,6,0,4,2,80,38,17,25
"2011","Eastbourne 006C","E01020942","Total",46,20,20,6,6,0,5,1,40,20,15,5
"2011","Eastbourne 006D","E01020946","Total",27,11,9,7,4,0,3,1,23,11,6,6
"2011","Eastbourne 006E","E01020947","Total",42,10,17,15,7,0,4,3,35,10,13,12
"2011","Eastbourne 007A","E01020914","Total",84,39,24,21,7,2,2,3,77,37,22,18
"2011","Eastbourne 007B","E01020915","Total",67,29,16,22,4,2,1,1,63,27,15,21
"2011","Eastbourne 007C","E01020952","Total",65,29,15,21,4,1,3,0,61,28,12,21
"2011","Eastbourne 007D","E01020953","Total",31,18,9,4,2,0,2,0,29,18,7,4
"2011","Eastbourne 007E","E01020954","Total",38,21,8,9,4,1,3,0,34,20,5,9
"2011","Eastbourne 008A","E01020948","Total",11,6,3,2,2,0,2,0,9,6,1,2
"2011","Eastbourne 008B","E01020963","Total",35,11,14,10,4,0,4,0,31,11,10,10
"2011","Eastbourne 008C","E01020965","Total",32,11,9,12,1,0,0,1,31,11,9,11
"2011","Eastbourne 008D","E01020966","Total",18,4,11,3,5,0,5,0,13,4,6,3
"2011","Eastbourne 009A","E01020938","Total",39,15,14,10,3,1,1,1,36,14,13,9
"2011","Eastbourne 009B","E01020939","Total",56,22,21,13,6,1,5,0,50,21,16,13
"2011","Eastbourne 009C","E01020943","Total",75,35,23,17,11,2,5,4,64,33,18,13
"2011","Eastbourne 009D","E01020964","Total",51,21,19,11,4,0,3,1,47,21,16,10
"2011","Eastbourne 009E","E01020967","Total",26,5,11,10,5,0,4,1,21,5,7,9
"2011","Eastbourne 010A","E01020910","Total",65,25,19,21,6,2,3,1,59,23,16,20
"2011","Eastbourne 010B","E01020911","Total",61,26,9,26,5,3,0,2,56,23,9,24
"2011","Eastbourne 010C","E01020912","Total",56,23,7,26,1,1,0,0,55,22,7,26
"2011","Eastbourne 010D","E01020916","Total",78,33,18,27,5,1,2,2,73,32,16,25
"2011","Eastbourne 011A","E01020935","Total",47,21,11,15,5,1,3,1,42,20,8,14
"2011","Eastbourne 011B","E01020936","Total",23,12,8,3,1,0,1,0,22,12,7,3
"2011","Eastbourne 011C","E01020937","Total",26,7,9,10,8,2,2,4,18,5,7,6
"2011","Eastbourne 011D","E01020968","Total",33,11,7,15,4,2,2,0,29,9,5,15
"2011","Eastbourne 012A","E01020931","Total",19,5,6,8,3,1,2,0,16,4,4,8
"2011","Eastbourne 012B","E01020932","Total",17,9,6,2,1,0,1,0,16,9,5,2
"2011","Eastbourne 012C","E01020933","Total",13,6,4,3,3,0,3,0,10,6,1,3
"2011","Eastbourne 012D","E01020934","Total",16,5,7,4,0,0,0,0,16,5,7,4
"2011","Eastbourne 012E","E01020944","Total",34,17,13,4,4,0,4,0,30,17,9,4
"2011","Eastbourne 013A","E01020913","Total",102,35,16,51,5,2,2,1,97,33,14,50
"2011","Eastbourne 013B","E01020951","Total",35,18,8,9,3,1,1,1,32,17,7,8
"2011","Eastbourne 013C","E01020959","Total",32,13,10,9,8,4,4,0,24,9,6,9
"2011","Eastbourne 013D","E01020961","Total",14,5,4,5,1,0,0,1,13,5,4,4
"2011","Eastbourne 013E","E01020962","Total",50,16,20,14,7,1,5,1,43,15,15,13
"2011","Eastbourne 014A","E01020960","Total",84,24,26,34,5,2,3,0,79,22,23,34
"2011","Eastbourne 014B","E01032831","Total",32,16,8,8,4,0,4,0,28,16,4,8
"2011","Eastbourne 014C","E01032832","Total",86,29,9,48,4,0,2,2,82,29,7,46
"2011","Eastbourne 014D","E01032833","Total",48,15,15,18,8,0,5,3,40,15,10,15
"2011","Hastings 001A","E01020969","Total",27,9,9,9,5,1,3,1,22,8,6,8
"2011","Hastings 001B","E01020970","Total",40,18,12,10,5,0,3,2,35,18,9,8
"2011","Hastings 001C","E01020971","Total",76,21,23,32,8,0,3,5,68,21,20,27
"2011","Hastings 001D","E01020987","Total",72,35,23,14,8,0,5,3,64,35,18,11
"2011","Hastings 002A","E01020974","Total",32,15,9,8,3,0,3,0,29,15,6,8
"2011","Hastings 002B","E01020986","Total",38,13,15,10,4,0,3,1,34,13,12,9
"2011","Hastings 002C","E01020988","Total",17,9,5,3,1,0,1,0,16,9,4,3
"2011","Hastings 002D","E01021007","Total",12,5,5,2,5,0,4,1,7,5,1,1
"2011","Hastings 002E","E01021008","Total",31,15,11,5,7,1,5,1,24,14,6,4
"2011","Hastings 002F","E01021009","Total",34,13,13,8,5,2,3,0,29,11,10,8
"2011","Hastings 003A","E01020993","Total",86,30,7,49,6,2,1,3,80,28,6,46
"2011","Hastings 003B","E01020994","Total",80,31,13,36,10,2,5,3,70,29,8,33
"2011","Hastings 003C","E01020995","Total",62,14,11,37,6,0,0,6,56,14,11,31
"2011","Hastings 003D","E01020996","Total",90,28,13,49,4,1,1,2,86,27,12,47
"2011","Hastings 003E","E01021019","Total",56,16,16,24,8,1,5,2,48,15,11,22
"2011","Hastings 004A","E01021004","Total",57,25,8,24,5,0,3,2,52,25,5,22
"2011","Hastings 004B","E01021005","Total",100,24,9,67,7,0,3,4,93,24,6,63
"2011","Hastings 004C","E01021006","Total",87,32,18,37,13,0,4,9,74,32,14,28
"2011","Hastings 004D","E01021013","Total",87,39,20,28,8,0,6,2,79,39,14,26
"2011","Hastings 005A","E01020972","Total",118,32,14,72,10,2,4,4,108,30,10,68
"2011","Hastings 005B","E01020973","Total",68,29,12,27,3,0,1,2,65,29,11,25
"2011","Hastings 005C","E01020977","Total",89,35,10,44,13,2,4,7,76,33,6,37
"2011","Hastings 005D","E01021015","Total",142,37,11,94,17,1,3,13,125,36,8,81
"2011","Hastings 006A","E01021010","Total",37,14,12,11,5,3,2,0,32,11,10,11
"2011","Hastings 006B","E01021011","Total",71,28,14,29,0,0,0,0,71,28,14,29
"2011","Hastings 006C","E01021012","Total",40,17,10,13,2,0,2,0,38,17,8,13
"2011","Hastings 006D","E01021020","Total",85,27,13,45,5,0,1,4,80,27,12,41
"2011","Hastings 006E","E01021021","Total",85,38,19,28,10,2,7,1,75,36,12,27
"2011","Hastings 007A","E01021000","Total",52,25,9,18,3,0,0,3,49,25,9,15
"2011","Hastings 007B","E01021001","Total",50,19,16,15,5,0,2,3,45,19,14,12
"2011","Hastings 007C","E01021002","Total",56,25,10,21,4,0,2,2,52,25,8,19
"2011","Hastings 007D","E01021003","Total",55,21,15,19,11,2,4,5,44,19,11,14
"2011","Hastings 007E","E01021014","Total",127,47,16,64,8,3,1,4,119,44,15,60
"2011","Hastings 008A","E01020975","Total",48,13,12,23,1,0,1,0,47,13,11,23
"2011","Hastings 008B","E01020976","Total",40,17,13,10,3,0,3,0,37,17,10,10
"2011","Hastings 008C","E01020990","Total",87,39,19,29,6,1,3,2,81,38,16,27
"2011","Hastings 008D","E01020991","Total",45,12,11,22,7,2,4,1,38,10,7,21
"2011","Hastings 008E","E01020992","Total",97,28,22,47,10,1,4,5,87,27,18,42
"2011","Hastings 009A","E01020978","Total",101,27,33,41,7,0,5,2,94,27,28,39
"2011","Hastings 009B","E01020979","Total",70,23,9,38,7,2,2,3,63,21,7,35
"2011","Hastings 009C","E01020980","Total",63,24,8,31,7,1,2,4,56,23,6,27
"2011","Hastings 009D","E01020981","Total",56,16,14,26,5,1,3,1,51,15,11,25
"2011","Hastings 010A","E01020997","Total",61,22,12,27,6,1,1,4,55,21,11,23
"2011","Hastings 010B","E01020998","Total",54,13,15,26,12,1,6,5,42,12,9,21
"2011","Hastings 010C","E01020999","Total",30,17,6,7,1,1,0,0,29,16,6,7
"2011","Hastings 010D","E01021016","Total",64,13,20,31,12,1,8,3,52,12,12,28
"2011","Hastings 010E","E01021017","Total",59,17,24,18,7,0,7,0,52,17,17,18
"2011","Hastings 010F","E01021018","Total",49,21,14,14,4,0,3,1,45,21,11,13
"2011","Hastings 011A","E01020982","Total",81,30,13,38,14,4,4,6,67,26,9,32
"2011","Hastings 011B","E01020983","Total",57,11,14,32,10,1,6,3,47,10,8,29
"2011","Hastings 011C","E01020984","Total",74,26,17,31,7,1,2,4,67,25,15,27
"2011","Hastings 011D","E01020985","Total",64,15,12,37,12,2,3,7,52,13,9,30
"2011","Hastings 011E","E01020989","Total",71,24,10,37,8,0,1,7,63,24,9,30
"2011","Lewes 001A","E01021022","Total",44,17,12,15,5,0,4,1,39,17,8,14
"2011","Lewes 001B","E01021024","Total",48,14,15,19,7,1,4,2,41,13,11,17
"2011","Lewes 001C","E01021025","Total",26,11,8,7,3,0,2,1,23,11,6,6
"2011","Lewes 001D","E01021052","Total",17,11,3,3,1,0,0,1,16,11,3,2
"2011","Lewes 001E","E01021053","Total",18,9,5,4,3,0,3,0,15,9,2,4
"2011","Lewes 002A","E01021023","Total",31,12,6,13,3,0,2,1,28,12,4,12
"2011","Lewes 002B","E01021026","Total",27,9,12,6,6,1,5,0,21,8,7,6
"2011","Lewes 002C","E01021032","Total",35,18,8,9,4,1,2,1,31,17,6,8
"2011","Lewes 002D","E01021067","Total",14,5,8,1,0,0,0,0,14,5,8,1
"2011","Lewes 002E","E01021068","Total",20,6,8,6,3,0,3,0,17,6,5,6
"2011","Lewes 003A","E01021033","Total",55,26,13,16,6,1,4,1,49,25,9,15
"2011","Lewes 003B","E01021034","Total",48,18,11,19,4,0,3,1,44,18,8,18
"2011","Lewes 003C","E01021035","Total",50,21,14,15,9,2,5,2,41,19,9,13
"2011","Lewes 003D","E01021036","Total",31,10,7,14,4,0,3,1,27,10,4,13
"2011","Lewes 003E","E01021037","Total",72,27,13,32,9,2,1,6,63,25,12,26
"2011","Lewes 003F","E01021038","Total",59,26,21,12,10,2,7,1,49,24,14,11
"2011","Lewes 004A","E01021054","Total",19,11,5,3,1,0,0,1,18,11,5,2
"2011","Lewes 004B","E01021055","Total",27,8,7,12,0,0,0,0,27,8,7,12
"2011","Lewes 004C","E01021056","Total",26,12,9,5,3,0,3,0,23,12,6,5
"2011","Lewes 004D","E01021057","Total",59,28,12,19,6,1,3,2,53,27,9,17
"2011","Lewes 005A","E01021039","Total",42,22,7,13,5,1,3,1,37,21,4,12
"2011","Lewes 005B","E01021040","Total",38,14,12,12,4,1,3,0,34,13,9,12
"2011","Lewes 005C","E01021041","Total",34,15,9,10,3,1,1,1,31,14,8,9
"2011","Lewes 005D","E01021042","Total",31,10,11,10,3,0,3,0,28,10,8,10
"2011","Lewes 005E","E01021043","Total",82,36,18,28,8,2,5,1,74,34,13,27
"2011","Lewes 006A","E01021027","Total",31,9,12,10,1,0,0,1,30,9,12,9
"2011","Lewes 006B","E01021028","Total",55,21,22,12,4,1,0,3,51,20,22,9
"2011","Lewes 006C","E01021029","Total",38,16,11,11,2,1,1,0,36,15,10,11
"2011","Lewes 006D","E01021030","Total",27,8,9,10,1,1,0,0,26,7,9,10
"2011","Lewes 006E","E01021031","Total",23,12,3,8,6,2,3,1,17,10,0,7
"2011","Lewes 007A","E01021061","Total",51,14,12,25,6,0,5,1,45,14,7,24
"2011","Lewes 007B","E01021063","Total",50,25,12,13,6,0,3,3,44,25,9,10
"2011","Lewes 007C","E01021064","Total",36,17,11,8,7,1,5,1,29,16,6,7
"2011","Lewes 007D","E01021065","Total",39,15,9,15,9,2,5,2,30,13,4,13
"2011","Lewes 007E","E01021066","Total",48,14,12,22,6,0,6,0,42,14,6,22
"2011","Lewes 008A","E01021045","Total",43,9,14,20,10,2,5,3,33,7,9,17
"2011","Lewes 008B","E01021046","Total",38,15,10,13,3,2,1,0,35,13,9,13
"2011","Lewes 008C","E01021047","Total",49,23,14,12,5,2,1,2,44,21,13,10
"2011","Lewes 008D","E01021048","Total",63,14,21,28,12,1,10,1,51,13,11,27
"2011","Lewes 009A","E01021044","Total",97,32,26,39,10,2,8,0,87,30,18,39
"2011","Lewes 009B","E01021049","Total",62,23,11,28,4,0,3,1,58,23,8,27
"2011","Lewes 009C","E01021050","Total",54,24,15,15,7,1,5,1,47,23,10,14
"2011","Lewes 009D","E01021051","Total",45,10,16,19,9,0,6,3,36,10,10,16
"2011","Lewes 010A","E01021058","Total",60,24,13,23,5,0,4,1,55,24,9,22
"2011","Lewes 010B","E01021059","Total",37,8,9,20,4,0,2,2,33,8,7,18
"2011","Lewes 010C","E01021060","Total",44,23,10,11,4,1,2,1,40,22,8,10
"2011","Lewes 010D","E01021062","Total",60,21,13,26,5,1,2,2,55,20,11,24
"2011","Lewes 011A","E01021069","Total",29,8,12,9,2,0,2,0,27,8,10,9
"2011","Lewes 011B","E01021075","Total",44,8,15,21,7,2,4,1,37,6,11,20
"2011","Lewes 011C","E01021077","Total",21,10,5,6,5,1,2,2,16,9,3,4
"2011","Lewes 011D","E01021081","Total",19,6,9,4,5,0,4,1,14,6,5,3
"2011","Lewes 011E","E01021082","Total",5,2,2,1,0,0,0,0,5,2,2,1
"2011","Lewes 011F","E01021083","Total",19,6,8,5,3,0,3,0,16,6,5,5
"2011","Lewes 012A","E01021072","Total",17,4,12,1,2,0,2,0,15,4,10,1
"2011","Lewes 012B","E01021073","Total",25,11,6,8,5,0,2,3,20,11,4,5
"2011","Lewes 012C","E01021074","Total",42,12,7,23,5,1,3,1,37,11,4,22
"2011","Lewes 012D","E01021076","Total",75,33,13,29,10,5,2,3,65,28,11,26
"2011","Lewes 012E","E01021078","Total",20,10,4,6,2,0,2,0,18,10,2,6
"2011","Lewes 013A","E01021070","Total",44,18,18,8,6,1,4,1,38,17,14,7
"2011","Lewes 013B","E01021071","Total",70,22,21,27,9,0,7,2,61,22,14,25
"2011","Lewes 013C","E01021079","Total",41,13,12,16,6,1,3,2,35,12,9,14
"2011","Lewes 013D","E01021080","Total",33,13,11,9,5,1,4,0,28,12,7,9
"2011","Rother 001A","E01021132","Total",17,6,6,5,4,1,3,0,13,5,3,5
"2011","Rother 001B","E01021133","Total",48,18,15,15,11,1,8,2,37,17,7,13
"2011","Rother 001C","E01021134","Total",35,7,15,13,5,0,5,0,30,7,10,13
"2011","Rother 001D","E01021139","Total",43,20,9,14,6,1,4,1,37,19,5,13
"2011","Rother 001E","E01021140","Total",26,12,9,5,4,2,2,0,22,10,7,5
"2011","Rother 001F","E01021141","Total",18,7,4,7,2,2,0,0,16,5,4,7
"2011","Rother 002A","E01021103","Total",30,15,1,14,4,0,1,3,26,15,0,11
"2011","Rother 002B","E01021114","Total",32,17,6,9,3,0,2,1,29,17,4,8
"2011","Rother 002C","E01021115","Total",20,8,7,5,4,1,1,2,16,7,6,3
"2011","Rother 002D","E01021116","Total",31,16,5,10,4,0,3,1,27,16,2,9
"2011","Rother 003A","E01021098","Total",39,13,15,11,6,1,5,0,33,12,10,11
"2011","Rother 003B","E01021099","Total",10,5,2,3,1,0,1,0,9,5,1,3
"2011","Rother 003C","E01021100","Total",33,19,5,9,2,0,2,0,31,19,3,9
"2011","Rother 003D","E01021104","Total",28,12,8,8,2,1,0,1,26,11,8,7
"2011","Rother 003E","E01021105","Total",27,10,9,8,5,0,3,2,22,10,6,6
"2011","Rother 004A","E01021101","Total",46,16,12,18,4,2,0,2,42,14,12,16
"2011","Rother 004B","E01021102","Total",43,17,9,17,8,1,5,2,35,16,4,15
"2011","Rother 004C","E01021117","Total",28,11,5,12,1,0,1,0,27,11,4,12
"2011","Rother 004D","E01021118","Total",27,12,10,5,4,0,4,0,23,12,6,5
"2011","Rother 004E","E01021119","Total",44,13,7,24,6,1,2,3,38,12,5,21
"2011","Rother 005A","E01021087","Total",24,9,9,6,1,0,1,0,23,9,8,6
"2011","Rother 005B","E01021088","Total",14,8,2,4,2,1,1,0,12,7,1,4
"2011","Rother 005C","E01021089","Total",42,15,13,14,4,0,3,1,38,15,10,13
"2011","Rother 005D","E01021109","Total",23,7,4,12,2,0,0,2,21,7,4,10
"2011","Rother 005E","E01021110","Total",24,7,8,9,3,0,1,2,21,7,7,7
"2011","Rother 006A","E01021084","Total",83,35,17,31,8,1,5,2,75,34,12,29
"2011","Rother 006B","E01021085","Total",44,21,16,7,5,2,1,2,39,19,15,5
"2011","Rother 006C","E01021086","Total",57,25,18,14,6,1,5,0,51,24,13,14
"2011","Rother 006D","E01021096","Total",25,9,5,11,3,0,3,0,22,9,2,11
"2011","Rother 006E","E01021097","Total",22,6,10,6,3,0,3,0,19,6,7,6
"2011","Rother 007A","E01021111","Total",25,11,4,10,2,0,2,0,23,11,2,10
"2011","Rother 007B","E01021113","Total",53,17,17,19,3,0,3,0,50,17,14,19
"2011","Rother 007C","E01021131","Total",95,36,22,37,8,4,3,1,87,32,19,36
"2011","Rother 007D","E01021135","Total",105,29,17,59,7,2,2,3,98,27,15,56
"2011","Rother 007E","E01021136","Total",77,18,10,49,11,1,4,6,66,17,6,43
"2011","Rother 007F","E01021137","Total",65,21,10,34,7,0,2,5,58,21,8,29
"2011","Rother 008A","E01021112","Total",27,8,7,12,2,0,2,0,25,8,5,12
"2011","Rother 008B","E01021120","Total",17,11,4,2,1,0,1,0,16,11,3,2
"2011","Rother 008C","E01021126","Total",33,13,6,14,8,1,3,4,25,12,3,10
"2011","Rother 008D","E01021127","Total",59,19,15,25,4,1,2,1,55,18,13,24
"2011","Rother 008E","E01021128","Total",39,20,7,12,4,1,2,1,35,19,5,11
"2011","Rother 009A","E01021093","Total",12,3,5,4,1,0,0,1,11,3,5,3
"2011","Rother 009B","E01021095","Total",8,2,2,4,0,0,0,0,8,2,2,4
"2011","Rother 009C","E01021123","Total",16,6,7,3,1,0,1,0,15,6,6,3
"2011","Rother 009D","E01021124","Total",12,7,2,3,1,0,1,0,11,7,1,3
"2011","Rother 009E","E01021125","Total",11,6,4,1,2,0,2,0,9,6,2,1
"2011","Rother 009F","E01021129","Total",28,5,8,15,6,1,2,3,22,4,6,12
"2011","Rother 009G","E01021138","Total",15,4,4,7,1,0,1,0,14,4,3,7
"2011","Rother 010A","E01021094","Total",18,8,8,2,5,0,5,0,13,8,3,2
"2011","Rother 010B","E01021106","Total",14,6,5,3,1,0,1,0,13,6,4,3
"2011","Rother 010C","E01021107","Total",10,3,3,4,2,1,1,0,8,2,2,4
"2011","Rother 010D","E01021108","Total",43,15,13,15,2,1,1,0,41,14,12,15
"2011","Rother 010E","E01021130","Total",33,11,8,14,4,0,3,1,29,11,5,13
"2011","Rother 011A","E01021090","Total",94,42,24,28,12,5,5,2,82,37,19,26
"2011","Rother 011B","E01021091","Total",61,26,13,22,10,1,4,5,51,25,9,17
"2011","Rother 011C","E01021092","Total",56,14,11,31,8,1,1,6,48,13,10,25
"2011","Rother 011D","E01021121","Total",41,18,11,12,4,1,3,0,37,17,8,12
"2011","Rother 011E","E01021122","Total",38,12,8,18,9,0,3,6,29,12,5,12
"2011","Wealden 001A","E01021167","Total",85,28,34,23,7,0,3,4,78,28,31,19
"2011","Wealden 001B","E01021168","Total",40,20,10,10,4,2,1,1,36,18,9,9
"2011","Wealden 001C","E01021169","Total",32,16,11,5,9,1,7,1,23,15,4,4
"2011","Wealden 001D","E01021186","Total",22,6,12,4,3,0,3,0,19,6,9,4
"2011","Wealden 002A","E01021171","Total",44,15,18,11,9,0,9,0,35,15,9,11
"2011","Wealden 002B","E01021172","Total",40,12,17,11,7,1,4,2,33,11,13,9
"2011","Wealden 002C","E01021173","Total",15,11,2,2,0,0,0,0,15,11,2,2
"2011","Wealden 002D","E01021218","Total",11,5,2,4,1,0,0,1,10,5,2,3
"2011","Wealden 003A","E01021156","Total",37,22,9,6,8,2,5,1,29,20,4,5
"2011","Wealden 003B","E01021157","Total",22,9,8,5,2,1,1,0,20,8,7,5
"2011","Wealden 003C","E01021158","Total",47,22,12,13,4,1,2,1,43,21,10,12
"2011","Wealden 004A","E01021159","Total",20,8,8,4,4,0,2,2,16,8,6,2
"2011","Wealden 004B","E01021160","Total",26,8,8,10,5,0,3,2,21,8,5,8
"2011","Wealden 004C","E01021161","Total",43,15,20,8,11,0,10,1,32,15,10,7
"2011","Wealden 004D","E01021162","Total",21,12,8,1,3,0,3,0,18,12,5,1
"2011","Wealden 005A","E01021202","Total",19,6,8,5,5,0,4,1,14,6,4,4
"2011","Wealden 005B","E01021203","Total",17,7,6,4,3,0,2,1,14,7,4,3
"2011","Wealden 005C","E01021229","Total",32,16,7,9,7,2,3,2,25,14,4,7
"2011","Wealden 005D","E01021230","Total",31,10,12,9,4,0,3,1,27,10,9,8
"2011","Wealden 005E","E01021231","Total",47,24,13,10,3,0,2,1,44,24,11,9
"2011","Wealden 006A","E01021151","Total",48,20,12,16,8,1,4,3,40,19,8,13
"2011","Wealden 006B","E01021152","Total",43,15,10,18,5,2,2,1,38,13,8,17
"2011","Wealden 006C","E01021153","Total",52,24,16,12,6,0,5,1,46,24,11,11
"2011","Wealden 006D","E01021154","Total",44,20,13,11,3,0,2,1,41,20,11,10
"2011","Wealden 006E","E01021155","Total",40,19,15,6,6,1,5,0,34,18,10,6
"2011","Wealden 007A","E01021163","Total",12,2,7,3,4,1,3,0,8,1,4,3
"2011","Wealden 007B","E01021164","Total",40,23,9,8,6,1,3,2,34,22,6,6
"2011","Wealden 007C","E01021187","Total",19,4,9,6,5,1,2,2,14,3,7,4
"2011","Wealden 008A","E01021144","Total",16,5,6,5,1,0,1,0,15,5,5,5
"2011","Wealden 008B","E01021145","Total",19,7,6,6,2,0,2,0,17,7,4,6
"2011","Wealden 008C","E01021170","Total",33,13,11,9,4,0,4,0,29,13,7,9
"2011","Wealden 008D","E01021217","Total",10,3,3,4,2,0,1,1,8,3,2,3
"2011","Wealden 009A","E01021219","Total",22,10,8,4,3,0,3,0,19,10,5,4
"2011","Wealden 009B","E01021220","Total",31,7,13,11,3,0,3,0,28,7,10,11
"2011","Wealden 009C","E01021223","Total",27,13,12,2,1,0,1,0,26,13,11,2
"2011","Wealden 009D","E01021224","Total",54,18,8,28,5,1,0,4,49,17,8,24
"2011","Wealden 009E","E01021225","Total",46,20,19,7,7,2,4,1,39,18,15,6
"2011","Wealden 009F","E01021226","Total",50,23,13,14,7,1,5,1,43,22,8,13
"2011","Wealden 010A","E01021150","Total",5,2,3,0,1,0,1,0,4,2,2,0
"2011","Wealden 010B","E01021191","Total",43,18,15,10,6,0,6,0,37,18,9,10
"2011","Wealden 010C","E01021192","Total",38,17,14,7,3,0,2,1,35,17,12,6
"2011","Wealden 010D","E01021193","Total",63,17,15,31,11,0,7,4,52,17,8,27
"2011","Wealden 010E","E01021194","Total",54,19,17,18,8,0,7,1,46,19,10,17
"2011","Wealden 011A","E01021149","Total",18,8,3,7,1,0,0,1,17,8,3,6
"2011","Wealden 011B","E01021189","Total",20,10,7,3,3,0,2,1,17,10,5,2
"2011","Wealden 011C","E01021190","Total",21,10,3,8,2,0,1,1,19,10,2,7
"2011","Wealden 011D","E01021200","Total",38,16,7,15,5,1,4,0,33,15,3,15
"2011","Wealden 011E","E01021201","Total",21,5,11,5,7,0,6,1,14,5,5,4
"2011","Wealden 012A","E01021221","Total",35,14,13,8,5,2,3,0,30,12,10,8
"2011","Wealden 012B","E01021222","Total",30,13,10,7,2,0,1,1,28,13,9,6
"2011","Wealden 012C","E01021227","Total",46,22,12,12,4,1,3,0,42,21,9,12
"2011","Wealden 012D","E01021228","Total",36,16,12,8,4,0,4,0,32,16,8,8
"2011","Wealden 013A","E01021146","Total",43,14,20,9,4,1,3,0,39,13,17,9
"2011","Wealden 013B","E01021147","Total",19,7,9,3,6,1,5,0,13,6,4,3
"2011","Wealden 013C","E01021148","Total",35,16,11,8,4,0,3,1,31,16,8,7
"2011","Wealden 013D","E01021165","Total",13,5,4,4,3,1,1,1,10,4,3,3
"2011","Wealden 014A","E01021188","Total",13,7,2,4,2,1,1,0,11,6,1,4
"2011","Wealden 014B","E01021198","Total",45,24,10,11,3,0,3,0,42,24,7,11
"2011","Wealden 014C","E01021199","Total",16,9,3,4,4,1,2,1,12,8,1,3
"2011","Wealden 014D","E01021204","Total",32,19,5,8,6,2,3,1,26,17,2,7
"2011","Wealden 014E","E01021205","Total",16,8,2,6,4,1,1,2,12,7,1,4
"2011","Wealden 015A","E01021174","Total",39,14,15,10,4,1,2,1,35,13,13,9
"2011","Wealden 015B","E01021175","Total",20,7,7,6,1,0,1,0,19,7,6,6
"2011","Wealden 015C","E01021176","Total",23,11,7,5,5,0,5,0,18,11,2,5
"2011","Wealden 015D","E01021177","Total",25,15,1,9,1,0,1,0,24,15,0,9
"2011","Wealden 016A","E01021180","Total",23,12,2,9,2,0,0,2,21,12,2,7
"2011","Wealden 016B","E01021181","Total",28,8,11,9,5,0,3,2,23,8,8,7
"2011","Wealden 016C","E01021182","Total",23,11,8,4,3,1,1,1,20,10,7,3
"2011","Wealden 016D","E01021183","Total",89,35,12,42,10,4,2,4,79,31,10,38
"2011","Wealden 017A","E01021178","Total",61,20,11,30,3,0,3,0,58,20,8,30
"2011","Wealden 017B","E01021179","Total",61,18,8,35,6,2,3,1,55,16,5,34
"2011","Wealden 017C","E01021184","Total",31,13,14,4,2,1,1,0,29,12,13,4
"2011","Wealden 017D","E01021185","Total",74,27,11,36,4,1,0,3,70,26,11,33
"2011","Wealden 018A","E01021142","Total",4,1,2,1,0,0,0,0,4,1,2,1
"2011","Wealden 018B","E01021143","Total",26,11,5,10,3,0,2,1,23,11,3,9
"2011","Wealden 018C","E01021166","Total",25,5,8,12,6,1,3,2,19,4,5,10
"2011","Wealden 018D","E01021195","Total",39,18,12,9,1,0,1,0,38,18,11,9
"2011","Wealden 018E","E01021196","Total",40,22,6,12,1,1,0,0,39,21,6,12
"2011","Wealden 018F","E01021197","Total",46,19,20,7,7,0,6,1,39,19,14,6
"2011","Wealden 019A","E01021212","Total",43,19,12,12,2,0,2,0,41,19,10,12
"2011","Wealden 019B","E01021213","Total",68,33,13,22,9,5,3,1,59,28,10,21
"2011","Wealden 019C","E01021214","Total",31,17,4,10,4,2,2,0,27,15,2,10
"2011","Wealden 019D","E01021215","Total",27,10,9,8,6,0,5,1,21,10,4,7
"2011","Wealden 019E","E01021216","Total",20,7,5,8,1,0,1,0,19,7,4,8
"2011","Wealden 020A","E01021206","Total",35,17,11,7,8,1,7,0,27,16,4,7
"2011","Wealden 020B","E01021207","Total",28,11,4,13,4,3,0,1,24,8,4,12
"2011","Wealden 020C","E01021208","Total",54,24,20,10,5,1,4,0,49,23,16,10
"2011","Wealden 020D","E01021209","Total",35,16,16,3,7,0,6,1,28,16,10,2
"2011","Wealden 020E","E01021210","Total",37,16,14,7,5,0,4,1,32,16,10,6
"2011","Wealden 020F","E01021211","Total",13,6,3,4,2,0,2,0,11,6,1,4
"2011","Wealden 021A","E01021232","Total",37,18,14,5,4,1,3,0,33,17,11,5
"2011","Wealden 021B","E01021233","Total",29,14,11,4,7,1,6,0,22,13,5,4
"2011","Wealden 021C","E01021234","Total",21,13,7,1,3,1,2,0,18,12,5,1
"2011","Wealden 021D","E01021235","Total",18,4,11,3,4,0,4,0,14,4,7,3
"2011","Wealden 021E","E01021236","Total",23,8,6,9,0,0,0,0,23,8,6,9
"2011","Basingstoke and Deane 001A","E01022553","Total",30,10,7,13,5,2,2,1,25,8,5,12
"2011","Basingstoke and Deane 001B","E01022554","Total",34,13,14,7,7,1,4,2,27,12,10,5
"2011","Basingstoke and Deane 001C","E01022555","Total",43,16,19,8,5,0,4,1,38,16,15,7
"2011","Basingstoke and Deane 001D","E01022556","Total",59,20,15,24,2,0,2,0,57,20,13,24
"2011","Basingstoke and Deane 001E","E01022560","Total",23,9,7,7,3,1,2,0,20,8,5,7
"2011","Basingstoke and Deane 002A","E01022493","Total",14,4,6,4,2,0,2,0,12,4,4,4
"2011","Basingstoke and Deane 002B","E01022536","Total",13,4,4,5,5,0,3,2,8,4,1,3
"2011","Basingstoke and Deane 002C","E01022537","Total",20,5,12,3,3,0,3,0,17,5,9,3
"2011","Basingstoke and Deane 002D","E01022557","Total",37,15,11,11,0,0,0,0,37,15,11,11
"2011","Basingstoke and Deane 002E","E01022558","Total",31,10,12,9,1,0,1,0,30,10,11,9
"2011","Basingstoke and Deane 002F","E01022559","Total",26,7,17,2,6,0,6,0,20,7,11,2
"2011","Basingstoke and Deane 003A","E01022488","Total",32,18,6,8,2,1,1,0,30,17,5,8
"2011","Basingstoke and Deane 003B","E01022489","Total",22,11,8,3,3,2,1,0,19,9,7,3
"2011","Basingstoke and Deane 003C","E01022499","Total",16,7,5,4,3,2,1,0,13,5,4,4
"2011","Basingstoke and Deane 003D","E01022500","Total",19,3,12,4,4,1,3,0,15,2,9,4
"2011","Basingstoke and Deane 003E","E01022513","Total",22,5,5,12,1,0,0,1,21,5,5,11
"2011","Basingstoke and Deane 004A","E01022472","Total",10,4,1,5,1,1,0,0,9,3,1,5
"2011","Basingstoke and Deane 004B","E01022473","Total",32,15,13,4,4,2,2,0,28,13,11,4
"2011","Basingstoke and Deane 004C","E01022520","Total",35,10,9,16,6,0,3,3,29,10,6,13
"2011","Basingstoke and Deane 004D","E01022521","Total",28,9,13,6,6,0,6,0,22,9,7,6
"2011","Basingstoke and Deane 004E","E01022522","Total",28,12,9,7,1,0,1,0,27,12,8,7
"2011","Basingstoke and Deane 005A","E01022490","Total",35,12,11,12,4,1,2,1,31,11,9,11
"2011","Basingstoke and Deane 005B","E01022491","Total",67,23,14,30,4,0,3,1,63,23,11,29
"2011","Basingstoke and Deane 005C","E01022492","Total",15,3,9,3,2,0,2,0,13,3,7,3
"2011","Basingstoke and Deane 005D","E01022546","Total",14,5,8,1,1,0,1,0,13,5,7,1
"2011","Basingstoke and Deane 005E","E01022547","Total",24,17,4,3,4,4,0,0,20,13,4,3
"2011","Basingstoke and Deane 006A","E01022495","Total",36,9,19,8,5,0,5,0,31,9,14,8
"2011","Basingstoke and Deane 006B","E01022496","Total",49,18,22,9,9,2,7,0,40,16,15,9
"2011","Basingstoke and Deane 006C","E01022497","Total",23,10,6,7,1,0,1,0,22,10,5,7
"2011","Basingstoke and Deane 006D","E01022498","Total",29,9,13,7,3,0,2,1,26,9,11,6
"2011","Basingstoke and Deane 007B","E01022539","Total",42,14,13,15,3,0,2,1,39,14,11,14
"2011","Basingstoke and Deane 007C","E01022540","Total",99,42,17,40,7,1,2,4,92,41,15,36
"2011","Basingstoke and Deane 007E","E01022542","Total",45,11,10,24,7,1,4,2,38,10,6,22
"2011","Basingstoke and Deane 007F","E01022543","Total",50,14,26,10,7,0,5,2,43,14,21,8
"2011","Basingstoke and Deane 007H","E01032843","Total",48,13,15,20,4,0,3,1,44,13,12,19
"2011","Basingstoke and Deane 007I","E01032844","Total",45,17,11,17,6,0,5,1,39,17,6,16
"2011","Basingstoke and Deane 007J","E01032851","Total",89,26,24,39,12,4,7,1,77,22,17,38
"2011","Basingstoke and Deane 008A","E01022470","Total",29,8,17,4,4,0,3,1,25,8,14,3
"2011","Basingstoke and Deane 008B","E01022471","Total",28,8,14,6,2,0,2,0,26,8,12,6
"2011","Basingstoke and Deane 008C","E01022494","Total",57,21,19,17,6,1,2,3,51,20,17,14
"2011","Basingstoke and Deane 008D","E01022523","Total",104,29,21,54,10,1,2,7,94,28,19,47
"2011","Basingstoke and Deane 009A","E01022524","Total",88,26,27,35,8,1,5,2,80,25,22,33
"2011","Basingstoke and Deane 009B","E01022525","Total",25,7,9,9,1,0,1,0,24,7,8,9
"2011","Basingstoke and Deane 009C","E01022526","Total",62,15,17,30,7,0,5,2,55,15,12,28
"2011","Basingstoke and Deane 009D","E01022527","Total",59,17,14,28,11,0,6,5,48,17,8,23
"2011","Basingstoke and Deane 010B","E01022566","Total",31,7,15,9,4,2,1,1,27,5,14,8
"2011","Basingstoke and Deane 010C","E01022567","Total",54,20,12,22,3,0,3,0,51,20,9,22
"2011","Basingstoke and Deane 010D","E01022568","Total",58,18,16,24,5,0,2,3,53,18,14,21
"2011","Basingstoke and Deane 010E","E01022570","Total",28,8,14,6,6,1,5,0,22,7,9,6
"2011","Basingstoke and Deane 010F","E01032840","Total",55,20,13,22,3,0,1,2,52,20,12,20
"2011","Basingstoke and Deane 010G","E01032841","Total",50,25,14,11,5,0,3,2,45,25,11,9
"2011","Basingstoke and Deane 011B","E01022502","Total",42,14,16,12,10,5,5,0,32,9,11,12
"2011","Basingstoke and Deane 011C","E01022506","Total",32,14,12,6,1,0,1,0,31,14,11,6
"2011","Basingstoke and Deane 011D","E01022507","Total",44,21,13,10,3,0,2,1,41,21,11,9
"2011","Basingstoke and Deane 011E","E01032842","Total",22,6,12,4,7,1,6,0,15,5,6,4
"2011","Basingstoke and Deane 011F","E01032847","Total",49,18,14,17,11,3,7,1,38,15,7,16
"2011","Basingstoke and Deane 012A","E01022481","Total",39,14,9,16,2,0,1,1,37,14,8,15
"2011","Basingstoke and Deane 012B","E01022482","Total",66,23,13,30,2,0,1,1,64,23,12,29
"2011","Basingstoke and Deane 012D","E01022503","Total",24,10,10,4,1,0,1,0,23,10,9,4
"2011","Basingstoke and Deane 012E","E01032845","Total",47,15,21,11,4,0,4,0,43,15,17,11
"2011","Basingstoke and Deane 012F","E01032846","Total",38,22,11,5,2,0,2,0,36,22,9,5
"2011","Basingstoke and Deane 013A","E01022484","Total",76,25,16,35,7,1,4,2,69,24,12,33
"2011","Basingstoke and Deane 013B","E01022485","Total",50,17,12,21,3,0,1,2,47,17,11,19
"2011","Basingstoke and Deane 013C","E01022486","Total",97,36,30,31,10,1,9,0,87,35,21,31
"2011","Basingstoke and Deane 013D","E01022487","Total",61,19,13,29,5,0,3,2,56,19,10,27
"2011","Basingstoke and Deane 013E","E01022569","Total",19,5,8,6,3,2,1,0,16,3,7,6
"2011","Basingstoke and Deane 014A","E01022548","Total",40,8,12,20,4,0,2,2,36,8,10,18
"2011","Basingstoke and Deane 014B","E01022549","Total",71,22,19,30,6,0,6,0,65,22,13,30
"2011","Basingstoke and Deane 014C","E01022550","Total",73,25,12,36,7,2,1,4,66,23,11,32
"2011","Basingstoke and Deane 014D","E01022551","Total",37,14,12,11,5,0,5,0,32,14,7,11
"2011","Basingstoke and Deane 014E","E01022552","Total",63,24,22,17,5,1,3,1,58,23,19,16
"2011","Basingstoke and Deane 015A","E01022528","Total",17,5,8,4,2,0,2,0,15,5,6,4
"2011","Basingstoke and Deane 015B","E01022529","Total",26,10,11,5,2,0,1,1,24,10,10,4
"2011","Basingstoke and Deane 015C","E01022530","Total",9,4,2,3,2,0,2,0,7,4,0,3
"2011","Basingstoke and Deane 015D","E01022531","Total",17,10,6,1,3,0,3,0,14,10,3,1
"2011","Basingstoke and Deane 016A","E01022475","Total",54,16,25,13,11,1,9,1,43,15,16,12
"2011","Basingstoke and Deane 016B","E01022476","Total",44,15,16,13,4,0,4,0,40,15,12,13
"2011","Basingstoke and Deane 016C","E01022480","Total",47,18,16,13,7,2,4,1,40,16,12,12
"2011","Basingstoke and Deane 016D","E01022504","Total",31,8,13,10,6,0,5,1,25,8,8,9
"2011","Basingstoke and Deane 016E","E01022505","Total",26,13,9,4,2,0,2,0,24,13,7,4
"2011","Basingstoke and Deane 017A","E01022467","Total",16,5,10,1,1,0,1,0,15,5,9,1
"2011","Basingstoke and Deane 017B","E01022468","Total",38,12,18,8,4,0,2,2,34,12,16,6
"2011","Basingstoke and Deane 017C","E01022469","Total",25,13,4,8,3,1,2,0,22,12,2,8
"2011","Basingstoke and Deane 017D","E01022561","Total",22,7,13,2,6,0,6,0,16,7,7,2
"2011","Basingstoke and Deane 017E","E01022562","Total",10,2,4,4,1,0,1,0,9,2,3,4
"2011","Basingstoke and Deane 018A","E01022515","Total",9,4,3,2,1,0,1,0,8,4,2,2
"2011","Basingstoke and Deane 018B","E01022516","Total",18,7,8,3,2,0,1,1,16,7,7,2
"2011","Basingstoke and Deane 018C","E01022517","Total",11,6,5,0,4,1,3,0,7,5,2,0
"2011","Basingstoke and Deane 018D","E01022518","Total",28,14,12,2,5,3,2,0,23,11,10,2
"2011","Basingstoke and Deane 018E","E01022519","Total",7,1,2,4,1,0,0,1,6,1,2,3
"2011","Basingstoke and Deane 019A","E01022474","Total",90,27,28,35,9,0,6,3,81,27,22,32
"2011","Basingstoke and Deane 019B","E01022477","Total",51,18,18,15,5,0,4,1,46,18,14,14
"2011","Basingstoke and Deane 019C","E01022478","Total",59,16,15,28,3,0,1,2,56,16,14,26
"2011","Basingstoke and Deane 019D","E01022479","Total",75,25,26,24,13,2,9,2,62,23,17,22
"2011","Basingstoke and Deane 019E","E01022509","Total",35,15,11,9,6,0,4,2,29,15,7,7
"2011","Basingstoke and Deane 020A","E01022514","Total",22,8,9,5,1,1,0,0,21,7,9,5
"2011","Basingstoke and Deane 020B","E01022563","Total",27,6,11,10,1,1,0,0,26,5,11,10
"2011","Basingstoke and Deane 020C","E01022564","Total",36,16,12,8,7,1,5,1,29,15,7,7
"2011","Basingstoke and Deane 020D","E01022565","Total",48,21,13,14,5,2,1,2,43,19,12,12
"2011","Basingstoke and Deane 021B","E01022510","Total",42,9,22,11,7,1,5,1,35,8,17,10
"2011","Basingstoke and Deane 021C","E01022511","Total",18,7,9,2,2,0,1,1,16,7,8,1
"2011","Basingstoke and Deane 021D","E01022512","Total",23,8,10,5,2,0,2,0,21,8,8,5
"2011","Basingstoke and Deane 021E","E01032848","Total",66,21,28,17,8,1,6,1,58,20,22,16
"2011","Basingstoke and Deane 021F","E01032849","Total",57,17,28,12,7,0,6,1,50,17,22,11
"2011","Basingstoke and Deane 021G","E01032850","Total",43,19,14,10,7,1,5,1,36,18,9,9
"2011","Basingstoke and Deane 022A","E01022532","Total",25,8,13,4,3,0,3,0,22,8,10,4
"2011","Basingstoke and Deane 022B","E01022533","Total",30,8,15,7,7,0,6,1,23,8,9,6
"2011","Basingstoke and Deane 022C","E01022534","Total",28,12,4,12,3,0,1,2,25,12,3,10
"2011","Basingstoke and Deane 022D","E01022535","Total",23,7,10,6,3,1,1,1,20,6,9,5
"2011","East Hampshire 001A","E01022581","Total",28,12,11,5,2,0,2,0,26,12,9,5
"2011","East Hampshire 001B","E01022582","Total",12,2,4,6,1,0,1,0,11,2,3,6
"2011","East Hampshire 001C","E01022604","Total",20,7,3,10,1,0,1,0,19,7,2,10
"2011","East Hampshire 001D","E01022605","Total",23,12,7,4,4,0,3,1,19,12,4,3
"2011","East Hampshire 002A","E01022574","Total",32,15,8,9,2,0,2,0,30,15,6,9
"2011","East Hampshire 002B","E01022575","Total",75,19,13,43,4,0,2,2,71,19,11,41
"2011","East Hampshire 002C","E01022576","Total",57,20,13,24,6,1,3,2,51,19,10,22
"2011","East Hampshire 002D","E01022579","Total",52,19,13,20,4,0,3,1,48,19,10,19
"2011","East Hampshire 003A","E01022571","Total",24,12,10,2,6,1,5,0,18,11,5,2
"2011","East Hampshire 003B","E01022572","Total",25,11,9,5,0,0,0,0,25,11,9,5
"2011","East Hampshire 003C","E01022573","Total",25,8,12,5,3,0,2,1,22,8,10,4
"2011","East Hampshire 003D","E01022577","Total",35,7,18,10,7,2,5,0,28,5,13,10
"2011","East Hampshire 003E","E01022578","Total",60,16,31,13,8,1,6,1,52,15,25,12
"2011","East Hampshire 003F","E01022580","Total",23,6,12,5,4,0,4,0,19,6,8,5
"2011","East Hampshire 004A","E01022603","Total",36,14,6,16,4,1,2,1,32,13,4,15
"2011","East Hampshire 004B","E01022634","Total",26,9,8,9,5,0,5,0,21,9,3,9
"2011","East Hampshire 004C","E01022639","Total",40,8,14,18,10,1,8,1,30,7,6,17
"2011","East Hampshire 004D","E01022640","Total",55,24,11,20,6,3,2,1,49,21,9,19
"2011","East Hampshire 006A","E01022615","Total",58,30,7,21,3,0,0,3,55,30,7,18
"2011","East Hampshire 006B","E01022633","Total",22,8,8,6,2,0,1,1,20,8,7,5
"2011","East Hampshire 006C","E01022635","Total",60,25,11,24,3,0,3,0,57,25,8,24
"2011","East Hampshire 006D","E01022636","Total",32,10,12,10,3,0,3,0,29,10,9,10
"2011","East Hampshire 006E","E01022641","Total",27,14,5,8,2,0,1,1,25,14,4,7
"2011","East Hampshire 007A","E01022591","Total",27,12,8,7,7,1,6,0,20,11,2,7
"2011","East Hampshire 007B","E01022593","Total",15,6,6,3,2,0,2,0,13,6,4,3
"2011","East Hampshire 007C","E01022594","Total",28,9,5,14,3,0,1,2,25,9,4,12
"2011","East Hampshire 007D","E01022595","Total",30,13,13,4,4,0,4,0,26,13,9,4
"2011","East Hampshire 007E","E01022596","Total",5,3,2,0,0,0,0,0,5,3,2,0
"2011","East Hampshire 007F","E01022627","Total",39,15,16,8,6,1,5,0,33,14,11,8
"2011","East Hampshire 008A","E01022630","Total",42,21,8,13,5,3,2,0,37,18,6,13
"2011","East Hampshire 008D","E01022642","Total",19,7,10,2,3,0,2,1,16,7,8,1
"2011","East Hampshire 008E","E01032663","Total",71,27,23,21,6,1,2,3,65,26,21,18
"2011","East Hampshire 009A","E01022583","Total",49,20,15,14,4,0,2,2,45,20,13,12
"2011","East Hampshire 009B","E01022584","Total",49,23,12,14,6,2,4,0,43,21,8,14
"2011","East Hampshire 009C","E01022585","Total",26,12,11,3,5,0,5,0,21,12,6,3
"2011","East Hampshire 009D","E01022586","Total",25,14,8,3,2,1,1,0,23,13,7,3
"2011","East Hampshire 009E","E01022587","Total",55,15,30,10,6,1,5,0,49,14,25,10
"2011","East Hampshire 010A","E01022616","Total",50,22,19,9,8,0,8,0,42,22,11,9
"2011","East Hampshire 010B","E01022617","Total",32,16,13,3,3,0,3,0,29,16,10,3
"2011","East Hampshire 010C","E01022618","Total",20,10,7,3,1,0,1,0,19,10,6,3
"2011","East Hampshire 010D","E01022631","Total",20,9,8,3,0,0,0,0,20,9,8,3
"2011","East Hampshire 010E","E01022632","Total",18,8,6,4,1,0,1,0,17,8,5,4
"2011","East Hampshire 011A","E01022592","Total",52,20,20,12,14,1,12,1,38,19,8,11
"2011","East Hampshire 011B","E01022597","Total",37,9,12,16,5,0,3,2,32,9,9,14
"2011","East Hampshire 011C","E01022619","Total",19,7,7,5,3,0,3,0,16,7,4,5
"2011","East Hampshire 011D","E01022624","Total",22,9,9,4,2,0,2,0,20,9,7,4
"2011","East Hampshire 011E","E01022625","Total",43,20,16,7,3,0,3,0,40,20,13,7
"2011","East Hampshire 012A","E01022620","Total",26,10,11,5,0,0,0,0,26,10,11,5
"2011","East Hampshire 012B","E01022621","Total",57,28,12,17,7,0,4,3,50,28,8,14
"2011","East Hampshire 012C","E01022622","Total",24,12,5,7,4,1,2,1,20,11,3,6
"2011","East Hampshire 012D","E01022623","Total",83,39,16,28,5,0,3,2,78,39,13,26
"2011","East Hampshire 012F","E01032664","Total",24,8,12,4,3,0,3,0,21,8,9,4
"2011","East Hampshire 012G","E01032665","Total",40,18,15,7,4,0,3,1,36,18,12,6
"2011","East Hampshire 013A","E01022588","Total",27,13,9,5,5,0,5,0,22,13,4,5
"2011","East Hampshire 013B","E01022589","Total",36,15,9,12,3,0,1,2,33,15,8,10
"2011","East Hampshire 013C","E01022590","Total",34,14,12,8,5,1,4,0,29,13,8,8
"2011","East Hampshire 013D","E01022607","Total",25,11,4,10,2,0,2,0,23,11,2,10
"2011","East Hampshire 013E","E01022608","Total",16,10,6,0,0,0,0,0,16,10,6,0
"2011","East Hampshire 014A","E01022606","Total",34,12,13,9,5,0,4,1,29,12,9,8
"2011","East Hampshire 014B","E01022611","Total",29,10,12,7,4,0,3,1,25,10,9,6
"2011","East Hampshire 014C","E01022613","Total",39,20,11,8,5,1,3,1,34,19,8,7
"2011","East Hampshire 014D","E01022614","Total",37,17,8,12,3,0,2,1,34,17,6,11
"2011","East Hampshire 016A","E01022610","Total",18,7,9,2,0,0,0,0,18,7,9,2
"2011","East Hampshire 016B","E01022628","Total",31,13,13,5,5,0,5,0,26,13,8,5
"2011","East Hampshire 016C","E01022629","Total",12,3,4,5,1,0,1,0,11,3,3,5
"2011","East Hampshire 016D","E01032615","Total",5,3,2,0,0,0,0,0,5,3,2,0
"2011","East Hampshire 016E","E01032616","Total",21,7,11,3,2,0,1,1,19,7,10,2
"2011","East Hampshire 017A","E01022599","Total",26,7,12,7,5,0,3,2,21,7,9,5
"2011","East Hampshire 017B","E01022600","Total",21,13,4,4,2,0,2,0,19,13,2,4
"2011","East Hampshire 017C","E01022601","Total",19,8,7,4,2,0,2,0,17,8,5,4
"2011","East Hampshire 017D","E01022602","Total",4,3,1,0,0,0,0,0,4,3,1,0
"2011","East Hampshire 017E","E01032625","Total",10,3,2,5,0,0,0,0,10,3,2,5
"2011","Eastleigh 001A","E01022705","Total",12,4,7,1,0,0,0,0,12,4,7,1
"2011","Eastleigh 001B","E01022706","Total",11,5,5,1,2,0,1,1,9,5,4,0
"2011","Eastleigh 001C","E01022707","Total",33,14,14,5,5,1,4,0,28,13,10,5
"2011","Eastleigh 001D","E01022708","Total",41,19,13,9,5,0,4,1,36,19,9,8
"2011","Eastleigh 001E","E01022709","Total",31,21,7,3,1,0,1,0,30,21,6,3
"2011","Eastleigh 002A","E01022659","Total",57,23,17,17,3,0,2,1,54,23,15,16
"2011","Eastleigh 002B","E01022660","Total",28,10,12,6,2,0,2,0,26,10,10,6
"2011","Eastleigh 002C","E01022675","Total",11,3,5,3,1,0,0,1,10,3,5,2
"2011","Eastleigh 002D","E01022676","Total",19,6,9,4,1,1,0,0,18,5,9,4
"2011","Eastleigh 002E","E01022704","Total",38,15,17,6,3,0,3,0,35,15,14,6
"2011","Eastleigh 003A","E01022661","Total",30,9,13,8,4,0,3,1,26,9,10,7
"2011","Eastleigh 003B","E01022662","Total",16,9,6,1,2,1,1,0,14,8,5,1
"2011","Eastleigh 003C","E01022663","Total",19,11,4,4,0,0,0,0,19,11,4,4
"2011","Eastleigh 003D","E01022664","Total",27,13,12,2,3,1,2,0,24,12,10,2
"2011","Eastleigh 003E","E01022665","Total",48,18,17,13,6,0,6,0,42,18,11,13
"2011","Eastleigh 004A","E01022648","Total",25,8,9,8,1,0,1,0,24,8,8,8
"2011","Eastleigh 004B","E01022667","Total",41,12,21,8,6,0,6,0,35,12,15,8
"2011","Eastleigh 004C","E01022672","Total",35,16,9,10,4,1,3,0,31,15,6,10
"2011","Eastleigh 004D","E01022673","Total",56,20,13,23,8,1,7,0,48,19,6,23
"2011","Eastleigh 004E","E01022674","Total",40,22,8,10,4,1,1,2,36,21,7,8
"2011","Eastleigh 005A","E01022643","Total",31,18,6,7,1,0,0,1,30,18,6,6
"2011","Eastleigh 005B","E01022644","Total",37,16,12,9,3,2,1,0,34,14,11,9
"2011","Eastleigh 005C","E01022646","Total",50,22,21,7,8,1,7,0,42,21,14,7
"2011","Eastleigh 005D","E01022647","Total",23,6,8,9,1,0,1,0,22,6,7,9
"2011","Eastleigh 005E","E01022649","Total",93,36,21,36,1,1,0,0,92,35,21,36
"2011","Eastleigh 005F","E01022650","Total",26,6,11,9,6,1,5,0,20,5,6,9
"2011","Eastleigh 006A","E01022668","Total",89,26,21,42,8,0,4,4,81,26,17,38
"2011","Eastleigh 006B","E01022677","Total",92,30,21,41,7,1,6,0,85,29,15,41
"2011","Eastleigh 006C","E01022678","Total",68,29,13,26,8,2,4,2,60,27,9,24
"2011","Eastleigh 006D","E01022680","Total",63,19,14,30,7,1,3,3,56,18,11,27
"2011","Eastleigh 006E","E01022681","Total",59,26,10,23,9,4,3,2,50,22,7,21
"2011","Eastleigh 007A","E01022666","Total",45,13,12,20,3,0,2,1,42,13,10,19
"2011","Eastleigh 007B","E01022669","Total",54,24,20,10,5,0,5,0,49,24,15,10
"2011","Eastleigh 007C","E01022670","Total",95,33,31,31,10,2,5,3,85,31,26,28
"2011","Eastleigh 007D","E01022671","Total",43,18,8,17,7,1,1,5,36,17,7,12
"2011","Eastleigh 007E","E01022679","Total",66,23,17,26,6,1,4,1,60,22,13,25
"2011","Eastleigh 008A","E01022645","Total",10,5,3,2,3,0,2,1,7,5,1,1
"2011","Eastleigh 008B","E01022682","Total",13,5,7,1,3,0,3,0,10,5,4,1
"2011","Eastleigh 008C","E01022683","Total",24,9,9,6,3,2,1,0,21,7,8,6
"2011","Eastleigh 008D","E01022684","Total",30,11,10,9,8,2,5,1,22,9,5,8
"2011","Eastleigh 008E","E01022685","Total",21,11,4,6,0,0,0,0,21,11,4,6
"2011","Eastleigh 008F","E01022686","Total",28,12,10,6,2,0,2,0,26,12,8,6
"2011","Eastleigh 008G","E01022687","Total",50,19,19,12,11,1,6,4,39,18,13,8
"2011","Eastleigh 009A","E01022713","Total",30,13,8,9,2,0,2,0,28,13,6,9
"2011","Eastleigh 009B","E01022714","Total",15,6,6,3,1,0,1,0,14,6,5,3
"2011","Eastleigh 009C","E01022715","Total",53,17,18,18,4,0,4,0,49,17,14,18
"2011","Eastleigh 009D","E01022716","Total",58,21,13,24,5,1,4,0,53,20,9,24
"2011","Eastleigh 009E","E01022717","Total",26,11,8,7,3,0,3,0,23,11,5,7
"2011","Eastleigh 009F","E01022718","Total",23,10,8,5,3,0,2,1,20,10,6,4
"2011","Eastleigh 009G","E01022719","Total",16,8,7,1,2,0,2,0,14,8,5,1
"2011","Eastleigh 010A","E01022653","Total",15,7,5,3,0,0,0,0,15,7,5,3
"2011","Eastleigh 010B","E01022691","Total",45,19,21,5,3,0,3,0,42,19,18,5
"2011","Eastleigh 010C","E01022692","Total",153,67,39,47,11,2,5,4,142,65,34,43
"2011","Eastleigh 010D","E01022693","Total",19,14,3,2,0,0,0,0,19,14,3,2
"2011","Eastleigh 010E","E01022694","Total",61,28,23,10,7,1,6,0,54,27,17,10
"2011","Eastleigh 011A","E01022652","Total",48,14,18,16,1,0,1,0,47,14,17,16
"2011","Eastleigh 011B","E01022695","Total",44,18,21,5,6,1,5,0,38,17,16,5
"2011","Eastleigh 011C","E01022700","Total",46,20,14,12,8,1,6,1,38,19,8,11
"2011","Eastleigh 011D","E01022701","Total",22,12,3,7,2,1,0,1,20,11,3,6
"2011","Eastleigh 011E","E01022703","Total",46,15,15,16,4,2,2,0,42,13,13,16
"2011","Eastleigh 012A","E01022651","Total",57,23,17,17,4,0,2,2,53,23,15,15
"2011","Eastleigh 012B","E01022696","Total",26,13,10,3,3,1,2,0,23,12,8,3
"2011","Eastleigh 012C","E01022697","Total",24,6,10,8,4,0,4,0,20,6,6,8
"2011","Eastleigh 012D","E01022698","Total",21,9,10,2,3,0,3,0,18,9,7,2
"2011","Eastleigh 012E","E01022699","Total",27,12,10,5,4,0,4,0,23,12,6,5
"2011","Eastleigh 012F","E01022702","Total",20,11,9,0,3,0,3,0,17,11,6,0
"2011","Eastleigh 013A","E01022654","Total",33,14,9,10,2,0,1,1,31,14,8,9
"2011","Eastleigh 013B","E01022655","Total",112,44,17,51,8,2,4,2,104,42,13,49
"2011","Eastleigh 013C","E01022656","Total",32,12,6,14,2,0,1,1,30,12,5,13
"2011","Eastleigh 013D","E01022657","Total",42,14,13,15,4,2,2,0,38,12,11,15
"2011","Eastleigh 013E","E01022658","Total",23,10,9,4,3,0,3,0,20,10,6,4
"2011","Eastleigh 014A","E01022710","Total",33,12,13,8,6,3,3,0,27,9,10,8
"2011","Eastleigh 014B","E01022711","Total",60,22,15,23,13,3,5,5,47,19,10,18
"2011","Eastleigh 014C","E01022712","Total",44,28,8,8,4,0,4,0,40,28,4,8
"2011","Eastleigh 015A","E01022688","Total",55,17,21,17,8,0,7,1,47,17,14,16
"2011","Eastleigh 015B","E01022689","Total",25,14,6,5,3,0,1,2,22,14,5,3
"2011","Eastleigh 015C","E01022690","Total",78,39,20,19,9,3,6,0,69,36,14,19
"2011","Fareham 001A","E01022758","Total",67,29,25,13,8,0,5,3,59,29,20,10
"2011","Fareham 001B","E01022771","Total",25,13,6,6,1,0,1,0,24,13,5,6
"2011","Fareham 001C","E01022772","Total",39,11,15,13,7,0,5,2,32,11,10,11
"2011","Fareham 001D","E01022773","Total",29,18,7,4,3,0,2,1,26,18,5,3
"2011","Fareham 001E","E01022774","Total",25,6,9,10,4,0,2,2,21,6,7,8
"2011","Fareham 002A","E01022749","Total",22,5,12,5,3,0,3,0,19,5,9,5
"2011","Fareham 002B","E01022753","Total",32,22,7,3,2,1,1,0,30,21,6,3
"2011","Fareham 002C","E01022754","Total",54,26,15,13,1,0,1,0,53,26,14,13
"2011","Fareham 002D","E01022780","Total",40,20,10,10,4,0,3,1,36,20,7,9
"2011","Fareham 002E","E01022787","Total",32,14,11,7,3,0,3,0,29,14,8,7
"2011","Fareham 002F","E01022788","Total",41,18,16,7,4,0,4,0,37,18,12,7
"2011","Fareham 003A","E01022730","Total",40,22,8,10,1,0,0,1,39,22,8,9
"2011","Fareham 003B","E01022731","Total",29,14,10,5,3,1,2,0,26,13,8,5
"2011","Fareham 003C","E01022732","Total",103,39,19,45,9,1,3,5,94,38,16,40
"2011","Fareham 003D","E01022733","Total",42,15,14,13,5,0,3,2,37,15,11,11
"2011","Fareham 003E","E01022734","Total",46,20,8,18,3,1,1,1,43,19,7,17
"2011","Fareham 004A","E01022720","Total",17,8,7,2,4,1,3,0,13,7,4,2
"2011","Fareham 004B","E01022725","Total",11,4,7,0,1,0,1,0,10,4,6,0
"2011","Fareham 004C","E01022726","Total",12,2,4,6,2,0,1,1,10,2,3,5
"2011","Fareham 004D","E01022727","Total",33,9,17,7,1,0,1,0,32,9,16,7
"2011","Fareham 004E","E01022729","Total",21,8,8,5,2,1,1,0,19,7,7,5
"2011","Fareham 004F","E01022743","Total",28,5,13,10,6,0,3,3,22,5,10,7
"2011","Fareham 005A","E01022750","Total",20,10,5,5,2,0,1,1,18,10,4,4
"2011","Fareham 005B","E01022751","Total",26,17,7,2,1,0,1,0,25,17,6,2
"2011","Fareham 005C","E01022752","Total",18,12,6,0,1,0,1,0,17,12,5,0
"2011","Fareham 005D","E01022757","Total",36,17,10,9,2,0,1,1,34,17,9,8
"2011","Fareham 005E","E01022790","Total",24,11,11,2,1,0,1,0,23,11,10,2
"2011","Fareham 006A","E01022755","Total",30,8,11,11,1,0,1,0,29,8,10,11
"2011","Fareham 006B","E01022756","Total",22,8,10,4,2,0,2,0,20,8,8,4
"2011","Fareham 006C","E01022791","Total",31,10,13,8,3,0,1,2,28,10,12,6
"2011","Fareham 006D","E01022792","Total",41,16,9,16,0,0,0,0,41,16,9,16
"2011","Fareham 006E","E01022793","Total",28,18,6,4,3,1,1,1,25,17,5,3
"2011","Fareham 007A","E01022781","Total",34,13,5,16,3,0,1,2,31,13,4,14
"2011","Fareham 007B","E01022782","Total",23,8,10,5,2,1,1,0,21,7,9,5
"2011","Fareham 007C","E01022785","Total",19,6,11,2,3,0,3,0,16,6,8,2
"2011","Fareham 007D","E01022786","Total",49,24,13,12,3,0,3,0,46,24,10,12
"2011","Fareham 007E","E01022789","Total",25,7,12,6,2,0,2,0,23,7,10,6
"2011","Fareham 008A","E01022721","Total",33,12,14,7,8,1,5,2,25,11,9,5
"2011","Fareham 008B","E01022722","Total",39,13,16,10,4,0,2,2,35,13,14,8
"2011","Fareham 008C","E01022723","Total",52,15,13,24,3,0,3,0,49,15,10,24
"2011","Fareham 008D","E01022724","Total",52,18,22,12,5,0,5,0,47,18,17,12
"2011","Fareham 008E","E01022737","Total",32,7,10,15,2,0,1,1,30,7,9,14
"2011","Fareham 008F","E01022766","Total",9,1,6,2,1,0,1,0,8,1,5,2
"2011","Fareham 008G","E01022769","Total",34,7,19,8,4,1,2,1,30,6,17,7
"2011","Fareham 009A","E01022740","Total",15,4,9,2,1,0,0,1,14,4,9,1
"2011","Fareham 009B","E01022741","Total",11,2,9,0,5,0,5,0,6,2,4,0
"2011","Fareham 009C","E01022742","Total",11,6,4,1,4,1,2,1,7,5,2,0
"2011","Fareham 009D","E01022783","Total",18,5,10,3,2,0,2,0,16,5,8,3
"2011","Fareham 009E","E01022784","Total",11,2,7,2,4,1,3,0,7,1,4,2
"2011","Fareham 010A","E01022759","Total",28,11,12,5,2,0,2,0,26,11,10,5
"2011","Fareham 010B","E01022763","Total",16,7,7,2,3,1,1,1,13,6,6,1
"2011","Fareham 010C","E01022765","Total",22,9,10,3,4,0,3,1,18,9,7,2
"2011","Fareham 010D","E01022768","Total",27,9,11,7,4,0,4,0,23,9,7,7
"2011","Fareham 010E","E01022770","Total",23,8,9,6,5,0,4,1,18,8,5,5
"2011","Fareham 011A","E01022728","Total",78,29,25,24,7,1,6,0,71,28,19,24
"2011","Fareham 011B","E01022735","Total",38,15,11,12,4,1,3,0,34,14,8,12
"2011","Fareham 011C","E01022736","Total",29,13,11,5,6,0,5,1,23,13,6,4
"2011","Fareham 011D","E01022738","Total",40,10,8,22,4,0,1,3,36,10,7,19
"2011","Fareham 011E","E01022739","Total",92,34,13,45,4,2,2,0,88,32,11,45
"2011","Fareham 012A","E01022760","Total",40,19,12,9,2,0,1,1,38,19,11,8
"2011","Fareham 012B","E01022761","Total",48,15,17,16,4,0,4,0,44,15,13,16
"2011","Fareham 012C","E01022762","Total",36,14,11,11,4,0,4,0,32,14,7,11
"2011","Fareham 012D","E01022764","Total",27,10,8,9,2,1,1,0,25,9,7,9
"2011","Fareham 012E","E01022767","Total",35,19,10,6,2,0,2,0,33,19,8,6
"2011","Fareham 013B","E01022776","Total",16,9,5,2,0,0,0,0,16,9,5,2
"2011","Fareham 013C","E01022777","Total",39,19,13,7,3,0,3,0,36,19,10,7
"2011","Fareham 013D","E01022778","Total",26,9,12,5,1,1,0,0,25,8,12,5
"2011","Fareham 013F","E01032877","Total",36,16,7,13,7,1,4,2,29,15,3,11
"2011","Fareham 014A","E01022744","Total",17,4,11,2,4,0,4,0,13,4,7,2
"2011","Fareham 014B","E01022745","Total",15,5,8,2,2,0,2,0,13,5,6,2
"2011","Fareham 014C","E01022746","Total",19,7,12,0,4,0,4,0,15,7,8,0
"2011","Fareham 014D","E01022747","Total",35,21,11,3,3,1,2,0,32,20,9,3
"2011","Fareham 014E","E01022748","Total",35,13,17,5,4,0,3,1,31,13,14,4
"2011","Gosport 001A","E01022800","Total",59,24,14,21,8,1,4,3,51,23,10,18
"2011","Gosport 001B","E01022801","Total",55,15,10,30,3,1,2,0,52,14,8,30
"2011","Gosport 001C","E01022802","Total",35,16,7,12,4,0,3,1,31,16,4,11
"2011","Gosport 001D","E01022803","Total",67,26,10,31,7,0,5,2,60,26,5,29
"2011","Gosport 001E","E01022836","Total",25,10,9,6,3,0,3,0,22,10,6,6
"2011","Gosport 002A","E01022804","Total",27,8,6,13,6,0,2,4,21,8,4,9
"2011","Gosport 002B","E01022805","Total",48,18,11,19,7,0,5,2,41,18,6,17
"2011","Gosport 002C","E01022834","Total",34,10,7,17,5,0,2,3,29,10,5,14
"2011","Gosport 002D","E01022835","Total",52,18,10,24,7,2,2,3,45,16,8,21
"2011","Gosport 002E","E01022840","Total",65,19,16,30,18,4,9,5,47,15,7,25
"2011","Gosport 003A","E01022813","Total",40,23,11,6,5,1,4,0,35,22,7,6
"2011","Gosport 003B","E01022814","Total",55,24,21,10,11,0,8,3,44,24,13,7
"2011","Gosport 003C","E01022815","Total",33,15,13,5,4,0,3,1,29,15,10,4
"2011","Gosport 003D","E01022823","Total",38,12,11,15,5,1,0,4,33,11,11,11
"2011","Gosport 003E","E01022825","Total",36,19,8,9,8,1,3,4,28,18,5,5
"2011","Gosport 004A","E01022819","Total",118,34,31,53,19,3,9,7,99,31,22,46
"2011","Gosport 004B","E01022820","Total",136,37,29,70,16,1,6,9,120,36,23,61
"2011","Gosport 004E","E01022841","Total",60,19,21,20,7,0,5,2,53,19,16,18
"2011","Gosport 004F","E01022842","Total",67,21,17,29,6,0,6,0,61,21,11,29
"2011","Gosport 004G","E01032882","Total",178,55,32,91,15,3,8,4,163,52,24,87
"2011","Gosport 005A","E01022807","Total",83,21,30,32,12,2,9,1,71,19,21,31
"2011","Gosport 005B","E01022816","Total",48,15,22,11,8,2,6,0,40,13,16,11
"2011","Gosport 005C","E01022817","Total",63,18,20,25,9,1,5,3,54,17,15,22
"2011","Gosport 005D","E01022818","Total",69,29,17,23,3,0,2,1,66,29,15,22
"2011","Gosport 005E","E01022824","Total",116,41,30,45,10,2,6,2,106,39,24,43
"2011","Gosport 006A","E01022826","Total",42,24,10,8,3,0,1,2,39,24,9,6
"2011","Gosport 006C","E01022828","Total",22,10,4,8,3,1,2,0,19,9,2,8
"2011","Gosport 006D","E01022829","Total",17,5,8,4,5,0,5,0,12,5,3,4
"2011","Gosport 006E","E01022830","Total",25,9,11,5,2,0,2,0,23,9,9,5
"2011","Gosport 006F","E01032880","Total",31,12,14,5,3,0,3,0,28,12,11,5
"2011","Gosport 006G","E01032881","Total",54,15,17,22,3,0,2,1,51,15,15,21
"2011","Gosport 006H","E01032883","Total",65,20,21,24,6,0,6,0,59,20,15,24
"2011","Gosport 007A","E01022806","Total",60,23,23,14,11,1,6,4,49,22,17,10
"2011","Gosport 007D","E01022832","Total",78,26,21,31,6,0,5,1,72,26,16,30
"2011","Gosport 007E","E01022839","Total",42,17,16,9,5,1,1,3,37,16,15,6
"2011","Gosport 007F","E01032884","Total",53,20,21,12,12,2,10,0,41,18,11,12
"2011","Gosport 008A","E01022810","Total",46,16,14,16,3,0,2,1,43,16,12,15
"2011","Gosport 008B","E01022811","Total",143,46,48,49,13,1,9,3,130,45,39,46
"2011","Gosport 008C","E01022833","Total",131,35,27,69,17,2,5,10,114,33,22,59
"2011","Gosport 008D","E01022843","Total",97,29,16,52,9,2,4,3,88,27,12,49
"2011","Gosport 008F","E01032878","Total",70,25,12,33,4,0,4,0,66,25,8,33
"2011","Gosport 008G","E01032879","Total",53,11,19,23,5,0,4,1,48,11,15,22
"2011","Gosport 009A","E01022794","Total",33,9,17,7,9,0,6,3,24,9,11,4
"2011","Gosport 009B","E01022795","Total",32,15,14,3,5,0,4,1,27,15,10,2
"2011","Gosport 009C","E01022796","Total",9,3,4,2,0,0,0,0,9,3,4,2
"2011","Gosport 009D","E01022837","Total",29,10,14,5,4,1,2,1,25,9,12,4
"2011","Gosport 009E","E01022838","Total",21,9,10,2,4,0,4,0,17,9,6,2
"2011","Gosport 010A","E01022797","Total",18,4,7,7,5,0,3,2,13,4,4,5
"2011","Gosport 010B","E01022798","Total",19,7,7,5,1,0,1,0,18,7,6,5
"2011","Gosport 010C","E01022799","Total",19,7,10,2,2,0,2,0,17,7,8,2
"2011","Gosport 010D","E01022812","Total",32,8,10,14,6,0,3,3,26,8,7,11
"2011","Gosport 010E","E01022831","Total",54,22,21,11,7,1,6,0,47,21,15,11
"2011","Gosport 010F","E01022845","Total",63,24,19,20,7,0,5,2,56,24,14,18
"2011","Hart 001A","E01022890","Total",48,13,18,17,5,0,3,2,43,13,15,15
"2011","Hart 001B","E01022891","Total",31,7,15,9,3,0,2,1,28,7,13,8
"2011","Hart 001C","E01022892","Total",21,11,7,3,1,0,1,0,20,11,6,3
"2011","Hart 001D","E01022893","Total",34,8,18,8,4,0,3,1,30,8,15,7
"2011","Hart 001E","E01022894","Total",33,12,10,11,2,0,1,1,31,12,9,10
"2011","Hart 002A","E01022859","Total",24,10,11,3,1,0,1,0,23,10,10,3
"2011","Hart 002B","E01022895","Total",29,14,7,8,1,0,0,1,28,14,7,7
"2011","Hart 002C","E01022896","Total",32,16,11,5,1,0,1,0,31,16,10,5
"2011","Hart 002D","E01022897","Total",34,11,15,8,1,0,1,0,33,11,14,8
"2011","Hart 002E","E01022898","Total",13,9,3,1,0,0,0,0,13,9,3,1
"2011","Hart 003A","E01022846","Total",11,1,5,5,0,0,0,0,11,1,5,5
"2011","Hart 003B","E01022847","Total",31,18,7,6,7,1,4,2,24,17,3,4
"2011","Hart 003C","E01022848","Total",20,7,5,8,1,0,0,1,19,7,5,7
"2011","Hart 003D","E01022874","Total",21,10,5,6,0,0,0,0,21,10,5,6
"2011","Hart 003E","E01022875","Total",38,13,13,12,3,0,2,1,35,13,11,11
"2011","Hart 003F","E01022876","Total",16,6,6,4,2,0,2,0,14,6,4,4
"2011","Hart 003G","E01022877","Total",15,7,6,2,1,0,0,1,14,7,6,1
"2011","Hart 004A","E01022858","Total",13,3,7,3,1,1,0,0,12,2,7,3
"2011","Hart 004B","E01022878","Total",11,5,5,1,2,0,2,0,9,5,3,1
"2011","Hart 004C","E01022879","Total",40,11,12,17,5,0,4,1,35,11,8,16
"2011","Hart 004D","E01022880","Total",23,12,6,5,2,0,2,0,21,12,4,5
"2011","Hart 005A","E01022860","Total",18,7,7,4,2,0,2,0,16,7,5,4
"2011","Hart 005B","E01022862","Total",33,13,13,7,5,0,4,1,28,13,9,6
"2011","Hart 005D","E01022867","Total",30,6,14,10,6,0,5,1,24,6,9,9
"2011","Hart 005E","E01032852","Total",50,15,18,17,8,1,5,2,42,14,13,15
"2011","Hart 005F","E01032853","Total",24,14,6,4,2,1,0,1,22,13,6,3
"2011","Hart 005G","E01032854","Total",32,12,9,11,3,1,1,1,29,11,8,10
"2011","Hart 005H","E01032857","Total",7,1,2,4,2,0,2,0,5,1,0,4
"2011","Hart 006A","E01022881","Total",65,18,28,19,11,0,10,1,54,18,18,18
"2011","Hart 006B","E01022882","Total",20,9,9,2,7,0,7,0,13,9,2,2
"2011","Hart 006C","E01022883","Total",36,11,14,11,4,0,3,1,32,11,11,10
"2011","Hart 006D","E01022884","Total",24,9,11,4,3,0,3,0,21,9,8,4
"2011","Hart 006E","E01022885","Total",33,10,16,7,1,0,1,0,32,10,15,7
"2011","Hart 007A","E01022861","Total",23,7,12,4,2,0,2,0,21,7,10,4
"2011","Hart 007B","E01022863","Total",16,6,8,2,2,0,2,0,14,6,6,2
"2011","Hart 007C","E01022865","Total",11,6,5,0,0,0,0,0,11,6,5,0
"2011","Hart 007D","E01022868","Total",8,2,5,1,1,0,1,0,7,2,4,1
"2011","Hart 007E","E01022870","Total",16,11,2,3,0,0,0,0,16,11,2,3
"2011","Hart 008A","E01022864","Total",26,5,9,12,3,0,3,0,23,5,6,12
"2011","Hart 008B","E01022871","Total",36,14,11,11,4,1,2,1,32,13,9,10
"2011","Hart 008C","E01022872","Total",21,10,8,3,1,0,0,1,20,10,8,2
"2011","Hart 008D","E01022873","Total",14,5,5,4,1,0,1,0,13,5,4,4
"2011","Hart 008E","E01022887","Total",13,5,7,1,2,1,1,0,11,4,6,1
"2011","Hart 009A","E01022849","Total",24,9,7,8,4,1,2,1,20,8,5,7
"2011","Hart 009B","E01022850","Total",23,9,9,5,5,0,3,2,18,9,6,3
"2011","Hart 009C","E01022851","Total",27,5,12,10,4,0,1,3,23,5,11,7
"2011","Hart 009D","E01022853","Total",33,18,11,4,2,0,2,0,31,18,9,4
"2011","Hart 009E","E01022869","Total",16,7,5,4,2,1,1,0,14,6,4,4
"2011","Hart 010A","E01022852","Total",46,22,19,5,1,0,1,0,45,22,18,5
"2011","Hart 010B","E01022854","Total",34,20,8,6,3,0,2,1,31,20,6,5
"2011","Hart 010C","E01022855","Total",21,10,4,7,1,0,1,0,20,10,3,7
"2011","Hart 010D","E01022856","Total",22,11,6,5,0,0,0,0,22,11,6,5
"2011","Hart 010E","E01022857","Total",22,6,10,6,4,1,3,0,18,5,7,6
"2011","Hart 011B","E01022888","Total",24,8,14,2,1,0,1,0,23,8,13,2
"2011","Hart 011C","E01022889","Total",36,15,12,9,3,1,2,0,33,14,10,9
"2011","Hart 011D","E01032855","Total",14,5,5,4,2,0,2,0,12,5,3,4
"2011","Hart 011E","E01032856","Total",14,0,11,3,7,0,5,2,7,0,6,1
"2011","Havant 003A","E01022930","Total",23,13,6,4,3,2,0,1,20,11,6,3
"2011","Havant 003B","E01022931","Total",27,12,9,6,2,0,2,0,25,12,7,6
"2011","Havant 003C","E01022935","Total",25,6,13,6,7,1,5,1,18,5,8,5
"2011","Havant 003D","E01022975","Total",18,7,8,3,2,0,2,0,16,7,6,3
"2011","Havant 003E","E01022976","Total",38,12,10,16,6,0,5,1,32,12,5,15
"2011","Havant 004A","E01022922","Total",60,29,17,14,8,1,5,2,52,28,12,12
"2011","Havant 004B","E01022971","Total",31,13,10,8,3,1,2,0,28,12,8,8
"2011","Havant 004C","E01022972","Total",21,11,6,4,3,0,3,0,18,11,3,4
"2011","Havant 004D","E01022974","Total",29,13,9,7,3,0,3,0,26,13,6,7
"2011","Havant 005A","E01022959","Total",84,29,14,41,9,2,5,2,75,27,9,39
"2011","Havant 005B","E01022962","Total",34,12,11,11,9,2,4,3,25,10,7,8
"2011","Havant 005C","E01022965","Total",79,27,15,37,5,1,3,1,74,26,12,36
"2011","Havant 005D","E01022973","Total",53,15,13,25,9,0,5,4,44,15,8,21
"2011","Havant 006A","E01022901","Total",75,17,14,44,6,0,2,4,69,17,12,40
"2011","Havant 006B","E01022902","Total",64,14,16,34,10,1,5,4,54,13,11,30
"2011","Havant 006C","E01022966","Total",84,21,16,47,9,4,4,1,75,17,12,46
"2011","Havant 006D","E01022967","Total",91,21,21,49,13,2,8,3,78,19,13,46
"2011","Havant 007A","E01022960","Total",53,18,12,23,2,0,2,0,51,18,10,23
"2011","Havant 007B","E01022961","Total",46,21,9,16,3,0,2,1,43,21,7,15
"2011","Havant 007C","E01022963","Total",22,8,6,8,4,1,2,1,18,7,4,7
"2011","Havant 007D","E01022964","Total",73,20,19,34,6,0,3,3,67,20,16,31
"2011","Havant 008A","E01022903","Total",103,32,16,55,8,1,5,2,95,31,11,53
"2011","Havant 008B","E01022906","Total",98,28,23,47,6,0,6,0,92,28,17,47
"2011","Havant 008C","E01022968","Total",93,25,22,46,8,0,2,6,85,25,20,40
"2011","Havant 008D","E01022969","Total",96,32,16,48,3,1,1,1,93,31,15,47
"2011","Havant 009A","E01022913","Total",52,21,10,21,3,1,2,0,49,20,8,21
"2011","Havant 009B","E01022914","Total",54,10,10,34,8,0,4,4,46,10,6,30
"2011","Havant 009C","E01022915","Total",80,25,6,49,9,1,1,7,71,24,5,42
"2011","Havant 009D","E01022916","Total",75,29,16,30,4,0,2,2,71,29,14,28
"2011","Havant 009E","E01022917","Total",54,16,7,31,5,1,2,2,49,15,5,29
"2011","Havant 010A","E01022900","Total",81,22,11,48,13,3,5,5,68,19,6,43
"2011","Havant 010B","E01022904","Total",50,18,5,27,6,4,1,1,44,14,4,26
"2011","Havant 010C","E01022905","Total",134,27,29,78,13,1,8,4,121,26,21,74
"2011","Havant 010D","E01022908","Total",53,27,6,20,3,0,1,2,50,27,5,18
"2011","Havant 010E","E01022970","Total",111,27,19,65,8,1,3,4,103,26,16,61
"2011","Havant 011A","E01022947","Total",28,10,14,4,5,0,5,0,23,10,9,4
"2011","Havant 011B","E01022948","Total",38,18,14,6,4,1,3,0,34,17,11,6
"2011","Havant 011C","E01022949","Total",57,13,17,27,4,0,3,1,53,13,14,26
"2011","Havant 011D","E01022950","Total",15,7,7,1,2,0,2,0,13,7,5,1
"2011","Havant 011E","E01022951","Total",24,11,7,6,3,0,2,1,21,11,5,5
"2011","Havant 011F","E01022952","Total",29,11,10,8,5,1,4,0,24,10,6,8
"2011","Havant 013A","E01022924","Total",28,10,11,7,2,0,2,0,26,10,9,7
"2011","Havant 013B","E01022925","Total",36,17,4,15,2,0,1,1,34,17,3,14
"2011","Havant 013C","E01022926","Total",22,12,6,4,4,1,1,2,18,11,5,2
"2011","Havant 013D","E01022927","Total",40,24,7,9,1,0,1,0,39,24,6,9
"2011","Havant 013E","E01022928","Total",15,6,7,2,1,0,1,0,14,6,6,2
"2011","Havant 013F","E01022929","Total",26,10,9,7,2,1,1,0,24,9,8,7
"2011","Havant 014A","E01022953","Total",79,24,25,30,13,2,8,3,66,22,17,27
"2011","Havant 014B","E01022954","Total",24,8,12,4,5,1,4,0,19,7,8,4
"2011","Havant 014C","E01022955","Total",12,8,4,0,2,1,1,0,10,7,3,0
"2011","Havant 014D","E01022956","Total",42,16,6,20,3,0,1,2,39,16,5,18
"2011","Havant 014E","E01022957","Total",29,12,5,12,6,2,2,2,23,10,3,10
"2011","Havant 014F","E01022958","Total",17,2,12,3,4,0,4,0,13,2,8,3
"2011","Havant 015A","E01022937","Total",28,6,10,12,3,1,1,1,25,5,9,11
"2011","Havant 015B","E01022943","Total",8,5,2,1,1,0,1,0,7,5,1,1
"2011","Havant 015C","E01022944","Total",11,4,2,5,0,0,0,0,11,4,2,5
"2011","Havant 015D","E01022946","Total",30,12,10,8,3,1,2,0,27,11,8,8
"2011","Havant 016A","E01022940","Total",53,20,16,17,6,2,3,1,47,18,13,16
"2011","Havant 016B","E01022942","Total",51,12,7,32,9,2,3,4,42,10,4,28
"2011","Havant 016C","E01022945","Total",57,22,14,21,7,1,4,2,50,21,10,19
"2011","Havant 017A","E01022936","Total",49,16,13,20,7,3,3,1,42,13,10,19
"2011","Havant 017B","E01022938","Total",22,4,8,10,6,0,2,4,16,4,6,6
"2011","Havant 017C","E01022939","Total",39,13,14,12,5,1,4,0,34,12,10,12
"2011","Havant 017D","E01022941","Total",25,6,9,10,2,0,2,0,23,6,7,10
"2011","Havant 018A","E01022899","Total",54,15,14,25,8,0,5,3,46,15,9,22
"2011","Havant 018B","E01022907","Total",19,13,3,3,0,0,0,0,19,13,3,3
"2011","Havant 018C","E01022909","Total",23,11,6,6,1,1,0,0,22,10,6,6
"2011","Havant 018D","E01022910","Total",41,9,11,21,3,0,1,2,38,9,10,19
"2011","Havant 018E","E01022911","Total",19,9,4,6,3,0,1,2,16,9,3,4
"2011","Havant 018F","E01032605","Total",16,5,5,6,4,0,1,3,12,5,4,3
"2011","Havant 019A","E01022919","Total",54,20,16,18,10,0,5,5,44,20,11,13
"2011","Havant 019B","E01022933","Total",111,28,17,66,14,2,4,8,97,26,13,58
"2011","Havant 019C","E01022934","Total",118,35,26,57,13,1,6,6,105,34,20,51
"2011","Havant 019D","E01032618","Total",46,14,15,17,9,1,6,2,37,13,9,15
"2011","Havant 020A","E01022918","Total",31,7,10,14,4,0,2,2,27,7,8,12
"2011","Havant 020B","E01022920","Total",29,10,9,10,5,0,5,0,24,10,4,10
"2011","Havant 020C","E01022921","Total",32,8,18,6,5,1,3,1,27,7,15,5
"2011","Havant 020D","E01032617","Total",31,11,10,10,1,0,1,0,30,11,9,10
"2011","New Forest 001A","E01023011","Total",30,12,9,9,4,0,4,0,26,12,5,9
"2011","New Forest 001B","E01023012","Total",18,8,7,3,2,0,2,0,16,8,5,3
"2011","New Forest 001C","E01023021","Total",21,12,9,0,5,1,4,0,16,11,5,0
"2011","New Forest 001D","E01023022","Total",63,32,13,18,3,0,2,1,60,32,11,17
"2011","New Forest 001E","E01023023","Total",36,20,7,9,6,0,3,3,30,20,4,6
"2011","New Forest 001F","E01023024","Total",28,14,10,4,3,1,1,1,25,13,9,3
"2011","New Forest 001G","E01023025","Total",10,2,7,1,4,0,3,1,6,2,4,0
"2011","New Forest 002A","E01023076","Total",18,10,4,4,2,1,0,1,16,9,4,3
"2011","New Forest 002B","E01023082","Total",48,25,7,16,4,0,1,3,44,25,6,13
"2011","New Forest 002C","E01023083","Total",54,17,19,18,7,0,7,0,47,17,12,18
"2011","New Forest 002D","E01023088","Total",52,21,10,21,3,0,3,0,49,21,7,21
"2011","New Forest 003A","E01023073","Total",41,19,14,8,7,0,4,3,34,19,10,5
"2011","New Forest 003B","E01023080","Total",50,18,13,19,5,0,2,3,45,18,11,16
"2011","New Forest 003C","E01023081","Total",53,20,15,18,3,0,2,1,50,20,13,17
"2011","New Forest 003D","E01023089","Total",35,13,12,10,6,0,4,2,29,13,8,8
"2011","New Forest 003E","E01023090","Total",62,18,20,24,9,0,4,5,53,18,16,19
"2011","New Forest 004A","E01023074","Total",23,7,13,3,5,0,5,0,18,7,8,3
"2011","New Forest 004B","E01023077","Total",65,24,12,29,5,2,3,0,60,22,9,29
"2011","New Forest 004C","E01023078","Total",10,4,5,1,2,1,1,0,8,3,4,1
"2011","New Forest 004D","E01023079","Total",45,18,12,15,1,1,0,0,44,17,12,15
"2011","New Forest 004E","E01023085","Total",67,24,17,26,4,0,3,1,63,24,14,25
"2011","New Forest 005A","E01023072","Total",33,15,9,9,4,0,3,1,29,15,6,8
"2011","New Forest 005B","E01023075","Total",36,16,9,11,1,0,0,1,35,16,9,10
"2011","New Forest 005C","E01023084","Total",30,14,8,8,2,0,1,1,28,14,7,7
"2011","New Forest 005D","E01023086","Total",54,28,9,17,4,1,2,1,50,27,7,16
"2011","New Forest 005E","E01023087","Total",47,19,21,7,1,0,1,0,46,19,20,7
"2011","New Forest 006A","E01022977","Total",6,4,2,0,1,0,1,0,5,4,1,0
"2011","New Forest 006B","E01022978","Total",22,10,4,8,1,1,0,0,21,9,4,8
"2011","New Forest 006C","E01022979","Total",12,6,1,5,1,1,0,0,11,5,1,5
"2011","New Forest 006D","E01022980","Total",10,6,2,2,2,1,1,0,8,5,1,2
"2011","New Forest 007A","E01022992","Total",8,3,3,2,1,1,0,0,7,2,3,2
"2011","New Forest 007B","E01022993","Total",15,5,7,3,7,2,4,1,8,3,3,2
"2011","New Forest 007C","E01023045","Total",21,9,7,5,1,0,1,0,20,9,6,5
"2011","New Forest 007D","E01023046","Total",31,13,11,7,1,0,0,1,30,13,11,6
"2011","New Forest 008A","E01023007","Total",16,6,5,5,3,0,3,0,13,6,2,5
"2011","New Forest 008B","E01023010","Total",75,28,21,26,3,1,1,1,72,27,20,25
"2011","New Forest 008C","E01023047","Total",36,13,13,10,5,1,3,1,31,12,10,9
"2011","New Forest 008D","E01023048","Total",28,12,7,9,0,0,0,0,28,12,7,9
"2011","New Forest 008E","E01023049","Total",53,18,23,12,9,0,6,3,44,18,17,9
"2011","New Forest 008F","E01023050","Total",51,19,12,20,5,1,4,0,46,18,8,20
"2011","New Forest 009A","E01023008","Total",26,6,9,11,4,0,4,0,22,6,5,11
"2011","New Forest 009B","E01023009","Total",41,17,19,5,7,0,7,0,34,17,12,5
"2011","New Forest 009C","E01023038","Total",23,6,10,7,2,0,2,0,21,6,8,7
"2011","New Forest 009D","E01023039","Total",38,19,8,11,4,0,1,3,34,19,7,8
"2011","New Forest 009E","E01023040","Total",20,9,4,7,2,0,2,0,18,9,2,7
"2011","New Forest 010A","E01023026","Total",15,2,8,5,1,0,1,0,14,2,7,5
"2011","New Forest 010B","E01023062","Total",26,11,10,5,5,1,3,1,21,10,7,4
"2011","New Forest 010C","E01023064","Total",47,23,13,11,4,0,3,1,43,23,10,10
"2011","New Forest 010D","E01023066","Total",17,5,7,5,1,0,1,0,16,5,6,5
"2011","New Forest 010E","E01023067","Total",20,15,4,1,0,0,0,0,20,15,4,1
"2011","New Forest 011A","E01023003","Total",31,10,9,12,7,0,5,2,24,10,4,10
"2011","New Forest 011B","E01023004","Total",39,18,6,15,3,0,2,1,36,18,4,14
"2011","New Forest 011C","E01023005","Total",17,8,7,2,2,1,1,0,15,7,6,2
"2011","New Forest 011D","E01023006","Total",82,28,14,40,8,3,2,3,74,25,12,37
"2011","New Forest 011E","E01023028","Total",63,20,21,22,4,0,4,0,59,20,17,22
"2011","New Forest 011F","E01023037","Total",65,20,15,30,9,0,4,5,56,20,11,25
"2011","New Forest 012A","E01023065","Total",36,16,9,11,3,0,3,0,33,16,6,11
"2011","New Forest 012B","E01023068","Total",42,15,11,16,5,1,2,2,37,14,9,14
"2011","New Forest 012C","E01023069","Total",40,17,14,9,5,0,5,0,35,17,9,9
"2011","New Forest 012D","E01023070","Total",74,33,19,22,6,0,4,2,68,33,15,20
"2011","New Forest 012E","E01023071","Total",39,25,8,6,6,4,1,1,33,21,7,5
"2011","New Forest 013A","E01023029","Total",109,44,12,53,5,3,2,0,104,41,10,53
"2011","New Forest 013B","E01023030","Total",36,18,11,7,6,2,2,2,30,16,9,5
"2011","New Forest 013C","E01023032","Total",23,8,8,7,6,1,3,2,17,7,5,5
"2011","New Forest 013D","E01023033","Total",45,19,8,18,0,0,0,0,45,19,8,18
"2011","New Forest 014A","E01023013","Total",37,17,8,12,4,1,3,0,33,16,5,12
"2011","New Forest 014B","E01023014","Total",44,17,8,19,5,2,3,0,39,15,5,19
"2011","New Forest 014C","E01023015","Total",35,20,7,8,2,0,2,0,33,20,5,8
"2011","New Forest 014D","E01023016","Total",8,5,3,0,0,0,0,0,8,5,3,0
"2011","New Forest 014E","E01023027","Total",42,13,11,18,3,0,2,1,39,13,9,17
"2011","New Forest 014F","E01023031","Total",39,15,12,12,7,0,6,1,32,15,6,11
"2011","New Forest 015A","E01022989","Total",29,14,7,8,3,1,1,1,26,13,6,7
"2011","New Forest 015B","E01022991","Total",15,10,2,3,0,0,0,0,15,10,2,3
"2011","New Forest 015C","E01022998","Total",15,4,1,10,1,0,1,0,14,4,0,10
"2011","New Forest 015D","E01023000","Total",35,17,11,7,5,2,1,2,30,15,10,5
"2011","New Forest 016A","E01022994","Total",20,7,9,4,0,0,0,0,20,7,9,4
"2011","New Forest 016B","E01022995","Total",22,8,9,5,1,0,1,0,21,8,8,5
"2011","New Forest 016C","E01022996","Total",20,7,5,8,4,1,2,1,16,6,3,7
"2011","New Forest 016D","E01022997","Total",23,9,6,8,3,0,2,1,20,9,4,7
"2011","New Forest 016E","E01023063","Total",16,3,8,5,0,0,0,0,16,3,8,5
"2011","New Forest 017A","E01022990","Total",30,8,10,12,3,0,3,0,27,8,7,12
"2011","New Forest 017B","E01022999","Total",27,12,8,7,4,1,3,0,23,11,5,7
"2011","New Forest 017C","E01023041","Total",22,12,6,4,3,0,2,1,19,12,4,3
"2011","New Forest 017D","E01023042","Total",33,15,10,8,4,1,3,0,29,14,7,8
"2011","New Forest 017E","E01023043","Total",56,18,23,15,11,3,8,0,45,15,15,15
"2011","New Forest 018A","E01022984","Total",11,4,3,4,2,0,2,0,9,4,1,4
"2011","New Forest 018B","E01022985","Total",30,14,8,8,4,2,2,0,26,12,6,8
"2011","New Forest 018C","E01023020","Total",17,13,1,3,1,0,1,0,16,13,0,3
"2011","New Forest 018D","E01023034","Total",36,18,9,9,5,0,3,2,31,18,6,7
"2011","New Forest 018E","E01023035","Total",36,20,8,8,3,1,0,2,33,19,8,6
"2011","New Forest 018F","E01023036","Total",21,9,5,7,4,0,2,2,17,9,3,5
"2011","New Forest 019A","E01023001","Total",58,23,21,14,7,1,6,0,51,22,15,14
"2011","New Forest 019B","E01023002","Total",73,25,25,23,6,1,3,2,67,24,22,21
"2011","New Forest 019C","E01023058","Total",86,36,13,37,9,5,2,2,77,31,11,35
"2011","New Forest 019D","E01023060","Total",22,11,3,8,2,1,1,0,20,10,2,8
"2011","New Forest 019E","E01023061","Total",45,19,17,9,10,4,4,2,35,15,13,7
"2011","New Forest 020A","E01023017","Total",76,31,11,34,7,1,4,2,69,30,7,32
"2011","New Forest 020B","E01023018","Total",59,18,9,32,8,3,2,3,51,15,7,29
"2011","New Forest 020C","E01023019","Total",65,27,11,27,2,1,1,0,63,26,10,27
"2011","New Forest 020D","E01023055","Total",66,34,9,23,8,2,2,4,58,32,7,19
"2011","New Forest 021A","E01022986","Total",26,10,9,7,2,0,2,0,24,10,7,7
"2011","New Forest 021B","E01022988","Total",55,20,13,22,10,4,2,4,45,16,11,18
"2011","New Forest 021C","E01023054","Total",36,15,9,12,3,0,2,1,33,15,7,11
"2011","New Forest 021D","E01023056","Total",43,9,9,25,6,3,3,0,37,6,6,25
"2011","New Forest 021E","E01023057","Total",34,15,6,13,2,1,1,0,32,14,5,13
"2011","New Forest 022A","E01022981","Total",18,10,4,4,4,1,2,1,14,9,2,3
"2011","New Forest 022B","E01022982","Total",19,12,3,4,4,1,3,0,15,11,0,4
"2011","New Forest 022C","E01022983","Total",20,11,3,6,1,0,1,0,19,11,2,6
"2011","New Forest 022D","E01022987","Total",22,11,6,5,3,1,2,0,19,10,4,5
"2011","New Forest 023A","E01023044","Total",6,1,4,1,1,0,1,0,5,1,3,1
"2011","New Forest 023B","E01023051","Total",15,7,5,3,0,0,0,0,15,7,5,3
"2011","New Forest 023C","E01023052","Total",17,7,7,3,2,0,1,1,15,7,6,2
"2011","New Forest 023D","E01023053","Total",16,10,5,1,1,0,1,0,15,10,4,1
"2011","New Forest 023E","E01023059","Total",25,10,7,8,2,0,1,1,23,10,6,7
"2011","Rushmoor 001A","E01023099","Total",60,19,8,33,5,0,3,2,55,19,5,31
"2011","Rushmoor 001B","E01023104","Total",46,11,15,20,9,1,6,2,37,10,9,18
"2011","Rushmoor 001C","E01023106","Total",61,22,18,21,7,0,5,2,54,22,13,19
"2011","Rushmoor 001D","E01023121","Total",61,14,22,25,4,0,3,1,57,14,19,24
"2011","Rushmoor 002A","E01023105","Total",61,16,19,26,3,1,2,0,58,15,17,26
"2011","Rushmoor 002B","E01023119","Total",71,17,16,38,3,0,3,0,68,17,13,38
"2011","Rushmoor 002C","E01023120","Total",54,15,12,27,2,0,1,1,52,15,11,26
"2011","Rushmoor 002D","E01023122","Total",62,26,8,28,3,0,1,2,59,26,7,26
"2011","Rushmoor 002E","E01023146","Total",54,25,10,19,2,0,0,2,52,25,10,17
"2011","Rushmoor 003A","E01023100","Total",48,20,21,7,4,0,4,0,44,20,17,7
"2011","Rushmoor 003B","E01023101","Total",17,8,6,3,1,0,1,0,16,8,5,3
"2011","Rushmoor 003C","E01023102","Total",23,5,13,5,2,0,2,0,21,5,11,5
"2011","Rushmoor 003D","E01023134","Total",34,11,18,5,1,0,1,0,33,11,17,5
"2011","Rushmoor 003E","E01023147","Total",26,3,11,12,1,0,1,0,25,3,10,12
"2011","Rushmoor 004A","E01023096","Total",45,14,15,16,3,0,3,0,42,14,12,16
"2011","Rushmoor 004B","E01023097","Total",12,6,5,1,1,1,0,0,11,5,5,1
"2011","Rushmoor 004C","E01023103","Total",19,6,9,4,1,0,1,0,18,6,8,4
"2011","Rushmoor 004D","E01023111","Total",26,7,16,3,1,0,1,0,25,7,15,3
"2011","Rushmoor 004E","E01023112","Total",31,18,10,3,2,0,2,0,29,18,8,3
"2011","Rushmoor 005A","E01023092","Total",23,4,13,6,2,0,2,0,21,4,11,6
"2011","Rushmoor 005B","E01023093","Total",19,11,6,2,1,1,0,0,18,10,6,2
"2011","Rushmoor 005C","E01023132","Total",29,9,14,6,3,1,2,0,26,8,12,6
"2011","Rushmoor 005D","E01023133","Total",29,7,10,12,1,1,0,0,28,6,10,12
"2011","Rushmoor 005E","E01023135","Total",75,24,19,32,3,0,3,0,72,24,16,32
"2011","Rushmoor 006A","E01023091","Total",74,21,10,43,3,2,1,0,71,19,9,43
"2011","Rushmoor 006B","E01023094","Total",26,11,7,8,0,0,0,0,26,11,7,8
"2011","Rushmoor 006C","E01023095","Total",48,15,11,22,3,2,0,1,45,13,11,21
"2011","Rushmoor 006D","E01023098","Total",33,8,14,11,1,0,0,1,32,8,14,10
"2011","Rushmoor 006E","E01023148","Total",18,4,7,7,3,0,3,0,15,4,4,7
"2011","Rushmoor 006F","E01023149","Total",11,6,1,4,2,1,1,0,9,5,0,4
"2011","Rushmoor 007A","E01023113","Total",51,13,20,18,7,1,4,2,44,12,16,16
"2011","Rushmoor 007B","E01023114","Total",26,9,9,8,6,0,5,1,20,9,4,7
"2011","Rushmoor 007C","E01023136","Total",28,4,13,11,2,0,2,0,26,4,11,11
"2011","Rushmoor 007D","E01023137","Total",37,11,14,12,7,0,5,2,30,11,9,10
"2011","Rushmoor 007E","E01023138","Total",37,14,16,7,6,2,4,0,31,12,12,7
"2011","Rushmoor 007F","E01023139","Total",25,12,5,8,1,0,1,0,24,12,4,8
"2011","Rushmoor 007G","E01023140","Total",37,6,23,8,3,0,3,0,34,6,20,8
"2011","Rushmoor 008A","E01023141","Total",42,11,26,5,3,0,3,0,39,11,23,5
"2011","Rushmoor 008B","E01023142","Total",46,17,13,16,6,2,3,1,40,15,10,15
"2011","Rushmoor 008C","E01023143","Total",33,9,17,7,8,0,7,1,25,9,10,6
"2011","Rushmoor 008D","E01023144","Total",47,12,12,23,4,0,2,2,43,12,10,21
"2011","Rushmoor 009A","E01023118","Total",47,16,18,13,4,1,3,0,43,15,15,13
"2011","Rushmoor 009B","E01023124","Total",26,9,8,9,4,0,3,1,22,9,5,8
"2011","Rushmoor 009C","E01023125","Total",66,24,20,22,5,1,4,0,61,23,16,22
"2011","Rushmoor 009F","E01032858","Total",116,35,27,54,11,4,6,1,105,31,21,53
"2011","Rushmoor 010A","E01023128","Total",26,11,7,8,5,0,3,2,21,11,4,6
"2011","Rushmoor 010B","E01023129","Total",30,13,7,10,0,0,0,0,30,13,7,10
"2011","Rushmoor 010C","E01023130","Total",26,7,14,5,4,0,3,1,22,7,11,4
"2011","Rushmoor 010D","E01023131","Total",18,6,3,9,2,1,0,1,16,5,3,8
"2011","Rushmoor 010E","E01023145","Total",43,14,16,13,2,1,1,0,41,13,15,13
"2011","Rushmoor 011A","E01023109","Total",37,12,16,9,1,0,1,0,36,12,15,9
"2011","Rushmoor 011B","E01023115","Total",20,5,10,5,3,1,1,1,17,4,9,4
"2011","Rushmoor 011C","E01023116","Total",45,15,17,13,2,0,2,0,43,15,15,13
"2011","Rushmoor 011D","E01023117","Total",29,8,17,4,3,0,3,0,26,8,14,4
"2011","Rushmoor 012A","E01023107","Total",46,18,8,20,1,0,1,0,45,18,7,20
"2011","Rushmoor 012B","E01023108","Total",43,18,9,16,2,1,1,0,41,17,8,16
"2011","Rushmoor 012C","E01023110","Total",75,26,21,28,6,0,5,1,69,26,16,27
"2011","Rushmoor 012D","E01023123","Total",36,15,8,13,3,0,2,1,33,15,6,12
"2011","Test Valley 001A","E01023165","Total",30,12,9,9,3,1,1,1,27,11,8,8
"2011","Test Valley 001B","E01023169","Total",19,6,11,2,3,0,3,0,16,6,8,2
"2011","Test Valley 001C","E01023181","Total",37,14,14,9,2,0,2,0,35,14,12,9
"2011","Test Valley 001D","E01023182","Total",46,13,24,9,8,0,8,0,38,13,16,9
"2011","Test Valley 002A","E01023153","Total",85,26,23,36,5,0,5,0,80,26,18,36
"2011","Test Valley 002B","E01023154","Total",96,27,20,49,6,1,4,1,90,26,16,48
"2011","Test Valley 002C","E01023156","Total",82,23,15,44,7,1,2,4,75,22,13,40
"2011","Test Valley 002D","E01023157","Total",76,22,12,42,6,1,1,4,70,21,11,38
"2011","Test Valley 002E","E01023205","Total",76,25,18,33,6,2,2,2,70,23,16,31
"2011","Test Valley 003A","E01023155","Total",68,18,14,36,5,1,1,3,63,17,13,33
"2011","Test Valley 003B","E01023201","Total",50,17,10,23,1,0,0,1,49,17,10,22
"2011","Test Valley 003C","E01023202","Total",57,12,26,19,11,0,10,1,46,12,16,18
"2011","Test Valley 003D","E01023215","Total",34,12,12,10,3,0,3,0,31,12,9,10
"2011","Test Valley 003E","E01023219","Total",40,17,9,14,5,0,2,3,35,17,7,11
"2011","Test Valley 004A","E01023179","Total",65,29,20,16,3,0,3,0,62,29,17,16
"2011","Test Valley 004B","E01023183","Total",45,20,9,16,4,1,2,1,41,19,7,15
"2011","Test Valley 004C","E01023190","Total",21,5,11,5,3,0,3,0,18,5,8,5
"2011","Test Valley 004D","E01023203","Total",26,9,8,9,0,0,0,0,26,9,8,9
"2011","Test Valley 004E","E01023204","Total",75,23,24,28,7,2,4,1,68,21,20,27
"2011","Test Valley 005B","E01023180","Total",35,15,14,6,5,2,3,0,30,13,11,6
"2011","Test Valley 005C","E01023186","Total",59,27,18,14,5,1,4,0,54,26,14,14
"2011","Test Valley 005D","E01023189","Total",32,15,12,5,6,0,5,1,26,15,7,4
"2011","Test Valley 005E","E01023196","Total",20,13,2,5,1,0,1,0,19,13,1,5
"2011","Test Valley 005F","E01032870","Total",29,14,12,3,1,0,1,0,28,14,11,3
"2011","Test Valley 005G","E01032871","Total",36,16,14,6,2,1,1,0,34,15,13,6
"2011","Test Valley 006A","E01023187","Total",24,10,8,6,1,0,0,1,23,10,8,5
"2011","Test Valley 006B","E01023188","Total",19,11,6,2,1,1,0,0,18,10,6,2
"2011","Test Valley 006C","E01023216","Total",60,19,25,16,7,1,5,1,53,18,20,15
"2011","Test Valley 006D","E01023217","Total",26,12,9,5,3,1,2,0,23,11,7,5
"2011","Test Valley 006E","E01023218","Total",21,10,5,6,3,1,1,1,18,9,4,5
"2011","Test Valley 007A","E01023159","Total",29,11,10,8,3,0,3,0,26,11,7,8
"2011","Test Valley 007B","E01023195","Total",17,5,9,3,1,0,1,0,16,5,8,3
"2011","Test Valley 007C","E01023197","Total",29,10,13,6,3,0,2,1,26,10,11,5
"2011","Test Valley 007D","E01023198","Total",16,6,6,4,1,0,0,1,15,6,6,3
"2011","Test Valley 008A","E01023160","Total",16,1,11,4,1,0,1,0,15,1,10,4
"2011","Test Valley 008B","E01023168","Total",12,4,4,4,2,0,1,1,10,4,3,3
"2011","Test Valley 008C","E01023178","Total",26,14,9,3,4,0,4,0,22,14,5,3
"2011","Test Valley 009A","E01023166","Total",28,9,11,8,5,0,5,0,23,9,6,8
"2011","Test Valley 009B","E01023167","Total",21,6,9,6,4,0,2,2,17,6,7,4
"2011","Test Valley 009C","E01023177","Total",33,8,16,9,6,0,5,1,27,8,11,8
"2011","Test Valley 009D","E01023184","Total",13,5,5,3,2,0,1,1,11,5,4,2
"2011","Test Valley 009E","E01023185","Total",24,11,9,4,3,0,3,0,21,11,6,4
"2011","Test Valley 010A","E01023174","Total",48,22,17,9,3,0,3,0,45,22,14,9
"2011","Test Valley 010B","E01023175","Total",28,11,10,7,2,0,2,0,26,11,8,7
"2011","Test Valley 010C","E01023176","Total",36,19,11,6,3,0,2,1,33,19,9,5
"2011","Test Valley 010D","E01023207","Total",19,5,10,4,2,0,2,0,17,5,8,4
"2011","Test Valley 010E","E01023208","Total",39,16,12,11,1,0,1,0,38,16,11,11
"2011","Test Valley 010F","E01023209","Total",28,13,11,4,2,0,2,0,26,13,9,4
"2011","Test Valley 011A","E01023150","Total",48,13,18,17,5,1,3,1,43,12,15,16
"2011","Test Valley 011B","E01023151","Total",56,17,8,31,6,1,0,5,50,16,8,26
"2011","Test Valley 011C","E01023152","Total",33,11,8,14,4,0,2,2,29,11,6,12
"2011","Test Valley 011D","E01023206","Total",29,10,10,9,1,1,0,0,28,9,10,9
"2011","Test Valley 012A","E01023158","Total",23,11,9,3,2,0,2,0,21,11,7,3
"2011","Test Valley 012B","E01023191","Total",45,20,18,7,4,1,3,0,41,19,15,7
"2011","Test Valley 012C","E01023192","Total",72,27,16,29,8,1,2,5,64,26,14,24
"2011","Test Valley 012D","E01023193","Total",26,12,9,5,3,0,3,0,23,12,6,5
"2011","Test Valley 012E","E01023194","Total",20,11,4,5,5,2,1,2,15,9,3,3
"2011","Test Valley 012F","E01023200","Total",27,8,12,7,3,0,3,0,24,8,9,7
"2011","Test Valley 013A","E01023162","Total",15,5,7,3,3,0,3,0,12,5,4,3
"2011","Test Valley 013B","E01023163","Total",19,10,5,4,2,0,1,1,17,10,4,3
"2011","Test Valley 013C","E01023164","Total",21,10,6,5,2,1,1,0,19,9,5,5
"2011","Test Valley 013D","E01023199","Total",30,14,8,8,3,0,2,1,27,14,6,7
"2011","Test Valley 014A","E01023210","Total",18,9,7,2,1,0,1,0,17,9,6,2
"2011","Test Valley 014B","E01023211","Total",61,32,21,8,8,5,3,0,53,27,18,8
"2011","Test Valley 014C","E01023212","Total",14,6,7,1,2,0,2,0,12,6,5,1
"2011","Test Valley 014D","E01023213","Total",29,9,13,7,3,0,2,1,26,9,11,6
"2011","Test Valley 014E","E01023214","Total",24,13,9,2,3,0,3,0,21,13,6,2
"2011","Test Valley 015A","E01023170","Total",64,32,12,20,6,0,5,1,58,32,7,19
"2011","Test Valley 015B","E01023171","Total",9,2,4,3,2,0,1,1,7,2,3,2
"2011","Test Valley 015C","E01023172","Total",17,8,7,2,2,1,1,0,15,7,6,2
"2011","Test Valley 015D","E01023173","Total",15,7,5,3,1,0,0,1,14,7,5,2
"2011","Winchester 001A","E01023286","Total",26,12,7,7,4,3,1,0,22,9,6,7
"2011","Winchester 001B","E01023287","Total",32,14,13,5,2,0,1,1,30,14,12,4
"2011","Winchester 001C","E01023288","Total",15,5,5,5,2,0,2,0,13,5,3,5
"2011","Winchester 002A","E01023236","Total",17,7,4,6,2,1,1,0,15,6,3,6
"2011","Winchester 002B","E01023237","Total",47,15,12,20,3,0,1,2,44,15,11,18
"2011","Winchester 002C","E01023238","Total",25,8,9,8,3,0,2,1,22,8,7,7
"2011","Winchester 002D","E01023239","Total",19,3,13,3,0,0,0,0,19,3,13,3
"2011","Winchester 003A","E01023240","Total",33,16,9,8,2,0,2,0,31,16,7,8
"2011","Winchester 003B","E01023241","Total",10,3,6,1,2,0,2,0,8,3,4,1
"2011","Winchester 003C","E01023248","Total",15,9,3,3,1,0,1,0,14,9,2,3
"2011","Winchester 003D","E01023253","Total",32,10,10,12,2,0,2,0,30,10,8,12
"2011","Winchester 003E","E01023274","Total",16,9,6,1,2,0,2,0,14,9,4,1
"2011","Winchester 004A","E01023225","Total",24,8,9,7,4,0,2,2,20,8,7,5
"2011","Winchester 004B","E01023278","Total",28,11,12,5,1,0,1,0,27,11,11,5
"2011","Winchester 004C","E01023279","Total",33,13,16,4,3,0,3,0,30,13,13,4
"2011","Winchester 004D","E01023280","Total",31,17,12,2,4,1,3,0,27,16,9,2
"2011","Winchester 004E","E01023281","Total",39,12,18,9,6,0,5,1,33,12,13,8
"2011","Winchester 005A","E01023247","Total",14,7,6,1,0,0,0,0,14,7,6,1
"2011","Winchester 005B","E01023249","Total",15,1,8,6,1,0,1,0,14,1,7,6
"2011","Winchester 005C","E01023250","Total",54,14,13,27,6,0,4,2,48,14,9,25
"2011","Winchester 005D","E01023268","Total",18,9,6,3,3,2,0,1,15,7,6,2
"2011","Winchester 005E","E01023269","Total",37,14,16,7,7,1,4,2,30,13,12,5
"2011","Winchester 005F","E01023270","Total",26,9,13,4,1,0,0,1,25,9,13,3
"2011","Winchester 006A","E01023251","Total",29,14,8,7,3,0,1,2,26,14,7,5
"2011","Winchester 006B","E01023255","Total",47,16,14,17,5,0,4,1,42,16,10,16
"2011","Winchester 006C","E01023256","Total",64,24,15,25,5,1,3,1,59,23,12,24
"2011","Winchester 006D","E01023257","Total",56,17,17,22,7,3,3,1,49,14,14,21
"2011","Winchester 006E","E01023258","Total",32,8,8,16,2,0,2,0,30,8,6,16
"2011","Winchester 007A","E01023252","Total",32,13,10,9,3,1,2,0,29,12,8,9
"2011","Winchester 007B","E01023254","Total",49,20,18,11,6,0,4,2,43,20,14,9
"2011","Winchester 007C","E01023263","Total",15,6,6,3,2,0,2,0,13,6,4,3
"2011","Winchester 007D","E01023264","Total",14,4,8,2,2,0,2,0,12,4,6,2
"2011","Winchester 007E","E01023265","Total",22,10,6,6,4,1,2,1,18,9,4,5
"2011","Winchester 007F","E01023267","Total",19,10,6,3,4,1,3,0,15,9,3,3
"2011","Winchester 008A","E01023260","Total",48,17,5,26,2,0,1,1,46,17,4,25
"2011","Winchester 008B","E01023261","Total",39,20,2,17,4,0,1,3,35,20,1,14
"2011","Winchester 008C","E01023262","Total",44,8,13,23,6,1,2,3,38,7,11,20
"2011","Winchester 008D","E01023266","Total",26,10,5,11,3,0,1,2,23,10,4,9
"2011","Winchester 009A","E01023229","Total",19,5,10,4,1,0,0,1,18,5,10,3
"2011","Winchester 009B","E01023242","Total",11,3,5,3,0,0,0,0,11,3,5,3
"2011","Winchester 009C","E01023243","Total",32,9,17,6,7,3,3,1,25,6,14,5
"2011","Winchester 009D","E01023244","Total",19,5,7,7,0,0,0,0,19,5,7,7
"2011","Winchester 009E","E01023259","Total",30,13,4,13,3,0,0,3,27,13,4,10
"2011","Winchester 010A","E01023226","Total",22,9,10,3,0,0,0,0,22,9,10,3
"2011","Winchester 010B","E01023227","Total",42,22,11,9,2,1,1,0,40,21,10,9
"2011","Winchester 010C","E01023228","Total",26,15,7,4,2,0,2,0,24,15,5,4
"2011","Winchester 010D","E01023230","Total",18,9,5,4,1,0,1,0,17,9,4,4
"2011","Winchester 010E","E01023246","Total",14,5,5,4,2,0,2,0,12,5,3,4
"2011","Winchester 011A","E01023235","Total",26,13,6,7,2,2,0,0,24,11,6,7
"2011","Winchester 011B","E01023275","Total",26,11,10,5,2,0,2,0,24,11,8,5
"2011","Winchester 011C","E01023276","Total",21,11,5,5,2,0,2,0,19,11,3,5
"2011","Winchester 011D","E01023277","Total",9,3,5,1,3,0,3,0,6,3,2,1
"2011","Winchester 011E","E01023282","Total",22,9,4,9,4,2,1,1,18,7,3,8
"2011","Winchester 012A","E01023220","Total",45,22,9,14,6,1,4,1,39,21,5,13
"2011","Winchester 012B","E01023221","Total",41,14,17,10,2,1,1,0,39,13,16,10
"2011","Winchester 012C","E01023222","Total",11,5,2,4,0,0,0,0,11,5,2,4
"2011","Winchester 012D","E01023223","Total",41,15,11,15,6,0,3,3,35,15,8,12
"2011","Winchester 012E","E01023272","Total",30,13,8,9,2,1,1,0,28,12,7,9
"2011","Winchester 012F","E01023273","Total",19,6,10,3,4,0,3,1,15,6,7,2
"2011","Winchester 013A","E01023245","Total",27,16,8,3,1,0,1,0,26,16,7,3
"2011","Winchester 013B","E01023271","Total",14,6,4,4,1,0,1,0,13,6,3,4
"2011","Winchester 013D","E01023284","Total",67,26,25,16,3,0,3,0,64,26,22,16
"2011","Winchester 013E","E01023285","Total",29,7,11,11,5,0,4,1,24,7,7,10
"2011","Winchester 013F","E01032859","Total",42,17,16,9,3,0,3,0,39,17,13,9
"2011","Winchester 013G","E01032860","Total",51,20,17,14,6,1,5,0,45,19,12,14
"2011","Winchester 014A","E01023224","Total",28,14,9,5,6,1,3,2,22,13,6,3
"2011","Winchester 014B","E01023231","Total",21,9,10,2,5,0,3,2,16,9,7,0
"2011","Winchester 014C","E01023232","Total",22,8,10,4,3,0,3,0,19,8,7,4
"2011","Winchester 014D","E01023233","Total",20,12,5,3,3,0,2,1,17,12,3,2
"2011","Winchester 014E","E01023234","Total",29,15,11,3,2,0,2,0,27,15,9,3
"2011","Ashford 001B","E01023987","Total",13,5,5,3,1,0,1,0,12,5,4,3
"2011","Ashford 001C","E01023988","Total",16,3,7,6,3,0,3,0,13,3,4,6
"2011","Ashford 001D","E01024040","Total",28,9,9,10,4,0,4,0,24,9,5,10
"2011","Ashford 001E","E01024041","Total",16,6,4,6,0,0,0,0,16,6,4,6
"2011","Ashford 001F","E01032810","Total",80,32,27,21,8,2,5,1,72,30,22,20
"2011","Ashford 001G","E01032812","Total",36,17,14,5,6,1,3,2,30,16,11,3
"2011","Ashford 002A","E01023985","Total",13,4,6,3,4,0,4,0,9,4,2,3
"2011","Ashford 002B","E01023986","Total",26,10,8,8,2,0,1,1,24,10,7,7
"2011","Ashford 002C","E01023989","Total",12,9,2,1,2,0,2,0,10,9,0,1
"2011","Ashford 002D","E01023990","Total",32,13,4,15,2,1,1,0,30,12,3,15
"2011","Ashford 002E","E01024033","Total",24,5,9,10,3,0,1,2,21,5,8,8
"2011","Ashford 002F","E01024035","Total",12,5,4,3,0,0,0,0,12,5,4,3
"2011","Ashford 003A","E01023983","Total",22,8,7,7,3,0,3,0,19,8,4,7
"2011","Ashford 003B","E01023999","Total",34,14,11,9,7,2,5,0,27,12,6,9
"2011","Ashford 003D","E01032811","Total",67,19,25,23,6,1,3,2,61,18,22,21
"2011","Ashford 003E","E01032822","Total",22,12,3,7,1,0,1,0,21,12,2,7
"2011","Ashford 004A","E01023980","Total",36,13,7,16,4,0,1,3,32,13,6,13
"2011","Ashford 004B","E01023981","Total",39,7,17,15,7,0,6,1,32,7,11,14
"2011","Ashford 004C","E01023984","Total",79,23,17,39,7,1,3,3,72,22,14,36
"2011","Ashford 004E","E01023992","Total",57,18,15,24,0,0,0,0,57,18,15,24
"2011","Ashford 004F","E01023993","Total",40,15,17,8,4,0,4,0,36,15,13,8
"2011","Ashford 004G","E01024021","Total",50,15,18,17,5,0,1,4,45,15,17,13
"2011","Ashford 004H","E01024022","Total",40,18,5,17,1,0,1,0,39,18,4,17
"2011","Ashford 004I","E01032820","Total",49,13,18,18,4,0,3,1,45,13,15,17
"2011","Ashford 004J","E01032821","Total",34,9,17,8,2,1,1,0,32,8,16,8
"2011","Ashford 005A","E01023973","Total",100,28,20,52,11,1,6,4,89,27,14,48
"2011","Ashford 005B","E01024002","Total",64,17,22,25,8,1,5,2,56,16,17,23
"2011","Ashford 005C","E01024023","Total",99,40,30,29,12,4,7,1,87,36,23,28
"2011","Ashford 005D","E01024027","Total",63,25,13,25,6,0,4,2,57,25,9,23
"2011","Ashford 005E","E01024029","Total",82,34,20,28,7,0,5,2,75,34,15,26
"2011","Ashford 006A","E01023972","Total",42,15,11,16,7,2,4,1,35,13,7,15
"2011","Ashford 006B","E01023995","Total",15,11,3,1,1,0,1,0,14,11,2,1
"2011","Ashford 006C","E01023996","Total",35,15,13,7,4,0,3,1,31,15,10,6
"2011","Ashford 006D","E01024003","Total",38,17,8,13,3,0,2,1,35,17,6,12
"2011","Ashford 006E","E01024004","Total",19,7,10,2,2,0,2,0,17,7,8,2
"2011","Ashford 006F","E01024005","Total",45,12,14,19,3,0,1,2,42,12,13,17
"2011","Ashford 007A","E01023974","Total",64,25,8,31,10,4,3,3,54,21,5,28
"2011","Ashford 007B","E01023975","Total",70,18,15,37,5,1,2,2,65,17,13,35
"2011","Ashford 007C","E01023977","Total",33,13,5,15,1,0,1,0,32,13,4,15
"2011","Ashford 007D","E01024016","Total",48,15,22,11,11,2,9,0,37,13,13,11
"2011","Ashford 007E","E01024017","Total",55,21,17,17,9,3,4,2,46,18,13,15
"2011","Ashford 007F","E01024028","Total",110,34,14,62,6,0,3,3,104,34,11,59
"2011","Ashford 008A","E01023976","Total",49,15,7,27,10,1,3,6,39,14,4,21
"2011","Ashford 008B","E01024019","Total",79,27,9,43,6,2,1,3,73,25,8,40
"2011","Ashford 008C","E01024020","Total",140,39,21,80,6,0,4,2,134,39,17,78
"2011","Ashford 008E","E01032816","Total",50,15,24,11,4,0,3,1,46,15,21,10
"2011","Ashford 008F","E01032823","Total",55,21,8,26,2,0,2,0,53,21,6,26
"2011","Ashford 009A","E01024001","Total",63,23,13,27,10,2,4,4,53,21,9,23
"2011","Ashford 009B","E01024006","Total",28,17,4,7,3,2,1,0,25,15,3,7
"2011","Ashford 009D","E01024008","Total",72,35,23,14,4,1,2,1,68,34,21,13
"2011","Ashford 009F","E01032815","Total",54,14,15,25,2,0,2,0,52,14,13,25
"2011","Ashford 009G","E01032817","Total",58,18,15,25,5,0,4,1,53,18,11,24
"2011","Ashford 009H","E01032818","Total",68,25,19,24,7,1,5,1,61,24,14,23
"2011","Ashford 009I","E01032819","Total",65,22,20,23,4,0,4,0,61,22,16,23
"2011","Ashford 009J","E01032824","Total",40,15,10,15,2,0,1,1,38,15,9,14
"2011","Ashford 010A","E01024013","Total",40,15,18,7,8,1,6,1,32,14,12,6
"2011","Ashford 010B","E01024014","Total",29,10,8,11,5,0,3,2,24,10,5,9
"2011","Ashford 010C","E01024015","Total",14,9,4,1,1,0,1,0,13,9,3,1
"2011","Ashford 010D","E01024034","Total",38,20,8,10,6,3,1,2,32,17,7,8
"2011","Ashford 011A","E01023978","Total",14,6,3,5,2,0,2,0,12,6,1,5
"2011","Ashford 011B","E01023979","Total",48,24,14,10,3,0,1,2,45,24,13,8
"2011","Ashford 011C","E01024032","Total",29,11,6,12,3,0,1,2,26,11,5,10
"2011","Ashford 011D","E01024036","Total",19,10,6,3,3,0,2,1,16,10,4,2
"2011","Ashford 012B","E01024031","Total",29,12,10,7,6,2,4,0,23,10,6,7
"2011","Ashford 012C","E01024038","Total",23,9,6,8,1,0,1,0,22,9,5,8
"2011","Ashford 012D","E01024039","Total",17,7,4,6,1,0,1,0,16,7,3,6
"2011","Ashford 012E","E01032813","Total",68,29,23,16,3,1,2,0,65,28,21,16
"2011","Ashford 012F","E01032814","Total",40,17,10,13,2,1,0,1,38,16,10,12
"2011","Ashford 013A","E01024009","Total",15,9,3,3,0,0,0,0,15,9,3,3
"2011","Ashford 013B","E01024010","Total",26,7,6,13,5,0,4,1,21,7,2,12
"2011","Ashford 013C","E01024011","Total",23,9,5,9,2,1,1,0,21,8,4,9
"2011","Ashford 013D","E01024012","Total",24,11,3,10,4,1,2,1,20,10,1,9
"2011","Ashford 013E","E01024024","Total",52,26,15,11,5,1,3,1,47,25,12,10
"2011","Ashford 013F","E01024025","Total",57,32,10,15,6,1,2,3,51,31,8,12
"2011","Ashford 014A","E01023997","Total",27,13,5,9,3,1,2,0,24,12,3,9
"2011","Ashford 014B","E01023998","Total",26,10,6,10,4,1,2,1,22,9,4,9
"2011","Ashford 014C","E01024026","Total",17,6,8,3,2,0,2,0,15,6,6,3
"2011","Ashford 014D","E01024037","Total",42,15,17,10,3,0,3,0,39,15,14,10
"2011","Canterbury 001A","E01024078","Total",100,21,29,50,12,1,5,6,88,20,24,44
"2011","Canterbury 001B","E01024080","Total",69,27,18,24,7,2,3,2,62,25,15,22
"2011","Canterbury 001C","E01024081","Total",59,18,13,28,6,1,3,2,53,17,10,26
"2011","Canterbury 001D","E01024082","Total",59,18,11,30,6,2,1,3,53,16,10,27
"2011","Canterbury 001E","E01024095","Total",48,25,12,11,5,0,4,1,43,25,8,10
"2011","Canterbury 002A","E01024094","Total",43,21,12,10,2,0,2,0,41,21,10,10
"2011","Canterbury 002B","E01024096","Total",32,12,9,11,5,0,3,2,27,12,6,9
"2011","Canterbury 002C","E01024097","Total",27,4,12,11,7,0,4,3,20,4,8,8
"2011","Canterbury 002D","E01024098","Total",36,17,9,10,3,1,1,1,33,16,8,9
"2011","Canterbury 003A","E01024064","Total",45,24,13,8,5,1,4,0,40,23,9,8
"2011","Canterbury 003B","E01024066","Total",83,26,10,47,6,1,2,3,77,25,8,44
"2011","Canterbury 003C","E01024079","Total",36,19,9,8,3,1,2,0,33,18,7,8
"2011","Canterbury 003D","E01024083","Total",59,21,7,31,7,2,1,4,52,19,6,27
"2011","Canterbury 003E","E01024118","Total",46,16,12,18,2,0,2,0,44,16,10,18
"2011","Canterbury 004A","E01024059","Total",54,19,13,22,6,2,2,2,48,17,11,20
"2011","Canterbury 004B","E01024065","Total",52,29,8,15,6,3,2,1,46,26,6,14
"2011","Canterbury 004C","E01024117","Total",26,10,4,12,2,0,2,0,24,10,2,12
"2011","Canterbury 004D","E01024119","Total",95,29,24,42,14,1,10,3,81,28,14,39
"2011","Canterbury 004E","E01024120","Total",36,18,6,12,2,0,0,2,34,18,6,10
"2011","Canterbury 005A","E01024056","Total",22,10,6,6,4,1,3,0,18,9,3,6
"2011","Canterbury 005B","E01024057","Total",19,5,8,6,5,0,4,1,14,5,4,5
"2011","Canterbury 005C","E01024058","Total",41,19,12,10,3,0,3,0,38,19,9,10
"2011","Canterbury 005D","E01024114","Total",31,13,13,5,5,2,3,0,26,11,10,5
"2011","Canterbury 005E","E01024115","Total",27,11,10,6,2,2,0,0,25,9,10,6
"2011","Canterbury 006A","E01024073","Total",57,21,18,18,4,0,4,0,53,21,14,18
"2011","Canterbury 006B","E01024074","Total",34,17,10,7,5,2,2,1,29,15,8,6
"2011","Canterbury 006C","E01024075","Total",36,18,3,15,0,0,0,0,36,18,3,15
"2011","Canterbury 006D","E01024076","Total",51,14,20,17,4,0,4,0,47,14,16,17
"2011","Canterbury 006E","E01024077","Total",49,19,13,17,3,0,1,2,46,19,12,15
"2011","Canterbury 007A","E01024055","Total",27,10,7,10,3,1,1,1,24,9,6,9
"2011","Canterbury 007B","E01024061","Total",83,14,11,58,8,0,1,7,75,14,10,51
"2011","Canterbury 007C","E01024063","Total",32,16,12,4,4,0,3,1,28,16,9,3
"2011","Canterbury 007D","E01024071","Total",72,32,17,23,4,0,2,2,68,32,15,21
"2011","Canterbury 007E","E01024116","Total",22,13,5,4,2,0,0,2,20,13,5,2
"2011","Canterbury 008A","E01024060","Total",52,24,17,11,4,0,4,0,48,24,13,11
"2011","Canterbury 008B","E01024069","Total",61,24,19,18,7,1,4,2,54,23,15,16
"2011","Canterbury 008C","E01024070","Total",44,20,15,9,5,2,3,0,39,18,12,9
"2011","Canterbury 008D","E01024072","Total",67,32,22,13,5,1,4,0,62,31,18,13
"2011","Canterbury 008E","E01024106","Total",38,16,13,9,4,2,2,0,34,14,11,9
"2011","Canterbury 009A","E01024062","Total",40,16,11,13,3,0,3,0,37,16,8,13
"2011","Canterbury 009B","E01024105","Total",23,8,7,8,2,1,0,1,21,7,7,7
"2011","Canterbury 009C","E01024107","Total",33,10,11,12,6,1,5,0,27,9,6,12
"2011","Canterbury 009D","E01024108","Total",49,17,2,30,3,1,1,1,46,16,1,29
"2011","Canterbury 009E","E01024109","Total",40,16,12,12,0,0,0,0,40,16,12,12
"2011","Canterbury 010A","E01024084","Total",43,11,17,15,1,0,1,0,42,11,16,15
"2011","Canterbury 010B","E01024085","Total",31,8,15,8,5,1,3,1,26,7,12,7
"2011","Canterbury 010C","E01024086","Total",75,19,18,38,7,1,4,2,68,18,14,36
"2011","Canterbury 010D","E01024087","Total",17,6,4,7,0,0,0,0,17,6,4,7
"2011","Canterbury 011A","E01024091","Total",57,17,9,31,3,0,2,1,54,17,7,30
"2011","Canterbury 011B","E01024110","Total",13,6,3,4,0,0,0,0,13,6,3,4
"2011","Canterbury 011C","E01024111","Total",72,20,18,34,12,1,6,5,60,19,12,29
"2011","Canterbury 011D","E01024112","Total",26,14,6,6,1,0,0,1,25,14,6,5
"2011","Canterbury 011E","E01024113","Total",23,10,6,7,3,1,1,1,20,9,5,6
"2011","Canterbury 012C","E01024067","Total",13,5,5,3,0,0,0,0,13,5,5,3
"2011","Canterbury 012D","E01024068","Total",25,11,9,5,3,0,2,1,22,11,7,4
"2011","Canterbury 012E","E01024123","Total",24,13,7,4,2,1,1,0,22,12,6,4
"2011","Canterbury 012F","E01032809","Total",41,13,15,13,2,0,2,0,39,13,13,13
"2011","Canterbury 013A","E01024099","Total",59,17,11,31,8,1,4,3,51,16,7,28
"2011","Canterbury 013B","E01024100","Total",32,4,6,22,1,0,0,1,31,4,6,21
"2011","Canterbury 013C","E01024101","Total",34,16,5,13,3,2,1,0,31,14,4,13
"2011","Canterbury 013D","E01024102","Total",22,6,9,7,1,0,0,1,21,6,9,6
"2011","Canterbury 013E","E01024103","Total",48,16,9,23,3,0,1,2,45,16,8,21
"2011","Canterbury 014A","E01024047","Total",39,8,8,23,7,0,4,3,32,8,4,20
"2011","Canterbury 014B","E01024049","Total",67,19,9,39,4,0,1,3,63,19,8,36
"2011","Canterbury 014C","E01024090","Total",64,15,5,44,5,2,1,2,59,13,4,42
"2011","Canterbury 014D","E01024092","Total",37,8,8,21,2,0,0,2,35,8,8,19
"2011","Canterbury 014E","E01024093","Total",69,23,9,37,5,1,0,4,64,22,9,33
"2011","Canterbury 016A","E01024044","Total",36,9,11,16,3,0,1,2,33,9,10,14
"2011","Canterbury 016B","E01024045","Total",25,8,8,9,1,0,1,0,24,8,7,9
"2011","Canterbury 016C","E01024046","Total",30,6,17,7,4,0,4,0,26,6,13,7
"2011","Canterbury 016D","E01024048","Total",44,10,8,26,3,0,2,1,41,10,6,25
"2011","Canterbury 016E","E01024131","Total",26,7,13,6,5,0,5,0,21,7,8,6
"2011","Canterbury 017A","E01024052","Total",82,25,26,31,8,1,6,1,74,24,20,30
"2011","Canterbury 017B","E01024053","Total",42,13,19,10,7,1,6,0,35,12,13,10
"2011","Canterbury 017C","E01024054","Total",34,15,11,8,2,0,0,2,32,15,11,6
"2011","Canterbury 017D","E01024127","Total",35,14,8,13,1,0,1,0,34,14,7,13
"2011","Canterbury 018A","E01024042","Total",27,10,4,13,0,0,0,0,27,10,4,13
"2011","Canterbury 018B","E01024043","Total",20,8,10,2,5,0,5,0,15,8,5,2
"2011","Canterbury 018C","E01024088","Total",33,16,5,12,2,0,1,1,31,16,4,11
"2011","Canterbury 018D","E01024089","Total",17,4,11,2,1,0,1,0,16,4,10,2
"2011","Canterbury 019A","E01024128","Total",82,26,8,48,4,1,2,1,78,25,6,47
"2011","Canterbury 019B","E01024129","Total",33,11,7,15,2,0,0,2,31,11,7,13
"2011","Canterbury 019C","E01024130","Total",70,24,22,24,2,0,0,2,68,24,22,22
"2011","Canterbury 020A","E01024104","Total",37,13,11,13,6,1,3,2,31,12,8,11
"2011","Canterbury 020B","E01024121","Total",17,4,7,6,3,1,2,0,14,3,5,6
"2011","Canterbury 020C","E01024122","Total",43,18,8,17,4,1,0,3,39,17,8,14
"2011","Canterbury 020D","E01024124","Total",11,6,3,2,2,0,2,0,9,6,1,2
"2011","Canterbury 020E","E01024126","Total",67,13,12,42,7,2,3,2,60,11,9,40
"2011","Canterbury 020F","E01032807","Total",33,9,16,8,2,0,0,2,31,9,16,6
"2011","Canterbury 020G","E01032808","Total",63,20,7,36,5,0,1,4,58,20,6,32
"2011","Dartford 001A","E01024148","Total",109,29,20,60,8,0,1,7,101,29,19,53
"2011","Dartford 001B","E01024149","Total",161,44,38,79,12,2,3,7,149,42,35,72
"2011","Dartford 001C","E01024154","Total",57,14,11,32,2,1,0,1,55,13,11,31
"2011","Dartford 001D","E01024155","Total",80,24,8,48,5,1,1,3,75,23,7,45
"2011","Dartford 002A","E01024140","Total",98,36,32,30,3,1,2,0,95,35,30,30
"2011","Dartford 002B","E01024141","Total",45,11,20,14,5,0,5,0,40,11,15,14
"2011","Dartford 002C","E01024143","Total",56,14,22,20,4,0,3,1,52,14,19,19
"2011","Dartford 002D","E01024179","Total",137,44,33,60,7,1,3,3,130,43,30,57
"2011","Dartford 003A","E01024180","Total",52,16,16,20,6,1,4,1,46,15,12,19
"2011","Dartford 003B","E01024181","Total",41,12,22,7,6,0,6,0,35,12,16,7
"2011","Dartford 003C","E01024182","Total",41,13,9,19,3,1,1,1,38,12,8,18
"2011","Dartford 003D","E01024183","Total",21,8,9,4,2,0,2,0,19,8,7,4
"2011","Dartford 003E","E01024184","Total",70,21,22,27,4,0,4,0,66,21,18,27
"2011","Dartford 003F","E01024185","Total",55,14,16,25,8,1,5,2,47,13,11,23
"2011","Dartford 004A","E01024142","Total",102,38,25,39,7,1,4,2,95,37,21,37
"2011","Dartford 004B","E01024176","Total",83,25,18,40,8,0,5,3,75,25,13,37
"2011","Dartford 004C","E01024177","Total",116,34,16,66,8,3,3,2,108,31,13,64
"2011","Dartford 004D","E01024178","Total",63,26,11,26,5,0,3,2,58,26,8,24
"2011","Dartford 005A","E01024156","Total",52,18,19,15,2,0,0,2,50,18,19,13
"2011","Dartford 005B","E01024161","Total",77,28,24,25,11,0,5,6,66,28,19,19
"2011","Dartford 005C","E01024162","Total",44,12,13,19,2,0,2,0,42,12,11,19
"2011","Dartford 005D","E01024163","Total",51,16,19,16,0,0,0,0,51,16,19,16
"2011","Dartford 005E","E01024164","Total",59,15,29,15,4,0,4,0,55,15,25,15
"2011","Dartford 006A","E01024169","Total",55,21,15,19,4,1,2,1,51,20,13,18
"2011","Dartford 006B","E01024170","Total",81,28,16,37,10,2,6,2,71,26,10,35
"2011","Dartford 006C","E01024171","Total",46,18,17,11,6,0,4,2,40,18,13,9
"2011","Dartford 006D","E01024172","Total",64,18,21,25,10,2,7,1,54,16,14,24
"2011","Dartford 007A","E01024144","Total",19,6,10,3,5,0,4,1,14,6,6,2
"2011","Dartford 007B","E01024145","Total",30,10,12,8,6,0,6,0,24,10,6,8
"2011","Dartford 007C","E01024146","Total",19,3,13,3,4,0,3,1,15,3,10,2
"2011","Dartford 007D","E01024147","Total",29,13,10,6,4,0,2,2,25,13,8,4
"2011","Dartford 007E","E01024186","Total",34,16,8,10,4,0,4,0,30,16,4,10
"2011","Dartford 008A","E01024133","Total",26,12,12,2,1,0,0,1,25,12,12,1
"2011","Dartford 008B","E01024136","Total",42,17,14,11,3,0,2,1,39,17,12,10
"2011","Dartford 008C","E01024137","Total",34,7,16,11,5,0,3,2,29,7,13,9
"2011","Dartford 008D","E01024138","Total",80,26,19,35,6,0,3,3,74,26,16,32
"2011","Dartford 008E","E01024139","Total",27,14,11,2,1,0,1,0,26,14,10,2
"2011","Dartford 009A","E01024165","Total",86,31,10,45,10,4,3,3,76,27,7,42
"2011","Dartford 009B","E01024166","Total",83,26,23,34,7,1,4,2,76,25,19,32
"2011","Dartford 009C","E01024167","Total",76,26,25,25,7,3,4,0,69,23,21,25
"2011","Dartford 009D","E01024168","Total",44,14,12,18,7,2,3,2,37,12,9,16
"2011","Dartford 010A","E01024150","Total",21,7,7,7,4,0,3,1,17,7,4,6
"2011","Dartford 010B","E01024151","Total",16,5,7,4,3,1,2,0,13,4,5,4
"2011","Dartford 010C","E01024152","Total",117,50,27,40,12,4,3,5,105,46,24,35
"2011","Dartford 010D","E01024153","Total",16,4,8,4,2,0,2,0,14,4,6,4
"2011","Dartford 011A","E01024173","Total",33,7,13,13,2,0,2,0,31,7,11,13
"2011","Dartford 011B","E01024187","Total",15,8,5,2,2,0,2,0,13,8,3,2
"2011","Dartford 011C","E01024188","Total",19,7,8,4,2,0,2,0,17,7,6,4
"2011","Dartford 011D","E01024189","Total",40,11,16,13,3,0,2,1,37,11,14,12
"2011","Dartford 012A","E01024132","Total",37,11,8,18,7,1,4,2,30,10,4,16
"2011","Dartford 012B","E01024134","Total",60,20,18,22,5,1,4,0,55,19,14,22
"2011","Dartford 012C","E01024135","Total",50,15,10,25,5,0,2,3,45,15,8,22
"2011","Dartford 012D","E01024174","Total",23,10,8,5,1,0,1,0,22,10,7,5
"2011","Dartford 012E","E01024175","Total",34,13,10,11,2,0,2,0,32,13,8,11
"2011","Dartford 013A","E01024157","Total",31,16,9,6,4,0,4,0,27,16,5,6
"2011","Dartford 013B","E01024158","Total",26,7,11,8,1,0,1,0,25,7,10,8
"2011","Dartford 013C","E01024159","Total",9,5,2,2,3,1,2,0,6,4,0,2
"2011","Dartford 013D","E01024160","Total",17,6,7,4,4,0,4,0,13,6,3,4
"2011","Dover 001A","E01024206","Total",26,13,6,7,3,1,2,0,23,12,4,7
"2011","Dover 001B","E01024207","Total",27,11,12,4,1,0,1,0,26,11,11,4
"2011","Dover 001C","E01024208","Total",34,17,7,10,6,4,1,1,28,13,6,9
"2011","Dover 001D","E01024209","Total",30,9,12,9,6,0,4,2,24,9,8,7
"2011","Dover 002A","E01024202","Total",41,18,9,14,6,1,4,1,35,17,5,13
"2011","Dover 002B","E01024242","Total",27,15,8,4,4,1,2,1,23,14,6,3
"2011","Dover 002C","E01024243","Total",60,27,19,14,6,1,5,0,54,26,14,14
"2011","Dover 002D","E01024244","Total",41,17,15,9,4,2,1,1,37,15,14,8
"2011","Dover 002E","E01024245","Total",38,17,8,13,3,0,2,1,35,17,6,12
"2011","Dover 003A","E01024219","Total",45,18,14,13,4,1,3,0,41,17,11,13
"2011","Dover 003B","E01024220","Total",34,13,13,8,3,0,3,0,31,13,10,8
"2011","Dover 003C","E01024221","Total",41,12,13,16,2,0,1,1,39,12,12,15
"2011","Dover 003D","E01024227","Total",53,16,15,22,5,1,2,2,48,15,13,20
"2011","Dover 003E","E01024229","Total",37,14,10,13,6,1,4,1,31,13,6,12
"2011","Dover 004A","E01024228","Total",36,14,10,12,5,1,2,2,31,13,8,10
"2011","Dover 004B","E01024230","Total",36,16,8,12,4,0,2,2,32,16,6,10
"2011","Dover 004C","E01024231","Total",40,16,12,12,6,0,3,3,34,16,9,9
"2011","Dover 004D","E01024252","Total",49,26,13,10,4,2,2,0,45,24,11,10
"2011","Dover 005A","E01024201","Total",23,13,4,6,2,0,0,2,21,13,4,4
"2011","Dover 005B","E01024217","Total",56,25,11,20,6,1,3,2,50,24,8,18
"2011","Dover 005C","E01024223","Total",52,22,14,16,2,1,1,0,50,21,13,16
"2011","Dover 005D","E01024225","Total",54,31,14,9,4,2,2,0,50,29,12,9
"2011","Dover 005E","E01024226","Total",52,18,12,22,9,2,4,3,43,16,8,19
"2011","Dover 006A","E01024190","Total",34,12,12,10,7,1,3,3,27,11,9,7
"2011","Dover 006B","E01024191","Total",52,19,18,15,4,1,2,1,48,18,16,14
"2011","Dover 006C","E01024192","Total",78,27,15,36,6,1,1,4,72,26,14,32
"2011","Dover 006D","E01024204","Total",39,17,7,15,3,1,1,1,36,16,6,14
"2011","Dover 007A","E01024218","Total",71,21,16,34,11,1,5,5,60,20,11,29
"2011","Dover 007B","E01024222","Total",73,30,14,29,10,2,7,1,63,28,7,28
"2011","Dover 007C","E01024224","Total",30,13,14,3,6,2,3,1,24,11,11,2
"2011","Dover 007D","E01024250","Total",48,21,12,15,6,0,4,2,42,21,8,13
"2011","Dover 007E","E01024251","Total",30,10,9,11,10,1,3,6,20,9,6,5
"2011","Dover 008A","E01024200","Total",26,12,9,5,6,2,3,1,20,10,6,4
"2011","Dover 008B","E01024203","Total",19,4,6,9,3,0,1,2,16,4,5,7
"2011","Dover 008C","E01024205","Total",44,21,10,13,5,2,2,1,39,19,8,12
"2011","Dover 008D","E01024255","Total",25,7,10,8,6,0,4,2,19,7,6,6
"2011","Dover 009A","E01024232","Total",28,11,8,9,3,0,2,1,25,11,6,8
"2011","Dover 009B","E01024236","Total",25,13,10,2,4,0,4,0,21,13,6,2
"2011","Dover 009C","E01024237","Total",15,7,4,4,0,0,0,0,15,7,4,4
"2011","Dover 009D","E01024253","Total",26,5,12,9,4,0,2,2,22,5,10,7
"2011","Dover 010C","E01024233","Total",19,13,5,1,3,2,1,0,16,11,4,1
"2011","Dover 010D","E01024235","Total",30,13,9,8,4,0,3,1,26,13,6,7
"2011","Dover 010E","E01024254","Total",71,22,14,35,7,2,3,2,64,20,11,33
"2011","Dover 010F","E01024256","Total",34,14,15,5,3,0,2,1,31,14,13,4
"2011","Dover 010G","E01033210","Total",38,16,8,14,4,0,3,1,34,16,5,13
"2011","Dover 011A","E01024193","Total",87,33,12,42,8,1,3,4,79,32,9,38
"2011","Dover 011B","E01024194","Total",78,28,18,32,5,1,4,0,73,27,14,32
"2011","Dover 011C","E01024195","Total",44,17,11,16,5,1,2,2,39,16,9,14
"2011","Dover 011D","E01024196","Total",71,18,10,43,6,0,2,4,65,18,8,39
"2011","Dover 011E","E01024197","Total",65,32,14,19,7,3,1,3,58,29,13,16
"2011","Dover 011F","E01024240","Total",109,24,12,73,13,3,3,7,96,21,9,66
"2011","Dover 011G","E01024241","Total",123,45,14,64,8,1,2,5,115,44,12,59
"2011","Dover 011H","E01024248","Total",113,43,15,55,8,1,2,5,105,42,13,50
"2011","Dover 012B","E01024238","Total",39,15,8,16,3,1,2,0,36,14,6,16
"2011","Dover 012C","E01024239","Total",47,21,13,13,5,2,1,2,42,19,12,11
"2011","Dover 012D","E01024247","Total",49,16,11,22,6,2,1,3,43,14,10,19
"2011","Dover 012E","E01033209","Total",18,7,4,7,7,1,3,3,11,6,1,4
"2011","Dover 012F","E01033211","Total",16,7,3,6,2,0,2,0,14,7,1,6
"2011","Dover 013A","E01024214","Total",59,15,16,28,6,0,2,4,53,15,14,24
"2011","Dover 013B","E01024215","Total",53,16,14,23,10,3,5,2,43,13,9,21
"2011","Dover 013C","E01024216","Total",49,23,15,11,4,0,4,0,45,23,11,11
"2011","Dover 013D","E01024246","Total",99,28,21,50,7,0,6,1,92,28,15,49
"2011","Dover 013E","E01024249","Total",58,26,10,22,9,2,4,3,49,24,6,19
"2011","Dover 014A","E01024198","Total",22,9,9,4,4,0,2,2,18,9,7,2
"2011","Dover 014B","E01024212","Total",26,12,8,6,4,1,2,1,22,11,6,5
"2011","Dover 014C","E01024213","Total",18,8,6,4,3,1,1,1,15,7,5,3
"2011","Dover 014D","E01024234","Total",19,8,7,4,2,1,1,0,17,7,6,4
"2011","Gravesham 001A","E01024276","Total",81,22,26,33,6,0,5,1,75,22,21,32
"2011","Gravesham 001B","E01024277","Total",100,22,20,58,9,0,5,4,91,22,15,54
"2011","Gravesham 001C","E01024278","Total",144,32,17,95,8,2,4,2,136,30,13,93
"2011","Gravesham 001D","E01024279","Total",76,29,11,36,2,0,0,2,74,29,11,34
"2011","Gravesham 002A","E01024257","Total",66,17,19,30,7,1,2,4,59,16,17,26
"2011","Gravesham 002C","E01024290","Total",32,6,7,19,4,0,1,3,28,6,6,16
"2011","Gravesham 002D","E01024291","Total",49,17,9,23,4,0,2,2,45,17,7,21
"2011","Gravesham 002E","E01024295","Total",66,16,17,33,6,2,3,1,60,14,14,32
"2011","Gravesham 002F","E01032799","Total",32,5,10,17,11,1,6,4,21,4,4,13
"2011","Gravesham 002G","E01032800","Total",29,5,9,15,5,0,2,3,24,5,7,12
"2011","Gravesham 003A","E01024258","Total",43,16,10,17,6,0,3,3,37,16,7,14
"2011","Gravesham 003B","E01024261","Total",31,13,11,7,2,0,2,0,29,13,9,7
"2011","Gravesham 003C","E01024293","Total",57,14,18,25,6,0,5,1,51,14,13,24
"2011","Gravesham 003D","E01024294","Total",116,35,18,63,11,2,3,6,105,33,15,57
"2011","Gravesham 003E","E01024296","Total",95,31,22,42,6,2,1,3,89,29,21,39
"2011","Gravesham 004A","E01024262","Total",66,22,11,33,5,2,1,2,61,20,10,31
"2011","Gravesham 004B","E01024263","Total",58,21,14,23,8,3,4,1,50,18,10,22
"2011","Gravesham 004C","E01024282","Total",57,22,16,19,2,0,1,1,55,22,15,18
"2011","Gravesham 004D","E01024283","Total",41,14,13,14,7,1,5,1,34,13,8,13
"2011","Gravesham 004E","E01024284","Total",63,19,20,24,7,1,4,2,56,18,16,22
"2011","Gravesham 005A","E01024259","Total",24,8,9,7,3,1,1,1,21,7,8,6
"2011","Gravesham 005B","E01024260","Total",42,13,15,14,6,0,5,1,36,13,10,13
"2011","Gravesham 005C","E01024292","Total",34,11,14,9,4,2,2,0,30,9,12,9
"2011","Gravesham 005D","E01024313","Total",43,22,10,11,2,0,2,0,41,22,8,11
"2011","Gravesham 005E","E01024317","Total",30,10,12,8,2,1,1,0,28,9,11,8
"2011","Gravesham 005F","E01024318","Total",53,22,24,7,4,0,4,0,49,22,20,7
"2011","Gravesham 006A","E01024280","Total",84,31,17,36,5,0,2,3,79,31,15,33
"2011","Gravesham 006B","E01024281","Total",47,13,15,19,4,0,4,0,43,13,11,19
"2011","Gravesham 006C","E01024285","Total",34,11,8,15,2,0,1,1,32,11,7,14
"2011","Gravesham 006D","E01024287","Total",36,5,11,20,3,1,1,1,33,4,10,19
"2011","Gravesham 006E","E01024288","Total",21,8,5,8,5,0,1,4,16,8,4,4
"2011","Gravesham 007A","E01024308","Total",74,34,10,30,10,6,3,1,64,28,7,29
"2011","Gravesham 007B","E01024310","Total",39,13,5,21,3,1,2,0,36,12,3,21
"2011","Gravesham 007C","E01024311","Total",62,20,7,35,4,2,1,1,58,18,6,34
"2011","Gravesham 007D","E01024314","Total",27,9,7,11,1,0,1,0,26,9,6,11
"2011","Gravesham 007E","E01024315","Total",36,14,8,14,5,0,5,0,31,14,3,14
"2011","Gravesham 008A","E01024297","Total",30,15,8,7,1,0,1,0,29,15,7,7
"2011","Gravesham 008B","E01024298","Total",20,6,12,2,2,0,2,0,18,6,10,2
"2011","Gravesham 008C","E01024299","Total",26,11,9,6,2,0,2,0,24,11,7,6
"2011","Gravesham 008D","E01024309","Total",68,21,11,36,1,0,0,1,67,21,11,35
"2011","Gravesham 008E","E01024312","Total",32,10,2,20,1,0,0,1,31,10,2,19
"2011","Gravesham 009A","E01024264","Total",51,14,10,27,4,0,3,1,47,14,7,26
"2011","Gravesham 009B","E01024286","Total",25,8,7,10,4,0,4,0,21,8,3,10
"2011","Gravesham 009C","E01024316","Total",46,15,17,14,5,0,4,1,41,15,13,13
"2011","Gravesham 009D","E01024319","Total",53,23,4,26,1,0,0,1,52,23,4,25
"2011","Gravesham 010A","E01024265","Total",17,4,9,4,1,0,1,0,16,4,8,4
"2011","Gravesham 010B","E01024266","Total",40,15,12,13,2,0,1,1,38,15,11,12
"2011","Gravesham 010C","E01024267","Total",34,16,10,8,4,0,3,1,30,16,7,7
"2011","Gravesham 010D","E01024300","Total",23,8,7,8,0,0,0,0,23,8,7,8
"2011","Gravesham 010E","E01024301","Total",12,8,2,2,1,1,0,0,11,7,2,2
"2011","Gravesham 011A","E01024303","Total",60,18,17,25,9,2,6,1,51,16,11,24
"2011","Gravesham 011B","E01024304","Total",64,28,13,23,9,0,4,5,55,28,9,18
"2011","Gravesham 011C","E01024305","Total",86,24,15,47,8,0,4,4,78,24,11,43
"2011","Gravesham 011D","E01024306","Total",65,25,11,29,10,2,3,5,55,23,8,24
"2011","Gravesham 011E","E01024307","Total",37,18,6,13,3,0,3,0,34,18,3,13
"2011","Gravesham 012A","E01024268","Total",16,3,11,2,4,0,4,0,12,3,7,2
"2011","Gravesham 012B","E01024269","Total",27,10,9,8,5,1,3,1,22,9,6,7
"2011","Gravesham 012C","E01024270","Total",29,10,14,5,5,0,5,0,24,10,9,5
"2011","Gravesham 012D","E01024271","Total",27,12,8,7,1,0,1,0,26,12,7,7
"2011","Gravesham 012E","E01024272","Total",11,3,6,2,0,0,0,0,11,3,6,2
"2011","Gravesham 013A","E01024273","Total",21,12,3,6,2,1,0,1,19,11,3,5
"2011","Gravesham 013B","E01024274","Total",26,2,16,8,0,0,0,0,26,2,16,8
"2011","Gravesham 013C","E01024275","Total",39,21,16,2,5,0,5,0,34,21,11,2
"2011","Gravesham 013D","E01024302","Total",18,5,5,8,2,0,2,0,16,5,3,8
"2011","Maidstone 001A","E01024333","Total",55,21,18,16,6,1,5,0,49,20,13,16
"2011","Maidstone 001B","E01024334","Total",23,12,6,5,2,0,2,0,21,12,4,5
"2011","Maidstone 001C","E01024335","Total",22,7,9,6,6,1,5,0,16,6,4,6
"2011","Maidstone 001D","E01024338","Total",14,6,4,4,3,0,1,2,11,6,3,2
"2011","Maidstone 001E","E01024347","Total",22,6,13,3,4,0,4,0,18,6,9,3
"2011","Maidstone 002A","E01024353","Total",25,11,9,5,2,0,2,0,23,11,7,5
"2011","Maidstone 002B","E01024354","Total",50,19,16,15,3,0,2,1,47,19,14,14
"2011","Maidstone 002C","E01024355","Total",56,14,17,25,11,0,8,3,45,14,9,22
"2011","Maidstone 002D","E01024385","Total",44,9,17,18,4,0,4,0,40,9,13,18
"2011","Maidstone 002E","E01024386","Total",32,14,14,4,4,0,4,0,28,14,10,4
"2011","Maidstone 003A","E01024320","Total",20,12,5,3,2,1,1,0,18,11,4,3
"2011","Maidstone 003B","E01024321","Total",25,7,11,7,3,0,2,1,22,7,9,6
"2011","Maidstone 003C","E01024322","Total",11,5,5,1,1,0,1,0,10,5,4,1
"2011","Maidstone 003D","E01024323","Total",36,17,15,4,3,0,3,0,33,17,12,4
"2011","Maidstone 003E","E01024324","Total",23,10,10,3,1,0,1,0,22,10,9,3
"2011","Maidstone 003F","E01024341","Total",12,3,8,1,2,0,2,0,10,3,6,1
"2011","Maidstone 004A","E01024352","Total",89,25,23,41,4,0,2,2,85,25,21,39
"2011","Maidstone 004C","E01024382","Total",57,13,22,22,7,0,2,5,50,13,20,17
"2011","Maidstone 004D","E01024383","Total",57,23,16,18,9,0,5,4,48,23,11,14
"2011","Maidstone 004E","E01024384","Total",58,20,14,24,2,0,1,1,56,20,13,23
"2011","Maidstone 004F","E01033090","Total",63,17,15,31,10,1,5,4,53,16,10,27
"2011","Maidstone 004G","E01033092","Total",43,7,18,18,7,0,4,3,36,7,14,15
"2011","Maidstone 005A","E01024330","Total",21,8,12,1,6,1,4,1,15,7,8,0
"2011","Maidstone 005B","E01024336","Total",22,13,5,4,3,2,1,0,19,11,4,4
"2011","Maidstone 005C","E01024337","Total",41,17,19,5,11,0,10,1,30,17,9,4
"2011","Maidstone 005D","E01024348","Total",24,8,10,6,2,0,2,0,22,8,8,6
"2011","Maidstone 005E","E01024351","Total",28,12,8,8,3,1,0,2,25,11,8,6
"2011","Maidstone 006A","E01024339","Total",58,18,24,16,5,0,4,1,53,18,20,15
"2011","Maidstone 006B","E01024340","Total",49,11,15,23,4,0,1,3,45,11,14,20
"2011","Maidstone 006C","E01024356","Total",52,22,17,13,5,0,4,1,47,22,13,12
"2011","Maidstone 006E","E01024373","Total",64,25,19,20,6,1,2,3,58,24,17,17
"2011","Maidstone 006F","E01033087","Total",57,16,20,21,7,0,6,1,50,16,14,20
"2011","Maidstone 006G","E01033091","Total",50,17,18,15,4,1,2,1,46,16,16,14
"2011","Maidstone 007A","E01024326","Total",15,6,8,1,1,0,1,0,14,6,7,1
"2011","Maidstone 007B","E01024327","Total",40,10,16,14,4,0,3,1,36,10,13,13
"2011","Maidstone 007C","E01024328","Total",30,14,6,10,5,0,3,2,25,14,3,8
"2011","Maidstone 007D","E01024329","Total",14,3,6,5,2,0,1,1,12,3,5,4
"2011","Maidstone 007E","E01024349","Total",45,24,14,7,4,0,4,0,41,24,10,7
"2011","Maidstone 008A","E01024357","Total",82,24,30,28,8,0,5,3,74,24,25,25
"2011","Maidstone 008B","E01024358","Total",74,20,20,34,4,1,3,0,70,19,17,34
"2011","Maidstone 008C","E01024367","Total",51,12,16,23,4,0,3,1,47,12,13,22
"2011","Maidstone 008E","E01024369","Total",38,15,11,12,7,2,2,3,31,13,9,9
"2011","Maidstone 008F","E01033088","Total",45,16,19,10,3,0,2,1,42,16,17,9
"2011","Maidstone 008G","E01033089","Total",82,27,21,34,6,2,4,0,76,25,17,34
"2011","Maidstone 009A","E01024360","Total",54,19,21,14,5,0,4,1,49,19,17,13
"2011","Maidstone 009B","E01024372","Total",67,19,15,33,6,1,1,4,61,18,14,29
"2011","Maidstone 009C","E01024374","Total",111,32,16,63,11,1,3,7,100,31,13,56
"2011","Maidstone 009D","E01024401","Total",69,20,25,24,3,1,2,0,66,19,23,24
"2011","Maidstone 009E","E01024403","Total",41,22,8,11,4,1,2,1,37,21,6,10
"2011","Maidstone 010A","E01024371","Total",34,11,3,20,1,0,0,1,33,11,3,19
"2011","Maidstone 010B","E01024392","Total",58,12,17,29,12,0,12,0,46,12,5,29
"2011","Maidstone 010C","E01024393","Total",48,16,13,19,2,1,1,0,46,15,12,19
"2011","Maidstone 010D","E01024395","Total",60,22,11,27,8,2,5,1,52,20,6,26
"2011","Maidstone 010E","E01024396","Total",60,23,10,27,5,2,1,2,55,21,9,25
"2011","Maidstone 011A","E01024361","Total",42,13,12,17,6,1,5,0,36,12,7,17
"2011","Maidstone 011B","E01024362","Total",28,11,15,2,5,0,5,0,23,11,10,2
"2011","Maidstone 011C","E01024363","Total",42,20,9,13,4,1,2,1,38,19,7,12
"2011","Maidstone 011D","E01024387","Total",32,12,7,13,3,0,3,0,29,12,4,13
"2011","Maidstone 012A","E01024331","Total",24,9,7,8,5,1,3,1,19,8,4,7
"2011","Maidstone 012B","E01024394","Total",24,16,4,4,3,2,1,0,21,14,3,4
"2011","Maidstone 012C","E01024402","Total",9,5,2,2,0,0,0,0,9,5,2,2
"2011","Maidstone 012D","E01024404","Total",22,5,11,6,3,0,2,1,19,5,9,5
"2011","Maidstone 012E","E01024405","Total",41,12,11,18,4,0,2,2,37,12,9,16
"2011","Maidstone 013A","E01024389","Total",239,51,35,153,31,3,11,17,208,48,24,136
"2011","Maidstone 013B","E01024390","Total",100,32,15,53,10,0,5,5,90,32,10,48
"2011","Maidstone 013C","E01024391","Total",64,16,11,37,7,0,5,2,57,16,6,35
"2011","Maidstone 013D","E01024397","Total",70,18,17,35,10,1,5,4,60,17,12,31
"2011","Maidstone 013E","E01024398","Total",102,22,11,69,11,2,1,8,91,20,10,61
"2011","Maidstone 013F","E01024399","Total",45,14,9,22,5,1,2,2,40,13,7,20
"2011","Maidstone 013G","E01024400","Total",42,19,8,15,2,1,1,0,40,18,7,15
"2011","Maidstone 014A","E01024325","Total",26,8,15,3,7,2,5,0,19,6,10,3
"2011","Maidstone 014B","E01024346","Total",18,8,4,6,4,2,2,0,14,6,2,6
"2011","Maidstone 014C","E01024377","Total",29,10,8,11,4,1,2,1,25,9,6,10
"2011","Maidstone 014D","E01024378","Total",28,9,11,8,3,0,3,0,25,9,8,8
"2011","Maidstone 015A","E01024332","Total",17,9,7,1,3,1,2,0,14,8,5,1
"2011","Maidstone 015B","E01024350","Total",47,26,14,7,7,0,6,1,40,26,8,6
"2011","Maidstone 015C","E01024375","Total",42,8,14,20,6,0,3,3,36,8,11,17
"2011","Maidstone 015D","E01024388","Total",118,41,30,47,8,3,5,0,110,38,25,47
"2011","Maidstone 015E","E01024410","Total",25,11,9,5,4,0,4,0,21,11,5,5
"2011","Maidstone 016A","E01024342","Total",48,12,15,21,1,0,0,1,47,12,15,20
"2011","Maidstone 016B","E01024343","Total",25,12,9,4,2,1,1,0,23,11,8,4
"2011","Maidstone 016C","E01024344","Total",22,8,10,4,4,1,3,0,18,7,7,4
"2011","Maidstone 016D","E01024376","Total",32,14,8,10,2,1,1,0,30,13,7,10
"2011","Maidstone 017A","E01024364","Total",49,18,17,14,4,0,3,1,45,18,14,13
"2011","Maidstone 017B","E01024365","Total",29,13,11,5,3,0,3,0,26,13,8,5
"2011","Maidstone 017C","E01024366","Total",33,11,5,17,2,0,1,1,31,11,4,16
"2011","Maidstone 017D","E01024411","Total",26,10,7,9,3,0,2,1,23,10,5,8
"2011","Maidstone 018A","E01024345","Total",22,10,7,5,2,0,1,1,20,10,6,4
"2011","Maidstone 018B","E01024379","Total",28,7,13,8,3,0,3,0,25,7,10,8
"2011","Maidstone 018C","E01024380","Total",25,9,5,11,2,1,0,1,23,8,5,10
"2011","Maidstone 018D","E01024381","Total",56,14,13,29,6,0,3,3,50,14,10,26
"2011","Maidstone 019A","E01024406","Total",43,18,8,17,4,0,2,2,39,18,6,15
"2011","Maidstone 019B","E01024407","Total",33,12,11,10,8,3,5,0,25,9,6,10
"2011","Maidstone 019C","E01024408","Total",34,12,15,7,6,0,5,1,28,12,10,6
"2011","Maidstone 019D","E01024409","Total",22,7,8,7,3,0,3,0,19,7,5,7
"2011","Sevenoaks 001A","E01024445","Total",24,14,6,4,1,0,1,0,23,14,5,4
"2011","Sevenoaks 001B","E01024446","Total",32,11,14,7,3,1,2,0,29,10,12,7
"2011","Sevenoaks 001C","E01024447","Total",23,9,7,7,4,1,3,0,19,8,4,7
"2011","Sevenoaks 001D","E01024472","Total",38,15,8,15,4,0,2,2,34,15,6,13
"2011","Sevenoaks 001E","E01024479","Total",23,7,6,10,0,0,0,0,23,7,6,10
"2011","Sevenoaks 002A","E01024476","Total",91,33,13,45,8,0,4,4,83,33,9,41
"2011","Sevenoaks 002B","E01024477","Total",48,18,11,19,6,2,3,1,42,16,8,18
"2011","Sevenoaks 002C","E01024478","Total",35,13,9,13,3,0,2,1,32,13,7,12
"2011","Sevenoaks 002D","E01024480","Total",74,30,19,25,6,1,4,1,68,29,15,24
"2011","Sevenoaks 002E","E01024481","Total",50,18,9,23,1,0,0,1,49,18,9,22
"2011","Sevenoaks 002F","E01024482","Total",58,23,7,28,3,0,2,1,55,23,5,27
"2011","Sevenoaks 003A","E01024421","Total",22,9,3,10,2,1,1,0,20,8,2,10
"2011","Sevenoaks 003B","E01024473","Total",38,15,13,10,6,0,6,0,32,15,7,10
"2011","Sevenoaks 003C","E01024474","Total",26,12,8,6,1,0,0,1,25,12,8,5
"2011","Sevenoaks 003D","E01024475","Total",45,14,13,18,4,0,4,0,41,14,9,18
"2011","Sevenoaks 004A","E01024441","Total",12,7,4,1,1,0,1,0,11,7,3,1
"2011","Sevenoaks 004B","E01024442","Total",22,7,7,8,7,0,5,2,15,7,2,6
"2011","Sevenoaks 004C","E01024443","Total",8,3,2,3,1,0,1,0,7,3,1,3
"2011","Sevenoaks 004D","E01024444","Total",39,20,4,15,2,1,1,0,37,19,3,15
"2011","Sevenoaks 005A","E01024431","Total",19,9,5,5,1,0,1,0,18,9,4,5
"2011","Sevenoaks 005B","E01024432","Total",36,12,12,12,0,0,0,0,36,12,12,12
"2011","Sevenoaks 005C","E01024433","Total",13,5,3,5,0,0,0,0,13,5,3,5
"2011","Sevenoaks 005D","E01024434","Total",44,10,23,11,3,0,3,0,41,10,20,11
"2011","Sevenoaks 007A","E01024435","Total",18,6,3,9,0,0,0,0,18,6,3,9
"2011","Sevenoaks 007B","E01024436","Total",16,6,6,4,2,0,2,0,14,6,4,4
"2011","Sevenoaks 007C","E01024437","Total",20,8,5,7,5,0,4,1,15,8,1,6
"2011","Sevenoaks 007D","E01024438","Total",17,5,6,6,4,0,3,1,13,5,3,5
"2011","Sevenoaks 008A","E01024422","Total",51,19,13,19,2,0,1,1,49,19,12,18
"2011","Sevenoaks 008B","E01024423","Total",38,10,13,15,9,0,6,3,29,10,7,12
"2011","Sevenoaks 008C","E01024439","Total",33,18,5,10,1,0,0,1,32,18,5,9
"2011","Sevenoaks 008D","E01024440","Total",34,14,7,13,1,0,1,0,33,14,6,13
"2011","Sevenoaks 008E","E01024452","Total",24,11,8,5,1,0,1,0,23,11,7,5
"2011","Sevenoaks 009A","E01024448","Total",18,9,7,2,2,0,2,0,16,9,5,2
"2011","Sevenoaks 009B","E01024449","Total",15,10,2,3,0,0,0,0,15,10,2,3
"2011","Sevenoaks 009C","E01024450","Total",45,18,7,20,5,1,2,2,40,17,5,18
"2011","Sevenoaks 009D","E01024453","Total",12,5,3,4,1,0,1,0,11,5,2,4
"2011","Sevenoaks 009E","E01024454","Total",38,16,12,10,7,2,3,2,31,14,9,8
"2011","Sevenoaks 010A","E01024457","Total",29,9,6,14,2,0,2,0,27,9,4,14
"2011","Sevenoaks 010B","E01024460","Total",57,28,12,17,10,2,4,4,47,26,8,13
"2011","Sevenoaks 010C","E01024461","Total",33,12,15,6,4,0,4,0,29,12,11,6
"2011","Sevenoaks 010D","E01024465","Total",33,15,14,4,3,0,2,1,30,15,12,3
"2011","Sevenoaks 010E","E01024466","Total",35,15,6,14,1,0,1,0,34,15,5,14
"2011","Sevenoaks 010F","E01024468","Total",36,7,20,9,4,0,2,2,32,7,18,7
"2011","Sevenoaks 011A","E01024416","Total",23,11,7,5,4,2,2,0,19,9,5,5
"2011","Sevenoaks 011B","E01024418","Total",22,8,11,3,1,0,1,0,21,8,10,3
"2011","Sevenoaks 011C","E01024424","Total",10,1,3,6,2,0,2,0,8,1,1,6
"2011","Sevenoaks 011D","E01024463","Total",11,4,6,1,1,0,1,0,10,4,5,1
"2011","Sevenoaks 011E","E01024464","Total",17,7,3,7,2,0,2,0,15,7,1,7
"2011","Sevenoaks 011F","E01024467","Total",29,9,15,5,0,0,0,0,29,9,15,5
"2011","Sevenoaks 012A","E01024458","Total",19,2,10,7,7,0,5,2,12,2,5,5
"2011","Sevenoaks 012B","E01024459","Total",25,10,10,5,3,0,1,2,22,10,9,3
"2011","Sevenoaks 012C","E01024462","Total",19,4,6,9,1,0,1,0,18,4,5,9
"2011","Sevenoaks 012D","E01024469","Total",16,6,8,2,6,2,4,0,10,4,4,2
"2011","Sevenoaks 012E","E01024470","Total",18,4,8,6,2,0,2,0,16,4,6,6
"2011","Sevenoaks 012F","E01024471","Total",15,5,7,3,3,0,3,0,12,5,4,3
"2011","Sevenoaks 013A","E01024417","Total",33,16,7,10,3,1,1,1,30,15,6,9
"2011","Sevenoaks 013B","E01024419","Total",25,10,8,7,6,1,5,0,19,9,3,7
"2011","Sevenoaks 013C","E01024483","Total",31,16,9,6,1,0,1,0,30,16,8,6
"2011","Sevenoaks 013D","E01024484","Total",16,5,5,6,3,1,2,0,13,4,3,6
"2011","Sevenoaks 013E","E01024485","Total",60,30,8,22,5,2,1,2,55,28,7,20
"2011","Sevenoaks 014A","E01024425","Total",32,9,9,14,7,1,2,4,25,8,7,10
"2011","Sevenoaks 014B","E01024426","Total",17,7,5,5,4,0,3,1,13,7,2,4
"2011","Sevenoaks 014C","E01024427","Total",44,16,14,14,5,0,4,1,39,16,10,13
"2011","Sevenoaks 014D","E01024428","Total",30,11,6,13,1,0,1,0,29,11,5,13
"2011","Sevenoaks 014E","E01024429","Total",65,25,13,27,10,3,6,1,55,22,7,26
"2011","Sevenoaks 014F","E01024430","Total",22,8,5,9,1,0,1,0,21,8,4,9
"2011","Sevenoaks 015A","E01024420","Total",22,5,7,10,5,1,4,0,17,4,3,10
"2011","Sevenoaks 015B","E01024451","Total",39,16,11,12,1,0,1,0,38,16,10,12
"2011","Sevenoaks 015C","E01024455","Total",17,11,3,3,2,1,1,0,15,10,2,3
"2011","Sevenoaks 015D","E01024456","Total",16,7,4,5,4,2,2,0,12,5,2,5
"2011","Sevenoaks 016A","E01024413","Total",51,25,8,18,4,1,1,2,47,24,7,16
"2011","Sevenoaks 016B","E01024414","Total",50,21,12,17,6,1,2,3,44,20,10,14
"2011","Sevenoaks 016C","E01024415","Total",25,9,11,5,2,0,2,0,23,9,9,5
"2011","Sevenoaks 016D","E01032619","Total",36,15,15,6,10,0,7,3,26,15,8,3
"2011","Shepway 001A","E01024490","Total",25,10,10,5,4,0,2,2,21,10,8,3
"2011","Shepway 001B","E01024544","Total",21,8,6,7,4,1,2,1,17,7,4,6
"2011","Shepway 001C","E01024545","Total",18,8,4,6,2,0,0,2,16,8,4,4
"2011","Shepway 001D","E01024547","Total",27,14,3,10,2,0,0,2,25,14,3,8
"2011","Shepway 002A","E01024492","Total",42,18,12,12,2,0,2,0,40,18,10,12
"2011","Shepway 002B","E01024541","Total",91,25,21,45,14,2,5,7,77,23,16,38
"2011","Shepway 002C","E01024542","Total",41,14,12,15,5,2,3,0,36,12,9,15
"2011","Shepway 002E","E01033213","Total",79,26,21,32,7,1,2,4,72,25,19,28
"2011","Shepway 002F","E01033214","Total",36,16,15,5,6,2,4,0,30,14,11,5
"2011","Shepway 003A","E01024496","Total",92,25,11,56,11,1,1,9,81,24,10,47
"2011","Shepway 003B","E01024497","Total",48,17,11,20,5,1,4,0,43,16,7,20
"2011","Shepway 003C","E01024498","Total",82,26,14,42,8,1,2,5,74,25,12,37
"2011","Shepway 003D","E01024503","Total",50,19,12,19,7,1,4,2,43,18,8,17
"2011","Shepway 003E","E01024518","Total",37,18,10,9,4,1,3,0,33,17,7,9
"2011","Shepway 004A","E01024499","Total",76,25,12,39,6,1,4,1,70,24,8,38
"2011","Shepway 004B","E01024500","Total",69,16,10,43,8,1,2,5,61,15,8,38
"2011","Shepway 004C","E01024501","Total",105,40,15,50,10,4,3,3,95,36,12,47
"2011","Shepway 004D","E01024502","Total",63,20,8,35,8,0,2,6,55,20,6,29
"2011","Shepway 004E","E01024505","Total",84,23,21,40,9,3,4,2,75,20,17,38
"2011","Shepway 005A","E01024491","Total",72,28,22,22,6,1,2,3,66,27,20,19
"2011","Shepway 005B","E01024493","Total",37,15,7,15,3,1,2,0,34,14,5,15
"2011","Shepway 005C","E01024494","Total",45,19,12,14,5,0,2,3,40,19,10,11
"2011","Shepway 005D","E01024495","Total",53,25,9,19,6,1,5,0,47,24,4,19
"2011","Shepway 005E","E01024520","Total",46,17,14,15,3,1,1,1,43,16,13,14
"2011","Shepway 005F","E01024528","Total",32,9,8,15,5,1,2,2,27,8,6,13
"2011","Shepway 006A","E01024511","Total",35,17,10,8,4,2,1,1,31,15,9,7
"2011","Shepway 006B","E01024512","Total",56,22,16,18,6,2,4,0,50,20,12,18
"2011","Shepway 006C","E01024513","Total",47,20,9,18,4,1,2,1,43,19,7,17
"2011","Shepway 006D","E01024514","Total",35,17,9,9,1,0,1,0,34,17,8,9
"2011","Shepway 006E","E01024515","Total",31,15,8,8,2,0,2,0,29,15,6,8
"2011","Shepway 006F","E01024516","Total",27,10,2,15,2,0,0,2,25,10,2,13
"2011","Shepway 006G","E01024519","Total",33,16,12,5,10,3,7,0,23,13,5,5
"2011","Shepway 006H","E01024521","Total",45,17,19,9,3,1,2,0,42,16,17,9
"2011","Shepway 008A","E01024523","Total",22,7,7,8,4,1,3,0,18,6,4,8
"2011","Shepway 008B","E01024526","Total",18,9,8,1,3,0,3,0,15,9,5,1
"2011","Shepway 008C","E01024527","Total",20,8,9,3,5,1,2,2,15,7,7,1
"2011","Shepway 008D","E01024550","Total",41,20,14,7,2,0,2,0,39,20,12,7
"2011","Shepway 009A","E01024489","Total",8,5,1,2,2,1,0,1,6,4,1,1
"2011","Shepway 009B","E01024530","Total",20,5,9,6,1,0,1,0,19,5,8,6
"2011","Shepway 009C","E01024536","Total",24,8,8,8,3,0,3,0,21,8,5,8
"2011","Shepway 009D","E01024546","Total",28,14,10,4,3,0,2,1,25,14,8,3
"2011","Shepway 010A","E01024522","Total",37,22,7,8,1,1,0,0,36,21,7,8
"2011","Shepway 010B","E01024524","Total",46,17,6,23,0,0,0,0,46,17,6,23
"2011","Shepway 010C","E01024525","Total",56,21,13,22,1,0,0,1,55,21,13,21
"2011","Shepway 010D","E01024529","Total",33,10,8,15,1,1,0,0,32,9,8,15
"2011","Shepway 010E","E01024531","Total",41,13,6,22,5,1,1,3,36,12,5,19
"2011","Shepway 011A","E01024486","Total",36,6,16,14,9,1,6,2,27,5,10,12
"2011","Shepway 011B","E01024487","Total",21,10,5,6,3,1,1,1,18,9,4,5
"2011","Shepway 011C","E01024488","Total",29,17,3,9,1,0,0,1,28,17,3,8
"2011","Shepway 011D","E01024548","Total",20,6,3,11,8,3,3,2,12,3,0,9
"2011","Shepway 011E","E01024549","Total",20,11,6,3,4,1,2,1,16,10,4,2
"2011","Shepway 012A","E01024537","Total",26,12,6,8,7,2,2,3,19,10,4,5
"2011","Shepway 012B","E01024538","Total",16,8,6,2,3,0,3,0,13,8,3,2
"2011","Shepway 012C","E01024539","Total",72,27,12,33,5,1,2,2,67,26,10,31
"2011","Shepway 012D","E01024540","Total",17,7,6,4,1,1,0,0,16,6,6,4
"2011","Shepway 013A","E01024532","Total",31,10,10,11,7,1,4,2,24,9,6,9
"2011","Shepway 013B","E01024533","Total",32,14,4,14,3,2,0,1,29,12,4,13
"2011","Shepway 013C","E01024534","Total",54,10,11,33,7,0,6,1,47,10,5,32
"2011","Shepway 013D","E01024535","Total",65,19,19,27,9,2,5,2,56,17,14,25
"2011","Shepway 014A","E01024504","Total",110,38,10,62,3,0,1,2,107,38,9,60
"2011","Shepway 014B","E01024507","Total",93,33,12,48,11,2,1,8,82,31,11,40
"2011","Shepway 014C","E01033212","Total",67,21,8,38,12,2,1,9,55,19,7,29
"2011","Shepway 014D","E01033215","Total",30,9,5,16,3,0,0,3,27,9,5,13
"2011","Shepway 015A","E01024508","Total",97,30,25,42,17,3,6,8,80,27,19,34
"2011","Shepway 015B","E01024509","Total",41,16,6,19,6,2,1,3,35,14,5,16
"2011","Shepway 015C","E01024510","Total",36,10,18,8,7,0,6,1,29,10,12,7
"2011","Shepway 015D","E01024517","Total",46,14,11,21,1,0,1,0,45,14,10,21
"2011","Swale 001A","E01024609","Total",70,14,17,39,15,1,7,7,55,13,10,32
"2011","Swale 001B","E01024610","Total",105,23,16,66,9,0,3,6,96,23,13,60
"2011","Swale 001C","E01024611","Total",123,21,16,86,13,2,6,5,110,19,10,81
"2011","Swale 001D","E01024612","Total",92,22,20,50,8,1,4,3,84,21,16,47
"2011","Swale 002A","E01024613","Total",65,20,13,32,13,2,8,3,52,18,5,29
"2011","Swale 002B","E01024614","Total",98,20,12,66,9,2,4,3,89,18,8,63
"2011","Swale 002C","E01024615","Total",86,11,11,64,9,1,1,7,77,10,10,57
"2011","Swale 002D","E01024616","Total",70,26,10,34,6,3,1,2,64,23,9,32
"2011","Swale 003A","E01024585","Total",58,14,13,31,5,0,3,2,53,14,10,29
"2011","Swale 003B","E01024587","Total",27,10,1,16,2,1,1,0,25,9,0,16
"2011","Swale 003C","E01024588","Total",16,9,3,4,2,0,2,0,14,9,1,4
"2011","Swale 003D","E01024589","Total",26,9,14,3,6,0,4,2,20,9,10,1
"2011","Swale 004A","E01024595","Total",50,16,15,19,10,1,8,1,40,15,7,18
"2011","Swale 004B","E01024598","Total",40,17,9,14,1,0,1,0,39,17,8,14
"2011","Swale 004D","E01024619","Total",32,11,10,11,3,0,3,0,29,11,7,11
"2011","Swale 004E","E01024621","Total",79,25,10,44,11,4,2,5,68,21,8,39
"2011","Swale 004F","E01032653","Total",65,30,13,22,1,0,1,0,64,30,12,22
"2011","Swale 004G","E01032654","Total",68,24,23,21,11,1,8,2,57,23,15,19
"2011","Swale 005A","E01024594","Total",36,15,6,15,5,1,2,2,31,14,4,13
"2011","Swale 005B","E01024596","Total",78,23,17,38,9,2,4,3,69,21,13,35
"2011","Swale 005C","E01024597","Total",73,23,10,40,8,0,1,7,65,23,9,33
"2011","Swale 005D","E01024620","Total",23,7,8,8,6,1,3,2,17,6,5,6
"2011","Swale 006A","E01024580","Total",69,16,6,47,13,2,4,7,56,14,2,40
"2011","Swale 006B","E01024581","Total",48,16,9,23,5,3,2,0,43,13,7,23
"2011","Swale 006C","E01024586","Total",43,11,12,20,2,0,1,1,41,11,11,19
"2011","Swale 006D","E01024618","Total",62,13,17,32,7,0,6,1,55,13,11,31
"2011","Swale 007B","E01024576","Total",39,11,13,15,4,0,4,0,35,11,9,15
"2011","Swale 007C","E01024577","Total",51,17,9,25,5,2,3,0,46,15,6,25
"2011","Swale 007D","E01024578","Total",59,24,15,20,7,2,3,2,52,22,12,18
"2011","Swale 007E","E01024579","Total",159,45,42,72,13,2,7,4,146,43,35,68
"2011","Swale 007F","E01024583","Total",83,29,17,37,4,0,3,1,79,29,14,36
"2011","Swale 007G","E01032655","Total",41,18,8,15,4,0,2,2,37,18,6,13
"2011","Swale 007H","E01032656","Total",35,12,14,9,7,0,4,3,28,12,10,6
"2011","Swale 008A","E01024570","Total",41,12,9,20,1,0,0,1,40,12,9,19
"2011","Swale 008B","E01024571","Total",24,8,8,8,2,0,0,2,22,8,8,6
"2011","Swale 008C","E01024572","Total",14,6,4,4,3,1,1,1,11,5,3,3
"2011","Swale 008D","E01024573","Total",33,19,7,7,3,1,1,1,30,18,6,6
"2011","Swale 008E","E01024575","Total",23,4,14,5,0,0,0,0,23,4,14,5
"2011","Swale 009A","E01024554","Total",48,17,14,17,3,0,3,0,45,17,11,17
"2011","Swale 009B","E01024561","Total",58,22,11,25,3,1,1,1,55,21,10,24
"2011","Swale 009C","E01024567","Total",137,50,28,59,14,0,9,5,123,50,19,54
"2011","Swale 009D","E01024568","Total",53,18,20,15,8,1,4,3,45,17,16,12
"2011","Swale 009E","E01024582","Total",32,10,13,9,5,0,3,2,27,10,10,7
"2011","Swale 010A","E01024559","Total",47,17,9,21,6,2,2,2,41,15,7,19
"2011","Swale 010B","E01024584","Total",79,22,14,43,9,0,3,6,70,22,11,37
"2011","Swale 010C","E01024590","Total",80,23,6,51,4,1,0,3,76,22,6,48
"2011","Swale 010D","E01024599","Total",112,30,18,64,4,0,2,2,108,30,16,62
"2011","Swale 010E","E01024608","Total",51,12,18,21,12,1,9,2,39,11,9,19
"2011","Swale 011A","E01024591","Total",61,23,15,23,7,0,4,3,54,23,11,20
"2011","Swale 011B","E01024592","Total",29,7,12,10,2,0,1,1,27,7,11,9
"2011","Swale 011C","E01024593","Total",60,17,20,23,13,2,7,4,47,15,13,19
"2011","Swale 011D","E01024600","Total",53,20,13,20,6,0,3,3,47,20,10,17
"2011","Swale 011E","E01024601","Total",31,10,6,15,3,0,1,2,28,10,5,13
"2011","Swale 012A","E01024560","Total",58,23,14,21,4,0,2,2,54,23,12,19
"2011","Swale 012B","E01024562","Total",56,20,15,21,6,0,5,1,50,20,10,20
"2011","Swale 012C","E01024569","Total",28,10,14,4,2,0,2,0,26,10,12,4
"2011","Swale 012D","E01024630","Total",41,17,9,15,5,0,2,3,36,17,7,12
"2011","Swale 012E","E01024632","Total",16,1,12,3,3,0,1,2,13,1,11,1
"2011","Swale 013A","E01024606","Total",33,14,12,7,2,0,2,0,31,14,10,7
"2011","Swale 013C","E01024628","Total",24,12,4,8,5,3,1,1,19,9,3,7
"2011","Swale 013D","E01024629","Total",14,4,5,5,5,2,3,0,9,2,2,5
"2011","Swale 013E","E01024631","Total",19,4,9,6,1,0,1,0,18,4,8,6
"2011","Swale 013F","E01032735","Total",40,14,13,13,6,0,5,1,34,14,8,12
"2011","Swale 013G","E01032737","Total",45,14,13,18,8,0,4,4,37,14,9,14
"2011","Swale 014A","E01024564","Total",17,10,3,4,2,1,0,1,15,9,3,3
"2011","Swale 014B","E01024603","Total",26,10,10,6,2,0,1,1,24,10,9,5
"2011","Swale 014C","E01024604","Total",70,27,8,35,5,2,2,1,65,25,6,34
"2011","Swale 014D","E01024605","Total",17,4,4,9,1,0,0,1,16,4,4,8
"2011","Swale 014E","E01024626","Total",18,6,8,4,4,1,3,0,14,5,5,4
"2011","Swale 014F","E01024627","Total",89,25,11,53,6,0,1,5,83,25,10,48
"2011","Swale 015A","E01024551","Total",108,38,35,35,11,1,7,3,97,37,28,32
"2011","Swale 015B","E01024552","Total",59,23,6,30,3,0,3,0,56,23,3,30
"2011","Swale 015C","E01024553","Total",41,18,12,11,4,0,4,0,37,18,8,11
"2011","Swale 015D","E01024563","Total",75,23,10,42,9,1,3,5,66,22,7,37
"2011","Swale 015E","E01024602","Total",42,13,17,12,3,0,2,1,39,13,15,11
"2011","Swale 015F","E01024625","Total",38,9,17,12,9,0,6,3,29,9,11,9
"2011","Swale 016A","E01024565","Total",25,8,8,9,2,0,1,1,23,8,7,8
"2011","Swale 016B","E01024566","Total",41,15,8,18,9,0,3,6,32,15,5,12
"2011","Swale 016C","E01024622","Total",55,18,9,28,9,0,3,6,46,18,6,22
"2011","Swale 016D","E01024623","Total",43,15,11,17,1,0,1,0,42,15,10,17
"2011","Swale 016E","E01024624","Total",53,15,9,29,10,1,3,6,43,14,6,23
"2011","Swale 017A","E01024555","Total",34,14,10,10,3,1,2,0,31,13,8,10
"2011","Swale 017B","E01024556","Total",20,10,6,4,2,0,1,1,18,10,5,3
"2011","Swale 017C","E01024557","Total",43,22,9,12,4,0,2,2,39,22,7,10
"2011","Swale 017D","E01024558","Total",29,11,11,7,2,0,2,0,27,11,9,7
"2011","Thanet 001A","E01024657","Total",132,40,19,73,18,5,3,10,114,35,16,63
"2011","Thanet 001B","E01024658","Total",92,20,20,52,11,1,5,5,81,19,15,47
"2011","Thanet 001C","E01024659","Total",54,28,7,19,5,0,2,3,49,28,5,16
"2011","Thanet 001D","E01024660","Total",97,41,15,41,14,5,4,5,83,36,11,36
"2011","Thanet 001E","E01024678","Total",104,21,12,71,12,2,4,6,92,19,8,65
"2011","Thanet 002A","E01024653","Total",27,11,7,9,4,1,0,3,23,10,7,6
"2011","Thanet 002B","E01024654","Total",23,12,6,5,1,0,1,0,22,12,5,5
"2011","Thanet 002C","E01024655","Total",27,11,13,3,2,1,1,0,25,10,12,3
"2011","Thanet 002D","E01024656","Total",22,9,6,7,2,0,2,0,20,9,4,7
"2011","Thanet 002E","E01024675","Total",36,14,11,11,3,0,2,1,33,14,9,10
"2011","Thanet 003A","E01024676","Total",96,30,13,53,8,1,1,6,88,29,12,47
"2011","Thanet 003B","E01024677","Total",119,40,17,62,12,1,4,7,107,39,13,55
"2011","Thanet 003C","E01024695","Total",61,27,13,21,2,0,1,1,59,27,12,20
"2011","Thanet 003D","E01024697","Total",91,27,13,51,6,0,2,4,85,27,11,47
"2011","Thanet 003E","E01024710","Total",50,18,8,24,4,1,1,2,46,17,7,22
"2011","Thanet 004A","E01024661","Total",95,28,15,52,7,0,3,4,88,28,12,48
"2011","Thanet 004B","E01024664","Total",78,31,16,31,5,0,4,1,73,31,12,30
"2011","Thanet 004C","E01024665","Total",54,22,18,14,8,0,6,2,46,22,12,12
"2011","Thanet 004D","E01024694","Total",50,20,14,16,3,0,1,2,47,20,13,14
"2011","Thanet 004E","E01024696","Total",56,18,20,18,5,0,3,2,51,18,17,16
"2011","Thanet 005A","E01024672","Total",75,26,12,37,3,2,1,0,72,24,11,37
"2011","Thanet 005B","E01024673","Total",60,23,14,23,2,1,0,1,58,22,14,22
"2011","Thanet 005C","E01024674","Total",21,6,10,5,2,0,2,0,19,6,8,5
"2011","Thanet 005D","E01024711","Total",19,7,8,4,3,2,1,0,16,5,7,4
"2011","Thanet 005E","E01024712","Total",21,9,9,3,3,1,2,0,18,8,7,3
"2011","Thanet 006A","E01024633","Total",74,17,18,39,6,2,2,2,68,15,16,37
"2011","Thanet 006B","E01024634","Total",65,14,16,35,4,0,2,2,61,14,14,33
"2011","Thanet 006C","E01024662","Total",64,20,13,31,7,1,5,1,57,19,8,30
"2011","Thanet 006D","E01024663","Total",139,48,14,77,12,3,0,9,127,45,14,68
"2011","Thanet 006E","E01024666","Total",92,20,7,65,5,1,1,3,87,19,6,62
"2011","Thanet 007A","E01024641","Total",48,15,8,25,6,1,2,3,42,14,6,22
"2011","Thanet 007B","E01024713","Total",66,21,15,30,5,4,1,0,61,17,14,30
"2011","Thanet 007C","E01024714","Total",30,6,9,15,4,0,2,2,26,6,7,13
"2011","Thanet 007D","E01024715","Total",50,23,13,14,1,1,0,0,49,22,13,14
"2011","Thanet 007E","E01024716","Total",79,37,18,24,4,1,0,3,75,36,18,21
"2011","Thanet 008A","E01024636","Total",34,11,15,8,7,1,6,0,27,10,9,8
"2011","Thanet 008B","E01024637","Total",20,10,5,5,7,1,2,4,13,9,3,1
"2011","Thanet 008C","E01024638","Total",32,10,9,13,4,0,3,1,28,10,6,12
"2011","Thanet 008D","E01024639","Total",50,18,17,15,5,1,3,1,45,17,14,14
"2011","Thanet 008E","E01024640","Total",23,9,5,9,1,0,1,0,22,9,4,9
"2011","Thanet 009A","E01024635","Total",45,18,8,19,4,1,1,2,41,17,7,17
"2011","Thanet 009B","E01024642","Total",36,18,12,6,5,0,3,2,31,18,9,4
"2011","Thanet 009C","E01024644","Total",19,10,4,5,3,0,2,1,16,10,2,4
"2011","Thanet 009D","E01024692","Total",86,34,27,25,10,3,5,2,76,31,22,23
"2011","Thanet 009E","E01024693","Total",35,15,11,9,7,1,4,2,28,14,7,7
"2011","Thanet 010A","E01024643","Total",46,15,16,15,12,1,8,3,34,14,8,12
"2011","Thanet 010B","E01024705","Total",34,13,9,12,3,1,1,1,31,12,8,11
"2011","Thanet 010C","E01024706","Total",36,15,11,10,1,0,1,0,35,15,10,10
"2011","Thanet 010D","E01024707","Total",39,18,12,9,5,0,4,1,34,18,8,8
"2011","Thanet 010E","E01024708","Total",14,5,3,6,0,0,0,0,14,5,3,6
"2011","Thanet 011A","E01024686","Total",51,18,9,24,6,0,3,3,45,18,6,21
"2011","Thanet 011B","E01024688","Total",36,13,7,16,3,0,1,2,33,13,6,14
"2011","Thanet 011C","E01024689","Total",27,8,14,5,2,0,2,0,25,8,12,5
"2011","Thanet 011D","E01024690","Total",37,13,13,11,2,0,2,0,35,13,11,11
"2011","Thanet 011E","E01024691","Total",35,15,9,11,2,1,1,0,33,14,8,11
"2011","Thanet 012A","E01024669","Total",105,46,27,32,12,3,2,7,93,43,25,25
"2011","Thanet 012B","E01024698","Total",54,19,10,25,4,0,0,4,50,19,10,21
"2011","Thanet 012C","E01024699","Total",121,47,16,58,15,2,4,9,106,45,12,49
"2011","Thanet 012D","E01024700","Total",88,40,20,28,4,0,3,1,84,40,17,27
"2011","Thanet 012E","E01024709","Total",15,7,5,3,0,0,0,0,15,7,5,3
"2011","Thanet 013A","E01024682","Total",101,27,9,65,4,0,1,3,97,27,8,62
"2011","Thanet 013B","E01024683","Total",104,25,13,66,10,3,3,4,94,22,10,62
"2011","Thanet 013C","E01024684","Total",63,17,9,37,13,2,5,6,50,15,4,31
"2011","Thanet 013D","E01024685","Total",79,26,12,41,11,1,4,6,68,25,8,35
"2011","Thanet 013E","E01024687","Total",73,22,14,37,7,0,2,5,66,22,12,32
"2011","Thanet 014A","E01024701","Total",38,15,13,10,4,0,4,0,34,15,9,10
"2011","Thanet 014B","E01024702","Total",33,10,11,12,3,0,2,1,30,10,9,11
"2011","Thanet 014C","E01024703","Total",40,18,11,11,3,0,2,1,37,18,9,10
"2011","Thanet 014D","E01024704","Total",55,25,15,15,10,2,4,4,45,23,11,11
"2011","Thanet 015A","E01024645","Total",67,24,15,28,7,0,3,4,60,24,12,24
"2011","Thanet 015B","E01024647","Total",58,14,21,23,10,2,7,1,48,12,14,22
"2011","Thanet 015C","E01024668","Total",92,36,17,39,7,1,3,3,85,35,14,36
"2011","Thanet 015D","E01024670","Total",96,43,12,41,7,2,0,5,89,41,12,36
"2011","Thanet 015E","E01024681","Total",107,33,23,51,6,1,3,2,101,32,20,49
"2011","Thanet 016A","E01024646","Total",83,23,17,43,10,1,2,7,73,22,15,36
"2011","Thanet 016B","E01024648","Total",62,19,19,24,9,0,8,1,53,19,11,23
"2011","Thanet 016C","E01024649","Total",87,27,23,37,10,1,1,8,77,26,22,29
"2011","Thanet 016D","E01024667","Total",100,31,7,62,8,3,1,4,92,28,6,58
"2011","Thanet 016E","E01024671","Total",76,27,15,34,10,6,2,2,66,21,13,32
"2011","Thanet 017A","E01024650","Total",29,11,14,4,7,0,7,0,22,11,7,4
"2011","Thanet 017B","E01024651","Total",25,9,8,8,2,0,1,1,23,9,7,7
"2011","Thanet 017C","E01024652","Total",28,14,8,6,2,0,1,1,26,14,7,5
"2011","Thanet 017D","E01024679","Total",18,7,8,3,1,0,1,0,17,7,7,3
"2011","Thanet 017E","E01024680","Total",46,22,12,12,3,0,1,2,43,22,11,10
"2011","Tonbridge and Malling 001A","E01024719","Total",43,15,15,13,6,1,4,1,37,14,11,12
"2011","Tonbridge and Malling 001B","E01024720","Total",18,8,6,4,1,0,1,0,17,8,5,4
"2011","Tonbridge and Malling 001C","E01024721","Total",23,7,12,4,6,0,5,1,17,7,7,3
"2011","Tonbridge and Malling 001D","E01024722","Total",36,14,16,6,4,0,3,1,32,14,13,5
"2011","Tonbridge and Malling 001E","E01024727","Total",85,34,32,19,14,3,8,3,71,31,24,16
"2011","Tonbridge and Malling 001F","E01024728","Total",50,20,14,16,6,1,4,1,44,19,10,15
"2011","Tonbridge and Malling 002C","E01024771","Total",92,30,25,37,9,2,6,1,83,28,19,36
"2011","Tonbridge and Malling 002D","E01024772","Total",45,16,16,13,11,0,8,3,34,16,8,10
"2011","Tonbridge and Malling 002E","E01024773","Total",28,10,13,5,4,0,4,0,24,10,9,5
"2011","Tonbridge and Malling 002F","E01024774","Total",92,27,33,32,8,0,4,4,84,27,29,28
"2011","Tonbridge and Malling 002G","E01032830","Total",93,36,17,40,5,0,3,2,88,36,14,38
"2011","Tonbridge and Malling 003A","E01024741","Total",74,19,9,46,4,0,3,1,70,19,6,45
"2011","Tonbridge and Malling 003B","E01024761","Total",57,21,22,14,15,0,15,0,42,21,7,14
"2011","Tonbridge and Malling 003C","E01024762","Total",56,25,16,15,4,1,3,0,52,24,13,15
"2011","Tonbridge and Malling 003D","E01024763","Total",42,19,11,12,5,1,3,1,37,18,8,11
"2011","Tonbridge and Malling 003E","E01024764","Total",36,16,10,10,7,2,3,2,29,14,7,8
"2011","Tonbridge and Malling 003F","E01024765","Total",20,7,8,5,3,0,2,1,17,7,6,4
"2011","Tonbridge and Malling 003G","E01024782","Total",23,10,9,4,3,0,3,0,20,10,6,4
"2011","Tonbridge and Malling 003H","E01024785","Total",36,13,11,12,2,0,1,1,34,13,10,11
"2011","Tonbridge and Malling 005A","E01024717","Total",37,14,8,15,2,0,1,1,35,14,7,14
"2011","Tonbridge and Malling 005B","E01024718","Total",13,5,7,1,3,0,2,1,10,5,5,0
"2011","Tonbridge and Malling 005C","E01024735","Total",30,8,14,8,8,1,7,0,22,7,7,8
"2011","Tonbridge and Malling 005D","E01024736","Total",57,17,13,27,4,1,2,1,53,16,11,26
"2011","Tonbridge and Malling 005E","E01024737","Total",97,34,17,46,11,0,8,3,86,34,9,43
"2011","Tonbridge and Malling 006A","E01024723","Total",17,4,7,6,1,0,1,0,16,4,6,6
"2011","Tonbridge and Malling 006B","E01024724","Total",53,22,14,17,9,1,6,2,44,21,8,15
"2011","Tonbridge and Malling 006C","E01024725","Total",37,20,10,7,3,1,1,1,34,19,9,6
"2011","Tonbridge and Malling 006D","E01024726","Total",44,14,14,16,4,0,2,2,40,14,12,14
"2011","Tonbridge and Malling 006E","E01024755","Total",31,10,13,8,5,0,4,1,26,10,9,7
"2011","Tonbridge and Malling 006F","E01024786","Total",59,16,13,30,3,1,1,1,56,15,12,29
"2011","Tonbridge and Malling 007A","E01024746","Total",18,10,2,6,2,1,0,1,16,9,2,5
"2011","Tonbridge and Malling 007C","E01024760","Total",42,14,16,12,10,0,9,1,32,14,7,11
"2011","Tonbridge and Malling 007D","E01024781","Total",36,14,14,8,7,2,4,1,29,12,10,7
"2011","Tonbridge and Malling 007E","E01032825","Total",73,38,17,18,6,1,4,1,67,37,13,17
"2011","Tonbridge and Malling 007F","E01032826","Total",42,13,21,8,8,1,7,0,34,12,14,8
"2011","Tonbridge and Malling 007G","E01032827","Total",51,16,16,19,6,1,5,0,45,15,11,19
"2011","Tonbridge and Malling 007H","E01032828","Total",18,6,8,4,3,0,3,0,15,6,5,4
"2011","Tonbridge and Malling 008A","E01024743","Total",34,14,9,11,4,1,3,0,30,13,6,11
"2011","Tonbridge and Malling 008B","E01024744","Total",26,10,8,8,2,0,1,1,24,10,7,7
"2011","Tonbridge and Malling 008C","E01024745","Total",30,16,6,8,5,3,2,0,25,13,4,8
"2011","Tonbridge and Malling 008D","E01024747","Total",54,15,12,27,4,0,3,1,50,15,9,26
"2011","Tonbridge and Malling 009A","E01024730","Total",27,13,9,5,2,1,1,0,25,12,8,5
"2011","Tonbridge and Malling 009B","E01024731","Total",8,1,5,2,1,0,1,0,7,1,4,2
"2011","Tonbridge and Malling 009C","E01024775","Total",80,29,11,40,3,1,0,2,77,28,11,38
"2011","Tonbridge and Malling 009D","E01024776","Total",34,14,8,12,2,0,2,0,32,14,6,12
"2011","Tonbridge and Malling 009E","E01024777","Total",28,6,8,14,3,0,3,0,25,6,5,14
"2011","Tonbridge and Malling 010A","E01024734","Total",31,12,13,6,0,0,0,0,31,12,13,6
"2011","Tonbridge and Malling 010B","E01024752","Total",25,10,11,4,5,1,4,0,20,9,7,4
"2011","Tonbridge and Malling 010C","E01024753","Total",33,11,14,8,6,0,5,1,27,11,9,7
"2011","Tonbridge and Malling 010D","E01024754","Total",23,7,10,6,3,0,2,1,20,7,8,5
"2011","Tonbridge and Malling 011A","E01024729","Total",63,26,12,25,8,5,3,0,55,21,9,25
"2011","Tonbridge and Malling 011B","E01024748","Total",14,6,7,1,1,0,0,1,13,6,7,0
"2011","Tonbridge and Malling 011C","E01024749","Total",61,29,11,21,7,3,2,2,54,26,9,19
"2011","Tonbridge and Malling 011D","E01024750","Total",30,19,5,6,1,0,0,1,29,19,5,5
"2011","Tonbridge and Malling 011E","E01024751","Total",9,4,3,2,1,1,0,0,8,3,3,2
"2011","Tonbridge and Malling 012A","E01024732","Total",37,12,15,10,6,0,6,0,31,12,9,10
"2011","Tonbridge and Malling 012B","E01024733","Total",32,16,9,7,1,0,1,0,31,16,8,7
"2011","Tonbridge and Malling 012C","E01024756","Total",69,18,28,23,6,0,6,0,63,18,22,23
"2011","Tonbridge and Malling 012D","E01024766","Total",57,17,27,13,13,3,10,0,44,14,17,13
"2011","Tonbridge and Malling 012E","E01024767","Total",64,16,21,27,10,1,6,3,54,15,15,24
"2011","Tonbridge and Malling 012F","E01024768","Total",29,7,14,8,6,0,6,0,23,7,8,8
"2011","Tonbridge and Malling 013A","E01024757","Total",30,11,15,4,6,1,4,1,24,10,11,3
"2011","Tonbridge and Malling 013B","E01024758","Total",33,16,9,8,5,2,2,1,28,14,7,7
"2011","Tonbridge and Malling 013C","E01024778","Total",38,14,15,9,4,0,2,2,34,14,13,7
"2011","Tonbridge and Malling 013D","E01024779","Total",34,15,9,10,4,1,2,1,30,14,7,9
"2011","Tonbridge and Malling 013E","E01024780","Total",66,20,25,21,9,0,7,2,57,20,18,19
"2011","Tonbridge and Malling 014A","E01024740","Total",48,21,15,12,3,0,2,1,45,21,13,11
"2011","Tonbridge and Malling 014B","E01024742","Total",75,22,14,39,6,2,2,2,69,20,12,37
"2011","Tonbridge and Malling 014C","E01024783","Total",35,12,8,15,3,0,2,1,32,12,6,14
"2011","Tonbridge and Malling 014D","E01024784","Total",14,6,4,4,2,0,2,0,12,6,2,4
"2011","Tonbridge and Malling 014E","E01032620","Total",37,14,13,10,7,2,4,1,30,12,9,9
"2011","Tonbridge and Malling 014F","E01032829","Total",19,5,4,10,3,1,2,0,16,4,2,10
"2011","Tunbridge Wells 001A","E01024798","Total",52,23,15,14,6,1,2,3,46,22,13,11
"2011","Tunbridge Wells 001B","E01024811","Total",21,8,9,4,2,0,2,0,19,8,7,4
"2011","Tunbridge Wells 001C","E01024812","Total",24,7,10,7,2,0,2,0,22,7,8,7
"2011","Tunbridge Wells 001D","E01024813","Total",39,15,12,12,4,1,2,1,35,14,10,11
"2011","Tunbridge Wells 001E","E01024814","Total",15,6,7,2,1,0,1,0,14,6,6,2
"2011","Tunbridge Wells 001F","E01024815","Total",41,12,5,24,1,0,0,1,40,12,5,23
"2011","Tunbridge Wells 001G","E01024816","Total",31,13,9,9,5,2,2,1,26,11,7,8
"2011","Tunbridge Wells 002A","E01024837","Total",39,16,14,9,4,0,3,1,35,16,11,8
"2011","Tunbridge Wells 002B","E01024844","Total",46,14,17,15,4,0,2,2,42,14,15,13
"2011","Tunbridge Wells 002C","E01024846","Total",43,18,13,12,4,0,3,1,39,18,10,11
"2011","Tunbridge Wells 002D","E01024849","Total",40,17,13,10,7,1,2,4,33,16,11,6
"2011","Tunbridge Wells 002E","E01024850","Total",13,2,4,7,3,0,1,2,10,2,3,5
"2011","Tunbridge Wells 003A","E01024836","Total",56,15,17,24,3,0,2,1,53,15,15,23
"2011","Tunbridge Wells 003B","E01024839","Total",30,9,12,9,1,0,1,0,29,9,11,9
"2011","Tunbridge Wells 003C","E01024845","Total",39,16,9,14,2,1,1,0,37,15,8,14
"2011","Tunbridge Wells 003D","E01024847","Total",61,17,15,29,5,0,4,1,56,17,11,28
"2011","Tunbridge Wells 003E","E01024848","Total",28,10,6,12,1,0,0,1,27,10,6,11
"2011","Tunbridge Wells 004A","E01024793","Total",28,10,10,8,3,0,2,1,25,10,8,7
"2011","Tunbridge Wells 004B","E01024825","Total",17,6,6,5,0,0,0,0,17,6,6,5
"2011","Tunbridge Wells 004C","E01024826","Total",18,8,8,2,3,0,3,0,15,8,5,2
"2011","Tunbridge Wells 004D","E01024827","Total",35,14,11,10,3,1,2,0,32,13,9,10
"2011","Tunbridge Wells 004E","E01024828","Total",35,13,9,13,4,0,2,2,31,13,7,11
"2011","Tunbridge Wells 005A","E01024840","Total",94,24,11,59,8,1,1,6,86,23,10,53
"2011","Tunbridge Wells 005B","E01024841","Total",72,19,7,46,8,1,3,4,64,18,4,42
"2011","Tunbridge Wells 005C","E01024842","Total",45,21,7,17,4,3,1,0,41,18,6,17
"2011","Tunbridge Wells 005D","E01024843","Total",67,18,19,30,5,1,3,1,62,17,16,29
"2011","Tunbridge Wells 006A","E01024829","Total",34,17,13,4,4,0,4,0,30,17,9,4
"2011","Tunbridge Wells 006B","E01024851","Total",21,12,3,6,3,2,1,0,18,10,2,6
"2011","Tunbridge Wells 006C","E01024852","Total",7,4,1,2,0,0,0,0,7,4,1,2
"2011","Tunbridge Wells 006D","E01024853","Total",15,4,7,4,3,0,3,0,12,4,4,4
"2011","Tunbridge Wells 006E","E01024854","Total",18,6,4,8,1,1,0,0,17,5,4,8
"2011","Tunbridge Wells 007A","E01024799","Total",29,11,12,6,4,0,3,1,25,11,9,5
"2011","Tunbridge Wells 007B","E01024800","Total",14,7,6,1,3,0,3,0,11,7,3,1
"2011","Tunbridge Wells 007C","E01024835","Total",46,18,18,10,6,1,5,0,40,17,13,10
"2011","Tunbridge Wells 007D","E01024838","Total",27,16,9,2,1,0,1,0,26,16,8,2
"2011","Tunbridge Wells 008A","E01024801","Total",49,12,13,24,7,2,3,2,42,10,10,22
"2011","Tunbridge Wells 008B","E01024802","Total",37,14,17,6,5,1,2,2,32,13,15,4
"2011","Tunbridge Wells 008C","E01024823","Total",24,9,6,9,6,1,3,2,18,8,3,7
"2011","Tunbridge Wells 008D","E01024833","Total",68,22,13,33,3,0,2,1,65,22,11,32
"2011","Tunbridge Wells 009A","E01024821","Total",31,17,8,6,3,0,3,0,28,17,5,6
"2011","Tunbridge Wells 009B","E01024822","Total",32,12,8,12,5,1,1,3,27,11,7,9
"2011","Tunbridge Wells 009C","E01024824","Total",23,9,11,3,3,0,2,1,20,9,9,2
"2011","Tunbridge Wells 009D","E01024832","Total",32,9,14,9,4,0,4,0,28,9,10,9
"2011","Tunbridge Wells 009E","E01024834","Total",62,24,16,22,1,0,1,0,61,24,15,22
"2011","Tunbridge Wells 010A","E01024795","Total",80,25,5,50,9,1,0,8,71,24,5,42
"2011","Tunbridge Wells 010B","E01024796","Total",34,18,5,11,3,0,1,2,31,18,4,9
"2011","Tunbridge Wells 010C","E01024830","Total",55,18,13,24,8,1,6,1,47,17,7,23
"2011","Tunbridge Wells 010D","E01024831","Total",54,20,6,28,3,2,0,1,51,18,6,27
"2011","Tunbridge Wells 011A","E01024792","Total",22,11,10,1,4,1,3,0,18,10,7,1
"2011","Tunbridge Wells 011B","E01024794","Total",32,14,8,10,3,1,2,0,29,13,6,10
"2011","Tunbridge Wells 011C","E01024804","Total",22,8,7,7,5,1,3,1,17,7,4,6
"2011","Tunbridge Wells 011D","E01024805","Total",28,13,6,9,1,1,0,0,27,12,6,9
"2011","Tunbridge Wells 011E","E01024806","Total",32,14,9,9,8,2,4,2,24,12,5,7
"2011","Tunbridge Wells 012A","E01024797","Total",16,5,6,5,2,0,2,0,14,5,4,5
"2011","Tunbridge Wells 012B","E01024817","Total",26,8,10,8,2,0,2,0,24,8,8,8
"2011","Tunbridge Wells 012C","E01024818","Total",31,10,10,11,3,0,2,1,28,10,8,10
"2011","Tunbridge Wells 012D","E01024819","Total",25,6,11,8,3,0,3,0,22,6,8,8
"2011","Tunbridge Wells 012E","E01024820","Total",20,9,4,7,6,3,3,0,14,6,1,7
"2011","Tunbridge Wells 013A","E01024787","Total",25,11,4,10,3,1,1,1,22,10,3,9
"2011","Tunbridge Wells 013B","E01024788","Total",61,26,13,22,2,0,1,1,59,26,12,21
"2011","Tunbridge Wells 013C","E01024790","Total",28,9,6,13,3,0,1,2,25,9,5,11
"2011","Tunbridge Wells 013D","E01024791","Total",44,13,19,12,9,1,5,3,35,12,14,9
"2011","Tunbridge Wells 013E","E01024803","Total",44,16,12,16,8,1,5,2,36,15,7,14
"2011","Tunbridge Wells 014A","E01024789","Total",35,13,12,10,8,1,7,0,27,12,5,10
"2011","Tunbridge Wells 014B","E01024807","Total",49,15,11,23,2,2,0,0,47,13,11,23
"2011","Tunbridge Wells 014C","E01024808","Total",34,14,11,9,2,0,2,0,32,14,9,9
"2011","Tunbridge Wells 014D","E01024809","Total",26,14,8,4,4,1,3,0,22,13,5,4
"2011","Tunbridge Wells 014E","E01024810","Total",28,12,6,10,1,0,1,0,27,12,5,10
"2011","Cherwell 001A","E01028479","Total",11,3,4,4,4,1,3,0,7,2,1,4
"2011","Cherwell 001B","E01028480","Total",21,9,7,5,6,1,5,0,15,8,2,5
"2011","Cherwell 001C","E01028508","Total",17,7,5,5,3,0,2,1,14,7,3,4
"2011","Cherwell 001D","E01028509","Total",16,7,7,2,5,0,4,1,11,7,3,1
"2011","Cherwell 002A","E01028441","Total",105,42,19,44,9,0,3,6,96,42,16,38
"2011","Cherwell 002C","E01028443","Total",45,21,13,11,0,0,0,0,45,21,13,11
"2011","Cherwell 002D","E01028444","Total",31,15,7,9,0,0,0,0,31,15,7,9
"2011","Cherwell 002E","E01032943","Total",65,22,20,23,5,1,4,0,60,21,16,23
"2011","Cherwell 002F","E01032944","Total",56,26,15,15,5,0,3,2,51,26,12,13
"2011","Cherwell 003A","E01028445","Total",55,24,9,22,8,3,3,2,47,21,6,20
"2011","Cherwell 003B","E01028446","Total",40,15,13,12,5,1,3,1,35,14,10,11
"2011","Cherwell 003C","E01028447","Total",35,9,9,17,4,0,4,0,31,9,5,17
"2011","Cherwell 003D","E01028448","Total",66,25,16,25,2,0,1,1,64,25,15,24
"2011","Cherwell 004A","E01028435","Total",57,13,12,32,2,1,0,1,55,12,12,31
"2011","Cherwell 004C","E01028437","Total",30,14,10,6,3,1,2,0,27,13,8,6
"2011","Cherwell 004D","E01028438","Total",44,21,13,10,4,1,3,0,40,20,10,10
"2011","Cherwell 004E","E01028439","Total",43,18,15,10,3,0,2,1,40,18,13,9
"2011","Cherwell 004F","E01028440","Total",56,17,12,27,6,1,3,2,50,16,9,25
"2011","Cherwell 004G","E01032941","Total",57,13,13,31,4,0,3,1,53,13,10,30
"2011","Cherwell 004H","E01032942","Total",74,21,14,39,4,1,2,1,70,20,12,38
"2011","Cherwell 005A","E01028449","Total",56,22,10,24,6,1,1,4,50,21,9,20
"2011","Cherwell 005B","E01028450","Total",89,30,9,50,2,0,1,1,87,30,8,49
"2011","Cherwell 005C","E01028451","Total",42,17,9,16,1,0,1,0,41,17,8,16
"2011","Cherwell 005D","E01028452","Total",58,14,6,38,3,0,0,3,55,14,6,35
"2011","Cherwell 005E","E01028453","Total",68,23,11,34,3,0,2,1,65,23,9,33
"2011","Cherwell 005F","E01028454","Total",80,28,10,42,9,0,4,5,71,28,6,37
"2011","Cherwell 006A","E01028430","Total",37,15,15,7,4,1,3,0,33,14,12,7
"2011","Cherwell 006B","E01028431","Total",24,10,9,5,2,0,2,0,22,10,7,5
"2011","Cherwell 006C","E01028432","Total",38,12,19,7,5,0,5,0,33,12,14,7
"2011","Cherwell 006D","E01028433","Total",24,13,3,8,1,1,0,0,23,12,3,8
"2011","Cherwell 006E","E01028434","Total",15,3,9,3,2,0,2,0,13,3,7,3
"2011","Cherwell 007A","E01028426","Total",50,27,14,9,4,0,4,0,46,27,10,9
"2011","Cherwell 007B","E01028427","Total",35,9,15,11,1,0,1,0,34,9,14,11
"2011","Cherwell 007C","E01028428","Total",26,10,13,3,3,0,2,1,23,10,11,2
"2011","Cherwell 007D","E01028429","Total",10,4,6,0,3,0,3,0,7,4,3,0
"2011","Cherwell 008A","E01028422","Total",36,14,10,12,3,1,2,0,33,13,8,12
"2011","Cherwell 008B","E01028423","Total",23,10,6,7,1,0,1,0,22,10,5,7
"2011","Cherwell 008C","E01028475","Total",34,17,12,5,5,0,5,0,29,17,7,5
"2011","Cherwell 008D","E01028476","Total",42,20,14,8,3,0,2,1,39,20,12,7
"2011","Cherwell 009A","E01028474","Total",42,17,13,12,2,0,1,1,40,17,12,11
"2011","Cherwell 009B","E01028485","Total",30,13,10,7,3,1,2,0,27,12,8,7
"2011","Cherwell 009C","E01028486","Total",11,4,7,0,0,0,0,0,11,4,7,0
"2011","Cherwell 009D","E01028503","Total",13,8,3,2,1,1,0,0,12,7,3,2
"2011","Cherwell 009E","E01028504","Total",20,13,6,1,3,2,1,0,17,11,5,1
"2011","Cherwell 010A","E01028481","Total",29,10,10,9,1,0,1,0,28,10,9,9
"2011","Cherwell 010B","E01028482","Total",15,5,9,1,0,0,0,0,15,5,9,1
"2011","Cherwell 010C","E01028505","Total",55,24,16,15,4,0,2,2,51,24,14,13
"2011","Cherwell 010D","E01028506","Total",23,10,5,8,4,2,1,1,19,8,4,7
"2011","Cherwell 010E","E01028507","Total",13,5,7,1,2,0,2,0,11,5,5,1
"2011","Cherwell 011A","E01028425","Total",45,18,15,12,4,1,3,0,41,17,12,12
"2011","Cherwell 011B","E01028477","Total",28,11,9,8,1,0,0,1,27,11,9,7
"2011","Cherwell 011C","E01028478","Total",31,8,17,6,4,0,4,0,27,8,13,6
"2011","Cherwell 011D","E01028483","Total",12,5,5,2,1,0,1,0,11,5,4,2
"2011","Cherwell 011E","E01028484","Total",13,3,7,3,2,0,2,0,11,3,5,3
"2011","Cherwell 011F","E01028499","Total",12,5,5,2,2,0,2,0,10,5,3,2
"2011","Cherwell 012A","E01028459","Total",38,15,13,10,2,0,2,0,36,15,11,10
"2011","Cherwell 012B","E01028460","Total",48,13,20,15,3,0,3,0,45,13,17,15
"2011","Cherwell 012C","E01028461","Total",55,22,21,12,5,2,2,1,50,20,19,11
"2011","Cherwell 012D","E01028462","Total",31,13,7,11,0,0,0,0,31,13,7,11
"2011","Cherwell 013A","E01028455","Total",33,11,10,12,2,0,1,1,31,11,9,11
"2011","Cherwell 013B","E01028456","Total",38,10,8,20,2,1,0,1,36,9,8,19
"2011","Cherwell 013C","E01028457","Total",24,14,7,3,3,1,2,0,21,13,5,3
"2011","Cherwell 013D","E01028458","Total",50,22,11,17,5,0,2,3,45,22,9,14
"2011","Cherwell 013E","E01028467","Total",32,10,12,10,3,0,3,0,29,10,9,10
"2011","Cherwell 014A","E01028466","Total",62,19,15,28,4,1,3,0,58,18,12,28
"2011","Cherwell 014B","E01028469","Total",16,8,5,3,1,0,1,0,15,8,4,3
"2011","Cherwell 014C","E01028470","Total",31,9,9,13,5,0,4,1,26,9,5,12
"2011","Cherwell 014D","E01028471","Total",53,21,7,25,3,1,1,1,50,20,6,24
"2011","Cherwell 014E","E01028472","Total",24,7,12,5,4,1,3,0,20,6,9,5
"2011","Cherwell 014F","E01028473","Total",28,16,8,4,2,0,1,1,26,16,7,3
"2011","Cherwell 015A","E01028463","Total",80,25,24,31,4,0,2,2,76,25,22,29
"2011","Cherwell 015B","E01028464","Total",24,10,11,3,2,0,2,0,22,10,9,3
"2011","Cherwell 015C","E01028465","Total",37,17,13,7,2,0,2,0,35,17,11,7
"2011","Cherwell 015D","E01028468","Total",34,14,11,9,6,1,4,1,28,13,7,8
"2011","Cherwell 016A","E01028424","Total",10,3,5,2,0,0,0,0,10,3,5,2
"2011","Cherwell 016B","E01028497","Total",15,6,6,3,4,0,3,1,11,6,3,2
"2011","Cherwell 016C","E01028498","Total",31,14,10,7,2,0,2,0,29,14,8,7
"2011","Cherwell 016D","E01028500","Total",33,15,13,5,2,1,1,0,31,14,12,5
"2011","Cherwell 016E","E01028501","Total",9,5,3,1,1,0,1,0,8,5,2,1
"2011","Cherwell 016F","E01028502","Total",19,8,10,1,2,0,2,0,17,8,8,1
"2011","Cherwell 017A","E01028487","Total",33,11,13,9,3,1,2,0,30,10,11,9
"2011","Cherwell 017B","E01028489","Total",10,5,2,3,1,0,1,0,9,5,1,3
"2011","Cherwell 017C","E01028490","Total",23,10,5,8,0,0,0,0,23,10,5,8
"2011","Cherwell 017D","E01028491","Total",14,6,3,5,0,0,0,0,14,6,3,5
"2011","Cherwell 017E","E01028494","Total",35,14,6,15,1,0,0,1,34,14,6,14
"2011","Cherwell 018A","E01028492","Total",24,11,5,8,1,1,0,0,23,10,5,8
"2011","Cherwell 018B","E01028493","Total",33,8,10,15,3,1,1,1,30,7,9,14
"2011","Cherwell 018C","E01028495","Total",30,13,10,7,2,2,0,0,28,11,10,7
"2011","Cherwell 018D","E01028496","Total",46,23,13,10,2,0,2,0,44,23,11,10
"2011","Cherwell 019A","E01028488","Total",36,13,11,12,1,0,1,0,35,13,10,12
"2011","Cherwell 019B","E01028510","Total",25,12,10,3,6,2,3,1,19,10,7,2
"2011","Cherwell 019C","E01028511","Total",25,6,14,5,2,0,2,0,23,6,12,5
"2011","Cherwell 019D","E01028512","Total",37,21,14,2,3,1,1,1,34,20,13,1
"2011","Oxford 001A","E01028594","Total",22,8,5,9,1,0,1,0,21,8,4,9
"2011","Oxford 001B","E01028595","Total",34,10,13,11,3,0,3,0,31,10,10,11
"2011","Oxford 001C","E01028596","Total",22,9,7,6,1,0,1,0,21,9,6,6
"2011","Oxford 001D","E01028597","Total",42,15,8,19,1,1,0,0,41,14,8,19
"2011","Oxford 002C","E01028591","Total",16,5,7,4,2,0,2,0,14,5,5,4
"2011","Oxford 002D","E01028592","Total",20,9,9,2,4,1,3,0,16,8,6,2
"2011","Oxford 002F","E01032554","Total",24,6,14,4,2,1,1,0,22,5,13,4
"2011","Oxford 002G","E01032555","Total",103,31,19,53,6,1,3,2,97,30,16,51
"2011","Oxford 003A","E01028565","Total",13,5,5,3,2,0,1,1,11,5,4,2
"2011","Oxford 003B","E01028583","Total",16,2,5,9,3,0,3,0,13,2,2,9
"2011","Oxford 003C","E01028584","Total",58,17,18,23,3,0,2,1,55,17,16,22
"2011","Oxford 003D","E01028585","Total",10,3,5,2,2,0,2,0,8,3,3,2
"2011","Oxford 004A","E01028560","Total",34,14,12,8,4,2,2,0,30,12,10,8
"2011","Oxford 004B","E01028561","Total",28,11,8,9,1,0,1,0,27,11,7,9
"2011","Oxford 004C","E01028562","Total",56,17,15,24,3,0,3,0,53,17,12,24
"2011","Oxford 004D","E01028563","Total",18,8,7,3,0,0,0,0,18,8,7,3
"2011","Oxford 005A","E01028513","Total",140,39,22,79,5,1,1,3,135,38,21,76
"2011","Oxford 005B","E01028514","Total",85,20,10,55,6,3,0,3,79,17,10,52
"2011","Oxford 005C","E01028516","Total",74,19,13,42,2,2,0,0,72,17,13,42
"2011","Oxford 005D","E01028538","Total",52,19,10,23,5,1,2,2,47,18,8,21
"2011","Oxford 006A","E01028534","Total",8,2,3,3,1,0,1,0,7,2,2,3
"2011","Oxford 006B","E01028535","Total",12,4,4,4,1,0,1,0,11,4,3,4
"2011","Oxford 006C","E01028536","Total",17,3,2,12,0,0,0,0,17,3,2,12
"2011","Oxford 006D","E01028537","Total",15,1,9,5,3,0,3,0,12,1,6,5
"2011","Oxford 006E","E01028539","Total",42,12,11,19,0,0,0,0,42,12,11,19
"2011","Oxford 006F","E01028540","Total",22,7,10,5,3,0,3,0,19,7,7,5
"2011","Oxford 007A","E01028515","Total",41,9,10,22,3,0,2,1,38,9,8,21
"2011","Oxford 007B","E01028571","Total",33,16,11,6,5,1,4,0,28,15,7,6
"2011","Oxford 007C","E01028572","Total",32,7,11,14,1,0,0,1,31,7,11,13
"2011","Oxford 007D","E01028573","Total",16,5,9,2,1,0,1,0,15,5,8,2
"2011","Oxford 007E","E01028574","Total",40,11,4,25,1,0,1,0,39,11,3,25
"2011","Oxford 008A","E01028521","Total",13,4,4,5,5,0,4,1,8,4,0,4
"2011","Oxford 008B","E01028522","Total",37,11,14,12,3,1,2,0,34,10,12,12
"2011","Oxford 008E","E01033282","Total",39,14,8,17,7,1,2,4,32,13,6,13
"2011","Oxford 009A","E01028548","Total",28,8,12,8,3,0,3,0,25,8,9,8
"2011","Oxford 009B","E01028549","Total",16,8,5,3,1,0,1,0,15,8,4,3
"2011","Oxford 009C","E01028550","Total",36,13,7,16,5,1,3,1,31,12,4,15
"2011","Oxford 009D","E01028551","Total",25,5,8,12,4,0,2,2,21,5,6,10
"2011","Oxford 010A","E01028523","Total",45,14,8,23,1,0,1,0,44,14,7,23
"2011","Oxford 010B","E01028524","Total",72,12,8,52,2,0,0,2,70,12,8,50
"2011","Oxford 010C","E01028525","Total",100,28,11,61,11,1,1,9,89,27,10,52
"2011","Oxford 010D","E01028526","Total",28,6,12,10,1,0,1,0,27,6,11,10
"2011","Oxford 011A","E01028579","Total",18,8,4,6,0,0,0,0,18,8,4,6
"2011","Oxford 011B","E01028580","Total",19,7,4,8,2,1,0,1,17,6,4,7
"2011","Oxford 011C","E01028581","Total",19,8,5,6,2,0,1,1,17,8,4,5
"2011","Oxford 011D","E01028582","Total",26,4,11,11,6,0,2,4,20,4,9,7
"2011","Oxford 011E","E01028586","Total",20,6,6,8,2,1,1,0,18,5,5,8
"2011","Oxford 011F","E01028587","Total",34,9,6,19,3,0,1,2,31,9,5,17
"2011","Oxford 011G","E01028588","Total",10,7,2,1,1,0,0,1,9,7,2,0
"2011","Oxford 012A","E01028541","Total",25,6,10,9,4,2,2,0,21,4,8,9
"2011","Oxford 012B","E01028542","Total",54,17,14,23,6,0,3,3,48,17,11,20
"2011","Oxford 012C","E01028543","Total",32,11,11,10,4,0,3,1,28,11,8,9
"2011","Oxford 012D","E01028544","Total",15,3,6,6,2,0,2,0,13,3,4,6
"2011","Oxford 013A","E01028531","Total",41,21,8,12,1,0,1,0,40,21,7,12
"2011","Oxford 013B","E01028532","Total",53,18,15,20,6,0,3,3,47,18,12,17
"2011","Oxford 013C","E01028533","Total",71,12,6,53,4,0,0,4,67,12,6,49
"2011","Oxford 013D","E01028556","Total",63,17,11,35,4,0,2,2,59,17,9,33
"2011","Oxford 013E","E01028557","Total",70,23,11,36,6,3,1,2,64,20,10,34
"2011","Oxford 013F","E01028558","Total",47,15,16,16,11,0,9,2,36,15,7,14
"2011","Oxford 013G","E01028559","Total",31,8,6,17,1,0,1,0,30,8,5,17
"2011","Oxford 014A","E01028545","Total",26,8,8,10,1,0,1,0,25,8,7,10
"2011","Oxford 014B","E01028546","Total",60,25,9,26,10,2,5,3,50,23,4,23
"2011","Oxford 014C","E01028547","Total",37,13,16,8,1,0,1,0,36,13,15,8
"2011","Oxford 015A","E01028527","Total",34,14,8,12,2,0,1,1,32,14,7,11
"2011","Oxford 015B","E01028528","Total",28,8,3,17,3,0,2,1,25,8,1,16
"2011","Oxford 015C","E01028529","Total",62,17,7,38,5,1,0,4,57,16,7,34
"2011","Oxford 015D","E01028530","Total",61,22,12,27,12,3,5,4,49,19,7,23
"2011","Oxford 015E","E01028575","Total",26,7,11,8,4,0,4,0,22,7,7,8
"2011","Oxford 015F","E01028578","Total",19,9,6,4,1,0,0,1,18,9,6,3
"2011","Oxford 016A","E01028552","Total",101,23,14,64,6,3,2,1,95,20,12,63
"2011","Oxford 016B","E01028553","Total",75,23,17,35,7,4,1,2,68,19,16,33
"2011","Oxford 016C","E01028554","Total",38,8,8,22,4,0,4,0,34,8,4,22
"2011","Oxford 016D","E01028555","Total",50,21,12,17,3,0,3,0,47,21,9,17
"2011","Oxford 016E","E01028576","Total",87,25,7,55,4,1,0,3,83,24,7,52
"2011","Oxford 016F","E01028577","Total",87,25,9,53,4,2,0,2,83,23,9,51
"2011","Oxford 017A","E01028517","Total",85,28,18,39,7,1,3,3,78,27,15,36
"2011","Oxford 017B","E01028518","Total",123,40,22,61,10,4,2,4,113,36,20,57
"2011","Oxford 017C","E01028519","Total",70,14,19,37,8,0,3,5,62,14,16,32
"2011","Oxford 017D","E01028567","Total",102,29,21,52,10,0,7,3,92,29,14,49
"2011","Oxford 018A","E01028520","Total",118,35,10,73,6,0,3,3,112,35,7,70
"2011","Oxford 018B","E01028568","Total",131,44,14,73,3,0,1,2,128,44,13,71
"2011","Oxford 018C","E01028569","Total",152,50,23,79,19,0,8,11,133,50,15,68
"2011","Oxford 018D","E01028570","Total",108,43,25,40,4,1,1,2,104,42,24,38
"2011","South Oxfordshire 001A","E01028666","Total",32,11,15,6,1,0,1,0,31,11,14,6
"2011","South Oxfordshire 001B","E01028667","Total",33,10,16,7,2,0,2,0,31,10,14,7
"2011","South Oxfordshire 001C","E01028668","Total",22,10,9,3,2,0,2,0,20,10,7,3
"2011","South Oxfordshire 001D","E01028669","Total",26,16,7,3,2,1,1,0,24,15,6,3
"2011","South Oxfordshire 002A","E01028638","Total",17,5,6,6,4,0,2,2,13,5,4,4
"2011","South Oxfordshire 002B","E01028639","Total",22,3,10,9,5,0,4,1,17,3,6,8
"2011","South Oxfordshire 002C","E01028640","Total",27,13,9,5,4,1,2,1,23,12,7,4
"2011","South Oxfordshire 002D","E01028683","Total",10,6,2,2,2,0,1,1,8,6,1,1
"2011","South Oxfordshire 003A","E01028670","Total",19,6,8,5,1,0,1,0,18,6,7,5
"2011","South Oxfordshire 003B","E01028671","Total",32,13,11,8,3,0,2,1,29,13,9,7
"2011","South Oxfordshire 003C","E01028672","Total",17,7,4,6,2,0,2,0,15,7,2,6
"2011","South Oxfordshire 003D","E01028673","Total",38,15,15,8,7,1,5,1,31,14,10,7
"2011","South Oxfordshire 004A","E01028646","Total",17,6,3,8,2,0,0,2,15,6,3,6
"2011","South Oxfordshire 004B","E01028647","Total",23,7,11,5,1,0,1,0,22,7,10,5
"2011","South Oxfordshire 004C","E01028681","Total",20,5,11,4,3,0,3,0,17,5,8,4
"2011","South Oxfordshire 004D","E01028682","Total",15,5,6,4,0,0,0,0,15,5,6,4
"2011","South Oxfordshire 004E","E01028684","Total",24,16,7,1,4,2,2,0,20,14,5,1
"2011","South Oxfordshire 005A","E01028598","Total",32,15,9,8,10,4,4,2,22,11,5,6
"2011","South Oxfordshire 005B","E01028613","Total",25,8,16,1,3,0,3,0,22,8,13,1
"2011","South Oxfordshire 005C","E01028614","Total",31,13,8,10,1,0,1,0,30,13,7,10
"2011","South Oxfordshire 005D","E01028615","Total",23,9,9,5,6,0,4,2,17,9,5,3
"2011","South Oxfordshire 005E","E01028616","Total",34,16,11,7,2,1,1,0,32,15,10,7
"2011","South Oxfordshire 006A","E01028604","Total",34,11,3,20,6,1,3,2,28,10,0,18
"2011","South Oxfordshire 006B","E01028605","Total",47,15,10,22,4,1,2,1,43,14,8,21
"2011","South Oxfordshire 006C","E01028607","Total",12,5,3,4,0,0,0,0,12,5,3,4
"2011","South Oxfordshire 006D","E01028641","Total",16,8,6,2,2,0,1,1,14,8,5,1
"2011","South Oxfordshire 006E","E01028657","Total",14,3,5,6,0,0,0,0,14,3,5,6
"2011","South Oxfordshire 006F","E01028658","Total",20,6,10,4,3,0,2,1,17,6,8,3
"2011","South Oxfordshire 007A","E01028600","Total",28,13,10,5,2,0,1,1,26,13,9,4
"2011","South Oxfordshire 007B","E01028603","Total",12,3,5,4,0,0,0,0,12,3,5,4
"2011","South Oxfordshire 007C","E01028606","Total",23,6,7,10,2,0,2,0,21,6,5,10
"2011","South Oxfordshire 007D","E01028609","Total",25,14,8,3,2,2,0,0,23,12,8,3
"2011","South Oxfordshire 007E","E01028610","Total",19,10,7,2,1,0,1,0,18,10,6,2
"2011","South Oxfordshire 008A","E01028678","Total",22,8,8,6,1,0,1,0,21,8,7,6
"2011","South Oxfordshire 008B","E01028679","Total",33,13,6,14,4,0,2,2,29,13,4,12
"2011","South Oxfordshire 008C","E01028680","Total",26,10,11,5,4,1,2,1,22,9,9,4
"2011","South Oxfordshire 009A","E01028625","Total",46,20,19,7,4,1,3,0,42,19,16,7
"2011","South Oxfordshire 009B","E01028626","Total",40,20,14,6,5,1,2,2,35,19,12,4
"2011","South Oxfordshire 009C","E01028627","Total",48,15,13,20,3,0,3,0,45,15,10,20
"2011","South Oxfordshire 009D","E01028628","Total",37,15,11,11,3,0,3,0,34,15,8,11
"2011","South Oxfordshire 009E","E01028629","Total",36,14,10,12,2,0,1,1,34,14,9,11
"2011","South Oxfordshire 010A","E01028621","Total",71,18,20,33,6,1,4,1,65,17,16,32
"2011","South Oxfordshire 010B","E01028622","Total",27,10,8,9,2,0,2,0,25,10,6,9
"2011","South Oxfordshire 010C","E01028623","Total",36,13,8,15,4,1,3,0,32,12,5,15
"2011","South Oxfordshire 010D","E01028624","Total",21,5,10,6,2,0,2,0,19,5,8,6
"2011","South Oxfordshire 011A","E01028599","Total",12,10,2,0,4,3,1,0,8,7,1,0
"2011","South Oxfordshire 011B","E01028601","Total",8,5,2,1,1,1,0,0,7,4,2,1
"2011","South Oxfordshire 011C","E01028602","Total",12,1,11,0,1,0,1,0,11,1,10,0
"2011","South Oxfordshire 011D","E01028620","Total",40,21,15,4,2,0,2,0,38,21,13,4
"2011","South Oxfordshire 012A","E01028608","Total",10,4,4,2,2,1,1,0,8,3,3,2
"2011","South Oxfordshire 012B","E01028617","Total",39,15,15,9,3,1,1,1,36,14,14,8
"2011","South Oxfordshire 012C","E01028674","Total",25,15,6,4,0,0,0,0,25,15,6,4
"2011","South Oxfordshire 012D","E01028675","Total",39,18,11,10,5,2,3,0,34,16,8,10
"2011","South Oxfordshire 012E","E01028676","Total",57,22,18,17,2,0,2,0,55,22,16,17
"2011","South Oxfordshire 012F","E01028677","Total",27,9,8,10,5,1,2,2,22,8,6,8
"2011","South Oxfordshire 013A","E01028630","Total",47,13,18,16,5,1,3,1,42,12,15,15
"2011","South Oxfordshire 013B","E01028631","Total",30,14,9,7,2,0,2,0,28,14,7,7
"2011","South Oxfordshire 013C","E01028632","Total",52,25,5,22,3,1,1,1,49,24,4,21
"2011","South Oxfordshire 013D","E01028633","Total",64,20,15,29,6,0,4,2,58,20,11,27
"2011","South Oxfordshire 014A","E01028634","Total",17,6,9,2,0,0,0,0,17,6,9,2
"2011","South Oxfordshire 014B","E01028635","Total",44,18,9,17,4,3,0,1,40,15,9,16
"2011","South Oxfordshire 014C","E01028636","Total",42,18,9,15,2,0,1,1,40,18,8,14
"2011","South Oxfordshire 014D","E01028637","Total",21,10,9,2,3,0,3,0,18,10,6,2
"2011","South Oxfordshire 015A","E01028618","Total",20,8,8,4,2,0,2,0,18,8,6,4
"2011","South Oxfordshire 015B","E01028619","Total",39,16,10,13,2,0,2,0,37,16,8,13
"2011","South Oxfordshire 015C","E01028644","Total",19,9,7,3,2,0,2,0,17,9,5,3
"2011","South Oxfordshire 015D","E01028648","Total",20,9,7,4,1,0,1,0,19,9,6,4
"2011","South Oxfordshire 015E","E01028649","Total",25,9,6,10,5,1,4,0,20,8,2,10
"2011","South Oxfordshire 016A","E01028650","Total",43,15,16,12,6,2,1,3,37,13,15,9
"2011","South Oxfordshire 016B","E01028651","Total",35,15,10,10,3,0,0,3,32,15,10,7
"2011","South Oxfordshire 016C","E01028652","Total",46,17,20,9,5,3,2,0,41,14,18,9
"2011","South Oxfordshire 017A","E01028653","Total",50,27,18,5,1,0,1,0,49,27,17,5
"2011","South Oxfordshire 017B","E01028654","Total",25,9,12,4,3,0,2,1,22,9,10,3
"2011","South Oxfordshire 017C","E01028655","Total",59,18,30,11,5,0,5,0,54,18,25,11
"2011","South Oxfordshire 017D","E01028656","Total",8,3,2,3,0,0,0,0,8,3,2,3
"2011","South Oxfordshire 018A","E01028611","Total",7,3,3,1,0,0,0,0,7,3,3,1
"2011","South Oxfordshire 018B","E01028642","Total",24,8,13,3,3,0,3,0,21,8,10,3
"2011","South Oxfordshire 018C","E01028643","Total",24,13,8,3,3,1,1,1,21,12,7,2
"2011","South Oxfordshire 018D","E01028645","Total",14,5,6,3,1,0,1,0,13,5,5,3
"2011","South Oxfordshire 018E","E01028685","Total",19,9,5,5,0,0,0,0,19,9,5,5
"2011","South Oxfordshire 018F","E01028686","Total",20,8,7,5,0,0,0,0,20,8,7,5
"2011","South Oxfordshire 019A","E01028612","Total",16,9,4,3,1,0,1,0,15,9,3,3
"2011","South Oxfordshire 019B","E01028660","Total",30,11,9,10,2,0,2,0,28,11,7,10
"2011","South Oxfordshire 019C","E01028661","Total",9,6,3,0,0,0,0,0,9,6,3,0
"2011","South Oxfordshire 019D","E01028662","Total",13,9,3,1,1,0,1,0,12,9,2,1
"2011","South Oxfordshire 020A","E01028659","Total",19,5,12,2,6,0,6,0,13,5,6,2
"2011","South Oxfordshire 020B","E01028663","Total",46,24,7,15,5,0,2,3,41,24,5,12
"2011","South Oxfordshire 020C","E01028664","Total",18,6,9,3,3,0,3,0,15,6,6,3
"2011","South Oxfordshire 020D","E01028665","Total",14,7,5,2,1,1,0,0,13,6,5,2
"2011","Vale of White Horse 001A","E01028708","Total",28,7,13,8,2,0,2,0,26,7,11,8
"2011","Vale of White Horse 001B","E01028709","Total",20,7,11,2,4,0,3,1,16,7,8,1
"2011","Vale of White Horse 001C","E01028710","Total",24,7,15,2,3,1,2,0,21,6,13,2
"2011","Vale of White Horse 001D","E01028711","Total",34,16,11,7,5,1,2,2,29,15,9,5
"2011","Vale of White Horse 002A","E01028733","Total",9,2,5,2,0,0,0,0,9,2,5,2
"2011","Vale of White Horse 002B","E01028734","Total",14,6,5,3,4,0,4,0,10,6,1,3
"2011","Vale of White Horse 002C","E01028735","Total",31,11,7,13,8,1,4,3,23,10,3,10
"2011","Vale of White Horse 002D","E01028740","Total",23,6,10,7,4,0,3,1,19,6,7,6
"2011","Vale of White Horse 002E","E01028741","Total",16,3,7,6,2,0,0,2,14,3,7,4
"2011","Vale of White Horse 002F","E01028742","Total",25,9,5,11,3,0,2,1,22,9,3,10
"2011","Vale of White Horse 003A","E01028738","Total",25,0,18,7,1,0,1,0,24,0,17,7
"2011","Vale of White Horse 003B","E01028739","Total",27,13,7,7,2,0,1,1,25,13,6,6
"2011","Vale of White Horse 003C","E01028743","Total",7,0,6,1,1,0,1,0,6,0,5,1
"2011","Vale of White Horse 003D","E01028744","Total",21,6,10,5,4,0,4,0,17,6,6,5
"2011","Vale of White Horse 003E","E01028750","Total",31,11,11,9,3,0,3,0,28,11,8,9
"2011","Vale of White Horse 003F","E01028751","Total",15,3,5,7,0,0,0,0,15,3,5,7
"2011","Vale of White Horse 003G","E01028752","Total",26,10,8,8,6,1,4,1,20,9,4,7
"2011","Vale of White Horse 004A","E01028693","Total",16,7,5,4,3,0,3,0,13,7,2,4
"2011","Vale of White Horse 004B","E01028694","Total",27,10,11,6,2,0,2,0,25,10,9,6
"2011","Vale of White Horse 004C","E01028701","Total",47,17,16,14,2,1,1,0,45,16,15,14
"2011","Vale of White Horse 004D","E01028705","Total",21,13,4,4,0,0,0,0,21,13,4,4
"2011","Vale of White Horse 004E","E01028706","Total",16,3,11,2,2,0,2,0,14,3,9,2
"2011","Vale of White Horse 004F","E01028707","Total",26,13,9,4,2,0,2,0,24,13,7,4
"2011","Vale of White Horse 005A","E01028688","Total",18,6,7,5,2,0,2,0,16,6,5,5
"2011","Vale of White Horse 005B","E01028689","Total",45,20,9,16,4,1,2,1,41,19,7,15
"2011","Vale of White Horse 005C","E01028695","Total",26,9,11,6,2,0,2,0,24,9,9,6
"2011","Vale of White Horse 005D","E01028699","Total",21,9,7,5,5,0,4,1,16,9,3,4
"2011","Vale of White Horse 006B","E01028696","Total",20,8,10,2,4,0,3,1,16,8,7,1
"2011","Vale of White Horse 006C","E01028697","Total",62,25,11,26,3,0,2,1,59,25,9,25
"2011","Vale of White Horse 006D","E01028698","Total",42,20,15,7,5,0,4,1,37,20,11,6
"2011","Vale of White Horse 006E","E01028700","Total",76,29,18,29,5,0,4,1,71,29,14,28
"2011","Vale of White Horse 006F","E01028703","Total",75,26,27,22,6,0,5,1,69,26,22,21
"2011","Vale of White Horse 006G","E01033305","Total",45,12,15,18,8,1,3,4,37,11,12,14
"2011","Vale of White Horse 006H","E01033306","Total",37,12,10,15,3,1,1,1,34,11,9,14
"2011","Vale of White Horse 007A","E01028726","Total",22,4,12,6,5,0,5,0,17,4,7,6
"2011","Vale of White Horse 007B","E01028736","Total",53,25,22,6,9,3,5,1,44,22,17,5
"2011","Vale of White Horse 007C","E01028737","Total",36,17,11,8,5,2,2,1,31,15,9,7
"2011","Vale of White Horse 008A","E01028690","Total",41,17,6,18,2,1,1,0,39,16,5,18
"2011","Vale of White Horse 008B","E01028691","Total",33,16,8,9,6,1,3,2,27,15,5,7
"2011","Vale of White Horse 008C","E01028692","Total",88,30,20,38,6,1,4,1,82,29,16,37
"2011","Vale of White Horse 008D","E01028702","Total",21,6,12,3,3,0,3,0,18,6,9,3
"2011","Vale of White Horse 008E","E01028704","Total",57,23,17,17,5,2,3,0,52,21,14,17
"2011","Vale of White Horse 009A","E01028716","Total",66,24,17,25,3,0,3,0,63,24,14,25
"2011","Vale of White Horse 009B","E01028717","Total",39,9,16,14,9,1,5,3,30,8,11,11
"2011","Vale of White Horse 009C","E01028718","Total",40,12,12,16,7,0,4,3,33,12,8,13
"2011","Vale of White Horse 009D","E01028719","Total",16,6,7,3,3,1,1,1,13,5,6,2
"2011","Vale of White Horse 009E","E01028749","Total",42,15,20,7,7,0,5,2,35,15,15,5
"2011","Vale of White Horse 010A","E01028714","Total",31,10,12,9,7,0,5,2,24,10,7,7
"2011","Vale of White Horse 010B","E01028731","Total",27,9,8,10,2,0,2,0,25,9,6,10
"2011","Vale of White Horse 010C","E01028732","Total",34,15,9,10,3,1,2,0,31,14,7,10
"2011","Vale of White Horse 010D","E01028753","Total",39,22,12,5,3,1,2,0,36,21,10,5
"2011","Vale of White Horse 010E","E01028754","Total",22,5,6,11,1,0,1,0,21,5,5,11
"2011","Vale of White Horse 011A","E01028721","Total",30,13,9,8,3,0,0,3,27,13,9,5
"2011","Vale of White Horse 011B","E01028722","Total",24,7,11,6,5,2,3,0,19,5,8,6
"2011","Vale of White Horse 011C","E01028723","Total",20,4,9,7,1,0,1,0,19,4,8,7
"2011","Vale of White Horse 011D","E01028724","Total",25,12,7,6,4,1,3,0,21,11,4,6
"2011","Vale of White Horse 011E","E01028725","Total",46,20,12,14,3,1,1,1,43,19,11,13
"2011","Vale of White Horse 014A","E01028755","Total",39,20,12,7,6,1,3,2,33,19,9,5
"2011","Vale of White Horse 014B","E01028756","Total",74,19,20,35,7,1,3,3,67,18,17,32
"2011","Vale of White Horse 014C","E01028758","Total",18,8,7,3,3,0,2,1,15,8,5,2
"2011","Vale of White Horse 014D","E01028759","Total",21,5,3,13,3,0,1,2,18,5,2,11
"2011","Vale of White Horse 014E","E01028760","Total",30,12,15,3,4,1,3,0,26,11,12,3
"2011","Vale of White Horse 014F","E01028761","Total",26,10,7,9,3,0,1,2,23,10,6,7
"2011","Vale of White Horse 015A","E01028712","Total",32,15,12,5,4,0,3,1,28,15,9,4
"2011","Vale of White Horse 015B","E01028727","Total",26,11,8,7,4,1,2,1,22,10,6,6
"2011","Vale of White Horse 015C","E01028728","Total",21,6,7,8,3,0,3,0,18,6,4,8
"2011","Vale of White Horse 015D","E01028729","Total",20,5,13,2,6,0,6,0,14,5,7,2
"2011","Vale of White Horse 015E","E01028730","Total",16,4,8,4,3,0,2,1,13,4,6,3
"2011","Vale of White Horse 015F","E01028757","Total",57,19,18,20,6,1,4,1,51,18,14,19
"2011","Vale of White Horse 016E","E01028713","Total",27,6,12,9,5,0,4,1,22,6,8,8
"2011","Vale of White Horse 016F","E01028715","Total",25,8,10,7,1,0,0,1,24,8,10,6
"2011","Vale of White Horse 016G","E01028720","Total",31,15,7,9,4,0,4,0,27,15,3,9
"2011","Vale of White Horse 016A","E01028745","Total",19,8,6,5,2,0,2,0,17,8,4,5
"2011","Vale of White Horse 016B","E01028746","Total",14,6,4,4,0,0,0,0,14,6,4,4
"2011","Vale of White Horse 016C","E01028747","Total",9,1,5,3,1,0,1,0,8,1,4,3
"2011","Vale of White Horse 016D","E01028748","Total",17,6,4,7,4,0,3,1,13,6,1,6
"2011","West Oxfordshire 001A","E01028780","Total",43,16,19,8,2,0,2,0,41,16,17,8
"2011","West Oxfordshire 001B","E01028781","Total",49,19,12,18,0,0,0,0,49,19,12,18
"2011","West Oxfordshire 001C","E01028782","Total",33,19,10,4,3,0,3,0,30,19,7,4
"2011","West Oxfordshire 001D","E01028783","Total",43,16,17,10,5,0,3,2,38,16,14,8
"2011","West Oxfordshire 002A","E01028795","Total",18,8,4,6,1,0,1,0,17,8,3,6
"2011","West Oxfordshire 002B","E01028796","Total",21,9,7,5,2,1,0,1,19,8,7,4
"2011","West Oxfordshire 002C","E01028797","Total",10,4,5,1,2,1,1,0,8,3,4,1
"2011","West Oxfordshire 002D","E01028806","Total",33,17,13,3,7,2,5,0,26,15,8,3
"2011","West Oxfordshire 003A","E01028763","Total",31,14,14,3,3,0,3,0,28,14,11,3
"2011","West Oxfordshire 003B","E01028776","Total",13,4,8,1,2,0,2,0,11,4,6,1
"2011","West Oxfordshire 003C","E01028798","Total",36,15,12,9,3,1,0,2,33,14,12,7
"2011","West Oxfordshire 004B","E01028804","Total",20,7,6,7,4,0,3,1,16,7,3,6
"2011","West Oxfordshire 004D","E01028823","Total",34,8,19,7,6,0,6,0,28,8,13,7
"2011","West Oxfordshire 004E","E01028824","Total",31,8,12,11,3,0,3,0,28,8,9,11
"2011","West Oxfordshire 004F","E01028825","Total",20,5,10,5,1,0,1,0,19,5,9,5
"2011","West Oxfordshire 004G","E01032954","Total",59,25,17,17,9,1,5,3,50,24,12,14
"2011","West Oxfordshire 005A","E01028777","Total",27,13,8,6,3,0,3,0,24,13,5,6
"2011","West Oxfordshire 005B","E01028778","Total",32,15,10,7,2,1,0,1,30,14,10,6
"2011","West Oxfordshire 005C","E01028779","Total",20,7,8,5,3,0,2,1,17,7,6,4
"2011","West Oxfordshire 005D","E01028799","Total",21,7,10,4,1,0,1,0,20,7,9,4
"2011","West Oxfordshire 006A","E01028788","Total",18,4,5,9,3,1,1,1,15,3,4,8
"2011","West Oxfordshire 006B","E01028789","Total",15,9,6,0,3,0,3,0,12,9,3,0
"2011","West Oxfordshire 006C","E01028790","Total",11,3,7,1,2,0,2,0,9,3,5,1
"2011","West Oxfordshire 006D","E01028791","Total",16,7,7,2,4,0,3,1,12,7,4,1
"2011","West Oxfordshire 007A","E01028784","Total",28,14,8,6,6,2,4,0,22,12,4,6
"2011","West Oxfordshire 007B","E01028792","Total",10,6,3,1,2,0,2,0,8,6,1,1
"2011","West Oxfordshire 007C","E01028793","Total",31,12,7,12,2,0,2,0,29,12,5,12
"2011","West Oxfordshire 007D","E01028794","Total",18,10,3,5,5,2,1,2,13,8,2,3
"2011","West Oxfordshire 008A","E01028810","Total",24,13,9,2,3,0,3,0,21,13,6,2
"2011","West Oxfordshire 008B","E01028811","Total",49,23,12,14,1,0,1,0,48,23,11,14
"2011","West Oxfordshire 008D","E01028813","Total",38,12,9,17,4,0,3,1,34,12,6,16
"2011","West Oxfordshire 008E","E01028814","Total",30,17,7,6,2,0,1,1,28,17,6,5
"2011","West Oxfordshire 008F","E01028815","Total",11,5,5,1,0,0,0,0,11,5,5,1
"2011","West Oxfordshire 008G","E01032947","Total",66,22,21,23,9,2,5,2,57,20,16,21
"2011","West Oxfordshire 008H","E01032948","Total",27,11,6,10,1,0,1,0,26,11,5,10
"2011","West Oxfordshire 008I","E01032952","Total",37,14,17,6,5,1,4,0,32,13,13,6
"2011","West Oxfordshire 009A","E01028809","Total",62,25,11,26,4,0,3,1,58,25,8,25
"2011","West Oxfordshire 009B","E01028820","Total",24,14,6,4,1,0,1,0,23,14,5,4
"2011","West Oxfordshire 009C","E01028821","Total",47,18,21,8,6,1,5,0,41,17,16,8
"2011","West Oxfordshire 009D","E01028822","Total",21,12,8,1,2,0,2,0,19,12,6,1
"2011","West Oxfordshire 010A","E01028807","Total",54,17,17,20,4,0,3,1,50,17,14,19
"2011","West Oxfordshire 010B","E01028808","Total",45,16,15,14,6,0,3,3,39,16,12,11
"2011","West Oxfordshire 010C","E01028816","Total",20,10,4,6,2,1,0,1,18,9,4,5
"2011","West Oxfordshire 010D","E01028817","Total",39,17,11,11,4,1,3,0,35,16,8,11
"2011","West Oxfordshire 010E","E01028818","Total",46,15,17,14,6,0,4,2,40,15,13,12
"2011","West Oxfordshire 010F","E01028819","Total",68,23,22,23,5,0,5,0,63,23,17,23
"2011","West Oxfordshire 011A","E01028785","Total",39,22,10,7,1,1,0,0,38,21,10,7
"2011","West Oxfordshire 011B","E01028786","Total",16,6,6,4,2,0,2,0,14,6,4,4
"2011","West Oxfordshire 011C","E01028787","Total",31,7,13,11,2,0,1,1,29,7,12,10
"2011","West Oxfordshire 011D","E01028800","Total",27,13,6,8,2,0,2,0,25,13,4,8
"2011","West Oxfordshire 012A","E01028762","Total",28,8,13,7,6,0,5,1,22,8,8,6
"2011","West Oxfordshire 012B","E01028766","Total",34,19,11,4,4,0,3,1,30,19,8,3
"2011","West Oxfordshire 012C","E01028767","Total",25,4,10,11,4,0,4,0,21,4,6,11
"2011","West Oxfordshire 013D","E01028772","Total",39,12,20,7,4,1,2,1,35,11,18,6
"2011","West Oxfordshire 013E","E01032949","Total",50,21,19,10,6,1,5,0,44,20,14,10
"2011","West Oxfordshire 013F","E01032950","Total",55,22,23,10,3,0,3,0,52,22,20,10
"2011","West Oxfordshire 013G","E01032951","Total",54,24,18,12,9,3,6,0,45,21,12,12
"2011","West Oxfordshire 013H","E01032953","Total",53,17,26,10,7,0,5,2,46,17,21,8
"2011","West Oxfordshire 014A","E01028771","Total",36,7,15,14,1,0,1,0,35,7,14,14
"2011","West Oxfordshire 014B","E01028773","Total",26,5,12,9,2,0,2,0,24,5,10,9
"2011","West Oxfordshire 014C","E01028774","Total",35,19,11,5,3,1,2,0,32,18,9,5
"2011","West Oxfordshire 014D","E01028775","Total",19,7,5,7,2,0,1,1,17,7,4,6
"2011","West Oxfordshire 015A","E01028764","Total",23,6,9,8,0,0,0,0,23,6,9,8
"2011","West Oxfordshire 015B","E01028765","Total",39,17,10,12,5,1,4,0,34,16,6,12
"2011","West Oxfordshire 015C","E01028801","Total",18,10,3,5,0,0,0,0,18,10,3,5
"2011","West Oxfordshire 015D","E01028802","Total",17,10,3,4,0,0,0,0,17,10,3,4
"2011","Elmbridge 001A","E01030330","Total",33,5,16,12,6,0,4,2,27,5,12,10
"2011","Elmbridge 001B","E01030331","Total",39,12,17,10,2,0,2,0,37,12,15,10
"2011","Elmbridge 001C","E01030332","Total",44,20,11,13,3,2,1,0,41,18,10,13
"2011","Elmbridge 001D","E01030333","Total",26,15,8,3,3,0,3,0,23,15,5,3
"2011","Elmbridge 002A","E01030326","Total",21,6,11,4,6,1,3,2,15,5,8,2
"2011","Elmbridge 002B","E01030327","Total",16,6,9,1,2,1,1,0,14,5,8,1
"2011","Elmbridge 002C","E01030328","Total",9,6,2,1,1,0,1,0,8,6,1,1
"2011","Elmbridge 002D","E01030329","Total",19,5,8,6,4,0,4,0,15,5,4,6
"2011","Elmbridge 003A","E01030334","Total",36,12,13,11,4,0,3,1,32,12,10,10
"2011","Elmbridge 003B","E01030335","Total",49,17,19,13,5,2,1,2,44,15,18,11
"2011","Elmbridge 003C","E01030336","Total",78,26,20,32,4,1,1,2,74,25,19,30
"2011","Elmbridge 003D","E01030337","Total",39,15,12,12,5,2,2,1,34,13,10,11
"2011","Elmbridge 004A","E01030361","Total",40,12,15,13,3,1,2,0,37,11,13,13
"2011","Elmbridge 004B","E01030362","Total",49,16,11,22,6,1,4,1,43,15,7,21
"2011","Elmbridge 004C","E01030363","Total",60,14,17,29,7,1,6,0,53,13,11,29
"2011","Elmbridge 004D","E01030364","Total",63,27,13,23,2,1,1,0,61,26,12,23
"2011","Elmbridge 005A","E01030350","Total",27,6,7,14,4,0,4,0,23,6,3,14
"2011","Elmbridge 005B","E01030351","Total",20,6,7,7,1,0,0,1,19,6,7,6
"2011","Elmbridge 005C","E01030352","Total",28,8,13,7,4,0,4,0,24,8,9,7
"2011","Elmbridge 005D","E01030353","Total",17,7,5,5,1,0,1,0,16,7,4,5
"2011","Elmbridge 006A","E01030322","Total",33,7,12,14,3,0,3,0,30,7,9,14
"2011","Elmbridge 006B","E01030323","Total",15,3,6,6,3,0,2,1,12,3,4,5
"2011","Elmbridge 006C","E01030324","Total",39,19,11,9,3,0,3,0,36,19,8,9
"2011","Elmbridge 006D","E01030325","Total",19,9,5,5,3,1,1,1,16,8,4,4
"2011","Elmbridge 007A","E01030357","Total",30,12,9,9,3,0,3,0,27,12,6,9
"2011","Elmbridge 007B","E01030358","Total",24,12,6,6,3,1,0,2,21,11,6,4
"2011","Elmbridge 007C","E01030359","Total",61,14,18,29,5,0,4,1,56,14,14,28
"2011","Elmbridge 007D","E01030360","Total",37,12,9,16,1,0,1,0,36,12,8,16
"2011","Elmbridge 008A","E01030354","Total",63,18,12,33,3,1,2,0,60,17,10,33
"2011","Elmbridge 008B","E01030355","Total",22,9,5,8,1,0,1,0,21,9,4,8
"2011","Elmbridge 008C","E01030356","Total",26,12,6,8,2,1,1,0,24,11,5,8
"2011","Elmbridge 008D","E01030365","Total",27,9,8,10,5,1,2,2,22,8,6,8
"2011","Elmbridge 008E","E01030368","Total",28,12,5,11,1,0,1,0,27,12,4,11
"2011","Elmbridge 009A","E01030319","Total",21,6,5,10,3,0,2,1,18,6,3,9
"2011","Elmbridge 009B","E01030320","Total",39,18,13,8,5,0,4,1,34,18,9,7
"2011","Elmbridge 009C","E01030321","Total",11,1,7,3,3,0,3,0,8,1,4,3
"2011","Elmbridge 009D","E01030369","Total",21,6,8,7,3,0,3,0,18,6,5,7
"2011","Elmbridge 009E","E01030370","Total",28,6,13,9,7,1,4,2,21,5,9,7
"2011","Elmbridge 010A","E01030313","Total",38,14,14,10,1,0,1,0,37,14,13,10
"2011","Elmbridge 010B","E01030314","Total",21,10,8,3,5,0,4,1,16,10,4,2
"2011","Elmbridge 010C","E01030366","Total",35,20,9,6,2,1,1,0,33,19,8,6
"2011","Elmbridge 010D","E01030367","Total",14,5,4,5,0,0,0,0,14,5,4,5
"2011","Elmbridge 011A","E01030338","Total",14,7,2,5,2,1,1,0,12,6,1,5
"2011","Elmbridge 011B","E01030339","Total",32,10,11,11,4,1,2,1,28,9,9,10
"2011","Elmbridge 011C","E01030340","Total",30,8,10,12,5,0,4,1,25,8,6,11
"2011","Elmbridge 011D","E01030341","Total",17,3,8,6,3,0,1,2,14,3,7,4
"2011","Elmbridge 012A","E01030371","Total",45,15,16,14,3,0,3,0,42,15,13,14
"2011","Elmbridge 012B","E01030372","Total",20,8,9,3,1,0,1,0,19,8,8,3
"2011","Elmbridge 012C","E01030373","Total",37,12,16,9,6,1,4,1,31,11,12,8
"2011","Elmbridge 012D","E01030374","Total",18,7,5,6,3,2,1,0,15,5,4,6
"2011","Elmbridge 012E","E01030375","Total",36,15,14,7,1,1,0,0,35,14,14,7
"2011","Elmbridge 012F","E01030376","Total",28,14,8,6,14,8,5,1,14,6,3,5
"2011","Elmbridge 013A","E01030307","Total",16,4,6,6,2,0,2,0,14,4,4,6
"2011","Elmbridge 013B","E01030308","Total",12,1,6,5,1,0,1,0,11,1,5,5
"2011","Elmbridge 013C","E01030309","Total",19,9,3,7,2,0,2,0,17,9,1,7
"2011","Elmbridge 013D","E01030310","Total",85,35,18,32,5,2,2,1,80,33,16,31
"2011","Elmbridge 014A","E01030311","Total",46,11,14,21,2,0,1,1,44,11,13,20
"2011","Elmbridge 014B","E01030312","Total",40,15,13,12,6,0,6,0,34,15,7,12
"2011","Elmbridge 014C","E01030315","Total",36,10,12,14,1,0,0,1,35,10,12,13
"2011","Elmbridge 014D","E01030316","Total",18,8,3,7,0,0,0,0,18,8,3,7
"2011","Elmbridge 014E","E01030317","Total",28,7,11,10,0,0,0,0,28,7,11,10
"2011","Elmbridge 014F","E01030318","Total",6,1,2,3,0,0,0,0,6,1,2,3
"2011","Elmbridge 015A","E01030296","Total",15,9,2,4,1,1,0,0,14,8,2,4
"2011","Elmbridge 015B","E01030297","Total",34,10,18,6,1,0,1,0,33,10,17,6
"2011","Elmbridge 015C","E01030298","Total",27,12,7,8,3,2,0,1,24,10,7,7
"2011","Elmbridge 015D","E01030299","Total",38,15,18,5,6,0,5,1,32,15,13,4
"2011","Elmbridge 016A","E01030346","Total",26,5,9,12,4,0,3,1,22,5,6,11
"2011","Elmbridge 016B","E01030347","Total",36,6,12,18,1,0,1,0,35,6,11,18
"2011","Elmbridge 016C","E01030348","Total",18,6,9,3,2,0,2,0,16,6,7,3
"2011","Elmbridge 016D","E01030349","Total",25,12,9,4,4,0,3,1,21,12,6,3
"2011","Elmbridge 017A","E01030300","Total",50,18,15,17,1,0,0,1,49,18,15,16
"2011","Elmbridge 017B","E01030301","Total",20,9,5,6,4,3,1,0,16,6,4,6
"2011","Elmbridge 017C","E01030302","Total",32,8,14,10,1,0,1,0,31,8,13,10
"2011","Elmbridge 017D","E01030304","Total",74,26,15,33,4,1,0,3,70,25,15,30
"2011","Elmbridge 017E","E01030305","Total",18,7,1,10,0,0,0,0,18,7,1,10
"2011","Elmbridge 017F","E01030306","Total",19,5,8,6,3,0,3,0,16,5,5,6
"2011","Elmbridge 018A","E01030303","Total",17,5,5,7,4,1,2,1,13,4,3,6
"2011","Elmbridge 018B","E01030342","Total",9,3,3,3,1,0,1,0,8,3,2,3
"2011","Elmbridge 018C","E01030343","Total",24,11,8,5,3,1,2,0,21,10,6,5
"2011","Elmbridge 018D","E01030344","Total",9,3,1,5,1,0,0,1,8,3,1,4
"2011","Elmbridge 018E","E01030345","Total",31,10,7,14,4,1,1,2,27,9,6,12
"2011","Epsom and Ewell 001A","E01030386","Total",12,1,6,5,2,0,2,0,10,1,4,5
"2011","Epsom and Ewell 001B","E01030387","Total",38,16,16,6,4,0,4,0,34,16,12,6
"2011","Epsom and Ewell 001C","E01030388","Total",17,6,3,8,4,1,1,2,13,5,2,6
"2011","Epsom and Ewell 001D","E01030389","Total",38,17,12,9,5,0,4,1,33,17,8,8
"2011","Epsom and Ewell 001E","E01030393","Total",26,16,5,5,4,3,0,1,22,13,5,4
"2011","Epsom and Ewell 002A","E01030394","Total",22,8,12,2,2,1,1,0,20,7,11,2
"2011","Epsom and Ewell 002B","E01030399","Total",60,26,16,18,6,0,5,1,54,26,11,17
"2011","Epsom and Ewell 002C","E01030400","Total",106,33,21,52,8,4,4,0,98,29,17,52
"2011","Epsom and Ewell 002D","E01030414","Total",37,7,14,16,7,2,4,1,30,5,10,15
"2011","Epsom and Ewell 003A","E01030377","Total",27,13,7,7,3,2,0,1,24,11,7,6
"2011","Epsom and Ewell 003B","E01030378","Total",31,12,13,6,4,0,3,1,27,12,10,5
"2011","Epsom and Ewell 003C","E01030406","Total",32,13,11,8,5,0,4,1,27,13,7,7
"2011","Epsom and Ewell 003D","E01030407","Total",10,3,5,2,1,0,1,0,9,3,4,2
"2011","Epsom and Ewell 003E","E01030408","Total",8,3,4,1,0,0,0,0,8,3,4,1
"2011","Epsom and Ewell 004A","E01030395","Total",11,4,6,1,1,0,1,0,10,4,5,1
"2011","Epsom and Ewell 004B","E01030413","Total",56,18,21,17,1,0,1,0,55,18,20,17
"2011","Epsom and Ewell 004C","E01030415","Total",36,12,17,7,2,0,2,0,34,12,15,7
"2011","Epsom and Ewell 004D","E01030416","Total",18,7,6,5,2,0,2,0,16,7,4,5
"2011","Epsom and Ewell 005A","E01030383","Total",84,23,24,37,6,1,4,1,78,22,20,36
"2011","Epsom and Ewell 005B","E01030384","Total",91,30,33,28,9,1,5,3,82,29,28,25
"2011","Epsom and Ewell 005C","E01030401","Total",48,26,14,8,9,1,6,2,39,25,8,6
"2011","Epsom and Ewell 005D","E01030402","Total",50,20,13,17,2,0,2,0,48,20,11,17
"2011","Epsom and Ewell 007A","E01030385","Total",51,18,13,20,3,1,1,1,48,17,12,19
"2011","Epsom and Ewell 007B","E01030391","Total",38,12,16,10,4,0,4,0,34,12,12,10
"2011","Epsom and Ewell 007C","E01030403","Total",28,12,8,8,5,1,2,2,23,11,6,6
"2011","Epsom and Ewell 007D","E01030404","Total",20,13,5,2,5,3,1,1,15,10,4,1
"2011","Epsom and Ewell 007E","E01030409","Total",24,8,8,8,3,1,0,2,21,7,8,6
"2011","Epsom and Ewell 007F","E01030410","Total",47,22,14,11,5,2,2,1,42,20,12,10
"2011","Epsom and Ewell 008A","E01030381","Total",19,8,4,7,2,0,2,0,17,8,2,7
"2011","Epsom and Ewell 008B","E01030411","Total",41,15,11,15,2,0,2,0,39,15,9,15
"2011","Epsom and Ewell 008C","E01030412","Total",52,13,18,21,4,0,4,0,48,13,14,21
"2011","Epsom and Ewell 008D","E01030419","Total",30,12,9,9,2,0,0,2,28,12,9,7
"2011","Epsom and Ewell 009A","E01030379","Total",25,11,8,6,2,0,2,0,23,11,6,6
"2011","Epsom and Ewell 009B","E01030380","Total",14,7,5,2,0,0,0,0,14,7,5,2
"2011","Epsom and Ewell 009C","E01030405","Total",44,20,15,9,4,0,3,1,40,20,12,8
"2011","Epsom and Ewell 009D","E01030417","Total",11,2,5,4,1,0,1,0,10,2,4,4
"2011","Epsom and Ewell 009E","E01030418","Total",20,13,4,3,1,1,0,0,19,12,4,3
"2011","Epsom and Ewell 009F","E01030420","Total",33,14,8,11,4,1,3,0,29,13,5,11
"2011","Epsom and Ewell 010A","E01030382","Total",14,3,3,8,2,0,2,0,12,3,1,8
"2011","Epsom and Ewell 010B","E01030390","Total",58,25,16,17,5,1,3,1,53,24,13,16
"2011","Epsom and Ewell 010C","E01030392","Total",32,9,12,11,5,0,5,0,27,9,7,11
"2011","Epsom and Ewell 010D","E01030396","Total",7,4,1,2,0,0,0,0,7,4,1,2
"2011","Epsom and Ewell 010E","E01030398","Total",9,6,3,0,1,0,1,0,8,6,2,0
"2011","Epsom and Ewell 010F","E01032624","Total",13,5,4,4,2,0,2,0,11,5,2,4
"2011","Guildford 001A","E01030440","Total",27,13,9,5,3,0,2,1,24,13,7,4
"2011","Guildford 001B","E01030458","Total",10,4,4,2,3,2,1,0,7,2,3,2
"2011","Guildford 001C","E01030459","Total",24,9,6,9,1,0,0,1,23,9,6,8
"2011","Guildford 001D","E01030475","Total",15,7,4,4,3,1,1,1,12,6,3,3
"2011","Guildford 001E","E01030476","Total",11,6,4,1,1,0,1,0,10,6,3,1
"2011","Guildford 001F","E01030477","Total",35,14,9,12,5,0,4,1,30,14,5,11
"2011","Guildford 002A","E01030465","Total",18,4,3,11,2,0,0,2,16,4,3,9
"2011","Guildford 002B","E01030466","Total",12,2,6,4,5,0,4,1,7,2,2,3
"2011","Guildford 002C","E01030473","Total",18,8,5,5,3,1,2,0,15,7,3,5
"2011","Guildford 002D","E01030474","Total",23,5,10,8,0,0,0,0,23,5,10,8
"2011","Guildford 003A","E01030441","Total",22,12,4,6,2,0,2,0,20,12,2,6
"2011","Guildford 003B","E01030442","Total",8,3,3,2,2,0,2,0,6,3,1,2
"2011","Guildford 003C","E01030443","Total",17,5,9,3,2,0,2,0,15,5,7,3
"2011","Guildford 003D","E01030444","Total",22,11,4,7,1,1,0,0,21,10,4,7
"2011","Guildford 003E","E01030445","Total",22,11,5,6,3,1,2,0,19,10,3,6
"2011","Guildford 003F","E01030446","Total",15,6,6,3,1,0,1,0,14,6,5,3
"2011","Guildford 003G","E01030447","Total",30,6,14,10,5,0,5,0,25,6,9,10
"2011","Guildford 004A","E01030426","Total",38,13,7,18,2,0,2,0,36,13,5,18
"2011","Guildford 004B","E01030427","Total",25,7,15,3,6,1,5,0,19,6,10,3
"2011","Guildford 004C","E01030428","Total",19,7,7,5,1,0,1,0,18,7,6,5
"2011","Guildford 004D","E01030429","Total",41,13,10,18,5,0,2,3,36,13,8,15
"2011","Guildford 004E","E01030430","Total",16,2,7,7,1,0,1,0,15,2,6,7
"2011","Guildford 005A","E01030499","Total",19,10,5,4,1,0,1,0,18,10,4,4
"2011","Guildford 005B","E01030500","Total",19,9,6,4,3,1,1,1,16,8,5,3
"2011","Guildford 005C","E01030501","Total",33,13,11,9,4,0,4,0,29,13,7,9
"2011","Guildford 005D","E01030502","Total",23,7,9,7,5,0,2,3,18,7,7,4
"2011","Guildford 005E","E01030503","Total",45,11,2,32,1,0,0,1,44,11,2,31
"2011","Guildford 005F","E01030504","Total",14,5,8,1,3,0,3,0,11,5,5,1
"2011","Guildford 006A","E01030485","Total",40,17,9,14,0,0,0,0,40,17,9,14
"2011","Guildford 006B","E01030487","Total",25,12,6,7,4,2,2,0,21,10,4,7
"2011","Guildford 006C","E01030488","Total",41,13,11,17,3,0,1,2,38,13,10,15
"2011","Guildford 006D","E01030489","Total",53,19,19,15,3,0,3,0,50,19,16,15
"2011","Guildford 007A","E01030481","Total",37,11,6,20,2,0,1,1,35,11,5,19
"2011","Guildford 007B","E01030482","Total",36,15,4,17,2,1,1,0,34,14,3,17
"2011","Guildford 007C","E01030483","Total",60,20,15,25,6,0,3,3,54,20,12,22
"2011","Guildford 007D","E01030484","Total",29,13,11,5,2,1,1,0,27,12,10,5
"2011","Guildford 008A","E01030434","Total",34,15,10,9,7,4,2,1,27,11,8,8
"2011","Guildford 008B","E01030435","Total",27,14,10,3,4,0,4,0,23,14,6,3
"2011","Guildford 008C","E01030462","Total",29,11,4,14,1,0,0,1,28,11,4,13
"2011","Guildford 008D","E01030463","Total",39,11,20,8,3,0,3,0,36,11,17,8
"2011","Guildford 008E","E01030464","Total",60,26,11,23,5,1,0,4,55,25,11,19
"2011","Guildford 009A","E01030486","Total",20,10,6,4,3,1,2,0,17,9,4,4
"2011","Guildford 009B","E01030493","Total",32,12,8,12,5,2,1,2,27,10,7,10
"2011","Guildford 009C","E01030495","Total",19,4,3,12,2,0,1,1,17,4,2,11
"2011","Guildford 009D","E01030498","Total",14,10,2,2,1,0,1,0,13,10,1,2
"2011","Guildford 010A","E01030424","Total",50,26,9,15,4,1,2,1,46,25,7,14
"2011","Guildford 010B","E01030431","Total",24,15,6,3,3,0,3,0,21,15,3,3
"2011","Guildford 010C","E01030432","Total",41,14,4,23,5,3,1,1,36,11,3,22
"2011","Guildford 010D","E01030433","Total",46,16,8,22,5,0,3,2,41,16,5,20
"2011","Guildford 011A","E01030436","Total",42,19,12,11,5,1,4,0,37,18,8,11
"2011","Guildford 011B","E01030437","Total",25,5,16,4,5,0,5,0,20,5,11,4
"2011","Guildford 011C","E01030439","Total",19,6,9,4,6,0,6,0,13,6,3,4
"2011","Guildford 011D","E01030460","Total",12,4,5,3,0,0,0,0,12,4,5,3
"2011","Guildford 011E","E01030461","Total",29,7,10,12,1,0,1,0,28,7,9,12
"2011","Guildford 012A","E01030470","Total",11,7,3,1,1,0,1,0,10,7,2,1
"2011","Guildford 012B","E01030494","Total",28,12,6,10,1,0,1,0,27,12,5,10
"2011","Guildford 012C","E01030496","Total",47,11,12,24,4,0,4,0,43,11,8,24
"2011","Guildford 012D","E01030497","Total",91,37,12,42,3,0,3,0,88,37,9,42
"2011","Guildford 013A","E01030438","Total",33,7,15,11,5,0,4,1,28,7,11,10
"2011","Guildford 013B","E01030450","Total",41,13,13,15,4,2,1,1,37,11,12,14
"2011","Guildford 013C","E01030451","Total",34,12,8,14,0,0,0,0,34,12,8,14
"2011","Guildford 013D","E01030453","Total",18,5,11,2,5,1,4,0,13,4,7,2
"2011","Guildford 013E","E01030455","Total",17,4,6,7,3,0,3,0,14,4,3,7
"2011","Guildford 013F","E01030457","Total",34,5,12,17,3,0,2,1,31,5,10,16
"2011","Guildford 014A","E01030421","Total",25,12,5,8,0,0,0,0,25,12,5,8
"2011","Guildford 014B","E01030422","Total",36,15,12,9,5,1,2,2,31,14,10,7
"2011","Guildford 014C","E01030423","Total",26,13,7,6,1,0,1,0,25,13,6,6
"2011","Guildford 014D","E01030425","Total",14,3,4,7,0,0,0,0,14,3,4,7
"2011","Guildford 015A","E01030452","Total",16,5,6,5,3,1,2,0,13,4,4,5
"2011","Guildford 015B","E01030467","Total",15,8,3,4,0,0,0,0,15,8,3,4
"2011","Guildford 015C","E01030468","Total",10,3,4,3,2,0,1,1,8,3,3,2
"2011","Guildford 015D","E01030469","Total",22,9,2,11,0,0,0,0,22,9,2,11
"2011","Guildford 016A","E01030448","Total",9,3,4,2,4,0,3,1,5,3,1,1
"2011","Guildford 016B","E01030449","Total",13,5,2,6,0,0,0,0,13,5,2,6
"2011","Guildford 016C","E01030454","Total",34,10,13,11,3,0,3,0,31,10,10,11
"2011","Guildford 016D","E01030456","Total",13,6,4,3,2,1,1,0,11,5,3,3
"2011","Guildford 017A","E01030471","Total",6,4,2,0,0,0,0,0,6,4,2,0
"2011","Guildford 017B","E01030472","Total",19,8,5,6,1,0,1,0,18,8,4,6
"2011","Guildford 017C","E01030478","Total",21,9,5,7,4,1,2,1,17,8,3,6
"2011","Guildford 017D","E01030479","Total",53,24,16,13,4,0,2,2,49,24,14,11
"2011","Guildford 017E","E01030480","Total",19,3,9,7,1,0,1,0,18,3,8,7
"2011","Guildford 018A","E01030490","Total",23,11,10,2,2,0,2,0,21,11,8,2
"2011","Guildford 018B","E01030491","Total",36,12,16,8,4,0,4,0,32,12,12,8
"2011","Guildford 018C","E01030492","Total",12,4,5,3,3,1,1,1,9,3,4,2
"2011","Mole Valley 001A","E01030506","Total",13,7,4,2,0,0,0,0,13,7,4,2
"2011","Mole Valley 001B","E01030508","Total",8,5,1,2,0,0,0,0,8,5,1,2
"2011","Mole Valley 001C","E01030509","Total",18,8,7,3,3,0,3,0,15,8,4,3
"2011","Mole Valley 001D","E01030513","Total",41,13,16,12,4,1,3,0,37,12,13,12
"2011","Mole Valley 001E","E01030514","Total",16,6,4,6,2,2,0,0,14,4,4,6
"2011","Mole Valley 002A","E01030505","Total",25,8,10,7,4,0,4,0,21,8,6,7
"2011","Mole Valley 002B","E01030507","Total",16,7,7,2,4,1,3,0,12,6,4,2
"2011","Mole Valley 002C","E01030511","Total",11,2,8,1,1,0,1,0,10,2,7,1
"2011","Mole Valley 002D","E01030512","Total",19,6,6,7,0,0,0,0,19,6,6,7
"2011","Mole Valley 003A","E01030548","Total",56,16,19,21,5,0,2,3,51,16,17,18
"2011","Mole Valley 003B","E01030549","Total",50,20,16,14,5,0,3,2,45,20,13,12
"2011","Mole Valley 003C","E01030550","Total",36,9,10,17,7,0,3,4,29,9,7,13
"2011","Mole Valley 003D","E01030551","Total",72,22,19,31,4,1,1,2,68,21,18,29
"2011","Mole Valley 004A","E01030510","Total",21,9,6,6,3,1,2,0,18,8,4,6
"2011","Mole Valley 004B","E01030552","Total",20,7,6,7,2,0,0,2,18,7,6,5
"2011","Mole Valley 004C","E01030553","Total",20,6,10,4,1,0,1,0,19,6,9,4
"2011","Mole Valley 004D","E01030554","Total",12,2,6,4,2,0,2,0,10,2,4,4
"2011","Mole Valley 005A","E01030539","Total",32,10,9,13,3,0,3,0,29,10,6,13
"2011","Mole Valley 005B","E01030540","Total",13,6,4,3,3,0,2,1,10,6,2,2
"2011","Mole Valley 005C","E01030541","Total",8,2,3,3,1,0,1,0,7,2,2,3
"2011","Mole Valley 005D","E01030542","Total",18,7,9,2,4,0,4,0,14,7,5,2
"2011","Mole Valley 005E","E01030543","Total",28,14,11,3,3,0,3,0,25,14,8,3
"2011","Mole Valley 006A","E01030516","Total",34,11,13,10,5,1,4,0,29,10,9,10
"2011","Mole Valley 006B","E01030517","Total",17,7,9,1,1,0,1,0,16,7,8,1
"2011","Mole Valley 006C","E01030518","Total",8,3,4,1,1,0,1,0,7,3,3,1
"2011","Mole Valley 006D","E01030519","Total",41,18,13,10,4,0,2,2,37,18,11,8
"2011","Mole Valley 007A","E01030520","Total",36,12,12,12,4,1,2,1,32,11,10,11
"2011","Mole Valley 007B","E01030521","Total",24,9,10,5,3,0,3,0,21,9,7,5
"2011","Mole Valley 007C","E01030522","Total",15,1,10,4,3,0,3,0,12,1,7,4
"2011","Mole Valley 007D","E01030523","Total",18,11,6,1,3,0,3,0,15,11,3,1
"2011","Mole Valley 008A","E01030524","Total",14,5,7,2,3,0,3,0,11,5,4,2
"2011","Mole Valley 008B","E01030525","Total",18,5,11,2,2,1,1,0,16,4,10,2
"2011","Mole Valley 008C","E01030526","Total",32,12,14,6,7,0,6,1,25,12,8,5
"2011","Mole Valley 008D","E01030527","Total",18,9,5,4,4,1,2,1,14,8,3,3
"2011","Mole Valley 009A","E01030532","Total",28,10,13,5,6,2,4,0,22,8,9,5
"2011","Mole Valley 009B","E01030533","Total",19,7,9,3,3,0,3,0,16,7,6,3
"2011","Mole Valley 009C","E01030534","Total",30,13,9,8,3,0,3,0,27,13,6,8
"2011","Mole Valley 009D","E01030556","Total",20,5,12,3,5,0,5,0,15,5,7,3
"2011","Mole Valley 010A","E01030535","Total",35,16,12,7,4,0,3,1,31,16,9,6
"2011","Mole Valley 010B","E01030536","Total",31,15,7,9,6,2,2,2,25,13,5,7
"2011","Mole Valley 010C","E01030537","Total",24,16,4,4,1,1,0,0,23,15,4,4
"2011","Mole Valley 010D","E01030538","Total",36,18,12,6,8,0,7,1,28,18,5,5
"2011","Mole Valley 011A","E01030544","Total",22,14,7,1,3,0,2,1,19,14,5,0
"2011","Mole Valley 011B","E01030545","Total",35,14,11,10,4,1,2,1,31,13,9,9
"2011","Mole Valley 011C","E01030546","Total",55,26,13,16,13,5,6,2,42,21,7,14
"2011","Mole Valley 011D","E01030547","Total",100,36,18,46,7,1,5,1,93,35,13,45
"2011","Mole Valley 012A","E01030529","Total",37,12,10,15,3,0,2,1,34,12,8,14
"2011","Mole Valley 012B","E01030555","Total",33,10,13,10,2,0,2,0,31,10,11,10
"2011","Mole Valley 012C","E01030557","Total",30,15,12,3,5,1,4,0,25,14,8,3
"2011","Mole Valley 012D","E01030558","Total",29,12,9,8,5,1,3,1,24,11,6,7
"2011","Mole Valley 013A","E01030515","Total",33,8,11,14,10,0,5,5,23,8,6,9
"2011","Mole Valley 013B","E01030528","Total",18,8,6,4,0,0,0,0,18,8,6,4
"2011","Mole Valley 013C","E01030530","Total",17,11,4,2,3,3,0,0,14,8,4,2
"2011","Mole Valley 013D","E01030531","Total",36,18,9,9,4,0,3,1,32,18,6,8
"2011","Reigate and Banstead 001A","E01030603","Total",17,3,10,4,1,0,1,0,16,3,9,4
"2011","Reigate and Banstead 001B","E01030604","Total",20,9,2,9,0,0,0,0,20,9,2,9
"2011","Reigate and Banstead 001C","E01030605","Total",31,16,7,8,4,0,3,1,27,16,4,7
"2011","Reigate and Banstead 001D","E01030607","Total",18,4,9,5,3,0,3,0,15,4,6,5
"2011","Reigate and Banstead 002A","E01030559","Total",13,4,4,5,2,0,1,1,11,4,3,4
"2011","Reigate and Banstead 002B","E01030560","Total",45,19,12,14,8,1,7,0,37,18,5,14
"2011","Reigate and Banstead 002C","E01030561","Total",21,11,5,5,3,1,2,0,18,10,3,5
"2011","Reigate and Banstead 002D","E01030562","Total",43,13,20,10,6,0,5,1,37,13,15,9
"2011","Reigate and Banstead 002E","E01030563","Total",11,4,4,3,1,0,1,0,10,4,3,3
"2011","Reigate and Banstead 002F","E01030564","Total",23,9,7,7,3,0,3,0,20,9,4,7
"2011","Reigate and Banstead 003A","E01030606","Total",20,4,10,6,3,0,3,0,17,4,7,6
"2011","Reigate and Banstead 003B","E01030641","Total",20,8,6,6,2,0,2,0,18,8,4,6
"2011","Reigate and Banstead 003C","E01030642","Total",29,9,11,9,4,0,4,0,25,9,7,9
"2011","Reigate and Banstead 003D","E01030644","Total",6,1,4,1,3,0,3,0,3,1,1,1
"2011","Reigate and Banstead 004A","E01030565","Total",30,15,10,5,3,1,2,0,27,14,8,5
"2011","Reigate and Banstead 004B","E01030566","Total",16,9,6,1,1,0,1,0,15,9,5,1
"2011","Reigate and Banstead 004C","E01030567","Total",16,3,7,6,4,0,3,1,12,3,4,5
"2011","Reigate and Banstead 004D","E01030568","Total",15,6,5,4,0,0,0,0,15,6,5,4
"2011","Reigate and Banstead 004E","E01030569","Total",85,31,28,26,11,2,7,2,74,29,21,24
"2011","Reigate and Banstead 005A","E01030608","Total",57,26,8,23,1,0,1,0,56,26,7,23
"2011","Reigate and Banstead 005B","E01030609","Total",83,41,18,24,7,1,5,1,76,40,13,23
"2011","Reigate and Banstead 005C","E01030640","Total",50,17,10,23,4,0,1,3,46,17,9,20
"2011","Reigate and Banstead 005D","E01030643","Total",36,21,5,10,2,1,1,0,34,20,4,10
"2011","Reigate and Banstead 006A","E01030635","Total",21,9,8,4,3,1,1,1,18,8,7,3
"2011","Reigate and Banstead 006B","E01030636","Total",16,5,6,5,2,0,1,1,14,5,5,4
"2011","Reigate and Banstead 006C","E01030637","Total",12,6,5,1,1,1,0,0,11,5,5,1
"2011","Reigate and Banstead 006D","E01030638","Total",22,6,9,7,2,0,1,1,20,6,8,6
"2011","Reigate and Banstead 006E","E01030639","Total",13,6,4,3,3,0,1,2,10,6,3,1
"2011","Reigate and Banstead 007A","E01030589","Total",11,2,5,4,5,1,4,0,6,1,1,4
"2011","Reigate and Banstead 007B","E01030590","Total",28,9,12,7,3,0,3,0,25,9,9,7
"2011","Reigate and Banstead 007C","E01030591","Total",15,3,8,4,4,0,2,2,11,3,6,2
"2011","Reigate and Banstead 007D","E01030592","Total",25,9,10,6,5,0,5,0,20,9,5,6
"2011","Reigate and Banstead 008A","E01030599","Total",65,20,11,34,4,0,3,1,61,20,8,33
"2011","Reigate and Banstead 008B","E01030600","Total",43,15,13,15,2,0,2,0,41,15,11,15
"2011","Reigate and Banstead 008C","E01030601","Total",41,16,8,17,2,1,1,0,39,15,7,17
"2011","Reigate and Banstead 008D","E01030602","Total",32,13,10,9,1,1,0,0,31,12,10,9
"2011","Reigate and Banstead 009A","E01030598","Total",31,8,10,13,5,2,3,0,26,6,7,13
"2011","Reigate and Banstead 009B","E01030623","Total",24,9,10,5,3,1,2,0,21,8,8,5
"2011","Reigate and Banstead 009C","E01030624","Total",14,5,7,2,2,0,2,0,12,5,5,2
"2011","Reigate and Banstead 009D","E01030625","Total",16,7,7,2,5,0,5,0,11,7,2,2
"2011","Reigate and Banstead 009E","E01030626","Total",9,4,4,1,1,0,1,0,8,4,3,1
"2011","Reigate and Banstead 009F","E01030627","Total",18,4,12,2,2,0,2,0,16,4,10,2
"2011","Reigate and Banstead 010A","E01030615","Total",63,9,12,42,4,2,2,0,59,7,10,42
"2011","Reigate and Banstead 010B","E01030616","Total",24,12,10,2,3,0,2,1,21,12,8,1
"2011","Reigate and Banstead 010C","E01030617","Total",24,12,7,5,2,2,0,0,22,10,7,5
"2011","Reigate and Banstead 010D","E01030618","Total",49,19,16,14,5,0,3,2,44,19,13,12
"2011","Reigate and Banstead 010E","E01030619","Total",55,12,12,31,5,0,1,4,50,12,11,27
"2011","Reigate and Banstead 010F","E01030622","Total",38,8,16,14,4,0,3,1,34,8,13,13
"2011","Reigate and Banstead 011A","E01030610","Total",46,16,11,19,3,1,1,1,43,15,10,18
"2011","Reigate and Banstead 011B","E01030611","Total",76,24,29,23,6,0,5,1,70,24,24,22
"2011","Reigate and Banstead 011C","E01030612","Total",37,13,9,15,4,1,2,1,33,12,7,14
"2011","Reigate and Banstead 011D","E01030613","Total",38,12,17,9,2,0,2,0,36,12,15,9
"2011","Reigate and Banstead 011E","E01030614","Total",23,11,7,5,2,1,0,1,21,10,7,4
"2011","Reigate and Banstead 012A","E01030593","Total",34,2,24,8,3,0,2,1,31,2,22,7
"2011","Reigate and Banstead 012B","E01030596","Total",10,1,4,5,2,0,1,1,8,1,3,4
"2011","Reigate and Banstead 012C","E01030597","Total",33,13,15,5,1,0,1,0,32,13,14,5
"2011","Reigate and Banstead 012D","E01030620","Total",18,7,10,1,2,1,1,0,16,6,9,1
"2011","Reigate and Banstead 012E","E01030621","Total",41,18,8,15,3,0,1,2,38,18,7,13
"2011","Reigate and Banstead 013A","E01030594","Total",49,16,14,19,3,0,1,2,46,16,13,17
"2011","Reigate and Banstead 013B","E01030595","Total",37,10,15,12,2,0,2,0,35,10,13,12
"2011","Reigate and Banstead 013C","E01030630","Total",48,17,13,18,4,1,3,0,44,16,10,18
"2011","Reigate and Banstead 013D","E01030631","Total",47,15,15,17,3,0,2,1,44,15,13,16
"2011","Reigate and Banstead 014A","E01030570","Total",30,14,8,8,1,0,1,0,29,14,7,8
"2011","Reigate and Banstead 014B","E01030571","Total",28,11,11,6,2,0,2,0,26,11,9,6
"2011","Reigate and Banstead 014C","E01030572","Total",72,28,21,23,7,2,5,0,65,26,16,23
"2011","Reigate and Banstead 014D","E01030573","Total",40,13,19,8,4,0,4,0,36,13,15,8
"2011","Reigate and Banstead 014E","E01030574","Total",37,12,17,8,6,0,5,1,31,12,12,7
"2011","Reigate and Banstead 015A","E01030628","Total",14,3,5,6,0,0,0,0,14,3,5,6
"2011","Reigate and Banstead 015B","E01030629","Total",14,3,5,6,0,0,0,0,14,3,5,6
"2011","Reigate and Banstead 015C","E01030632","Total",21,7,10,4,3,0,2,1,18,7,8,3
"2011","Reigate and Banstead 015D","E01030633","Total",39,11,9,19,1,0,0,1,38,11,9,18
"2011","Reigate and Banstead 015E","E01030634","Total",63,23,18,22,6,2,2,2,57,21,16,20
"2011","Reigate and Banstead 016A","E01030584","Total",34,12,12,10,6,0,5,1,28,12,7,9
"2011","Reigate and Banstead 016B","E01030585","Total",33,16,10,7,3,0,3,0,30,16,7,7
"2011","Reigate and Banstead 016C","E01030586","Total",54,19,22,13,6,0,4,2,48,19,18,11
"2011","Reigate and Banstead 016D","E01030587","Total",24,11,11,2,3,0,3,0,21,11,8,2
"2011","Reigate and Banstead 016E","E01030588","Total",61,15,16,30,8,1,3,4,53,14,13,26
"2011","Reigate and Banstead 017A","E01030580","Total",51,17,17,17,3,1,2,0,48,16,15,17
"2011","Reigate and Banstead 017B","E01030581","Total",16,6,5,5,3,0,1,2,13,6,4,3
"2011","Reigate and Banstead 017C","E01030582","Total",37,14,12,11,1,0,1,0,36,14,11,11
"2011","Reigate and Banstead 017D","E01030583","Total",13,4,8,1,4,0,3,1,9,4,5,0
"2011","Reigate and Banstead 018A","E01030575","Total",47,14,16,17,6,0,4,2,41,14,12,15
"2011","Reigate and Banstead 018B","E01030576","Total",34,12,12,10,5,0,4,1,29,12,8,9
"2011","Reigate and Banstead 018C","E01030577","Total",48,23,10,15,5,1,2,2,43,22,8,13
"2011","Reigate and Banstead 018D","E01030578","Total",37,9,9,19,2,0,2,0,35,9,7,19
"2011","Reigate and Banstead 018E","E01030579","Total",20,10,3,7,3,0,3,0,17,10,0,7
"2011","Runnymede 001A","E01030667","Total",36,13,14,9,3,0,3,0,33,13,11,9
"2011","Runnymede 001B","E01030668","Total",37,18,11,8,5,3,2,0,32,15,9,8
"2011","Runnymede 001C","E01030669","Total",27,11,11,5,3,0,1,2,24,11,10,3
"2011","Runnymede 001D","E01030670","Total",17,10,4,3,3,1,2,0,14,9,2,3
"2011","Runnymede 002A","E01030671","Total",14,3,4,7,1,1,0,0,13,2,4,7
"2011","Runnymede 002B","E01030672","Total",14,4,7,3,1,0,1,0,13,4,6,3
"2011","Runnymede 002C","E01030673","Total",14,7,6,1,1,0,1,0,13,7,5,1
"2011","Runnymede 002D","E01030674","Total",34,13,14,7,2,0,2,0,32,13,12,7
"2011","Runnymede 002E","E01030675","Total",22,8,5,9,3,0,1,2,19,8,4,7
"2011","Runnymede 002F","E01030676","Total",28,14,5,9,0,0,0,0,28,14,5,9
"2011","Runnymede 003A","E01030663","Total",64,23,19,22,4,0,3,1,60,23,16,21
"2011","Runnymede 003B","E01030664","Total",50,13,13,24,5,0,2,3,45,13,11,21
"2011","Runnymede 003C","E01030665","Total",45,17,12,16,8,2,4,2,37,15,8,14
"2011","Runnymede 003D","E01030666","Total",26,4,9,13,4,0,3,1,22,4,6,12
"2011","Runnymede 003E","E01030687","Total",15,7,5,3,1,0,1,0,14,7,4,3
"2011","Runnymede 003F","E01030688","Total",33,14,12,7,0,0,0,0,33,14,12,7
"2011","Runnymede 004A","E01030656","Total",41,17,9,15,3,0,3,0,38,17,6,15
"2011","Runnymede 004B","E01030658","Total",20,7,7,6,3,0,3,0,17,7,4,6
"2011","Runnymede 004C","E01030685","Total",17,7,6,4,2,0,2,0,15,7,4,4
"2011","Runnymede 004D","E01030686","Total",9,4,3,2,0,0,0,0,9,4,3,2
"2011","Runnymede 005A","E01030689","Total",19,5,8,6,2,0,1,1,17,5,7,5
"2011","Runnymede 005B","E01030690","Total",20,4,8,8,2,0,2,0,18,4,6,8
"2011","Runnymede 005C","E01030691","Total",19,6,5,8,2,0,2,0,17,6,3,8
"2011","Runnymede 005D","E01030692","Total",14,3,1,10,2,0,1,1,12,3,0,9
"2011","Runnymede 006A","E01030652","Total",38,12,10,16,3,0,2,1,35,12,8,15
"2011","Runnymede 006B","E01030653","Total",45,17,16,12,8,0,6,2,37,17,10,10
"2011","Runnymede 006C","E01030654","Total",34,12,7,15,3,0,2,1,31,12,5,14
"2011","Runnymede 006D","E01030657","Total",51,20,14,17,2,0,2,0,49,20,12,17
"2011","Runnymede 006E","E01030659","Total",26,12,8,6,1,0,1,0,25,12,7,6
"2011","Runnymede 007A","E01030647","Total",30,8,17,5,5,0,5,0,25,8,12,5
"2011","Runnymede 007B","E01030648","Total",38,11,11,16,2,1,0,1,36,10,11,15
"2011","Runnymede 007C","E01030649","Total",56,18,10,28,6,1,4,1,50,17,6,27
"2011","Runnymede 007D","E01030650","Total",55,15,11,29,4,0,2,2,51,15,9,27
"2011","Runnymede 007E","E01030651","Total",31,11,10,10,3,0,3,0,28,11,7,10
"2011","Runnymede 007F","E01030655","Total",20,11,3,6,1,1,0,0,19,10,3,6
"2011","Runnymede 007G","E01030662","Total",37,9,16,12,4,0,4,0,33,9,12,12
"2011","Runnymede 008A","E01030677","Total",24,5,14,5,2,0,2,0,22,5,12,5
"2011","Runnymede 008B","E01030678","Total",33,9,12,12,2,0,2,0,31,9,10,12
"2011","Runnymede 008C","E01030679","Total",12,5,5,2,2,1,1,0,10,4,4,2
"2011","Runnymede 008D","E01030680","Total",34,16,12,6,8,4,3,1,26,12,9,5
"2011","Runnymede 009A","E01030645","Total",72,27,13,32,7,1,3,3,65,26,10,29
"2011","Runnymede 009B","E01030646","Total",46,16,19,11,5,0,5,0,41,16,14,11
"2011","Runnymede 009C","E01030660","Total",44,19,11,14,3,1,2,0,41,18,9,14
"2011","Runnymede 009D","E01030661","Total",20,7,9,4,3,0,2,1,17,7,7,3
"2011","Runnymede 009E","E01030684","Total",27,10,7,10,1,0,1,0,26,10,6,10
"2011","Runnymede 010A","E01030681","Total",33,14,12,7,5,0,4,1,28,14,8,6
"2011","Runnymede 010B","E01030682","Total",23,8,11,4,2,0,2,0,21,8,9,4
"2011","Runnymede 010C","E01030683","Total",23,7,9,7,0,0,0,0,23,7,9,7
"2011","Runnymede 010D","E01030693","Total",22,6,10,6,0,0,0,0,22,6,10,6
"2011","Runnymede 010E","E01030694","Total",40,13,12,15,3,0,2,1,37,13,10,14
"2011","Runnymede 010F","E01030695","Total",7,1,3,3,0,0,0,0,7,1,3,3
"2011","Runnymede 010G","E01030696","Total",40,16,14,10,2,0,1,1,38,16,13,9
"2011","Spelthorne 001A","E01030743","Total",33,11,11,11,3,1,1,1,30,10,10,10
"2011","Spelthorne 001B","E01030744","Total",62,17,20,25,6,0,3,3,56,17,17,22
"2011","Spelthorne 001C","E01030745","Total",63,19,17,27,5,0,2,3,58,19,15,24
"2011","Spelthorne 001D","E01030747","Total",35,9,16,10,5,0,4,1,30,9,12,9
"2011","Spelthorne 002A","E01030709","Total",48,18,7,23,5,0,0,5,43,18,7,18
"2011","Spelthorne 002B","E01030710","Total",58,16,15,27,6,1,1,4,52,15,14,23
"2011","Spelthorne 002C","E01030711","Total",53,11,19,23,7,0,5,2,46,11,14,21
"2011","Spelthorne 002D","E01030746","Total",67,22,14,31,3,0,2,1,64,22,12,30
"2011","Spelthorne 003A","E01030707","Total",35,6,15,14,3,0,3,0,32,6,12,14
"2011","Spelthorne 003B","E01030708","Total",33,13,7,13,3,0,1,2,30,13,6,11
"2011","Spelthorne 003C","E01030712","Total",22,6,11,5,6,1,4,1,16,5,7,4
"2011","Spelthorne 003D","E01030713","Total",26,12,10,4,3,0,3,0,23,12,7,4
"2011","Spelthorne 003E","E01030714","Total",28,12,9,7,1,0,1,0,27,12,8,7
"2011","Spelthorne 003F","E01030715","Total",25,11,9,5,4,0,4,0,21,11,5,5
"2011","Spelthorne 003G","E01030716","Total",19,8,8,3,0,0,0,0,19,8,8,3
"2011","Spelthorne 004A","E01030734","Total",27,12,10,5,1,0,1,0,26,12,9,5
"2011","Spelthorne 004B","E01030735","Total",36,17,11,8,4,1,1,2,32,16,10,6
"2011","Spelthorne 004C","E01030736","Total",30,12,9,9,4,1,2,1,26,11,7,8
"2011","Spelthorne 004D","E01030737","Total",27,8,5,14,1,0,0,1,26,8,5,13
"2011","Spelthorne 004E","E01030738","Total",43,13,15,15,5,0,4,1,38,13,11,14
"2011","Spelthorne 005A","E01030701","Total",40,13,15,12,4,2,2,0,36,11,13,12
"2011","Spelthorne 005B","E01030702","Total",35,10,8,17,5,0,4,1,30,10,4,16
"2011","Spelthorne 005C","E01030703","Total",36,11,12,13,2,1,1,0,34,10,11,13
"2011","Spelthorne 005D","E01030704","Total",20,9,4,7,1,1,0,0,19,8,4,7
"2011","Spelthorne 005E","E01030705","Total",23,2,13,8,3,0,2,1,20,2,11,7
"2011","Spelthorne 005F","E01030706","Total",19,5,7,7,1,0,1,0,18,5,6,7
"2011","Spelthorne 006A","E01030697","Total",25,10,11,4,4,1,3,0,21,9,8,4
"2011","Spelthorne 006B","E01030698","Total",41,15,13,13,4,0,4,0,37,15,9,13
"2011","Spelthorne 006C","E01030699","Total",37,13,6,18,4,0,0,4,33,13,6,14
"2011","Spelthorne 006D","E01030700","Total",37,12,8,17,1,0,1,0,36,12,7,17
"2011","Spelthorne 006E","E01030725","Total",63,19,19,25,4,1,2,1,59,18,17,24
"2011","Spelthorne 007A","E01030729","Total",44,17,7,20,4,0,3,1,40,17,4,19
"2011","Spelthorne 007B","E01030739","Total",61,20,16,25,4,0,2,2,57,20,14,23
"2011","Spelthorne 007C","E01030740","Total",43,19,12,12,5,1,4,0,38,18,8,12
"2011","Spelthorne 007D","E01030741","Total",38,12,9,17,2,0,1,1,36,12,8,16
"2011","Spelthorne 008A","E01030748","Total",43,15,14,14,5,3,1,1,38,12,13,13
"2011","Spelthorne 008B","E01030749","Total",65,16,27,22,4,0,3,1,61,16,24,21
"2011","Spelthorne 008C","E01030750","Total",47,13,14,20,1,0,1,0,46,13,13,20
"2011","Spelthorne 008D","E01030751","Total",43,8,13,22,6,0,4,2,37,8,9,20
"2011","Spelthorne 008E","E01030752","Total",50,8,18,24,2,0,2,0,48,8,16,24
"2011","Spelthorne 009A","E01030726","Total",14,7,4,3,0,0,0,0,14,7,4,3
"2011","Spelthorne 009B","E01030727","Total",37,16,8,13,1,0,0,1,36,16,8,12
"2011","Spelthorne 009C","E01030728","Total",19,8,9,2,4,0,4,0,15,8,5,2
"2011","Spelthorne 009D","E01030742","Total",30,11,11,8,3,0,3,0,27,11,8,8
"2011","Spelthorne 010A","E01030753","Total",19,8,9,2,1,0,1,0,18,8,8,2
"2011","Spelthorne 010B","E01030754","Total",12,4,7,1,1,0,1,0,11,4,6,1
"2011","Spelthorne 010C","E01030755","Total",69,20,19,30,3,0,2,1,66,20,17,29
"2011","Spelthorne 010D","E01030756","Total",18,3,11,4,3,0,1,2,15,3,10,2
"2011","Spelthorne 011A","E01030717","Total",44,12,16,16,5,0,2,3,39,12,14,13
"2011","Spelthorne 011B","E01030718","Total",19,7,8,4,1,0,0,1,18,7,8,3
"2011","Spelthorne 011C","E01030719","Total",32,6,12,14,3,0,2,1,29,6,10,13
"2011","Spelthorne 011D","E01030720","Total",25,9,9,7,1,0,0,1,24,9,9,6
"2011","Spelthorne 012A","E01030721","Total",45,14,12,19,3,2,1,0,42,12,11,19
"2011","Spelthorne 012B","E01030722","Total",42,17,17,8,4,0,4,0,38,17,13,8
"2011","Spelthorne 012C","E01030723","Total",25,8,10,7,1,0,0,1,24,8,10,6
"2011","Spelthorne 012D","E01030724","Total",47,16,11,20,1,0,1,0,46,16,10,20
"2011","Spelthorne 013A","E01030730","Total",15,6,6,3,2,0,2,0,13,6,4,3
"2011","Spelthorne 013B","E01030731","Total",44,14,21,9,6,0,4,2,38,14,17,7
"2011","Spelthorne 013C","E01030732","Total",20,7,7,6,0,0,0,0,20,7,7,6
"2011","Spelthorne 013D","E01030733","Total",34,6,15,13,3,1,2,0,31,5,13,13
"2011","Surrey Heath 001A","E01030763","Total",8,3,1,4,1,0,0,1,7,3,1,3
"2011","Surrey Heath 001B","E01030764","Total",8,2,2,4,0,0,0,0,8,2,2,4
"2011","Surrey Heath 001C","E01030765","Total",34,14,11,9,1,0,1,0,33,14,10,9
"2011","Surrey Heath 001D","E01030809","Total",21,7,8,6,4,0,3,1,17,7,5,5
"2011","Surrey Heath 001E","E01030810","Total",15,6,6,3,4,0,4,0,11,6,2,3
"2011","Surrey Heath 001F","E01030811","Total",14,7,6,1,2,0,1,1,12,7,5,0
"2011","Surrey Heath 002A","E01030757","Total",27,7,13,7,7,1,3,3,20,6,10,4
"2011","Surrey Heath 002B","E01030758","Total",20,8,8,4,2,0,2,0,18,8,6,4
"2011","Surrey Heath 002C","E01030759","Total",37,12,10,15,3,1,2,0,34,11,8,15
"2011","Surrey Heath 002D","E01030760","Total",17,7,6,4,2,0,1,1,15,7,5,3
"2011","Surrey Heath 003A","E01030778","Total",21,5,11,5,2,0,2,0,19,5,9,5
"2011","Surrey Heath 003B","E01030779","Total",14,2,11,1,1,0,1,0,13,2,10,1
"2011","Surrey Heath 003C","E01030780","Total",18,6,12,0,3,0,3,0,15,6,9,0
"2011","Surrey Heath 003D","E01030781","Total",34,15,12,7,6,1,5,0,28,14,7,7
"2011","Surrey Heath 004A","E01030786","Total",71,10,23,38,7,1,4,2,64,9,19,36
"2011","Surrey Heath 004B","E01030787","Total",33,17,6,10,1,0,1,0,32,17,5,10
"2011","Surrey Heath 004C","E01030788","Total",63,16,11,36,3,0,2,1,60,16,9,35
"2011","Surrey Heath 004D","E01030801","Total",36,15,12,9,4,1,1,2,32,14,11,7
"2011","Surrey Heath 004E","E01030802","Total",18,6,6,6,2,0,2,0,16,6,4,6
"2011","Surrey Heath 005A","E01030796","Total",11,3,6,2,0,0,0,0,11,3,6,2
"2011","Surrey Heath 005B","E01030797","Total",17,5,10,2,4,0,4,0,13,5,6,2
"2011","Surrey Heath 005C","E01030798","Total",11,2,4,5,2,0,2,0,9,2,2,5
"2011","Surrey Heath 005D","E01030799","Total",8,2,4,2,1,0,1,0,7,2,3,2
"2011","Surrey Heath 005E","E01030800","Total",30,11,3,16,1,0,1,0,29,11,2,16
"2011","Surrey Heath 006A","E01030761","Total",24,11,9,4,4,0,4,0,20,11,5,4
"2011","Surrey Heath 006B","E01030762","Total",34,13,16,5,3,2,1,0,31,11,15,5
"2011","Surrey Heath 006C","E01030806","Total",19,10,4,5,1,0,0,1,18,10,4,4
"2011","Surrey Heath 006D","E01030807","Total",15,4,4,7,0,0,0,0,15,4,4,7
"2011","Surrey Heath 006E","E01030808","Total",27,11,14,2,4,0,4,0,23,11,10,2
"2011","Surrey Heath 007A","E01030774","Total",30,8,15,7,2,0,2,0,28,8,13,7
"2011","Surrey Heath 007B","E01030775","Total",11,5,4,2,5,3,2,0,6,2,2,2
"2011","Surrey Heath 007C","E01030776","Total",33,10,18,5,6,0,5,1,27,10,13,4
"2011","Surrey Heath 007D","E01030777","Total",37,13,10,14,4,1,3,0,33,12,7,14
"2011","Surrey Heath 008A","E01030793","Total",63,17,10,36,3,0,0,3,60,17,10,33
"2011","Surrey Heath 008B","E01030794","Total",28,12,6,10,2,1,1,0,26,11,5,10
"2011","Surrey Heath 008C","E01030795","Total",22,8,9,5,0,0,0,0,22,8,9,5
"2011","Surrey Heath 008D","E01030803","Total",34,11,9,14,2,1,1,0,32,10,8,14
"2011","Surrey Heath 008E","E01030804","Total",15,8,1,6,2,1,1,0,13,7,0,6
"2011","Surrey Heath 008F","E01030805","Total",54,20,12,22,6,3,2,1,48,17,10,21
"2011","Surrey Heath 009A","E01030789","Total",8,5,3,0,1,0,1,0,7,5,2,0
"2011","Surrey Heath 009B","E01030790","Total",32,14,13,5,3,0,3,0,29,14,10,5
"2011","Surrey Heath 009C","E01030791","Total",18,6,11,1,3,0,2,1,15,6,9,0
"2011","Surrey Heath 009D","E01030792","Total",8,0,3,5,0,0,0,0,8,0,3,5
"2011","Surrey Heath 010A","E01030766","Total",19,5,8,6,3,0,3,0,16,5,5,6
"2011","Surrey Heath 010B","E01030767","Total",48,18,6,24,3,0,0,3,45,18,6,21
"2011","Surrey Heath 010C","E01030768","Total",27,9,12,6,3,0,1,2,24,9,11,4
"2011","Surrey Heath 010D","E01030769","Total",21,6,14,1,2,1,1,0,19,5,13,1
"2011","Surrey Heath 011A","E01030770","Total",21,10,8,3,1,0,1,0,20,10,7,3
"2011","Surrey Heath 011B","E01030771","Total",14,7,7,0,1,0,1,0,13,7,6,0
"2011","Surrey Heath 011C","E01030772","Total",36,16,15,5,5,0,4,1,31,16,11,4
"2011","Surrey Heath 011D","E01030773","Total",23,8,13,2,2,1,1,0,21,7,12,2
"2011","Surrey Heath 012A","E01030782","Total",13,4,4,5,1,0,1,0,12,4,3,5
"2011","Surrey Heath 012B","E01030783","Total",18,6,9,3,1,0,1,0,17,6,8,3
"2011","Surrey Heath 012C","E01030784","Total",44,16,21,7,8,2,5,1,36,14,16,6
"2011","Surrey Heath 012D","E01030785","Total",18,3,10,5,3,1,2,0,15,2,8,5
"2011","Tandridge 002A","E01030855","Total",8,4,4,0,0,0,0,0,8,4,4,0
"2011","Tandridge 002B","E01030856","Total",26,10,12,4,3,0,3,0,23,10,9,4
"2011","Tandridge 002C","E01030859","Total",37,16,12,9,6,3,3,0,31,13,9,9
"2011","Tandridge 002D","E01030860","Total",73,30,24,19,8,2,5,1,65,28,19,18
"2011","Tandridge 003A","E01030844","Total",50,19,16,15,3,0,3,0,47,19,13,15
"2011","Tandridge 003B","E01030845","Total",29,10,13,6,3,2,0,1,26,8,13,5
"2011","Tandridge 003C","E01030846","Total",23,9,6,8,1,0,0,1,22,9,6,7
"2011","Tandridge 003D","E01030857","Total",81,32,31,18,12,1,9,2,69,31,22,16
"2011","Tandridge 003E","E01030858","Total",74,31,22,21,9,0,5,4,65,31,17,17
"2011","Tandridge 004A","E01030828","Total",14,1,9,4,5,0,5,0,9,1,4,4
"2011","Tandridge 004B","E01030829","Total",35,7,14,14,4,0,2,2,31,7,12,12
"2011","Tandridge 004C","E01030830","Total",21,6,9,6,3,0,3,0,18,6,6,6
"2011","Tandridge 004D","E01030850","Total",50,17,14,19,3,0,2,1,47,17,12,18
"2011","Tandridge 004E","E01030851","Total",63,25,11,27,2,0,1,1,61,25,10,26
"2011","Tandridge 004F","E01030861","Total",18,4,6,8,6,1,2,3,12,3,4,5
"2011","Tandridge 005A","E01030820","Total",11,7,3,1,2,0,2,0,9,7,1,1
"2011","Tandridge 005B","E01030847","Total",18,5,7,6,0,0,0,0,18,5,7,6
"2011","Tandridge 005C","E01030848","Total",64,26,23,15,2,0,2,0,62,26,21,15
"2011","Tandridge 006A","E01030831","Total",21,5,12,4,6,0,6,0,15,5,6,4
"2011","Tandridge 006B","E01030832","Total",11,2,3,6,3,0,0,3,8,2,3,3
"2011","Tandridge 006C","E01030836","Total",49,17,22,10,4,1,3,0,45,16,19,10
"2011","Tandridge 006D","E01030837","Total",46,17,18,11,4,0,4,0,42,17,14,11
"2011","Tandridge 006E","E01030838","Total",22,6,7,9,1,0,1,0,21,6,6,9
"2011","Tandridge 006F","E01030839","Total",10,6,3,1,4,2,2,0,6,4,1,1
"2011","Tandridge 007A","E01030840","Total",41,14,11,16,3,0,3,0,38,14,8,16
"2011","Tandridge 007B","E01030841","Total",10,4,1,5,1,0,1,0,9,4,0,5
"2011","Tandridge 007C","E01030842","Total",45,11,13,21,3,0,2,1,42,11,11,20
"2011","Tandridge 007D","E01030843","Total",51,17,18,16,2,0,1,1,49,17,17,15
"2011","Tandridge 008A","E01030812","Total",42,18,11,13,3,0,2,1,39,18,9,12
"2011","Tandridge 008B","E01030813","Total",29,13,10,6,3,0,1,2,26,13,9,4
"2011","Tandridge 008C","E01030814","Total",24,9,9,6,3,0,3,0,21,9,6,6
"2011","Tandridge 008D","E01030815","Total",21,6,9,6,3,1,2,0,18,5,7,6
"2011","Tandridge 009A","E01030824","Total",54,21,16,17,5,2,3,0,49,19,13,17
"2011","Tandridge 009B","E01030825","Total",12,5,3,4,1,0,0,1,11,5,3,3
"2011","Tandridge 009C","E01030826","Total",42,19,15,8,5,1,4,0,37,18,11,8
"2011","Tandridge 009D","E01030827","Total",28,14,7,7,3,0,2,1,25,14,5,6
"2011","Tandridge 010A","E01030821","Total",19,4,10,5,3,0,2,1,16,4,8,4
"2011","Tandridge 010B","E01030822","Total",16,7,5,4,0,0,0,0,16,7,5,4
"2011","Tandridge 010C","E01030833","Total",18,6,7,5,1,0,1,0,17,6,6,5
"2011","Tandridge 010D","E01030834","Total",29,9,6,14,1,0,1,0,28,9,5,14
"2011","Tandridge 010E","E01030835","Total",13,4,6,3,1,0,1,0,12,4,5,3
"2011","Tandridge 011A","E01030816","Total",24,9,2,13,1,0,1,0,23,9,1,13
"2011","Tandridge 011B","E01030817","Total",7,4,2,1,2,1,1,0,5,3,1,1
"2011","Tandridge 011C","E01030818","Total",20,6,5,9,4,1,2,1,16,5,3,8
"2011","Tandridge 011D","E01030819","Total",17,6,9,2,4,0,4,0,13,6,5,2
"2011","Tandridge 011E","E01030823","Total",18,5,8,5,4,0,2,2,14,5,6,3
"2011","Tandridge 012A","E01030852","Total",58,21,12,25,2,0,1,1,56,21,11,24
"2011","Tandridge 012B","E01030853","Total",41,20,9,12,7,2,3,2,34,18,6,10
"2011","Tandridge 012C","E01030854","Total",36,12,11,13,6,1,4,1,30,11,7,12
"2011","Tandridge 012D","E01032571","Total",25,13,4,8,0,0,0,0,25,13,4,8
"2011","Waverley 001A","E01030890","Total",40,16,8,16,4,0,3,1,36,16,5,15
"2011","Waverley 001B","E01030902","Total",20,9,4,7,2,1,1,0,18,8,3,7
"2011","Waverley 001C","E01030903","Total",36,15,15,6,5,0,5,0,31,15,10,6
"2011","Waverley 001D","E01030904","Total",21,9,7,5,1,0,0,1,20,9,7,4
"2011","Waverley 002A","E01030891","Total",16,4,8,4,2,0,2,0,14,4,6,4
"2011","Waverley 002B","E01030892","Total",31,11,13,7,2,0,2,0,29,11,11,7
"2011","Waverley 002C","E01030899","Total",18,11,3,4,1,0,1,0,17,11,2,4
"2011","Waverley 002D","E01030900","Total",17,5,5,7,2,1,1,0,15,4,4,7
"2011","Waverley 002E","E01030901","Total",75,30,8,37,6,3,0,3,69,27,8,34
"2011","Waverley 003A","E01030884","Total",43,16,10,17,0,0,0,0,43,16,10,17
"2011","Waverley 003B","E01030885","Total",16,8,3,5,2,1,1,0,14,7,2,5
"2011","Waverley 003C","E01030886","Total",14,6,4,4,0,0,0,0,14,6,4,4
"2011","Waverley 003D","E01030893","Total",27,13,4,10,3,1,1,1,24,12,3,9
"2011","Waverley 003E","E01030895","Total",26,8,9,9,1,0,1,0,25,8,8,9
"2011","Waverley 004A","E01030881","Total",18,5,5,8,3,0,2,1,15,5,3,7
"2011","Waverley 004B","E01030883","Total",16,6,6,4,2,0,2,0,14,6,4,4
"2011","Waverley 004C","E01030888","Total",22,11,7,4,1,0,1,0,21,11,6,4
"2011","Waverley 004D","E01030894","Total",12,4,5,3,2,0,1,1,10,4,4,2
"2011","Waverley 005A","E01030911","Total",18,6,3,9,6,1,3,2,12,5,0,7
"2011","Waverley 005B","E01030912","Total",35,16,12,7,4,1,3,0,31,15,9,7
"2011","Waverley 005C","E01030913","Total",57,20,14,23,3,0,2,1,54,20,12,22
"2011","Waverley 005D","E01030920","Total",40,12,14,14,2,0,2,0,38,12,12,14
"2011","Waverley 005E","E01030921","Total",43,23,10,10,5,1,4,0,38,22,6,10
"2011","Waverley 006A","E01030882","Total",10,4,4,2,1,0,1,0,9,4,3,2
"2011","Waverley 006B","E01030887","Total",19,8,9,2,2,0,2,0,17,8,7,2
"2011","Waverley 006C","E01030889","Total",33,17,7,9,5,2,3,0,28,15,4,9
"2011","Waverley 006D","E01030896","Total",39,12,12,15,3,0,2,1,36,12,10,14
"2011","Waverley 006E","E01030897","Total",22,8,9,5,2,0,2,0,20,8,7,5
"2011","Waverley 007A","E01030916","Total",32,11,14,7,5,1,4,0,27,10,10,7
"2011","Waverley 007B","E01030917","Total",11,5,4,2,1,0,1,0,10,5,3,2
"2011","Waverley 007C","E01030918","Total",17,7,5,5,2,1,1,0,15,6,4,5
"2011","Waverley 007D","E01030919","Total",11,3,5,3,3,0,3,0,8,3,2,3
"2011","Waverley 007E","E01030922","Total",22,8,9,5,2,0,2,0,20,8,7,5
"2011","Waverley 008A","E01030863","Total",21,11,5,5,2,0,0,2,19,11,5,3
"2011","Waverley 008B","E01030865","Total",24,10,6,8,2,0,2,0,22,10,4,8
"2011","Waverley 008C","E01030866","Total",11,4,4,3,0,0,0,0,11,4,4,3
"2011","Waverley 008D","E01030940","Total",23,11,5,7,3,1,2,0,20,10,3,7
"2011","Waverley 009A","E01030898","Total",19,9,7,3,1,1,0,0,18,8,7,3
"2011","Waverley 009B","E01030905","Total",38,21,6,11,3,2,0,1,35,19,6,10
"2011","Waverley 009C","E01030906","Total",38,12,17,9,6,1,5,0,32,11,12,9
"2011","Waverley 009D","E01030907","Total",15,8,5,2,4,0,4,0,11,8,1,2
"2011","Waverley 010A","E01030914","Total",42,11,6,25,0,0,0,0,42,11,6,25
"2011","Waverley 010B","E01030915","Total",45,13,18,14,3,1,1,1,42,12,17,13
"2011","Waverley 010C","E01030923","Total",14,4,5,5,1,0,1,0,13,4,4,5
"2011","Waverley 010D","E01030924","Total",26,9,13,4,4,0,4,0,22,9,9,4
"2011","Waverley 010E","E01030925","Total",12,3,5,4,0,0,0,0,12,3,5,4
"2011","Waverley 011A","E01030877","Total",11,6,1,4,2,1,1,0,9,5,0,4
"2011","Waverley 011B","E01030878","Total",20,11,8,1,3,0,3,0,17,11,5,1
"2011","Waverley 011C","E01030937","Total",31,15,10,6,2,0,2,0,29,15,8,6
"2011","Waverley 011D","E01030938","Total",26,11,5,10,2,0,1,1,24,11,4,9
"2011","Waverley 011E","E01030939","Total",24,10,9,5,1,0,1,0,23,10,8,5
"2011","Waverley 012A","E01030864","Total",14,3,4,7,3,1,2,0,11,2,2,7
"2011","Waverley 012B","E01030879","Total",13,5,4,4,1,0,0,1,12,5,4,3
"2011","Waverley 012C","E01030941","Total",18,4,7,7,3,0,3,0,15,4,4,7
"2011","Waverley 012D","E01030942","Total",13,5,6,2,2,0,1,1,11,5,5,1
"2011","Waverley 012E","E01030943","Total",38,14,14,10,2,0,2,0,36,14,12,10
"2011","Waverley 013A","E01030870","Total",21,10,6,5,1,0,0,1,20,10,6,4
"2011","Waverley 013B","E01030871","Total",41,15,17,9,7,2,4,1,34,13,13,8
"2011","Waverley 013C","E01030872","Total",58,33,12,13,9,0,8,1,49,33,4,12
"2011","Waverley 013D","E01030873","Total",30,14,9,7,4,0,3,1,26,14,6,6
"2011","Waverley 013E","E01030874","Total",10,1,5,4,1,0,1,0,9,1,4,4
"2011","Waverley 013F","E01030875","Total",26,12,7,7,5,0,3,2,21,12,4,5
"2011","Waverley 013G","E01030876","Total",6,2,1,3,0,0,0,0,6,2,1,3
"2011","Waverley 015A","E01030862","Total",21,13,1,7,1,0,0,1,20,13,1,6
"2011","Waverley 015B","E01030867","Total",26,12,6,8,4,0,3,1,22,12,3,7
"2011","Waverley 015C","E01030868","Total",20,5,10,5,3,0,3,0,17,5,7,5
"2011","Waverley 015D","E01030869","Total",14,5,4,5,3,1,0,2,11,4,4,3
"2011","Waverley 015E","E01030880","Total",20,5,8,7,2,0,2,0,18,5,6,7
"2011","Waverley 016A","E01030930","Total",14,4,3,7,3,0,3,0,11,4,0,7
"2011","Waverley 016B","E01030931","Total",21,6,8,7,0,0,0,0,21,6,8,7
"2011","Waverley 016C","E01030932","Total",38,8,17,13,7,0,6,1,31,8,11,12
"2011","Waverley 016D","E01030933","Total",26,9,7,10,2,0,2,0,24,9,5,10
"2011","Waverley 017A","E01030926","Total",17,8,8,1,5,1,4,0,12,7,4,1
"2011","Waverley 017B","E01030927","Total",25,10,7,8,0,0,0,0,25,10,7,8
"2011","Waverley 017C","E01030928","Total",49,23,15,11,4,1,3,0,45,22,12,11
"2011","Waverley 017D","E01030929","Total",16,5,9,2,0,0,0,0,16,5,9,2
"2011","Waverley 018A","E01030908","Total",12,3,5,4,5,1,4,0,7,2,1,4
"2011","Waverley 018B","E01030909","Total",19,5,9,5,4,0,4,0,15,5,5,5
"2011","Waverley 018C","E01030910","Total",11,4,5,2,2,0,2,0,9,4,3,2
"2011","Waverley 018D","E01030934","Total",14,4,2,8,2,1,0,1,12,3,2,7
"2011","Waverley 018E","E01030935","Total",22,13,6,3,3,1,2,0,19,12,4,3
"2011","Waverley 018F","E01032626","Total",14,5,3,6,1,0,0,1,13,5,3,5
"2011","Woking 001A","E01030946","Total",53,18,12,23,8,0,3,5,45,18,9,18
"2011","Woking 001B","E01030947","Total",40,20,16,4,8,2,5,1,32,18,11,3
"2011","Woking 001C","E01030948","Total",30,12,14,4,2,0,2,0,28,12,12,4
"2011","Woking 001D","E01030949","Total",46,15,19,12,2,0,2,0,44,15,17,12
"2011","Woking 001E","E01030950","Total",39,11,12,16,5,1,3,1,34,10,9,15
"2011","Woking 002A","E01030996","Total",8,0,5,3,0,0,0,0,8,0,5,3
"2011","Woking 002B","E01030998","Total",12,2,4,6,0,0,0,0,12,2,4,6
"2011","Woking 002C","E01031002","Total",18,8,10,0,3,0,3,0,15,8,7,0
"2011","Woking 002D","E01031003","Total",9,1,3,5,2,0,2,0,7,1,1,5
"2011","Woking 002E","E01031004","Total",59,22,19,18,5,2,3,0,54,20,16,18
"2011","Woking 003A","E01030963","Total",9,0,5,4,2,0,1,1,7,0,4,3
"2011","Woking 003B","E01030964","Total",18,1,9,8,4,0,3,1,14,1,6,7
"2011","Woking 003C","E01030965","Total",24,9,9,6,4,0,4,0,20,9,5,6
"2011","Woking 003D","E01030966","Total",15,6,7,2,0,0,0,0,15,6,7,2
"2011","Woking 003E","E01030967","Total",17,5,7,5,1,0,1,0,16,5,6,5
"2011","Woking 003F","E01030968","Total",30,9,8,13,4,1,2,1,26,8,6,12
"2011","Woking 004A","E01030980","Total",22,3,3,16,1,0,1,0,21,3,2,16
"2011","Woking 004B","E01030981","Total",11,1,5,5,3,0,3,0,8,1,2,5
"2011","Woking 004C","E01030982","Total",34,11,10,13,2,0,2,0,32,11,8,13
"2011","Woking 004D","E01030983","Total",28,5,7,16,1,0,0,1,27,5,7,15
"2011","Woking 004E","E01030984","Total",50,11,12,27,5,2,1,2,45,9,11,25
"2011","Woking 004F","E01030985","Total",59,19,12,28,7,0,3,4,52,19,9,24
"2011","Woking 005A","E01030951","Total",30,12,10,8,1,0,1,0,29,12,9,8
"2011","Woking 005B","E01030952","Total",86,25,14,47,8,1,3,4,78,24,11,43
"2011","Woking 005C","E01030953","Total",14,11,3,0,1,0,1,0,13,11,2,0
"2011","Woking 005D","E01030956","Total",31,8,12,11,4,0,4,0,27,8,8,11
"2011","Woking 005E","E01030957","Total",46,22,6,18,2,0,1,1,44,22,5,17
"2011","Woking 005F","E01030958","Total",39,13,16,10,7,2,4,1,32,11,12,9
"2011","Woking 005G","E01030959","Total",12,5,5,2,0,0,0,0,12,5,5,2
"2011","Woking 006A","E01030988","Total",22,5,10,7,4,0,4,0,18,5,6,7
"2011","Woking 006B","E01030989","Total",26,12,3,11,1,0,0,1,25,12,3,10
"2011","Woking 006C","E01030990","Total",10,5,4,1,2,1,1,0,8,4,3,1
"2011","Woking 006D","E01030997","Total",24,5,13,6,3,0,3,0,21,5,10,6
"2011","Woking 007A","E01030974","Total",27,12,11,4,3,0,3,0,24,12,8,4
"2011","Woking 007B","E01030975","Total",16,8,5,3,1,0,1,0,15,8,4,3
"2011","Woking 007C","E01030976","Total",27,11,8,8,0,0,0,0,27,11,8,8
"2011","Woking 007D","E01030977","Total",20,8,8,4,2,0,2,0,18,8,6,4
"2011","Woking 007E","E01030979","Total",86,27,20,39,5,2,1,2,81,25,19,37
"2011","Woking 008A","E01030954","Total",34,9,15,10,3,0,3,0,31,9,12,10
"2011","Woking 008B","E01030969","Total",6,3,3,0,2,1,1,0,4,2,2,0
"2011","Woking 008C","E01030970","Total",15,7,7,1,2,0,2,0,13,7,5,1
"2011","Woking 008D","E01030991","Total",28,8,14,6,1,0,1,0,27,8,13,6
"2011","Woking 008E","E01030993","Total",46,11,13,22,5,3,1,1,41,8,12,21
"2011","Woking 009A","E01030960","Total",48,12,25,11,6,0,5,1,42,12,20,10
"2011","Woking 009B","E01030961","Total",28,10,10,8,2,0,2,0,26,10,8,8
"2011","Woking 009C","E01030962","Total",53,11,21,21,5,0,2,3,48,11,19,18
"2011","Woking 009D","E01031000","Total",21,7,11,3,5,1,4,0,16,6,7,3
"2011","Woking 010A","E01030955","Total",19,5,7,7,2,0,1,1,17,5,6,6
"2011","Woking 010B","E01030992","Total",23,6,13,4,2,0,2,0,21,6,11,4
"2011","Woking 010C","E01030999","Total",7,1,3,3,0,0,0,0,7,1,3,3
"2011","Woking 010D","E01031001","Total",16,7,3,6,2,0,1,1,14,7,2,5
"2011","Woking 011A","E01030971","Total",63,21,20,22,3,0,1,2,60,21,19,20
"2011","Woking 011B","E01030972","Total",32,9,8,15,2,0,1,1,30,9,7,14
"2011","Woking 011C","E01030973","Total",34,11,5,18,3,0,1,2,31,11,4,16
"2011","Woking 011D","E01030994","Total",36,10,14,12,5,0,1,4,31,10,13,8
"2011","Woking 011E","E01030995","Total",37,14,10,13,3,0,1,2,34,14,9,11
"2011","Woking 012A","E01030944","Total",17,6,4,7,0,0,0,0,17,6,4,7
"2011","Woking 012B","E01030945","Total",30,12,12,6,2,0,2,0,28,12,10,6
"2011","Woking 012C","E01030978","Total",24,4,14,6,3,0,3,0,21,4,11,6
"2011","Woking 012D","E01030986","Total",11,6,2,3,3,1,2,0,8,5,0,3
"2011","Woking 012E","E01030987","Total",17,9,5,3,0,0,0,0,17,9,5,3
"2011","Adur 001A","E01031349","Total",22,9,4,9,1,0,0,1,21,9,4,8
"2011","Adur 001B","E01031350","Total",29,12,2,15,1,0,1,0,28,12,1,15
"2011","Adur 001C","E01031351","Total",34,15,8,11,3,0,2,1,31,15,6,10
"2011","Adur 001D","E01031352","Total",36,18,9,9,6,1,3,2,30,17,6,7
"2011","Adur 001E","E01031370","Total",44,20,12,12,4,0,2,2,40,20,10,10
"2011","Adur 001F","E01031374","Total",33,11,10,12,8,1,3,4,25,10,7,8
"2011","Adur 002A","E01031338","Total",18,6,9,3,2,0,2,0,16,6,7,3
"2011","Adur 002B","E01031339","Total",24,11,7,6,1,0,1,0,23,11,6,6
"2011","Adur 002C","E01031340","Total",17,6,7,4,2,0,2,0,15,6,5,4
"2011","Adur 002D","E01031365","Total",25,10,8,7,3,0,2,1,22,10,6,6
"2011","Adur 002E","E01031367","Total",10,3,4,3,0,0,0,0,10,3,4,3
"2011","Adur 003A","E01031345","Total",23,8,9,6,5,0,4,1,18,8,5,5
"2011","Adur 003B","E01031353","Total",6,4,1,1,0,0,0,0,6,4,1,1
"2011","Adur 003C","E01031354","Total",26,10,6,10,3,0,1,2,23,10,5,8
"2011","Adur 003D","E01031355","Total",48,18,11,19,3,1,2,0,45,17,9,19
"2011","Adur 003E","E01031359","Total",30,12,9,9,3,2,1,0,27,10,8,9
"2011","Adur 004A","E01031347","Total",69,25,6,38,5,0,1,4,64,25,5,34
"2011","Adur 004B","E01031348","Total",89,38,16,35,5,2,2,1,84,36,14,34
"2011","Adur 004C","E01031366","Total",44,14,17,13,1,0,1,0,43,14,16,13
"2011","Adur 004D","E01031371","Total",62,23,8,31,7,1,5,1,55,22,3,30
"2011","Adur 004E","E01031372","Total",56,17,12,27,4,1,0,3,52,16,12,24
"2011","Adur 004F","E01031373","Total",42,19,9,14,1,0,1,0,41,19,8,14
"2011","Adur 004G","E01031375","Total",30,13,9,8,4,2,2,0,26,11,7,8
"2011","Adur 005A","E01031356","Total",57,22,15,20,7,1,6,0,50,21,9,20
"2011","Adur 005B","E01031357","Total",76,29,20,27,10,1,6,3,66,28,14,24
"2011","Adur 005C","E01031364","Total",66,21,14,31,6,1,3,2,60,20,11,29
"2011","Adur 005D","E01031368","Total",33,15,7,11,0,0,0,0,33,15,7,11
"2011","Adur 005E","E01031369","Total",23,6,5,12,2,0,1,1,21,6,4,11
"2011","Adur 006A","E01031344","Total",32,9,8,15,2,0,2,0,30,9,6,15
"2011","Adur 006B","E01031346","Total",20,8,5,7,3,0,2,1,17,8,3,6
"2011","Adur 006C","E01031361","Total",65,24,13,28,5,1,4,0,60,23,9,28
"2011","Adur 006D","E01031362","Total",35,12,10,13,8,1,5,2,27,11,5,11
"2011","Adur 006E","E01031363","Total",34,10,9,15,4,0,2,2,30,10,7,13
"2011","Adur 007A","E01031358","Total",50,16,8,26,1,0,1,0,49,16,7,26
"2011","Adur 007B","E01031360","Total",52,25,7,20,4,0,4,0,48,25,3,20
"2011","Adur 007C","E01031376","Total",22,12,3,7,3,2,1,0,19,10,2,7
"2011","Adur 007D","E01031378","Total",35,14,5,16,5,2,2,1,30,12,3,15
"2011","Adur 008A","E01031341","Total",64,16,16,32,9,1,8,0,55,15,8,32
"2011","Adur 008B","E01031342","Total",39,12,7,20,4,1,3,0,35,11,4,20
"2011","Adur 008C","E01031343","Total",28,10,10,8,2,0,1,1,26,10,9,7
"2011","Adur 008D","E01031377","Total",44,9,14,21,7,0,6,1,37,9,8,20
"2011","Adur 008E","E01031379","Total",22,10,6,6,4,2,2,0,18,8,4,6
"2011","Arun 001A","E01031390","Total",31,13,4,14,3,0,1,2,28,13,3,12
"2011","Arun 001B","E01031391","Total",36,17,10,9,1,1,0,0,35,16,10,9
"2011","Arun 001C","E01031392","Total",25,7,10,8,4,0,3,1,21,7,7,7
"2011","Arun 001D","E01031465","Total",20,12,6,2,3,1,1,1,17,11,5,1
"2011","Arun 002A","E01031386","Total",28,12,6,10,4,1,1,2,24,11,5,8
"2011","Arun 002B","E01031387","Total",31,18,7,6,5,2,1,2,26,16,6,4
"2011","Arun 002C","E01031425","Total",18,5,8,5,1,0,1,0,17,5,7,5
"2011","Arun 002D","E01031426","Total",21,10,7,4,2,0,2,0,19,10,5,4
"2011","Arun 003A","E01031393","Total",26,11,8,7,3,0,3,0,23,11,5,7
"2011","Arun 003B","E01031394","Total",51,23,13,15,6,2,2,2,45,21,11,13
"2011","Arun 003C","E01031395","Total",27,17,7,3,4,2,2,0,23,15,5,3
"2011","Arun 003D","E01031396","Total",29,14,5,10,2,1,0,1,27,13,5,9
"2011","Arun 003E","E01031397","Total",21,11,7,3,2,0,2,0,19,11,5,3
"2011","Arun 003F","E01031466","Total",13,6,4,3,1,0,1,0,12,6,3,3
"2011","Arun 004A","E01031427","Total",58,24,8,26,3,0,2,1,55,24,6,25
"2011","Arun 004B","E01031429","Total",85,21,13,51,4,0,1,3,81,21,12,48
"2011","Arun 004C","E01031430","Total",52,21,13,18,4,0,2,2,48,21,11,16
"2011","Arun 004D","E01031467","Total",54,16,18,20,5,0,2,3,49,16,16,17
"2011","Arun 004E","E01031468","Total",79,27,21,31,8,2,4,2,71,25,17,29
"2011","Arun 005A","E01031388","Total",74,40,15,19,5,1,4,0,69,39,11,19
"2011","Arun 005B","E01031389","Total",42,17,18,7,5,1,3,1,37,16,15,6
"2011","Arun 005C","E01031414","Total",26,14,7,5,2,0,1,1,24,14,6,4
"2011","Arun 005D","E01031415","Total",40,19,8,13,3,1,2,0,37,18,6,13
"2011","Arun 005E","E01031459","Total",65,19,20,26,6,1,3,2,59,18,17,24
"2011","Arun 006A","E01031470","Total",46,18,7,21,4,1,2,1,42,17,5,20
"2011","Arun 006B","E01031471","Total",27,17,6,4,5,1,3,1,22,16,3,3
"2011","Arun 006C","E01031472","Total",29,10,5,14,3,1,2,0,26,9,3,14
"2011","Arun 006D","E01031473","Total",35,15,7,13,2,0,1,1,33,15,6,12
"2011","Arun 007A","E01031407","Total",58,24,17,17,3,1,0,2,55,23,17,15
"2011","Arun 007B","E01031408","Total",77,29,23,25,6,0,2,4,71,29,21,21
"2011","Arun 007C","E01031410","Total",35,18,9,8,1,0,1,0,34,18,8,8
"2011","Arun 007D","E01031462","Total",52,23,12,17,2,0,2,0,50,23,10,17
"2011","Arun 007E","E01031463","Total",36,14,11,11,5,0,3,2,31,14,8,9
"2011","Arun 007F","E01031464","Total",38,16,8,14,4,1,2,1,34,15,6,13
"2011","Arun 008A","E01031412","Total",10,6,3,1,0,0,0,0,10,6,3,1
"2011","Arun 008B","E01031422","Total",13,8,4,1,1,1,0,0,12,7,4,1
"2011","Arun 008C","E01031423","Total",18,11,4,3,1,0,0,1,17,11,4,2
"2011","Arun 008D","E01031424","Total",10,3,4,3,3,0,3,0,7,3,1,3
"2011","Arun 009A","E01031398","Total",37,18,11,8,3,0,2,1,34,18,9,7
"2011","Arun 009B","E01031399","Total",30,11,12,7,7,0,7,0,23,11,5,7
"2011","Arun 009C","E01031409","Total",44,19,10,15,3,2,1,0,41,17,9,15
"2011","Arun 009D","E01031455","Total",43,22,8,13,4,1,2,1,39,21,6,12
"2011","Arun 009E","E01031461","Total",22,11,6,5,2,0,1,1,20,11,5,4
"2011","Arun 009F","E01031469","Total",47,23,4,20,1,1,0,0,46,22,4,20
"2011","Arun 010A","E01031411","Total",11,4,5,2,4,0,4,0,7,4,1,2
"2011","Arun 010B","E01031413","Total",22,5,7,10,3,0,1,2,19,5,6,8
"2011","Arun 010C","E01031457","Total",17,7,4,6,5,3,2,0,12,4,2,6
"2011","Arun 010D","E01031458","Total",8,3,2,3,2,1,1,0,6,2,1,3
"2011","Arun 010E","E01031460","Total",26,7,11,8,4,2,0,2,22,5,11,6
"2011","Arun 011A","E01031400","Total",38,14,12,12,1,0,1,0,37,14,11,12
"2011","Arun 011B","E01031428","Total",43,14,13,16,3,0,2,1,40,14,11,15
"2011","Arun 011C","E01031454","Total",94,42,21,31,11,0,7,4,83,42,14,27
"2011","Arun 011D","E01031456","Total",60,21,12,27,9,2,6,1,51,19,6,26
"2011","Arun 012A","E01031401","Total",37,19,5,13,3,2,1,0,34,17,4,13
"2011","Arun 012B","E01031402","Total",30,11,10,9,6,0,5,1,24,11,5,8
"2011","Arun 012C","E01031403","Total",48,23,12,13,5,1,3,1,43,22,9,12
"2011","Arun 012D","E01031405","Total",27,12,5,10,2,1,1,0,25,11,4,10
"2011","Arun 012E","E01031406","Total",42,19,10,13,6,0,6,0,36,19,4,13
"2011","Arun 013A","E01031417","Total",66,36,17,13,8,2,5,1,58,34,12,12
"2011","Arun 013B","E01031438","Total",57,26,22,9,7,2,5,0,50,24,17,9
"2011","Arun 013C","E01031439","Total",32,11,14,7,5,1,3,1,27,10,11,6
"2011","Arun 013D","E01031440","Total",19,8,4,7,2,0,0,2,17,8,4,5
"2011","Arun 014A","E01031404","Total",65,29,7,29,4,2,1,1,61,27,6,28
"2011","Arun 014B","E01031433","Total",48,17,8,23,7,2,1,4,41,15,7,19
"2011","Arun 014C","E01031434","Total",53,16,14,23,2,2,0,0,51,14,14,23
"2011","Arun 014D","E01031441","Total",52,18,12,22,5,0,3,2,47,18,9,20
"2011","Arun 014E","E01031442","Total",43,12,11,20,3,0,2,1,40,12,9,19
"2011","Arun 015A","E01031416","Total",11,3,7,1,2,0,2,0,9,3,5,1
"2011","Arun 015B","E01031418","Total",26,9,11,6,2,0,2,0,24,9,9,6
"2011","Arun 015C","E01031419","Total",43,19,5,19,4,1,1,2,39,18,4,17
"2011","Arun 015D","E01031420","Total",21,9,8,4,2,0,2,0,19,9,6,4
"2011","Arun 015E","E01031421","Total",41,18,15,8,6,1,4,1,35,17,11,7
"2011","Arun 016A","E01031443","Total",53,23,7,23,3,1,2,0,50,22,5,23
"2011","Arun 016B","E01031444","Total",54,21,10,23,3,0,2,1,51,21,8,22
"2011","Arun 016C","E01031450","Total",66,25,13,28,8,1,1,6,58,24,12,22
"2011","Arun 016D","E01031451","Total",51,20,13,18,10,4,2,4,41,16,11,14
"2011","Arun 016E","E01031452","Total",24,11,5,8,2,0,2,0,22,11,3,8
"2011","Arun 017A","E01031431","Total",13,4,4,5,0,0,0,0,13,4,4,5
"2011","Arun 017B","E01031432","Total",59,22,13,24,4,0,4,0,55,22,9,24
"2011","Arun 017C","E01031435","Total",31,9,13,9,2,0,1,1,29,9,12,8
"2011","Arun 017D","E01031436","Total",66,23,13,30,0,0,0,0,66,23,13,30
"2011","Arun 017E","E01031437","Total",48,12,9,27,6,2,1,3,42,10,8,24
"2011","Arun 017F","E01031453","Total",29,12,4,13,2,1,1,0,27,11,3,13
"2011","Arun 018A","E01031380","Total",20,8,6,6,2,0,2,0,18,8,4,6
"2011","Arun 018B","E01031381","Total",27,11,5,11,3,0,3,0,24,11,2,11
"2011","Arun 018C","E01031382","Total",16,10,4,2,0,0,0,0,16,10,4,2
"2011","Arun 018D","E01031383","Total",12,8,3,1,0,0,0,0,12,8,3,1
"2011","Arun 018E","E01031384","Total",23,12,4,7,0,0,0,0,23,12,4,7
"2011","Arun 019A","E01031385","Total",45,15,9,21,3,0,0,3,42,15,9,18
"2011","Arun 019B","E01031445","Total",23,12,5,6,1,1,0,0,22,11,5,6
"2011","Arun 019C","E01031446","Total",23,8,10,5,3,1,1,1,20,7,9,4
"2011","Arun 019D","E01031447","Total",23,10,7,6,3,0,3,0,20,10,4,6
"2011","Arun 019E","E01031448","Total",23,9,11,3,4,1,3,0,19,8,8,3
"2011","Arun 019F","E01031449","Total",51,18,8,25,4,0,1,3,47,18,7,22
"2011","Chichester 001A","E01031502","Total",20,10,8,2,3,0,3,0,17,10,5,2
"2011","Chichester 001B","E01031503","Total",36,17,12,7,7,2,5,0,29,15,7,7
"2011","Chichester 001C","E01031504","Total",50,20,10,20,3,1,1,1,47,19,9,19
"2011","Chichester 001D","E01031519","Total",17,6,1,10,0,0,0,0,17,6,1,10
"2011","Chichester 002A","E01031517","Total",19,9,5,5,3,0,3,0,16,9,2,5
"2011","Chichester 002B","E01031518","Total",22,10,6,6,2,1,1,0,20,9,5,6
"2011","Chichester 002C","E01031544","Total",22,13,5,4,3,0,2,1,19,13,3,3
"2011","Chichester 002D","E01031545","Total",13,7,1,5,3,0,1,2,10,7,0,3
"2011","Chichester 003A","E01031508","Total",26,13,4,9,2,0,1,1,24,13,3,8
"2011","Chichester 003B","E01031520","Total",26,8,7,11,2,0,2,0,24,8,5,11
"2011","Chichester 003C","E01031521","Total",13,5,7,1,3,0,3,0,10,5,4,1
"2011","Chichester 003D","E01031536","Total",10,6,2,2,1,0,1,0,9,6,1,2
"2011","Chichester 004A","E01031497","Total",21,13,3,5,0,0,0,0,21,13,3,5
"2011","Chichester 004C","E01031511","Total",32,18,7,7,4,0,2,2,28,18,5,5
"2011","Chichester 004D","E01031512","Total",59,28,10,21,6,1,3,2,53,27,7,19
"2011","Chichester 004F","E01032717","Total",58,27,12,19,3,0,3,0,55,27,9,19
"2011","Chichester 005A","E01031478","Total",9,4,2,3,1,0,0,1,8,4,2,2
"2011","Chichester 005B","E01031479","Total",16,6,7,3,2,1,1,0,14,5,6,3
"2011","Chichester 005C","E01031498","Total",13,4,6,3,2,0,2,0,11,4,4,3
"2011","Chichester 005D","E01031514","Total",27,12,8,7,1,0,1,0,26,12,7,7
"2011","Chichester 005E","E01031515","Total",51,21,10,20,4,0,3,1,47,21,7,19
"2011","Chichester 005F","E01031516","Total",25,14,3,8,2,1,0,1,23,13,3,7
"2011","Chichester 006A","E01031477","Total",44,22,8,14,3,1,1,1,41,21,7,13
"2011","Chichester 006B","E01031485","Total",6,2,3,1,1,0,1,0,5,2,2,1
"2011","Chichester 006C","E01031487","Total",26,12,4,10,4,2,1,1,22,10,3,9
"2011","Chichester 006D","E01031509","Total",62,25,17,20,5,0,4,1,57,25,13,19
"2011","Chichester 007A","E01031506","Total",20,6,8,6,2,0,1,1,18,6,7,5
"2011","Chichester 007B","E01031507","Total",20,10,6,4,0,0,0,0,20,10,6,4
"2011","Chichester 007C","E01031531","Total",10,7,3,0,0,0,0,0,10,7,3,0
"2011","Chichester 007D","E01031533","Total",30,7,15,8,2,0,2,0,28,7,13,8
"2011","Chichester 007E","E01031543","Total",65,31,17,17,6,0,6,0,59,31,11,17
"2011","Chichester 008A","E01031482","Total",59,23,8,28,0,0,0,0,59,23,8,28
"2011","Chichester 008B","E01031483","Total",89,37,23,29,5,1,3,1,84,36,20,28
"2011","Chichester 008C","E01031486","Total",20,6,7,7,2,0,2,0,18,6,5,7
"2011","Chichester 008D","E01031488","Total",50,21,11,18,3,1,0,2,47,20,11,16
"2011","Chichester 008E","E01031494","Total",61,21,9,31,3,1,1,1,58,20,8,30
"2011","Chichester 008F","E01031495","Total",26,9,9,8,4,3,1,0,22,6,8,8
"2011","Chichester 009A","E01031475","Total",15,6,6,3,4,0,4,0,11,6,2,3
"2011","Chichester 009B","E01031476","Total",10,2,5,3,0,0,0,0,10,2,5,3
"2011","Chichester 009C","E01031532","Total",9,2,5,2,0,0,0,0,9,2,5,2
"2011","Chichester 009D","E01031534","Total",47,18,16,13,7,1,6,0,40,17,10,13
"2011","Chichester 009E","E01031535","Total",25,11,5,9,1,0,1,0,24,11,4,9
"2011","Chichester 010A","E01031480","Total",33,15,2,16,0,0,0,0,33,15,2,16
"2011","Chichester 010B","E01031481","Total",46,19,11,16,5,2,2,1,41,17,9,15
"2011","Chichester 010C","E01031484","Total",46,23,12,11,5,0,5,0,41,23,7,11
"2011","Chichester 010D","E01031490","Total",18,8,6,4,0,0,0,0,18,8,6,4
"2011","Chichester 010E","E01031491","Total",36,19,9,8,1,0,1,0,35,19,8,8
"2011","Chichester 011A","E01031474","Total",38,17,12,9,5,2,2,1,33,15,10,8
"2011","Chichester 011B","E01031493","Total",34,11,6,17,2,1,1,0,32,10,5,17
"2011","Chichester 011C","E01031496","Total",42,16,12,14,5,1,4,0,37,15,8,14
"2011","Chichester 011D","E01031505","Total",40,22,12,6,6,1,5,0,34,21,7,6
"2011","Chichester 012A","E01031489","Total",29,15,10,4,1,1,0,0,28,14,10,4
"2011","Chichester 012B","E01031492","Total",55,28,6,21,2,0,1,1,53,28,5,20
"2011","Chichester 012C","E01031513","Total",41,18,15,8,3,1,2,0,38,17,13,8
"2011","Chichester 012D","E01031530","Total",38,18,11,9,3,0,2,1,35,18,9,8
"2011","Chichester 012E","E01031538","Total",52,17,10,25,3,1,1,1,49,16,9,24
"2011","Chichester 012F","E01031539","Total",34,14,8,12,2,0,1,1,32,14,7,11
"2011","Chichester 013A","E01031499","Total",63,37,8,18,3,0,2,1,60,37,6,17
"2011","Chichester 013B","E01031500","Total",26,8,5,13,1,0,1,0,25,8,4,13
"2011","Chichester 013C","E01031501","Total",23,4,9,10,2,0,1,1,21,4,8,9
"2011","Chichester 013D","E01031529","Total",13,5,3,5,4,1,1,2,9,4,2,3
"2011","Chichester 013E","E01031540","Total",16,9,2,5,1,0,1,0,15,9,1,5
"2011","Chichester 013F","E01031541","Total",24,12,5,7,2,1,1,0,22,11,4,7
"2011","Chichester 013G","E01031542","Total",19,6,4,9,3,1,1,1,16,5,3,8
"2011","Chichester 014A","E01031522","Total",63,22,17,24,4,0,3,1,59,22,14,23
"2011","Chichester 014B","E01031523","Total",42,18,16,8,5,0,5,0,37,18,11,8
"2011","Chichester 014C","E01031524","Total",13,8,3,2,0,0,0,0,13,8,3,2
"2011","Chichester 014D","E01031525","Total",30,11,7,12,2,1,1,0,28,10,6,12
"2011","Chichester 014E","E01031526","Total",28,13,7,8,5,2,3,0,23,11,4,8
"2011","Chichester 014F","E01031527","Total",29,13,5,11,3,1,2,0,26,12,3,11
"2011","Chichester 014G","E01031528","Total",38,22,6,10,4,1,3,0,34,21,3,10
"2011","Crawley 001A","E01031573","Total",49,16,12,21,2,1,1,0,47,15,11,21
"2011","Crawley 001B","E01031574","Total",44,19,9,16,5,2,2,1,39,17,7,15
"2011","Crawley 001C","E01031575","Total",49,17,12,20,5,0,3,2,44,17,9,18
"2011","Crawley 001D","E01031576","Total",56,20,8,28,4,0,2,2,52,20,6,26
"2011","Crawley 001E","E01031577","Total",24,11,4,9,4,4,0,0,20,7,4,9
"2011","Crawley 002A","E01031586","Total",59,22,11,26,3,2,0,1,56,20,11,25
"2011","Crawley 002B","E01031587","Total",26,10,11,5,3,1,2,0,23,9,9,5
"2011","Crawley 002C","E01031588","Total",23,7,7,9,5,1,3,1,18,6,4,8
"2011","Crawley 002D","E01031590","Total",22,7,7,8,4,1,3,0,18,6,4,8
"2011","Crawley 002E","E01031593","Total",17,5,4,8,2,0,1,1,15,5,3,7
"2011","Crawley 003A","E01031570","Total",45,16,16,13,3,0,3,0,42,16,13,13
"2011","Crawley 003B","E01031571","Total",59,16,12,31,3,0,1,2,56,16,11,29
"2011","Crawley 003C","E01031572","Total",43,16,8,19,2,0,1,1,41,16,7,18
"2011","Crawley 003D","E01031609","Total",59,20,18,21,4,0,4,0,55,20,14,21
"2011","Crawley 003E","E01031610","Total",56,22,12,22,1,0,1,0,55,22,11,22
"2011","Crawley 004A","E01031583","Total",64,25,14,25,3,1,1,1,61,24,13,24
"2011","Crawley 004B","E01031584","Total",45,17,9,19,3,0,3,0,42,17,6,19
"2011","Crawley 004C","E01031585","Total",29,10,6,13,3,0,2,1,26,10,4,12
"2011","Crawley 004D","E01031601","Total",23,10,4,9,0,0,0,0,23,10,4,9
"2011","Crawley 004F","E01032835","Total",57,15,8,34,3,0,2,1,54,15,6,33
"2011","Crawley 004G","E01032836","Total",35,10,7,18,3,0,3,0,32,10,4,18
"2011","Crawley 005A","E01031589","Total",17,7,6,4,5,1,3,1,12,6,3,3
"2011","Crawley 005B","E01031591","Total",82,35,23,24,6,1,5,0,76,34,18,24
"2011","Crawley 005C","E01031594","Total",59,23,16,20,1,0,0,1,58,23,16,19
"2011","Crawley 005D","E01031600","Total",42,20,12,10,3,1,2,0,39,19,10,10
"2011","Crawley 005E","E01031603","Total",48,23,8,17,2,1,1,0,46,22,7,17
"2011","Crawley 006A","E01031564","Total",37,13,6,18,3,2,0,1,34,11,6,17
"2011","Crawley 006B","E01031565","Total",80,33,18,29,4,1,3,0,76,32,15,29
"2011","Crawley 006C","E01031566","Total",40,16,11,13,4,0,4,0,36,16,7,13
"2011","Crawley 006D","E01031567","Total",33,14,9,10,4,0,4,0,29,14,5,10
"2011","Crawley 006E","E01031568","Total",57,19,10,28,4,0,2,2,53,19,8,26
"2011","Crawley 007A","E01031596","Total",94,25,22,47,4,2,2,0,90,23,20,47
"2011","Crawley 007B","E01031597","Total",16,6,2,8,0,0,0,0,16,6,2,8
"2011","Crawley 007C","E01031598","Total",60,19,14,27,7,1,3,3,53,18,11,24
"2011","Crawley 007D","E01031599","Total",52,23,12,17,5,3,0,2,47,20,12,15
"2011","Crawley 007E","E01031608","Total",49,17,9,23,5,0,3,2,44,17,6,21
"2011","Crawley 008A","E01031578","Total",40,17,17,6,2,0,2,0,38,17,15,6
"2011","Crawley 008B","E01031580","Total",87,26,32,29,7,1,4,2,80,25,28,27
"2011","Crawley 008C","E01031581","Total",33,13,16,4,1,0,1,0,32,13,15,4
"2011","Crawley 008D","E01031592","Total",26,13,10,3,4,0,4,0,22,13,6,3
"2011","Crawley 009A","E01031560","Total",26,5,8,13,6,0,5,1,20,5,3,12
"2011","Crawley 009B","E01031561","Total",26,10,5,11,3,2,1,0,23,8,4,11
"2011","Crawley 009C","E01031562","Total",50,19,8,23,3,3,0,0,47,16,8,23
"2011","Crawley 009D","E01031563","Total",16,3,5,8,3,0,0,3,13,3,5,5
"2011","Crawley 009E","E01031579","Total",51,18,20,13,4,1,2,1,47,17,18,12
"2011","Crawley 009F","E01031582","Total",60,31,14,15,1,0,1,0,59,31,13,15
"2011","Crawley 010A","E01031547","Total",62,20,16,26,2,0,2,0,60,20,14,26
"2011","Crawley 010B","E01031548","Total",79,21,16,42,6,0,2,4,73,21,14,38
"2011","Crawley 010C","E01031549","Total",66,18,15,33,5,1,3,1,61,17,12,32
"2011","Crawley 010D","E01031550","Total",64,26,10,28,5,0,5,0,59,26,5,28
"2011","Crawley 010E","E01031569","Total",64,24,16,24,11,0,3,8,53,24,13,16
"2011","Crawley 011A","E01031595","Total",60,23,6,31,2,0,1,1,58,23,5,30
"2011","Crawley 011B","E01031604","Total",40,9,13,18,3,0,1,2,37,9,12,16
"2011","Crawley 011C","E01031605","Total",60,24,10,26,2,1,0,1,58,23,10,25
"2011","Crawley 011D","E01031606","Total",51,22,14,15,4,0,3,1,47,22,11,14
"2011","Crawley 011E","E01031607","Total",37,20,8,9,4,3,1,0,33,17,7,9
"2011","Crawley 012A","E01031546","Total",37,11,6,20,6,0,3,3,31,11,3,17
"2011","Crawley 012B","E01031551","Total",54,14,17,23,4,1,2,1,50,13,15,22
"2011","Crawley 012C","E01031553","Total",60,23,8,29,1,1,0,0,59,22,8,29
"2011","Crawley 012D","E01031554","Total",51,12,11,28,6,0,1,5,45,12,10,23
"2011","Crawley 012E","E01031555","Total",53,20,13,20,2,1,0,1,51,19,13,19
"2011","Crawley 013A","E01031552","Total",79,21,10,48,5,0,2,3,74,21,8,45
"2011","Crawley 013B","E01031556","Total",120,45,27,48,9,2,1,6,111,43,26,42
"2011","Crawley 013C","E01031557","Total",48,19,9,20,4,2,2,0,44,17,7,20
"2011","Crawley 013D","E01031558","Total",85,26,10,49,5,0,3,2,80,26,7,47
"2011","Crawley 013E","E01031559","Total",58,10,16,32,6,1,2,3,52,9,14,29
"2011","Horsham 001A","E01031670","Total",22,10,7,5,1,0,0,1,21,10,7,4
"2011","Horsham 001B","E01031671","Total",37,11,13,13,6,1,3,2,31,10,10,11
"2011","Horsham 001C","E01031673","Total",58,22,17,19,6,2,3,1,52,20,14,18
"2011","Horsham 001D","E01031676","Total",33,12,14,7,4,0,4,0,29,12,10,7
"2011","Horsham 002A","E01031644","Total",28,16,7,5,3,1,2,0,25,15,5,5
"2011","Horsham 002B","E01031645","Total",28,11,11,6,4,0,2,2,24,11,9,4
"2011","Horsham 002C","E01031646","Total",39,17,10,12,2,0,2,0,37,17,8,12
"2011","Horsham 002D","E01031647","Total",24,7,4,13,1,0,0,1,23,7,4,12
"2011","Horsham 002E","E01031649","Total",16,5,10,1,1,0,1,0,15,5,9,1
"2011","Horsham 002F","E01031650","Total",19,6,8,5,3,0,3,0,16,6,5,5
"2011","Horsham 002G","E01031666","Total",16,7,7,2,2,0,2,0,14,7,5,2
"2011","Horsham 002H","E01031668","Total",26,13,7,6,1,0,1,0,25,13,6,6
"2011","Horsham 003A","E01031620","Total",62,18,15,29,6,0,5,1,56,18,10,28
"2011","Horsham 003B","E01031648","Total",34,15,7,12,3,1,1,1,31,14,6,11
"2011","Horsham 003C","E01031651","Total",46,21,10,15,4,0,3,1,42,21,7,14
"2011","Horsham 003D","E01031658","Total",38,16,9,13,3,0,3,0,35,16,6,13
"2011","Horsham 003E","E01031689","Total",27,13,9,5,3,1,2,0,24,12,7,5
"2011","Horsham 004A","E01031654","Total",31,13,14,4,5,1,4,0,26,12,10,4
"2011","Horsham 004B","E01031655","Total",40,11,17,12,7,1,5,1,33,10,12,11
"2011","Horsham 004C","E01031667","Total",32,17,10,5,2,0,1,1,30,17,9,4
"2011","Horsham 004D","E01031669","Total",58,19,17,22,3,1,2,0,55,18,15,22
"2011","Horsham 004E","E01031672","Total",25,12,9,4,1,0,1,0,24,12,8,4
"2011","Horsham 005A","E01031657","Total",36,19,6,11,2,1,1,0,34,18,5,11
"2011","Horsham 005B","E01031659","Total",22,5,11,6,4,0,4,0,18,5,7,6
"2011","Horsham 005C","E01031674","Total",9,8,0,1,1,0,0,1,8,8,0,0
"2011","Horsham 005D","E01031675","Total",20,6,8,6,3,0,2,1,17,6,6,5
"2011","Horsham 006A","E01031636","Total",44,15,13,16,3,0,3,0,41,15,10,16
"2011","Horsham 006B","E01031652","Total",61,25,20,16,3,0,2,1,58,25,18,15
"2011","Horsham 006C","E01031653","Total",27,11,11,5,4,0,4,0,23,11,7,5
"2011","Horsham 006D","E01031656","Total",45,20,9,16,5,1,2,2,40,19,7,14
"2011","Horsham 006E","E01031688","Total",30,11,9,10,6,1,4,1,24,10,5,9
"2011","Horsham 006F","E01031691","Total",27,11,10,6,3,1,2,0,24,10,8,6
"2011","Horsham 007A","E01031619","Total",26,12,5,9,2,0,2,0,24,12,3,9
"2011","Horsham 007B","E01031637","Total",62,22,16,24,8,1,5,2,54,21,11,22
"2011","Horsham 007C","E01031638","Total",39,13,17,9,4,0,3,1,35,13,14,8
"2011","Horsham 007D","E01031690","Total",7,3,2,2,0,0,0,0,7,3,2,2
"2011","Horsham 008A","E01031639","Total",21,5,8,8,1,0,1,0,20,5,7,8
"2011","Horsham 008B","E01031640","Total",15,8,5,2,2,0,2,0,13,8,3,2
"2011","Horsham 008C","E01031660","Total",17,8,5,4,2,0,2,0,15,8,3,4
"2011","Horsham 008D","E01031661","Total",15,6,6,3,1,0,1,0,14,6,5,3
"2011","Horsham 008E","E01031679","Total",15,5,7,3,2,0,2,0,13,5,5,3
"2011","Horsham 009A","E01031677","Total",31,9,12,10,8,0,7,1,23,9,5,9
"2011","Horsham 009B","E01031678","Total",19,7,8,4,3,0,3,0,16,7,5,4
"2011","Horsham 009C","E01031680","Total",16,7,6,3,1,0,1,0,15,7,5,3
"2011","Horsham 009D","E01031681","Total",38,18,12,8,4,1,3,0,34,17,9,8
"2011","Horsham 009E","E01031682","Total",29,13,12,4,4,0,4,0,25,13,8,4
"2011","Horsham 009F","E01031683","Total",35,18,7,10,1,0,1,0,34,18,6,10
"2011","Horsham 010A","E01031611","Total",17,7,3,7,2,1,1,0,15,6,2,7
"2011","Horsham 010B","E01031612","Total",41,16,12,13,7,0,6,1,34,16,6,12
"2011","Horsham 010C","E01031613","Total",36,19,9,8,3,0,2,1,33,19,7,7
"2011","Horsham 010D","E01031614","Total",79,33,20,26,11,1,6,4,68,32,14,22
"2011","Horsham 010E","E01031615","Total",16,8,4,4,1,0,1,0,15,8,3,4
"2011","Horsham 011A","E01031632","Total",17,3,8,6,6,0,5,1,11,3,3,5
"2011","Horsham 011B","E01031633","Total",15,4,4,7,1,0,1,0,14,4,3,7
"2011","Horsham 011C","E01031634","Total",29,12,10,7,3,0,3,0,26,12,7,7
"2011","Horsham 011D","E01031635","Total",23,13,7,3,2,0,1,1,21,13,6,2
"2011","Horsham 012A","E01031621","Total",11,4,5,2,3,0,2,1,8,4,3,1
"2011","Horsham 012B","E01031623","Total",14,6,3,5,1,0,1,0,13,6,2,5
"2011","Horsham 012C","E01031627","Total",31,19,9,3,2,0,1,1,29,19,8,2
"2011","Horsham 012D","E01031664","Total",21,7,11,3,3,1,2,0,18,6,9,3
"2011","Horsham 013A","E01031626","Total",22,11,6,5,1,0,1,0,21,11,5,5
"2011","Horsham 013B","E01031630","Total",24,10,11,3,5,0,4,1,19,10,7,2
"2011","Horsham 013C","E01031631","Total",37,14,8,15,2,1,1,0,35,13,7,15
"2011","Horsham 013D","E01031662","Total",29,16,6,7,1,0,1,0,28,16,5,7
"2011","Horsham 013E","E01031663","Total",57,25,11,21,4,0,2,2,53,25,9,19
"2011","Horsham 013F","E01031665","Total",14,2,6,6,4,0,2,2,10,2,4,4
"2011","Horsham 014A","E01031618","Total",27,12,11,4,4,2,1,1,23,10,10,3
"2011","Horsham 014B","E01031641","Total",26,9,12,5,5,0,4,1,21,9,8,4
"2011","Horsham 014C","E01031642","Total",45,17,17,11,3,0,3,0,42,17,14,11
"2011","Horsham 014D","E01031643","Total",52,19,12,21,9,1,6,2,43,18,6,19
"2011","Horsham 014E","E01031687","Total",43,26,6,11,3,0,3,0,40,26,3,11
"2011","Horsham 015A","E01031622","Total",28,20,5,3,1,1,0,0,27,19,5,3
"2011","Horsham 015B","E01031624","Total",29,13,9,7,2,0,2,0,27,13,7,7
"2011","Horsham 015C","E01031625","Total",25,12,9,4,4,1,3,0,21,11,6,4
"2011","Horsham 015D","E01031628","Total",27,13,5,9,0,0,0,0,27,13,5,9
"2011","Horsham 015E","E01031629","Total",15,6,0,9,0,0,0,0,15,6,0,9
"2011","Horsham 016A","E01031616","Total",45,21,13,11,4,1,3,0,41,20,10,11
"2011","Horsham 016B","E01031617","Total",44,17,10,17,6,0,4,2,38,17,6,15
"2011","Horsham 016C","E01031684","Total",22,7,5,10,2,0,2,0,20,7,3,10
"2011","Horsham 016D","E01031685","Total",35,15,13,7,3,0,3,0,32,15,10,7
"2011","Horsham 016E","E01031686","Total",19,10,7,2,1,0,0,1,18,10,7,1
"2011","Mid Sussex 001A","E01031731","Total",74,25,20,29,4,1,1,2,70,24,19,27
"2011","Mid Sussex 001B","E01031732","Total",62,25,21,16,3,0,2,1,59,25,19,15
"2011","Mid Sussex 001C","E01031733","Total",49,20,16,13,4,2,1,1,45,18,15,12
"2011","Mid Sussex 001D","E01031734","Total",28,14,10,4,2,0,2,0,26,14,8,4
"2011","Mid Sussex 001E","E01031741","Total",32,9,17,6,5,0,5,0,27,9,12,6
"2011","Mid Sussex 001F","E01031742","Total",33,18,12,3,2,0,2,0,31,18,10,3
"2011","Mid Sussex 001G","E01031743","Total",56,22,17,17,5,2,3,0,51,20,14,17
"2011","Mid Sussex 002A","E01031718","Total",24,12,8,4,4,0,4,0,20,12,4,4
"2011","Mid Sussex 002B","E01031719","Total",50,23,20,7,6,0,6,0,44,23,14,7
"2011","Mid Sussex 002C","E01031720","Total",22,8,9,5,6,1,5,0,16,7,4,5
"2011","Mid Sussex 002D","E01031722","Total",21,7,8,6,2,2,0,0,19,5,8,6
"2011","Mid Sussex 003A","E01031695","Total",23,12,8,3,3,1,2,0,20,11,6,3
"2011","Mid Sussex 003B","E01031696","Total",35,20,6,9,1,0,0,1,34,20,6,8
"2011","Mid Sussex 003C","E01031729","Total",22,6,10,6,3,0,3,0,19,6,7,6
"2011","Mid Sussex 003D","E01031730","Total",49,20,18,11,5,0,3,2,44,20,15,9
"2011","Mid Sussex 003E","E01031735","Total",34,16,13,5,0,0,0,0,34,16,13,5
"2011","Mid Sussex 004A","E01031736","Total",15,7,5,3,0,0,0,0,15,7,5,3
"2011","Mid Sussex 004B","E01031737","Total",44,22,13,9,4,1,2,1,40,21,11,8
"2011","Mid Sussex 004C","E01031738","Total",9,5,3,1,1,0,1,0,8,5,2,1
"2011","Mid Sussex 004D","E01031739","Total",20,11,8,1,2,0,2,0,18,11,6,1
"2011","Mid Sussex 004E","E01031740","Total",21,10,9,2,2,0,2,0,19,10,7,2
"2011","Mid Sussex 005A","E01031721","Total",30,16,8,6,5,2,2,1,25,14,6,5
"2011","Mid Sussex 005B","E01031723","Total",12,2,6,4,1,0,1,0,11,2,5,4
"2011","Mid Sussex 005C","E01031724","Total",27,11,13,3,2,0,1,1,25,11,12,2
"2011","Mid Sussex 005D","E01031725","Total",23,14,5,4,0,0,0,0,23,14,5,4
"2011","Mid Sussex 006A","E01031694","Total",29,13,8,8,2,1,1,0,27,12,7,8
"2011","Mid Sussex 006B","E01031764","Total",19,8,6,5,1,0,0,1,18,8,6,4
"2011","Mid Sussex 006C","E01031765","Total",23,11,8,4,5,1,4,0,18,10,4,4
"2011","Mid Sussex 006D","E01031766","Total",25,12,5,8,6,1,2,3,19,11,3,5
"2011","Mid Sussex 007A","E01031692","Total",49,16,11,22,9,3,3,3,40,13,8,19
"2011","Mid Sussex 007B","E01031693","Total",20,10,7,3,3,1,1,1,17,9,6,2
"2011","Mid Sussex 007C","E01031697","Total",13,6,4,3,2,0,2,0,11,6,2,3
"2011","Mid Sussex 007D","E01031727","Total",19,6,8,5,1,0,1,0,18,6,7,5
"2011","Mid Sussex 008A","E01031758","Total",17,10,4,3,0,0,0,0,17,10,4,3
"2011","Mid Sussex 008B","E01031760","Total",23,3,13,7,2,0,2,0,21,3,11,7
"2011","Mid Sussex 008C","E01031772","Total",36,9,13,14,3,0,3,0,33,9,10,14
"2011","Mid Sussex 008D","E01031773","Total",16,10,3,3,0,0,0,0,16,10,3,3
"2011","Mid Sussex 008E","E01031774","Total",9,3,4,2,2,0,1,1,7,3,3,1
"2011","Mid Sussex 008F","E01031775","Total",30,19,9,2,3,0,2,1,27,19,7,1
"2011","Mid Sussex 009A","E01031751","Total",54,16,18,20,5,1,3,1,49,15,15,19
"2011","Mid Sussex 009B","E01031759","Total",12,3,5,4,3,1,2,0,9,2,3,4
"2011","Mid Sussex 009C","E01031761","Total",21,9,3,9,1,0,0,1,20,9,3,8
"2011","Mid Sussex 009E","E01032837","Total",27,10,12,5,4,1,3,0,23,9,9,5
"2011","Mid Sussex 009F","E01032838","Total",47,21,17,9,2,0,1,1,45,21,16,8
"2011","Mid Sussex 009G","E01032839","Total",12,5,5,2,3,0,3,0,9,5,2,2
"2011","Mid Sussex 010A","E01031752","Total",51,20,9,22,2,1,1,0,49,19,8,22
"2011","Mid Sussex 010B","E01031753","Total",30,14,6,10,1,0,1,0,29,14,5,10
"2011","Mid Sussex 010C","E01031754","Total",30,11,11,8,6,0,3,3,24,11,8,5
"2011","Mid Sussex 010D","E01031755","Total",25,11,9,5,4,1,3,0,21,10,6,5
"2011","Mid Sussex 010E","E01031757","Total",45,24,7,14,1,0,0,1,44,24,7,13
"2011","Mid Sussex 011A","E01031726","Total",32,16,6,10,3,1,2,0,29,15,4,10
"2011","Mid Sussex 011B","E01031728","Total",30,7,15,8,1,0,1,0,29,7,14,8
"2011","Mid Sussex 011C","E01031749","Total",28,10,16,2,3,0,3,0,25,10,13,2
"2011","Mid Sussex 011D","E01031750","Total",46,21,10,15,1,0,1,0,45,21,9,15
"2011","Mid Sussex 011E","E01031756","Total",37,14,9,14,2,1,1,0,35,13,8,14
"2011","Mid Sussex 011F","E01031763","Total",18,9,3,6,1,1,0,0,17,8,3,6
"2011","Mid Sussex 012A","E01031699","Total",47,17,14,16,1,0,1,0,46,17,13,16
"2011","Mid Sussex 012B","E01031700","Total",41,18,20,3,8,1,7,0,33,17,13,3
"2011","Mid Sussex 012C","E01031701","Total",55,22,20,13,4,0,2,2,51,22,18,11
"2011","Mid Sussex 012D","E01031714","Total",27,13,10,4,1,0,1,0,26,13,9,4
"2011","Mid Sussex 013A","E01031704","Total",37,15,9,13,1,0,1,0,36,15,8,13
"2011","Mid Sussex 013B","E01031706","Total",26,12,10,4,3,0,2,1,23,12,8,3
"2011","Mid Sussex 013C","E01031711","Total",32,17,8,7,2,0,1,1,30,17,7,6
"2011","Mid Sussex 013D","E01031712","Total",54,23,14,17,2,1,1,0,52,22,13,17
"2011","Mid Sussex 013E","E01031713","Total",16,8,6,2,1,0,1,0,15,8,5,2
"2011","Mid Sussex 014A","E01031705","Total",42,19,10,13,2,0,1,1,40,19,9,12
"2011","Mid Sussex 014B","E01031707","Total",15,4,9,2,3,0,3,0,12,4,6,2
"2011","Mid Sussex 014C","E01031708","Total",27,9,8,10,2,1,1,0,25,8,7,10
"2011","Mid Sussex 014D","E01031709","Total",35,13,14,8,3,1,2,0,32,12,12,8
"2011","Mid Sussex 014E","E01031716","Total",56,23,13,20,2,1,1,0,54,22,12,20
"2011","Mid Sussex 014F","E01031717","Total",31,12,11,8,1,0,0,1,30,12,11,7
"2011","Mid Sussex 015A","E01031702","Total",13,8,2,3,1,1,0,0,12,7,2,3
"2011","Mid Sussex 015B","E01031703","Total",13,5,3,5,1,0,1,0,12,5,2,5
"2011","Mid Sussex 015C","E01031710","Total",22,6,15,1,3,1,2,0,19,5,13,1
"2011","Mid Sussex 015D","E01031715","Total",34,11,19,4,1,0,1,0,33,11,18,4
"2011","Mid Sussex 016A","E01031698","Total",25,6,15,4,3,0,3,0,22,6,12,4
"2011","Mid Sussex 016B","E01031767","Total",16,7,7,2,1,0,1,0,15,7,6,2
"2011","Mid Sussex 016C","E01031769","Total",46,20,18,8,3,0,3,0,43,20,15,8
"2011","Mid Sussex 016D","E01031770","Total",29,18,6,5,1,1,0,0,28,17,6,5
"2011","Mid Sussex 016E","E01031771","Total",50,19,13,18,5,0,4,1,45,19,9,17
"2011","Mid Sussex 017A","E01031744","Total",16,7,5,4,1,0,1,0,15,7,4,4
"2011","Mid Sussex 017B","E01031745","Total",38,15,16,7,1,0,1,0,37,15,15,7
"2011","Mid Sussex 017C","E01031746","Total",52,26,10,16,6,2,1,3,46,24,9,13
"2011","Mid Sussex 017D","E01031747","Total",23,14,5,4,2,2,0,0,21,12,5,4
"2011","Mid Sussex 017E","E01031748","Total",20,11,5,4,3,0,3,0,17,11,2,4
"2011","Mid Sussex 017F","E01031768","Total",19,11,6,2,0,0,0,0,19,11,6,2
"2011","Worthing 001A","E01031793","Total",15,6,3,6,2,0,2,0,13,6,1,6
"2011","Worthing 001B","E01031820","Total",12,6,4,2,2,0,2,0,10,6,2,2
"2011","Worthing 001C","E01031821","Total",29,18,8,3,2,1,1,0,27,17,7,3
"2011","Worthing 001D","E01031828","Total",13,5,4,4,2,0,2,0,11,5,2,4
"2011","Worthing 001E","E01031829","Total",19,5,8,6,2,0,2,0,17,5,6,6
"2011","Worthing 002A","E01031822","Total",31,17,9,5,6,1,5,0,25,16,4,5
"2011","Worthing 002B","E01031825","Total",23,9,10,4,4,0,4,0,19,9,6,4
"2011","Worthing 002C","E01031826","Total",40,22,4,14,3,2,1,0,37,20,3,14
"2011","Worthing 002D","E01031827","Total",42,16,11,15,4,1,1,2,38,15,10,13
"2011","Worthing 002E","E01031839","Total",57,21,21,15,8,4,4,0,49,17,17,15
"2011","Worthing 003A","E01031792","Total",34,11,5,18,3,0,1,2,31,11,4,16
"2011","Worthing 003B","E01031794","Total",21,5,9,7,4,0,3,1,17,5,6,6
"2011","Worthing 003C","E01031795","Total",55,24,10,21,3,0,1,2,52,24,9,19
"2011","Worthing 003D","E01031818","Total",84,31,19,34,8,1,5,2,76,30,14,32
"2011","Worthing 003E","E01031830","Total",79,28,18,33,8,2,3,3,71,26,15,30
"2011","Worthing 004A","E01031778","Total",28,11,5,12,2,0,1,1,26,11,4,11
"2011","Worthing 004B","E01031797","Total",24,13,7,4,4,0,3,1,20,13,4,3
"2011","Worthing 004C","E01031800","Total",40,28,11,1,2,1,0,1,38,27,11,0
"2011","Worthing 004D","E01031823","Total",13,9,2,2,0,0,0,0,13,9,2,2
"2011","Worthing 004E","E01031824","Total",23,11,8,4,3,1,2,0,20,10,6,4
"2011","Worthing 005A","E01031776","Total",47,21,12,14,4,2,2,0,43,19,10,14
"2011","Worthing 005B","E01031777","Total",48,17,18,13,4,1,2,1,44,16,16,12
"2011","Worthing 005C","E01031780","Total",33,14,7,12,0,0,0,0,33,14,7,12
"2011","Worthing 005D","E01031781","Total",52,19,14,19,0,0,0,0,52,19,14,19
"2011","Worthing 005E","E01031798","Total",26,11,5,10,3,1,2,0,23,10,3,10
"2011","Worthing 006A","E01031783","Total",45,19,4,22,4,1,0,3,41,18,4,19
"2011","Worthing 006B","E01031785","Total",52,26,11,15,5,3,1,1,47,23,10,14
"2011","Worthing 006C","E01031786","Total",51,17,12,22,4,0,2,2,47,17,10,20
"2011","Worthing 006D","E01031817","Total",58,21,12,25,7,0,3,4,51,21,9,21
"2011","Worthing 006E","E01031819","Total",75,23,14,38,6,1,3,2,69,22,11,36
"2011","Worthing 007A","E01031782","Total",29,10,8,11,6,1,2,3,23,9,6,8
"2011","Worthing 007B","E01031784","Total",65,33,8,24,5,2,2,1,60,31,6,23
"2011","Worthing 007C","E01031836","Total",66,26,23,17,6,0,4,2,60,26,19,15
"2011","Worthing 007D","E01031838","Total",37,15,10,12,7,2,4,1,30,13,6,11
"2011","Worthing 007E","E01031840","Total",33,14,10,9,4,0,4,0,29,14,6,9
"2011","Worthing 008A","E01031791","Total",101,37,10,54,9,3,1,5,92,34,9,49
"2011","Worthing 008B","E01031796","Total",66,28,11,27,5,2,1,2,61,26,10,25
"2011","Worthing 008C","E01031799","Total",69,25,20,24,3,0,2,1,66,25,18,23
"2011","Worthing 008D","E01031801","Total",86,35,23,28,9,3,5,1,77,32,18,27
"2011","Worthing 008E","E01031837","Total",61,27,15,19,7,1,5,1,54,26,10,18
"2011","Worthing 009A","E01031779","Total",84,25,16,43,5,2,1,2,79,23,15,41
"2011","Worthing 009B","E01031831","Total",36,14,9,13,3,0,2,1,33,14,7,12
"2011","Worthing 009C","E01031832","Total",22,12,5,5,2,0,2,0,20,12,3,5
"2011","Worthing 009D","E01031833","Total",59,21,11,27,6,2,3,1,53,19,8,26
"2011","Worthing 009E","E01031834","Total",43,10,18,15,5,1,3,1,38,9,15,14
"2011","Worthing 010A","E01031790","Total",56,18,14,24,9,0,5,4,47,18,9,20
"2011","Worthing 010B","E01031807","Total",23,11,6,6,6,1,3,2,17,10,3,4
"2011","Worthing 010C","E01031809","Total",31,10,11,10,5,1,3,1,26,9,8,9
"2011","Worthing 010D","E01031810","Total",60,22,15,23,6,1,5,0,54,21,10,23
"2011","Worthing 010E","E01031811","Total",20,9,6,5,5,1,3,1,15,8,3,4
"2011","Worthing 011A","E01031787","Total",65,27,18,20,7,0,7,0,58,27,11,20
"2011","Worthing 011B","E01031788","Total",107,31,37,39,11,2,6,3,96,29,31,36
"2011","Worthing 011C","E01031789","Total",53,20,13,20,7,0,5,2,46,20,8,18
"2011","Worthing 011D","E01031808","Total",42,15,3,24,6,5,0,1,36,10,3,23
"2011","Worthing 011E","E01031835","Total",45,20,10,15,7,0,4,3,38,20,6,12
"2011","Worthing 012A","E01031812","Total",23,10,11,2,2,2,0,0,21,8,11,2
"2011","Worthing 012B","E01031813","Total",44,13,7,24,3,2,0,1,41,11,7,23
"2011","Worthing 012C","E01031814","Total",28,10,12,6,2,0,1,1,26,10,11,5
"2011","Worthing 012D","E01031815","Total",20,8,9,3,2,0,2,0,18,8,7,3
"2011","Worthing 012E","E01031816","Total",41,16,12,13,5,1,4,0,36,15,8,13
"2011","Worthing 013A","E01031802","Total",16,8,4,4,2,0,1,1,14,8,3,3
"2011","Worthing 013B","E01031803","Total",15,6,5,4,1,0,1,0,14,6,4,4
"2011","Worthing 013C","E01031804","Total",21,10,9,2,4,2,2,0,17,8,7,2
"2011","Worthing 013D","E01031805","Total",20,10,4,6,2,1,1,0,18,9,3,6
"2011","Worthing 013E","E01031806","Total",62,28,13,21,4,1,2,1,58,27,11,20
"2011","Bath and North East Somerset 001A","E01014399","Total",43,20,10,13,2,0,2,0,41,20,8,13
"2011","Bath and North East Somerset 001B","E01014400","Total",30,13,10,7,4,0,2,2,26,13,8,5
"2011","Bath and North East Somerset 001C","E01014401","Total",65,22,14,29,7,2,2,3,58,20,12,26
"2011","Bath and North East Somerset 002A","E01014402","Total",62,29,9,24,5,1,4,0,57,28,5,24
"2011","Bath and North East Somerset 002B","E01014403","Total",19,9,8,2,1,0,1,0,18,9,7,2
"2011","Bath and North East Somerset 002C","E01014404","Total",85,36,14,35,6,2,2,2,79,34,12,33
"2011","Bath and North East Somerset 003A","E01014395","Total",14,7,4,3,1,0,1,0,13,7,3,3
"2011","Bath and North East Somerset 003B","E01014396","Total",53,24,19,10,3,0,3,0,50,24,16,10
"2011","Bath and North East Somerset 003C","E01014397","Total",15,5,5,5,0,0,0,0,15,5,5,5
"2011","Bath and North East Somerset 003D","E01014398","Total",36,11,17,8,7,0,5,2,29,11,12,6
"2011","Bath and North East Somerset 004A","E01014409","Total",57,28,9,20,3,1,2,0,54,27,7,20
"2011","Bath and North East Somerset 004B","E01014410","Total",59,23,21,15,9,2,6,1,50,21,15,14
"2011","Bath and North East Somerset 004C","E01014411","Total",43,18,14,11,2,0,1,1,41,18,13,10
"2011","Bath and North East Somerset 005A","E01014477","Total",20,5,11,4,1,0,1,0,19,5,10,4
"2011","Bath and North East Somerset 005B","E01014478","Total",65,25,12,28,8,3,3,2,57,22,9,26
"2011","Bath and North East Somerset 005C","E01014479","Total",18,5,8,5,4,0,3,1,14,5,5,4
"2011","Bath and North East Somerset 005D","E01014480","Total",29,8,6,15,3,0,2,1,26,8,4,14
"2011","Bath and North East Somerset 006A","E01014465","Total",52,21,19,12,5,3,1,1,47,18,18,11
"2011","Bath and North East Somerset 006B","E01014466","Total",62,30,8,24,6,3,0,3,56,27,8,21
"2011","Bath and North East Somerset 006C","E01014467","Total",26,8,9,9,4,1,2,1,22,7,7,8
"2011","Bath and North East Somerset 006D","E01014468","Total",28,13,7,8,7,1,4,2,21,12,3,6
"2011","Bath and North East Somerset 007A","E01014370","Total",22,8,5,9,3,0,1,2,19,8,4,7
"2011","Bath and North East Somerset 007B","E01014371","Total",19,7,7,5,5,1,3,1,14,6,4,4
"2011","Bath and North East Somerset 007C","E01014372","Total",25,10,7,8,6,0,4,2,19,10,3,6
"2011","Bath and North East Somerset 007D","E01014412","Total",37,11,18,8,5,0,2,3,32,11,16,5
"2011","Bath and North East Somerset 007E","E01014413","Total",30,8,13,9,2,0,2,0,28,8,11,9
"2011","Bath and North East Somerset 007F","E01014414","Total",36,10,8,18,6,0,0,6,30,10,8,12
"2011","Bath and North East Somerset 008A","E01014427","Total",36,15,7,14,2,1,0,1,34,14,7,13
"2011","Bath and North East Somerset 008B","E01014428","Total",9,5,2,2,0,0,0,0,9,5,2,2
"2011","Bath and North East Somerset 008C","E01014429","Total",44,17,15,12,2,2,0,0,42,15,15,12
"2011","Bath and North East Somerset 008D","E01014430","Total",42,19,14,9,2,1,1,0,40,18,13,9
"2011","Bath and North East Somerset 009A","E01014405","Total",24,7,12,5,2,0,2,0,22,7,10,5
"2011","Bath and North East Somerset 009C","E01014407","Total",55,11,4,40,8,0,1,7,47,11,3,33
"2011","Bath and North East Somerset 009E","E01033080","Total",35,13,10,12,3,0,2,1,32,13,8,11
"2011","Bath and North East Somerset 010A","E01014373","Total",63,35,13,15,10,1,6,3,53,34,7,12
"2011","Bath and North East Somerset 010B","E01014374","Total",27,10,10,7,2,0,2,0,25,10,8,7
"2011","Bath and North East Somerset 010C","E01014375","Total",8,4,2,2,3,1,2,0,5,3,0,2
"2011","Bath and North East Somerset 010D","E01014376","Total",12,6,4,2,1,0,1,0,11,6,3,2
"2011","Bath and North East Somerset 010E","E01014377","Total",25,9,10,6,8,2,5,1,17,7,5,5
"2011","Bath and North East Somerset 010G","E01033078","Total",33,15,13,5,3,0,3,0,30,15,10,5
"2011","Bath and North East Somerset 010H","E01033079","Total",24,5,9,10,2,0,2,0,22,5,7,10
"2011","Bath and North East Somerset 011A","E01014461","Total",48,23,6,19,4,0,3,1,44,23,3,18
"2011","Bath and North East Somerset 011B","E01014462","Total",110,40,13,57,5,1,2,2,105,39,11,55
"2011","Bath and North East Somerset 011C","E01014463","Total",75,29,8,38,11,1,1,9,64,28,7,29
"2011","Bath and North East Somerset 011D","E01014464","Total",91,30,10,51,8,0,4,4,83,30,6,47
"2011","Bath and North East Somerset 012A","E01014380","Total",16,3,10,3,4,0,4,0,12,3,6,3
"2011","Bath and North East Somerset 012B","E01014381","Total",15,3,6,6,1,0,1,0,14,3,5,6
"2011","Bath and North East Somerset 012C","E01014481","Total",15,6,4,5,0,0,0,0,15,6,4,5
"2011","Bath and North East Somerset 012D","E01014482","Total",11,4,5,2,1,1,0,0,10,3,5,2
"2011","Bath and North East Somerset 012E","E01014483","Total",37,14,12,11,3,1,2,0,34,13,10,11
"2011","Bath and North East Somerset 012F","E01014484","Total",3,0,1,2,0,0,0,0,3,0,1,2
"2011","Bath and North East Somerset 013A","E01014473","Total",17,9,5,3,2,0,1,1,15,9,4,2
"2011","Bath and North East Somerset 013B","E01014474","Total",26,9,7,10,1,0,0,1,25,9,7,9
"2011","Bath and North East Somerset 013C","E01014475","Total",17,6,7,4,4,0,3,1,13,6,4,3
"2011","Bath and North East Somerset 013D","E01014476","Total",23,11,6,6,1,0,1,0,22,11,5,6
"2011","Bath and North East Somerset 014A","E01014435","Total",12,7,3,2,1,0,0,1,11,7,3,1
"2011","Bath and North East Somerset 014B","E01014436","Total",24,7,7,10,4,0,3,1,20,7,4,9
"2011","Bath and North East Somerset 014C","E01014437","Total",62,33,7,22,4,1,0,3,58,32,7,19
"2011","Bath and North East Somerset 014D","E01014438","Total",53,25,10,18,7,0,3,4,46,25,7,14
"2011","Bath and North East Somerset 015A","E01014455","Total",38,11,5,22,2,0,1,1,36,11,4,21
"2011","Bath and North East Somerset 015B","E01014456","Total",42,22,9,11,3,0,1,2,39,22,8,9
"2011","Bath and North East Somerset 015C","E01014457","Total",23,9,9,5,1,0,1,0,22,9,8,5
"2011","Bath and North East Somerset 015D","E01014458","Total",85,25,10,50,14,3,6,5,71,22,4,45
"2011","Bath and North East Somerset 016A","E01014391","Total",15,5,2,8,1,0,0,1,14,5,2,7
"2011","Bath and North East Somerset 016B","E01014392","Total",15,5,5,5,2,0,2,0,13,5,3,5
"2011","Bath and North East Somerset 016C","E01014452","Total",17,6,9,2,7,0,5,2,10,6,4,0
"2011","Bath and North East Somerset 016D","E01014453","Total",16,9,4,3,3,0,2,1,13,9,2,2
"2011","Bath and North East Somerset 016E","E01014454","Total",11,6,3,2,1,0,1,0,10,6,2,2
"2011","Bath and North East Somerset 016F","E01014459","Total",33,11,10,12,1,1,0,0,32,10,10,12
"2011","Bath and North East Somerset 016G","E01014460","Total",10,4,5,1,3,0,3,0,7,4,2,1
"2011","Bath and North East Somerset 017A","E01014415","Total",30,10,10,10,3,1,2,0,27,9,8,10
"2011","Bath and North East Somerset 017B","E01014416","Total",34,14,13,7,2,1,1,0,32,13,12,7
"2011","Bath and North East Somerset 017C","E01014417","Total",23,11,7,5,3,1,1,1,20,10,6,4
"2011","Bath and North East Somerset 018A","E01014387","Total",31,22,2,7,0,0,0,0,31,22,2,7
"2011","Bath and North East Somerset 018B","E01014388","Total",18,8,6,4,3,0,3,0,15,8,3,4
"2011","Bath and North East Somerset 018C","E01014389","Total",33,13,9,11,2,0,0,2,31,13,9,9
"2011","Bath and North East Somerset 018D","E01014390","Total",109,40,16,53,10,1,6,3,99,39,10,50
"2011","Bath and North East Somerset 019A","E01014431","Total",35,17,5,13,1,0,1,0,34,17,4,13
"2011","Bath and North East Somerset 019B","E01014432","Total",39,7,8,24,3,0,0,3,36,7,8,21
"2011","Bath and North East Somerset 019C","E01014433","Total",79,36,13,30,4,0,2,2,75,36,11,28
"2011","Bath and North East Somerset 019D","E01014434","Total",44,16,14,14,4,0,4,0,40,16,10,14
"2011","Bath and North East Somerset 020A","E01014385","Total",31,13,7,11,3,1,1,1,28,12,6,10
"2011","Bath and North East Somerset 020B","E01014386","Total",17,11,4,2,1,0,1,0,16,11,3,2
"2011","Bath and North East Somerset 020C","E01014419","Total",26,12,6,8,2,2,0,0,24,10,6,8
"2011","Bath and North East Somerset 020D","E01014446","Total",13,7,3,3,1,0,1,0,12,7,2,3
"2011","Bath and North East Somerset 020E","E01014447","Total",10,3,3,4,1,0,1,0,9,3,2,4
"2011","Bath and North East Somerset 021A","E01014382","Total",28,16,10,2,6,1,4,1,22,15,6,1
"2011","Bath and North East Somerset 021B","E01014383","Total",15,10,3,2,0,0,0,0,15,10,3,2
"2011","Bath and North East Somerset 021C","E01014384","Total",34,17,8,9,0,0,0,0,34,17,8,9
"2011","Bath and North East Somerset 021D","E01014418","Total",23,4,9,10,3,0,3,0,20,4,6,10
"2011","Bath and North East Somerset 022A","E01014379","Total",41,20,7,14,5,3,1,1,36,17,6,13
"2011","Bath and North East Somerset 022B","E01014442","Total",44,22,12,10,4,1,3,0,40,21,9,10
"2011","Bath and North East Somerset 022C","E01014443","Total",39,19,11,9,5,1,4,0,34,18,7,9
"2011","Bath and North East Somerset 022D","E01014444","Total",28,13,11,4,4,1,2,1,24,12,9,3
"2011","Bath and North East Somerset 022E","E01014445","Total",55,20,6,29,3,0,1,2,52,20,5,27
"2011","Bath and North East Somerset 023A","E01014393","Total",19,11,6,2,2,0,1,1,17,11,5,1
"2011","Bath and North East Somerset 023B","E01014394","Total",30,13,7,10,5,2,3,0,25,11,4,10
"2011","Bath and North East Somerset 023C","E01014439","Total",37,12,7,18,4,0,1,3,33,12,6,15
"2011","Bath and North East Somerset 023D","E01014440","Total",40,16,9,15,4,2,2,0,36,14,7,15
"2011","Bath and North East Somerset 023E","E01014441","Total",33,20,3,10,1,0,0,1,32,20,3,9
"2011","Bath and North East Somerset 024A","E01014448","Total",53,17,9,27,8,1,2,5,45,16,7,22
"2011","Bath and North East Somerset 024B","E01014449","Total",61,29,9,23,3,0,2,1,58,29,7,22
"2011","Bath and North East Somerset 024C","E01014450","Total",71,24,12,35,11,1,3,7,60,23,9,28
"2011","Bath and North East Somerset 024D","E01014451","Total",42,24,6,12,3,1,2,0,39,23,4,12
"2011","Bath and North East Somerset 025A","E01014420","Total",39,18,5,16,4,1,2,1,35,17,3,15
"2011","Bath and North East Somerset 025B","E01014421","Total",31,11,10,10,5,2,3,0,26,9,7,10
"2011","Bath and North East Somerset 025C","E01014422","Total",38,18,10,10,4,0,3,1,34,18,7,9
"2011","Bath and North East Somerset 025D","E01014423","Total",46,16,12,18,3,1,1,1,43,15,11,17
"2011","Bath and North East Somerset 026A","E01014469","Total",29,11,10,8,6,1,5,0,23,10,5,8
"2011","Bath and North East Somerset 026B","E01014470","Total",60,27,17,16,2,0,2,0,58,27,15,16
"2011","Bath and North East Somerset 026C","E01014471","Total",37,14,11,12,2,0,1,1,35,14,10,11
"2011","Bath and North East Somerset 026D","E01014472","Total",53,28,14,11,4,0,4,0,49,28,10,11
"2011","Bath and North East Somerset 027A","E01014424","Total",28,12,10,6,2,0,2,0,26,12,8,6
"2011","Bath and North East Somerset 027B","E01014425","Total",53,23,14,16,5,0,4,1,48,23,10,15
"2011","Bath and North East Somerset 027C","E01014426","Total",42,15,14,13,13,1,8,4,29,14,6,9
"2011","Bournemouth 001A","E01015301","Total",28,10,9,9,4,1,2,1,24,9,7,8
"2011","Bournemouth 001B","E01015303","Total",38,14,8,16,3,0,1,2,35,14,7,14
"2011","Bournemouth 001C","E01015305","Total",65,15,13,37,5,0,2,3,60,15,11,34
"2011","Bournemouth 001D","E01015306","Total",79,26,9,44,7,3,1,3,72,23,8,41
"2011","Bournemouth 002A","E01015302","Total",63,20,11,32,11,0,5,6,52,20,6,26
"2011","Bournemouth 002B","E01015304","Total",84,34,11,39,5,0,5,0,79,34,6,39
"2011","Bournemouth 002C","E01015308","Total",80,36,13,31,4,2,1,1,76,34,12,30
"2011","Bournemouth 002D","E01015311","Total",10,2,5,3,4,0,3,1,6,2,2,2
"2011","Bournemouth 003A","E01015332","Total",31,11,11,9,2,1,1,0,29,10,10,9
"2011","Bournemouth 003B","E01015333","Total",33,15,9,9,2,0,2,0,31,15,7,9
"2011","Bournemouth 003C","E01015334","Total",44,18,11,15,1,0,0,1,43,18,11,14
"2011","Bournemouth 003D","E01015335","Total",34,13,6,15,3,0,2,1,31,13,4,14
"2011","Bournemouth 003E","E01015337","Total",50,25,11,14,5,1,3,1,45,24,8,13
"2011","Bournemouth 004A","E01015343","Total",41,14,11,16,0,0,0,0,41,14,11,16
"2011","Bournemouth 004B","E01015349","Total",47,14,13,20,6,0,5,1,41,14,8,19
"2011","Bournemouth 004C","E01015351","Total",39,16,11,12,4,0,4,0,35,16,7,12
"2011","Bournemouth 004D","E01015352","Total",50,19,14,17,2,2,0,0,48,17,14,17
"2011","Bournemouth 004E","E01015353","Total",30,11,6,13,5,1,4,0,25,10,2,13
"2011","Bournemouth 004F","E01015354","Total",52,31,10,11,1,1,0,0,51,30,10,11
"2011","Bournemouth 005A","E01015307","Total",69,24,9,36,4,1,2,1,65,23,7,35
"2011","Bournemouth 005B","E01015309","Total",96,39,13,44,13,5,2,6,83,34,11,38
"2011","Bournemouth 005C","E01015312","Total",66,28,7,31,9,3,1,5,57,25,6,26
"2011","Bournemouth 005D","E01015313","Total",63,23,8,32,10,2,2,6,53,21,6,26
"2011","Bournemouth 005E","E01015359","Total",32,9,6,17,2,0,2,0,30,9,4,17
"2011","Bournemouth 006A","E01015320","Total",34,16,8,10,6,0,2,4,28,16,6,6
"2011","Bournemouth 006B","E01015323","Total",35,12,15,8,4,0,4,0,31,12,11,8
"2011","Bournemouth 006C","E01015324","Total",50,20,13,17,9,1,6,2,41,19,7,15
"2011","Bournemouth 006D","E01015325","Total",42,26,9,7,6,1,4,1,36,25,5,6
"2011","Bournemouth 006E","E01015350","Total",13,6,4,3,3,1,2,0,10,5,2,3
"2011","Bournemouth 007A","E01015310","Total",75,20,21,34,12,0,6,6,63,20,15,28
"2011","Bournemouth 007B","E01015336","Total",38,14,8,16,1,1,0,0,37,13,8,16
"2011","Bournemouth 007C","E01015355","Total",44,16,13,15,2,0,2,0,42,16,11,15
"2011","Bournemouth 007D","E01015357","Total",52,24,10,18,2,0,0,2,50,24,10,16
"2011","Bournemouth 007E","E01015358","Total",48,23,10,15,4,0,3,1,44,23,7,14
"2011","Bournemouth 008A","E01015338","Total",73,27,14,32,5,0,1,4,68,27,13,28
"2011","Bournemouth 008B","E01015339","Total",55,17,9,29,5,1,1,3,50,16,8,26
"2011","Bournemouth 008C","E01015340","Total",22,13,2,7,1,0,0,1,21,13,2,6
"2011","Bournemouth 008D","E01015341","Total",89,32,11,46,6,1,3,2,83,31,8,44
"2011","Bournemouth 009A","E01015321","Total",37,17,5,15,5,1,0,4,32,16,5,11
"2011","Bournemouth 009B","E01015356","Total",45,19,11,15,5,1,3,1,40,18,8,14
"2011","Bournemouth 009C","E01015374","Total",71,22,7,42,4,3,0,1,67,19,7,41
"2011","Bournemouth 009D","E01015375","Total",37,13,8,16,5,0,1,4,32,13,7,12
"2011","Bournemouth 009E","E01015377","Total",42,17,8,17,5,0,1,4,37,17,7,13
"2011","Bournemouth 010A","E01015322","Total",33,13,10,10,5,0,2,3,28,13,8,7
"2011","Bournemouth 010B","E01015330","Total",41,20,14,7,5,1,2,2,36,19,12,5
"2011","Bournemouth 010C","E01015342","Total",25,11,8,6,2,0,1,1,23,11,7,5
"2011","Bournemouth 010D","E01015373","Total",54,28,10,16,4,0,3,1,50,28,7,15
"2011","Bournemouth 010E","E01015378","Total",38,16,11,11,5,1,2,2,33,15,9,9
"2011","Bournemouth 011A","E01015314","Total",21,7,9,5,2,0,2,0,19,7,7,5
"2011","Bournemouth 011B","E01015315","Total",14,5,7,2,3,0,2,1,11,5,5,1
"2011","Bournemouth 011C","E01015318","Total",44,19,14,11,2,1,1,0,42,18,13,11
"2011","Bournemouth 011D","E01015319","Total",29,12,10,7,3,1,2,0,26,11,8,7
"2011","Bournemouth 012A","E01015344","Total",16,5,6,5,5,0,5,0,11,5,1,5
"2011","Bournemouth 012B","E01015346","Total",31,10,9,12,6,1,5,0,25,9,4,12
"2011","Bournemouth 012C","E01015348","Total",15,6,2,7,2,0,2,0,13,6,0,7
"2011","Bournemouth 012D","E01015360","Total",34,14,11,9,2,0,1,1,32,14,10,8
"2011","Bournemouth 013A","E01015326","Total",38,13,7,18,10,0,3,7,28,13,4,11
"2011","Bournemouth 013B","E01015331","Total",73,23,18,32,10,1,5,4,63,22,13,28
"2011","Bournemouth 013C","E01015345","Total",33,15,10,8,6,0,6,0,27,15,4,8
"2011","Bournemouth 013D","E01015376","Total",41,10,15,16,5,1,3,1,36,9,12,15
"2011","Bournemouth 014A","E01015316","Total",22,14,4,4,3,0,2,1,19,14,2,3
"2011","Bournemouth 014B","E01015317","Total",49,16,17,16,4,1,3,0,45,15,14,16
"2011","Bournemouth 014C","E01015361","Total",46,21,5,20,4,0,1,3,42,21,4,17
"2011","Bournemouth 014D","E01015362","Total",50,18,7,25,6,0,1,5,44,18,6,20
"2011","Bournemouth 014E","E01015363","Total",50,30,13,7,4,2,2,0,46,28,11,7
"2011","Bournemouth 015A","E01015292","Total",64,28,10,26,10,2,5,3,54,26,5,23
"2011","Bournemouth 015B","E01015293","Total",75,35,11,29,2,1,0,1,73,34,11,28
"2011","Bournemouth 015C","E01015294","Total",97,34,16,47,8,3,3,2,89,31,13,45
"2011","Bournemouth 015D","E01015327","Total",62,23,8,31,3,0,2,1,59,23,6,30
"2011","Bournemouth 015E","E01015329","Total",35,12,13,10,7,0,5,2,28,12,8,8
"2011","Bournemouth 016A","E01015272","Total",30,11,10,9,4,1,2,1,26,10,8,8
"2011","Bournemouth 016B","E01015273","Total",93,38,15,40,11,4,4,3,82,34,11,37
"2011","Bournemouth 016C","E01015275","Total",39,18,6,15,1,0,1,0,38,18,5,15
"2011","Bournemouth 016D","E01015276","Total",56,19,11,26,3,1,2,0,53,18,9,26
"2011","Bournemouth 016E","E01015277","Total",59,23,13,23,5,1,2,2,54,22,11,21
"2011","Bournemouth 017A","E01015283","Total",22,9,6,7,0,0,0,0,22,9,6,7
"2011","Bournemouth 017C","E01015286","Total",34,17,5,12,7,2,2,3,27,15,3,9
"2011","Bournemouth 017D","E01015287","Total",14,3,4,7,0,0,0,0,14,3,4,7
"2011","Bournemouth 017E","E01015328","Total",29,9,4,16,3,0,1,2,26,9,3,14
"2011","Bournemouth 017F","E01033242","Total",17,9,6,2,1,0,1,0,16,9,5,2
"2011","Bournemouth 017G","E01033285","Total",22,5,6,11,1,0,1,0,21,5,5,11
"2011","Bournemouth 018A","E01015274","Total",56,21,10,25,3,0,2,1,53,21,8,24
"2011","Bournemouth 018B","E01015297","Total",30,15,8,7,4,0,3,1,26,15,5,6
"2011","Bournemouth 018C","E01015364","Total",27,7,5,15,3,0,0,3,24,7,5,12
"2011","Bournemouth 018D","E01015365","Total",62,27,15,20,7,1,5,1,55,26,10,19
"2011","Bournemouth 018E","E01015366","Total",22,10,8,4,1,0,1,0,21,10,7,4
"2011","Bournemouth 019B","E01015279","Total",57,23,8,26,7,2,2,3,50,21,6,23
"2011","Bournemouth 019C","E01015280","Total",68,21,10,37,10,2,2,6,58,19,8,31
"2011","Bournemouth 019D","E01015281","Total",93,30,18,45,8,3,1,4,85,27,17,41
"2011","Bournemouth 019E","E01015282","Total",58,16,15,27,15,5,4,6,43,11,11,21
"2011","Bournemouth 019F","E01033241","Total",23,5,7,11,4,0,4,0,19,5,3,11
"2011","Bournemouth 019G","E01033283","Total",14,8,3,3,2,0,1,1,12,8,2,2
"2011","Bournemouth 020A","E01015295","Total",14,5,5,4,3,0,3,0,11,5,2,4
"2011","Bournemouth 020B","E01015296","Total",44,16,11,17,8,0,5,3,36,16,6,14
"2011","Bournemouth 020C","E01015298","Total",15,8,4,3,3,2,0,1,12,6,4,2
"2011","Bournemouth 020D","E01015299","Total",44,23,11,10,4,2,1,1,40,21,10,9
"2011","Bournemouth 020E","E01015300","Total",22,13,2,7,0,0,0,0,22,13,2,7
"2011","Bournemouth 021A","E01015285","Total",39,9,7,23,5,2,3,0,34,7,4,23
"2011","Bournemouth 021B","E01015288","Total",76,25,12,39,5,0,2,3,71,25,10,36
"2011","Bournemouth 021C","E01015289","Total",26,6,7,13,3,0,2,1,23,6,5,12
"2011","Bournemouth 021D","E01015290","Total",32,11,6,15,4,2,1,1,28,9,5,14
"2011","Bournemouth 021E","E01015291","Total",20,3,4,13,1,0,0,1,19,3,4,12
"2011","Bournemouth 023A","E01015371","Total",27,6,6,15,3,0,0,3,24,6,6,12
"2011","Bournemouth 023B","E01015372","Total",23,10,8,5,1,0,1,0,22,10,7,5
"2011","Bournemouth 023C","E01033286","Total",17,7,5,5,0,0,0,0,17,7,5,5
"2011","Bournemouth 023D","E01033288","Total",11,8,2,1,0,0,0,0,11,8,2,1
"2011","Bournemouth 024A","E01015367","Total",26,5,7,14,2,0,1,1,24,5,6,13
"2011","Bournemouth 024B","E01015368","Total",15,5,6,4,3,0,1,2,12,5,5,2
"2011","Bournemouth 024C","E01015369","Total",25,6,10,9,3,0,3,0,22,6,7,9
"2011","Bournemouth 024D","E01015370","Total",21,7,6,8,2,1,1,0,19,6,5,8
"2011","Bristol 001A","E01014601","Total",54,14,5,35,4,0,2,2,50,14,3,33
"2011","Bristol 001B","E01014602","Total",136,50,22,64,9,1,4,4,127,49,18,60
"2011","Bristol 001C","E01014603","Total",78,30,11,37,2,1,1,0,76,29,10,37
"2011","Bristol 001E","E01014605","Total",109,31,12,66,10,2,4,4,99,29,8,62
"2011","Bristol 001G","E01032516","Total",68,21,11,36,2,1,1,0,66,20,10,36
"2011","Bristol 001H","E01032517","Total",84,34,13,37,6,1,2,3,78,33,11,34
"2011","Bristol 002A","E01014688","Total",110,35,16,59,10,0,4,6,100,35,12,53
"2011","Bristol 002B","E01014689","Total",111,40,12,59,7,1,2,4,104,39,10,55
"2011","Bristol 002C","E01014690","Total",82,21,14,47,2,0,1,1,80,21,13,46
"2011","Bristol 002D","E01014691","Total",76,28,9,39,1,0,1,0,75,28,8,39
"2011","Bristol 002E","E01014692","Total",84,25,19,40,9,2,3,4,75,23,16,36
"2011","Bristol 002F","E01014693","Total",32,19,7,6,2,2,0,0,30,17,7,6
"2011","Bristol 002G","E01014694","Total",57,21,11,25,10,5,2,3,47,16,9,22
"2011","Bristol 003A","E01014497","Total",86,24,16,46,10,1,4,5,76,23,12,41
"2011","Bristol 003B","E01014498","Total",110,39,11,60,9,2,4,3,101,37,7,57
"2011","Bristol 003C","E01014638","Total",97,30,16,51,4,1,1,2,93,29,15,49
"2011","Bristol 003D","E01014639","Total",143,44,16,83,12,2,5,5,131,42,11,78
"2011","Bristol 003E","E01014640","Total",71,16,12,43,12,3,4,5,59,13,8,38
"2011","Bristol 004A","E01014631","Total",29,10,11,8,5,0,4,1,24,10,7,7
"2011","Bristol 004B","E01014632","Total",46,12,11,23,6,2,1,3,40,10,10,20
"2011","Bristol 004C","E01014633","Total",58,19,11,28,9,0,5,4,49,19,6,24
"2011","Bristol 004D","E01014636","Total",104,30,16,58,11,1,6,4,93,29,10,54
"2011","Bristol 005A","E01014630","Total",110,40,20,50,6,0,5,1,104,40,15,49
"2011","Bristol 005B","E01014634","Total",22,5,7,10,2,0,2,0,20,5,5,10
"2011","Bristol 005C","E01014659","Total",134,32,27,75,10,2,2,6,124,30,25,69
"2011","Bristol 005D","E01014661","Total",81,30,11,40,7,0,4,3,74,30,7,37
"2011","Bristol 006A","E01014616","Total",9,3,3,3,0,0,0,0,9,3,3,3
"2011","Bristol 006B","E01014719","Total",20,10,5,5,4,2,1,1,16,8,4,4
"2011","Bristol 006C","E01014720","Total",48,24,9,15,4,0,2,2,44,24,7,13
"2011","Bristol 006D","E01014721","Total",19,7,9,3,1,0,1,0,18,7,8,3
"2011","Bristol 007A","E01014641","Total",36,17,7,12,5,1,2,2,31,16,5,10
"2011","Bristol 007B","E01014642","Total",45,16,9,20,5,0,3,2,40,16,6,18
"2011","Bristol 007C","E01014643","Total",60,31,10,19,9,3,4,2,51,28,6,17
"2011","Bristol 007D","E01014644","Total",58,25,11,22,4,1,2,1,54,24,9,21
"2011","Bristol 008A","E01014492","Total",63,23,8,32,5,1,0,4,58,22,8,28
"2011","Bristol 008B","E01014493","Total",52,15,10,27,7,0,3,4,45,15,7,23
"2011","Bristol 008C","E01014494","Total",26,13,5,8,3,2,0,1,23,11,5,7
"2011","Bristol 008D","E01014495","Total",47,27,8,12,2,0,1,1,45,27,7,11
"2011","Bristol 008E","E01014496","Total",53,23,12,18,4,2,2,0,49,21,10,18
"2011","Bristol 008F","E01014499","Total",68,27,11,30,4,1,3,0,64,26,8,30
"2011","Bristol 009A","E01014715","Total",12,7,4,1,0,0,0,0,12,7,4,1
"2011","Bristol 009B","E01014716","Total",14,7,5,2,0,0,0,0,14,7,5,2
"2011","Bristol 009C","E01014717","Total",12,8,3,1,2,0,1,1,10,8,2,0
"2011","Bristol 009D","E01014718","Total",18,8,8,2,1,0,1,0,17,8,7,2
"2011","Bristol 010A","E01014510","Total",61,25,21,15,6,2,3,1,55,23,18,14
"2011","Bristol 010B","E01014635","Total",50,15,15,20,4,2,2,0,46,13,13,20
"2011","Bristol 010C","E01014637","Total",17,3,9,5,0,0,0,0,17,3,9,5
"2011","Bristol 010D","E01014662","Total",48,10,17,21,10,0,6,4,38,10,11,17
"2011","Bristol 011A","E01014615","Total",20,8,7,5,4,1,3,0,16,7,4,5
"2011","Bristol 011B","E01014617","Total",19,7,11,1,4,0,4,0,15,7,7,1
"2011","Bristol 011C","E01014618","Total",16,4,7,5,1,0,1,0,15,4,6,5
"2011","Bristol 011D","E01014620","Total",19,2,13,4,3,0,3,0,16,2,10,4
"2011","Bristol 012A","E01014571","Total",57,19,12,26,9,1,4,4,48,18,8,22
"2011","Bristol 012B","E01014577","Total",35,10,9,16,6,3,2,1,29,7,7,15
"2011","Bristol 012C","E01014586","Total",47,11,18,18,7,0,6,1,40,11,12,17
"2011","Bristol 012D","E01014587","Total",51,14,15,22,9,0,8,1,42,14,7,21
"2011","Bristol 013A","E01014588","Total",42,11,8,23,8,0,3,5,34,11,5,18
"2011","Bristol 013B","E01014589","Total",116,33,8,75,7,1,0,6,109,32,8,69
"2011","Bristol 013C","E01014590","Total",50,18,4,28,7,0,3,4,43,18,1,24
"2011","Bristol 013D","E01014591","Total",30,14,7,9,3,1,1,1,27,13,6,8
"2011","Bristol 013E","E01014592","Total",49,19,13,17,3,0,2,1,46,19,11,16
"2011","Bristol 014A","E01014660","Total",71,23,15,33,2,0,0,2,69,23,15,31
"2011","Bristol 014B","E01014663","Total",85,24,13,48,10,2,2,6,75,22,11,42
"2011","Bristol 014C","E01014664","Total",57,13,13,31,6,1,2,3,51,12,11,28
"2011","Bristol 014D","E01014665","Total",104,31,31,42,3,0,2,1,101,31,29,41
"2011","Bristol 015A","E01014709","Total",13,4,6,3,2,0,2,0,11,4,4,3
"2011","Bristol 015B","E01014710","Total",13,3,8,2,5,3,2,0,8,0,6,2
"2011","Bristol 015C","E01014711","Total",23,9,9,5,2,0,2,0,21,9,7,5
"2011","Bristol 015D","E01014712","Total",29,11,6,12,5,1,2,2,24,10,4,10
"2011","Bristol 015E","E01014713","Total",14,5,6,3,1,1,0,0,13,4,6,3
"2011","Bristol 015F","E01014714","Total",16,7,6,3,1,0,1,0,15,7,5,3
"2011","Bristol 016A","E01014507","Total",22,5,7,10,0,0,0,0,22,5,7,10
"2011","Bristol 016B","E01014508","Total",31,10,12,9,2,1,1,0,29,9,11,9
"2011","Bristol 016C","E01014509","Total",36,12,13,11,3,1,1,1,33,11,12,10
"2011","Bristol 016D","E01014511","Total",21,8,12,1,4,1,2,1,17,7,10,0
"2011","Bristol 016E","E01014512","Total",15,6,4,5,2,1,1,0,13,5,3,5
"2011","Bristol 016F","E01014513","Total",29,9,19,1,6,3,3,0,23,6,16,1
"2011","Bristol 016G","E01014514","Total",39,17,14,8,4,0,3,1,35,17,11,7
"2011","Bristol 017A","E01014619","Total",21,6,13,2,6,0,6,0,15,6,7,2
"2011","Bristol 017B","E01014621","Total",32,5,14,13,3,1,2,0,29,4,12,13
"2011","Bristol 017C","E01014666","Total",24,5,10,9,4,0,4,0,20,5,6,9
"2011","Bristol 017D","E01014667","Total",33,8,15,10,6,0,6,0,27,8,9,10
"2011","Bristol 017E","E01014672","Total",28,9,9,10,4,0,4,0,24,9,5,10
"2011","Bristol 018A","E01014624","Total",91,28,18,45,8,0,4,4,83,28,14,41
"2011","Bristol 018D","E01014629","Total",82,16,12,54,10,1,3,6,72,15,9,48
"2011","Bristol 018E","E01032518","Total",99,36,13,50,1,0,1,0,98,36,12,50
"2011","Bristol 018F","E01032519","Total",38,15,13,10,0,0,0,0,38,15,13,10
"2011","Bristol 019A","E01014572","Total",49,11,10,28,7,1,3,3,42,10,7,25
"2011","Bristol 019B","E01014573","Total",39,16,15,8,3,0,2,1,36,16,13,7
"2011","Bristol 019C","E01014575","Total",66,16,23,27,11,2,5,4,55,14,18,23
"2011","Bristol 019D","E01014576","Total",85,25,23,37,3,1,0,2,82,24,23,35
"2011","Bristol 020A","E01014487","Total",19,6,5,8,5,0,4,1,14,6,1,7
"2011","Bristol 020B","E01014491","Total",41,15,14,12,6,1,4,1,35,14,10,11
"2011","Bristol 020C","E01014668","Total",26,9,13,4,4,0,3,1,22,9,10,3
"2011","Bristol 020D","E01014669","Total",28,5,15,8,7,0,6,1,21,5,9,7
"2011","Bristol 020E","E01014670","Total",16,5,8,3,2,0,1,1,14,5,7,2
"2011","Bristol 020F","E01014671","Total",20,8,3,9,3,0,1,2,17,8,2,7
"2011","Bristol 021A","E01014622","Total",51,16,12,23,4,0,2,2,47,16,10,21
"2011","Bristol 021B","E01014623","Total",54,19,10,25,7,3,3,1,47,16,7,24
"2011","Bristol 021C","E01014626","Total",101,25,25,51,13,2,3,8,88,23,22,43
"2011","Bristol 021D","E01014627","Total",91,28,30,33,20,0,19,1,71,28,11,32
"2011","Bristol 022A","E01014557","Total",12,6,3,3,2,0,1,1,10,6,2,2
"2011","Bristol 022B","E01014558","Total",9,1,4,4,0,0,0,0,9,1,4,4
"2011","Bristol 022C","E01014559","Total",13,1,8,4,0,0,0,0,13,1,8,4
"2011","Bristol 022D","E01014560","Total",24,7,9,8,0,0,0,0,24,7,9,8
"2011","Bristol 022E","E01014562","Total",21,8,10,3,7,2,4,1,14,6,6,2
"2011","Bristol 023A","E01014485","Total",86,35,22,29,3,1,2,0,83,34,20,29
"2011","Bristol 023B","E01014486","Total",153,44,31,78,16,5,7,4,137,39,24,74
"2011","Bristol 023C","E01014488","Total",62,18,15,29,13,0,2,11,49,18,13,18
"2011","Bristol 023D","E01014489","Total",94,29,25,40,16,2,4,10,78,27,21,30
"2011","Bristol 023F","E01033347","Total",54,14,5,35,4,1,2,1,50,13,3,34
"2011","Bristol 023G","E01033348","Total",76,24,9,43,14,6,3,5,62,18,6,38
"2011","Bristol 023H","E01033366","Total",144,41,17,86,15,3,5,7,129,38,12,79
"2011","Bristol 025A","E01014539","Total",19,7,9,3,2,0,2,0,17,7,7,3
"2011","Bristol 025C","E01014561","Total",21,8,9,4,4,1,3,0,17,7,6,4
"2011","Bristol 025D","E01014563","Total",27,6,5,16,5,0,3,2,22,6,2,14
"2011","Bristol 025E","E01033342","Total",23,9,8,6,5,2,2,1,18,7,6,5
"2011","Bristol 025F","E01033367","Total",46,13,5,28,6,1,1,4,40,12,4,24
"2011","Bristol 026A","E01014551","Total",20,4,10,6,3,1,2,0,17,3,8,6
"2011","Bristol 026B","E01014552","Total",18,6,7,5,1,0,0,1,17,6,7,4
"2011","Bristol 026C","E01014553","Total",15,5,10,0,3,1,2,0,12,4,8,0
"2011","Bristol 026D","E01014554","Total",8,2,3,3,0,0,0,0,8,2,3,3
"2011","Bristol 026E","E01014556","Total",18,4,9,5,3,1,0,2,15,3,9,3
"2011","Bristol 027A","E01014673","Total",78,36,11,31,6,2,2,2,72,34,9,29
"2011","Bristol 027B","E01014674","Total",49,14,11,24,5,1,3,1,44,13,8,23
"2011","Bristol 027C","E01014675","Total",49,21,11,17,7,1,3,3,42,20,8,14
"2011","Bristol 027D","E01014676","Total",52,23,12,17,4,2,2,0,48,21,10,17
"2011","Bristol 028A","E01014682","Total",48,17,9,22,6,0,2,4,42,17,7,18
"2011","Bristol 028B","E01014683","Total",66,23,16,27,6,2,1,3,60,21,15,24
"2011","Bristol 028C","E01014685","Total",87,22,15,50,11,2,3,6,76,20,12,44
"2011","Bristol 028D","E01014686","Total",77,16,15,46,4,0,3,1,73,16,12,45
"2011","Bristol 028E","E01014687","Total",62,22,15,25,7,1,4,2,55,21,11,23
"2011","Bristol 029A","E01014565","Total",84,23,18,43,13,1,2,10,71,22,16,33
"2011","Bristol 029B","E01014566","Total",71,32,12,27,10,1,1,8,61,31,11,19
"2011","Bristol 029C","E01014567","Total",86,24,19,43,13,3,7,3,73,21,12,40
"2011","Bristol 029D","E01014681","Total",113,38,18,57,8,0,4,4,105,38,14,53
"2011","Bristol 029E","E01014684","Total",69,19,16,34,11,2,2,7,58,17,14,27
"2011","Bristol 030A","E01014544","Total",21,8,7,6,2,0,2,0,19,8,5,6
"2011","Bristol 030B","E01014545","Total",9,3,4,2,2,0,2,0,7,3,2,2
"2011","Bristol 030C","E01014546","Total",21,6,5,10,6,0,4,2,15,6,1,8
"2011","Bristol 030D","E01014547","Total",15,3,8,4,2,1,1,0,13,2,7,4
"2011","Bristol 032A","E01014538","Total",8,1,5,2,1,0,1,0,7,1,4,2
"2011","Bristol 032B","E01014540","Total",52,9,17,26,6,1,5,0,46,8,12,26
"2011","Bristol 032C","E01014542","Total",12,3,5,4,3,0,2,1,9,3,3,3
"2011","Bristol 032E","E01033344","Total",26,10,2,14,0,0,0,0,26,10,2,14
"2011","Bristol 032F","E01033345","Total",4,0,2,2,2,0,2,0,2,0,0,2
"2011","Bristol 032G","E01033350","Total",8,2,1,5,1,1,0,0,7,1,1,5
"2011","Bristol 033A","E01014677","Total",24,13,4,7,3,2,0,1,21,11,4,6
"2011","Bristol 033B","E01014678","Total",49,18,12,19,3,2,1,0,46,16,11,19
"2011","Bristol 033C","E01014679","Total",48,20,14,14,3,0,3,0,45,20,11,14
"2011","Bristol 033D","E01014680","Total",31,19,5,7,2,2,0,0,29,17,5,7
"2011","Bristol 034A","E01014548","Total",39,16,12,11,9,2,4,3,30,14,8,8
"2011","Bristol 034B","E01014549","Total",21,12,4,5,3,2,0,1,18,10,4,4
"2011","Bristol 034C","E01014550","Total",25,11,6,8,9,2,5,2,16,9,1,6
"2011","Bristol 034D","E01014555","Total",13,8,1,4,1,1,0,0,12,7,1,4
"2011","Bristol 035A","E01014528","Total",32,11,11,10,5,0,5,0,27,11,6,10
"2011","Bristol 035B","E01014529","Total",71,27,7,37,4,1,1,2,67,26,6,35
"2011","Bristol 035C","E01014530","Total",38,19,8,11,2,0,2,0,36,19,6,11
"2011","Bristol 035D","E01014531","Total",46,20,11,15,7,5,2,0,39,15,9,15
"2011","Bristol 035E","E01014532","Total",44,20,10,14,3,1,2,0,41,19,8,14
"2011","Bristol 035F","E01014537","Total",64,19,19,26,8,2,6,0,56,17,13,26
"2011","Bristol 036A","E01014695","Total",53,18,11,24,1,0,1,0,52,18,10,24
"2011","Bristol 036B","E01014696","Total",33,9,9,15,5,1,4,0,28,8,5,15
"2011","Bristol 036C","E01014698","Total",38,13,9,16,4,0,4,0,34,13,5,16
"2011","Bristol 036D","E01014699","Total",59,22,8,29,6,2,1,3,53,20,7,26
"2011","Bristol 036E","E01014700","Total",26,11,10,5,2,0,2,0,24,11,8,5
"2011","Bristol 036F","E01014701","Total",26,16,5,5,5,3,1,1,21,13,4,4
"2011","Bristol 037A","E01014730","Total",60,21,19,20,12,4,7,1,48,17,12,19
"2011","Bristol 037B","E01014731","Total",48,18,11,19,2,1,1,0,46,17,10,19
"2011","Bristol 037C","E01014732","Total",68,27,12,29,3,1,1,1,65,26,11,28
"2011","Bristol 037D","E01014735","Total",36,19,7,10,5,3,1,1,31,16,6,9
"2011","Bristol 038A","E01014523","Total",35,17,10,8,4,0,3,1,31,17,7,7
"2011","Bristol 038B","E01014524","Total",38,17,8,13,2,0,2,0,36,17,6,13
"2011","Bristol 038C","E01014525","Total",51,13,18,20,2,1,0,1,49,12,18,19
"2011","Bristol 038D","E01014526","Total",90,24,12,54,12,1,4,7,78,23,8,47
"2011","Bristol 038E","E01014527","Total",36,8,11,17,6,0,3,3,30,8,8,14
"2011","Bristol 039A","E01014500","Total",42,12,13,17,4,0,4,0,38,12,9,17
"2011","Bristol 039B","E01014502","Total",53,14,8,31,4,0,0,4,49,14,8,27
"2011","Bristol 039E","E01033359","Total",36,10,10,16,5,0,1,4,31,10,9,12
"2011","Bristol 039F","E01033361","Total",26,3,10,13,2,1,1,0,24,2,9,13
"2011","Bristol 039G","E01033362","Total",24,6,7,11,1,0,1,0,23,6,6,11
"2011","Bristol 039H","E01033364","Total",30,9,11,10,4,2,2,0,26,7,9,10
"2011","Bristol 040A","E01014729","Total",83,19,10,54,6,0,3,3,77,19,7,51
"2011","Bristol 040B","E01014733","Total",66,22,15,29,4,2,2,0,62,20,13,29
"2011","Bristol 040C","E01014734","Total",43,18,11,14,0,0,0,0,43,18,11,14
"2011","Bristol 040D","E01014736","Total",60,26,8,26,2,1,0,1,58,25,8,25
"2011","Bristol 041A","E01014501","Total",43,21,7,15,3,1,2,0,40,20,5,15
"2011","Bristol 041B","E01014504","Total",29,17,0,12,0,0,0,0,29,17,0,12
"2011","Bristol 041C","E01014505","Total",46,19,21,6,5,2,2,1,41,17,19,5
"2011","Bristol 041D","E01014506","Total",31,17,8,6,5,0,5,0,26,17,3,6
"2011","Bristol 042A","E01014645","Total",45,21,6,18,2,0,2,0,43,21,4,18
"2011","Bristol 042B","E01014646","Total",36,12,13,11,8,0,7,1,28,12,6,10
"2011","Bristol 042C","E01014648","Total",38,10,18,10,7,1,4,2,31,9,14,8
"2011","Bristol 042D","E01014649","Total",30,9,10,11,6,2,3,1,24,7,7,10
"2011","Bristol 042E","E01014651","Total",31,14,7,10,1,0,1,0,30,14,6,10
"2011","Bristol 043A","E01014533","Total",18,9,5,4,4,1,2,1,14,8,3,3
"2011","Bristol 043B","E01014534","Total",44,11,18,15,5,2,3,0,39,9,15,15
"2011","Bristol 043C","E01014535","Total",47,13,16,18,3,0,1,2,44,13,15,16
"2011","Bristol 043D","E01014536","Total",52,22,6,24,2,0,1,1,50,22,5,23
"2011","Bristol 044A","E01014578","Total",79,20,16,43,11,0,6,5,68,20,10,38
"2011","Bristol 044B","E01014583","Total",86,34,8,44,5,2,1,2,81,32,7,42
"2011","Bristol 044C","E01014585","Total",164,47,21,96,13,0,2,11,151,47,19,85
"2011","Bristol 044D","E01014647","Total",68,26,9,33,7,0,4,3,61,26,5,30
"2011","Bristol 044E","E01014650","Total",47,22,8,17,3,1,1,1,44,21,7,16
"2011","Bristol 045A","E01014579","Total",74,26,6,42,3,0,1,2,71,26,5,40
"2011","Bristol 045B","E01014580","Total",92,28,9,55,1,0,0,1,91,28,9,54
"2011","Bristol 045C","E01014581","Total",115,31,9,75,12,2,2,8,103,29,7,67
"2011","Bristol 045D","E01014582","Total",74,20,9,45,2,0,0,2,72,20,9,43
"2011","Bristol 045E","E01014584","Total",83,27,16,40,10,2,5,3,73,25,11,37
"2011","Bristol 046A","E01014518","Total",58,16,12,30,5,1,2,2,53,15,10,28
"2011","Bristol 046B","E01014519","Total",42,20,5,17,1,0,1,0,41,20,4,17
"2011","Bristol 046C","E01014520","Total",21,10,4,7,5,1,1,3,16,9,3,4
"2011","Bristol 046D","E01014521","Total",43,15,14,14,1,0,1,0,42,15,13,14
"2011","Bristol 047A","E01014607","Total",39,18,3,18,3,0,1,2,36,18,2,16
"2011","Bristol 047B","E01014608","Total",110,42,16,52,9,0,5,4,101,42,11,48
"2011","Bristol 047C","E01014609","Total",84,29,13,42,10,6,2,2,74,23,11,40
"2011","Bristol 047D","E01014610","Total",78,25,11,42,5,1,0,4,73,24,11,38
"2011","Bristol 047E","E01014613","Total",48,19,7,22,3,0,2,1,45,19,5,21
"2011","Bristol 047F","E01014614","Total",21,10,10,1,4,0,4,0,17,10,6,1
"2011","Bristol 048A","E01014594","Total",130,32,13,85,3,1,0,2,127,31,13,83
"2011","Bristol 048B","E01014598","Total",25,10,3,12,1,1,0,0,24,9,3,12
"2011","Bristol 048C","E01014599","Total",30,15,4,11,1,1,0,0,29,14,4,11
"2011","Bristol 048D","E01014600","Total",56,19,6,31,6,0,2,4,50,19,4,27
"2011","Bristol 049A","E01014702","Total",42,13,15,14,3,0,3,0,39,13,12,14
"2011","Bristol 049B","E01014703","Total",72,32,9,31,5,0,2,3,67,32,7,28
"2011","Bristol 049C","E01014704","Total",76,21,10,45,10,0,3,7,66,21,7,38
"2011","Bristol 049D","E01014705","Total",21,6,6,9,7,1,5,1,14,5,1,8
"2011","Bristol 049E","E01014706","Total",47,14,5,28,1,0,1,0,46,14,4,28
"2011","Bristol 049F","E01014707","Total",35,18,4,13,2,1,1,0,33,17,3,13
"2011","Bristol 049G","E01014708","Total",42,15,9,18,5,0,3,2,37,15,6,16
"2011","Bristol 050A","E01014515","Total",77,23,15,39,5,1,2,2,72,22,13,37
"2011","Bristol 050B","E01014516","Total",121,27,13,81,11,0,2,9,110,27,11,72
"2011","Bristol 050C","E01014517","Total",73,28,8,37,3,0,1,2,70,28,7,35
"2011","Bristol 050D","E01014522","Total",124,26,20,78,16,2,7,7,108,24,13,71
"2011","Bristol 051A","E01014593","Total",129,26,13,90,9,0,2,7,120,26,11,83
"2011","Bristol 051B","E01014595","Total",64,21,7,36,6,2,3,1,58,19,4,35
"2011","Bristol 051C","E01014596","Total",71,23,9,39,11,2,2,7,60,21,7,32
"2011","Bristol 051D","E01014597","Total",57,23,8,26,4,4,0,0,53,19,8,26
"2011","Bristol 052A","E01014611","Total",22,11,7,4,4,0,3,1,18,11,4,3
"2011","Bristol 052B","E01014612","Total",51,18,9,24,4,0,3,1,47,18,6,23
"2011","Bristol 052C","E01014722","Total",27,15,4,8,3,2,0,1,24,13,4,7
"2011","Bristol 052D","E01014723","Total",43,21,11,11,3,1,2,0,40,20,9,11
"2011","Bristol 052E","E01014725","Total",25,11,7,7,4,0,4,0,21,11,3,7
"2011","Bristol 053B","E01014726","Total",130,26,7,97,15,1,3,11,115,25,4,86
"2011","Bristol 053C","E01014727","Total",126,30,13,83,14,1,7,6,112,29,6,77
"2011","Bristol 053E","E01032514","Total",197,44,20,133,23,5,5,13,174,39,15,120
"2011","Bristol 053F","E01032515","Total",72,18,11,43,8,1,3,4,64,17,8,39
"2011","Bristol 054A","E01033352","Total",49,12,11,26,4,2,0,2,45,10,11,24
"2011","Bristol 054B","E01033353","Total",35,7,12,16,4,1,2,1,31,6,10,15
"2011","Bristol 054C","E01033355","Total",12,4,3,5,2,0,1,1,10,4,2,4
"2011","Bristol 054D","E01033358","Total",125,29,16,80,19,6,4,9,106,23,12,71
"2011","Bristol 054E","E01033370","Total",47,10,9,28,4,1,1,2,43,9,8,26
"2011","Bristol 055A","E01014564","Total",110,27,19,64,12,4,2,6,98,23,17,58
"2011","Bristol 055B","E01014653","Total",242,72,26,144,53,11,9,33,189,61,17,111
"2011","Bristol 055C","E01014655","Total",131,41,22,68,13,3,6,4,118,38,16,64
"2011","Bristol 056A","E01014654","Total",149,37,26,86,31,10,6,15,118,27,20,71
"2011","Bristol 056B","E01014658","Total",224,66,21,137,34,2,6,26,190,64,15,111
"2011","Bristol 056C","E01033356","Total",101,22,9,70,14,3,5,6,87,19,4,64
"2011","Bristol 056D","E01033369","Total",114,25,21,68,17,2,8,7,97,23,13,61
"2011","Bristol 057A","E01014568","Total",145,44,25,76,22,5,8,9,123,39,17,67
"2011","Bristol 057B","E01014569","Total",98,18,22,58,14,1,5,8,84,17,17,50
"2011","Bristol 057C","E01014570","Total",84,25,14,45,6,1,3,2,78,24,11,43
"2011","Bristol 057D","E01014574","Total",129,39,21,69,30,14,11,5,99,25,10,64
"2011","Cornwall 010A","E01018753","Total",26,9,9,8,2,0,1,1,24,9,8,7
"2011","Cornwall 010B","E01018754","Total",37,14,6,17,3,1,0,2,34,13,6,15
"2011","Cornwall 010C","E01018755","Total",23,10,4,9,3,0,2,1,20,10,2,8
"2011","Cornwall 010D","E01018756","Total",31,11,12,8,6,0,5,1,25,11,7,7
"2011","Cornwall 012A","E01018777","Total",19,8,6,5,3,0,3,0,16,8,3,5
"2011","Cornwall 012B","E01018782","Total",45,17,16,12,6,1,2,3,39,16,14,9
"2011","Cornwall 012C","E01018783","Total",29,8,9,12,3,0,3,0,26,8,6,12
"2011","Cornwall 012D","E01018784","Total",27,12,7,8,4,0,2,2,23,12,5,6
"2011","Cornwall 013A","E01018750","Total",68,23,18,27,11,0,5,6,57,23,13,21
"2011","Cornwall 013B","E01018751","Total",42,13,9,20,7,1,3,3,35,12,6,17
"2011","Cornwall 013C","E01018752","Total",58,24,18,16,11,2,5,4,47,22,13,12
"2011","Cornwall 013D","E01018779","Total",48,17,12,19,3,0,3,0,45,17,9,19
"2011","Cornwall 016A","E01018758","Total",54,22,11,21,5,0,5,0,49,22,6,21
"2011","Cornwall 016B","E01018768","Total",68,27,20,21,9,2,4,3,59,25,16,18
"2011","Cornwall 016C","E01018769","Total",59,23,12,24,8,1,5,2,51,22,7,22
"2011","Cornwall 016D","E01018778","Total",33,12,10,11,7,0,6,1,26,12,4,10
"2011","Cornwall 017A","E01018767","Total",67,16,13,38,6,0,5,1,61,16,8,37
"2011","Cornwall 017B","E01018770","Total",52,21,5,26,6,1,0,5,46,20,5,21
"2011","Cornwall 017C","E01018771","Total",34,7,7,20,7,0,3,4,27,7,4,16
"2011","Cornwall 017D","E01018772","Total",31,17,8,6,2,1,1,0,29,16,7,6
"2011","Cornwall 022A","E01018764","Total",12,3,4,5,2,0,1,1,10,3,3,4
"2011","Cornwall 022B","E01018787","Total",28,13,9,6,3,0,2,1,25,13,7,5
"2011","Cornwall 022C","E01018795","Total",15,6,6,3,2,0,2,0,13,6,4,3
"2011","Cornwall 022D","E01018796","Total",29,14,8,7,0,0,0,0,29,14,8,7
"2011","Cornwall 023A","E01018757","Total",27,8,9,10,2,0,1,1,25,8,8,9
"2011","Cornwall 023B","E01018763","Total",23,8,5,10,5,0,3,2,18,8,2,8
"2011","Cornwall 023C","E01018765","Total",20,7,4,9,4,1,2,1,16,6,2,8
"2011","Cornwall 023D","E01018785","Total",34,22,5,7,3,1,2,0,31,21,3,7
"2011","Cornwall 025A","E01018786","Total",32,12,11,9,6,1,5,0,26,11,6,9
"2011","Cornwall 025B","E01018788","Total",34,12,8,14,3,1,2,0,31,11,6,14
"2011","Cornwall 025C","E01018790","Total",40,18,4,18,3,1,0,2,37,17,4,16
"2011","Cornwall 025D","E01018794","Total",34,14,9,11,5,3,1,1,29,11,8,10
"2011","Cornwall 026A","E01018789","Total",41,21,10,10,3,1,1,1,38,20,9,9
"2011","Cornwall 026B","E01018791","Total",25,11,11,3,4,1,3,0,21,10,8,3
"2011","Cornwall 026C","E01018792","Total",65,24,19,22,2,0,1,1,63,24,18,21
"2011","Cornwall 026D","E01018793","Total",53,21,12,20,8,4,4,0,45,17,8,20
"2011","Cornwall 028A","E01018759","Total",26,13,6,7,6,3,2,1,20,10,4,6
"2011","Cornwall 028B","E01018760","Total",22,9,6,7,1,0,1,0,21,9,5,7
"2011","Cornwall 028C","E01018761","Total",27,11,8,8,3,1,0,2,24,10,8,6
"2011","Cornwall 028D","E01018766","Total",23,9,3,11,3,0,1,2,20,9,2,9
"2011","Cornwall 028E","E01018774","Total",35,9,8,18,6,0,3,3,29,9,5,15
"2011","Cornwall 029A","E01018797","Total",44,27,7,10,3,0,2,1,41,27,5,9
"2011","Cornwall 029B","E01018798","Total",31,11,11,9,4,1,3,0,27,10,8,9
"2011","Cornwall 029C","E01018799","Total",50,18,12,20,6,1,3,2,44,17,9,18
"2011","Cornwall 029D","E01018800","Total",53,21,19,13,3,0,3,0,50,21,16,13
"2011","Cornwall 034A","E01018780","Total",70,23,21,26,7,1,5,1,63,22,16,25
"2011","Cornwall 034B","E01018781","Total",31,21,4,6,7,4,1,2,24,17,3,4
"2011","Cornwall 034E","E01033294","Total",48,14,16,18,8,0,4,4,40,14,12,14
"2011","Cornwall 037A","E01018762","Total",17,8,1,8,5,2,1,2,12,6,0,6
"2011","Cornwall 037B","E01018773","Total",31,19,7,5,3,0,3,0,28,19,4,5
"2011","Cornwall 037C","E01018775","Total",18,7,3,8,0,0,0,0,18,7,3,8
"2011","Cornwall 037D","E01018776","Total",21,5,8,8,2,0,2,0,19,5,6,8
"2011","Cornwall 032A","E01018815","Total",49,21,11,17,4,0,3,1,45,21,8,16
"2011","Cornwall 032B","E01018831","Total",27,17,5,5,3,2,0,1,24,15,5,4
"2011","Cornwall 032C","E01018832","Total",21,7,9,5,3,0,2,1,18,7,7,4
"2011","Cornwall 032D","E01018847","Total",36,15,13,8,3,1,2,0,33,14,11,8
"2011","Cornwall 033A","E01018833","Total",28,14,6,8,4,1,2,1,24,13,4,7
"2011","Cornwall 033B","E01018842","Total",33,20,6,7,2,0,2,0,31,20,4,7
"2011","Cornwall 033C","E01018843","Total",16,7,4,5,5,2,3,0,11,5,1,5
"2011","Cornwall 033D","E01018844","Total",28,10,12,6,6,1,5,0,22,9,7,6
"2011","Cornwall 040A","E01018825","Total",41,15,17,9,5,1,3,1,36,14,14,8
"2011","Cornwall 040B","E01018826","Total",41,16,17,8,5,0,3,2,36,16,14,6
"2011","Cornwall 040C","E01018851","Total",33,21,4,8,1,1,0,0,32,20,4,8
"2011","Cornwall 040D","E01018852","Total",65,31,23,11,7,2,4,1,58,29,19,10
"2011","Cornwall 042A","E01018823","Total",37,17,13,7,2,0,0,2,35,17,13,5
"2011","Cornwall 042B","E01018824","Total",60,24,12,24,2,0,2,0,58,24,10,24
"2011","Cornwall 042C","E01018853","Total",108,38,30,40,19,4,8,7,89,34,22,33
"2011","Cornwall 042D","E01018854","Total",64,21,9,34,5,0,2,3,59,21,7,31
"2011","Cornwall 043A","E01018819","Total",47,22,8,17,4,0,1,3,43,22,7,14
"2011","Cornwall 043B","E01018822","Total",25,11,10,4,3,0,1,2,22,11,9,2
"2011","Cornwall 043C","E01018855","Total",73,23,22,28,5,1,3,1,68,22,19,27
"2011","Cornwall 043D","E01018856","Total",39,15,12,12,3,1,2,0,36,14,10,12
"2011","Cornwall 043E","E01018857","Total",46,16,9,21,2,0,2,0,44,16,7,21
"2011","Cornwall 043F","E01018858","Total",28,11,6,11,1,0,1,0,27,11,5,11
"2011","Cornwall 044A","E01018807","Total",31,13,11,7,1,0,0,1,30,13,11,6
"2011","Cornwall 044B","E01018808","Total",45,20,14,11,4,1,1,2,41,19,13,9
"2011","Cornwall 044C","E01018809","Total",67,26,23,18,3,0,2,1,64,26,21,17
"2011","Cornwall 044D","E01018810","Total",26,9,11,6,3,1,1,1,23,8,10,5
"2011","Cornwall 047A","E01018816","Total",13,5,5,3,1,0,1,0,12,5,4,3
"2011","Cornwall 047B","E01018817","Total",31,13,10,8,3,0,3,0,28,13,7,8
"2011","Cornwall 047C","E01018818","Total",17,7,5,5,3,1,2,0,14,6,3,5
"2011","Cornwall 047D","E01018820","Total",34,20,6,8,5,2,3,0,29,18,3,8
"2011","Cornwall 047E","E01018821","Total",23,7,11,5,6,0,5,1,17,7,6,4
"2011","Cornwall 048A","E01018845","Total",25,15,5,5,1,0,0,1,24,15,5,4
"2011","Cornwall 048B","E01018846","Total",19,5,5,9,2,0,0,2,17,5,5,7
"2011","Cornwall 048C","E01018848","Total",24,13,4,7,0,0,0,0,24,13,4,7
"2011","Cornwall 048D","E01018849","Total",23,7,7,9,5,0,5,0,18,7,2,9
"2011","Cornwall 048E","E01018850","Total",18,10,4,4,1,0,1,0,17,10,3,4
"2011","Cornwall 056A","E01018827","Total",18,7,8,3,1,0,0,1,17,7,8,2
"2011","Cornwall 056B","E01018828","Total",26,15,8,3,1,0,1,0,25,15,7,3
"2011","Cornwall 056C","E01018829","Total",25,6,8,11,6,1,4,1,19,5,4,10
"2011","Cornwall 056D","E01018830","Total",17,6,7,4,2,0,1,1,15,6,6,3
"2011","Cornwall 060A","E01018834","Total",51,20,12,19,3,1,2,0,48,19,10,19
"2011","Cornwall 060B","E01018835","Total",57,23,12,22,5,0,3,2,52,23,9,20
"2011","Cornwall 060C","E01018836","Total",76,26,10,40,7,2,2,3,69,24,8,37
"2011","Cornwall 060D","E01018837","Total",49,23,14,12,6,2,3,1,43,21,11,11
"2011","Cornwall 062A","E01018838","Total",32,10,5,17,5,0,3,2,27,10,2,15
"2011","Cornwall 062B","E01018839","Total",25,9,5,11,5,0,3,2,20,9,2,9
"2011","Cornwall 062C","E01018840","Total",33,11,9,13,2,0,1,1,31,11,8,12
"2011","Cornwall 062D","E01018841","Total",90,37,12,41,6,1,3,2,84,36,9,39
"2011","Cornwall 062E","E01018860","Total",79,30,14,35,5,2,1,2,74,28,13,33
"2011","Cornwall 063A","E01018803","Total",18,5,9,4,3,0,2,1,15,5,7,3
"2011","Cornwall 063B","E01018804","Total",28,8,9,11,2,0,2,0,26,8,7,11
"2011","Cornwall 063C","E01018805","Total",21,6,8,7,3,0,1,2,18,6,7,5
"2011","Cornwall 063D","E01018806","Total",34,19,8,7,0,0,0,0,34,19,8,7
"2011","Cornwall 064A","E01018811","Total",36,16,11,9,3,0,3,0,33,16,8,9
"2011","Cornwall 064B","E01018812","Total",53,19,13,21,6,0,5,1,47,19,8,20
"2011","Cornwall 064C","E01018813","Total",29,15,9,5,2,1,1,0,27,14,8,5
"2011","Cornwall 064D","E01018814","Total",50,24,14,12,6,4,1,1,44,20,13,11
"2011","Cornwall 064E","E01018859","Total",15,6,5,4,1,0,1,0,14,6,4,4
"2011","Cornwall 045A","E01018889","Total",20,8,8,4,3,1,2,0,17,7,6,4
"2011","Cornwall 045B","E01018890","Total",18,6,6,6,1,0,1,0,17,6,5,6
"2011","Cornwall 045C","E01018891","Total",57,25,10,22,8,1,4,3,49,24,6,19
"2011","Cornwall 045D","E01018892","Total",22,11,5,6,2,0,1,1,20,11,4,5
"2011","Cornwall 045E","E01018893","Total",27,9,2,16,1,0,0,1,26,9,2,15
"2011","Cornwall 046A","E01018908","Total",40,18,5,17,5,1,3,1,35,17,2,16
"2011","Cornwall 046B","E01018909","Total",52,18,13,21,6,0,5,1,46,18,8,20
"2011","Cornwall 046C","E01018910","Total",98,35,4,59,5,0,1,4,93,35,3,55
"2011","Cornwall 046D","E01018911","Total",45,16,11,18,3,1,2,0,42,15,9,18
"2011","Cornwall 049A","E01018912","Total",21,11,6,4,4,1,2,1,17,10,4,3
"2011","Cornwall 049B","E01018913","Total",53,22,16,15,8,1,5,2,45,21,11,13
"2011","Cornwall 049C","E01018914","Total",42,15,12,15,7,0,7,0,35,15,5,15
"2011","Cornwall 049D","E01018915","Total",67,21,25,21,8,2,5,1,59,19,20,20
"2011","Cornwall 050A","E01018916","Total",30,14,11,5,2,0,2,0,28,14,9,5
"2011","Cornwall 050B","E01018917","Total",26,10,9,7,3,0,3,0,23,10,6,7
"2011","Cornwall 050C","E01018918","Total",38,20,8,10,4,0,4,0,34,20,4,10
"2011","Cornwall 050D","E01018919","Total",18,6,2,10,2,1,1,0,16,5,1,10
"2011","Cornwall 051A","E01018894","Total",44,24,11,9,5,0,4,1,39,24,7,8
"2011","Cornwall 051B","E01018895","Total",31,7,11,13,1,0,1,0,30,7,10,13
"2011","Cornwall 051C","E01018896","Total",24,9,7,8,3,1,1,1,21,8,6,7
"2011","Cornwall 051D","E01018897","Total",44,15,12,17,4,0,3,1,40,15,9,16
"2011","Cornwall 051E","E01018898","Total",73,16,14,43,6,0,2,4,67,16,12,39
"2011","Cornwall 052A","E01018865","Total",72,27,12,33,4,0,2,2,68,27,10,31
"2011","Cornwall 052B","E01018866","Total",45,19,6,20,6,2,2,2,39,17,4,18
"2011","Cornwall 052C","E01018867","Total",91,34,10,47,6,3,2,1,85,31,8,46
"2011","Cornwall 052D","E01018868","Total",76,26,18,32,8,3,4,1,68,23,14,31
"2011","Cornwall 053A","E01018874","Total",24,8,6,10,5,1,3,1,19,7,3,9
"2011","Cornwall 053B","E01018875","Total",49,13,6,30,2,0,0,2,47,13,6,28
"2011","Cornwall 053C","E01018876","Total",36,10,8,18,4,0,1,3,32,10,7,15
"2011","Cornwall 053D","E01018877","Total",17,7,4,6,1,1,0,0,16,6,4,6
"2011","Cornwall 053E","E01018878","Total",60,28,8,24,6,2,3,1,54,26,5,23
"2011","Cornwall 055A","E01018869","Total",42,15,6,21,6,2,0,4,36,13,6,17
"2011","Cornwall 055B","E01018870","Total",80,23,8,49,6,1,0,5,74,22,8,44
"2011","Cornwall 055C","E01018871","Total",39,23,7,9,6,5,1,0,33,18,6,9
"2011","Cornwall 055D","E01018872","Total",34,11,9,14,3,0,3,0,31,11,6,14
"2011","Cornwall 055E","E01018873","Total",44,15,5,24,3,1,0,2,41,14,5,22
"2011","Cornwall 059A","E01018863","Total",36,16,6,14,8,2,4,2,28,14,2,12
"2011","Cornwall 059B","E01018864","Total",22,12,5,5,6,2,2,2,16,10,3,3
"2011","Cornwall 059C","E01018921","Total",33,12,9,12,3,1,1,1,30,11,8,11
"2011","Cornwall 059D","E01018922","Total",27,16,4,7,7,4,2,1,20,12,2,6
"2011","Cornwall 066A","E01018879","Total",16,9,4,3,0,0,0,0,16,9,4,3
"2011","Cornwall 066B","E01018880","Total",32,12,9,11,1,0,1,0,31,12,8,11
"2011","Cornwall 066C","E01018899","Total",23,8,8,7,2,0,2,0,21,8,6,7
"2011","Cornwall 066D","E01018900","Total",10,6,1,3,1,1,0,0,9,5,1,3
"2011","Cornwall 066E","E01018901","Total",23,6,8,9,5,0,4,1,18,6,4,8
"2011","Cornwall 071A","E01018882","Total",47,17,21,9,7,0,7,0,40,17,14,9
"2011","Cornwall 071B","E01018883","Total",39,23,9,7,4,0,1,3,35,23,8,4
"2011","Cornwall 071C","E01018884","Total",54,26,11,17,2,0,2,0,52,26,9,17
"2011","Cornwall 071D","E01018885","Total",44,17,11,16,2,0,1,1,42,17,10,15
"2011","Cornwall 071E","E01018886","Total",41,19,10,12,5,2,2,1,36,17,8,11
"2011","Cornwall 071F","E01018887","Total",73,27,23,23,8,0,7,1,65,27,16,22
"2011","Cornwall 071G","E01018888","Total",78,28,18,32,5,0,2,3,73,28,16,29
"2011","Cornwall 072A","E01018861","Total",17,9,1,7,1,1,0,0,16,8,1,7
"2011","Cornwall 072B","E01018862","Total",12,6,3,3,2,2,0,0,10,4,3,3
"2011","Cornwall 072C","E01018905","Total",26,12,8,6,5,1,4,0,21,11,4,6
"2011","Cornwall 072D","E01018906","Total",26,9,11,6,5,1,4,0,21,8,7,6
"2011","Cornwall 072E","E01018907","Total",33,16,4,13,7,3,3,1,26,13,1,12
"2011","Cornwall 073A","E01018881","Total",34,9,14,11,6,1,4,1,28,8,10,10
"2011","Cornwall 073B","E01018902","Total",21,9,5,7,3,1,1,1,18,8,4,6
"2011","Cornwall 073C","E01018903","Total",13,3,3,7,3,1,1,1,10,2,2,6
"2011","Cornwall 073D","E01018904","Total",46,22,11,13,3,0,3,0,43,22,8,13
"2011","Cornwall 073E","E01018920","Total",35,12,4,19,9,2,3,4,26,10,1,15
"2011","Cornwall 001A","E01018936","Total",27,11,5,11,3,2,0,1,24,9,5,10
"2011","Cornwall 001B","E01018937","Total",95,38,12,45,7,2,1,4,88,36,11,41
"2011","Cornwall 001C","E01018938","Total",38,12,9,17,2,0,2,0,36,12,7,17
"2011","Cornwall 001D","E01018959","Total",23,7,9,7,2,0,2,0,21,7,7,7
"2011","Cornwall 001E","E01018960","Total",58,26,13,19,3,1,1,1,55,25,12,18
"2011","Cornwall 001F","E01018961","Total",39,12,10,17,5,1,2,2,34,11,8,15
"2011","Cornwall 002A","E01018943","Total",24,11,5,8,3,1,2,0,21,10,3,8
"2011","Cornwall 002B","E01018951","Total",28,11,6,11,5,2,3,0,23,9,3,11
"2011","Cornwall 002C","E01018974","Total",32,13,7,12,4,0,4,0,28,13,3,12
"2011","Cornwall 003A","E01018940","Total",29,13,8,8,3,0,2,1,26,13,6,7
"2011","Cornwall 003B","E01018941","Total",33,14,9,10,2,1,1,0,31,13,8,10
"2011","Cornwall 003C","E01018942","Total",29,9,3,17,2,1,1,0,27,8,2,17
"2011","Cornwall 003D","E01018969","Total",32,11,13,8,3,0,3,0,29,11,10,8
"2011","Cornwall 004B","E01018953","Total",9,4,3,2,2,0,2,0,7,4,1,2
"2011","Cornwall 004C","E01018968","Total",27,11,7,9,7,2,3,2,20,9,4,7
"2011","Cornwall 004D","E01033291","Total",29,15,9,5,2,0,2,0,27,15,7,5
"2011","Cornwall 004E","E01033292","Total",62,22,8,32,3,0,2,1,59,22,6,31
"2011","Cornwall 005A","E01018946","Total",28,17,3,8,3,0,1,2,25,17,2,6
"2011","Cornwall 005B","E01018947","Total",89,35,22,32,9,0,6,3,80,35,16,29
"2011","Cornwall 005C","E01018948","Total",50,7,13,30,5,0,4,1,45,7,9,29
"2011","Cornwall 005D","E01018949","Total",59,19,11,29,11,1,8,2,48,18,3,27
"2011","Cornwall 005E","E01018950","Total",51,24,12,15,4,1,2,1,47,23,10,14
"2011","Cornwall 006A","E01018925","Total",23,10,11,2,3,0,3,0,20,10,8,2
"2011","Cornwall 006B","E01018952","Total",17,8,1,8,4,0,1,3,13,8,0,5
"2011","Cornwall 006C","E01018965","Total",30,17,5,8,3,1,2,0,27,16,3,8
"2011","Cornwall 006D","E01018966","Total",9,3,3,3,3,1,1,1,6,2,2,2
"2011","Cornwall 006E","E01018967","Total",13,4,6,3,2,0,2,0,11,4,4,3
"2011","Cornwall 007A","E01018924","Total",17,8,4,5,1,0,1,0,16,8,3,5
"2011","Cornwall 007B","E01018962","Total",33,21,5,7,4,3,0,1,29,18,5,6
"2011","Cornwall 007E","E01033289","Total",26,12,11,3,7,2,5,0,19,10,6,3
"2011","Cornwall 008A","E01018954","Total",40,19,5,16,5,2,1,2,35,17,4,14
"2011","Cornwall 008B","E01018955","Total",27,10,7,10,4,1,2,1,23,9,5,9
"2011","Cornwall 008C","E01018956","Total",13,5,4,4,1,0,0,1,12,5,4,3
"2011","Cornwall 008D","E01018957","Total",33,8,13,12,6,1,2,3,27,7,11,9
"2011","Cornwall 008E","E01018958","Total",23,6,5,12,3,1,2,0,20,5,3,12
"2011","Cornwall 009A","E01018970","Total",38,18,9,11,2,2,0,0,36,16,9,11
"2011","Cornwall 009B","E01018971","Total",49,17,17,15,7,0,6,1,42,17,11,14
"2011","Cornwall 009C","E01018972","Total",40,22,6,12,5,2,3,0,35,20,3,12
"2011","Cornwall 009D","E01018973","Total",45,21,10,14,9,2,7,0,36,19,3,14
"2011","Cornwall 011A","E01018923","Total",26,9,8,9,7,2,3,2,19,7,5,7
"2011","Cornwall 011B","E01018926","Total",34,16,7,11,1,1,0,0,33,15,7,11
"2011","Cornwall 011C","E01018944","Total",19,5,7,7,3,1,0,2,16,4,7,5
"2011","Cornwall 011D","E01018945","Total",12,6,1,5,1,0,1,0,11,6,0,5
"2011","Cornwall 014A","E01018932","Total",66,21,11,34,10,1,2,7,56,20,9,27
"2011","Cornwall 014B","E01018933","Total",50,26,9,15,7,3,1,3,43,23,8,12
"2011","Cornwall 014C","E01018934","Total",29,9,11,9,5,0,4,1,24,9,7,8
"2011","Cornwall 014D","E01018935","Total",81,32,22,27,5,1,4,0,76,31,18,27
"2011","Cornwall 015A","E01018927","Total",39,23,5,11,4,1,2,1,35,22,3,10
"2011","Cornwall 015B","E01018928","Total",68,24,14,30,10,1,2,7,58,23,12,23
"2011","Cornwall 015C","E01018929","Total",24,14,3,7,4,2,2,0,20,12,1,7
"2011","Cornwall 015D","E01018930","Total",104,34,18,52,15,0,8,7,89,34,10,45
"2011","Cornwall 015E","E01018931","Total",30,10,10,10,6,0,5,1,24,10,5,9
"2011","Cornwall 054A","E01019008","Total",51,18,11,22,4,1,2,1,47,17,9,21
"2011","Cornwall 054B","E01019009","Total",62,28,15,19,9,1,4,4,53,27,11,15
"2011","Cornwall 054C","E01019010","Total",38,20,11,7,1,0,1,0,37,20,10,7
"2011","Cornwall 054D","E01019011","Total",21,8,3,10,4,1,1,2,17,7,2,8
"2011","Cornwall 054E","E01019012","Total",27,10,5,12,3,0,2,1,24,10,3,11
"2011","Cornwall 057A","E01018978","Total",34,10,10,14,8,0,4,4,26,10,6,10
"2011","Cornwall 057B","E01018981","Total",26,16,5,5,1,1,0,0,25,15,5,5
"2011","Cornwall 057C","E01018982","Total",81,35,15,31,9,1,5,3,72,34,10,28
"2011","Cornwall 057D","E01018983","Total",31,12,6,13,2,0,1,1,29,12,5,12
"2011","Cornwall 057E","E01018984","Total",85,42,7,36,9,5,1,3,76,37,6,33
"2011","Cornwall 058A","E01018985","Total",60,31,18,11,6,1,5,0,54,30,13,11
"2011","Cornwall 058B","E01018986","Total",25,11,6,8,2,0,2,0,23,11,4,8
"2011","Cornwall 058C","E01018987","Total",22,8,8,6,4,0,3,1,18,8,5,5
"2011","Cornwall 061A","E01018975","Total",50,24,13,13,3,1,1,1,47,23,12,12
"2011","Cornwall 061B","E01018979","Total",26,8,6,12,6,0,2,4,20,8,4,8
"2011","Cornwall 061C","E01018980","Total",23,12,3,8,2,1,1,0,21,11,2,8
"2011","Cornwall 061D","E01018990","Total",42,17,9,16,4,1,1,2,38,16,8,14
"2011","Cornwall 061E","E01019007","Total",44,20,13,11,10,1,7,2,34,19,6,9
"2011","Cornwall 065A","E01018988","Total",38,18,12,8,7,2,3,2,31,16,9,6
"2011","Cornwall 065B","E01018989","Total",43,13,10,20,6,1,4,1,37,12,6,19
"2011","Cornwall 065C","E01018991","Total",48,23,5,20,2,1,0,1,46,22,5,19
"2011","Cornwall 065D","E01019006","Total",20,13,2,5,0,0,0,0,20,13,2,5
"2011","Cornwall 067A","E01018976","Total",51,26,14,11,6,2,3,1,45,24,11,10
"2011","Cornwall 067B","E01018977","Total",69,23,12,34,4,1,2,1,65,22,10,33
"2011","Cornwall 067C","E01018994","Total",36,16,9,11,7,1,5,1,29,15,4,10
"2011","Cornwall 067D","E01018996","Total",49,18,7,24,6,0,1,5,43,18,6,19
"2011","Cornwall 067E","E01018997","Total",88,21,10,57,5,2,0,3,83,19,10,54
"2011","Cornwall 068A","E01018995","Total",83,35,14,34,10,2,3,5,73,33,11,29
"2011","Cornwall 068B","E01018998","Total",75,30,15,30,6,3,1,2,69,27,14,28
"2011","Cornwall 068C","E01018999","Total",57,28,6,23,6,4,0,2,51,24,6,21
"2011","Cornwall 068D","E01019001","Total",63,27,18,18,9,0,7,2,54,27,11,16
"2011","Cornwall 069A","E01018992","Total",34,18,10,6,3,0,2,1,31,18,8,5
"2011","Cornwall 069B","E01018993","Total",63,18,18,27,9,2,4,3,54,16,14,24
"2011","Cornwall 069C","E01019005","Total",39,21,7,11,2,0,1,1,37,21,6,10
"2011","Cornwall 070A","E01019000","Total",30,9,6,15,4,0,1,3,26,9,5,12
"2011","Cornwall 070B","E01019002","Total",31,13,10,8,3,1,2,0,28,12,8,8
"2011","Cornwall 070C","E01019003","Total",41,20,11,10,6,2,4,0,35,18,7,10
"2011","Cornwall 070D","E01019004","Total",85,27,20,38,18,4,8,6,67,23,12,32
"2011","Cornwall 018A","E01019048","Total",31,14,7,10,1,0,1,0,30,14,6,10
"2011","Cornwall 018B","E01019049","Total",34,9,14,11,7,0,5,2,27,9,9,9
"2011","Cornwall 018C","E01019050","Total",21,6,11,4,1,0,0,1,20,6,11,3
"2011","Cornwall 018D","E01019051","Total",60,26,14,20,10,3,1,6,50,23,13,14
"2011","Cornwall 019A","E01019060","Total",19,5,5,9,4,0,2,2,15,5,3,7
"2011","Cornwall 019B","E01019061","Total",43,11,19,13,4,1,2,1,39,10,17,12
"2011","Cornwall 019C","E01019062","Total",68,31,13,24,4,0,2,2,64,31,11,22
"2011","Cornwall 019D","E01019063","Total",52,23,14,15,9,2,6,1,43,21,8,14
"2011","Cornwall 019E","E01019064","Total",43,9,12,22,6,2,3,1,37,7,9,21
"2011","Cornwall 019F","E01019065","Total",31,8,8,15,1,0,1,0,30,8,7,15
"2011","Cornwall 020A","E01019028","Total",66,27,16,23,5,1,4,0,61,26,12,23
"2011","Cornwall 020B","E01019029","Total",39,13,7,19,2,0,1,1,37,13,6,18
"2011","Cornwall 020C","E01019030","Total",46,22,10,14,4,0,3,1,42,22,7,13
"2011","Cornwall 020D","E01019031","Total",42,16,10,16,4,1,2,1,38,15,8,15
"2011","Cornwall 021A","E01019018","Total",32,14,13,5,6,0,5,1,26,14,8,4
"2011","Cornwall 021B","E01019019","Total",32,17,9,6,3,1,2,0,29,16,7,6
"2011","Cornwall 021C","E01019020","Total",60,22,13,25,4,1,3,0,56,21,10,25
"2011","Cornwall 021D","E01019021","Total",42,20,6,16,2,0,0,2,40,20,6,14
"2011","Cornwall 021E","E01019022","Total",74,21,18,35,14,2,7,5,60,19,11,30
"2011","Cornwall 021F","E01019023","Total",81,43,15,23,7,2,5,0,74,41,10,23
"2011","Cornwall 024A","E01019052","Total",44,18,10,16,7,2,2,3,37,16,8,13
"2011","Cornwall 024B","E01019053","Total",40,16,7,17,6,1,3,2,34,15,4,15
"2011","Cornwall 024C","E01019054","Total",36,10,11,15,5,0,4,1,31,10,7,14
"2011","Cornwall 024D","E01019055","Total",52,11,13,28,6,0,5,1,46,11,8,27
"2011","Cornwall 027A","E01019035","Total",28,12,13,3,2,2,0,0,26,10,13,3
"2011","Cornwall 027B","E01019036","Total",25,13,4,8,3,1,1,1,22,12,3,7
"2011","Cornwall 027C","E01019037","Total",38,14,9,15,4,0,2,2,34,14,7,13
"2011","Cornwall 027D","E01019074","Total",53,26,10,17,4,1,3,0,49,25,7,17
"2011","Cornwall 027E","E01019075","Total",33,13,9,11,1,0,1,0,32,13,8,11
"2011","Cornwall 027F","E01019076","Total",71,21,15,35,7,1,3,3,64,20,12,32
"2011","Cornwall 030A","E01019069","Total",40,15,8,17,4,1,2,1,36,14,6,16
"2011","Cornwall 030B","E01019070","Total",62,24,9,29,7,0,2,5,55,24,7,24
"2011","Cornwall 030C","E01019071","Total",24,11,8,5,4,2,2,0,20,9,6,5
"2011","Cornwall 030D","E01019072","Total",46,23,6,17,4,1,3,0,42,22,3,17
"2011","Cornwall 030E","E01019073","Total",29,14,9,6,4,2,2,0,25,12,7,6
"2011","Cornwall 031A","E01019056","Total",84,27,11,46,15,3,4,8,69,24,7,38
"2011","Cornwall 031B","E01019057","Total",66,28,18,20,6,3,2,1,60,25,16,19
"2011","Cornwall 031C","E01019058","Total",44,18,13,13,2,0,2,0,42,18,11,13
"2011","Cornwall 031D","E01019059","Total",49,28,8,13,6,2,3,1,43,26,5,12
"2011","Cornwall 035A","E01019024","Total",44,18,12,14,7,2,3,2,37,16,9,12
"2011","Cornwall 035B","E01019025","Total",28,17,8,3,1,0,1,0,27,17,7,3
"2011","Cornwall 035C","E01019026","Total",18,7,8,3,3,0,3,0,15,7,5,3
"2011","Cornwall 035D","E01019027","Total",35,12,10,13,3,0,2,1,32,12,8,12
"2011","Cornwall 036A","E01019013","Total",72,31,14,27,5,2,2,1,67,29,12,26
"2011","Cornwall 036B","E01019014","Total",32,10,11,11,1,0,1,0,31,10,10,11
"2011","Cornwall 036C","E01019015","Total",22,10,8,4,1,0,1,0,21,10,7,4
"2011","Cornwall 036D","E01019016","Total",56,19,14,23,1,0,1,0,55,19,13,23
"2011","Cornwall 036E","E01019017","Total",45,18,18,9,2,1,1,0,43,17,17,9
"2011","Cornwall 038A","E01019032","Total",32,8,11,13,7,2,3,2,25,6,8,11
"2011","Cornwall 038B","E01019034","Total",52,19,9,24,4,2,1,1,48,17,8,23
"2011","Cornwall 038C","E01019045","Total",62,34,14,14,4,1,3,0,58,33,11,14
"2011","Cornwall 038D","E01019047","Total",32,8,9,15,6,1,2,3,26,7,7,12
"2011","Cornwall 039A","E01019033","Total",56,17,11,28,9,3,2,4,47,14,9,24
"2011","Cornwall 039B","E01019041","Total",73,27,11,35,5,2,1,2,68,25,10,33
"2011","Cornwall 039C","E01019042","Total",62,24,15,23,6,2,2,2,56,22,13,21
"2011","Cornwall 039D","E01019043","Total",28,6,11,11,6,0,4,2,22,6,7,9
"2011","Cornwall 039E","E01019044","Total",38,18,10,10,1,0,1,0,37,18,9,10
"2011","Cornwall 039F","E01019046","Total",52,21,10,21,7,1,5,1,45,20,5,20
"2011","Cornwall 041A","E01019038","Total",12,8,1,3,0,0,0,0,12,8,1,3
"2011","Cornwall 041B","E01019039","Total",18,10,2,6,2,1,0,1,16,9,2,5
"2011","Cornwall 041C","E01019040","Total",29,14,6,9,4,1,3,0,25,13,3,9
"2011","Cornwall 041D","E01019066","Total",18,10,5,3,2,0,1,1,16,10,4,2
"2011","Cornwall 041E","E01019067","Total",12,5,2,5,2,1,0,1,10,4,2,4
"2011","Cornwall 041F","E01019068","Total",22,8,9,5,6,1,5,0,16,7,4,5
"2011","Isles of Scilly 001A","E01019077","Total",22,8,13,1,3,0,3,0,19,8,10,1
"2011","North Somerset 001B","E01014790","Total",22,6,11,5,5,0,5,0,17,6,6,5
"2011","North Somerset 001C","E01014795","Total",59,24,13,22,5,2,2,1,54,22,11,21
"2011","North Somerset 001D","E01014797","Total",40,13,13,14,10,2,6,2,30,11,7,12
"2011","North Somerset 001E","E01032675","Total",41,16,14,11,3,0,3,0,38,16,11,11
"2011","North Somerset 001F","E01032676","Total",28,11,12,5,4,0,3,1,24,11,9,4
"2011","North Somerset 001G","E01032681","Total",28,14,9,5,3,1,2,0,25,13,7,5
"2011","North Somerset 002A","E01014789","Total",9,5,3,1,0,0,0,0,9,5,3,1
"2011","North Somerset 002B","E01014793","Total",31,14,13,4,2,0,2,0,29,14,11,4
"2011","North Somerset 002C","E01014794","Total",17,8,6,3,3,1,1,1,14,7,5,2
"2011","North Somerset 002D","E01014798","Total",24,7,11,6,3,0,3,0,21,7,8,6
"2011","North Somerset 003B","E01014792","Total",36,15,9,12,3,2,1,0,33,13,8,12
"2011","North Somerset 003C","E01014796","Total",19,12,5,2,3,0,2,1,16,12,3,1
"2011","North Somerset 003D","E01032677","Total",55,20,17,18,4,0,4,0,51,20,13,18
"2011","North Somerset 003E","E01032678","Total",34,11,19,4,5,0,4,1,29,11,15,3
"2011","North Somerset 003F","E01032682","Total",50,18,14,18,5,1,3,1,45,17,11,17
"2011","North Somerset 004A","E01014766","Total",17,5,7,5,5,0,5,0,12,5,2,5
"2011","North Somerset 004B","E01014767","Total",12,6,5,1,3,1,2,0,9,5,3,1
"2011","North Somerset 004C","E01014786","Total",56,27,11,18,5,1,2,2,51,26,9,16
"2011","North Somerset 004D","E01014787","Total",41,21,11,9,4,0,3,1,37,21,8,8
"2011","North Somerset 005A","E01014752","Total",39,23,8,8,2,0,2,0,37,23,6,8
"2011","North Somerset 005B","E01014754","Total",26,12,10,4,7,0,6,1,19,12,4,3
"2011","North Somerset 005C","E01014758","Total",7,6,1,0,0,0,0,0,7,6,1,0
"2011","North Somerset 005D","E01014759","Total",13,5,7,1,6,0,6,0,7,5,1,1
"2011","North Somerset 006B","E01014849","Total",19,7,8,4,2,0,2,0,17,7,6,4
"2011","North Somerset 006C","E01014850","Total",27,7,10,10,2,0,2,0,25,7,8,10
"2011","North Somerset 006D","E01014851","Total",65,25,19,21,8,3,3,2,57,22,16,19
"2011","North Somerset 006E","E01014852","Total",25,7,8,10,3,0,1,2,22,7,7,8
"2011","North Somerset 006F","E01032674","Total",60,30,17,13,6,2,2,2,54,28,15,11
"2011","North Somerset 006G","E01032680","Total",18,10,4,4,1,1,0,0,17,9,4,4
"2011","North Somerset 007A","E01014750","Total",37,17,9,11,4,0,3,1,33,17,6,10
"2011","North Somerset 007B","E01014751","Total",57,18,11,28,7,0,3,4,50,18,8,24
"2011","North Somerset 007C","E01014753","Total",62,26,17,19,6,1,4,1,56,25,13,18
"2011","North Somerset 007D","E01014755","Total",6,1,3,2,2,0,2,0,4,1,1,2
"2011","North Somerset 007E","E01014760","Total",31,16,8,7,3,1,1,1,28,15,7,6
"2011","North Somerset 008A","E01014780","Total",46,22,8,16,2,0,1,1,44,22,7,15
"2011","North Somerset 008B","E01014781","Total",45,22,14,9,8,2,6,0,37,20,8,9
"2011","North Somerset 008C","E01014782","Total",17,5,7,5,4,0,4,0,13,5,3,5
"2011","North Somerset 008D","E01014783","Total",41,17,15,9,6,0,5,1,35,17,10,8
"2011","North Somerset 008E","E01014784","Total",28,12,11,5,5,0,4,1,23,12,7,4
"2011","North Somerset 008F","E01014785","Total",15,5,8,2,4,1,3,0,11,4,5,2
"2011","North Somerset 009A","E01014775","Total",28,13,10,5,5,0,3,2,23,13,7,3
"2011","North Somerset 009B","E01014776","Total",26,11,9,6,6,3,2,1,20,8,7,5
"2011","North Somerset 009C","E01014777","Total",41,17,16,8,4,1,3,0,37,16,13,8
"2011","North Somerset 009D","E01014778","Total",11,5,4,2,0,0,0,0,11,5,4,2
"2011","North Somerset 009E","E01014779","Total",30,10,15,5,6,1,5,0,24,9,10,5
"2011","North Somerset 010A","E01014756","Total",42,22,11,9,7,4,3,0,35,18,8,9
"2011","North Somerset 010B","E01014757","Total",43,23,12,8,6,4,2,0,37,19,10,8
"2011","North Somerset 010C","E01014761","Total",35,17,11,7,4,1,3,0,31,16,8,7
"2011","North Somerset 010D","E01014762","Total",27,9,12,6,4,0,4,0,23,9,8,6
"2011","North Somerset 010E","E01014763","Total",64,31,12,21,4,1,2,1,60,30,10,20
"2011","North Somerset 011A","E01014737","Total",18,6,8,4,3,0,3,0,15,6,5,4
"2011","North Somerset 011B","E01014738","Total",48,22,13,13,4,0,2,2,44,22,11,11
"2011","North Somerset 011C","E01014739","Total",30,15,10,5,8,1,5,2,22,14,5,3
"2011","North Somerset 011D","E01014740","Total",33,13,16,4,6,0,6,0,27,13,10,4
"2011","North Somerset 012A","E01014855","Total",14,8,6,0,3,0,3,0,11,8,3,0
"2011","North Somerset 012B","E01014856","Total",39,10,16,13,4,0,4,0,35,10,12,13
"2011","North Somerset 012C","E01014857","Total",39,18,11,10,6,1,5,0,33,17,6,10
"2011","North Somerset 012D","E01014858","Total",37,12,13,12,3,1,2,0,34,11,11,12
"2011","North Somerset 012E","E01014859","Total",33,16,8,9,5,4,1,0,28,12,7,9
"2011","North Somerset 012F","E01014860","Total",36,16,15,5,4,0,4,0,32,16,11,5
"2011","North Somerset 013A","E01014847","Total",27,11,11,5,6,1,3,2,21,10,8,3
"2011","North Somerset 013B","E01014848","Total",18,2,9,7,3,0,3,0,15,2,6,7
"2011","North Somerset 013C","E01014853","Total",36,12,13,11,2,1,1,0,34,11,12,11
"2011","North Somerset 013D","E01014854","Total",10,4,5,1,2,0,2,0,8,4,3,1
"2011","North Somerset 014A","E01014764","Total",44,14,13,17,7,0,6,1,37,14,7,16
"2011","North Somerset 014B","E01014765","Total",41,17,10,14,4,1,2,1,37,16,8,13
"2011","North Somerset 014C","E01014773","Total",44,18,14,12,7,1,6,0,37,17,8,12
"2011","North Somerset 014D","E01014774","Total",27,10,6,11,3,0,2,1,24,10,4,10
"2011","North Somerset 015A","E01014821","Total",53,17,17,19,4,1,1,2,49,16,16,17
"2011","North Somerset 015B","E01014822","Total",35,19,9,7,1,0,1,0,34,19,8,7
"2011","North Somerset 015C","E01014823","Total",32,16,10,6,3,0,3,0,29,16,7,6
"2011","North Somerset 015D","E01014824","Total",32,16,9,7,3,0,2,1,29,16,7,6
"2011","North Somerset 015E","E01014825","Total",25,13,7,5,5,2,2,1,20,11,5,4
"2011","North Somerset 015F","E01014826","Total",66,31,10,25,2,0,2,0,64,31,8,25
"2011","North Somerset 015G","E01014827","Total",67,24,7,36,9,1,3,5,58,23,4,31
"2011","North Somerset 016A","E01014817","Total",33,13,9,11,5,0,3,2,28,13,6,9
"2011","North Somerset 016B","E01014820","Total",33,15,3,15,2,0,0,2,31,15,3,13
"2011","North Somerset 016C","E01014835","Total",56,20,8,28,4,2,2,0,52,18,6,28
"2011","North Somerset 016D","E01014836","Total",51,22,12,17,3,0,1,2,48,22,11,15
"2011","North Somerset 016E","E01014838","Total",56,23,19,14,4,0,4,0,52,23,15,14
"2011","North Somerset 016F","E01014840","Total",64,20,9,35,8,0,4,4,56,20,5,31
"2011","North Somerset 017A","E01014812","Total",34,14,5,15,4,0,2,2,30,14,3,13
"2011","North Somerset 017B","E01014813","Total",55,20,13,22,6,2,2,2,49,18,11,20
"2011","North Somerset 017C","E01014815","Total",45,14,14,17,5,0,5,0,40,14,9,17
"2011","North Somerset 017D","E01014816","Total",8,3,3,2,2,0,1,1,6,3,2,1
"2011","North Somerset 017E","E01014818","Total",19,5,8,6,5,1,4,0,14,4,4,6
"2011","North Somerset 017F","E01014819","Total",25,9,6,10,3,0,3,0,22,9,3,10
"2011","North Somerset 018A","E01014841","Total",35,13,9,13,7,2,2,3,28,11,7,10
"2011","North Somerset 018B","E01014842","Total",40,14,8,18,8,1,3,4,32,13,5,14
"2011","North Somerset 018C","E01014843","Total",29,12,5,12,0,0,0,0,29,12,5,12
"2011","North Somerset 018D","E01014844","Total",35,13,8,14,8,1,5,2,27,12,3,12
"2011","North Somerset 018E","E01014845","Total",18,7,9,2,1,0,1,0,17,7,8,2
"2011","North Somerset 018F","E01014846","Total",31,12,10,9,3,0,2,1,28,12,8,8
"2011","North Somerset 020A","E01014799","Total",59,23,13,23,8,0,4,4,51,23,9,19
"2011","North Somerset 020B","E01014800","Total",78,19,16,43,8,2,3,3,70,17,13,40
"2011","North Somerset 020C","E01014801","Total",27,6,3,18,1,0,0,1,26,6,3,17
"2011","North Somerset 020D","E01014802","Total",45,19,10,16,6,0,4,2,39,19,6,14
"2011","North Somerset 020E","E01014809","Total",75,20,16,39,7,0,3,4,68,20,13,35
"2011","North Somerset 020F","E01014811","Total",51,25,12,14,4,1,1,2,47,24,11,12
"2011","North Somerset 021A","E01014829","Total",120,35,17,68,10,2,3,5,110,33,14,63
"2011","North Somerset 021B","E01014830","Total",65,29,9,27,3,0,1,2,62,29,8,25
"2011","North Somerset 021C","E01014831","Total",95,20,13,62,13,2,3,8,82,18,10,54
"2011","North Somerset 021D","E01014832","Total",74,15,4,55,9,0,1,8,65,15,3,47
"2011","North Somerset 021E","E01014833","Total",100,34,8,58,15,3,3,9,85,31,5,49
"2011","North Somerset 022A","E01014804","Total",18,8,7,3,2,1,1,0,16,7,6,3
"2011","North Somerset 022B","E01014806","Total",45,17,7,21,5,0,3,2,40,17,4,19
"2011","North Somerset 022C","E01014807","Total",49,18,10,21,8,0,4,4,41,18,6,17
"2011","North Somerset 022D","E01014808","Total",35,13,8,14,1,0,1,0,34,13,7,14
"2011","North Somerset 023A","E01014744","Total",15,7,4,4,0,0,0,0,15,7,4,4
"2011","North Somerset 023B","E01014746","Total",56,17,14,25,10,3,4,3,46,14,10,22
"2011","North Somerset 023C","E01014769","Total",67,31,16,20,5,1,4,0,62,30,12,20
"2011","North Somerset 023D","E01014770","Total",14,5,5,4,1,0,1,0,13,5,4,4
"2011","North Somerset 023E","E01014771","Total",22,15,3,4,2,0,1,1,20,15,2,3
"2011","North Somerset 023F","E01014772","Total",14,5,3,6,1,1,0,0,13,4,3,6
"2011","North Somerset 024A","E01014741","Total",30,15,10,5,5,3,1,1,25,12,9,4
"2011","North Somerset 024B","E01014742","Total",11,3,6,2,2,0,2,0,9,3,4,2
"2011","North Somerset 024C","E01014745","Total",21,11,5,5,4,0,2,2,17,11,3,3
"2011","North Somerset 024D","E01014747","Total",15,5,7,3,4,0,2,2,11,5,5,1
"2011","North Somerset 024E","E01014748","Total",16,10,4,2,2,1,1,0,14,9,3,2
"2011","North Somerset 024F","E01014749","Total",29,10,11,8,6,1,5,0,23,9,6,8
"2011","North Somerset 025A","E01014803","Total",23,10,4,9,2,0,2,0,21,10,2,9
"2011","North Somerset 025B","E01014805","Total",13,7,4,2,1,0,1,0,12,7,3,2
"2011","North Somerset 025C","E01014828","Total",89,27,14,48,13,3,8,2,76,24,6,46
"2011","North Somerset 025D","E01014834","Total",82,38,17,27,4,2,0,2,78,36,17,25
"2011","North Somerset 026A","E01014839","Total",68,25,20,23,4,0,3,1,64,25,17,22
"2011","North Somerset 026B","E01032666","Total",30,9,13,8,3,0,3,0,27,9,10,8
"2011","North Somerset 026C","E01032667","Total",45,18,13,14,2,0,2,0,43,18,11,14
"2011","North Somerset 026D","E01032668","Total",70,25,13,32,3,1,2,0,67,24,11,32
"2011","North Somerset 026E","E01032672","Total",36,19,9,8,7,2,2,3,29,17,7,5
"2011","North Somerset 026F","E01032673","Total",47,19,9,19,4,0,1,3,43,19,8,16
"2011","North Somerset 027A","E01014810","Total",80,44,17,19,10,2,5,3,70,42,12,16
"2011","North Somerset 027B","E01032669","Total",77,32,23,22,6,0,5,1,71,32,18,21
"2011","North Somerset 027C","E01032670","Total",101,35,24,42,9,1,6,2,92,34,18,40
"2011","North Somerset 027D","E01032671","Total",75,39,15,21,4,2,2,0,71,37,13,21
"2011","North Somerset 027E","E01032679","Total",79,35,24,20,4,1,2,1,75,34,22,19
"2011","Plymouth 001A","E01015025","Total",14,5,9,0,5,1,4,0,9,4,5,0
"2011","Plymouth 001B","E01015097","Total",6,3,0,3,0,0,0,0,6,3,0,3
"2011","Plymouth 001C","E01015160","Total",23,11,7,5,1,0,1,0,22,11,6,5
"2011","Plymouth 001D","E01015164","Total",56,25,17,14,8,2,5,1,48,23,12,13
"2011","Plymouth 002A","E01015027","Total",40,12,10,18,4,0,2,2,36,12,8,16
"2011","Plymouth 002B","E01015159","Total",66,29,9,28,2,0,0,2,64,29,9,26
"2011","Plymouth 002C","E01015161","Total",63,31,9,23,8,0,5,3,55,31,4,20
"2011","Plymouth 002D","E01015162","Total",58,24,11,23,7,0,3,4,51,24,8,19
"2011","Plymouth 002E","E01015166","Total",105,33,24,48,14,0,6,8,91,33,18,40
"2011","Plymouth 003A","E01015023","Total",54,23,11,20,3,1,0,2,51,22,11,18
"2011","Plymouth 003B","E01015026","Total",79,23,15,41,8,0,4,4,71,23,11,37
"2011","Plymouth 003C","E01015028","Total",87,32,15,40,9,0,6,3,78,32,9,37
"2011","Plymouth 003D","E01015163","Total",48,21,8,19,3,1,1,1,45,20,7,18
"2011","Plymouth 003E","E01015165","Total",63,27,21,15,3,1,2,0,60,26,19,15
"2011","Plymouth 004A","E01015024","Total",44,13,10,21,7,1,3,3,37,12,7,18
"2011","Plymouth 004B","E01015082","Total",77,25,17,35,3,2,1,0,74,23,16,35
"2011","Plymouth 004C","E01015083","Total",52,16,13,23,11,2,4,5,41,14,9,18
"2011","Plymouth 004D","E01015084","Total",51,19,9,23,4,1,2,1,47,18,7,22
"2011","Plymouth 005A","E01015090","Total",32,15,8,9,3,0,2,1,29,15,6,8
"2011","Plymouth 005B","E01015091","Total",35,17,6,12,2,0,2,0,33,17,4,12
"2011","Plymouth 005C","E01015092","Total",32,14,3,15,0,0,0,0,32,14,3,15
"2011","Plymouth 005D","E01015093","Total",40,18,3,19,5,1,1,3,35,17,2,16
"2011","Plymouth 005E","E01015094","Total",56,19,17,20,3,0,3,0,53,19,14,20
"2011","Plymouth 006A","E01015085","Total",47,17,11,19,7,1,2,4,40,16,9,15
"2011","Plymouth 006B","E01015087","Total",68,23,12,33,10,1,3,6,58,22,9,27
"2011","Plymouth 006C","E01015088","Total",116,32,15,69,8,1,1,6,108,31,14,63
"2011","Plymouth 006D","E01015147","Total",27,12,6,9,4,0,4,0,23,12,2,9
"2011","Plymouth 006E","E01015148","Total",57,24,8,25,5,1,3,1,52,23,5,24
"2011","Plymouth 007A","E01015030","Total",86,30,13,43,11,4,4,3,75,26,9,40
"2011","Plymouth 007B","E01015070","Total",89,38,25,26,9,2,4,3,80,36,21,23
"2011","Plymouth 007C","E01015081","Total",73,37,6,30,5,2,0,3,68,35,6,27
"2011","Plymouth 007D","E01015086","Total",60,19,13,28,8,1,5,2,52,18,8,26
"2011","Plymouth 007E","E01015089","Total",54,30,12,12,3,0,2,1,51,30,10,11
"2011","Plymouth 008A","E01015029","Total",96,42,19,35,2,1,1,0,94,41,18,35
"2011","Plymouth 008B","E01015064","Total",18,8,5,5,2,0,2,0,16,8,3,5
"2011","Plymouth 008C","E01015065","Total",23,8,8,7,4,0,2,2,19,8,6,5
"2011","Plymouth 008D","E01015071","Total",40,12,13,15,3,0,2,1,37,12,11,14
"2011","Plymouth 009A","E01015076","Total",35,13,6,16,2,0,1,1,33,13,5,15
"2011","Plymouth 009B","E01015142","Total",35,12,10,13,4,0,3,1,31,12,7,12
"2011","Plymouth 009C","E01015143","Total",42,17,10,15,8,1,4,3,34,16,6,12
"2011","Plymouth 009D","E01015144","Total",76,23,9,44,13,2,5,6,63,21,4,38
"2011","Plymouth 009E","E01015146","Total",114,43,8,63,5,0,1,4,109,43,7,59
"2011","Plymouth 009F","E01015149","Total",74,26,8,40,10,2,5,3,64,24,3,37
"2011","Plymouth 009G","E01015150","Total",25,9,4,12,2,1,0,1,23,8,4,11
"2011","Plymouth 010A","E01015063","Total",52,19,8,25,2,0,2,0,50,19,6,25
"2011","Plymouth 010B","E01015068","Total",50,26,19,5,3,1,1,1,47,25,18,4
"2011","Plymouth 010C","E01015069","Total",62,24,10,28,8,2,2,4,54,22,8,24
"2011","Plymouth 010D","E01015095","Total",38,19,9,10,3,0,3,0,35,19,6,10
"2011","Plymouth 010E","E01015096","Total",64,23,14,27,2,0,2,0,62,23,12,27
"2011","Plymouth 011A","E01015074","Total",68,34,9,25,4,0,1,3,64,34,8,22
"2011","Plymouth 011B","E01015077","Total",59,18,14,27,8,2,2,4,51,16,12,23
"2011","Plymouth 011C","E01015079","Total",38,16,11,11,5,1,3,1,33,15,8,10
"2011","Plymouth 011D","E01015102","Total",49,25,13,11,2,0,2,0,47,25,11,11
"2011","Plymouth 011E","E01015104","Total",32,13,12,7,5,2,3,0,27,11,9,7
"2011","Plymouth 012A","E01015035","Total",40,17,14,9,5,2,3,0,35,15,11,9
"2011","Plymouth 012B","E01015037","Total",49,17,14,18,8,0,7,1,41,17,7,17
"2011","Plymouth 012C","E01015058","Total",89,26,17,46,8,1,4,3,81,25,13,43
"2011","Plymouth 012D","E01015066","Total",42,19,11,12,3,1,2,0,39,18,9,12
"2011","Plymouth 012E","E01015067","Total",22,12,8,2,1,1,0,0,21,11,8,2
"2011","Plymouth 013A","E01015072","Total",71,26,16,29,7,0,6,1,64,26,10,28
"2011","Plymouth 013B","E01015073","Total",64,28,7,29,9,3,3,3,55,25,4,26
"2011","Plymouth 013C","E01015078","Total",53,23,7,23,2,1,1,0,51,22,6,23
"2011","Plymouth 013D","E01015080","Total",101,20,11,70,9,0,3,6,92,20,8,64
"2011","Plymouth 013E","E01015106","Total",41,21,7,13,1,1,0,0,40,20,7,13
"2011","Plymouth 014A","E01015039","Total",46,16,16,14,4,1,2,1,42,15,14,13
"2011","Plymouth 014B","E01015040","Total",57,13,8,36,4,0,4,0,53,13,4,36
"2011","Plymouth 014C","E01015041","Total",62,22,11,29,3,0,3,0,59,22,8,29
"2011","Plymouth 014D","E01015075","Total",74,29,7,38,2,0,0,2,72,29,7,36
"2011","Plymouth 014E","E01015145","Total",189,46,23,120,16,0,2,14,173,46,21,106
"2011","Plymouth 015A","E01015120","Total",33,20,7,6,2,0,2,0,31,20,5,6
"2011","Plymouth 015B","E01015121","Total",38,23,11,4,5,1,3,1,33,22,8,3
"2011","Plymouth 015C","E01015123","Total",34,15,9,10,4,1,2,1,30,14,7,9
"2011","Plymouth 015D","E01015124","Total",31,17,9,5,3,1,1,1,28,16,8,4
"2011","Plymouth 015E","E01015125","Total",41,16,12,13,6,3,3,0,35,13,9,13
"2011","Plymouth 016A","E01015033","Total",21,9,8,4,2,0,2,0,19,9,6,4
"2011","Plymouth 016B","E01015034","Total",17,5,10,2,3,0,3,0,14,5,7,2
"2011","Plymouth 016C","E01015036","Total",23,9,9,5,3,0,3,0,20,9,6,5
"2011","Plymouth 016D","E01015038","Total",47,17,18,12,12,4,5,3,35,13,13,9
"2011","Plymouth 016E","E01015101","Total",15,8,3,4,2,0,2,0,13,8,1,4
"2011","Plymouth 017A","E01015098","Total",36,12,16,8,4,2,1,1,32,10,15,7
"2011","Plymouth 017B","E01015099","Total",32,13,13,6,4,1,2,1,28,12,11,5
"2011","Plymouth 017C","E01015100","Total",37,12,16,9,3,0,3,0,34,12,13,9
"2011","Plymouth 017D","E01015103","Total",43,17,16,10,6,1,4,1,37,16,12,9
"2011","Plymouth 017E","E01015105","Total",33,14,12,7,1,0,0,1,32,14,12,6
"2011","Plymouth 018A","E01015107","Total",55,27,14,14,4,0,3,1,51,27,11,13
"2011","Plymouth 018B","E01015110","Total",30,17,10,3,2,0,2,0,28,17,8,3
"2011","Plymouth 018C","E01015111","Total",57,25,18,14,3,1,1,1,54,24,17,13
"2011","Plymouth 018D","E01015119","Total",49,19,22,8,6,0,5,1,43,19,17,7
"2011","Plymouth 019A","E01015112","Total",33,13,13,7,6,0,5,1,27,13,8,6
"2011","Plymouth 019B","E01015113","Total",34,21,7,6,4,0,2,2,30,21,5,4
"2011","Plymouth 019C","E01015114","Total",30,14,9,7,1,0,1,0,29,14,8,7
"2011","Plymouth 019D","E01015118","Total",35,15,14,6,5,0,4,1,30,15,10,5
"2011","Plymouth 019E","E01015122","Total",35,25,7,3,3,0,3,0,32,25,4,3
"2011","Plymouth 020A","E01015042","Total",59,16,14,29,6,2,1,3,53,14,13,26
"2011","Plymouth 020B","E01015044","Total",46,18,12,16,4,1,1,2,42,17,11,14
"2011","Plymouth 020C","E01015167","Total",54,25,9,20,7,2,4,1,47,23,5,19
"2011","Plymouth 020D","E01015168","Total",62,24,7,31,10,3,1,6,52,21,6,25
"2011","Plymouth 020E","E01015171","Total",49,17,10,22,2,0,1,1,47,17,9,21
"2011","Plymouth 021A","E01015055","Total",46,15,8,23,4,1,2,1,42,14,6,22
"2011","Plymouth 021B","E01015056","Total",36,8,10,18,2,0,0,2,34,8,10,16
"2011","Plymouth 021C","E01015057","Total",81,30,10,41,4,0,1,3,77,30,9,38
"2011","Plymouth 021D","E01015059","Total",58,22,17,19,8,0,5,3,50,22,12,16
"2011","Plymouth 021E","E01015060","Total",58,23,11,24,2,1,0,1,56,22,11,23
"2011","Plymouth 021F","E01015176","Total",31,20,5,6,2,2,0,0,29,18,5,6
"2011","Plymouth 022A","E01015108","Total",49,24,15,10,3,0,3,0,46,24,12,10
"2011","Plymouth 022B","E01015109","Total",50,20,13,17,4,0,4,0,46,20,9,17
"2011","Plymouth 022C","E01015115","Total",35,16,9,10,4,1,1,2,31,15,8,8
"2011","Plymouth 022D","E01015116","Total",36,18,7,11,2,0,2,0,34,18,5,11
"2011","Plymouth 022E","E01015117","Total",40,20,10,10,2,0,0,2,38,20,10,8
"2011","Plymouth 023A","E01015031","Total",18,9,6,3,1,0,0,1,17,9,6,2
"2011","Plymouth 023B","E01015032","Total",25,11,6,8,3,1,2,0,22,10,4,8
"2011","Plymouth 023C","E01015049","Total",19,10,6,3,2,0,1,1,17,10,5,2
"2011","Plymouth 023D","E01015050","Total",11,6,3,2,1,0,1,0,10,6,2,2
"2011","Plymouth 023E","E01015051","Total",18,3,6,9,1,0,0,1,17,3,6,8
"2011","Plymouth 024A","E01015169","Total",31,14,11,6,5,2,2,1,26,12,9,5
"2011","Plymouth 024B","E01015170","Total",64,20,14,30,5,1,2,2,59,19,12,28
"2011","Plymouth 024C","E01015173","Total",47,18,12,17,5,1,2,2,42,17,10,15
"2011","Plymouth 024D","E01015174","Total",38,18,15,5,4,0,4,0,34,18,11,5
"2011","Plymouth 025A","E01015061","Total",53,22,10,21,4,1,3,0,49,21,7,21
"2011","Plymouth 025B","E01015062","Total",29,9,7,13,4,1,3,0,25,8,4,13
"2011","Plymouth 025C","E01015175","Total",40,17,12,11,5,2,1,2,35,15,11,9
"2011","Plymouth 025D","E01015177","Total",37,12,9,16,2,0,2,0,35,12,7,16
"2011","Plymouth 025E","E01015178","Total",36,11,12,13,9,1,6,2,27,10,6,11
"2011","Plymouth 026A","E01015043","Total",105,33,15,57,17,6,5,6,88,27,10,51
"2011","Plymouth 026B","E01015045","Total",95,28,11,56,16,4,4,8,79,24,7,48
"2011","Plymouth 026C","E01015046","Total",88,23,12,53,9,1,4,4,79,22,8,49
"2011","Plymouth 026D","E01015047","Total",101,35,17,49,8,2,5,1,93,33,12,48
"2011","Plymouth 026E","E01015048","Total",71,20,13,38,6,1,1,4,65,19,12,34
"2011","Plymouth 027A","E01015053","Total",23,8,4,11,2,0,2,0,21,8,2,11
"2011","Plymouth 027B","E01015054","Total",13,2,4,7,4,0,2,2,9,2,2,5
"2011","Plymouth 027C","E01015152","Total",93,21,15,57,9,2,1,6,84,19,14,51
"2011","Plymouth 027E","E01015156","Total",22,2,2,18,1,0,0,1,21,2,2,17
"2011","Plymouth 027F","E01032657","Total",17,4,4,9,5,0,3,2,12,4,1,7
"2011","Plymouth 027G","E01032658","Total",41,12,8,21,5,2,1,2,36,10,7,19
"2011","Plymouth 028A","E01015052","Total",29,13,2,14,7,1,1,5,22,12,1,9
"2011","Plymouth 028B","E01015179","Total",39,16,13,10,6,2,4,0,33,14,9,10
"2011","Plymouth 028C","E01015180","Total",79,28,10,41,4,1,2,1,75,27,8,40
"2011","Plymouth 028D","E01015181","Total",64,21,9,34,4,2,1,1,60,19,8,33
"2011","Plymouth 028E","E01015182","Total",67,31,10,26,8,3,3,2,59,28,7,24
"2011","Plymouth 029A","E01015151","Total",57,23,7,27,11,1,3,7,46,22,4,20
"2011","Plymouth 029B","E01015153","Total",84,25,19,40,7,0,4,3,77,25,15,37
"2011","Plymouth 029C","E01015155","Total",90,26,12,52,13,1,4,8,77,25,8,44
"2011","Plymouth 029D","E01015157","Total",52,14,11,27,8,2,4,2,44,12,7,25
"2011","Plymouth 029E","E01015158","Total",40,7,11,22,4,0,2,2,36,7,9,20
"2011","Plymouth 029F","E01015172","Total",41,11,12,18,5,2,3,0,36,9,9,18
"2011","Plymouth 030A","E01015126","Total",20,14,2,4,0,0,0,0,20,14,2,4
"2011","Plymouth 030B","E01015127","Total",46,26,10,10,4,2,2,0,42,24,8,10
"2011","Plymouth 030C","E01015131","Total",9,4,3,2,0,0,0,0,9,4,3,2
"2011","Plymouth 030D","E01015132","Total",21,9,6,6,3,0,2,1,18,9,4,5
"2011","Plymouth 030E","E01015133","Total",26,11,9,6,2,0,2,0,24,11,7,6
"2011","Plymouth 031A","E01015135","Total",38,17,11,10,5,2,3,0,33,15,8,10
"2011","Plymouth 031B","E01015136","Total",39,16,13,10,3,0,2,1,36,16,11,9
"2011","Plymouth 031C","E01015137","Total",32,13,9,10,4,1,1,2,28,12,8,8
"2011","Plymouth 031D","E01015138","Total",19,7,5,7,2,0,2,0,17,7,3,7
"2011","Plymouth 031E","E01015139","Total",53,24,11,18,6,0,4,2,47,24,7,16
"2011","Plymouth 031F","E01015141","Total",23,5,12,6,3,0,3,0,20,5,9,6
"2011","Plymouth 032A","E01015128","Total",24,12,9,3,4,0,4,0,20,12,5,3
"2011","Plymouth 032B","E01015129","Total",71,40,14,17,3,1,2,0,68,39,12,17
"2011","Plymouth 032C","E01015130","Total",34,22,12,0,5,0,5,0,29,22,7,0
"2011","Plymouth 032D","E01015134","Total",39,14,18,7,1,0,1,0,38,14,17,7
"2011","Plymouth 032E","E01015140","Total",15,9,4,2,1,1,0,0,14,8,4,2
"2011","Poole 001A","E01015431","Total",16,8,5,3,3,0,1,2,13,8,4,1
"2011","Poole 001B","E01015432","Total",31,18,4,9,8,1,0,7,23,17,4,2
"2011","Poole 001C","E01015433","Total",6,0,3,3,1,0,1,0,5,0,2,3
"2011","Poole 001D","E01015434","Total",23,12,10,1,4,0,4,0,19,12,6,1
"2011","Poole 002A","E01015379","Total",43,12,3,28,4,1,1,2,39,11,2,26
"2011","Poole 002B","E01015435","Total",53,28,3,22,5,0,2,3,48,28,1,19
"2011","Poole 002C","E01015436","Total",27,11,10,6,4,2,1,1,23,9,9,5
"2011","Poole 002D","E01015437","Total",20,7,8,5,3,0,3,0,17,7,5,5
"2011","Poole 003A","E01015395","Total",19,10,7,2,1,0,1,0,18,10,6,2
"2011","Poole 003B","E01015396","Total",18,8,7,3,1,0,1,0,17,8,6,3
"2011","Poole 003C","E01015397","Total",16,6,6,4,4,0,4,0,12,6,2,4
"2011","Poole 003D","E01015398","Total",17,14,2,1,1,0,1,0,16,14,1,1
"2011","Poole 003E","E01015399","Total",18,7,9,2,3,0,2,1,15,7,7,1
"2011","Poole 003F","E01015400","Total",17,6,6,5,1,0,1,0,16,6,5,5
"2011","Poole 003G","E01015401","Total",18,9,8,1,4,0,4,0,14,9,4,1
"2011","Poole 004A","E01015412","Total",11,7,3,1,0,0,0,0,11,7,3,1
"2011","Poole 004B","E01015413","Total",50,21,15,14,7,0,6,1,43,21,9,13
"2011","Poole 004C","E01015414","Total",49,19,8,22,5,1,3,1,44,18,5,21
"2011","Poole 004D","E01015415","Total",63,29,5,29,8,3,0,5,55,26,5,24
"2011","Poole 004E","E01015416","Total",19,13,1,5,0,0,0,0,19,13,1,5
"2011","Poole 005A","E01015407","Total",33,10,10,13,4,2,2,0,29,8,8,13
"2011","Poole 005B","E01015408","Total",30,11,10,9,3,0,2,1,27,11,8,8
"2011","Poole 005C","E01015409","Total",78,34,11,33,5,0,2,3,73,34,9,30
"2011","Poole 005D","E01015410","Total",52,33,7,12,6,2,3,1,46,31,4,11
"2011","Poole 005E","E01015411","Total",39,29,3,7,0,0,0,0,39,29,3,7
"2011","Poole 006A","E01015417","Total",43,19,9,15,3,1,2,0,40,18,7,15
"2011","Poole 006B","E01015418","Total",31,19,5,7,4,3,1,0,27,16,4,7
"2011","Poole 006C","E01015419","Total",41,23,13,5,7,1,5,1,34,22,8,4
"2011","Poole 006D","E01015420","Total",55,24,7,24,4,1,2,1,51,23,5,23
"2011","Poole 006E","E01015421","Total",23,11,1,11,0,0,0,0,23,11,1,11
"2011","Poole 006F","E01015422","Total",45,17,17,11,3,1,2,0,42,16,15,11
"2011","Poole 007A","E01015380","Total",27,14,5,8,3,0,2,1,24,14,3,7
"2011","Poole 007B","E01015381","Total",52,20,11,21,4,2,2,0,48,18,9,21
"2011","Poole 007C","E01015382","Total",98,31,12,55,6,1,2,3,92,30,10,52
"2011","Poole 007D","E01015383","Total",22,16,3,3,1,1,0,0,21,15,3,3
"2011","Poole 007E","E01015384","Total",89,35,9,45,8,3,4,1,81,32,5,44
"2011","Poole 007F","E01015385","Total",57,30,5,22,6,5,1,0,51,25,4,22
"2011","Poole 008A","E01015438","Total",30,14,7,9,1,0,0,1,29,14,7,8
"2011","Poole 008B","E01015439","Total",46,12,10,24,4,1,1,2,42,11,9,22
"2011","Poole 008C","E01015441","Total",56,19,5,32,6,0,2,4,50,19,3,28
"2011","Poole 008D","E01015442","Total",68,32,10,26,1,0,0,1,67,32,10,25
"2011","Poole 008E","E01015443","Total",58,16,4,38,6,0,2,4,52,16,2,34
"2011","Poole 008F","E01015444","Total",45,17,12,16,5,2,0,3,40,15,12,13
"2011","Poole 009A","E01015386","Total",64,20,14,30,5,1,4,0,59,19,10,30
"2011","Poole 009B","E01015387","Total",31,14,5,12,0,0,0,0,31,14,5,12
"2011","Poole 009C","E01015388","Total",27,13,7,7,5,1,4,0,22,12,3,7
"2011","Poole 009D","E01015389","Total",20,9,8,3,3,0,3,0,17,9,5,3
"2011","Poole 010A","E01015390","Total",56,25,8,23,6,6,0,0,50,19,8,23
"2011","Poole 010B","E01015391","Total",25,13,6,6,6,1,3,2,19,12,3,4
"2011","Poole 010C","E01015392","Total",39,16,13,10,3,0,3,0,36,16,10,10
"2011","Poole 010D","E01015393","Total",35,12,9,14,5,0,5,0,30,12,4,14
"2011","Poole 010E","E01015394","Total",47,23,12,12,5,3,2,0,42,20,10,12
"2011","Poole 011A","E01015440","Total",62,24,11,27,3,0,2,1,59,24,9,26
"2011","Poole 011B","E01015447","Total",27,15,7,5,1,1,0,0,26,14,7,5
"2011","Poole 011C","E01015449","Total",62,30,7,25,4,0,2,2,58,30,5,23
"2011","Poole 011D","E01015456","Total",54,22,7,25,2,0,1,1,52,22,6,24
"2011","Poole 011E","E01015457","Total",26,9,5,12,2,0,1,1,24,9,4,11
"2011","Poole 012A","E01015445","Total",22,10,6,6,2,0,2,0,20,10,4,6
"2011","Poole 012B","E01015446","Total",26,11,5,10,2,0,2,0,24,11,3,10
"2011","Poole 012C","E01015448","Total",40,16,8,16,4,1,3,0,36,15,5,16
"2011","Poole 012D","E01015450","Total",42,19,8,15,4,1,2,1,38,18,6,14
"2011","Poole 012E","E01015451","Total",18,8,7,3,3,0,3,0,15,8,4,3
"2011","Poole 013A","E01015458","Total",18,5,8,5,3,1,2,0,15,4,6,5
"2011","Poole 013B","E01015460","Total",65,23,21,21,11,3,5,3,54,20,16,18
"2011","Poole 013C","E01015461","Total",44,22,10,12,5,0,4,1,39,22,6,11
"2011","Poole 013D","E01015462","Total",27,5,14,8,5,1,3,1,22,4,11,7
"2011","Poole 013E","E01015463","Total",21,9,8,4,4,1,2,1,17,8,6,3
"2011","Poole 013F","E01015464","Total",27,11,10,6,5,1,4,0,22,10,6,6
"2011","Poole 014A","E01015427","Total",52,20,10,22,5,1,3,1,47,19,7,21
"2011","Poole 014B","E01015428","Total",56,13,23,20,10,1,6,3,46,12,17,17
"2011","Poole 014C","E01015429","Total",63,26,9,28,10,3,3,4,53,23,6,24
"2011","Poole 014D","E01015430","Total",79,25,8,46,11,3,2,6,68,22,6,40
"2011","Poole 015A","E01015465","Total",47,19,9,19,7,0,4,3,40,19,5,16
"2011","Poole 015B","E01015466","Total",27,12,4,11,1,1,0,0,26,11,4,11
"2011","Poole 015D","E01015468","Total",56,29,11,16,3,1,2,0,53,28,9,16
"2011","Poole 015F","E01032659","Total",36,12,8,16,4,0,3,1,32,12,5,15
"2011","Poole 015G","E01032660","Total",47,16,11,20,3,0,1,2,44,16,10,18
"2011","Poole 015H","E01032661","Total",20,12,3,5,2,0,0,2,18,12,3,3
"2011","Poole 015I","E01032662","Total",37,10,7,20,3,0,2,1,34,10,5,19
"2011","Poole 016A","E01015423","Total",69,24,14,31,6,0,3,3,63,24,11,28
"2011","Poole 016B","E01015424","Total",47,11,14,22,7,0,2,5,40,11,12,17
"2011","Poole 016C","E01015425","Total",38,18,6,14,2,1,0,1,36,17,6,13
"2011","Poole 016D","E01015426","Total",38,11,6,21,3,0,3,0,35,11,3,21
"2011","Poole 017A","E01015452","Total",27,12,9,6,2,0,2,0,25,12,7,6
"2011","Poole 017B","E01015453","Total",55,19,16,20,6,1,4,1,49,18,12,19
"2011","Poole 017C","E01015454","Total",43,14,12,17,6,2,4,0,37,12,8,17
"2011","Poole 017D","E01015455","Total",43,14,17,12,9,2,7,0,34,12,10,12
"2011","Poole 017E","E01015459","Total",23,10,7,6,11,4,5,2,12,6,2,4
"2011","Poole 018A","E01015402","Total",22,8,5,9,3,1,2,0,19,7,3,9
"2011","Poole 018B","E01015403","Total",17,8,3,6,2,0,1,1,15,8,2,5
"2011","Poole 018C","E01015404","Total",19,1,7,11,1,0,1,0,18,1,6,11
"2011","Poole 018D","E01015405","Total",11,7,1,3,0,0,0,0,11,7,1,3
"2011","Poole 018E","E01015406","Total",36,9,8,19,7,1,4,2,29,8,4,17
"2011","South Gloucestershire 001A","E01014985","Total",28,12,13,3,7,1,6,0,21,11,7,3
"2011","South Gloucestershire 001B","E01014986","Total",55,21,14,20,5,1,4,0,50,20,10,20
"2011","South Gloucestershire 001C","E01014987","Total",26,11,10,5,6,1,2,3,20,10,8,2
"2011","South Gloucestershire 001D","E01014988","Total",22,17,3,2,0,0,0,0,22,17,3,2
"2011","South Gloucestershire 001E","E01014989","Total",7,2,4,1,1,0,1,0,6,2,3,1
"2011","South Gloucestershire 002A","E01014990","Total",27,10,14,3,10,2,7,1,17,8,7,2
"2011","South Gloucestershire 002B","E01014991","Total",82,27,27,28,11,0,7,4,71,27,20,24
"2011","South Gloucestershire 002C","E01014992","Total",30,12,10,8,3,0,1,2,27,12,9,6
"2011","South Gloucestershire 002D","E01014993","Total",23,12,8,3,1,0,0,1,22,12,8,2
"2011","South Gloucestershire 003A","E01014884","Total",30,14,6,10,2,1,1,0,28,13,5,10
"2011","South Gloucestershire 003B","E01014885","Total",37,22,11,4,4,1,2,1,33,21,9,3
"2011","South Gloucestershire 003C","E01014929","Total",43,17,9,17,9,2,5,2,34,15,4,15
"2011","South Gloucestershire 003D","E01014930","Total",46,21,11,14,4,0,1,3,42,21,10,11
"2011","South Gloucestershire 004A","E01014863","Total",23,12,4,7,3,1,1,1,20,11,3,6
"2011","South Gloucestershire 004B","E01014864","Total",15,7,4,4,2,0,1,1,13,7,3,3
"2011","South Gloucestershire 004C","E01014962","Total",17,9,8,0,1,0,1,0,16,9,7,0
"2011","South Gloucestershire 004D","E01014963","Total",36,20,13,3,0,0,0,0,36,20,13,3
"2011","South Gloucestershire 005A","E01014861","Total",41,18,9,14,4,1,2,1,37,17,7,13
"2011","South Gloucestershire 005B","E01014862","Total",81,23,26,32,13,2,10,1,68,21,16,31
"2011","South Gloucestershire 005C","E01014953","Total",47,21,15,11,7,1,4,2,40,20,11,9
"2011","South Gloucestershire 005D","E01014954","Total",44,16,9,19,3,0,2,1,41,16,7,18
"2011","South Gloucestershire 006A","E01015014","Total",19,9,7,3,1,0,1,0,18,9,6,3
"2011","South Gloucestershire 006B","E01015015","Total",35,13,12,10,3,0,3,0,32,13,9,10
"2011","South Gloucestershire 006C","E01015016","Total",13,8,2,3,1,1,0,0,12,7,2,3
"2011","South Gloucestershire 006D","E01015017","Total",31,12,8,11,4,0,2,2,27,12,6,9
"2011","South Gloucestershire 006E","E01015018","Total",32,12,9,11,0,0,0,0,32,12,9,11
"2011","South Gloucestershire 007A","E01015019","Total",81,20,23,38,8,1,6,1,73,19,17,37
"2011","South Gloucestershire 007B","E01015020","Total",74,26,12,36,6,0,2,4,68,26,10,32
"2011","South Gloucestershire 007C","E01015021","Total",27,13,11,3,4,0,4,0,23,13,7,3
"2011","South Gloucestershire 007D","E01015022","Total",42,18,11,13,7,0,7,0,35,18,4,13
"2011","South Gloucestershire 008A","E01014886","Total",51,21,16,14,3,0,2,1,48,21,14,13
"2011","South Gloucestershire 008B","E01014887","Total",15,2,8,5,3,0,3,0,12,2,5,5
"2011","South Gloucestershire 008C","E01014888","Total",11,8,3,0,0,0,0,0,11,8,3,0
"2011","South Gloucestershire 008D","E01014889","Total",33,18,11,4,7,1,5,1,26,17,6,3
"2011","South Gloucestershire 009A","E01014872","Total",49,22,17,10,4,0,4,0,45,22,13,10
"2011","South Gloucestershire 009B","E01014874","Total",38,15,14,9,7,1,4,2,31,14,10,7
"2011","South Gloucestershire 009C","E01014876","Total",67,23,22,22,5,0,5,0,62,23,17,22
"2011","South Gloucestershire 009D","E01014877","Total",48,21,21,6,6,0,5,1,42,21,16,5
"2011","South Gloucestershire 009E","E01014879","Total",27,10,13,4,3,0,3,0,24,10,10,4
"2011","South Gloucestershire 009F","E01014881","Total",46,18,17,11,3,0,3,0,43,18,14,11
"2011","South Gloucestershire 010A","E01015009","Total",32,10,12,10,1,0,1,0,31,10,11,10
"2011","South Gloucestershire 010B","E01015010","Total",41,19,9,13,3,0,2,1,38,19,7,12
"2011","South Gloucestershire 010C","E01015011","Total",52,22,9,21,5,2,0,3,47,20,9,18
"2011","South Gloucestershire 010D","E01015012","Total",15,9,2,4,3,1,1,1,12,8,1,3
"2011","South Gloucestershire 010E","E01015013","Total",52,29,9,14,6,1,5,0,46,28,4,14
"2011","South Gloucestershire 011A","E01014946","Total",64,24,17,23,5,0,4,1,59,24,13,22
"2011","South Gloucestershire 011B","E01014947","Total",17,2,10,5,5,0,3,2,12,2,7,3
"2011","South Gloucestershire 011C","E01014948","Total",90,28,14,48,9,0,1,8,81,28,13,40
"2011","South Gloucestershire 011D","E01014949","Total",41,13,11,17,5,0,4,1,36,13,7,16
"2011","South Gloucestershire 011E","E01014950","Total",38,18,9,11,3,1,2,0,35,17,7,11
"2011","South Gloucestershire 011F","E01014951","Total",62,26,15,21,6,0,5,1,56,26,10,20
"2011","South Gloucestershire 011G","E01014952","Total",33,14,14,5,5,0,5,0,28,14,9,5
"2011","South Gloucestershire 012A","E01014873","Total",26,9,13,4,6,1,4,1,20,8,9,3
"2011","South Gloucestershire 012B","E01014875","Total",57,19,20,18,6,2,3,1,51,17,17,17
"2011","South Gloucestershire 012C","E01014878","Total",54,24,15,15,2,0,2,0,52,24,13,15
"2011","South Gloucestershire 012D","E01014880","Total",69,25,25,19,8,1,5,2,61,24,20,17
"2011","South Gloucestershire 012E","E01014882","Total",102,37,18,47,2,1,1,0,100,36,17,47
"2011","South Gloucestershire 012F","E01014883","Total",26,11,6,9,1,0,1,0,25,11,5,9
"2011","South Gloucestershire 013A","E01014911","Total",18,7,7,4,1,0,1,0,17,7,6,4
"2011","South Gloucestershire 013B","E01014912","Total",37,17,14,6,4,2,2,0,33,15,12,6
"2011","South Gloucestershire 013C","E01014913","Total",34,16,11,7,3,0,2,1,31,16,9,6
"2011","South Gloucestershire 013D","E01014914","Total",55,21,7,27,6,2,2,2,49,19,5,25
"2011","South Gloucestershire 014A","E01014892","Total",68,33,10,25,7,2,3,2,61,31,7,23
"2011","South Gloucestershire 014B","E01014893","Total",43,20,9,14,6,2,4,0,37,18,5,14
"2011","South Gloucestershire 014C","E01014894","Total",40,17,13,10,5,0,5,0,35,17,8,10
"2011","South Gloucestershire 014D","E01014895","Total",43,13,19,11,6,0,4,2,37,13,15,9
"2011","South Gloucestershire 014E","E01014896","Total",47,22,13,12,7,0,6,1,40,22,7,11
"2011","South Gloucestershire 015A","E01014979","Total",41,21,12,8,6,1,2,3,35,20,10,5
"2011","South Gloucestershire 015B","E01014980","Total",27,12,10,5,1,0,1,0,26,12,9,5
"2011","South Gloucestershire 015C","E01014982","Total",33,14,12,7,2,0,2,0,31,14,10,7
"2011","South Gloucestershire 015D","E01014983","Total",73,27,22,24,5,1,3,1,68,26,19,23
"2011","South Gloucestershire 015E","E01014984","Total",42,21,12,9,4,0,2,2,38,21,10,7
"2011","South Gloucestershire 016A","E01014998","Total",38,16,13,9,4,1,3,0,34,15,10,9
"2011","South Gloucestershire 016B","E01014999","Total",28,16,9,3,6,1,5,0,22,15,4,3
"2011","South Gloucestershire 016C","E01015000","Total",46,14,14,18,3,0,3,0,43,14,11,18
"2011","South Gloucestershire 016D","E01015001","Total",41,17,15,9,6,0,6,0,35,17,9,9
"2011","South Gloucestershire 017A","E01014978","Total",28,8,9,11,5,1,3,1,23,7,6,10
"2011","South Gloucestershire 017B","E01014981","Total",112,48,34,30,12,2,7,3,100,46,27,27
"2011","South Gloucestershire 017C","E01014996","Total",18,4,8,6,2,0,2,0,16,4,6,6
"2011","South Gloucestershire 017E","E01033331","Total",31,11,7,13,3,1,1,1,28,10,6,12
"2011","South Gloucestershire 017F","E01033333","Total",29,9,7,13,3,0,1,2,26,9,6,11
"2011","South Gloucestershire 018A","E01014904","Total",42,16,6,20,4,0,2,2,38,16,4,18
"2011","South Gloucestershire 018B","E01014905","Total",22,13,5,4,5,1,2,2,17,12,3,2
"2011","South Gloucestershire 018C","E01014906","Total",67,25,17,25,9,3,3,3,58,22,14,22
"2011","South Gloucestershire 018D","E01014907","Total",34,12,16,6,6,0,6,0,28,12,10,6
"2011","South Gloucestershire 018E","E01014908","Total",20,8,9,3,4,2,2,0,16,6,7,3
"2011","South Gloucestershire 018F","E01014909","Total",32,12,8,12,1,0,1,0,31,12,7,12
"2011","South Gloucestershire 018G","E01014910","Total",53,16,15,22,8,0,6,2,45,16,9,20
"2011","South Gloucestershire 019A","E01014867","Total",22,7,5,10,2,0,2,0,20,7,3,10
"2011","South Gloucestershire 019B","E01014868","Total",43,18,16,9,4,0,3,1,39,18,13,8
"2011","South Gloucestershire 019D","E01014994","Total",18,8,4,6,2,0,2,0,16,8,2,6
"2011","South Gloucestershire 019E","E01014995","Total",14,7,6,1,3,0,3,0,11,7,3,1
"2011","South Gloucestershire 019F","E01033338","Total",46,14,18,14,1,0,1,0,45,14,17,14
"2011","South Gloucestershire 019G","E01033339","Total",69,27,13,29,6,0,3,3,63,27,10,26
"2011","South Gloucestershire 020A","E01014901","Total",26,13,9,4,6,0,6,0,20,13,3,4
"2011","South Gloucestershire 020B","E01014902","Total",14,4,8,2,4,0,3,1,10,4,5,1
"2011","South Gloucestershire 020C","E01014903","Total",13,5,6,2,2,1,1,0,11,4,5,2
"2011","South Gloucestershire 020D","E01014965","Total",23,11,10,2,1,0,1,0,22,11,9,2
"2011","South Gloucestershire 021A","E01014964","Total",41,17,17,7,4,1,3,0,37,16,14,7
"2011","South Gloucestershire 021B","E01014966","Total",55,28,21,6,7,1,6,0,48,27,15,6
"2011","South Gloucestershire 021C","E01014967","Total",37,17,10,10,4,0,2,2,33,17,8,8
"2011","South Gloucestershire 021D","E01014969","Total",30,15,11,4,2,1,1,0,28,14,10,4
"2011","South Gloucestershire 021F","E01033334","Total",39,16,15,8,7,0,6,1,32,16,9,7
"2011","South Gloucestershire 021G","E01033336","Total",54,29,17,8,5,0,3,2,49,29,14,6
"2011","South Gloucestershire 022A","E01014897","Total",24,11,6,7,3,1,2,0,21,10,4,7
"2011","South Gloucestershire 022B","E01014898","Total",26,11,7,8,2,0,1,1,24,11,6,7
"2011","South Gloucestershire 022C","E01014899","Total",27,12,9,6,1,0,1,0,26,12,8,6
"2011","South Gloucestershire 022D","E01014900","Total",18,6,7,5,2,0,1,1,16,6,6,4
"2011","South Gloucestershire 023A","E01014959","Total",38,22,7,9,0,0,0,0,38,22,7,9
"2011","South Gloucestershire 023B","E01014960","Total",53,16,13,24,7,1,3,3,46,15,10,21
"2011","South Gloucestershire 023C","E01014961","Total",67,21,14,32,8,1,5,2,59,20,9,30
"2011","South Gloucestershire 023D","E01014968","Total",78,29,20,29,9,3,3,3,69,26,17,26
"2011","South Gloucestershire 024A","E01014865","Total",62,18,14,30,15,5,6,4,47,13,8,26
"2011","South Gloucestershire 024B","E01014869","Total",43,13,15,15,5,0,5,0,38,13,10,15
"2011","South Gloucestershire 024C","E01014870","Total",19,7,1,11,2,0,0,2,17,7,1,9
"2011","South Gloucestershire 024D","E01014871","Total",29,17,6,6,4,0,4,0,25,17,2,6
"2011","South Gloucestershire 024E","E01014890","Total",29,8,9,12,5,0,5,0,24,8,4,12
"2011","South Gloucestershire 024F","E01014891","Total",18,3,9,6,1,0,1,0,17,3,8,6
"2011","South Gloucestershire 025A","E01014955","Total",19,5,8,6,2,0,2,0,17,5,6,6
"2011","South Gloucestershire 025B","E01014956","Total",41,23,8,10,6,3,1,2,35,20,7,8
"2011","South Gloucestershire 025C","E01014957","Total",29,10,13,6,3,0,2,1,26,10,11,5
"2011","South Gloucestershire 025D","E01014974","Total",24,11,6,7,1,0,1,0,23,11,5,7
"2011","South Gloucestershire 025E","E01014977","Total",77,22,10,45,4,1,2,1,73,21,8,44
"2011","South Gloucestershire 026A","E01014922","Total",45,20,13,12,7,2,5,0,38,18,8,12
"2011","South Gloucestershire 026B","E01014923","Total",77,36,19,22,7,1,4,2,70,35,15,20
"2011","South Gloucestershire 026C","E01014924","Total",58,21,13,24,5,3,2,0,53,18,11,24
"2011","South Gloucestershire 026D","E01014973","Total",39,10,9,20,5,0,3,2,34,10,6,18
"2011","South Gloucestershire 026E","E01014975","Total",52,24,17,11,10,2,7,1,42,22,10,10
"2011","South Gloucestershire 026F","E01014976","Total",50,18,15,17,4,0,3,1,46,18,12,16
"2011","South Gloucestershire 027A","E01014925","Total",45,21,9,15,2,0,2,0,43,21,7,15
"2011","South Gloucestershire 027B","E01014926","Total",101,29,16,56,4,1,0,3,97,28,16,53
"2011","South Gloucestershire 027C","E01014927","Total",57,20,19,18,6,0,6,0,51,20,13,18
"2011","South Gloucestershire 027D","E01014928","Total",51,17,11,23,4,1,2,1,47,16,9,22
"2011","South Gloucestershire 027E","E01014958","Total",54,14,10,30,3,0,1,2,51,14,9,28
"2011","South Gloucestershire 028A","E01014915","Total",41,22,7,12,4,0,0,4,37,22,7,8
"2011","South Gloucestershire 028B","E01015003","Total",25,16,4,5,1,1,0,0,24,15,4,5
"2011","South Gloucestershire 028C","E01015005","Total",75,28,15,32,6,0,2,4,69,28,13,28
"2011","South Gloucestershire 028D","E01015007","Total",82,32,13,37,5,1,3,1,77,31,10,36
"2011","South Gloucestershire 028E","E01015008","Total",51,13,11,27,3,0,1,2,48,13,10,25
"2011","South Gloucestershire 029A","E01014943","Total",60,30,18,12,7,1,6,0,53,29,12,12
"2011","South Gloucestershire 029B","E01014944","Total",49,22,15,12,2,0,1,1,47,22,14,11
"2011","South Gloucestershire 029C","E01014972","Total",33,19,10,4,6,3,3,0,27,16,7,4
"2011","South Gloucestershire 029D","E01015002","Total",64,25,20,19,3,1,2,0,61,24,18,19
"2011","South Gloucestershire 029E","E01015004","Total",54,17,15,22,5,0,4,1,49,17,11,21
"2011","South Gloucestershire 029F","E01015006","Total",53,24,16,13,13,5,7,1,40,19,9,12
"2011","South Gloucestershire 030A","E01014936","Total",36,13,11,12,3,0,3,0,33,13,8,12
"2011","South Gloucestershire 030B","E01014938","Total",53,22,10,21,1,0,0,1,52,22,10,20
"2011","South Gloucestershire 030C","E01014939","Total",53,19,16,18,7,1,5,1,46,18,11,17
"2011","South Gloucestershire 030D","E01014940","Total",29,13,12,4,9,0,9,0,20,13,3,4
"2011","South Gloucestershire 030E","E01014941","Total",80,27,11,42,10,1,3,6,70,26,8,36
"2011","South Gloucestershire 030F","E01014942","Total",65,25,8,32,4,0,1,3,61,25,7,29
"2011","South Gloucestershire 030G","E01014945","Total",58,24,17,17,9,1,6,2,49,23,11,15
"2011","South Gloucestershire 031A","E01014916","Total",41,23,6,12,4,0,1,3,37,23,5,9
"2011","South Gloucestershire 031B","E01014917","Total",44,18,10,16,4,0,2,2,40,18,8,14
"2011","South Gloucestershire 031C","E01014918","Total",22,16,3,3,1,1,0,0,21,15,3,3
"2011","South Gloucestershire 031D","E01014919","Total",17,6,7,4,4,2,2,0,13,4,5,4
"2011","South Gloucestershire 031E","E01014920","Total",21,8,6,7,7,1,3,3,14,7,3,4
"2011","South Gloucestershire 031F","E01014921","Total",24,11,2,11,4,0,1,3,20,11,1,8
"2011","South Gloucestershire 032A","E01014866","Total",34,16,9,9,2,0,2,0,32,16,7,9
"2011","South Gloucestershire 032B","E01014931","Total",18,7,4,7,2,0,2,0,16,7,2,7
"2011","South Gloucestershire 032C","E01014932","Total",31,11,14,6,3,0,3,0,28,11,11,6
"2011","South Gloucestershire 032D","E01014933","Total",29,16,7,6,3,0,3,0,26,16,4,6
"2011","South Gloucestershire 032E","E01014934","Total",5,2,2,1,1,0,1,0,4,2,1,1
"2011","South Gloucestershire 032F","E01014935","Total",38,17,17,4,7,2,5,0,31,15,12,4
"2011","South Gloucestershire 032G","E01014937","Total",25,13,9,3,1,0,1,0,24,13,8,3
"2011","Swindon 001A","E01015519","Total",30,16,5,9,2,0,1,1,28,16,4,8
"2011","Swindon 001B","E01015520","Total",26,7,11,8,4,1,3,0,22,6,8,8
"2011","Swindon 001C","E01015521","Total",27,10,9,8,3,1,0,2,24,9,9,6
"2011","Swindon 001D","E01015522","Total",46,18,12,16,2,0,1,1,44,18,11,15
"2011","Swindon 001E","E01015523","Total",24,10,8,6,6,0,4,2,18,10,4,4
"2011","Swindon 001F","E01015524","Total",27,8,12,7,2,0,2,0,25,8,10,7
"2011","Swindon 003A","E01015543","Total",47,11,8,28,4,0,3,1,43,11,5,27
"2011","Swindon 003B","E01015544","Total",90,31,16,43,5,1,2,2,85,30,14,41
"2011","Swindon 003C","E01015545","Total",116,29,21,66,8,0,8,0,108,29,13,66
"2011","Swindon 003D","E01015546","Total",122,30,10,82,4,0,1,3,118,30,9,79
"2011","Swindon 004A","E01015513","Total",47,20,14,13,5,1,2,2,42,19,12,11
"2011","Swindon 004B","E01015514","Total",17,6,9,2,5,0,4,1,12,6,5,1
"2011","Swindon 004C","E01015515","Total",24,8,10,6,1,0,0,1,23,8,10,5
"2011","Swindon 004D","E01015516","Total",33,12,17,4,5,0,5,0,28,12,12,4
"2011","Swindon 004E","E01015517","Total",20,9,5,6,3,0,2,1,17,9,3,5
"2011","Swindon 005A","E01015555","Total",32,10,12,10,1,0,1,0,31,10,11,10
"2011","Swindon 005B","E01015556","Total",31,11,8,12,2,0,2,0,29,11,6,12
"2011","Swindon 005C","E01015557","Total",26,9,13,4,6,1,4,1,20,8,9,3
"2011","Swindon 005D","E01015558","Total",69,23,13,33,6,0,1,5,63,23,12,28
"2011","Swindon 005E","E01015559","Total",26,10,7,9,3,1,2,0,23,9,5,9
"2011","Swindon 005F","E01015560","Total",33,13,9,11,4,0,1,3,29,13,8,8
"2011","Swindon 006A","E01015526","Total",43,13,13,17,3,1,2,0,40,12,11,17
"2011","Swindon 006B","E01015528","Total",75,21,13,41,8,0,6,2,67,21,7,39
"2011","Swindon 006C","E01015529","Total",38,9,15,14,6,0,4,2,32,9,11,12
"2011","Swindon 006D","E01015530","Total",41,10,8,23,4,2,2,0,37,8,6,23
"2011","Swindon 007A","E01015506","Total",51,12,11,28,5,0,1,4,46,12,10,24
"2011","Swindon 007B","E01015507","Total",106,38,14,54,3,1,1,1,103,37,13,53
"2011","Swindon 007C","E01015527","Total",65,22,11,32,10,1,6,3,55,21,5,29
"2011","Swindon 007D","E01015580","Total",55,21,9,25,6,1,4,1,49,20,5,24
"2011","Swindon 008A","E01015473","Total",25,11,8,6,2,0,2,0,23,11,6,6
"2011","Swindon 008B","E01015474","Total",39,16,9,14,1,0,0,1,38,16,9,13
"2011","Swindon 008C","E01015547","Total",25,11,9,5,7,1,4,2,18,10,5,3
"2011","Swindon 008D","E01015548","Total",21,6,7,8,1,0,0,1,20,6,7,7
"2011","Swindon 009A","E01015549","Total",38,12,13,13,3,0,2,1,35,12,11,12
"2011","Swindon 009B","E01015550","Total",30,14,7,9,4,3,1,0,26,11,6,9
"2011","Swindon 009C","E01015551","Total",27,15,10,2,4,1,2,1,23,14,8,1
"2011","Swindon 009D","E01015552","Total",37,14,12,11,4,0,4,0,33,14,8,11
"2011","Swindon 009E","E01015553","Total",28,11,11,6,3,0,3,0,25,11,8,6
"2011","Swindon 009F","E01015554","Total",21,4,8,9,7,0,5,2,14,4,3,7
"2011","Swindon 010A","E01015508","Total",51,13,21,17,6,0,6,0,45,13,15,17
"2011","Swindon 010B","E01015509","Total",54,18,17,19,8,0,7,1,46,18,10,18
"2011","Swindon 010C","E01015510","Total",45,10,16,19,3,0,3,0,42,10,13,19
"2011","Swindon 010D","E01015511","Total",29,11,8,10,7,1,6,0,22,10,2,10
"2011","Swindon 011A","E01015562","Total",68,20,25,23,9,0,4,5,59,20,21,18
"2011","Swindon 011B","E01015563","Total",33,14,15,4,3,0,3,0,30,14,12,4
"2011","Swindon 011C","E01015565","Total",48,17,9,22,5,1,1,3,43,16,8,19
"2011","Swindon 011D","E01015566","Total",64,26,19,19,4,0,4,0,60,26,15,19
"2011","Swindon 012B","E01015578","Total",53,17,18,18,6,1,3,2,47,16,15,16
"2011","Swindon 012C","E01015579","Total",46,18,14,14,8,1,6,1,38,17,8,13
"2011","Swindon 012D","E01015581","Total",19,6,8,5,1,0,1,0,18,6,7,5
"2011","Swindon 012E","E01015582","Total",40,15,13,12,2,0,2,0,38,15,11,12
"2011","Swindon 012F","E01032708","Total",45,15,19,11,5,0,5,0,40,15,14,11
"2011","Swindon 012G","E01032716","Total",40,16,12,12,10,1,6,3,30,15,6,9
"2011","Swindon 013A","E01015481","Total",51,19,17,15,6,0,4,2,45,19,13,13
"2011","Swindon 013B","E01015482","Total",13,5,6,2,1,0,1,0,12,5,5,2
"2011","Swindon 013C","E01015483","Total",12,7,4,1,1,0,1,0,11,7,3,1
"2011","Swindon 013D","E01015484","Total",17,7,8,2,1,0,1,0,16,7,7,2
"2011","Swindon 013E","E01015485","Total",26,8,15,3,4,0,4,0,22,8,11,3
"2011","Swindon 013F","E01015486","Total",32,16,4,12,4,2,2,0,28,14,2,12
"2011","Swindon 014A","E01015561","Total",30,13,7,10,1,0,1,0,29,13,6,10
"2011","Swindon 014B","E01015564","Total",30,8,15,7,4,0,3,1,26,8,12,6
"2011","Swindon 014C","E01015567","Total",31,12,9,10,2,0,2,0,29,12,7,10
"2011","Swindon 014D","E01015568","Total",37,11,14,12,7,0,7,0,30,11,7,12
"2011","Swindon 015A","E01015475","Total",33,10,8,15,5,0,3,2,28,10,5,13
"2011","Swindon 015B","E01015476","Total",42,7,7,28,5,0,0,5,37,7,7,23
"2011","Swindon 015C","E01015477","Total",46,20,12,14,7,1,1,5,39,19,11,9
"2011","Swindon 015D","E01015480","Total",35,7,9,19,6,1,2,3,29,6,7,16
"2011","Swindon 016A","E01015538","Total",87,31,16,40,7,2,1,4,80,29,15,36
"2011","Swindon 016B","E01015572","Total",66,20,9,37,4,2,0,2,62,18,9,35
"2011","Swindon 016C","E01015573","Total",120,31,29,60,17,3,8,6,103,28,21,54
"2011","Swindon 016D","E01015575","Total",75,15,11,49,8,3,3,2,67,12,8,47
"2011","Swindon 017A","E01015479","Total",45,11,18,16,7,0,5,2,38,11,13,14
"2011","Swindon 017B","E01015493","Total",28,10,12,6,4,1,3,0,24,9,9,6
"2011","Swindon 017C","E01015574","Total",40,15,14,11,6,0,5,1,34,15,9,10
"2011","Swindon 017D","E01015576","Total",28,7,11,10,3,0,3,0,25,7,8,10
"2011","Swindon 018A","E01015499","Total",17,6,7,4,1,0,1,0,16,6,6,4
"2011","Swindon 018B","E01015500","Total",63,24,17,22,6,2,4,0,57,22,13,22
"2011","Swindon 018C","E01015504","Total",40,17,12,11,4,0,3,1,36,17,9,10
"2011","Swindon 018D","E01015505","Total",79,25,29,25,13,1,11,1,66,24,18,24
"2011","Swindon 019A","E01015494","Total",27,9,7,11,3,0,2,1,24,9,5,10
"2011","Swindon 019C","E01015496","Total",40,9,16,15,4,2,1,1,36,7,15,14
"2011","Swindon 019D","E01015497","Total",44,17,19,8,9,0,8,1,35,17,11,7
"2011","Swindon 019E","E01032714","Total",19,7,3,9,0,0,0,0,19,7,3,9
"2011","Swindon 019F","E01032715","Total",23,5,7,11,3,0,1,2,20,5,6,9
"2011","Swindon 020A","E01015537","Total",91,21,14,56,7,3,1,3,84,18,13,53
"2011","Swindon 020B","E01015539","Total",72,16,12,44,7,3,1,3,65,13,11,41
"2011","Swindon 020C","E01015540","Total",74,21,16,37,6,0,2,4,68,21,14,33
"2011","Swindon 020D","E01015541","Total",97,23,10,64,8,3,2,3,89,20,8,61
"2011","Swindon 020E","E01015542","Total",98,37,11,50,5,0,0,5,93,37,11,45
"2011","Swindon 021A","E01015478","Total",39,15,12,12,2,0,1,1,37,15,11,11
"2011","Swindon 021B","E01015498","Total",48,18,20,10,6,1,5,0,42,17,15,10
"2011","Swindon 021D","E01015532","Total",28,10,8,10,8,1,3,4,20,9,5,6
"2011","Swindon 021E","E01032706","Total",38,10,12,16,4,0,2,2,34,10,10,14
"2011","Swindon 021F","E01032707","Total",18,6,8,4,1,0,1,0,17,6,7,4
"2011","Swindon 022A","E01015501","Total",35,8,18,9,5,0,4,1,30,8,14,8
"2011","Swindon 022B","E01015502","Total",62,26,12,24,2,0,2,0,60,26,10,24
"2011","Swindon 022C","E01015503","Total",59,17,21,21,8,0,7,1,51,17,14,20
"2011","Swindon 022D","E01015569","Total",57,20,9,28,2,1,1,0,55,19,8,28
"2011","Swindon 022E","E01015570","Total",61,16,10,35,11,0,4,7,50,16,6,28
"2011","Swindon 022F","E01015571","Total",39,14,9,16,5,0,4,1,34,14,5,15
"2011","Swindon 023A","E01015487","Total",30,8,12,10,5,0,2,3,25,8,10,7
"2011","Swindon 023B","E01015488","Total",52,30,8,14,2,0,2,0,50,30,6,14
"2011","Swindon 023C","E01015489","Total",28,10,8,10,4,1,2,1,24,9,6,9
"2011","Swindon 023D","E01015490","Total",44,18,12,14,8,1,6,1,36,17,6,13
"2011","Swindon 023E","E01015491","Total",56,17,11,28,7,0,4,3,49,17,7,25
"2011","Swindon 023F","E01015492","Total",76,27,22,27,7,0,6,1,69,27,16,26
"2011","Swindon 024A","E01015533","Total",14,2,9,3,1,0,1,0,13,2,8,3
"2011","Swindon 024B","E01015534","Total",33,12,14,7,6,2,1,3,27,10,13,4
"2011","Swindon 024C","E01015535","Total",12,6,5,1,0,0,0,0,12,6,5,1
"2011","Swindon 024D","E01015536","Total",60,17,14,29,7,0,6,1,53,17,8,28
"2011","Swindon 025A","E01015583","Total",55,25,20,10,10,3,6,1,45,22,14,9
"2011","Swindon 025B","E01015584","Total",11,7,4,0,1,0,1,0,10,7,3,0
"2011","Swindon 025C","E01015585","Total",37,14,13,10,4,1,3,0,33,13,10,10
"2011","Swindon 025D","E01015586","Total",19,6,10,3,0,0,0,0,19,6,10,3
"2011","Swindon 025E","E01015587","Total",37,17,4,16,4,2,2,0,33,15,2,16
"2011","Swindon 025F","E01015588","Total",40,13,19,8,7,0,5,2,33,13,14,6
"2011","Swindon 026A","E01015525","Total",28,8,13,7,3,0,3,0,25,8,10,7
"2011","Swindon 026B","E01032700","Total",33,18,12,3,3,1,2,0,30,17,10,3
"2011","Swindon 026C","E01032703","Total",42,15,20,7,3,0,3,0,39,15,17,7
"2011","Swindon 026D","E01032705","Total",55,21,14,20,1,0,0,1,54,21,14,19
"2011","Swindon 026E","E01032709","Total",47,16,14,17,2,0,2,0,45,16,12,17
"2011","Swindon 026F","E01032713","Total",38,14,14,10,4,0,3,1,34,14,11,9
"2011","Swindon 027A","E01032701","Total",36,14,11,11,1,0,1,0,35,14,10,11
"2011","Swindon 027B","E01032702","Total",33,13,13,7,2,0,2,0,31,13,11,7
"2011","Swindon 027C","E01032704","Total",59,19,18,22,3,1,1,1,56,18,17,21
"2011","Swindon 027D","E01032711","Total",41,9,19,13,4,0,4,0,37,9,15,13
"2011","Swindon 027E","E01032712","Total",67,23,17,27,3,1,2,0,64,22,15,27
"2011","Swindon 028A","E01015471","Total",30,9,14,7,1,0,1,0,29,9,13,7
"2011","Swindon 028B","E01015472","Total",90,37,26,27,3,0,2,1,87,37,24,26
"2011","Swindon 028C","E01015512","Total",31,11,16,4,4,0,3,1,27,11,13,3
"2011","Swindon 028D","E01015518","Total",43,16,14,13,7,1,6,0,36,15,8,13
"2011","Swindon 028E","E01032710","Total",26,9,13,4,1,0,1,0,25,9,12,4
"2011","Torbay 001A","E01015262","Total",48,10,14,24,7,1,2,4,41,9,12,20
"2011","Torbay 001B","E01015263","Total",84,26,4,54,4,1,0,3,80,25,4,51
"2011","Torbay 001C","E01015264","Total",20,8,4,8,4,3,1,0,16,5,3,8
"2011","Torbay 001D","E01015265","Total",54,15,6,33,8,1,1,6,46,14,5,27
"2011","Torbay 001E","E01015266","Total",70,23,13,34,8,2,4,2,62,21,9,32
"2011","Torbay 002A","E01015236","Total",41,17,10,14,5,1,2,2,36,16,8,12
"2011","Torbay 002B","E01015237","Total",54,24,9,21,7,0,0,7,47,24,9,14
"2011","Torbay 002C","E01015238","Total",59,23,16,20,4,0,3,1,55,23,13,19
"2011","Torbay 002D","E01015239","Total",57,22,14,21,10,1,8,1,47,21,6,20
"2011","Torbay 003A","E01015249","Total",58,21,13,24,1,0,0,1,57,21,13,23
"2011","Torbay 003B","E01015250","Total",61,33,15,13,4,1,3,0,57,32,12,13
"2011","Torbay 003C","E01015251","Total",26,13,9,4,4,1,2,1,22,12,7,3
"2011","Torbay 003D","E01015252","Total",133,52,38,43,14,2,9,3,119,50,29,40
"2011","Torbay 003E","E01015253","Total",78,42,14,22,4,1,3,0,74,41,11,22
"2011","Torbay 003F","E01015254","Total",22,6,8,8,2,0,1,1,20,6,7,7
"2011","Torbay 004A","E01015257","Total",76,20,10,46,11,1,3,7,65,19,7,39
"2011","Torbay 004B","E01015258","Total",69,24,16,29,6,3,2,1,63,21,14,28
"2011","Torbay 004C","E01015259","Total",70,31,13,26,5,1,3,1,65,30,10,25
"2011","Torbay 004D","E01015260","Total",59,19,15,25,15,4,5,6,44,15,10,19
"2011","Torbay 005A","E01015240","Total",41,14,9,18,6,0,3,3,35,14,6,15
"2011","Torbay 005B","E01015241","Total",53,27,9,17,6,2,3,1,47,25,6,16
"2011","Torbay 005C","E01015242","Total",69,33,13,23,9,2,3,4,60,31,10,19
"2011","Torbay 005D","E01015243","Total",30,10,10,10,5,1,2,2,25,9,8,8
"2011","Torbay 006A","E01015214","Total",72,26,5,41,4,0,2,2,68,26,3,39
"2011","Torbay 006B","E01015215","Total",56,30,15,11,6,4,2,0,50,26,13,11
"2011","Torbay 006C","E01015216","Total",80,28,22,30,7,1,4,2,73,27,18,28
"2011","Torbay 006D","E01015218","Total",47,15,12,20,6,1,4,1,41,14,8,19
"2011","Torbay 008A","E01015217","Total",94,42,9,43,17,4,3,10,77,38,6,33
"2011","Torbay 008B","E01015255","Total",61,16,10,35,5,1,2,2,56,15,8,33
"2011","Torbay 008C","E01015256","Total",55,18,14,23,8,1,3,4,47,17,11,19
"2011","Torbay 008D","E01015261","Total",71,19,15,37,9,1,4,4,62,18,11,33
"2011","Torbay 010A","E01015267","Total",35,15,10,10,2,0,1,1,33,15,9,9
"2011","Torbay 010B","E01015268","Total",39,14,15,10,6,0,5,1,33,14,10,9
"2011","Torbay 010C","E01015269","Total",24,10,6,8,2,0,1,1,22,10,5,7
"2011","Torbay 010D","E01015270","Total",39,16,12,11,3,0,1,2,36,16,11,9
"2011","Torbay 010E","E01015271","Total",14,6,3,5,1,0,1,0,13,6,2,5
"2011","Torbay 011A","E01015224","Total",56,22,15,19,6,1,4,1,50,21,11,18
"2011","Torbay 011B","E01015225","Total",34,15,8,11,3,1,1,1,31,14,7,10
"2011","Torbay 011C","E01015226","Total",23,7,11,5,5,0,3,2,18,7,8,3
"2011","Torbay 011D","E01015227","Total",19,10,5,4,2,0,1,1,17,10,4,3
"2011","Torbay 011E","E01015228","Total",44,18,8,18,4,1,2,1,40,17,6,17
"2011","Torbay 011F","E01015230","Total",15,9,5,1,0,0,0,0,15,9,5,1
"2011","Torbay 012A","E01015202","Total",37,15,10,12,4,0,3,1,33,15,7,11
"2011","Torbay 012B","E01015203","Total",24,17,2,5,2,2,0,0,22,15,2,5
"2011","Torbay 012C","E01015204","Total",44,15,11,18,9,3,6,0,35,12,5,18
"2011","Torbay 012D","E01015205","Total",44,21,11,12,3,1,1,1,41,20,10,11
"2011","Torbay 012E","E01015206","Total",50,18,11,21,7,1,2,4,43,17,9,17
"2011","Torbay 013A","E01015190","Total",50,12,11,27,7,1,4,2,43,11,7,25
"2011","Torbay 013B","E01015191","Total",58,26,12,20,4,1,3,0,54,25,9,20
"2011","Torbay 013C","E01015192","Total",74,25,11,38,8,1,3,4,66,24,8,34
"2011","Torbay 013D","E01015193","Total",36,20,5,11,0,0,0,0,36,20,5,11
"2011","Torbay 013E","E01015194","Total",48,17,6,25,2,0,1,1,46,17,5,24
"2011","Torbay 013F","E01015195","Total",41,13,11,17,5,1,3,1,36,12,8,16
"2011","Torbay 013G","E01015196","Total",106,36,9,61,12,1,2,9,94,35,7,52
"2011","Torbay 014A","E01015229","Total",23,15,3,5,3,1,2,0,20,14,1,5
"2011","Torbay 014B","E01015231","Total",87,26,10,51,12,2,3,7,75,24,7,44
"2011","Torbay 014C","E01015232","Total",42,20,5,17,5,0,2,3,37,20,3,14
"2011","Torbay 014D","E01015233","Total",51,18,8,25,7,2,2,3,44,16,6,22
"2011","Torbay 014E","E01015234","Total",65,27,12,26,4,0,1,3,61,27,11,23
"2011","Torbay 014F","E01015235","Total",24,10,8,6,1,1,0,0,23,9,8,6
"2011","Torbay 015A","E01015219","Total",26,9,8,9,3,0,3,0,23,9,5,9
"2011","Torbay 015B","E01015220","Total",35,16,5,14,3,0,1,2,32,16,4,12
"2011","Torbay 015C","E01015221","Total",33,12,8,13,5,1,3,1,28,11,5,12
"2011","Torbay 015D","E01015222","Total",46,18,13,15,10,1,6,3,36,17,7,12
"2011","Torbay 015E","E01015223","Total",39,26,9,4,4,1,3,0,35,25,6,4
"2011","Torbay 016A","E01015197","Total",19,11,4,4,0,0,0,0,19,11,4,4
"2011","Torbay 016B","E01015198","Total",28,12,8,8,4,0,3,1,24,12,5,7
"2011","Torbay 016C","E01015199","Total",8,2,3,3,3,0,2,1,5,2,1,2
"2011","Torbay 016D","E01015200","Total",25,11,5,9,2,1,0,1,23,10,5,8
"2011","Torbay 016E","E01015201","Total",26,10,8,8,5,1,3,1,21,9,5,7
"2011","Torbay 017A","E01015183","Total",22,15,3,4,2,2,0,0,20,13,3,4
"2011","Torbay 017B","E01015184","Total",12,6,2,4,3,1,1,1,9,5,1,3
"2011","Torbay 017C","E01015185","Total",32,12,3,17,5,1,1,3,27,11,2,14
"2011","Torbay 017D","E01015186","Total",76,28,11,37,9,2,1,6,67,26,10,31
"2011","Torbay 017E","E01015187","Total",23,8,7,8,2,0,2,0,21,8,5,8
"2011","Torbay 017F","E01015188","Total",35,16,6,13,4,1,3,0,31,15,3,13
"2011","Torbay 017G","E01015189","Total",42,16,9,17,7,1,2,4,35,15,7,13
"2011","Torbay 018A","E01015244","Total",32,15,7,10,3,1,1,1,29,14,6,9
"2011","Torbay 018B","E01015245","Total",47,16,11,20,4,0,2,2,43,16,9,18
"2011","Torbay 018C","E01015246","Total",28,10,8,10,6,1,4,1,22,9,4,9
"2011","Torbay 018D","E01015247","Total",56,16,7,33,7,0,4,3,49,16,3,30
"2011","Torbay 018E","E01015248","Total",73,35,12,26,9,2,3,4,64,33,9,22
"2011","Torbay 019E","E01015207","Total",46,18,11,17,4,2,1,1,42,16,10,16
"2011","Torbay 019F","E01015208","Total",21,8,6,7,0,0,0,0,21,8,6,7
"2011","Torbay 019A","E01015209","Total",26,7,8,11,2,0,1,1,24,7,7,10
"2011","Torbay 019B","E01015210","Total",79,22,19,38,9,0,6,3,70,22,13,35
"2011","Torbay 019G","E01015211","Total",31,16,8,7,2,0,1,1,29,16,7,6
"2011","Torbay 019C","E01015212","Total",54,20,19,15,4,1,3,0,50,19,16,15
"2011","Torbay 019D","E01015213","Total",36,11,10,15,4,1,2,1,32,10,8,14
"2011","Wiltshire 012A","E01031841","Total",43,15,10,18,3,1,1,1,40,14,9,17
"2011","Wiltshire 012B","E01031868","Total",21,12,2,7,0,0,0,0,21,12,2,7
"2011","Wiltshire 012C","E01031873","Total",34,12,13,9,8,2,5,1,26,10,8,8
"2011","Wiltshire 012D","E01031874","Total",22,9,8,5,1,0,1,0,21,9,7,5
"2011","Wiltshire 012E","E01031884","Total",27,8,10,9,3,0,2,1,24,8,8,8
"2011","Wiltshire 019A","E01031861","Total",65,30,21,14,4,0,3,1,61,30,18,13
"2011","Wiltshire 019B","E01031862","Total",76,34,16,26,5,2,1,2,71,32,15,24
"2011","Wiltshire 019C","E01031863","Total",18,8,5,5,3,3,0,0,15,5,5,5
"2011","Wiltshire 019D","E01031864","Total",11,7,1,3,0,0,0,0,11,7,1,3
"2011","Wiltshire 019E","E01031865","Total",35,12,11,12,3,0,2,1,32,12,9,11
"2011","Wiltshire 024A","E01031866","Total",22,9,5,8,5,3,2,0,17,6,3,8
"2011","Wiltshire 024B","E01031869","Total",73,33,22,18,7,0,5,2,66,33,17,16
"2011","Wiltshire 024C","E01031870","Total",31,12,11,8,6,3,3,0,25,9,8,8
"2011","Wiltshire 024D","E01031871","Total",42,17,13,12,2,1,0,1,40,16,13,11
"2011","Wiltshire 025A","E01031850","Total",51,22,19,10,6,0,4,2,45,22,15,8
"2011","Wiltshire 025B","E01031851","Total",72,28,19,25,3,0,2,1,69,28,17,24
"2011","Wiltshire 025C","E01031852","Total",37,17,12,8,2,0,2,0,35,17,10,8
"2011","Wiltshire 025E","E01032688","Total",59,28,15,16,9,1,6,2,50,27,9,14
"2011","Wiltshire 025F","E01032689","Total",49,19,13,17,3,0,3,0,46,19,10,17
"2011","Wiltshire 025G","E01032692","Total",49,22,11,16,7,1,6,0,42,21,5,16
"2011","Wiltshire 025H","E01032693","Total",59,19,16,24,4,1,3,0,55,18,13,24
"2011","Wiltshire 026A","E01031853","Total",41,14,13,14,9,2,5,2,32,12,8,12
"2011","Wiltshire 026B","E01031854","Total",60,23,13,24,3,1,1,1,57,22,12,23
"2011","Wiltshire 026C","E01031855","Total",20,4,9,7,4,0,3,1,16,4,6,6
"2011","Wiltshire 026D","E01031856","Total",47,19,7,21,4,1,2,1,43,18,5,20
"2011","Wiltshire 028A","E01031845","Total",39,14,14,11,11,1,6,4,28,13,8,7
"2011","Wiltshire 028B","E01031846","Total",40,13,16,11,8,1,3,4,32,12,13,7
"2011","Wiltshire 028C","E01031848","Total",31,9,14,8,7,1,5,1,24,8,9,7
"2011","Wiltshire 028D","E01031872","Total",57,28,10,19,2,0,2,0,55,28,8,19
"2011","Wiltshire 028E","E01031876","Total",32,11,8,13,6,2,3,1,26,9,5,12
"2011","Wiltshire 029A","E01031843","Total",37,16,12,9,6,1,4,1,31,15,8,8
"2011","Wiltshire 029B","E01031847","Total",21,4,13,4,4,0,4,0,17,4,9,4
"2011","Wiltshire 029C","E01031849","Total",36,11,13,12,4,0,4,0,32,11,9,12
"2011","Wiltshire 029D","E01031877","Total",26,9,11,6,4,0,3,1,22,9,8,5
"2011","Wiltshire 034A","E01031844","Total",68,29,20,19,4,1,3,0,64,28,17,19
"2011","Wiltshire 034B","E01031857","Total",55,22,22,11,11,0,9,2,44,22,13,9
"2011","Wiltshire 034C","E01031858","Total",39,12,16,11,11,1,8,2,28,11,8,9
"2011","Wiltshire 034D","E01031883","Total",31,13,12,6,4,1,3,0,27,12,9,6
"2011","Wiltshire 038A","E01031842","Total",39,22,9,8,1,1,0,0,38,21,9,8
"2011","Wiltshire 038B","E01031867","Total",55,18,24,13,9,0,7,2,46,18,17,11
"2011","Wiltshire 038C","E01031882","Total",30,13,9,8,6,3,3,0,24,10,6,8
"2011","Wiltshire 041A","E01031859","Total",74,19,26,29,7,2,5,0,67,17,21,29
"2011","Wiltshire 041B","E01031860","Total",48,20,13,15,6,2,1,3,42,18,12,12
"2011","Wiltshire 041C","E01031878","Total",64,19,25,20,5,0,4,1,59,19,21,19
"2011","Wiltshire 041D","E01031879","Total",23,4,12,7,2,0,1,1,21,4,11,6
"2011","Wiltshire 041E","E01031880","Total",26,6,13,7,5,1,3,1,21,5,10,6
"2011","Wiltshire 041G","E01032697","Total",86,25,27,34,7,3,3,1,79,22,24,33
"2011","Wiltshire 041H","E01032698","Total",51,14,15,22,7,1,3,3,44,13,12,19
"2011","Wiltshire 001A","E01031887","Total",40,14,15,11,4,0,2,2,36,14,13,9
"2011","Wiltshire 001B","E01031934","Total",23,13,4,6,3,0,3,0,20,13,1,6
"2011","Wiltshire 001C","E01031935","Total",41,18,14,9,5,1,4,0,36,17,10,9
"2011","Wiltshire 001D","E01031936","Total",60,30,7,23,4,2,0,2,56,28,7,21
"2011","Wiltshire 002A","E01031885","Total",13,7,3,3,2,0,2,0,11,7,1,3
"2011","Wiltshire 002B","E01031947","Total",71,19,25,27,9,1,6,2,62,18,19,25
"2011","Wiltshire 002C","E01031948","Total",46,15,14,17,5,0,4,1,41,15,10,16
"2011","Wiltshire 002D","E01031949","Total",43,19,15,9,6,1,5,0,37,18,10,9
"2011","Wiltshire 003A","E01031954","Total",19,9,7,3,3,0,3,0,16,9,4,3
"2011","Wiltshire 003B","E01031955","Total",18,9,6,3,1,0,1,0,17,9,5,3
"2011","Wiltshire 003C","E01031956","Total",49,16,12,21,5,1,2,2,44,15,10,19
"2011","Wiltshire 003D","E01031962","Total",10,4,4,2,0,0,0,0,10,4,4,2
"2011","Wiltshire 004A","E01031886","Total",9,4,3,2,1,1,0,0,8,3,3,2
"2011","Wiltshire 004B","E01031892","Total",10,7,2,1,3,2,1,0,7,5,1,1
"2011","Wiltshire 004C","E01031893","Total",22,9,11,2,5,2,3,0,17,7,8,2
"2011","Wiltshire 004D","E01031894","Total",23,14,5,4,2,0,2,0,21,14,3,4
"2011","Wiltshire 005A","E01031957","Total",35,17,11,7,1,1,0,0,34,16,11,7
"2011","Wiltshire 005B","E01031958","Total",22,12,7,3,2,1,1,0,20,11,6,3
"2011","Wiltshire 005C","E01031959","Total",14,6,4,4,3,1,2,0,11,5,2,4
"2011","Wiltshire 005D","E01031960","Total",23,8,8,7,2,0,2,0,21,8,6,7
"2011","Wiltshire 006A","E01031963","Total",73,30,17,26,11,3,4,4,62,27,13,22
"2011","Wiltshire 006B","E01031964","Total",35,10,12,13,6,0,3,3,29,10,9,10
"2011","Wiltshire 006C","E01031967","Total",65,26,13,26,7,1,3,3,58,25,10,23
"2011","Wiltshire 006D","E01031969","Total",35,15,17,3,8,1,7,0,27,14,10,3
"2011","Wiltshire 007B","E01031944","Total",26,4,15,7,6,0,4,2,20,4,11,5
"2011","Wiltshire 007D","E01031946","Total",28,8,19,1,5,0,5,0,23,8,14,1
"2011","Wiltshire 007E","E01031961","Total",18,7,8,3,1,0,1,0,17,7,7,3
"2011","Wiltshire 007F","E01031965","Total",20,6,9,5,3,0,3,0,17,6,6,5
"2011","Wiltshire 007G","E01031966","Total",22,5,12,5,3,0,2,1,19,5,10,4
"2011","Wiltshire 007H","E01031968","Total",21,8,8,5,2,0,2,0,19,8,6,5
"2011","Wiltshire 007I","E01032699","Total",34,11,16,7,5,0,4,1,29,11,12,6
"2011","Wiltshire 008A","E01031939","Total",38,14,15,9,6,1,5,0,32,13,10,9
"2011","Wiltshire 008B","E01031940","Total",32,11,14,7,4,1,2,1,28,10,12,6
"2011","Wiltshire 008C","E01031950","Total",10,3,5,2,0,0,0,0,10,3,5,2
"2011","Wiltshire 008D","E01031951","Total",14,5,7,2,3,0,2,1,11,5,5,1
"2011","Wiltshire 009A","E01031907","Total",54,18,21,15,3,0,3,0,51,18,18,15
"2011","Wiltshire 009B","E01031910","Total",43,15,13,15,6,1,3,2,37,14,10,13
"2011","Wiltshire 009C","E01031914","Total",76,22,22,32,11,0,8,3,65,22,14,29
"2011","Wiltshire 009D","E01031915","Total",33,12,11,10,15,2,8,5,18,10,3,5
"2011","Wiltshire 009E","E01031919","Total",23,10,6,7,2,0,1,1,21,10,5,6
"2011","Wiltshire 009F","E01031920","Total",27,13,9,5,1,0,1,0,26,13,8,5
"2011","Wiltshire 010A","E01031905","Total",30,14,10,6,3,0,3,0,27,14,7,6
"2011","Wiltshire 010B","E01031906","Total",52,21,25,6,8,0,7,1,44,21,18,5
"2011","Wiltshire 010C","E01031908","Total",76,30,17,29,7,1,6,0,69,29,11,29
"2011","Wiltshire 010D","E01031909","Total",28,17,8,3,2,0,2,0,26,17,6,3
"2011","Wiltshire 010E","E01031925","Total",49,17,9,23,5,1,3,1,44,16,6,22
"2011","Wiltshire 010F","E01031926","Total",52,26,9,17,7,1,2,4,45,25,7,13
"2011","Wiltshire 010G","E01031927","Total",23,10,8,5,2,0,0,2,21,10,8,3
"2011","Wiltshire 011A","E01031911","Total",60,23,18,19,6,1,5,0,54,22,13,19
"2011","Wiltshire 011B","E01031912","Total",64,19,18,27,4,0,4,0,60,19,14,27
"2011","Wiltshire 011C","E01031913","Total",22,12,3,7,0,0,0,0,22,12,3,7
"2011","Wiltshire 011D","E01031917","Total",52,16,15,21,6,0,5,1,46,16,10,20
"2011","Wiltshire 011E","E01031918","Total",55,17,16,22,8,2,6,0,47,15,10,22
"2011","Wiltshire 011F","E01031928","Total",82,23,23,36,6,1,2,3,76,22,21,33
"2011","Wiltshire 013A","E01031891","Total",40,19,13,8,7,1,5,1,33,18,8,7
"2011","Wiltshire 013B","E01031904","Total",35,17,8,10,1,0,1,0,34,17,7,10
"2011","Wiltshire 013C","E01031937","Total",20,8,6,6,4,1,1,2,16,7,5,4
"2011","Wiltshire 013D","E01031938","Total",23,13,6,4,3,1,0,2,20,12,6,2
"2011","Wiltshire 014A","E01031916","Total",42,20,10,12,3,0,3,0,39,20,7,12
"2011","Wiltshire 014B","E01031921","Total",36,14,15,7,5,1,4,0,31,13,11,7
"2011","Wiltshire 014C","E01031922","Total",27,10,11,6,6,0,6,0,21,10,5,6
"2011","Wiltshire 014D","E01031923","Total",27,9,11,7,4,0,3,1,23,9,8,6
"2011","Wiltshire 014E","E01031924","Total",51,18,20,13,4,0,3,1,47,18,17,12
"2011","Wiltshire 015A","E01031895","Total",43,19,4,20,7,2,2,3,36,17,2,17
"2011","Wiltshire 015B","E01031896","Total",69,30,12,27,1,0,0,1,68,30,12,26
"2011","Wiltshire 015C","E01031897","Total",66,23,22,21,5,1,3,1,61,22,19,20
"2011","Wiltshire 015D","E01031898","Total",60,15,18,27,2,1,0,1,58,14,18,26
"2011","Wiltshire 015F","E01032690","Total",56,19,18,19,5,0,5,0,51,19,13,19
"2011","Wiltshire 015G","E01032691","Total",54,18,18,18,8,0,6,2,46,18,12,16
"2011","Wiltshire 016A","E01031900","Total",39,18,8,13,3,0,2,1,36,18,6,12
"2011","Wiltshire 016B","E01031901","Total",66,18,18,30,7,1,4,2,59,17,14,28
"2011","Wiltshire 016C","E01031902","Total",50,17,11,22,7,0,6,1,43,17,5,21
"2011","Wiltshire 016D","E01031903","Total",49,16,14,19,5,1,3,1,44,15,11,18
"2011","Wiltshire 017A","E01031888","Total",24,5,10,9,4,0,4,0,20,5,6,9
"2011","Wiltshire 017B","E01031889","Total",70,29,19,22,10,2,4,4,60,27,15,18
"2011","Wiltshire 017C","E01031890","Total",27,13,7,7,4,1,1,2,23,12,6,5
"2011","Wiltshire 017D","E01031929","Total",30,13,9,8,3,2,0,1,27,11,9,7
"2011","Wiltshire 017E","E01031930","Total",26,11,13,2,1,0,1,0,25,11,12,2
"2011","Wiltshire 018A","E01031931","Total",28,13,8,7,0,0,0,0,28,13,8,7
"2011","Wiltshire 018B","E01031932","Total",21,7,9,5,2,0,2,0,19,7,7,5
"2011","Wiltshire 018C","E01031933","Total",61,30,10,21,8,3,4,1,53,27,6,20
"2011","Wiltshire 018D","E01031941","Total",51,9,21,21,10,0,8,2,41,9,13,19
"2011","Wiltshire 018E","E01031942","Total",25,8,8,9,0,0,0,0,25,8,8,9
"2011","Wiltshire 018F","E01031952","Total",121,51,28,42,7,0,2,5,114,51,26,37
"2011","Wiltshire 018G","E01031953","Total",100,39,36,25,3,1,1,1,97,38,35,24
"2011","Wiltshire 045B","E01031988","Total",19,4,11,4,2,0,2,0,17,4,9,4
"2011","Wiltshire 045C","E01031998","Total",31,10,13,8,3,0,3,0,28,10,10,8
"2011","Wiltshire 045D","E01032026","Total",26,10,9,7,6,0,4,2,20,10,5,5
"2011","Wiltshire 045F","E01032696","Total",44,20,11,13,3,1,1,1,41,19,10,12
"2011","Wiltshire 046A","E01031989","Total",53,17,17,19,7,1,3,3,46,16,14,16
"2011","Wiltshire 046B","E01031996","Total",45,17,15,13,3,0,3,0,42,17,12,13
"2011","Wiltshire 046C","E01031997","Total",32,13,11,8,4,3,1,0,28,10,10,8
"2011","Wiltshire 046D","E01031999","Total",33,12,13,8,4,0,2,2,29,12,11,6
"2011","Wiltshire 048A","E01031974","Total",17,5,5,7,1,0,1,0,16,5,4,7
"2011","Wiltshire 048B","E01031975","Total",54,22,12,20,5,3,2,0,49,19,10,20
"2011","Wiltshire 048C","E01031976","Total",48,14,19,15,5,0,4,1,43,14,15,14
"2011","Wiltshire 048D","E01031977","Total",90,38,32,20,10,2,6,2,80,36,26,18
"2011","Wiltshire 048E","E01031978","Total",80,29,21,30,2,1,0,1,78,28,21,29
"2011","Wiltshire 048F","E01031979","Total",50,16,21,13,4,1,3,0,46,15,18,13
"2011","Wiltshire 049A","E01032013","Total",33,11,12,10,3,1,2,0,30,10,10,10
"2011","Wiltshire 049B","E01032032","Total",22,10,9,3,1,0,1,0,21,10,8,3
"2011","Wiltshire 049C","E01032033","Total",28,12,9,7,6,1,5,0,22,11,4,7
"2011","Wiltshire 049D","E01032034","Total",31,12,13,6,5,0,3,2,26,12,10,4
"2011","Wiltshire 050A","E01032010","Total",34,20,10,4,6,2,4,0,28,18,6,4
"2011","Wiltshire 050B","E01032035","Total",23,10,5,8,1,1,0,0,22,9,5,8
"2011","Wiltshire 050C","E01032036","Total",31,17,4,10,4,0,1,3,27,17,3,7
"2011","Wiltshire 050D","E01032037","Total",45,20,13,12,12,2,5,5,33,18,8,7
"2011","Wiltshire 051A","E01031984","Total",37,14,18,5,6,0,5,1,31,14,13,4
"2011","Wiltshire 051B","E01031985","Total",54,23,18,13,8,0,4,4,46,23,14,9
"2011","Wiltshire 051C","E01031986","Total",48,20,14,14,6,0,4,2,42,20,10,12
"2011","Wiltshire 051D","E01032017","Total",21,10,10,1,5,2,3,0,16,8,7,1
"2011","Wiltshire 052A","E01031980","Total",58,20,13,25,3,0,2,1,55,20,11,24
"2011","Wiltshire 052B","E01031981","Total",100,42,17,41,10,2,6,2,90,40,11,39
"2011","Wiltshire 052C","E01031982","Total",53,22,14,17,6,3,3,0,47,19,11,17
"2011","Wiltshire 052D","E01031983","Total",125,54,19,52,8,4,2,2,117,50,17,50
"2011","Wiltshire 053A","E01032018","Total",17,5,8,4,1,0,1,0,16,5,7,4
"2011","Wiltshire 053B","E01032019","Total",49,13,13,23,4,0,3,1,45,13,10,22
"2011","Wiltshire 053C","E01032020","Total",29,16,8,5,4,0,3,1,25,16,5,4
"2011","Wiltshire 053D","E01032025","Total",20,10,4,6,1,0,0,1,19,10,4,5
"2011","Wiltshire 054A","E01031990","Total",37,14,14,9,5,1,4,0,32,13,10,9
"2011","Wiltshire 054B","E01032004","Total",47,24,6,17,1,0,0,1,46,24,6,16
"2011","Wiltshire 054C","E01032027","Total",19,9,6,4,2,1,0,1,17,8,6,3
"2011","Wiltshire 054D","E01032038","Total",15,4,6,5,1,0,1,0,14,4,5,5
"2011","Wiltshire 054E","E01032039","Total",39,16,10,13,3,1,2,0,36,15,8,13
"2011","Wiltshire 054F","E01032040","Total",48,24,14,10,3,0,3,0,45,24,11,10
"2011","Wiltshire 055A","E01032001","Total",34,10,10,14,5,1,2,2,29,9,8,12
"2011","Wiltshire 055B","E01032002","Total",32,9,16,7,5,1,4,0,27,8,12,7
"2011","Wiltshire 055C","E01032003","Total",32,17,11,4,2,0,2,0,30,17,9,4
"2011","Wiltshire 055D","E01032024","Total",82,41,19,22,4,0,1,3,78,41,18,19
"2011","Wiltshire 056A","E01032014","Total",43,21,14,8,4,1,2,1,39,20,12,7
"2011","Wiltshire 056B","E01032015","Total",39,17,7,15,2,0,2,0,37,17,5,15
"2011","Wiltshire 056C","E01032016","Total",37,11,16,10,8,0,5,3,29,11,11,7
"2011","Wiltshire 056D","E01032021","Total",39,18,9,12,6,2,4,0,33,16,5,12
"2011","Wiltshire 057A","E01032000","Total",54,20,17,17,4,0,4,0,50,20,13,17
"2011","Wiltshire 057B","E01032011","Total",95,37,18,40,7,0,5,2,88,37,13,38
"2011","Wiltshire 057C","E01032012","Total",21,6,9,6,3,0,2,1,18,6,7,5
"2011","Wiltshire 058A","E01032008","Total",31,17,7,7,1,0,0,1,30,17,7,6
"2011","Wiltshire 058B","E01032009","Total",19,10,4,5,0,0,0,0,19,10,4,5
"2011","Wiltshire 058C","E01032022","Total",43,21,9,13,3,0,1,2,40,21,8,11
"2011","Wiltshire 059A","E01032005","Total",27,12,7,8,1,0,1,0,26,12,6,8
"2011","Wiltshire 059B","E01032006","Total",24,15,8,1,0,0,0,0,24,15,8,1
"2011","Wiltshire 059C","E01032007","Total",51,27,13,11,2,1,1,0,49,26,12,11
"2011","Wiltshire 059D","E01032023","Total",79,27,8,44,11,0,2,9,68,27,6,35
"2011","Wiltshire 060A","E01031970","Total",24,12,9,3,3,1,1,1,21,11,8,2
"2011","Wiltshire 060B","E01031971","Total",30,15,6,9,4,0,0,4,26,15,6,5
"2011","Wiltshire 060C","E01031972","Total",27,13,8,6,3,1,2,0,24,12,6,6
"2011","Wiltshire 060D","E01032041","Total",17,5,7,5,4,0,2,2,13,5,5,3
"2011","Wiltshire 060E","E01032042","Total",31,13,13,5,5,2,3,0,26,11,10,5
"2011","Wiltshire 061A","E01031991","Total",27,11,9,7,2,1,1,0,25,10,8,7
"2011","Wiltshire 061B","E01032029","Total",20,5,8,7,3,0,0,3,17,5,8,4
"2011","Wiltshire 061C","E01032030","Total",47,24,7,16,2,1,1,0,45,23,6,16
"2011","Wiltshire 061D","E01032031","Total",8,4,3,1,0,0,0,0,8,4,3,1
"2011","Wiltshire 062A","E01031973","Total",18,7,6,5,2,0,2,0,16,7,4,5
"2011","Wiltshire 062B","E01031992","Total",11,3,6,2,3,0,2,1,8,3,4,1
"2011","Wiltshire 062C","E01031993","Total",33,17,11,5,6,1,4,1,27,16,7,4
"2011","Wiltshire 062D","E01031994","Total",38,13,11,14,3,0,2,1,35,13,9,13
"2011","Wiltshire 062E","E01031995","Total",37,22,10,5,1,0,1,0,36,22,9,5
"2011","Wiltshire 020A","E01032063","Total",71,23,18,30,7,2,5,0,64,21,13,30
"2011","Wiltshire 020B","E01032064","Total",50,23,6,21,5,0,3,2,45,23,3,19
"2011","Wiltshire 020C","E01032065","Total",56,21,17,18,5,1,3,1,51,20,14,17
"2011","Wiltshire 020D","E01032073","Total",60,23,21,16,5,0,5,0,55,23,16,16
"2011","Wiltshire 020E","E01032074","Total",14,4,7,3,3,0,3,0,11,4,4,3
"2011","Wiltshire 021A","E01032043","Total",23,11,8,4,2,1,1,0,21,10,7,4
"2011","Wiltshire 021B","E01032044","Total",18,4,7,7,3,0,3,0,15,4,4,7
"2011","Wiltshire 021C","E01032057","Total",16,6,7,3,3,0,3,0,13,6,4,3
"2011","Wiltshire 021D","E01032070","Total",43,17,14,12,7,2,4,1,36,15,10,11
"2011","Wiltshire 021E","E01032071","Total",45,16,16,13,8,2,6,0,37,14,10,13
"2011","Wiltshire 021F","E01032072","Total",68,30,16,22,6,1,1,4,62,29,15,18
"2011","Wiltshire 022A","E01032062","Total",51,17,10,24,8,2,5,1,43,15,5,23
"2011","Wiltshire 022B","E01032066","Total",45,16,9,20,1,1,0,0,44,15,9,20
"2011","Wiltshire 022C","E01032067","Total",30,8,11,11,5,1,4,0,25,7,7,11
"2011","Wiltshire 022D","E01032068","Total",39,10,11,18,2,0,2,0,37,10,9,18
"2011","Wiltshire 022E","E01032069","Total",40,15,16,9,8,1,6,1,32,14,10,8
"2011","Wiltshire 023A","E01032058","Total",26,10,9,7,7,0,6,1,19,10,3,6
"2011","Wiltshire 023B","E01032059","Total",32,8,17,7,4,0,4,0,28,8,13,7
"2011","Wiltshire 023C","E01032060","Total",24,10,6,8,1,0,1,0,23,10,5,8
"2011","Wiltshire 023D","E01032061","Total",17,7,8,2,2,0,2,0,15,7,6,2
"2011","Wiltshire 027A","E01032045","Total",33,18,11,4,5,1,3,1,28,17,8,3
"2011","Wiltshire 027B","E01032046","Total",56,27,14,15,7,1,2,4,49,26,12,11
"2011","Wiltshire 027C","E01032047","Total",26,12,7,7,6,2,2,2,20,10,5,5
"2011","Wiltshire 027D","E01032048","Total",51,25,9,17,4,1,3,0,47,24,6,17
"2011","Wiltshire 027E","E01032049","Total",28,14,8,6,3,1,2,0,25,13,6,6
"2011","Wiltshire 027F","E01032050","Total",26,10,9,7,1,0,1,0,25,10,8,7
"2011","Wiltshire 030A","E01032077","Total",26,11,9,6,1,0,0,1,25,11,9,5
"2011","Wiltshire 030B","E01032078","Total",120,41,28,51,11,0,6,5,109,41,22,46
"2011","Wiltshire 030C","E01032079","Total",32,10,14,8,1,0,1,0,31,10,13,8
"2011","Wiltshire 030D","E01032080","Total",39,22,15,2,3,0,3,0,36,22,12,2
"2011","Wiltshire 031A","E01032085","Total",38,15,15,8,2,1,1,0,36,14,14,8
"2011","Wiltshire 031B","E01032086","Total",109,33,26,50,11,2,4,5,98,31,22,45
"2011","Wiltshire 031C","E01032087","Total",48,22,5,21,6,1,0,5,42,21,5,16
"2011","Wiltshire 032A","E01032099","Total",85,34,18,33,5,1,4,0,80,33,14,33
"2011","Wiltshire 032B","E01032100","Total",38,18,9,11,0,0,0,0,38,18,9,11
"2011","Wiltshire 032C","E01032101","Total",60,21,20,19,9,2,5,2,51,19,15,17
"2011","Wiltshire 032D","E01032102","Total",25,10,6,9,3,1,1,1,22,9,5,8
"2011","Wiltshire 033A","E01032096","Total",120,39,7,74,13,6,2,5,107,33,5,69
"2011","Wiltshire 033B","E01032097","Total",30,20,5,5,4,1,2,1,26,19,3,4
"2011","Wiltshire 033C","E01032098","Total",41,15,10,16,3,0,2,1,38,15,8,15
"2011","Wiltshire 035A","E01032092","Total",36,19,10,7,4,1,2,1,32,18,8,6
"2011","Wiltshire 035B","E01032093","Total",108,40,14,54,5,2,0,3,103,38,14,51
"2011","Wiltshire 035C","E01032094","Total",119,43,35,41,20,2,15,3,99,41,20,38
"2011","Wiltshire 035D","E01032095","Total",50,21,14,15,6,0,5,1,44,21,9,14
"2011","Wiltshire 036A","E01032088","Total",41,16,18,7,9,1,6,2,32,15,12,5
"2011","Wiltshire 036B","E01032089","Total",49,23,16,10,6,0,5,1,43,23,11,9
"2011","Wiltshire 036C","E01032090","Total",37,9,16,12,4,0,2,2,33,9,14,10
"2011","Wiltshire 036D","E01032091","Total",52,15,11,26,5,0,3,2,47,15,8,24
"2011","Wiltshire 037A","E01032053","Total",28,8,7,13,3,0,1,2,25,8,6,11
"2011","Wiltshire 037B","E01032083","Total",37,13,11,13,4,1,3,0,33,12,8,13
"2011","Wiltshire 037C","E01032084","Total",45,21,9,15,5,2,2,1,40,19,7,14
"2011","Wiltshire 039A","E01032052","Total",14,7,5,2,2,0,1,1,12,7,4,1
"2011","Wiltshire 039B","E01032054","Total",39,9,13,17,5,0,3,2,34,9,10,15
"2011","Wiltshire 039C","E01032055","Total",8,2,4,2,3,0,3,0,5,2,1,2
"2011","Wiltshire 039D","E01032056","Total",38,16,9,13,8,1,4,3,30,15,5,10
"2011","Wiltshire 039E","E01032121","Total",28,17,6,5,1,0,1,0,27,17,5,5
"2011","Wiltshire 040A","E01032115","Total",67,18,16,33,7,0,3,4,60,18,13,29
"2011","Wiltshire 040B","E01032116","Total",71,28,18,25,7,1,3,3,64,27,15,22
"2011","Wiltshire 040C","E01032117","Total",100,37,25,38,8,1,7,0,92,36,18,38
"2011","Wiltshire 040D","E01032118","Total",85,31,14,40,8,2,4,2,77,29,10,38
"2011","Wiltshire 040E","E01032119","Total",104,41,27,36,9,0,8,1,95,41,19,35
"2011","Wiltshire 040G","E01032694","Total",86,22,28,36,4,1,3,0,82,21,25,36
"2011","Wiltshire 040H","E01032695","Total",15,8,2,5,1,0,1,0,14,8,1,5
"2011","Wiltshire 042A","E01032104","Total",59,27,7,25,6,3,2,1,53,24,5,24
"2011","Wiltshire 042B","E01032105","Total",29,12,13,4,9,3,6,0,20,9,7,4
"2011","Wiltshire 042C","E01032107","Total",18,6,6,6,5,1,3,1,13,5,3,5
"2011","Wiltshire 042D","E01032108","Total",19,9,6,4,3,0,3,0,16,9,3,4
"2011","Wiltshire 043A","E01032110","Total",33,13,12,8,3,0,3,0,30,13,9,8
"2011","Wiltshire 043B","E01032111","Total",41,17,9,15,4,0,4,0,37,17,5,15
"2011","Wiltshire 043C","E01032112","Total",61,30,23,8,6,0,6,0,55,30,17,8
"2011","Wiltshire 043D","E01032113","Total",44,17,10,17,4,0,1,3,40,17,9,14
"2011","Wiltshire 044A","E01032103","Total",57,27,16,14,7,3,4,0,50,24,12,14
"2011","Wiltshire 044B","E01032106","Total",26,12,10,4,6,0,6,0,20,12,4,4
"2011","Wiltshire 044C","E01032109","Total",45,20,10,15,6,0,4,2,39,20,6,13
"2011","Wiltshire 044D","E01032114","Total",57,29,16,12,5,0,4,1,52,29,12,11
"2011","Wiltshire 047A","E01032051","Total",16,8,5,3,3,0,3,0,13,8,2,3
"2011","Wiltshire 047B","E01032075","Total",29,10,8,11,0,0,0,0,29,10,8,11
"2011","Wiltshire 047C","E01032076","Total",19,9,3,7,3,1,1,1,16,8,2,6
"2011","Wiltshire 047D","E01032081","Total",22,12,4,6,2,0,2,0,20,12,2,6
"2011","Wiltshire 047E","E01032082","Total",16,7,8,1,1,0,1,0,15,7,7,1
"2011","East Devon 001A","E01019902","Total",33,11,14,8,9,1,6,2,24,10,8,6
"2011","East Devon 001B","E01019938","Total",24,16,6,2,4,0,3,1,20,16,3,1
"2011","East Devon 001C","E01019967","Total",12,5,3,4,1,0,1,0,11,5,2,4
"2011","East Devon 002A","E01019927","Total",45,21,8,16,7,1,4,2,38,20,4,14
"2011","East Devon 002B","E01019932","Total",41,17,12,12,5,3,1,1,36,14,11,11
"2011","East Devon 002C","E01019933","Total",25,8,6,11,5,0,3,2,20,8,3,9
"2011","East Devon 002D","E01019934","Total",34,14,8,12,2,0,1,1,32,14,7,11
"2011","East Devon 003A","E01019928","Total",49,31,8,10,5,1,4,0,44,30,4,10
"2011","East Devon 003B","E01019929","Total",45,24,11,10,4,0,3,1,41,24,8,9
"2011","East Devon 003C","E01019930","Total",34,16,10,8,4,2,2,0,30,14,8,8
"2011","East Devon 003D","E01019931","Total",17,11,5,1,2,1,1,0,15,10,4,1
"2011","East Devon 004A","E01019925","Total",18,10,4,4,4,1,2,1,14,9,2,3
"2011","East Devon 004D","E01019959","Total",17,5,6,6,1,0,1,0,16,5,5,6
"2011","East Devon 004E","E01019960","Total",25,15,7,3,6,3,3,0,19,12,4,3
"2011","East Devon 004F","E01019962","Total",36,16,10,10,3,0,2,1,33,16,8,9
"2011","East Devon 004G","E01032628","Total",32,12,17,3,3,0,2,1,29,12,15,2
"2011","East Devon 005A","E01019886","Total",63,33,16,14,8,2,6,0,55,31,10,14
"2011","East Devon 005B","E01019887","Total",52,31,7,14,7,4,2,1,45,27,5,13
"2011","East Devon 005C","E01019888","Total",34,16,11,7,5,1,4,0,29,15,7,7
"2011","East Devon 005D","E01019889","Total",25,17,4,4,0,0,0,0,25,17,4,4
"2011","East Devon 005E","E01019966","Total",15,6,3,6,3,1,0,2,12,5,3,4
"2011","East Devon 006A","E01019891","Total",20,11,7,2,0,0,0,0,20,11,7,2
"2011","East Devon 006B","E01019892","Total",20,12,5,3,2,0,2,0,18,12,3,3
"2011","East Devon 006C","E01019893","Total",28,10,9,9,2,0,2,0,26,10,7,9
"2011","East Devon 006D","E01019903","Total",25,15,7,3,2,1,1,0,23,14,6,3
"2011","East Devon 007A","E01019899","Total",38,19,10,9,5,1,3,1,33,18,7,8
"2011","East Devon 007B","E01019900","Total",22,5,7,10,6,1,5,0,16,4,2,10
"2011","East Devon 007C","E01019935","Total",17,10,4,3,0,0,0,0,17,10,4,3
"2011","East Devon 007D","E01019936","Total",18,13,1,4,0,0,0,0,18,13,1,4
"2011","East Devon 007E","E01019961","Total",31,20,5,6,5,2,2,1,26,18,3,5
"2011","East Devon 008A","E01019939","Total",17,9,5,3,6,1,3,2,11,8,2,1
"2011","East Devon 008B","E01019940","Total",13,5,6,2,2,0,2,0,11,5,4,2
"2011","East Devon 008C","E01019942","Total",53,29,12,12,4,1,2,1,49,28,10,11
"2011","East Devon 008D","E01019943","Total",26,15,7,4,4,1,1,2,22,14,6,2
"2011","East Devon 008E","E01019944","Total",37,15,8,14,5,0,4,1,32,15,4,13
"2011","East Devon 009A","E01019890","Total",26,12,11,3,5,0,4,1,21,12,7,2
"2011","East Devon 009B","E01019901","Total",13,7,3,3,3,0,2,1,10,7,1,2
"2011","East Devon 009C","E01019951","Total",19,5,10,4,6,0,5,1,13,5,5,3
"2011","East Devon 010A","E01019946","Total",15,6,5,4,2,1,0,1,13,5,5,3
"2011","East Devon 010B","E01019947","Total",32,19,6,7,2,0,2,0,30,19,4,7
"2011","East Devon 010C","E01019948","Total",17,13,3,1,3,2,0,1,14,11,3,0
"2011","East Devon 010D","E01019949","Total",28,7,13,8,2,0,1,1,26,7,12,7
"2011","East Devon 010E","E01019950","Total",19,9,4,6,0,0,0,0,19,9,4,6
"2011","East Devon 011A","E01019952","Total",45,24,16,5,2,0,2,0,43,24,14,5
"2011","East Devon 011B","E01019953","Total",27,13,5,9,3,0,2,1,24,13,3,8
"2011","East Devon 011C","E01019954","Total",65,32,13,20,4,1,1,2,61,31,12,18
"2011","East Devon 011D","E01019955","Total",32,16,12,4,3,0,2,1,29,16,10,3
"2011","East Devon 012A","E01019956","Total",34,22,7,5,4,1,3,0,30,21,4,5
"2011","East Devon 012B","E01019957","Total",9,3,5,1,4,0,4,0,5,3,1,1
"2011","East Devon 012C","E01019958","Total",17,14,3,0,1,0,1,0,16,14,2,0
"2011","East Devon 013A","E01019937","Total",35,17,9,9,3,0,3,0,32,17,6,9
"2011","East Devon 013B","E01019945","Total",37,15,13,9,6,2,3,1,31,13,10,8
"2011","East Devon 013C","E01019963","Total",38,18,8,12,2,0,2,0,36,18,6,12
"2011","East Devon 014A","E01019898","Total",32,13,12,7,7,1,4,2,25,12,8,5
"2011","East Devon 014B","E01019964","Total",15,2,7,6,2,0,1,1,13,2,6,5
"2011","East Devon 014C","E01019965","Total",40,19,7,14,6,1,3,2,34,18,4,12
"2011","East Devon 015A","E01019904","Total",37,20,12,5,6,2,4,0,31,18,8,5
"2011","East Devon 015B","E01019905","Total",22,11,6,5,2,0,2,0,20,11,4,5
"2011","East Devon 015C","E01019906","Total",35,16,9,10,3,1,1,1,32,15,8,9
"2011","East Devon 015D","E01019907","Total",34,18,13,3,6,1,4,1,28,17,9,2
"2011","East Devon 016A","E01019908","Total",81,46,15,20,8,3,5,0,73,43,10,20
"2011","East Devon 016B","E01019909","Total",14,9,3,2,0,0,0,0,14,9,3,2
"2011","East Devon 016C","E01019910","Total",24,10,8,6,1,0,1,0,23,10,7,6
"2011","East Devon 016D","E01019911","Total",12,10,1,1,0,0,0,0,12,10,1,1
"2011","East Devon 017A","E01019894","Total",13,10,1,2,1,1,0,0,12,9,1,2
"2011","East Devon 017B","E01019895","Total",17,11,5,1,0,0,0,0,17,11,5,1
"2011","East Devon 017C","E01019896","Total",12,4,4,4,2,0,2,0,10,4,2,4
"2011","East Devon 017D","E01019897","Total",53,24,12,17,9,1,7,1,44,23,5,16
"2011","East Devon 018A","E01019920","Total",56,28,9,19,8,2,6,0,48,26,3,19
"2011","East Devon 018B","E01019921","Total",36,20,7,9,3,1,1,1,33,19,6,8
"2011","East Devon 018C","E01019922","Total",44,24,11,9,2,0,2,0,42,24,9,9
"2011","East Devon 018D","E01019923","Total",45,21,13,11,6,1,3,2,39,20,10,9
"2011","East Devon 018E","E01019924","Total",75,51,13,11,4,1,3,0,71,50,10,11
"2011","East Devon 019A","E01019916","Total",81,41,17,23,11,1,6,4,70,40,11,19
"2011","East Devon 019B","E01019917","Total",47,16,14,17,4,0,2,2,43,16,12,15
"2011","East Devon 019C","E01019918","Total",47,18,13,16,3,1,2,0,44,17,11,16
"2011","East Devon 019D","E01019919","Total",77,38,15,24,5,0,4,1,72,38,11,23
"2011","East Devon 020A","E01019912","Total",30,11,6,13,2,1,1,0,28,10,5,13
"2011","East Devon 020B","E01019913","Total",8,3,3,2,0,0,0,0,8,3,3,2
"2011","East Devon 020C","E01019914","Total",87,33,20,34,11,3,6,2,76,30,14,32
"2011","East Devon 020D","E01019915","Total",24,12,3,9,0,0,0,0,24,12,3,9
"2011","Exeter 001C","E01019998","Total",23,10,7,6,3,0,3,0,20,10,4,6
"2011","Exeter 001D","E01019999","Total",11,6,2,3,2,1,1,0,9,5,1,3
"2011","Exeter 001E","E01020001","Total",18,11,2,5,1,0,0,1,17,11,2,4
"2011","Exeter 001F","E01033233","Total",23,10,8,5,8,1,5,2,15,9,3,3
"2011","Exeter 002A","E01019990","Total",92,48,7,37,3,0,0,3,89,48,7,34
"2011","Exeter 002B","E01019991","Total",86,35,11,40,6,1,4,1,80,34,7,39
"2011","Exeter 002C","E01019993","Total",21,15,6,0,5,2,3,0,16,13,3,0
"2011","Exeter 002D","E01020000","Total",37,21,5,11,0,0,0,0,37,21,5,11
"2011","Exeter 002E","E01020007","Total",16,10,3,3,2,2,0,0,14,8,3,3
"2011","Exeter 003A","E01019992","Total",35,17,6,12,3,0,2,1,32,17,4,11
"2011","Exeter 003B","E01020002","Total",64,23,13,28,4,0,4,0,60,23,9,28
"2011","Exeter 003C","E01020003","Total",32,13,6,13,1,0,1,0,31,13,5,13
"2011","Exeter 003D","E01020004","Total",36,25,6,5,4,0,3,1,32,25,3,4
"2011","Exeter 003E","E01020005","Total",74,37,4,33,6,2,0,4,68,35,4,29
"2011","Exeter 004A","E01019997","Total",17,7,5,5,2,1,0,1,15,6,5,4
"2011","Exeter 004B","E01020019","Total",12,2,5,5,0,0,0,0,12,2,5,5
"2011","Exeter 004C","E01020020","Total",22,7,11,4,3,0,2,1,19,7,9,3
"2011","Exeter 004D","E01020021","Total",20,7,10,3,5,1,4,0,15,6,6,3
"2011","Exeter 004E","E01020022","Total",38,19,6,13,2,0,1,1,36,19,5,12
"2011","Exeter 005A","E01019980","Total",71,31,9,31,8,0,4,4,63,31,5,27
"2011","Exeter 005B","E01019982","Total",65,34,9,22,2,0,1,1,63,34,8,21
"2011","Exeter 005C","E01019983","Total",38,11,17,10,6,0,5,1,32,11,12,9
"2011","Exeter 005D","E01019984","Total",28,14,8,6,3,1,2,0,25,13,6,6
"2011","Exeter 005E","E01019985","Total",84,36,14,34,6,0,4,2,78,36,10,32
"2011","Exeter 006A","E01019987","Total",28,12,9,7,1,0,1,0,27,12,8,7
"2011","Exeter 006B","E01019989","Total",41,15,15,11,6,0,2,4,35,15,13,7
"2011","Exeter 006C","E01020006","Total",55,29,10,16,8,0,5,3,47,29,5,13
"2011","Exeter 006D","E01020008","Total",24,7,7,10,3,0,3,0,21,7,4,10
"2011","Exeter 006E","E01020009","Total",27,14,11,2,3,1,2,0,24,13,9,2
"2011","Exeter 007A","E01019986","Total",21,11,10,0,2,0,2,0,19,11,8,0
"2011","Exeter 007B","E01020036","Total",49,15,13,21,8,2,4,2,41,13,9,19
"2011","Exeter 007C","E01020037","Total",85,41,14,30,6,2,1,3,79,39,13,27
"2011","Exeter 007D","E01020039","Total",87,44,10,33,11,5,3,3,76,39,7,30
"2011","Exeter 007E","E01020040","Total",32,16,4,12,0,0,0,0,32,16,4,12
"2011","Exeter 008A","E01019994","Total",30,12,4,14,4,2,1,1,26,10,3,13
"2011","Exeter 008B","E01019995","Total",54,20,9,25,6,3,2,1,48,17,7,24
"2011","Exeter 008C","E01020016","Total",53,10,14,29,12,1,7,4,41,9,7,25
"2011","Exeter 008D","E01020017","Total",66,22,17,27,9,4,4,1,57,18,13,26
"2011","Exeter 008E","E01020018","Total",53,19,14,20,4,1,0,3,49,18,14,17
"2011","Exeter 009A","E01019996","Total",22,5,8,9,5,1,2,2,17,4,6,7
"2011","Exeter 009B","E01020023","Total",49,20,19,10,10,3,5,2,39,17,14,8
"2011","Exeter 009C","E01020024","Total",22,9,7,6,2,0,2,0,20,9,5,6
"2011","Exeter 009D","E01020025","Total",41,18,16,7,6,2,2,2,35,16,14,5
"2011","Exeter 010A","E01019975","Total",63,27,11,25,3,0,2,1,60,27,9,24
"2011","Exeter 010B","E01020029","Total",33,23,8,2,4,2,1,1,29,21,7,1
"2011","Exeter 010C","E01020030","Total",73,30,16,27,4,0,2,2,69,30,14,25
"2011","Exeter 010D","E01020031","Total",47,24,7,16,6,2,0,4,41,22,7,12
"2011","Exeter 010E","E01020032","Total",29,10,12,7,5,0,1,4,24,10,11,3
"2011","Exeter 011A","E01020026","Total",28,10,13,5,3,0,2,1,25,10,11,4
"2011","Exeter 011B","E01020027","Total",51,21,19,11,12,2,9,1,39,19,10,10
"2011","Exeter 011D","E01020035","Total",42,18,10,14,4,0,2,2,38,18,8,12
"2011","Exeter 011E","E01020038","Total",30,16,6,8,3,1,1,1,27,15,5,7
"2011","Exeter 011F","E01033232","Total",47,18,14,15,6,1,4,1,41,17,10,14
"2011","Exeter 011G","E01033234","Total",43,21,10,12,6,0,5,1,37,21,5,11
"2011","Exeter 012A","E01019973","Total",37,15,8,14,3,1,1,1,34,14,7,13
"2011","Exeter 012B","E01019974","Total",23,9,7,7,4,0,2,2,19,9,5,5
"2011","Exeter 012C","E01019976","Total",13,5,4,4,0,0,0,0,13,5,4,4
"2011","Exeter 012D","E01019977","Total",31,18,5,8,5,2,1,2,26,16,4,6
"2011","Exeter 012E","E01019981","Total",69,33,12,24,8,3,2,3,61,30,10,21
"2011","Exeter 013A","E01019988","Total",28,15,8,5,1,0,1,0,27,15,7,5
"2011","Exeter 013B","E01020010","Total",80,27,8,45,8,0,3,5,72,27,5,40
"2011","Exeter 013C","E01020013","Total",28,9,8,11,2,1,1,0,26,8,7,11
"2011","Exeter 013D","E01020014","Total",71,24,13,34,6,0,4,2,65,24,9,32
"2011","Exeter 013E","E01020015","Total",103,42,12,49,6,1,0,5,97,41,12,44
"2011","Exeter 014A","E01019968","Total",32,25,4,3,4,4,0,0,28,21,4,3
"2011","Exeter 014B","E01019969","Total",24,11,7,6,3,0,3,0,21,11,4,6
"2011","Exeter 014C","E01019970","Total",37,20,9,8,3,0,3,0,34,20,6,8
"2011","Exeter 014D","E01019971","Total",59,23,12,24,4,0,3,1,55,23,9,23
"2011","Exeter 014E","E01019972","Total",56,28,13,15,7,1,3,3,49,27,10,12
"2011","Exeter 015A","E01020011","Total",22,8,6,8,5,2,1,2,17,6,5,6
"2011","Exeter 015B","E01020012","Total",67,28,10,29,6,2,3,1,61,26,7,28
"2011","Exeter 015C","E01020033","Total",34,13,11,10,4,1,3,0,30,12,8,10
"2011","Exeter 015E","E01033235","Total",23,15,7,1,5,1,4,0,18,14,3,1
"2011","Exeter 015F","E01033236","Total",16,5,7,4,2,0,2,0,14,5,5,4
"2011","Mid Devon 001A","E01020046","Total",24,14,7,3,4,2,2,0,20,12,5,3
"2011","Mid Devon 001B","E01020049","Total",16,6,3,7,1,0,1,0,15,6,2,7
"2011","Mid Devon 001C","E01020050","Total",38,19,6,13,8,2,3,3,30,17,3,10
"2011","Mid Devon 001D","E01020077","Total",20,8,9,3,4,3,1,0,16,5,8,3
"2011","Mid Devon 002A","E01020047","Total",40,17,16,7,4,0,4,0,36,17,12,7
"2011","Mid Devon 002B","E01020051","Total",20,9,7,4,2,0,2,0,18,9,5,4
"2011","Mid Devon 002C","E01020066","Total",83,33,27,23,10,1,6,3,73,32,21,20
"2011","Mid Devon 002D","E01020080","Total",13,3,2,8,1,0,0,1,12,3,2,7
"2011","Mid Devon 003A","E01020063","Total",48,16,16,16,6,1,4,1,42,15,12,15
"2011","Mid Devon 003B","E01020074","Total",25,10,8,7,4,0,3,1,21,10,5,6
"2011","Mid Devon 003C","E01020075","Total",45,25,10,10,1,0,1,0,44,25,9,10
"2011","Mid Devon 004A","E01020052","Total",53,18,18,17,8,0,6,2,45,18,12,15
"2011","Mid Devon 004B","E01020053","Total",45,20,12,13,6,3,2,1,39,17,10,12
"2011","Mid Devon 004C","E01020065","Total",66,31,11,24,7,1,4,2,59,30,7,22
"2011","Mid Devon 004D","E01020067","Total",97,39,10,48,3,0,1,2,94,39,9,46
"2011","Mid Devon 005A","E01020048","Total",68,18,10,40,14,0,2,12,54,18,8,28
"2011","Mid Devon 005B","E01020078","Total",42,16,11,15,7,1,4,2,35,15,7,13
"2011","Mid Devon 005C","E01020079","Total",35,16,6,13,3,0,2,1,32,16,4,12
"2011","Mid Devon 005D","E01020081","Total",37,17,8,12,4,0,4,0,33,17,4,12
"2011","Mid Devon 006A","E01020045","Total",40,15,17,8,5,1,4,0,35,14,13,8
"2011","Mid Devon 006B","E01020059","Total",32,14,10,8,6,1,3,2,26,13,7,6
"2011","Mid Devon 006C","E01020062","Total",27,11,9,7,1,0,1,0,26,11,8,7
"2011","Mid Devon 006D","E01020064","Total",40,17,13,10,3,1,2,0,37,16,11,10
"2011","Mid Devon 007A","E01020054","Total",46,24,13,9,4,1,3,0,42,23,10,9
"2011","Mid Devon 007B","E01020055","Total",58,27,16,15,6,1,4,1,52,26,12,14
"2011","Mid Devon 007C","E01020057","Total",44,19,10,15,5,1,4,0,39,18,6,15
"2011","Mid Devon 007D","E01020058","Total",29,11,14,4,5,1,3,1,24,10,11,3
"2011","Mid Devon 008A","E01020043","Total",72,27,17,28,10,2,5,3,62,25,12,25
"2011","Mid Devon 008B","E01020044","Total",24,11,8,5,1,0,1,0,23,11,7,5
"2011","Mid Devon 008C","E01020056","Total",22,9,7,6,2,0,2,0,20,9,5,6
"2011","Mid Devon 008D","E01020071","Total",39,17,9,13,0,0,0,0,39,17,9,13
"2011","Mid Devon 009A","E01020072","Total",33,14,12,7,2,0,2,0,31,14,10,7
"2011","Mid Devon 009B","E01020073","Total",19,8,5,6,3,0,2,1,16,8,3,5
"2011","Mid Devon 009C","E01020076","Total",33,23,7,3,6,2,4,0,27,21,3,3
"2011","Mid Devon 009D","E01020082","Total",21,14,2,5,0,0,0,0,21,14,2,5
"2011","Mid Devon 010A","E01020068","Total",17,6,9,2,3,0,3,0,14,6,6,2
"2011","Mid Devon 010B","E01020069","Total",25,13,9,3,2,0,2,0,23,13,7,3
"2011","Mid Devon 010C","E01020070","Total",22,8,7,7,4,0,4,0,18,8,3,7
"2011","Mid Devon 010D","E01020083","Total",48,25,14,9,10,4,5,1,38,21,9,8
"2011","Mid Devon 011A","E01020041","Total",81,28,22,31,5,0,3,2,76,28,19,29
"2011","Mid Devon 011B","E01020042","Total",28,16,8,4,2,0,1,1,26,16,7,3
"2011","Mid Devon 011C","E01020060","Total",42,20,10,12,9,2,6,1,33,18,4,11
"2011","Mid Devon 011D","E01020061","Total",55,26,14,15,8,2,4,2,47,24,10,13
"2011","North Devon 001A","E01020111","Total",79,31,10,38,10,2,4,4,69,29,6,34
"2011","North Devon 001B","E01020112","Total",56,27,5,24,4,1,2,1,52,26,3,23
"2011","North Devon 001C","E01020114","Total",32,15,7,10,4,0,2,2,28,15,5,8
"2011","North Devon 001D","E01020115","Total",22,8,7,7,4,2,2,0,18,6,5,7
"2011","North Devon 002A","E01020099","Total",25,8,5,12,5,0,4,1,20,8,1,11
"2011","North Devon 002B","E01020100","Total",16,7,7,2,3,2,1,0,13,5,6,2
"2011","North Devon 002C","E01020101","Total",38,21,6,11,4,0,3,1,34,21,3,10
"2011","North Devon 002D","E01020126","Total",19,8,5,6,2,0,2,0,17,8,3,6
"2011","North Devon 003A","E01020113","Total",62,15,9,38,5,0,2,3,57,15,7,35
"2011","North Devon 003B","E01020116","Total",37,14,7,16,3,0,2,1,34,14,5,15
"2011","North Devon 003C","E01020117","Total",22,10,7,5,3,0,1,2,19,10,6,3
"2011","North Devon 003D","E01020118","Total",57,19,8,30,4,0,2,2,53,19,6,28
"2011","North Devon 004A","E01020090","Total",22,14,1,7,2,1,1,0,20,13,0,7
"2011","North Devon 004B","E01020108","Total",37,16,11,10,3,0,2,1,34,16,9,9
"2011","North Devon 004C","E01020109","Total",17,6,5,6,2,0,1,1,15,6,4,5
"2011","North Devon 005A","E01020089","Total",56,33,13,10,4,0,3,1,52,33,10,9
"2011","North Devon 005B","E01020091","Total",22,7,11,4,6,2,4,0,16,5,7,4
"2011","North Devon 005C","E01020092","Total",12,8,4,0,1,0,1,0,11,8,3,0
"2011","North Devon 005D","E01020093","Total",46,24,13,9,3,1,0,2,43,23,13,7
"2011","North Devon 005E","E01020110","Total",44,14,17,13,9,0,9,0,35,14,8,13
"2011","North Devon 006A","E01020088","Total",31,10,10,11,6,1,4,1,25,9,6,10
"2011","North Devon 006B","E01020120","Total",23,11,8,4,4,0,3,1,19,11,5,3
"2011","North Devon 006C","E01020127","Total",18,6,8,4,2,0,1,1,16,6,7,3
"2011","North Devon 007A","E01020132","Total",37,14,14,9,7,1,6,0,30,13,8,9
"2011","North Devon 007B","E01020133","Total",34,17,11,6,5,1,4,0,29,16,7,6
"2011","North Devon 007C","E01020134","Total",47,22,7,18,3,0,1,2,44,22,6,16
"2011","North Devon 007D","E01020139","Total",54,32,7,15,0,0,0,0,54,32,7,15
"2011","North Devon 008A","E01020094","Total",48,21,7,20,11,3,6,2,37,18,1,18
"2011","North Devon 008B","E01020095","Total",67,30,12,25,5,2,1,2,62,28,11,23
"2011","North Devon 008C","E01020140","Total",21,9,7,5,0,0,0,0,21,9,7,5
"2011","North Devon 008D","E01020141","Total",116,42,14,60,8,1,4,3,108,41,10,57
"2011","North Devon 009A","E01020096","Total",61,30,13,18,4,1,2,1,57,29,11,17
"2011","North Devon 009B","E01020123","Total",41,14,4,23,3,0,1,2,38,14,3,21
"2011","North Devon 009C","E01020124","Total",20,5,7,8,4,1,2,1,16,4,5,7
"2011","North Devon 009D","E01020125","Total",18,8,6,4,4,1,2,1,14,7,4,3
"2011","North Devon 010A","E01020102","Total",52,28,9,15,2,0,1,1,50,28,8,14
"2011","North Devon 010B","E01020103","Total",78,33,7,38,2,0,0,2,76,33,7,36
"2011","North Devon 010C","E01020104","Total",109,43,18,48,8,2,5,1,101,41,13,47
"2011","North Devon 010D","E01020128","Total",13,10,3,0,0,0,0,0,13,10,3,0
"2011","North Devon 010E","E01020129","Total",47,22,10,15,6,3,2,1,41,19,8,14
"2011","North Devon 010F","E01020130","Total",57,26,16,15,6,1,4,1,51,25,12,14
"2011","North Devon 011A","E01020105","Total",45,18,11,16,10,0,6,4,35,18,5,12
"2011","North Devon 011B","E01020106","Total",9,5,4,0,1,0,1,0,8,5,3,0
"2011","North Devon 011C","E01020107","Total",15,7,5,3,0,0,0,0,15,7,5,3
"2011","North Devon 011D","E01020119","Total",25,10,9,6,4,0,3,1,21,10,6,5
"2011","North Devon 012A","E01020084","Total",51,22,12,17,5,1,2,2,46,21,10,15
"2011","North Devon 012B","E01020085","Total",47,24,8,15,4,2,1,1,43,22,7,14
"2011","North Devon 012C","E01020086","Total",20,14,3,3,2,0,2,0,18,14,1,3
"2011","North Devon 012D","E01020121","Total",44,23,9,12,2,0,2,0,42,23,7,12
"2011","North Devon 012E","E01020122","Total",26,10,8,8,5,1,4,0,21,9,4,8
"2011","North Devon 013A","E01020097","Total",27,12,6,9,3,0,3,0,24,12,3,9
"2011","North Devon 013B","E01020131","Total",36,19,7,10,4,1,0,3,32,18,7,7
"2011","North Devon 013C","E01020135","Total",58,23,11,24,7,1,4,2,51,22,7,22
"2011","North Devon 013D","E01020136","Total",44,22,12,10,2,0,2,0,42,22,10,10
"2011","North Devon 013E","E01020137","Total",47,17,12,18,4,0,3,1,43,17,9,17
"2011","North Devon 014A","E01020087","Total",22,12,7,3,2,0,2,0,20,12,5,3
"2011","North Devon 014B","E01020098","Total",48,20,20,8,7,2,5,0,41,18,15,8
"2011","North Devon 014C","E01020138","Total",31,15,8,8,2,1,1,0,29,14,7,8
"2011","South Hams 001A","E01020144","Total",41,19,17,5,2,0,2,0,39,19,15,5
"2011","South Hams 001B","E01020145","Total",35,14,8,13,3,1,2,0,32,13,6,13
"2011","South Hams 001C","E01020146","Total",27,14,9,4,3,1,2,0,24,13,7,4
"2011","South Hams 001D","E01020149","Total",40,22,9,9,4,1,1,2,36,21,8,7
"2011","South Hams 002A","E01020148","Total",24,8,10,6,2,0,2,0,22,8,8,6
"2011","South Hams 002B","E01020157","Total",35,16,10,9,6,0,4,2,29,16,6,7
"2011","South Hams 002C","E01020160","Total",42,17,14,11,4,0,4,0,38,17,10,11
"2011","South Hams 002D","E01020176","Total",20,13,4,3,0,0,0,0,20,13,4,3
"2011","South Hams 002E","E01020177","Total",34,18,6,10,2,1,0,1,32,17,6,9
"2011","South Hams 003A","E01020180","Total",76,35,20,21,11,5,6,0,65,30,14,21
"2011","South Hams 003B","E01020181","Total",53,26,10,17,10,3,6,1,43,23,4,16
"2011","South Hams 003C","E01020182","Total",71,35,14,22,7,1,4,2,64,34,10,20
"2011","South Hams 003D","E01020183","Total",51,21,15,15,10,2,6,2,41,19,9,13
"2011","South Hams 003E","E01020184","Total",51,28,11,12,8,5,3,0,43,23,8,12
"2011","South Hams 004A","E01020153","Total",14,11,0,3,0,0,0,0,14,11,0,3
"2011","South Hams 004B","E01020156","Total",26,14,7,5,3,2,1,0,23,12,6,5
"2011","South Hams 004C","E01020170","Total",40,15,12,13,8,1,3,4,32,14,9,9
"2011","South Hams 004D","E01020188","Total",29,16,7,6,4,1,2,1,25,15,5,5
"2011","South Hams 005A","E01020161","Total",66,32,13,21,6,0,4,2,60,32,9,19
"2011","South Hams 005B","E01020162","Total",57,31,20,6,3,1,2,0,54,30,18,6
"2011","South Hams 005C","E01020163","Total",46,21,20,5,8,2,6,0,38,19,14,5
"2011","South Hams 005D","E01020164","Total",50,21,18,11,7,2,3,2,43,19,15,9
"2011","South Hams 005E","E01020165","Total",59,29,20,10,10,1,7,2,49,28,13,8
"2011","South Hams 005F","E01020166","Total",23,14,9,0,4,0,4,0,19,14,5,0
"2011","South Hams 005G","E01020167","Total",30,13,11,6,1,0,0,1,29,13,11,5
"2011","South Hams 006A","E01020142","Total",34,13,14,7,1,1,0,0,33,12,14,7
"2011","South Hams 006B","E01020143","Total",51,27,11,13,8,2,5,1,43,25,6,12
"2011","South Hams 006C","E01020150","Total",37,25,7,5,0,0,0,0,37,25,7,5
"2011","South Hams 007A","E01020151","Total",16,8,4,4,0,0,0,0,16,8,4,4
"2011","South Hams 007B","E01020152","Total",19,7,2,10,2,0,0,2,17,7,2,8
"2011","South Hams 007C","E01020154","Total",56,28,13,15,2,0,2,0,54,28,11,15
"2011","South Hams 007D","E01020155","Total",35,16,5,14,3,1,0,2,32,15,5,12
"2011","South Hams 008A","E01020147","Total",28,6,8,14,5,0,4,1,23,6,4,13
"2011","South Hams 008B","E01020158","Total",31,10,12,9,3,0,1,2,28,10,11,7
"2011","South Hams 008C","E01020159","Total",16,6,7,3,1,0,1,0,15,6,6,3
"2011","South Hams 008D","E01020190","Total",31,14,8,9,2,0,1,1,29,14,7,8
"2011","South Hams 009A","E01020171","Total",22,9,5,8,2,1,1,0,20,8,4,8
"2011","South Hams 009B","E01020185","Total",18,7,8,3,3,0,3,0,15,7,5,3
"2011","South Hams 009C","E01020186","Total",17,11,3,3,4,1,3,0,13,10,0,3
"2011","South Hams 009D","E01020187","Total",42,13,15,14,5,0,3,2,37,13,12,12
"2011","South Hams 010A","E01020168","Total",43,16,10,17,4,1,3,0,39,15,7,17
"2011","South Hams 010B","E01020169","Total",73,31,23,19,12,1,9,2,61,30,14,17
"2011","South Hams 010C","E01020189","Total",51,25,13,13,6,2,2,2,45,23,11,11
"2011","South Hams 011A","E01020174","Total",23,11,7,5,5,1,2,2,18,10,5,3
"2011","South Hams 011B","E01020175","Total",21,10,1,10,1,0,0,1,20,10,1,9
"2011","South Hams 011C","E01020178","Total",36,20,10,6,6,2,4,0,30,18,6,6
"2011","South Hams 012A","E01020172","Total",24,11,7,6,4,0,3,1,20,11,4,5
"2011","South Hams 012B","E01020173","Total",28,13,8,7,6,0,5,1,22,13,3,6
"2011","South Hams 012C","E01020179","Total",20,9,4,7,5,0,3,2,15,9,1,5
"2011","Teignbridge 001A","E01020243","Total",16,9,5,2,3,0,2,1,13,9,3,1
"2011","Teignbridge 001B","E01020262","Total",9,5,2,2,1,0,1,0,8,5,1,2
"2011","Teignbridge 001C","E01020263","Total",16,7,7,2,5,1,3,1,11,6,4,1
"2011","Teignbridge 001D","E01020274","Total",12,5,5,2,2,0,2,0,10,5,3,2
"2011","Teignbridge 002A","E01020240","Total",22,9,10,3,3,1,2,0,19,8,8,3
"2011","Teignbridge 002B","E01020241","Total",38,17,13,8,5,0,3,2,33,17,10,6
"2011","Teignbridge 002C","E01020242","Total",33,15,12,6,4,0,4,0,29,15,8,6
"2011","Teignbridge 002D","E01020244","Total",37,13,8,16,4,1,2,1,33,12,6,15
"2011","Teignbridge 002E","E01020245","Total",25,10,12,3,4,2,2,0,21,8,10,3
"2011","Teignbridge 003A","E01020205","Total",9,5,3,1,4,0,3,1,5,5,0,0
"2011","Teignbridge 003B","E01020258","Total",43,19,13,11,9,1,4,4,34,18,9,7
"2011","Teignbridge 003C","E01020259","Total",10,4,2,4,2,1,1,0,8,3,1,4
"2011","Teignbridge 003D","E01020273","Total",28,15,8,5,4,0,3,1,24,15,5,4
"2011","Teignbridge 004A","E01020203","Total",18,12,4,2,3,0,1,2,15,12,3,0
"2011","Teignbridge 004B","E01020206","Total",43,16,16,11,3,0,3,0,40,16,13,11
"2011","Teignbridge 004C","E01020220","Total",36,17,9,10,3,1,2,0,33,16,7,10
"2011","Teignbridge 004D","E01020221","Total",41,22,12,7,5,0,5,0,36,22,7,7
"2011","Teignbridge 004E","E01020222","Total",23,7,9,7,1,0,1,0,22,7,8,7
"2011","Teignbridge 004F","E01020223","Total",24,11,5,8,1,0,0,1,23,11,5,7
"2011","Teignbridge 005A","E01020229","Total",32,16,7,9,5,0,3,2,27,16,4,7
"2011","Teignbridge 005B","E01020230","Total",29,13,6,10,3,0,2,1,26,13,4,9
"2011","Teignbridge 005C","E01020231","Total",21,11,5,5,2,0,1,1,19,11,4,4
"2011","Teignbridge 005D","E01020232","Total",48,17,16,15,2,0,1,1,46,17,15,14
"2011","Teignbridge 006A","E01020228","Total",45,15,18,12,9,1,6,2,36,14,12,10
"2011","Teignbridge 006B","E01020233","Total",21,5,6,10,3,1,2,0,18,4,4,10
"2011","Teignbridge 006C","E01020234","Total",51,28,5,18,2,1,0,1,49,27,5,17
"2011","Teignbridge 006D","E01020235","Total",51,20,15,16,4,1,2,1,47,19,13,15
"2011","Teignbridge 007A","E01020202","Total",17,4,8,5,4,0,4,0,13,4,4,5
"2011","Teignbridge 007B","E01020204","Total",49,18,9,22,6,2,3,1,43,16,6,21
"2011","Teignbridge 007C","E01020236","Total",17,3,10,4,3,1,1,1,14,2,9,3
"2011","Teignbridge 007D","E01020237","Total",27,13,9,5,1,0,0,1,26,13,9,4
"2011","Teignbridge 008A","E01020265","Total",33,17,8,8,5,1,3,1,28,16,5,7
"2011","Teignbridge 008B","E01020266","Total",33,17,12,4,3,1,2,0,30,16,10,4
"2011","Teignbridge 008C","E01020267","Total",24,7,10,7,3,0,2,1,21,7,8,6
"2011","Teignbridge 008D","E01020268","Total",15,3,3,9,2,1,0,1,13,2,3,8
"2011","Teignbridge 008E","E01020270","Total",44,18,13,13,4,1,2,1,40,17,11,12
"2011","Teignbridge 009A","E01020250","Total",23,7,10,6,3,0,3,0,20,7,7,6
"2011","Teignbridge 009B","E01020252","Total",49,21,13,15,5,0,3,2,44,21,10,13
"2011","Teignbridge 009C","E01020253","Total",52,22,23,7,5,1,4,0,47,21,19,7
"2011","Teignbridge 009D","E01020254","Total",49,17,15,17,4,0,3,1,45,17,12,16
"2011","Teignbridge 009E","E01020255","Total",31,17,5,9,3,0,0,3,28,17,5,6
"2011","Teignbridge 009F","E01020257","Total",19,11,6,2,3,0,2,1,16,11,4,1
"2011","Teignbridge 010A","E01020264","Total",47,18,14,15,2,0,1,1,45,18,13,14
"2011","Teignbridge 010B","E01020269","Total",51,22,7,22,6,4,1,1,45,18,6,21
"2011","Teignbridge 010C","E01020271","Total",72,32,15,25,7,2,3,2,65,30,12,23
"2011","Teignbridge 010D","E01020272","Total",92,25,26,41,10,1,7,2,82,24,19,39
"2011","Teignbridge 011A","E01020200","Total",14,5,4,5,0,0,0,0,14,5,4,5
"2011","Teignbridge 011B","E01020201","Total",21,10,5,6,0,0,0,0,21,10,5,6
"2011","Teignbridge 011C","E01020251","Total",28,12,10,6,2,0,2,0,26,12,8,6
"2011","Teignbridge 011D","E01020260","Total",27,11,4,12,6,1,4,1,21,10,0,11
"2011","Teignbridge 011E","E01020261","Total",14,4,6,4,3,0,3,0,11,4,3,4
"2011","Teignbridge 012A","E01020208","Total",46,14,11,21,4,1,1,2,42,13,10,19
"2011","Teignbridge 012B","E01020209","Total",49,19,9,21,7,0,3,4,42,19,6,17
"2011","Teignbridge 012C","E01020210","Total",11,6,4,1,0,0,0,0,11,6,4,1
"2011","Teignbridge 012D","E01020219","Total",63,24,18,21,7,0,6,1,56,24,12,20
"2011","Teignbridge 013A","E01020191","Total",12,8,3,1,0,0,0,0,12,8,3,1
"2011","Teignbridge 013B","E01020194","Total",40,24,11,5,2,0,2,0,38,24,9,5
"2011","Teignbridge 013C","E01020207","Total",37,22,10,5,5,0,5,0,32,22,5,5
"2011","Teignbridge 013D","E01020256","Total",36,12,15,9,4,1,3,0,32,11,12,9
"2011","Teignbridge 014A","E01020211","Total",64,18,16,30,6,1,2,3,58,17,14,27
"2011","Teignbridge 014B","E01020217","Total",65,23,23,19,10,1,6,3,55,22,17,16
"2011","Teignbridge 014C","E01020218","Total",57,19,12,26,3,1,1,1,54,18,11,25
"2011","Teignbridge 014D","E01020224","Total",55,19,19,17,5,1,3,1,50,18,16,16
"2011","Teignbridge 015A","E01020216","Total",80,32,17,31,13,2,4,7,67,30,13,24
"2011","Teignbridge 015B","E01020225","Total",57,20,25,12,2,0,2,0,55,20,23,12
"2011","Teignbridge 015C","E01020226","Total",16,2,9,5,3,0,3,0,13,2,6,5
"2011","Teignbridge 015D","E01020227","Total",37,15,8,14,3,1,1,1,34,14,7,13
"2011","Teignbridge 016A","E01020212","Total",44,14,5,25,7,1,2,4,37,13,3,21
"2011","Teignbridge 016B","E01020213","Total",45,21,4,20,3,0,2,1,42,21,2,19
"2011","Teignbridge 016C","E01020214","Total",24,8,9,7,3,1,1,1,21,7,8,6
"2011","Teignbridge 016D","E01020215","Total",10,3,6,1,1,0,1,0,9,3,5,1
"2011","Teignbridge 017A","E01020195","Total",45,19,18,8,7,1,6,0,38,18,12,8
"2011","Teignbridge 017B","E01020196","Total",63,27,12,24,6,1,1,4,57,26,11,20
"2011","Teignbridge 017C","E01020197","Total",16,6,3,7,4,1,2,1,12,5,1,6
"2011","Teignbridge 017D","E01020198","Total",68,21,27,20,6,1,5,0,62,20,22,20
"2011","Teignbridge 017E","E01020199","Total",63,26,15,22,9,1,6,2,54,25,9,20
"2011","Teignbridge 018A","E01020246","Total",22,9,7,6,2,0,2,0,20,9,5,6
"2011","Teignbridge 018B","E01020247","Total",47,15,16,16,5,0,4,1,42,15,12,15
"2011","Teignbridge 018C","E01020248","Total",20,9,5,6,3,0,2,1,17,9,3,5
"2011","Teignbridge 018D","E01020249","Total",16,4,9,3,4,0,3,1,12,4,6,2
"2011","Teignbridge 019A","E01020192","Total",19,6,8,5,0,0,0,0,19,6,8,5
"2011","Teignbridge 019B","E01020193","Total",25,10,8,7,5,0,2,3,20,10,6,4
"2011","Teignbridge 019C","E01020238","Total",22,8,8,6,1,0,0,1,21,8,8,5
"2011","Teignbridge 019D","E01020239","Total",22,8,5,9,2,0,2,0,20,8,3,9
"2011","Torridge 001A","E01020275","Total",42,17,8,17,1,0,1,0,41,17,7,17
"2011","Torridge 001B","E01020276","Total",24,8,9,7,2,0,1,1,22,8,8,6
"2011","Torridge 001C","E01020297","Total",61,23,11,27,5,2,2,1,56,21,9,26
"2011","Torridge 001D","E01020299","Total",30,12,9,9,4,2,2,0,26,10,7,9
"2011","Torridge 002A","E01020298","Total",34,14,10,10,6,0,6,0,28,14,4,10
"2011","Torridge 002B","E01020300","Total",34,16,11,7,3,1,1,1,31,15,10,6
"2011","Torridge 002C","E01020310","Total",43,18,11,14,6,3,3,0,37,15,8,14
"2011","Torridge 003A","E01020280","Total",89,31,17,41,9,3,2,4,80,28,15,37
"2011","Torridge 003B","E01020281","Total",34,17,11,6,6,1,4,1,28,16,7,5
"2011","Torridge 003C","E01020282","Total",45,14,11,20,5,0,2,3,40,14,9,17
"2011","Torridge 004A","E01020277","Total",82,35,7,40,0,0,0,0,82,35,7,40
"2011","Torridge 004B","E01020278","Total",29,11,11,7,7,0,6,1,22,11,5,6
"2011","Torridge 004C","E01020279","Total",88,27,18,43,3,0,2,1,85,27,16,42
"2011","Torridge 004D","E01020283","Total",41,15,12,14,8,0,5,3,33,15,7,11
"2011","Torridge 004E","E01020284","Total",69,27,14,28,4,0,2,2,65,27,12,26
"2011","Torridge 004F","E01020285","Total",86,24,17,45,12,1,9,2,74,23,8,43
"2011","Torridge 005A","E01020288","Total",27,15,7,5,4,0,3,1,23,15,4,4
"2011","Torridge 005B","E01020292","Total",24,14,3,7,3,2,1,0,21,12,2,7
"2011","Torridge 005C","E01020295","Total",16,8,5,3,3,0,2,1,13,8,3,2
"2011","Torridge 005D","E01020296","Total",20,7,4,9,4,0,2,2,16,7,2,7
"2011","Torridge 006A","E01020304","Total",50,16,12,22,6,0,5,1,44,16,7,21
"2011","Torridge 006B","E01020305","Total",41,12,10,19,10,1,3,6,31,11,7,13
"2011","Torridge 006C","E01020306","Total",28,13,8,7,6,2,4,0,22,11,4,7
"2011","Torridge 006D","E01020307","Total",75,28,15,32,10,1,8,1,65,27,7,31
"2011","Torridge 007A","E01020287","Total",21,12,4,5,4,0,3,1,17,12,1,4
"2011","Torridge 007B","E01020303","Total",26,10,9,7,4,3,1,0,22,7,8,7
"2011","Torridge 007C","E01020308","Total",15,8,4,3,3,0,2,1,12,8,2,2
"2011","Torridge 007D","E01020311","Total",30,7,9,14,3,0,2,1,27,7,7,13
"2011","Torridge 008A","E01020291","Total",27,11,10,6,4,0,3,1,23,11,7,5
"2011","Torridge 008B","E01020293","Total",39,14,6,19,4,0,3,1,35,14,3,18
"2011","Torridge 008C","E01020294","Total",40,18,7,15,5,2,2,1,35,16,5,14
"2011","Torridge 008D","E01020302","Total",27,9,8,10,3,0,1,2,24,9,7,8
"2011","Torridge 008E","E01020309","Total",21,7,6,8,5,0,4,1,16,7,2,7
"2011","Torridge 009A","E01020286","Total",24,11,5,8,3,1,1,1,21,10,4,7
"2011","Torridge 009B","E01020289","Total",15,5,9,1,3,0,3,0,12,5,6,1
"2011","Torridge 009C","E01020290","Total",21,7,9,5,6,1,5,0,15,6,4,5
"2011","Torridge 009D","E01020301","Total",24,10,6,8,2,0,2,0,22,10,4,8
"2011","West Devon 001A","E01020320","Total",15,5,8,2,3,1,2,0,12,4,6,2
"2011","West Devon 001B","E01020321","Total",40,16,11,13,3,0,3,0,37,16,8,13
"2011","West Devon 001C","E01020322","Total",19,6,9,4,3,1,2,0,16,5,7,4
"2011","West Devon 001D","E01020326","Total",43,18,13,12,6,3,2,1,37,15,11,11
"2011","West Devon 002A","E01020327","Total",37,12,11,14,2,0,1,1,35,12,10,13
"2011","West Devon 002B","E01020328","Total",75,23,19,33,4,0,3,1,71,23,16,32
"2011","West Devon 002C","E01020329","Total",20,8,11,1,8,2,6,0,12,6,5,1
"2011","West Devon 002D","E01020330","Total",47,22,9,16,3,0,2,1,44,22,7,15
"2011","West Devon 003A","E01020318","Total",31,13,10,8,4,1,2,1,27,12,8,7
"2011","West Devon 003B","E01020319","Total",25,15,6,4,1,0,1,0,24,15,5,4
"2011","West Devon 003C","E01020323","Total",33,16,8,9,1,0,1,0,32,16,7,9
"2011","West Devon 003D","E01020339","Total",33,19,8,6,4,1,3,0,29,18,5,6
"2011","West Devon 004A","E01020314","Total",18,6,6,6,3,1,1,1,15,5,5,5
"2011","West Devon 004B","E01020325","Total",32,14,13,5,6,2,4,0,26,12,9,5
"2011","West Devon 004C","E01020331","Total",25,13,4,8,5,2,2,1,20,11,2,7
"2011","West Devon 004D","E01020340","Total",23,17,2,4,1,0,0,1,22,17,2,3
"2011","West Devon 005A","E01020332","Total",33,10,12,11,4,0,4,0,29,10,8,11
"2011","West Devon 005B","E01020333","Total",44,18,15,11,5,0,5,0,39,18,10,11
"2011","West Devon 005C","E01020334","Total",71,29,22,20,7,1,5,1,64,28,17,19
"2011","West Devon 005D","E01020335","Total",22,10,6,6,5,2,1,2,17,8,5,4
"2011","West Devon 005E","E01020336","Total",13,9,3,1,1,0,1,0,12,9,2,1
"2011","West Devon 005F","E01020337","Total",21,6,5,10,3,0,3,0,18,6,2,10
"2011","West Devon 005G","E01020338","Total",80,38,18,24,4,0,3,1,76,38,15,23
"2011","West Devon 006A","E01020317","Total",31,11,13,7,8,2,6,0,23,9,7,7
"2011","West Devon 006B","E01020324","Total",21,12,6,3,3,0,3,0,18,12,3,3
"2011","West Devon 006C","E01020341","Total",18,9,5,4,1,1,0,0,17,8,5,4
"2011","West Devon 006D","E01020342","Total",38,17,10,11,3,1,1,1,35,16,9,10
"2011","West Devon 007A","E01020312","Total",24,14,5,5,3,0,2,1,21,14,3,4
"2011","West Devon 007B","E01020313","Total",38,22,9,7,1,0,1,0,37,22,8,7
"2011","West Devon 007C","E01020315","Total",29,11,11,7,2,0,2,0,27,11,9,7
"2011","West Devon 007D","E01020316","Total",25,11,11,3,4,1,3,0,21,10,8,3
"2011","Christchurch 001A","E01020343","Total",14,8,1,5,2,1,0,1,12,7,1,4
"2011","Christchurch 001B","E01020344","Total",48,22,11,15,2,1,0,1,46,21,11,14
"2011","Christchurch 001C","E01020345","Total",23,14,3,6,1,0,0,1,22,14,3,5
"2011","Christchurch 001D","E01020365","Total",16,6,6,4,3,0,3,0,13,6,3,4
"2011","Christchurch 002A","E01020351","Total",13,4,3,6,1,0,1,0,12,4,2,6
"2011","Christchurch 002B","E01020352","Total",27,17,7,3,4,0,3,1,23,17,4,2
"2011","Christchurch 002C","E01020353","Total",43,21,7,15,8,1,3,4,35,20,4,11
"2011","Christchurch 002D","E01020359","Total",43,16,10,17,3,0,1,2,40,16,9,15
"2011","Christchurch 002E","E01020366","Total",11,8,2,1,2,1,0,1,9,7,2,0
"2011","Christchurch 003A","E01020349","Total",18,10,5,3,2,0,2,0,16,10,3,3
"2011","Christchurch 003B","E01020350","Total",11,4,4,3,2,0,2,0,9,4,2,3
"2011","Christchurch 003C","E01020357","Total",43,17,13,13,6,0,5,1,37,17,8,12
"2011","Christchurch 003D","E01020358","Total",15,7,8,0,4,0,4,0,11,7,4,0
"2011","Christchurch 004A","E01020369","Total",26,9,9,8,2,0,1,1,24,9,8,7
"2011","Christchurch 004B","E01020370","Total",26,12,8,6,1,0,1,0,25,12,7,6
"2011","Christchurch 004C","E01020371","Total",7,5,1,1,0,0,0,0,7,5,1,1
"2011","Christchurch 004D","E01020372","Total",17,4,7,6,3,0,2,1,14,4,5,5
"2011","Christchurch 005A","E01020346","Total",57,21,12,24,7,2,3,2,50,19,9,22
"2011","Christchurch 005B","E01020347","Total",61,16,7,38,9,1,3,5,52,15,4,33
"2011","Christchurch 005C","E01020348","Total",63,24,8,31,9,3,2,4,54,21,6,27
"2011","Christchurch 005D","E01020363","Total",38,16,4,18,6,2,3,1,32,14,1,17
"2011","Christchurch 006A","E01020360","Total",33,10,15,8,5,0,5,0,28,10,10,8
"2011","Christchurch 006B","E01020361","Total",49,25,14,10,4,0,4,0,45,25,10,10
"2011","Christchurch 006C","E01020364","Total",33,12,6,15,0,0,0,0,33,12,6,15
"2011","Christchurch 006D","E01020367","Total",48,18,16,14,1,0,1,0,47,18,15,14
"2011","Christchurch 006E","E01020368","Total",46,17,13,16,5,0,4,1,41,17,9,15
"2011","Christchurch 007A","E01020354","Total",37,11,10,16,4,0,2,2,33,11,8,14
"2011","Christchurch 007B","E01020355","Total",14,4,7,3,0,0,0,0,14,4,7,3
"2011","Christchurch 007C","E01020356","Total",11,6,1,4,0,0,0,0,11,6,1,4
"2011","Christchurch 007D","E01020362","Total",20,7,7,6,3,0,3,0,17,7,4,6
"2011","East Dorset 001A","E01020373","Total",43,19,12,12,6,2,4,0,37,17,8,12
"2011","East Dorset 001B","E01020374","Total",14,4,7,3,6,1,3,2,8,3,4,1
"2011","East Dorset 001C","E01020389","Total",31,11,11,9,7,1,4,2,24,10,7,7
"2011","East Dorset 001D","E01020397","Total",14,8,2,4,0,0,0,0,14,8,2,4
"2011","East Dorset 002A","E01020416","Total",69,29,30,10,11,0,11,0,58,29,19,10
"2011","East Dorset 002B","E01020417","Total",19,8,7,4,4,0,3,1,15,8,4,3
"2011","East Dorset 002C","E01020418","Total",10,4,3,3,2,0,1,1,8,4,2,2
"2011","East Dorset 002D","E01020419","Total",33,13,17,3,3,0,3,0,30,13,14,3
"2011","East Dorset 002E","E01020420","Total",22,12,7,3,2,0,2,0,20,12,5,3
"2011","East Dorset 003A","E01020411","Total",32,10,11,11,5,0,5,0,27,10,6,11
"2011","East Dorset 003B","E01020412","Total",56,22,10,24,12,2,2,8,44,20,8,16
"2011","East Dorset 003C","E01020413","Total",12,2,7,3,3,0,2,1,9,2,5,2
"2011","East Dorset 003D","E01020414","Total",43,27,10,6,3,1,1,1,40,26,9,5
"2011","East Dorset 003E","E01020415","Total",19,5,9,5,4,1,3,0,15,4,6,5
"2011","East Dorset 004A","E01020403","Total",9,0,4,5,3,0,2,1,6,0,2,4
"2011","East Dorset 004B","E01020404","Total",21,3,13,5,11,0,7,4,10,3,6,1
"2011","East Dorset 004C","E01020405","Total",7,2,1,4,1,0,1,0,6,2,0,4
"2011","East Dorset 004D","E01020406","Total",14,7,4,3,2,0,0,2,12,7,4,1
"2011","East Dorset 005A","E01020396","Total",17,11,5,1,3,1,2,0,14,10,3,1
"2011","East Dorset 005B","E01020398","Total",16,7,3,6,0,0,0,0,16,7,3,6
"2011","East Dorset 005C","E01020409","Total",17,9,6,2,3,0,2,1,14,9,4,1
"2011","East Dorset 005D","E01020410","Total",27,12,7,8,5,1,3,1,22,11,4,7
"2011","East Dorset 006A","E01020421","Total",26,11,9,6,6,1,4,1,20,10,5,5
"2011","East Dorset 006B","E01020422","Total",26,12,6,8,6,3,2,1,20,9,4,7
"2011","East Dorset 006C","E01020423","Total",20,8,6,6,3,1,2,0,17,7,4,6
"2011","East Dorset 006D","E01020424","Total",20,11,5,4,3,2,1,0,17,9,4,4
"2011","East Dorset 006E","E01020425","Total",30,11,10,9,9,2,7,0,21,9,3,9
"2011","East Dorset 007A","E01020377","Total",17,11,4,2,1,0,1,0,16,11,3,2
"2011","East Dorset 007B","E01020379","Total",26,10,10,6,2,0,2,0,24,10,8,6
"2011","East Dorset 007C","E01020380","Total",9,3,5,1,2,0,2,0,7,3,3,1
"2011","East Dorset 007D","E01020381","Total",11,4,5,2,2,0,2,0,9,4,3,2
"2011","East Dorset 008A","E01020390","Total",21,7,6,8,3,0,2,1,18,7,4,7
"2011","East Dorset 008B","E01020391","Total",12,6,2,4,0,0,0,0,12,6,2,4
"2011","East Dorset 008C","E01020392","Total",14,4,4,6,1,0,1,0,13,4,3,6
"2011","East Dorset 008D","E01020393","Total",73,29,10,34,8,0,1,7,65,29,9,27
"2011","East Dorset 008E","E01020394","Total",38,13,4,21,8,3,1,4,30,10,3,17
"2011","East Dorset 009A","E01020375","Total",23,14,5,4,3,1,2,0,20,13,3,4
"2011","East Dorset 009B","E01020376","Total",24,10,9,5,6,1,3,2,18,9,6,3
"2011","East Dorset 009C","E01020378","Total",31,21,4,6,1,1,0,0,30,20,4,6
"2011","East Dorset 009D","E01020407","Total",14,9,4,1,2,0,2,0,12,9,2,1
"2011","East Dorset 009E","E01020408","Total",18,12,3,3,3,0,3,0,15,12,0,3
"2011","East Dorset 010A","E01020426","Total",50,28,16,6,7,2,4,1,43,26,12,5
"2011","East Dorset 010B","E01020427","Total",50,16,15,19,2,0,1,1,48,16,14,18
"2011","East Dorset 010C","E01020428","Total",47,22,15,10,12,2,9,1,35,20,6,9
"2011","East Dorset 010D","E01020429","Total",49,27,11,11,5,1,3,1,44,26,8,10
"2011","East Dorset 011A","E01020395","Total",11,5,2,4,1,0,1,0,10,5,1,4
"2011","East Dorset 011B","E01020399","Total",42,14,16,12,6,1,3,2,36,13,13,10
"2011","East Dorset 011C","E01020400","Total",13,4,3,6,3,2,1,0,10,2,2,6
"2011","East Dorset 011D","E01020401","Total",15,8,6,1,2,0,1,1,13,8,5,0
"2011","East Dorset 011E","E01020402","Total",14,9,3,2,1,0,1,0,13,9,2,2
"2011","East Dorset 012A","E01020382","Total",36,14,10,12,5,3,1,1,31,11,9,11
"2011","East Dorset 012B","E01020383","Total",20,13,6,1,2,0,2,0,18,13,4,1
"2011","East Dorset 012C","E01020384","Total",58,31,16,11,6,0,5,1,52,31,11,10
"2011","East Dorset 012D","E01020385","Total",35,12,12,11,4,0,4,0,31,12,8,11
"2011","East Dorset 012E","E01020386","Total",21,9,9,3,5,1,4,0,16,8,5,3
"2011","East Dorset 012F","E01020387","Total",11,5,4,2,4,2,2,0,7,3,2,2
"2011","East Dorset 012G","E01020388","Total",58,28,12,18,3,0,2,1,55,28,10,17
"2011","North Dorset 001A","E01020443","Total",82,35,17,30,9,5,2,2,73,30,15,28
"2011","North Dorset 001B","E01020447","Total",32,14,6,12,8,2,3,3,24,12,3,9
"2011","North Dorset 001C","E01020463","Total",32,15,8,9,6,0,5,1,26,15,3,8
"2011","North Dorset 001D","E01020464","Total",28,14,11,3,6,0,6,0,22,14,5,3
"2011","North Dorset 002A","E01020440","Total",28,12,10,6,4,1,3,0,24,11,7,6
"2011","North Dorset 002B","E01020450","Total",56,22,15,19,6,0,4,2,50,22,11,17
"2011","North Dorset 002D","E01020462","Total",15,5,4,6,2,0,1,1,13,5,3,5
"2011","North Dorset 002E","E01033156","Total",41,22,10,9,2,0,2,0,39,22,8,9
"2011","North Dorset 002F","E01033158","Total",25,11,6,8,3,0,3,0,22,11,3,8
"2011","North Dorset 003A","E01020454","Total",49,20,12,17,7,3,4,0,42,17,8,17
"2011","North Dorset 003B","E01020455","Total",34,12,7,15,3,1,1,1,31,11,6,14
"2011","North Dorset 003C","E01020456","Total",55,25,12,18,6,0,3,3,49,25,9,15
"2011","North Dorset 003D","E01020457","Total",17,9,4,4,1,0,1,0,16,9,3,4
"2011","North Dorset 004A","E01020433","Total",28,17,8,3,4,1,3,0,24,16,5,3
"2011","North Dorset 004B","E01020434","Total",32,15,8,9,1,0,1,0,31,15,7,9
"2011","North Dorset 004C","E01020449","Total",25,14,5,6,3,0,0,3,22,14,5,3
"2011","North Dorset 004D","E01020458","Total",43,17,19,7,4,0,4,0,39,17,15,7
"2011","North Dorset 004E","E01020459","Total",79,32,20,27,8,1,5,2,71,31,15,25
"2011","North Dorset 005A","E01020444","Total",50,22,12,16,7,1,3,3,43,21,9,13
"2011","North Dorset 005B","E01020445","Total",16,6,6,4,0,0,0,0,16,6,6,4
"2011","North Dorset 005C","E01020446","Total",19,12,2,5,3,1,0,2,16,11,2,3
"2011","North Dorset 005D","E01020460","Total",20,8,8,4,7,0,7,0,13,8,1,4
"2011","North Dorset 006A","E01020442","Total",30,13,10,7,3,1,1,1,27,12,9,6
"2011","North Dorset 006B","E01020452","Total",33,12,9,12,2,0,1,1,31,12,8,11
"2011","North Dorset 006C","E01020453","Total",28,12,6,10,2,0,0,2,26,12,6,8
"2011","North Dorset 006E","E01033154","Total",18,6,10,2,5,3,2,0,13,3,8,2
"2011","North Dorset 006F","E01033159","Total",12,5,6,1,4,1,2,1,8,4,4,0
"2011","North Dorset 007A","E01020435","Total",26,12,9,5,5,0,3,2,21,12,6,3
"2011","North Dorset 007B","E01020436","Total",48,14,13,21,4,0,4,0,44,14,9,21
"2011","North Dorset 007C","E01020437","Total",39,10,9,20,2,0,1,1,37,10,8,19
"2011","North Dorset 007D","E01020438","Total",60,21,16,23,3,0,2,1,57,21,14,22
"2011","North Dorset 007E","E01020439","Total",50,16,12,22,4,2,2,0,46,14,10,22
"2011","North Dorset 008A","E01020430","Total",20,9,6,5,3,0,3,0,17,9,3,5
"2011","North Dorset 008B","E01020431","Total",14,3,5,6,3,0,2,1,11,3,3,5
"2011","North Dorset 008C","E01020432","Total",16,6,3,7,1,0,0,1,15,6,3,6
"2011","North Dorset 008D","E01020441","Total",35,19,7,9,2,0,2,0,33,19,5,9
"2011","North Dorset 008E","E01020448","Total",37,17,9,11,4,0,3,1,33,17,6,10
"2011","Purbeck 001A","E01020465","Total",44,23,13,8,6,3,1,2,38,20,12,6
"2011","Purbeck 001B","E01020469","Total",44,29,8,7,3,1,2,0,41,28,6,7
"2011","Purbeck 001C","E01020470","Total",25,9,11,5,2,0,2,0,23,9,9,5
"2011","Purbeck 002A","E01020471","Total",57,21,14,22,3,0,1,2,54,21,13,20
"2011","Purbeck 002B","E01020472","Total",49,16,9,24,8,1,4,3,41,15,5,21
"2011","Purbeck 002C","E01020473","Total",42,17,6,19,5,2,3,0,37,15,3,19
"2011","Purbeck 002D","E01020474","Total",20,9,7,4,3,0,3,0,17,9,4,4
"2011","Purbeck 002E","E01020475","Total",43,23,13,7,5,1,3,1,38,22,10,6
"2011","Purbeck 003A","E01020476","Total",13,5,5,3,0,0,0,0,13,5,5,3
"2011","Purbeck 003B","E01020477","Total",40,18,7,15,4,0,3,1,36,18,4,14
"2011","Purbeck 003C","E01020485","Total",48,15,11,22,6,2,1,3,42,13,10,19
"2011","Purbeck 003D","E01020486","Total",31,21,5,5,3,0,2,1,28,21,3,4
"2011","Purbeck 003E","E01020487","Total",27,15,6,6,2,1,1,0,25,14,5,6
"2011","Purbeck 003F","E01020488","Total",28,12,7,9,4,0,2,2,24,12,5,7
"2011","Purbeck 004A","E01020489","Total",17,9,5,3,2,1,1,0,15,8,4,3
"2011","Purbeck 004B","E01020490","Total",18,9,3,6,1,0,1,0,17,9,2,6
"2011","Purbeck 004C","E01020491","Total",38,14,13,11,7,1,6,0,31,13,7,11
"2011","Purbeck 004D","E01020492","Total",25,11,4,10,1,1,0,0,24,10,4,10
"2011","Purbeck 004E","E01020493","Total",75,23,26,26,6,1,5,0,69,22,21,26
"2011","Purbeck 005A","E01020466","Total",19,7,8,4,4,0,4,0,15,7,4,4
"2011","Purbeck 005B","E01020467","Total",28,11,12,5,5,1,4,0,23,10,8,5
"2011","Purbeck 005C","E01020468","Total",19,10,3,6,4,2,1,1,15,8,2,5
"2011","Purbeck 006A","E01020478","Total",19,16,2,1,2,1,1,0,17,15,1,1
"2011","Purbeck 006B","E01020479","Total",13,4,3,6,2,1,1,0,11,3,2,6
"2011","Purbeck 006C","E01020480","Total",12,9,1,2,2,2,0,0,10,7,1,2
"2011","Purbeck 006D","E01020481","Total",24,9,7,8,5,1,4,0,19,8,3,8
"2011","Purbeck 006E","E01020482","Total",30,12,3,15,2,0,1,1,28,12,2,14
"2011","Purbeck 006F","E01020483","Total",44,26,9,9,8,3,4,1,36,23,5,8
"2011","Purbeck 006G","E01020484","Total",35,18,7,10,3,0,2,1,32,18,5,9
"2011","West Dorset 001A","E01020542","Total",25,11,8,6,2,0,2,0,23,11,6,6
"2011","West Dorset 001B","E01020543","Total",74,37,9,28,5,0,3,2,69,37,6,26
"2011","West Dorset 001C","E01020544","Total",29,11,13,5,4,0,4,0,25,11,9,5
"2011","West Dorset 001E","E01020546","Total",22,8,8,6,4,0,2,2,18,8,6,4
"2011","West Dorset 001F","E01020547","Total",32,20,2,10,1,0,1,0,31,20,1,10
"2011","West Dorset 001H","E01032642","Total",36,21,6,9,2,1,1,0,34,20,5,9
"2011","West Dorset 002A","E01020497","Total",25,17,4,4,2,0,1,1,23,17,3,3
"2011","West Dorset 002B","E01020508","Total",23,9,7,7,4,2,0,2,19,7,7,5
"2011","West Dorset 002C","E01020541","Total",30,15,11,4,4,0,4,0,26,15,7,4
"2011","West Dorset 002D","E01020550","Total",16,9,3,4,0,0,0,0,16,9,3,4
"2011","West Dorset 003A","E01020494","Total",23,9,10,4,6,0,5,1,17,9,5,3
"2011","West Dorset 003B","E01020495","Total",34,15,10,9,6,1,3,2,28,14,7,7
"2011","West Dorset 003C","E01020496","Total",43,19,11,13,5,4,0,1,38,15,11,12
"2011","West Dorset 003D","E01020506","Total",20,9,6,5,3,0,2,1,17,9,4,4
"2011","West Dorset 003E","E01020530","Total",17,6,5,6,6,0,4,2,11,6,1,4
"2011","West Dorset 003F","E01020534","Total",32,15,5,12,5,2,1,2,27,13,4,10
"2011","West Dorset 004A","E01020509","Total",40,13,17,10,9,1,6,2,31,12,11,8
"2011","West Dorset 004B","E01020510","Total",47,16,14,17,14,3,9,2,33,13,5,15
"2011","West Dorset 004C","E01020529","Total",33,16,10,7,6,0,4,2,27,16,6,5
"2011","West Dorset 004D","E01020539","Total",18,9,6,3,1,0,1,0,17,9,5,3
"2011","West Dorset 004E","E01020540","Total",38,23,7,8,7,1,3,3,31,22,4,5
"2011","West Dorset 005A","E01020511","Total",25,17,3,5,5,2,2,1,20,15,1,4
"2011","West Dorset 005B","E01020532","Total",23,14,4,5,2,0,2,0,21,14,2,5
"2011","West Dorset 005C","E01020533","Total",65,30,20,15,13,1,8,4,52,29,12,11
"2011","West Dorset 005D","E01020535","Total",18,9,5,4,3,2,0,1,15,7,5,3
"2011","West Dorset 006A","E01020498","Total",35,17,7,11,4,0,2,2,31,17,5,9
"2011","West Dorset 006B","E01020499","Total",53,26,11,16,10,2,6,2,43,24,5,14
"2011","West Dorset 006C","E01020500","Total",30,15,7,8,3,0,3,0,27,15,4,8
"2011","West Dorset 006D","E01020501","Total",22,17,3,2,2,2,0,0,20,15,3,2
"2011","West Dorset 007A","E01020507","Total",26,15,3,8,3,2,0,1,23,13,3,7
"2011","West Dorset 007B","E01020517","Total",32,18,11,3,7,1,6,0,25,17,5,3
"2011","West Dorset 007C","E01020531","Total",33,13,10,10,7,0,4,3,26,13,6,7
"2011","West Dorset 007D","E01020536","Total",32,14,10,8,4,0,4,0,28,14,6,8
"2011","West Dorset 008A","E01020502","Total",57,19,15,23,9,2,5,2,48,17,10,21
"2011","West Dorset 008B","E01020503","Total",55,23,13,19,15,4,7,4,40,19,6,15
"2011","West Dorset 008C","E01020504","Total",23,15,3,5,1,1,0,0,22,14,3,5
"2011","West Dorset 009C","E01020526","Total",32,16,7,9,11,5,2,4,21,11,5,5
"2011","West Dorset 009D","E01020527","Total",47,24,14,9,1,1,0,0,46,23,14,9
"2011","West Dorset 009E","E01020528","Total",60,27,18,15,11,2,9,0,49,25,9,15
"2011","West Dorset 009F","E01032641","Total",56,15,19,22,6,2,1,3,50,13,18,19
"2011","West Dorset 009G","E01032643","Total",45,18,13,14,5,0,2,3,40,18,11,11
"2011","West Dorset 009H","E01032644","Total",31,13,9,9,4,0,2,2,27,13,7,7
"2011","West Dorset 009I","E01032645","Total",30,14,7,9,3,0,2,1,27,14,5,8
"2011","West Dorset 010A","E01020518","Total",51,19,16,16,4,0,1,3,47,19,15,13
"2011","West Dorset 010B","E01020519","Total",61,29,20,12,5,2,3,0,56,27,17,12
"2011","West Dorset 010C","E01020520","Total",16,10,5,1,2,0,2,0,14,10,3,1
"2011","West Dorset 010D","E01020523","Total",25,13,12,0,4,1,3,0,21,12,9,0
"2011","West Dorset 010E","E01020524","Total",20,13,4,3,3,1,2,0,17,12,2,3
"2011","West Dorset 010F","E01020525","Total",17,9,4,4,3,0,2,1,14,9,2,3
"2011","West Dorset 011A","E01020505","Total",24,12,9,3,1,0,1,0,23,12,8,3
"2011","West Dorset 011B","E01020537","Total",33,17,5,11,5,0,2,3,28,17,3,8
"2011","West Dorset 011C","E01020538","Total",34,16,6,12,2,0,1,1,32,16,5,11
"2011","West Dorset 011D","E01020549","Total",39,16,9,14,3,0,2,1,36,16,7,13
"2011","West Dorset 012A","E01020512","Total",37,18,11,8,3,1,2,0,34,17,9,8
"2011","West Dorset 012B","E01020513","Total",30,13,9,8,4,0,4,0,26,13,5,8
"2011","West Dorset 012C","E01020514","Total",25,9,10,6,0,0,0,0,25,9,10,6
"2011","West Dorset 012D","E01020515","Total",36,16,12,8,2,0,2,0,34,16,10,8
"2011","West Dorset 012E","E01020516","Total",35,17,9,9,4,1,3,0,31,16,6,9
"2011","Weymouth and Portland 001A","E01020551","Total",89,28,25,36,8,0,7,1,81,28,18,35
"2011","Weymouth and Portland 001B","E01020552","Total",101,34,15,52,13,1,4,8,88,33,11,44
"2011","Weymouth and Portland 001C","E01020570","Total",20,12,5,3,3,0,1,2,17,12,4,1
"2011","Weymouth and Portland 001D","E01020571","Total",74,26,18,30,4,1,1,2,70,25,17,28
"2011","Weymouth and Portland 002A","E01020557","Total",18,9,6,3,3,0,3,0,15,9,3,3
"2011","Weymouth and Portland 002B","E01020558","Total",26,11,11,4,5,1,4,0,21,10,7,4
"2011","Weymouth and Portland 002C","E01020559","Total",10,4,5,1,3,0,2,1,7,4,3,0
"2011","Weymouth and Portland 002D","E01020560","Total",30,18,8,4,2,1,1,0,28,17,7,4
"2011","Weymouth and Portland 002E","E01020561","Total",47,18,20,9,2,0,2,0,45,18,18,9
"2011","Weymouth and Portland 003A","E01020574","Total",63,27,5,31,4,0,1,3,59,27,4,28
"2011","Weymouth and Portland 003B","E01020575","Total",73,29,15,29,11,0,3,8,62,29,12,21
"2011","Weymouth and Portland 003C","E01020576","Total",34,16,9,9,3,1,1,1,31,15,8,8
"2011","Weymouth and Portland 003D","E01020579","Total",25,9,10,6,4,0,4,0,21,9,6,6
"2011","Weymouth and Portland 003E","E01020580","Total",31,14,10,7,1,1,0,0,30,13,10,7
"2011","Weymouth and Portland 004A","E01020553","Total",41,18,6,17,3,1,0,2,38,17,6,15
"2011","Weymouth and Portland 004B","E01020554","Total",58,12,15,31,8,0,6,2,50,12,9,29
"2011","Weymouth and Portland 004C","E01020555","Total",48,16,12,20,13,3,5,5,35,13,7,15
"2011","Weymouth and Portland 004D","E01020556","Total",32,17,3,12,4,3,1,0,28,14,2,12
"2011","Weymouth and Portland 004E","E01020581","Total",47,18,20,9,8,1,6,1,39,17,14,8
"2011","Weymouth and Portland 004F","E01020582","Total",66,28,16,22,13,5,7,1,53,23,9,21
"2011","Weymouth and Portland 005A","E01020572","Total",66,33,14,19,8,2,6,0,58,31,8,19
"2011","Weymouth and Portland 005B","E01020573","Total",61,25,10,26,6,4,2,0,55,21,8,26
"2011","Weymouth and Portland 005C","E01020577","Total",55,22,13,20,11,2,5,4,44,20,8,16
"2011","Weymouth and Portland 005D","E01020578","Total",60,26,15,19,8,2,5,1,52,24,10,18
"2011","Weymouth and Portland 006A","E01020583","Total",37,15,7,15,3,0,3,0,34,15,4,15
"2011","Weymouth and Portland 006B","E01020584","Total",31,14,7,10,2,0,2,0,29,14,5,10
"2011","Weymouth and Portland 006C","E01020585","Total",74,23,7,44,5,1,1,3,69,22,6,41
"2011","Weymouth and Portland 007A","E01020586","Total",42,18,10,14,9,1,6,2,33,17,4,12
"2011","Weymouth and Portland 007B","E01020587","Total",62,28,15,19,1,1,0,0,61,27,15,19
"2011","Weymouth and Portland 007C","E01020588","Total",25,13,5,7,1,0,1,0,24,13,4,7
"2011","Weymouth and Portland 007D","E01020589","Total",48,17,10,21,5,0,3,2,43,17,7,19
"2011","Weymouth and Portland 008A","E01020563","Total",30,11,9,10,5,0,3,2,25,11,6,8
"2011","Weymouth and Portland 008D","E01020569","Total",83,24,10,49,18,5,4,9,65,19,6,40
"2011","Weymouth and Portland 008E","E01033200","Total",76,30,8,38,13,8,1,4,63,22,7,34
"2011","Weymouth and Portland 009A","E01020562","Total",50,28,13,9,10,8,1,1,40,20,12,8
"2011","Weymouth and Portland 009B","E01020564","Total",84,29,15,40,6,1,3,2,78,28,12,38
"2011","Weymouth and Portland 009C","E01020565","Total",53,23,10,20,8,2,2,4,45,21,8,16
"2011","Weymouth and Portland 009D","E01020566","Total",33,16,10,7,0,0,0,0,33,16,10,7
"2011","Cheltenham 001A","E01022163","Total",42,21,8,13,4,1,3,0,38,20,5,13
"2011","Cheltenham 001B","E01022164","Total",59,14,11,34,1,0,0,1,58,14,11,33
"2011","Cheltenham 001C","E01022165","Total",23,9,5,9,2,0,2,0,21,9,3,9
"2011","Cheltenham 001D","E01022166","Total",36,16,11,9,4,0,4,0,32,16,7,9
"2011","Cheltenham 002A","E01022143","Total",14,4,4,6,0,0,0,0,14,4,4,6
"2011","Cheltenham 002B","E01022144","Total",14,4,5,5,0,0,0,0,14,4,5,5
"2011","Cheltenham 002C","E01022145","Total",17,12,4,1,2,1,1,0,15,11,3,1
"2011","Cheltenham 002D","E01022146","Total",13,3,7,3,3,0,3,0,10,3,4,3
"2011","Cheltenham 003A","E01022122","Total",80,21,16,43,7,1,2,4,73,20,14,39
"2011","Cheltenham 003B","E01022160","Total",111,45,13,53,3,0,2,1,108,45,11,52
"2011","Cheltenham 003C","E01022161","Total",56,19,12,25,6,0,4,2,50,19,8,23
"2011","Cheltenham 003D","E01022162","Total",46,11,11,24,7,0,3,4,39,11,8,20
"2011","Cheltenham 004A","E01022139","Total",14,7,4,3,0,0,0,0,14,7,4,3
"2011","Cheltenham 004B","E01022151","Total",45,14,9,22,2,0,0,2,43,14,9,20
"2011","Cheltenham 004C","E01022152","Total",35,9,3,23,4,1,0,3,31,8,3,20
"2011","Cheltenham 004D","E01022153","Total",28,7,9,12,4,0,2,2,24,7,7,10
"2011","Cheltenham 004E","E01022154","Total",37,10,8,19,4,3,0,1,33,7,8,18
"2011","Cheltenham 005A","E01022120","Total",74,25,17,32,8,1,5,2,66,24,12,30
"2011","Cheltenham 005B","E01022121","Total",94,22,17,55,5,0,1,4,89,22,16,51
"2011","Cheltenham 005C","E01022147","Total",94,25,15,54,4,1,0,3,90,24,15,51
"2011","Cheltenham 005D","E01022157","Total",64,16,11,37,9,2,4,3,55,14,7,34
"2011","Cheltenham 005E","E01022159","Total",57,14,17,26,11,0,10,1,46,14,7,25
"2011","Cheltenham 006A","E01022131","Total",50,12,8,30,7,0,4,3,43,12,4,27
"2011","Cheltenham 006B","E01022132","Total",49,23,7,19,2,1,0,1,47,22,7,18
"2011","Cheltenham 006C","E01022133","Total",58,22,9,27,6,2,3,1,52,20,6,26
"2011","Cheltenham 006D","E01022134","Total",47,14,8,25,6,0,0,6,41,14,8,19
"2011","Cheltenham 007A","E01022148","Total",25,16,5,4,0,0,0,0,25,16,5,4
"2011","Cheltenham 007B","E01022149","Total",44,15,11,18,1,0,1,0,43,15,10,18
"2011","Cheltenham 007C","E01022150","Total",46,13,12,21,2,0,0,2,44,13,12,19
"2011","Cheltenham 007D","E01022155","Total",27,8,8,11,2,1,1,0,25,7,7,11
"2011","Cheltenham 007E","E01022156","Total",47,9,9,29,5,0,2,3,42,9,7,26
"2011","Cheltenham 007F","E01022158","Total",33,7,14,12,4,0,3,1,29,7,11,11
"2011","Cheltenham 008A","E01022100","Total",27,10,12,5,4,0,4,0,23,10,8,5
"2011","Cheltenham 008B","E01022101","Total",36,14,12,10,3,0,2,1,33,14,10,9
"2011","Cheltenham 008C","E01022102","Total",25,9,5,11,1,1,0,0,24,8,5,11
"2011","Cheltenham 008D","E01022140","Total",17,7,5,5,2,0,1,1,15,7,4,4
"2011","Cheltenham 008E","E01022141","Total",11,3,6,2,1,0,1,0,10,3,5,2
"2011","Cheltenham 008F","E01022142","Total",18,4,9,5,2,0,2,0,16,4,7,5
"2011","Cheltenham 009A","E01022116","Total",23,6,12,5,6,1,5,0,17,5,7,5
"2011","Cheltenham 009B","E01022117","Total",17,8,7,2,1,1,0,0,16,7,7,2
"2011","Cheltenham 009C","E01022119","Total",26,11,9,6,2,1,1,0,24,10,8,6
"2011","Cheltenham 009D","E01022124","Total",11,3,4,4,0,0,0,0,11,3,4,4
"2011","Cheltenham 009E","E01022125","Total",15,2,9,4,3,0,2,1,12,2,7,3
"2011","Cheltenham 009F","E01022126","Total",15,1,6,8,1,0,1,0,14,1,5,8
"2011","Cheltenham 009G","E01022127","Total",9,1,3,5,0,0,0,0,9,1,3,5
"2011","Cheltenham 010A","E01022106","Total",32,11,12,9,4,0,3,1,28,11,9,8
"2011","Cheltenham 010B","E01022107","Total",29,9,13,7,6,0,6,0,23,9,7,7
"2011","Cheltenham 010C","E01022108","Total",29,14,10,5,2,0,1,1,27,14,9,4
"2011","Cheltenham 010D","E01022123","Total",57,22,13,22,4,1,2,1,53,21,11,21
"2011","Cheltenham 011A","E01022135","Total",20,8,11,1,3,1,2,0,17,7,9,1
"2011","Cheltenham 011B","E01022136","Total",24,9,6,9,2,0,1,1,22,9,5,8
"2011","Cheltenham 011C","E01022137","Total",25,11,2,12,2,0,1,1,23,11,1,11
"2011","Cheltenham 011D","E01022138","Total",27,13,7,7,8,3,5,0,19,10,2,7
"2011","Cheltenham 011E","E01022174","Total",26,6,12,8,3,0,2,1,23,6,10,7
"2011","Cheltenham 012A","E01022103","Total",47,20,15,12,5,1,3,1,42,19,12,11
"2011","Cheltenham 012B","E01022104","Total",54,15,20,19,4,0,2,2,50,15,18,17
"2011","Cheltenham 012C","E01022105","Total",17,13,2,2,0,0,0,0,17,13,2,2
"2011","Cheltenham 012D","E01022109","Total",21,17,2,2,2,1,1,0,19,16,1,2
"2011","Cheltenham 012E","E01022110","Total",52,28,13,11,4,1,1,2,48,27,12,9
"2011","Cheltenham 012F","E01022111","Total",25,16,4,5,1,0,1,0,24,16,3,5
"2011","Cheltenham 012G","E01022112","Total",32,14,11,7,0,0,0,0,32,14,11,7
"2011","Cheltenham 013A","E01022167","Total",16,6,5,5,3,1,1,1,13,5,4,4
"2011","Cheltenham 013B","E01022168","Total",20,11,5,4,2,0,1,1,18,11,4,3
"2011","Cheltenham 013C","E01022169","Total",34,14,12,8,5,0,4,1,29,14,8,7
"2011","Cheltenham 013D","E01022170","Total",34,13,12,9,5,1,4,0,29,12,8,9
"2011","Cheltenham 013E","E01022171","Total",33,11,16,6,1,0,1,0,32,11,15,6
"2011","Cheltenham 013F","E01022172","Total",26,14,9,3,4,0,4,0,22,14,5,3
"2011","Cheltenham 013G","E01022173","Total",52,18,14,20,4,0,4,0,48,18,10,20
"2011","Cheltenham 014A","E01022113","Total",14,4,6,4,2,0,2,0,12,4,4,4
"2011","Cheltenham 014B","E01022114","Total",25,6,14,5,1,0,1,0,24,6,13,5
"2011","Cheltenham 014C","E01022115","Total",26,15,9,2,3,0,3,0,23,15,6,2
"2011","Cheltenham 014D","E01022118","Total",29,11,13,5,8,2,5,1,21,9,8,4
"2011","Cheltenham 015A","E01022128","Total",13,8,4,1,1,1,0,0,12,7,4,1
"2011","Cheltenham 015B","E01022129","Total",30,13,6,11,3,0,3,0,27,13,3,11
"2011","Cheltenham 015C","E01022130","Total",25,12,10,3,4,1,2,1,21,11,8,2
"2011","Cotswold 001A","E01022179","Total",47,18,19,10,6,1,4,1,41,17,15,9
"2011","Cotswold 001B","E01022182","Total",30,15,11,4,5,1,4,0,25,14,7,4
"2011","Cotswold 001C","E01022183","Total",27,14,8,5,4,2,2,0,23,12,6,5
"2011","Cotswold 001D","E01022184","Total",17,6,7,4,0,0,0,0,17,6,7,4
"2011","Cotswold 001E","E01022185","Total",23,8,8,7,3,1,1,1,20,7,7,6
"2011","Cotswold 002A","E01022177","Total",37,18,13,6,6,1,5,0,31,17,8,6
"2011","Cotswold 002B","E01022178","Total",25,11,8,6,3,0,2,1,22,11,6,5
"2011","Cotswold 002C","E01022205","Total",23,12,6,5,2,0,2,0,21,12,4,5
"2011","Cotswold 002D","E01022211","Total",34,19,5,10,4,2,1,1,30,17,4,9
"2011","Cotswold 002E","E01022212","Total",23,9,7,7,1,0,1,0,22,9,6,7
"2011","Cotswold 003A","E01022180","Total",59,29,19,11,5,0,5,0,54,29,14,11
"2011","Cotswold 003B","E01022181","Total",9,4,3,2,1,0,0,1,8,4,3,1
"2011","Cotswold 003C","E01022214","Total",43,18,18,7,6,1,5,0,37,17,13,7
"2011","Cotswold 003D","E01022222","Total",20,5,6,9,2,0,2,0,18,5,4,9
"2011","Cotswold 004A","E01022186","Total",17,6,6,5,3,0,3,0,14,6,3,5
"2011","Cotswold 004B","E01022187","Total",21,8,5,8,1,0,1,0,20,8,4,8
"2011","Cotswold 004C","E01022201","Total",21,9,5,7,0,0,0,0,21,9,5,7
"2011","Cotswold 004D","E01022216","Total",23,7,12,4,7,0,5,2,16,7,7,2
"2011","Cotswold 005A","E01022175","Total",26,10,5,11,1,0,1,0,25,10,4,11
"2011","Cotswold 005B","E01022207","Total",20,11,5,4,3,1,2,0,17,10,3,4
"2011","Cotswold 005C","E01022213","Total",25,11,8,6,2,1,0,1,23,10,8,5
"2011","Cotswold 005D","E01022215","Total",20,11,5,4,0,0,0,0,20,11,5,4
"2011","Cotswold 006A","E01022188","Total",44,22,4,18,6,3,2,1,38,19,2,17
"2011","Cotswold 006B","E01022189","Total",18,8,7,3,1,0,1,0,17,8,6,3
"2011","Cotswold 006C","E01022190","Total",44,19,9,16,5,1,3,1,39,18,6,15
"2011","Cotswold 006D","E01022196","Total",36,21,11,4,5,2,3,0,31,19,8,4
"2011","Cotswold 006E","E01022197","Total",32,13,10,9,4,0,4,0,28,13,6,9
"2011","Cotswold 007A","E01022194","Total",31,8,13,10,2,0,2,0,29,8,11,10
"2011","Cotswold 007B","E01022195","Total",32,14,13,5,0,0,0,0,32,14,13,5
"2011","Cotswold 007C","E01022199","Total",20,12,6,2,2,0,2,0,18,12,4,2
"2011","Cotswold 007D","E01022200","Total",49,16,11,22,6,1,3,2,43,15,8,20
"2011","Cotswold 008A","E01022191","Total",43,19,14,10,2,0,1,1,41,19,13,9
"2011","Cotswold 008B","E01022192","Total",39,18,11,10,3,0,3,0,36,18,8,10
"2011","Cotswold 008C","E01022193","Total",11,2,8,1,0,0,0,0,11,2,8,1
"2011","Cotswold 008D","E01022198","Total",23,13,4,6,4,1,1,2,19,12,3,4
"2011","Cotswold 008E","E01022225","Total",27,11,6,10,3,0,3,0,24,11,3,10
"2011","Cotswold 009A","E01022202","Total",10,2,5,3,4,0,3,1,6,2,2,2
"2011","Cotswold 009B","E01022203","Total",19,3,12,4,6,0,6,0,13,3,6,4
"2011","Cotswold 009C","E01022204","Total",46,23,10,13,4,0,2,2,42,23,8,11
"2011","Cotswold 009D","E01022208","Total",25,12,12,1,2,0,2,0,23,12,10,1
"2011","Cotswold 009E","E01022209","Total",19,9,7,3,4,2,2,0,15,7,5,3
"2011","Cotswold 009F","E01022210","Total",31,19,7,5,2,0,2,0,29,19,5,5
"2011","Cotswold 010A","E01022221","Total",32,16,5,11,0,0,0,0,32,16,5,11
"2011","Cotswold 010B","E01022223","Total",46,28,9,9,6,3,1,2,40,25,8,7
"2011","Cotswold 010C","E01022224","Total",18,9,4,5,4,0,3,1,14,9,1,4
"2011","Cotswold 011A","E01022176","Total",26,14,6,6,2,0,2,0,24,14,4,6
"2011","Cotswold 011B","E01022206","Total",17,9,4,4,1,1,0,0,16,8,4,4
"2011","Cotswold 011C","E01022217","Total",21,13,2,6,1,1,0,0,20,12,2,6
"2011","Cotswold 011D","E01022218","Total",37,25,3,9,0,0,0,0,37,25,3,9
"2011","Cotswold 011E","E01022219","Total",17,9,5,3,2,0,1,1,15,9,4,2
"2011","Cotswold 011F","E01022220","Total",24,12,6,6,5,1,2,2,19,11,4,4
"2011","Forest of Dean 001A","E01022233","Total",20,12,3,5,2,1,1,0,18,11,2,5
"2011","Forest of Dean 001B","E01022235","Total",24,16,7,1,1,0,1,0,23,16,6,1
"2011","Forest of Dean 001C","E01022247","Total",24,11,8,5,4,0,3,1,20,11,5,4
"2011","Forest of Dean 001D","E01022270","Total",38,12,11,15,9,0,7,2,29,12,4,13
"2011","Forest of Dean 001E","E01022271","Total",13,5,7,1,1,0,1,0,12,5,6,1
"2011","Forest of Dean 002A","E01022261","Total",43,20,10,13,5,1,4,0,38,19,6,13
"2011","Forest of Dean 002B","E01022262","Total",50,19,17,14,7,1,4,2,43,18,13,12
"2011","Forest of Dean 002C","E01022267","Total",16,7,6,3,4,1,3,0,12,6,3,3
"2011","Forest of Dean 003A","E01022251","Total",36,15,10,11,5,3,2,0,31,12,8,11
"2011","Forest of Dean 003B","E01022252","Total",20,7,9,4,7,2,5,0,13,5,4,4
"2011","Forest of Dean 003C","E01022258","Total",31,11,6,14,1,0,0,1,30,11,6,13
"2011","Forest of Dean 003D","E01022259","Total",25,13,8,4,4,1,3,0,21,12,5,4
"2011","Forest of Dean 003E","E01022260","Total",42,14,5,23,4,0,2,2,38,14,3,21
"2011","Forest of Dean 004A","E01022236","Total",47,18,16,13,10,1,7,2,37,17,9,11
"2011","Forest of Dean 004B","E01022237","Total",54,13,10,31,9,0,4,5,45,13,6,26
"2011","Forest of Dean 004C","E01022238","Total",56,25,7,24,6,1,3,2,50,24,4,22
"2011","Forest of Dean 004D","E01022239","Total",31,12,8,11,3,1,2,0,28,11,6,11
"2011","Forest of Dean 004E","E01022240","Total",68,22,14,32,8,2,3,3,60,20,11,29
"2011","Forest of Dean 004F","E01022249","Total",23,5,11,7,9,0,7,2,14,5,4,5
"2011","Forest of Dean 004G","E01022250","Total",42,12,10,20,4,0,3,1,38,12,7,19
"2011","Forest of Dean 005A","E01022228","Total",18,8,6,4,1,0,0,1,17,8,6,3
"2011","Forest of Dean 005B","E01022230","Total",23,10,7,6,4,0,3,1,19,10,4,5
"2011","Forest of Dean 005C","E01022265","Total",24,8,12,4,2,1,1,0,22,7,11,4
"2011","Forest of Dean 005D","E01022266","Total",14,4,5,5,2,0,2,0,12,4,3,5
"2011","Forest of Dean 006A","E01022234","Total",13,8,3,2,3,1,0,2,10,7,3,0
"2011","Forest of Dean 006B","E01022253","Total",32,14,12,6,3,0,3,0,29,14,9,6
"2011","Forest of Dean 006C","E01022263","Total",33,11,15,7,3,0,2,1,30,11,13,6
"2011","Forest of Dean 007A","E01022229","Total",28,10,7,11,2,0,2,0,26,10,5,11
"2011","Forest of Dean 007B","E01022241","Total",26,12,7,7,4,2,1,1,22,10,6,6
"2011","Forest of Dean 007C","E01022242","Total",31,12,5,14,5,1,2,2,26,11,3,12
"2011","Forest of Dean 007D","E01022243","Total",41,11,12,18,7,0,6,1,34,11,6,17
"2011","Forest of Dean 007E","E01022244","Total",37,13,5,19,3,0,2,1,34,13,3,18
"2011","Forest of Dean 007F","E01022245","Total",49,23,11,15,6,1,3,2,43,22,8,13
"2011","Forest of Dean 007G","E01022246","Total",18,10,4,4,0,0,0,0,18,10,4,4
"2011","Forest of Dean 008A","E01022231","Total",28,13,6,9,6,2,3,1,22,11,3,8
"2011","Forest of Dean 008B","E01022232","Total",37,15,8,14,7,1,3,3,30,14,5,11
"2011","Forest of Dean 008C","E01022264","Total",22,12,6,4,1,0,1,0,21,12,5,4
"2011","Forest of Dean 008D","E01022268","Total",31,14,7,10,2,0,2,0,29,14,5,10
"2011","Forest of Dean 008E","E01022269","Total",33,14,8,11,4,0,3,1,29,14,5,10
"2011","Forest of Dean 009A","E01022226","Total",51,25,15,11,7,2,4,1,44,23,11,10
"2011","Forest of Dean 009B","E01022227","Total",17,9,4,4,1,1,0,0,16,8,4,4
"2011","Forest of Dean 009C","E01022254","Total",66,30,12,24,8,1,5,2,58,29,7,22
"2011","Forest of Dean 009D","E01022255","Total",30,13,10,7,3,0,3,0,27,13,7,7
"2011","Forest of Dean 009E","E01022256","Total",51,18,7,26,5,1,2,2,46,17,5,24
"2011","Forest of Dean 009F","E01022257","Total",33,14,14,5,1,0,1,0,32,14,13,5
"2011","Forest of Dean 010A","E01022248","Total",24,8,14,2,3,0,3,0,21,8,11,2
"2011","Forest of Dean 010B","E01022272","Total",35,15,8,12,1,0,1,0,34,15,7,12
"2011","Forest of Dean 010C","E01022273","Total",20,8,8,4,4,0,4,0,16,8,4,4
"2011","Forest of Dean 010D","E01022274","Total",16,6,8,2,2,0,1,1,14,6,7,1
"2011","Forest of Dean 010E","E01022275","Total",18,5,11,2,3,1,1,1,15,4,10,1
"2011","Gloucester 001A","E01022313","Total",44,23,14,7,1,0,1,0,43,23,13,7
"2011","Gloucester 001B","E01022315","Total",26,11,11,4,2,1,1,0,24,10,10,4
"2011","Gloucester 001C","E01022316","Total",34,15,14,5,3,0,3,0,31,15,11,5
"2011","Gloucester 001D","E01022317","Total",28,12,12,4,3,0,3,0,25,12,9,4
"2011","Gloucester 001E","E01022318","Total",20,11,6,3,1,0,0,1,19,11,6,2
"2011","Gloucester 002A","E01022309","Total",24,8,9,7,1,0,1,0,23,8,8,7
"2011","Gloucester 002B","E01022310","Total",43,14,5,24,1,1,0,0,42,13,5,24
"2011","Gloucester 002C","E01022311","Total",42,14,6,22,3,0,0,3,39,14,6,19
"2011","Gloucester 002D","E01022312","Total",41,14,14,13,3,1,2,0,38,13,12,13
"2011","Gloucester 002E","E01022314","Total",15,8,5,2,2,0,2,0,13,8,3,2
"2011","Gloucester 003A","E01022295","Total",29,12,11,6,3,0,3,0,26,12,8,6
"2011","Gloucester 003B","E01022296","Total",56,23,11,22,5,2,1,2,51,21,10,20
"2011","Gloucester 003C","E01022297","Total",17,4,12,1,4,0,4,0,13,4,8,1
"2011","Gloucester 003D","E01022298","Total",35,13,15,7,2,0,2,0,33,13,13,7
"2011","Gloucester 004A","E01022332","Total",37,17,7,13,5,1,3,1,32,16,4,12
"2011","Gloucester 004B","E01022347","Total",37,15,7,15,3,0,0,3,34,15,7,12
"2011","Gloucester 004C","E01022348","Total",62,21,19,22,3,2,1,0,59,19,18,22
"2011","Gloucester 004E","E01032932","Total",11,5,3,3,1,0,1,0,10,5,2,3
"2011","Gloucester 004F","E01032937","Total",13,5,5,3,0,0,0,0,13,5,5,3
"2011","Gloucester 005A","E01022288","Total",76,29,9,38,2,0,2,0,74,29,7,38
"2011","Gloucester 005B","E01022289","Total",63,16,15,32,4,1,1,2,59,15,14,30
"2011","Gloucester 005C","E01022290","Total",56,23,6,27,5,2,0,3,51,21,6,24
"2011","Gloucester 005D","E01022291","Total",77,23,14,40,4,1,2,1,73,22,12,39
"2011","Gloucester 005E","E01022292","Total",33,12,6,15,1,0,1,0,32,12,5,15
"2011","Gloucester 006A","E01022283","Total",17,6,7,4,2,0,1,1,15,6,6,3
"2011","Gloucester 006B","E01022303","Total",33,14,7,12,3,1,1,1,30,13,6,11
"2011","Gloucester 006C","E01022304","Total",27,8,8,11,3,1,0,2,24,7,8,9
"2011","Gloucester 006D","E01022305","Total",21,10,8,3,3,0,3,0,18,10,5,3
"2011","Gloucester 006E","E01022308","Total",27,13,11,3,3,0,3,0,24,13,8,3
"2011","Gloucester 007A","E01022278","Total",42,19,10,13,5,2,2,1,37,17,8,12
"2011","Gloucester 007B","E01022279","Total",37,17,13,7,1,0,0,1,36,17,13,6
"2011","Gloucester 007C","E01022282","Total",83,40,27,16,10,1,9,0,73,39,18,16
"2011","Gloucester 007D","E01022284","Total",47,19,12,16,5,1,3,1,42,18,9,15
"2011","Gloucester 007E","E01022285","Total",62,15,18,29,9,0,4,5,53,15,14,24
"2011","Gloucester 007F","E01022286","Total",57,20,7,30,3,0,0,3,54,20,7,27
"2011","Gloucester 007G","E01022287","Total",33,17,4,12,0,0,0,0,33,17,4,12
"2011","Gloucester 008A","E01022293","Total",44,8,17,19,3,0,0,3,41,8,17,16
"2011","Gloucester 008B","E01022294","Total",63,23,8,32,2,0,1,1,61,23,7,31
"2011","Gloucester 008C","E01022323","Total",113,47,15,51,5,0,0,5,108,47,15,46
"2011","Gloucester 008D","E01022328","Total",45,15,9,21,6,0,3,3,39,15,6,18
"2011","Gloucester 008E","E01022329","Total",75,22,13,40,6,2,3,1,69,20,10,39
"2011","Gloucester 009A","E01022326","Total",74,33,18,23,4,1,3,0,70,32,15,23
"2011","Gloucester 009B","E01022327","Total",48,13,17,18,4,1,2,1,44,12,15,17
"2011","Gloucester 009C","E01022330","Total",39,19,11,9,2,0,2,0,37,19,9,9
"2011","Gloucester 009D","E01022331","Total",33,7,10,16,3,2,1,0,30,5,9,16
"2011","Gloucester 009E","E01022333","Total",81,19,11,51,11,0,2,9,70,19,9,42
"2011","Gloucester 009F","E01022334","Total",25,9,12,4,2,0,2,0,23,9,10,4
"2011","Gloucester 010A","E01022276","Total",32,15,15,2,6,0,6,0,26,15,9,2
"2011","Gloucester 010B","E01022277","Total",29,14,10,5,6,3,2,1,23,11,8,4
"2011","Gloucester 010C","E01022280","Total",53,15,20,18,3,0,3,0,50,15,17,18
"2011","Gloucester 010D","E01022281","Total",44,18,19,7,8,2,5,1,36,16,14,6
"2011","Gloucester 010E","E01022306","Total",31,15,8,8,4,1,2,1,27,14,6,7
"2011","Gloucester 010F","E01022307","Total",53,20,23,10,11,0,10,1,42,20,13,9
"2011","Gloucester 011A","E01022319","Total",112,36,15,61,16,1,7,8,96,35,8,53
"2011","Gloucester 011B","E01022320","Total",49,16,10,23,9,1,4,4,40,15,6,19
"2011","Gloucester 011C","E01022321","Total",42,19,5,18,2,1,0,1,40,18,5,17
"2011","Gloucester 011D","E01022322","Total",50,21,9,20,5,1,3,1,45,20,6,19
"2011","Gloucester 011E","E01022324","Total",76,24,14,38,9,2,3,4,67,22,11,34
"2011","Gloucester 011F","E01022325","Total",27,15,5,7,2,0,2,0,25,15,3,7
"2011","Gloucester 012A","E01022343","Total",19,10,5,4,3,0,2,1,16,10,3,3
"2011","Gloucester 012B","E01022344","Total",32,16,3,13,3,1,2,0,29,15,1,13
"2011","Gloucester 012C","E01022345","Total",28,10,8,10,4,1,3,0,24,9,5,10
"2011","Gloucester 012D","E01022346","Total",84,32,14,38,3,0,3,0,81,32,11,38
"2011","Gloucester 013A","E01022299","Total",38,16,10,12,3,0,1,2,35,16,9,10
"2011","Gloucester 013B","E01022300","Total",21,11,4,6,2,1,1,0,19,10,3,6
"2011","Gloucester 013C","E01022301","Total",60,27,15,18,2,0,1,1,58,27,14,17
"2011","Gloucester 013D","E01022302","Total",36,12,10,14,5,0,2,3,31,12,8,11
"2011","Gloucester 014A","E01022339","Total",52,21,17,14,3,1,2,0,49,20,15,14
"2011","Gloucester 014B","E01022340","Total",54,15,19,20,2,0,2,0,52,15,17,20
"2011","Gloucester 014C","E01022341","Total",70,30,25,15,5,0,5,0,65,30,20,15
"2011","Gloucester 014D","E01022342","Total",45,22,14,9,9,2,5,2,36,20,9,7
"2011","Gloucester 015A","E01022335","Total",29,16,10,3,4,1,3,0,25,15,7,3
"2011","Gloucester 015B","E01022336","Total",25,11,8,6,2,1,1,0,23,10,7,6
"2011","Gloucester 015D","E01022338","Total",68,29,18,21,6,0,4,2,62,29,14,19
"2011","Gloucester 015E","E01032933","Total",57,22,13,22,8,0,6,2,49,22,7,20
"2011","Gloucester 015F","E01032934","Total",33,16,11,6,3,0,3,0,30,16,8,6
"2011","Gloucester 015G","E01032935","Total",43,23,9,11,7,1,4,2,36,22,5,9
"2011","Gloucester 015H","E01032936","Total",99,30,17,52,5,1,4,0,94,29,13,52
"2011","Stroud 001A","E01022378","Total",27,10,11,6,3,0,3,0,24,10,8,6
"2011","Stroud 001B","E01022379","Total",43,19,7,17,8,5,3,0,35,14,4,17
"2011","Stroud 001C","E01022380","Total",21,11,6,4,4,1,3,0,17,10,3,4
"2011","Stroud 001D","E01022412","Total",63,26,15,22,4,0,4,0,59,26,11,22
"2011","Stroud 002A","E01022354","Total",21,7,11,3,2,1,1,0,19,6,10,3
"2011","Stroud 002B","E01022390","Total",28,8,9,11,5,1,2,2,23,7,7,9
"2011","Stroud 002C","E01022391","Total",18,7,6,5,0,0,0,0,18,7,6,5
"2011","Stroud 002D","E01022392","Total",16,9,4,3,0,0,0,0,16,9,4,3
"2011","Stroud 003A","E01022376","Total",29,13,6,10,2,0,0,2,27,13,6,8
"2011","Stroud 003B","E01022396","Total",21,7,8,6,3,0,1,2,18,7,7,4
"2011","Stroud 003C","E01022397","Total",18,8,1,9,1,1,0,0,17,7,1,9
"2011","Stroud 003D","E01022398","Total",13,4,3,6,2,0,2,0,11,4,1,6
"2011","Stroud 004A","E01022355","Total",36,17,7,12,3,0,2,1,33,17,5,11
"2011","Stroud 004B","E01022356","Total",67,30,11,26,4,1,1,2,63,29,10,24
"2011","Stroud 004C","E01022357","Total",35,16,12,7,6,2,4,0,29,14,8,7
"2011","Stroud 004D","E01022358","Total",34,18,8,8,4,0,3,1,30,18,5,7
"2011","Stroud 004E","E01022377","Total",68,28,24,16,6,1,4,1,62,27,20,15
"2011","Stroud 004F","E01022389","Total",33,16,12,5,2,0,2,0,31,16,10,5
"2011","Stroud 005A","E01022400","Total",38,16,14,8,2,0,2,0,36,16,12,8
"2011","Stroud 005B","E01022401","Total",41,17,10,14,2,0,2,0,39,17,8,14
"2011","Stroud 005C","E01022402","Total",40,15,13,12,3,1,2,0,37,14,11,12
"2011","Stroud 005D","E01022403","Total",42,15,11,16,7,2,2,3,35,13,9,13
"2011","Stroud 005E","E01022404","Total",18,8,8,2,2,0,2,0,16,8,6,2
"2011","Stroud 006A","E01022365","Total",43,15,11,17,7,2,4,1,36,13,7,16
"2011","Stroud 006B","E01022399","Total",68,35,10,23,9,1,4,4,59,34,6,19
"2011","Stroud 006C","E01022410","Total",84,31,13,40,2,0,0,2,82,31,13,38
"2011","Stroud 006D","E01022411","Total",45,20,11,14,5,0,5,0,40,20,6,14
"2011","Stroud 006E","E01022414","Total",74,31,20,23,11,0,7,4,63,31,13,19
"2011","Stroud 007A","E01022393","Total",14,8,5,1,3,0,3,0,11,8,2,1
"2011","Stroud 007B","E01022394","Total",39,19,14,6,5,0,5,0,34,19,9,6
"2011","Stroud 007C","E01022395","Total",27,15,6,6,2,1,1,0,25,14,5,6
"2011","Stroud 007D","E01022408","Total",9,4,3,2,1,0,1,0,8,4,2,2
"2011","Stroud 007E","E01022409","Total",21,10,6,5,4,1,3,0,17,9,3,5
"2011","Stroud 008A","E01022366","Total",29,9,15,5,7,0,5,2,22,9,10,3
"2011","Stroud 008B","E01022367","Total",27,16,9,2,3,0,3,0,24,16,6,2
"2011","Stroud 008C","E01022368","Total",5,2,2,1,0,0,0,0,5,2,2,1
"2011","Stroud 008D","E01022369","Total",80,36,23,21,8,0,6,2,72,36,17,19
"2011","Stroud 009A","E01022370","Total",30,10,11,9,4,0,4,0,26,10,7,9
"2011","Stroud 009B","E01022371","Total",15,7,4,4,0,0,0,0,15,7,4,4
"2011","Stroud 009C","E01022405","Total",28,13,8,7,1,0,0,1,27,13,8,6
"2011","Stroud 009D","E01022406","Total",17,5,8,4,5,1,2,2,12,4,6,2
"2011","Stroud 009E","E01022407","Total",13,6,3,4,3,1,2,0,10,5,1,4
"2011","Stroud 010A","E01022350","Total",32,13,10,9,4,1,2,1,28,12,8,8
"2011","Stroud 010B","E01022382","Total",14,8,4,2,2,0,1,1,12,8,3,1
"2011","Stroud 010C","E01022383","Total",34,14,8,12,3,0,1,2,31,14,7,10
"2011","Stroud 010D","E01022384","Total",21,7,7,7,2,0,2,0,19,7,5,7
"2011","Stroud 011A","E01022359","Total",27,17,7,3,4,0,3,1,23,17,4,2
"2011","Stroud 011B","E01022360","Total",12,3,8,1,2,0,2,0,10,3,6,1
"2011","Stroud 011C","E01022361","Total",18,8,3,7,3,2,1,0,15,6,2,7
"2011","Stroud 011D","E01022362","Total",17,7,5,5,1,0,1,0,16,7,4,5
"2011","Stroud 011E","E01022363","Total",42,13,13,16,6,0,4,2,36,13,9,14
"2011","Stroud 011F","E01022364","Total",45,13,10,22,5,1,3,1,40,12,7,21
"2011","Stroud 012A","E01022351","Total",25,5,9,11,7,0,4,3,18,5,5,8
"2011","Stroud 012B","E01022352","Total",10,5,3,2,0,0,0,0,10,5,3,2
"2011","Stroud 012C","E01022353","Total",26,11,7,8,6,2,2,2,20,9,5,6
"2011","Stroud 012D","E01022413","Total",22,7,9,6,5,0,4,1,17,7,5,5
"2011","Stroud 013A","E01022385","Total",31,13,6,12,3,0,3,0,28,13,3,12
"2011","Stroud 013B","E01022386","Total",19,9,5,5,2,1,1,0,17,8,4,5
"2011","Stroud 013C","E01022387","Total",55,21,18,16,5,0,3,2,50,21,15,14
"2011","Stroud 013D","E01022388","Total",41,21,12,8,5,2,2,1,36,19,10,7
"2011","Stroud 014A","E01022372","Total",22,9,6,7,2,0,1,1,20,9,5,6
"2011","Stroud 014B","E01022373","Total",40,17,9,14,1,0,1,0,39,17,8,14
"2011","Stroud 014C","E01022374","Total",56,20,16,20,9,3,5,1,47,17,11,19
"2011","Stroud 014D","E01022375","Total",77,30,12,35,12,1,7,4,65,29,5,31
"2011","Stroud 015A","E01022381","Total",40,18,13,9,6,1,5,0,34,17,8,9
"2011","Stroud 015B","E01022415","Total",20,11,8,1,1,0,1,0,19,11,7,1
"2011","Stroud 015C","E01022416","Total",35,13,14,8,4,0,3,1,31,13,11,7
"2011","Stroud 015D","E01022417","Total",33,16,14,3,1,0,1,0,32,16,13,3
"2011","Stroud 015E","E01022418","Total",34,13,11,10,4,0,2,2,30,13,9,8
"2011","Tewkesbury 001B","E01022450","Total",62,30,12,20,7,3,2,2,55,27,10,18
"2011","Tewkesbury 001C","E01022451","Total",27,12,7,8,1,0,1,0,26,12,6,8
"2011","Tewkesbury 001D","E01022452","Total",20,7,8,5,1,0,1,0,19,7,7,5
"2011","Tewkesbury 001E","E01022455","Total",18,6,7,5,2,0,2,0,16,6,5,5
"2011","Tewkesbury 001F","E01032938","Total",37,17,7,13,2,1,0,1,35,16,7,12
"2011","Tewkesbury 001G","E01032939","Total",53,20,20,13,8,1,6,1,45,19,14,12
"2011","Tewkesbury 001H","E01032940","Total",44,16,15,13,3,1,1,1,41,15,14,12
"2011","Tewkesbury 002A","E01022456","Total",26,14,9,3,2,0,2,0,24,14,7,3
"2011","Tewkesbury 002B","E01022457","Total",46,15,9,22,4,2,1,1,42,13,8,21
"2011","Tewkesbury 002C","E01022458","Total",68,21,11,36,4,1,1,2,64,20,10,34
"2011","Tewkesbury 002D","E01022459","Total",28,9,9,10,3,0,3,0,25,9,6,10
"2011","Tewkesbury 002E","E01022460","Total",21,11,6,4,1,1,0,0,20,10,6,4
"2011","Tewkesbury 002F","E01022461","Total",18,9,7,2,3,0,2,1,15,9,5,1
"2011","Tewkesbury 002G","E01022462","Total",15,5,6,4,3,1,1,1,12,4,5,3
"2011","Tewkesbury 003A","E01022449","Total",17,10,4,3,4,0,3,1,13,10,1,2
"2011","Tewkesbury 003B","E01022463","Total",22,13,0,9,2,2,0,0,20,11,0,9
"2011","Tewkesbury 003C","E01022464","Total",37,17,7,13,3,0,2,1,34,17,5,12
"2011","Tewkesbury 003D","E01022465","Total",16,7,9,0,6,0,6,0,10,7,3,0
"2011","Tewkesbury 003E","E01022466","Total",26,11,7,8,4,0,4,0,22,11,3,8
"2011","Tewkesbury 004A","E01022434","Total",17,7,8,2,3,0,2,1,14,7,6,1
"2011","Tewkesbury 004B","E01022441","Total",24,9,4,11,1,0,1,0,23,9,3,11
"2011","Tewkesbury 004C","E01022445","Total",13,9,2,2,2,1,1,0,11,8,1,2
"2011","Tewkesbury 004D","E01022453","Total",8,3,4,1,1,0,1,0,7,3,3,1
"2011","Tewkesbury 005A","E01022432","Total",41,19,13,9,5,0,5,0,36,19,8,9
"2011","Tewkesbury 005B","E01022433","Total",40,21,8,11,1,0,0,1,39,21,8,10
"2011","Tewkesbury 005C","E01022435","Total",66,24,13,29,2,1,1,0,64,23,12,29
"2011","Tewkesbury 005D","E01022436","Total",40,18,10,12,5,1,2,2,35,17,8,10
"2011","Tewkesbury 005E","E01022437","Total",37,13,16,8,1,0,1,0,36,13,15,8
"2011","Tewkesbury 005F","E01022438","Total",35,11,17,7,4,0,4,0,31,11,13,7
"2011","Tewkesbury 005G","E01022439","Total",50,19,26,5,7,0,5,2,43,19,21,3
"2011","Tewkesbury 006A","E01022440","Total",23,7,9,7,0,0,0,0,23,7,9,7
"2011","Tewkesbury 006B","E01022442","Total",16,8,6,2,4,2,2,0,12,6,4,2
"2011","Tewkesbury 006C","E01022443","Total",13,5,3,5,0,0,0,0,13,5,3,5
"2011","Tewkesbury 006D","E01022444","Total",17,4,10,3,2,0,1,1,15,4,9,2
"2011","Tewkesbury 007A","E01022425","Total",16,7,6,3,1,0,1,0,15,7,5,3
"2011","Tewkesbury 007B","E01022426","Total",18,7,7,4,3,0,1,2,15,7,6,2
"2011","Tewkesbury 007C","E01022427","Total",31,17,8,6,3,0,3,0,28,17,5,6
"2011","Tewkesbury 007D","E01022428","Total",66,26,13,27,9,0,7,2,57,26,6,25
"2011","Tewkesbury 007E","E01022429","Total",29,15,11,3,1,0,1,0,28,15,10,3
"2011","Tewkesbury 007F","E01022430","Total",22,6,11,5,1,0,1,0,21,6,10,5
"2011","Tewkesbury 007G","E01022431","Total",48,23,17,8,2,0,2,0,46,23,15,8
"2011","Tewkesbury 007H","E01022447","Total",32,12,12,8,3,1,2,0,29,11,10,8
"2011","Tewkesbury 008A","E01022420","Total",18,10,2,6,0,0,0,0,18,10,2,6
"2011","Tewkesbury 008B","E01022448","Total",30,7,9,14,2,0,1,1,28,7,8,13
"2011","Tewkesbury 008C","E01022454","Total",40,15,11,14,4,1,2,1,36,14,9,13
"2011","Tewkesbury 009A","E01022421","Total",50,23,8,19,2,1,0,1,48,22,8,18
"2011","Tewkesbury 009B","E01022422","Total",36,16,14,6,4,1,2,1,32,15,12,5
"2011","Tewkesbury 009C","E01022423","Total",42,27,6,9,1,0,1,0,41,27,5,9
"2011","Tewkesbury 009D","E01022424","Total",56,20,11,25,3,0,2,1,53,20,9,24
"2011","Tewkesbury 009E","E01022446","Total",37,17,13,7,2,1,1,0,35,16,12,7
"2011","Mendip 001A","E01029022","Total",24,11,8,5,4,1,2,1,20,10,6,4
"2011","Mendip 001B","E01029023","Total",16,7,6,3,1,0,1,0,15,7,5,3
"2011","Mendip 001C","E01029044","Total",54,22,13,19,5,1,3,1,49,21,10,18
"2011","Mendip 001D","E01029053","Total",43,17,12,14,9,1,8,0,34,16,4,14
"2011","Mendip 001E","E01029057","Total",32,15,3,14,5,3,1,1,27,12,2,13
"2011","Mendip 002A","E01029024","Total",31,14,8,9,7,1,4,2,24,13,4,7
"2011","Mendip 002B","E01029025","Total",21,9,5,7,1,0,0,1,20,9,5,6
"2011","Mendip 002C","E01029026","Total",28,15,5,8,6,3,1,2,22,12,4,6
"2011","Mendip 002D","E01029068","Total",40,20,8,12,6,0,4,2,34,20,4,10
"2011","Mendip 002E","E01029069","Total",14,6,5,3,5,0,4,1,9,6,1,2
"2011","Mendip 003A","E01029030","Total",44,20,13,11,7,1,3,3,37,19,10,8
"2011","Mendip 003B","E01029031","Total",47,23,14,10,6,1,5,0,41,22,9,10
"2011","Mendip 003C","E01029032","Total",9,3,4,2,0,0,0,0,9,3,4,2
"2011","Mendip 003D","E01029033","Total",46,18,15,13,6,2,4,0,40,16,11,13
"2011","Mendip 003E","E01029034","Total",27,14,4,9,0,0,0,0,27,14,4,9
"2011","Mendip 004A","E01029036","Total",63,25,15,23,8,1,7,0,55,24,8,23
"2011","Mendip 004B","E01029041","Total",68,35,13,20,3,0,3,0,65,35,10,20
"2011","Mendip 004C","E01029042","Total",75,31,8,36,6,2,0,4,69,29,8,32
"2011","Mendip 004D","E01029043","Total",49,26,7,16,2,0,1,1,47,26,6,15
"2011","Mendip 004E","E01029045","Total",47,21,13,13,9,2,6,1,38,19,7,12
"2011","Mendip 005A","E01029052","Total",35,14,9,12,6,0,5,1,29,14,4,11
"2011","Mendip 005B","E01029060","Total",32,12,15,5,8,3,5,0,24,9,10,5
"2011","Mendip 005C","E01029061","Total",37,19,8,10,4,1,3,0,33,18,5,10
"2011","Mendip 005D","E01029083","Total",12,7,3,2,1,0,1,0,11,7,2,2
"2011","Mendip 006A","E01029018","Total",37,13,18,6,3,0,2,1,34,13,16,5
"2011","Mendip 006B","E01029056","Total",36,15,14,7,5,0,5,0,31,15,9,7
"2011","Mendip 006C","E01029064","Total",30,12,8,10,4,1,2,1,26,11,6,9
"2011","Mendip 006D","E01029084","Total",46,15,10,21,6,0,2,4,40,15,8,17
"2011","Mendip 007A","E01029029","Total",74,25,16,33,5,0,2,3,69,25,14,30
"2011","Mendip 007B","E01029035","Total",37,16,15,6,4,1,2,1,33,15,13,5
"2011","Mendip 007C","E01029037","Total",43,18,20,5,7,0,7,0,36,18,13,5
"2011","Mendip 007D","E01029038","Total",72,32,11,29,6,0,3,3,66,32,8,26
"2011","Mendip 007E","E01029039","Total",30,11,10,9,8,2,5,1,22,9,5,8
"2011","Mendip 007F","E01029040","Total",52,18,16,18,8,2,5,1,44,16,11,17
"2011","Mendip 008A","E01029078","Total",39,23,6,10,7,0,4,3,32,23,2,7
"2011","Mendip 008B","E01029079","Total",55,21,16,18,5,1,2,2,50,20,14,16
"2011","Mendip 008C","E01029080","Total",34,15,12,7,4,1,3,0,30,14,9,7
"2011","Mendip 008D","E01029081","Total",50,17,16,17,5,2,3,0,45,15,13,17
"2011","Mendip 008E","E01029082","Total",29,14,11,4,4,1,3,0,25,13,8,4
"2011","Mendip 009A","E01029062","Total",65,21,8,36,7,0,4,3,58,21,4,33
"2011","Mendip 009B","E01029063","Total",80,32,23,25,10,1,5,4,70,31,18,21
"2011","Mendip 009C","E01029065","Total",31,11,11,9,6,0,6,0,25,11,5,9
"2011","Mendip 009D","E01029066","Total",41,21,7,13,4,0,1,3,37,21,6,10
"2011","Mendip 009E","E01029067","Total",48,18,14,16,8,2,4,2,40,16,10,14
"2011","Mendip 010A","E01029020","Total",29,16,5,8,3,2,1,0,26,14,4,8
"2011","Mendip 010B","E01029021","Total",10,6,1,3,1,1,0,0,9,5,1,3
"2011","Mendip 010C","E01029027","Total",24,16,6,2,3,2,1,0,21,14,5,2
"2011","Mendip 010D","E01029028","Total",19,5,8,6,4,0,3,1,15,5,5,5
"2011","Mendip 010E","E01029058","Total",44,22,7,15,3,0,3,0,41,22,4,15
"2011","Mendip 011A","E01029046","Total",49,18,7,24,2,1,0,1,47,17,7,23
"2011","Mendip 011D","E01029050","Total",80,31,18,31,11,2,4,5,69,29,14,26
"2011","Mendip 011E","E01029051","Total",37,20,7,10,5,1,4,0,32,19,3,10
"2011","Mendip 011F","E01032627","Total",82,43,8,31,5,3,1,1,77,40,7,30
"2011","Mendip 012A","E01029047","Total",66,15,20,31,11,1,6,4,55,14,14,27
"2011","Mendip 012B","E01029054","Total",35,20,8,7,2,0,1,1,33,20,7,6
"2011","Mendip 012C","E01029055","Total",28,12,7,9,6,2,4,0,22,10,3,9
"2011","Mendip 012D","E01029074","Total",26,11,8,7,2,0,2,0,24,11,6,7
"2011","Mendip 012E","E01029076","Total",37,19,14,4,6,1,5,0,31,18,9,4
"2011","Mendip 013A","E01029019","Total",44,19,12,13,6,1,5,0,38,18,7,13
"2011","Mendip 013B","E01029059","Total",36,16,12,8,3,0,3,0,33,16,9,8
"2011","Mendip 013C","E01029077","Total",26,10,7,9,6,1,4,1,20,9,3,8
"2011","Mendip 014A","E01029070","Total",59,27,15,17,3,1,2,0,56,26,13,17
"2011","Mendip 014B","E01029071","Total",78,36,21,21,5,1,4,0,73,35,17,21
"2011","Mendip 014C","E01029072","Total",88,35,16,37,7,4,3,0,81,31,13,37
"2011","Mendip 014D","E01029073","Total",42,17,11,14,3,1,1,1,39,16,10,13
"2011","Mendip 014E","E01029075","Total",34,12,12,10,4,1,3,0,30,11,9,10
"2011","Sedgemoor 001A","E01029085","Total",56,30,13,13,7,1,3,3,49,29,10,10
"2011","Sedgemoor 001B","E01029126","Total",24,7,10,7,2,0,2,0,22,7,8,7
"2011","Sedgemoor 001C","E01029127","Total",40,16,13,11,4,0,3,1,36,16,10,10
"2011","Sedgemoor 001D","E01029128","Total",17,9,7,1,2,0,2,0,15,9,5,1
"2011","Sedgemoor 001E","E01029129","Total",33,16,13,4,3,0,3,0,30,16,10,4
"2011","Sedgemoor 002C","E01029089","Total",42,16,15,11,10,1,6,3,32,15,9,8
"2011","Sedgemoor 002D","E01029113","Total",20,9,5,6,1,0,1,0,19,9,4,6
"2011","Sedgemoor 002E","E01029115","Total",27,13,9,5,4,0,3,1,23,13,6,4
"2011","Sedgemoor 002F","E01029140","Total",59,29,11,19,8,2,5,1,51,27,6,18
"2011","Sedgemoor 002G","E01032633","Total",33,15,12,6,5,0,4,1,28,15,8,5
"2011","Sedgemoor 003A","E01029086","Total",33,13,17,3,4,0,3,1,29,13,14,2
"2011","Sedgemoor 003B","E01029147","Total",24,15,4,5,1,0,0,1,23,15,4,4
"2011","Sedgemoor 003C","E01029148","Total",22,8,8,6,5,2,3,0,17,6,5,6
"2011","Sedgemoor 003D","E01029149","Total",13,7,4,2,3,2,1,0,10,5,3,2
"2011","Sedgemoor 004A","E01029114","Total",10,2,6,2,2,0,1,1,8,2,5,1
"2011","Sedgemoor 004B","E01029116","Total",32,10,5,17,4,1,3,0,28,9,2,17
"2011","Sedgemoor 004C","E01029117","Total",46,18,9,19,3,0,1,2,43,18,8,17
"2011","Sedgemoor 004D","E01029119","Total",46,21,11,14,2,0,2,0,44,21,9,14
"2011","Sedgemoor 004E","E01029120","Total",62,25,20,17,6,0,6,0,56,25,14,17
"2011","Sedgemoor 005A","E01029118","Total",37,18,6,13,2,0,2,0,35,18,4,13
"2011","Sedgemoor 005B","E01029131","Total",122,38,23,61,11,3,4,4,111,35,19,57
"2011","Sedgemoor 005C","E01029132","Total",70,20,11,39,10,1,4,5,60,19,7,34
"2011","Sedgemoor 005D","E01029133","Total",13,4,5,4,2,0,2,0,11,4,3,4
"2011","Sedgemoor 005E","E01029134","Total",44,16,11,17,9,2,4,3,35,14,7,14
"2011","Sedgemoor 006A","E01029135","Total",14,2,7,5,3,0,2,1,11,2,5,4
"2011","Sedgemoor 006B","E01029136","Total",36,10,14,12,8,1,6,1,28,9,8,11
"2011","Sedgemoor 006C","E01029145","Total",29,16,3,10,1,0,1,0,28,16,2,10
"2011","Sedgemoor 006D","E01029152","Total",58,19,16,23,8,2,6,0,50,17,10,23
"2011","Sedgemoor 007A","E01029121","Total",15,7,5,3,2,0,2,0,13,7,3,3
"2011","Sedgemoor 007B","E01029122","Total",31,13,12,6,3,0,3,0,28,13,9,6
"2011","Sedgemoor 007C","E01029123","Total",23,13,4,6,4,1,2,1,19,12,2,5
"2011","Sedgemoor 007D","E01029124","Total",26,9,9,8,4,2,2,0,22,7,7,8
"2011","Sedgemoor 007E","E01029125","Total",16,7,6,3,1,0,1,0,15,7,5,3
"2011","Sedgemoor 008A","E01029093","Total",79,30,15,34,8,1,4,3,71,29,11,31
"2011","Sedgemoor 008B","E01029096","Total",64,32,8,24,6,2,2,2,58,30,6,22
"2011","Sedgemoor 008C","E01029106","Total",87,21,13,53,15,4,8,3,72,17,5,50
"2011","Sedgemoor 008D","E01029107","Total",65,26,6,33,4,0,1,3,61,26,5,30
"2011","Sedgemoor 008E","E01029109","Total",64,28,9,27,8,1,3,4,56,27,6,23
"2011","Sedgemoor 009A","E01029094","Total",59,22,11,26,6,1,3,2,53,21,8,24
"2011","Sedgemoor 009B","E01029095","Total",57,27,8,22,7,2,1,4,50,25,7,18
"2011","Sedgemoor 009C","E01029110","Total",75,32,11,32,3,0,2,1,72,32,9,31
"2011","Sedgemoor 009D","E01029111","Total",113,37,28,48,16,1,8,7,97,36,20,41
"2011","Sedgemoor 009E","E01029112","Total",54,20,15,19,10,3,4,3,44,17,11,16
"2011","Sedgemoor 010A","E01029090","Total",38,17,10,11,7,2,5,0,31,15,5,11
"2011","Sedgemoor 010B","E01029091","Total",35,17,5,13,1,0,1,0,34,17,4,13
"2011","Sedgemoor 010C","E01029092","Total",45,19,13,13,2,0,1,1,43,19,12,12
"2011","Sedgemoor 010D","E01029108","Total",45,15,8,22,5,1,4,0,40,14,4,22
"2011","Sedgemoor 011A","E01029102","Total",47,23,13,11,4,0,2,2,43,23,11,9
"2011","Sedgemoor 011B","E01029103","Total",16,9,6,1,1,0,1,0,15,9,5,1
"2011","Sedgemoor 011C","E01029104","Total",20,11,5,4,1,0,1,0,19,11,4,4
"2011","Sedgemoor 011E","E01032631","Total",64,30,19,15,8,2,5,1,56,28,14,14
"2011","Sedgemoor 011F","E01032632","Total",19,12,5,2,2,1,1,0,17,11,4,2
"2011","Sedgemoor 011G","E01032634","Total",10,5,4,1,3,0,3,0,7,5,1,1
"2011","Sedgemoor 012A","E01029130","Total",29,13,8,8,5,2,3,0,24,11,5,8
"2011","Sedgemoor 012B","E01029137","Total",15,8,6,1,4,1,3,0,11,7,3,1
"2011","Sedgemoor 012C","E01029138","Total",22,11,2,9,0,0,0,0,22,11,2,9
"2011","Sedgemoor 012D","E01029139","Total",27,10,9,8,5,0,4,1,22,10,5,7
"2011","Sedgemoor 012E","E01029150","Total",16,5,6,5,4,0,4,0,12,5,2,5
"2011","Sedgemoor 012F","E01029151","Total",22,9,9,4,2,0,1,1,20,9,8,3
"2011","Sedgemoor 013A","E01029097","Total",78,26,9,43,6,1,2,3,72,25,7,40
"2011","Sedgemoor 013B","E01029098","Total",35,9,10,16,7,0,6,1,28,9,4,15
"2011","Sedgemoor 013C","E01029099","Total",27,11,3,13,0,0,0,0,27,11,3,13
"2011","Sedgemoor 013D","E01029100","Total",59,18,8,33,3,1,1,1,56,17,7,32
"2011","Sedgemoor 013E","E01029105","Total",54,22,8,24,5,2,3,0,49,20,5,24
"2011","Sedgemoor 014A","E01029101","Total",37,16,7,14,0,0,0,0,37,16,7,14
"2011","Sedgemoor 014C","E01029142","Total",27,13,10,4,3,0,3,0,24,13,7,4
"2011","Sedgemoor 014D","E01029143","Total",40,20,6,14,8,4,2,2,32,16,4,12
"2011","Sedgemoor 014E","E01029144","Total",13,5,7,1,2,0,2,0,11,5,5,1
"2011","Sedgemoor 014F","E01032629","Total",42,13,14,15,7,1,5,1,35,12,9,14
"2011","Sedgemoor 014G","E01032630","Total",38,17,8,13,2,0,2,0,36,17,6,13
"2011","South Somerset 001A","E01029157","Total",42,14,14,14,4,1,3,0,38,13,11,14
"2011","South Somerset 001B","E01029158","Total",39,20,7,12,4,1,2,1,35,19,5,11
"2011","South Somerset 001C","E01029221","Total",35,19,11,5,6,1,4,1,29,18,7,4
"2011","South Somerset 002A","E01029166","Total",31,14,6,11,5,1,3,1,26,13,3,10
"2011","South Somerset 002B","E01029167","Total",51,23,13,15,4,0,3,1,47,23,10,14
"2011","South Somerset 002C","E01029168","Total",33,9,14,10,6,1,4,1,27,8,10,9
"2011","South Somerset 002D","E01029210","Total",25,14,9,2,8,3,5,0,17,11,4,2
"2011","South Somerset 002E","E01029211","Total",19,7,7,5,1,0,1,0,18,7,6,5
"2011","South Somerset 003A","E01029224","Total",19,9,5,5,3,1,2,0,16,8,3,5
"2011","South Somerset 003B","E01029225","Total",55,21,23,11,5,0,5,0,50,21,18,11
"2011","South Somerset 003C","E01029226","Total",58,33,8,17,4,0,2,2,54,33,6,15
"2011","South Somerset 004A","E01029200","Total",38,20,6,12,6,1,2,3,32,19,4,9
"2011","South Somerset 004B","E01029201","Total",37,20,11,6,6,3,3,0,31,17,8,6
"2011","South Somerset 004C","E01029222","Total",26,15,6,5,6,2,4,0,20,13,2,5
"2011","South Somerset 004D","E01029223","Total",19,9,7,3,3,0,2,1,16,9,5,2
"2011","South Somerset 005A","E01029155","Total",9,4,4,1,3,1,2,0,6,3,2,1
"2011","South Somerset 005B","E01029227","Total",41,18,11,12,7,4,3,0,34,14,8,12
"2011","South Somerset 005C","E01029228","Total",40,22,7,11,3,0,1,2,37,22,6,9
"2011","South Somerset 005D","E01029229","Total",53,20,16,17,8,2,4,2,45,18,12,15
"2011","South Somerset 006A","E01029164","Total",19,13,5,1,1,0,1,0,18,13,4,1
"2011","South Somerset 006B","E01029165","Total",14,2,7,5,3,2,1,0,11,0,6,5
"2011","South Somerset 006C","E01029198","Total",33,10,16,7,3,0,2,1,30,10,14,6
"2011","South Somerset 006D","E01029199","Total",47,22,12,13,4,0,4,0,43,22,8,13
"2011","South Somerset 007A","E01029187","Total",24,13,4,7,2,1,1,0,22,12,3,7
"2011","South Somerset 007B","E01029188","Total",25,13,11,1,7,0,6,1,18,13,5,0
"2011","South Somerset 007C","E01029196","Total",30,16,5,9,5,1,4,0,25,15,1,9
"2011","South Somerset 007D","E01029197","Total",14,7,4,3,1,0,1,0,13,7,3,3
"2011","South Somerset 008A","E01029154","Total",36,17,9,10,0,0,0,0,36,17,9,10
"2011","South Somerset 008B","E01029156","Total",49,14,16,19,7,0,4,3,42,14,12,16
"2011","South Somerset 008C","E01029206","Total",31,14,6,11,5,0,2,3,26,14,4,8
"2011","South Somerset 008D","E01029207","Total",27,8,7,12,4,1,2,1,23,7,5,11
"2011","South Somerset 009A","E01029202","Total",29,10,9,10,5,1,4,0,24,9,5,10
"2011","South Somerset 009B","E01029203","Total",28,12,7,9,4,1,2,1,24,11,5,8
"2011","South Somerset 009C","E01029204","Total",22,9,8,5,2,0,1,1,20,9,7,4
"2011","South Somerset 009D","E01029205","Total",48,18,15,15,3,0,3,0,45,18,12,15
"2011","South Somerset 010A","E01029163","Total",39,18,6,15,3,1,2,0,36,17,4,15
"2011","South Somerset 010B","E01029216","Total",16,6,4,6,4,1,3,0,12,5,1,6
"2011","South Somerset 010C","E01029217","Total",16,9,5,2,1,0,1,0,15,9,4,2
"2011","South Somerset 010D","E01029218","Total",61,26,10,25,9,0,5,4,52,26,5,21
"2011","South Somerset 011A","E01029238","Total",76,34,17,25,5,2,2,1,71,32,15,24
"2011","South Somerset 011B","E01029252","Total",28,11,11,6,3,0,2,1,25,11,9,5
"2011","South Somerset 011C","E01029253","Total",67,31,15,21,3,0,2,1,64,31,13,20
"2011","South Somerset 011D","E01029254","Total",11,6,3,2,1,0,1,0,10,6,2,2
"2011","South Somerset 012A","E01029160","Total",62,30,26,6,8,1,6,1,54,29,20,5
"2011","South Somerset 012B","E01029248","Total",60,18,15,27,2,1,1,0,58,17,14,27
"2011","South Somerset 012C","E01029250","Total",10,5,2,3,1,0,0,1,9,5,2,2
"2011","South Somerset 012D","E01029251","Total",18,7,8,3,5,1,3,1,13,6,5,2
"2011","South Somerset 013A","E01029161","Total",58,24,16,18,6,0,5,1,52,24,11,17
"2011","South Somerset 013B","E01029162","Total",24,11,7,6,5,1,2,2,19,10,5,4
"2011","South Somerset 013C","E01029247","Total",99,48,12,39,6,1,2,3,93,47,10,36
"2011","South Somerset 013D","E01029255","Total",29,14,8,7,3,2,0,1,26,12,8,6
"2011","South Somerset 014A","E01029231","Total",36,10,11,15,5,0,5,0,31,10,6,15
"2011","South Somerset 014B","E01029233","Total",55,22,12,21,3,1,2,0,52,21,10,21
"2011","South Somerset 014C","E01029235","Total",46,23,14,9,7,1,6,0,39,22,8,9
"2011","South Somerset 014D","E01029236","Total",71,27,9,35,9,2,3,4,62,25,6,31
"2011","South Somerset 014E","E01029237","Total",74,19,8,47,9,1,4,4,65,18,4,43
"2011","South Somerset 015A","E01029232","Total",47,19,14,14,6,2,4,0,41,17,10,14
"2011","South Somerset 015B","E01029234","Total",37,13,11,13,6,2,2,2,31,11,9,11
"2011","South Somerset 015C","E01029239","Total",55,25,7,23,3,3,0,0,52,22,7,23
"2011","South Somerset 015D","E01029240","Total",34,8,16,10,4,2,2,0,30,6,14,10
"2011","South Somerset 016A","E01029241","Total",70,34,16,20,3,0,3,0,67,34,13,20
"2011","South Somerset 016B","E01029245","Total",57,26,22,9,7,1,5,1,50,25,17,8
"2011","South Somerset 016C","E01029246","Total",18,8,5,5,2,0,2,0,16,8,3,5
"2011","South Somerset 016D","E01029249","Total",47,17,11,19,1,1,0,0,46,16,11,19
"2011","South Somerset 017A","E01029189","Total",25,14,4,7,1,0,1,0,24,14,3,7
"2011","South Somerset 017B","E01029190","Total",9,5,3,1,3,1,2,0,6,4,1,1
"2011","South Somerset 017C","E01029191","Total",23,11,5,7,4,1,3,0,19,10,2,7
"2011","South Somerset 017D","E01029192","Total",37,19,10,8,3,0,3,0,34,19,7,8
"2011","South Somerset 017E","E01029212","Total",12,7,2,3,1,0,1,0,11,7,1,3
"2011","South Somerset 017F","E01029213","Total",17,6,8,3,1,0,1,0,16,6,7,3
"2011","South Somerset 017G","E01029214","Total",20,8,5,7,4,1,1,2,16,7,4,5
"2011","South Somerset 017H","E01029215","Total",31,13,6,12,4,0,1,3,27,13,5,9
"2011","South Somerset 018A","E01029159","Total",21,14,7,0,1,0,1,0,20,14,6,0
"2011","South Somerset 018B","E01029242","Total",31,12,8,11,1,0,1,0,30,12,7,11
"2011","South Somerset 018C","E01029243","Total",20,7,6,7,6,1,3,2,14,6,3,5
"2011","South Somerset 018D","E01029244","Total",16,10,5,1,2,0,2,0,14,10,3,1
"2011","South Somerset 019A","E01029193","Total",73,28,18,27,6,0,5,1,67,28,13,26
"2011","South Somerset 019B","E01029194","Total",69,28,20,21,9,3,6,0,60,25,14,21
"2011","South Somerset 019C","E01029195","Total",30,15,1,14,4,0,1,3,26,15,0,11
"2011","South Somerset 019D","E01029208","Total",22,8,4,10,2,0,0,2,20,8,4,8
"2011","South Somerset 019E","E01029209","Total",18,9,5,4,3,1,2,0,15,8,3,4
"2011","South Somerset 020A","E01029178","Total",12,2,7,3,6,0,6,0,6,2,1,3
"2011","South Somerset 020B","E01029179","Total",28,17,4,7,2,0,2,0,26,17,2,7
"2011","South Somerset 020C","E01029180","Total",27,11,11,5,6,0,6,0,21,11,5,5
"2011","South Somerset 020D","E01029181","Total",23,11,7,5,5,1,3,1,18,10,4,4
"2011","South Somerset 021A","E01029182","Total",18,12,3,3,2,0,2,0,16,12,1,3
"2011","South Somerset 021B","E01029183","Total",35,13,5,17,2,0,1,1,33,13,4,16
"2011","South Somerset 021C","E01029184","Total",32,15,9,8,2,0,2,0,30,15,7,8
"2011","South Somerset 021D","E01029185","Total",38,20,7,11,3,0,0,3,35,20,7,8
"2011","South Somerset 021E","E01029186","Total",34,6,6,22,5,0,4,1,29,6,2,21
"2011","South Somerset 022A","E01029169","Total",49,27,6,16,4,2,2,0,45,25,4,16
"2011","South Somerset 022B","E01029172","Total",20,13,6,1,3,0,3,0,17,13,3,1
"2011","South Somerset 022C","E01029173","Total",53,19,16,18,3,0,3,0,50,19,13,18
"2011","South Somerset 022D","E01029176","Total",13,6,7,0,4,2,2,0,9,4,5,0
"2011","South Somerset 022E","E01029177","Total",35,10,7,18,4,3,0,1,31,7,7,17
"2011","South Somerset 023A","E01029170","Total",41,17,14,10,7,0,5,2,34,17,9,8
"2011","South Somerset 023B","E01029171","Total",37,13,12,12,6,2,3,1,31,11,9,11
"2011","South Somerset 023C","E01029174","Total",15,8,1,6,0,0,0,0,15,8,1,6
"2011","South Somerset 023D","E01029175","Total",76,33,17,26,6,0,6,0,70,33,11,26
"2011","South Somerset 024A","E01029153","Total",25,11,6,8,4,1,1,2,21,10,5,6
"2011","South Somerset 024B","E01029219","Total",16,12,2,2,1,0,0,1,15,12,2,1
"2011","South Somerset 024C","E01029220","Total",21,11,3,7,3,0,3,0,18,11,0,7
"2011","South Somerset 024D","E01029230","Total",25,7,7,11,5,0,2,3,20,7,5,8
"2011","Taunton Deane 001A","E01029258","Total",29,14,10,5,5,2,2,1,24,12,8,4
"2011","Taunton Deane 001B","E01029259","Total",35,16,9,10,3,2,0,1,32,14,9,9
"2011","Taunton Deane 001C","E01029260","Total",82,43,27,12,5,2,1,2,77,41,26,10
"2011","Taunton Deane 001D","E01029268","Total",32,16,12,4,3,1,1,1,29,15,11,3
"2011","Taunton Deane 002A","E01029276","Total",14,7,5,2,0,0,0,0,14,7,5,2
"2011","Taunton Deane 002B","E01029278","Total",13,6,3,4,3,1,2,0,10,5,1,4
"2011","Taunton Deane 002C","E01029290","Total",40,14,18,8,7,0,7,0,33,14,11,8
"2011","Taunton Deane 002D","E01029306","Total",26,7,10,9,3,0,1,2,23,7,9,7
"2011","Taunton Deane 002E","E01029319","Total",55,19,16,20,6,1,5,0,49,18,11,20
"2011","Taunton Deane 003A","E01029267","Total",36,13,12,11,7,1,3,3,29,12,9,8
"2011","Taunton Deane 003B","E01029320","Total",59,25,18,16,7,2,2,3,52,23,16,13
"2011","Taunton Deane 003C","E01029321","Total",36,18,4,14,4,1,2,1,32,17,2,13
"2011","Taunton Deane 004A","E01029297","Total",61,26,12,23,5,1,4,0,56,25,8,23
"2011","Taunton Deane 004B","E01029298","Total",57,22,8,27,6,1,3,2,51,21,5,25
"2011","Taunton Deane 004C","E01029304","Total",59,28,7,24,4,1,1,2,55,27,6,22
"2011","Taunton Deane 004D","E01029305","Total",44,16,13,15,6,0,4,2,38,16,9,13
"2011","Taunton Deane 004E","E01029307","Total",59,22,14,23,5,1,3,1,54,21,11,22
"2011","Taunton Deane 005A","E01029271","Total",22,8,8,6,1,0,1,0,21,8,7,6
"2011","Taunton Deane 005B","E01029273","Total",31,21,9,1,1,1,0,0,30,20,9,1
"2011","Taunton Deane 005C","E01029274","Total",25,12,5,8,0,0,0,0,25,12,5,8
"2011","Taunton Deane 005D","E01029275","Total",25,15,8,2,3,0,3,0,22,15,5,2
"2011","Taunton Deane 005E","E01029279","Total",28,12,8,8,7,0,5,2,21,12,3,6
"2011","Taunton Deane 006A","E01029282","Total",37,17,12,8,4,0,4,0,33,17,8,8
"2011","Taunton Deane 006B","E01029291","Total",66,23,5,38,4,0,1,3,62,23,4,35
"2011","Taunton Deane 006C","E01029294","Total",54,27,17,10,4,1,2,1,50,26,15,9
"2011","Taunton Deane 006D","E01029317","Total",31,16,6,9,1,0,1,0,30,16,5,9
"2011","Taunton Deane 006E","E01029318","Total",14,6,5,3,0,0,0,0,14,6,5,3
"2011","Taunton Deane 007A","E01029285","Total",63,32,18,13,8,2,6,0,55,30,12,13
"2011","Taunton Deane 007B","E01029287","Total",49,21,11,17,4,0,4,0,45,21,7,17
"2011","Taunton Deane 007C","E01029288","Total",40,17,18,5,3,0,3,0,37,17,15,5
"2011","Taunton Deane 007D","E01029289","Total",45,16,11,18,5,0,4,1,40,16,7,17
"2011","Taunton Deane 007E","E01029299","Total",32,10,7,15,5,2,3,0,27,8,4,15
"2011","Taunton Deane 007F","E01029300","Total",49,27,7,15,5,1,2,2,44,26,5,13
"2011","Taunton Deane 008A","E01029256","Total",15,4,8,3,3,1,1,1,12,3,7,2
"2011","Taunton Deane 008B","E01029257","Total",82,46,17,19,5,0,2,3,77,46,15,16
"2011","Taunton Deane 008D","E01029277","Total",44,21,9,14,3,2,1,0,41,19,8,14
"2011","Taunton Deane 008E","E01032651","Total",23,11,6,6,1,0,1,0,22,11,5,6
"2011","Taunton Deane 008F","E01032652","Total",34,12,10,12,3,1,2,0,31,11,8,12
"2011","Taunton Deane 009A","E01029280","Total",66,30,16,20,5,0,3,2,61,30,13,18
"2011","Taunton Deane 009B","E01029281","Total",51,27,9,15,3,0,2,1,48,27,7,14
"2011","Taunton Deane 009C","E01029283","Total",71,30,20,21,9,1,4,4,62,29,16,17
"2011","Taunton Deane 009D","E01029292","Total",80,27,8,45,7,1,3,3,73,26,5,42
"2011","Taunton Deane 009E","E01029293","Total",145,57,6,82,7,2,2,3,138,55,4,79
"2011","Taunton Deane 010A","E01029266","Total",30,16,2,12,3,0,1,2,27,16,1,10
"2011","Taunton Deane 010B","E01029284","Total",23,6,7,10,2,0,2,0,21,6,5,10
"2011","Taunton Deane 010C","E01029286","Total",55,26,14,15,4,2,2,0,51,24,12,15
"2011","Taunton Deane 010D","E01029301","Total",34,10,13,11,3,0,3,0,31,10,10,11
"2011","Taunton Deane 010E","E01029303","Total",28,11,11,6,4,1,3,0,24,10,8,6
"2011","Taunton Deane 011A","E01029263","Total",32,11,14,7,4,1,3,0,28,10,11,7
"2011","Taunton Deane 011B","E01029264","Total",16,8,6,2,0,0,0,0,16,8,6,2
"2011","Taunton Deane 011C","E01029265","Total",17,8,5,4,2,1,1,0,15,7,4,4
"2011","Taunton Deane 011D","E01029302","Total",24,7,12,5,5,1,4,0,19,6,8,5
"2011","Taunton Deane 011E","E01029308","Total",31,13,11,7,6,1,5,0,25,12,6,7
"2011","Taunton Deane 012A","E01029309","Total",79,24,19,36,9,0,6,3,70,24,13,33
"2011","Taunton Deane 012B","E01029311","Total",54,24,13,17,6,3,1,2,48,21,12,15
"2011","Taunton Deane 012C","E01029312","Total",40,20,11,9,3,1,2,0,37,19,9,9
"2011","Taunton Deane 012D","E01029313","Total",41,17,15,9,11,0,10,1,30,17,5,8
"2011","Taunton Deane 012E","E01029316","Total",51,22,15,14,6,1,4,1,45,21,11,13
"2011","Taunton Deane 013A","E01029262","Total",22,4,15,3,4,0,4,0,18,4,11,3
"2011","Taunton Deane 013B","E01029269","Total",33,21,7,5,5,3,1,1,28,18,6,4
"2011","Taunton Deane 013C","E01029310","Total",26,15,7,4,5,1,4,0,21,14,3,4
"2011","Taunton Deane 013D","E01029314","Total",94,37,26,31,12,2,9,1,82,35,17,30
"2011","Taunton Deane 013E","E01029315","Total",31,14,12,5,1,0,1,0,30,14,11,5
"2011","Taunton Deane 014A","E01029261","Total",23,7,12,4,3,0,3,0,20,7,9,4
"2011","Taunton Deane 014B","E01029270","Total",35,14,16,5,7,0,6,1,28,14,10,4
"2011","Taunton Deane 014C","E01029295","Total",28,11,10,7,4,1,3,0,24,10,7,7
"2011","Taunton Deane 014D","E01029296","Total",15,6,8,1,5,1,4,0,10,5,4,1
"2011","West Somerset 001B","E01029324","Total",47,25,12,10,8,2,4,2,39,23,8,8
"2011","West Somerset 001C","E01029329","Total",30,14,10,6,3,0,2,1,27,14,8,5
"2011","West Somerset 001D","E01029330","Total",34,16,7,11,3,1,1,1,31,15,6,10
"2011","West Somerset 001F","E01032636","Total",42,15,14,13,3,0,2,1,39,15,12,12
"2011","West Somerset 002A","E01029322","Total",44,18,6,20,4,1,1,2,40,17,5,18
"2011","West Somerset 002B","E01029331","Total",22,9,9,4,4,0,4,0,18,9,5,4
"2011","West Somerset 002C","E01029333","Total",33,13,1,19,3,0,1,2,30,13,0,17
"2011","West Somerset 002D","E01029336","Total",33,12,9,12,7,1,3,3,26,11,6,9
"2011","West Somerset 003A","E01029326","Total",20,12,2,6,3,2,0,1,17,10,2,5
"2011","West Somerset 003B","E01029334","Total",20,3,5,12,2,0,2,0,18,3,3,12
"2011","West Somerset 003C","E01029339","Total",49,21,3,25,3,2,0,1,46,19,3,24
"2011","West Somerset 003E","E01029341","Total",25,12,4,9,1,0,1,0,24,12,3,9
"2011","West Somerset 003G","E01032635","Total",54,22,13,19,9,3,4,2,45,19,9,17
"2011","West Somerset 004A","E01029327","Total",21,11,5,5,2,0,2,0,19,11,3,5
"2011","West Somerset 004B","E01029335","Total",21,8,8,5,4,1,3,0,17,7,5,5
"2011","West Somerset 004C","E01029337","Total",31,7,12,12,6,0,4,2,25,7,8,10
"2011","West Somerset 004D","E01029342","Total",5,4,1,0,2,1,1,0,3,3,0,0
"2011","West Somerset 004E","E01029343","Total",28,11,7,10,2,0,2,0,26,11,5,10
"2011","West Somerset 005A","E01029325","Total",22,8,3,11,2,1,1,0,20,7,2,11
"2011","West Somerset 005B","E01029328","Total",34,10,9,15,4,0,3,1,30,10,6,14
"2011","West Somerset 005C","E01029338","Total",34,9,13,12,6,2,4,0,28,7,9,12
"2011","Isle of Anglesey 001A","W01000003","Total",79,26,20,33,10,1,5,4,69,25,15,29
"2011","Isle of Anglesey 001B","W01000004","Total",27,6,13,8,1,1,0,0,26,5,13,8
"2011","Isle of Anglesey 001C","W01000018","Total",42,15,7,20,6,2,3,1,36,13,4,19
"2011","Isle of Anglesey 001D","W01000028","Total",45,8,12,25,4,3,1,0,41,5,11,25
"2011","Isle of Anglesey 001E","W01000031","Total",29,9,13,7,5,0,4,1,24,9,9,6
"2011","Isle of Anglesey 002A","W01000010","Total",42,17,13,12,4,1,1,2,38,16,12,10
"2011","Isle of Anglesey 002B","W01000020","Total",14,5,6,3,1,1,0,0,13,4,6,3
"2011","Isle of Anglesey 002C","W01000021","Total",35,10,10,15,4,1,2,1,31,9,8,14
"2011","Isle of Anglesey 002D","W01000032","Total",23,6,5,12,3,2,0,1,20,4,5,11
"2011","Isle of Anglesey 003A","W01000016","Total",57,17,14,26,5,1,2,2,52,16,12,24
"2011","Isle of Anglesey 003B","W01000017","Total",53,20,11,22,5,1,3,1,48,19,8,21
"2011","Isle of Anglesey 003C","W01000029","Total",78,21,13,44,12,1,2,9,66,20,11,35
"2011","Isle of Anglesey 003D","W01000030","Total",108,35,28,45,16,1,9,6,92,34,19,39
"2011","Isle of Anglesey 003E","W01000033","Total",74,28,11,35,7,3,2,2,67,25,9,33
"2011","Isle of Anglesey 003F","W01000036","Total",52,16,7,29,6,0,2,4,46,16,5,25
"2011","Isle of Anglesey 003G","W01000037","Total",25,10,6,9,2,0,0,2,23,10,6,7
"2011","Isle of Anglesey 004A","W01000022","Total",29,13,8,8,3,1,2,0,26,12,6,8
"2011","Isle of Anglesey 004B","W01000034","Total",38,21,10,7,5,0,2,3,33,21,8,4
"2011","Isle of Anglesey 004C","W01000039","Total",16,2,8,6,3,0,3,0,13,2,5,6
"2011","Isle of Anglesey 004D","W01000040","Total",24,2,13,9,7,0,6,1,17,2,7,8
"2011","Isle of Anglesey 004E","W01000043","Total",36,10,7,19,2,1,0,1,34,9,7,18
"2011","Isle of Anglesey 004F","W01000044","Total",16,4,7,5,2,2,0,0,14,2,7,5
"2011","Isle of Anglesey 005A","W01000005","Total",55,26,14,15,5,0,3,2,50,26,11,13
"2011","Isle of Anglesey 005B","W01000013","Total",44,21,14,9,4,4,0,0,40,17,14,9
"2011","Isle of Anglesey 005C","W01000019","Total",23,11,7,5,3,0,2,1,20,11,5,4
"2011","Isle of Anglesey 005D","W01000026","Total",18,12,5,1,0,0,0,0,18,12,5,1
"2011","Isle of Anglesey 005E","W01000035","Total",29,12,12,5,4,0,4,0,25,12,8,5
"2011","Isle of Anglesey 006A","W01000006","Total",31,10,9,12,3,0,2,1,28,10,7,11
"2011","Isle of Anglesey 006B","W01000012","Total",18,7,4,7,1,0,0,1,17,7,4,6
"2011","Isle of Anglesey 006C","W01000014","Total",64,29,19,16,6,2,3,1,58,27,16,15
"2011","Isle of Anglesey 006D","W01000041","Total",112,32,24,56,12,4,4,4,100,28,20,52
"2011","Isle of Anglesey 007A","W01000001","Total",20,5,5,10,3,0,1,2,17,5,4,8
"2011","Isle of Anglesey 007B","W01000002","Total",25,13,9,3,2,1,1,0,23,12,8,3
"2011","Isle of Anglesey 007C","W01000009","Total",44,15,11,18,3,0,1,2,41,15,10,16
"2011","Isle of Anglesey 007D","W01000023","Total",35,13,8,14,4,2,1,1,31,11,7,13
"2011","Isle of Anglesey 007E","W01000024","Total",55,13,20,22,16,1,9,6,39,12,11,16
"2011","Isle of Anglesey 008A","W01000008","Total",25,10,12,3,0,0,0,0,25,10,12,3
"2011","Isle of Anglesey 008B","W01000011","Total",29,14,9,6,3,0,2,1,26,14,7,5
"2011","Isle of Anglesey 008C","W01000015","Total",27,10,15,2,3,1,2,0,24,9,13,2
"2011","Isle of Anglesey 008D","W01000042","Total",47,15,16,16,8,1,4,3,39,14,12,13
"2011","Isle of Anglesey 009A","W01000007","Total",30,10,9,11,2,0,2,0,28,10,7,11
"2011","Isle of Anglesey 009B","W01000025","Total",44,17,18,9,7,3,4,0,37,14,14,9
"2011","Isle of Anglesey 009C","W01000027","Total",38,15,10,13,5,1,2,2,33,14,8,11
"2011","Isle of Anglesey 009D","W01000038","Total",56,19,14,23,9,3,2,4,47,16,12,19
"2011","Gwynedd 001A","W01000062","Total",18,3,5,10,0,0,0,0,18,3,5,10
"2011","Gwynedd 001B","W01000076","Total",21,3,8,10,6,2,3,1,15,1,5,9
"2011","Gwynedd 001C","W01000077","Total",40,16,12,12,4,0,4,0,36,16,8,12
"2011","Gwynedd 001D","W01000091","Total",60,19,4,37,9,0,0,9,51,19,4,28
"2011","Gwynedd 001E","W01000092","Total",6,2,4,0,0,0,0,0,6,2,4,0
"2011","Gwynedd 002A","W01000064","Total",49,21,10,18,4,0,2,2,45,21,8,16
"2011","Gwynedd 002B","W01000072","Total",39,10,16,13,1,0,0,1,38,10,16,12
"2011","Gwynedd 002C","W01000075","Total",61,21,9,31,1,0,1,0,60,21,8,31
"2011","Gwynedd 002D","W01000090","Total",85,33,11,41,6,0,2,4,79,33,9,37
"2011","Gwynedd 002E","W01000102","Total",9,5,4,0,1,0,1,0,8,5,3,0
"2011","Gwynedd 003A","W01000050","Total",37,14,13,10,11,4,4,3,26,10,9,7
"2011","Gwynedd 003B","W01000071","Total",73,21,14,38,4,0,2,2,69,21,12,36
"2011","Gwynedd 003C","W01000096","Total",47,15,8,24,2,0,1,1,45,15,7,23
"2011","Gwynedd 003D","W01000097","Total",32,10,7,15,3,0,3,0,29,10,4,15
"2011","Gwynedd 003E","W01000115","Total",57,22,19,16,6,1,5,0,51,21,14,16
"2011","Gwynedd 004A","W01000052","Total",29,7,11,11,6,2,3,1,23,5,8,10
"2011","Gwynedd 004B","W01000053","Total",24,14,6,4,3,2,1,0,21,12,5,4
"2011","Gwynedd 004C","W01000087","Total",53,17,20,16,4,0,4,0,49,17,16,16
"2011","Gwynedd 004D","W01000119","Total",41,14,12,15,5,1,3,1,36,13,9,14
"2011","Gwynedd 005A","W01000063","Total",75,29,21,25,13,2,8,3,62,27,13,22
"2011","Gwynedd 005B","W01000081","Total",41,22,7,12,5,3,2,0,36,19,5,12
"2011","Gwynedd 005C","W01000099","Total",41,14,14,13,6,3,1,2,35,11,13,11
"2011","Gwynedd 005D","W01000103","Total",24,5,11,8,3,0,3,0,21,5,8,8
"2011","Gwynedd 006A","W01000059","Total",101,36,26,39,11,0,4,7,90,36,22,32
"2011","Gwynedd 006B","W01000093","Total",35,11,20,4,4,0,3,1,31,11,17,3
"2011","Gwynedd 006C","W01000098","Total",143,43,17,83,4,0,1,3,139,43,16,80
"2011","Gwynedd 006D","W01000110","Total",42,18,12,12,5,1,3,1,37,17,9,11
"2011","Gwynedd 007A","W01000054","Total",22,10,6,6,1,0,1,0,21,10,5,6
"2011","Gwynedd 007B","W01000088","Total",41,16,12,13,5,2,0,3,36,14,12,10
"2011","Gwynedd 007C","W01000111","Total",56,25,15,16,3,2,1,0,53,23,14,16
"2011","Gwynedd 007D","W01000118","Total",41,13,18,10,8,1,6,1,33,12,12,9
"2011","Gwynedd 008A","W01000073","Total",33,14,12,7,2,1,1,0,31,13,11,7
"2011","Gwynedd 008B","W01000086","Total",59,17,9,33,5,1,2,2,54,16,7,31
"2011","Gwynedd 008C","W01000104","Total",64,32,10,22,3,0,2,1,61,32,8,21
"2011","Gwynedd 008D","W01000112","Total",78,23,10,45,13,2,3,8,65,21,7,37
"2011","Gwynedd 009A","W01000056","Total",71,27,15,29,9,1,6,2,62,26,9,27
"2011","Gwynedd 009B","W01000065","Total",43,15,13,15,6,0,4,2,37,15,9,13
"2011","Gwynedd 009C","W01000113","Total",61,22,11,28,10,1,4,5,51,21,7,23
"2011","Gwynedd 009D","W01000114","Total",38,18,4,16,5,2,1,2,33,16,3,14
"2011","Gwynedd 010A","W01000066","Total",18,6,4,8,0,0,0,0,18,6,4,8
"2011","Gwynedd 010B","W01000100","Total",24,9,7,8,7,2,3,2,17,7,4,6
"2011","Gwynedd 010C","W01000105","Total",54,25,12,17,10,3,4,3,44,22,8,14
"2011","Gwynedd 010D","W01000106","Total",11,6,1,4,1,0,0,1,10,6,1,3
"2011","Gwynedd 010E","W01000107","Total",34,16,8,10,3,0,1,2,31,16,7,8
"2011","Gwynedd 011A","W01000047","Total",22,9,7,6,3,0,3,0,19,9,4,6
"2011","Gwynedd 011B","W01000061","Total",32,11,14,7,3,0,3,0,29,11,11,7
"2011","Gwynedd 011C","W01000078","Total",46,17,4,25,3,0,2,1,43,17,2,24
"2011","Gwynedd 011D","W01000089","Total",33,15,10,8,4,1,3,0,29,14,7,8
"2011","Gwynedd 012A","W01000070","Total",10,8,0,2,0,0,0,0,10,8,0,2
"2011","Gwynedd 012B","W01000094","Total",23,9,6,8,2,0,2,0,21,9,4,8
"2011","Gwynedd 012C","W01000095","Total",37,17,12,8,3,2,1,0,34,15,11,8
"2011","Gwynedd 012D","W01000108","Total",73,36,21,16,1,1,0,0,72,35,21,16
"2011","Gwynedd 012E","W01000109","Total",49,14,15,20,4,1,3,0,45,13,12,20
"2011","Gwynedd 013A","W01000069","Total",23,11,8,4,1,1,0,0,22,10,8,4
"2011","Gwynedd 013B","W01000074","Total",44,18,14,12,3,1,2,0,41,17,12,12
"2011","Gwynedd 013C","W01000079","Total",18,5,10,3,6,0,4,2,12,5,6,1
"2011","Gwynedd 013D","W01000101","Total",43,13,26,4,13,0,13,0,30,13,13,4
"2011","Gwynedd 014C","W01000080","Total",35,19,12,4,5,1,4,0,30,18,8,4
"2011","Gwynedd 014D","W01000084","Total",21,8,8,5,3,1,2,0,18,7,6,5
"2011","Gwynedd 014E","W01001932","Total",45,15,11,19,16,4,6,6,29,11,5,13
"2011","Gwynedd 015A","W01000051","Total",52,27,8,17,0,0,0,0,52,27,8,17
"2011","Gwynedd 015B","W01000060","Total",42,15,19,8,9,0,9,0,33,15,10,8
"2011","Gwynedd 015C","W01000082","Total",25,6,6,13,1,0,0,1,24,6,6,12
"2011","Gwynedd 015D","W01000083","Total",18,4,8,6,6,1,3,2,12,3,5,4
"2011","Gwynedd 016A","W01000048","Total",47,25,3,19,3,1,1,1,44,24,2,18
"2011","Gwynedd 016B","W01000049","Total",44,18,6,20,5,0,4,1,39,18,2,19
"2011","Gwynedd 016C","W01000057","Total",20,5,10,5,4,0,4,0,16,5,6,5
"2011","Gwynedd 016D","W01000067","Total",22,8,8,6,6,0,5,1,16,8,3,5
"2011","Gwynedd 016E","W01000068","Total",47,17,11,19,3,0,2,1,44,17,9,18
"2011","Gwynedd 017C","W01000085","Total",34,13,13,8,4,0,4,0,30,13,9,8
"2011","Gwynedd 017D","W01000116","Total",30,16,8,6,8,3,4,1,22,13,4,5
"2011","Gwynedd 017E","W01000117","Total",55,21,5,29,7,3,1,3,48,18,4,26
"2011","Gwynedd 017F","W01001933","Total",20,7,8,5,4,0,4,0,16,7,4,5
"2011","Conwy 001A","W01000132","Total",42,12,12,18,10,1,5,4,32,11,7,14
"2011","Conwy 001B","W01000146","Total",52,17,6,29,2,1,0,1,50,16,6,28
"2011","Conwy 001C","W01000147","Total",24,10,5,9,2,0,0,2,22,10,5,7
"2011","Conwy 001D","W01000169","Total",38,10,8,20,3,0,3,0,35,10,5,20
"2011","Conwy 001E","W01000186","Total",76,37,14,25,8,3,2,3,68,34,12,22
"2011","Conwy 002A","W01000133","Total",25,9,9,7,4,0,3,1,21,9,6,6
"2011","Conwy 002B","W01000168","Total",72,24,17,31,10,2,4,4,62,22,13,27
"2011","Conwy 002C","W01000187","Total",125,43,19,63,11,4,0,7,114,39,19,56
"2011","Conwy 002D","W01000188","Total",51,23,15,13,7,1,6,0,44,22,9,13
"2011","Conwy 003A","W01000154","Total",29,10,12,7,2,0,2,0,27,10,10,7
"2011","Conwy 003B","W01000173","Total",46,16,26,4,9,1,8,0,37,15,18,4
"2011","Conwy 003C","W01000174","Total",40,18,19,3,8,0,7,1,32,18,12,2
"2011","Conwy 003D","W01000175","Total",25,14,7,4,3,1,2,0,22,13,5,4
"2011","Conwy 004A","W01000155","Total",21,8,9,4,1,1,0,0,20,7,9,4
"2011","Conwy 004B","W01000156","Total",17,10,5,2,0,0,0,0,17,10,5,2
"2011","Conwy 004C","W01000157","Total",51,19,16,16,2,0,2,0,49,19,14,16
"2011","Conwy 004D","W01000158","Total",25,13,7,5,2,0,2,0,23,13,5,5
"2011","Conwy 005A","W01000149","Total",43,11,8,24,4,0,1,3,39,11,7,21
"2011","Conwy 005B","W01000150","Total",35,15,11,9,4,0,3,1,31,15,8,8
"2011","Conwy 005C","W01000151","Total",63,17,17,29,4,0,4,0,59,17,13,29
"2011","Conwy 005D","W01000152","Total",38,13,9,16,7,2,2,3,31,11,7,13
"2011","Conwy 005E","W01000184","Total",66,25,16,25,4,0,3,1,62,25,13,24
"2011","Conwy 006A","W01000135","Total",27,12,10,5,4,0,4,0,23,12,6,5
"2011","Conwy 006B","W01000136","Total",38,13,11,14,3,0,2,1,35,13,9,13
"2011","Conwy 006C","W01000165","Total",39,20,14,5,5,1,2,2,34,19,12,3
"2011","Conwy 006D","W01000166","Total",69,38,18,13,4,0,4,0,65,38,14,13
"2011","Conwy 007A","W01000139","Total",45,17,17,11,7,0,4,3,38,17,13,8
"2011","Conwy 007B","W01000143","Total",62,24,15,23,5,0,3,2,57,24,12,21
"2011","Conwy 007C","W01000144","Total",64,17,14,33,12,2,5,5,52,15,9,28
"2011","Conwy 007D","W01000182","Total",58,26,12,20,6,1,3,2,52,25,9,18
"2011","Conwy 008A","W01000138","Total",62,26,15,21,8,1,4,3,54,25,11,18
"2011","Conwy 008B","W01000145","Total",59,19,15,25,5,0,4,1,54,19,11,24
"2011","Conwy 008C","W01000180","Total",31,12,15,4,6,3,3,0,25,9,12,4
"2011","Conwy 008D","W01000181","Total",49,18,23,8,3,0,3,0,46,18,20,8
"2011","Conwy 008E","W01000183","Total",34,12,14,8,2,0,2,0,32,12,12,8
"2011","Conwy 009A","W01000126","Total",51,16,27,8,9,3,4,2,42,13,23,6
"2011","Conwy 009B","W01000127","Total",59,23,10,26,4,1,2,1,55,22,8,25
"2011","Conwy 009C","W01000128","Total",42,13,14,15,7,0,4,3,35,13,10,12
"2011","Conwy 009D","W01000153","Total",34,13,14,7,2,0,2,0,32,13,12,7
"2011","Conwy 009E","W01000163","Total",88,26,15,47,11,2,6,3,77,24,9,44
"2011","Conwy 009F","W01000164","Total",53,21,18,14,4,1,2,1,49,20,16,13
"2011","Conwy 010B","W01000140","Total",48,16,14,18,4,0,3,1,44,16,11,17
"2011","Conwy 010C","W01000141","Total",24,6,12,6,2,0,2,0,22,6,10,6
"2011","Conwy 010D","W01000142","Total",17,8,6,3,3,0,3,0,14,8,3,3
"2011","Conwy 010E","W01000178","Total",108,35,28,45,8,1,5,2,100,34,23,43
"2011","Conwy 010F","W01000179","Total",18,8,5,5,0,0,0,0,18,8,5,5
"2011","Conwy 010G","W01001927","Total",34,12,6,16,2,0,0,2,32,12,6,14
"2011","Conwy 010H","W01001928","Total",38,10,2,26,7,0,1,6,31,10,1,20
"2011","Conwy 011C","W01000167","Total",70,29,11,30,6,3,1,2,64,26,10,28
"2011","Conwy 011D","W01000176","Total",73,31,21,21,12,2,7,3,61,29,14,18
"2011","Conwy 011E","W01000177","Total",46,17,15,14,2,1,1,0,44,16,14,14
"2011","Conwy 011F","W01001926","Total",47,21,20,6,9,4,4,1,38,17,16,5
"2011","Conwy 012A","W01000124","Total",32,14,11,7,5,0,2,3,27,14,9,4
"2011","Conwy 012B","W01000129","Total",38,15,8,15,3,2,1,0,35,13,7,15
"2011","Conwy 012C","W01000130","Total",37,17,12,8,8,2,6,0,29,15,6,8
"2011","Conwy 012D","W01000131","Total",44,22,10,12,3,1,2,0,41,21,8,12
"2011","Conwy 013A","W01000123","Total",39,14,16,9,8,1,4,3,31,13,12,6
"2011","Conwy 013B","W01000125","Total",29,11,10,8,3,0,2,1,26,11,8,7
"2011","Conwy 013C","W01000170","Total",47,13,17,17,7,0,4,3,40,13,13,14
"2011","Conwy 013D","W01000171","Total",41,16,6,19,7,1,2,4,34,15,4,15
"2011","Conwy 013E","W01000172","Total",67,24,11,32,6,1,1,4,61,23,10,28
"2011","Conwy 014A","W01000122","Total",30,9,12,9,3,1,2,0,27,8,10,9
"2011","Conwy 014B","W01000159","Total",12,4,7,1,4,0,3,1,8,4,4,0
"2011","Conwy 014C","W01000162","Total",16,4,10,2,3,0,3,0,13,4,7,2
"2011","Conwy 014D","W01000190","Total",11,5,4,2,2,2,0,0,9,3,4,2
"2011","Conwy 015A","W01000121","Total",27,7,9,11,5,0,3,2,22,7,6,9
"2011","Conwy 015B","W01000134","Total",91,35,21,35,10,2,5,3,81,33,16,32
"2011","Conwy 015C","W01000137","Total",22,6,13,3,5,0,4,1,17,6,9,2
"2011","Conwy 015D","W01000148","Total",52,11,17,24,6,0,2,4,46,11,15,20
"2011","Conwy 015E","W01000185","Total",24,13,5,6,3,1,1,1,21,12,4,5
"2011","Conwy 015F","W01000189","Total",16,7,2,7,2,0,0,2,14,7,2,5
"2011","Denbighshire 001A","W01000218","Total",50,16,14,20,1,0,1,0,49,16,13,20
"2011","Denbighshire 001B","W01000219","Total",102,40,33,29,5,1,4,0,97,39,29,29
"2011","Denbighshire 001C","W01000220","Total",27,8,11,8,4,0,4,0,23,8,7,8
"2011","Denbighshire 002A","W01000213","Total",91,26,18,47,13,2,6,5,78,24,12,42
"2011","Denbighshire 002B","W01000214","Total",42,14,9,19,5,0,2,3,37,14,7,16
"2011","Denbighshire 002C","W01000215","Total",15,0,13,2,7,0,7,0,8,0,6,2
"2011","Denbighshire 002D","W01000216","Total",55,25,14,16,8,3,4,1,47,22,10,15
"2011","Denbighshire 003A","W01000212","Total",41,15,11,15,7,1,3,3,34,14,8,12
"2011","Denbighshire 003B","W01000221","Total",61,29,20,12,5,2,3,0,56,27,17,12
"2011","Denbighshire 003C","W01000222","Total",30,12,11,7,0,0,0,0,30,12,11,7
"2011","Denbighshire 004A","W01000226","Total",32,12,8,12,4,1,2,1,28,11,6,11
"2011","Denbighshire 004B","W01000227","Total",38,17,8,13,3,1,2,0,35,16,6,13
"2011","Denbighshire 004C","W01000228","Total",39,7,9,23,7,1,1,5,32,6,8,18
"2011","Denbighshire 004D","W01000239","Total",69,21,9,39,9,4,2,3,60,17,7,36
"2011","Denbighshire 004E","W01000240","Total",67,18,9,40,8,2,1,5,59,16,8,35
"2011","Denbighshire 004F","W01000241","Total",69,11,18,40,7,0,4,3,62,11,14,37
"2011","Denbighshire 006A","W01000236","Total",124,36,20,68,9,0,2,7,115,36,18,61
"2011","Denbighshire 006B","W01000237","Total",136,47,25,64,17,1,8,8,119,46,17,56
"2011","Denbighshire 006C","W01000238","Total",49,14,16,19,5,0,5,0,44,14,11,19
"2011","Denbighshire 008A","W01000200","Total",36,16,13,7,6,1,4,1,30,15,9,6
"2011","Denbighshire 008B","W01000201","Total",72,23,29,20,9,0,7,2,63,23,22,18
"2011","Denbighshire 008C","W01000217","Total",78,27,17,34,9,0,3,6,69,27,14,28
"2011","Denbighshire 008D","W01000248","Total",20,9,7,4,1,0,1,0,19,9,6,4
"2011","Denbighshire 009A","W01000191","Total",82,37,27,18,9,3,5,1,73,34,22,17
"2011","Denbighshire 009B","W01000223","Total",27,5,18,4,4,0,3,1,23,5,15,3
"2011","Denbighshire 009C","W01000224","Total",33,11,9,13,3,0,1,2,30,11,8,11
"2011","Denbighshire 009D","W01000225","Total",59,27,16,16,2,0,1,1,57,27,15,15
"2011","Denbighshire 010A","W01000245","Total",35,6,19,10,6,0,4,2,29,6,15,8
"2011","Denbighshire 010B","W01000246","Total",41,13,15,13,5,0,3,2,36,13,12,11
"2011","Denbighshire 010C","W01000247","Total",36,10,16,10,4,0,2,2,32,10,14,8
"2011","Denbighshire 011A","W01000194","Total",89,25,29,35,7,2,2,3,82,23,27,32
"2011","Denbighshire 011B","W01000198","Total",93,23,22,48,10,0,4,6,83,23,18,42
"2011","Denbighshire 011C","W01000199","Total",52,13,22,17,9,0,5,4,43,13,17,13
"2011","Denbighshire 012A","W01000195","Total",24,9,11,4,4,1,2,1,20,8,9,3
"2011","Denbighshire 012B","W01000196","Total",35,15,14,6,3,2,1,0,32,13,13,6
"2011","Denbighshire 012C","W01000197","Total",32,14,13,5,6,2,4,0,26,12,9,5
"2011","Denbighshire 012D","W01000211","Total",24,12,10,2,5,0,5,0,19,12,5,2
"2011","Denbighshire 013A","W01000203","Total",38,12,14,12,4,0,3,1,34,12,11,11
"2011","Denbighshire 013B","W01000204","Total",16,7,7,2,1,0,1,0,15,7,6,2
"2011","Denbighshire 013C","W01000206","Total",33,17,10,6,2,0,1,1,31,17,9,5
"2011","Denbighshire 014A","W01000242","Total",71,29,16,26,2,2,0,0,69,27,16,26
"2011","Denbighshire 014B","W01000243","Total",46,12,17,17,3,2,0,1,43,10,17,16
"2011","Denbighshire 014C","W01000244","Total",29,10,9,10,6,1,2,3,23,9,7,7
"2011","Denbighshire 015A","W01000193","Total",36,14,16,6,2,2,0,0,34,12,16,6
"2011","Denbighshire 015B","W01000202","Total",26,9,8,9,1,0,1,0,25,9,7,9
"2011","Denbighshire 015C","W01000207","Total",35,14,10,11,4,0,2,2,31,14,8,9
"2011","Denbighshire 016A","W01000192","Total",25,13,9,3,6,0,5,1,19,13,4,2
"2011","Denbighshire 016B","W01000205","Total",20,6,8,6,2,0,0,2,18,6,8,4
"2011","Denbighshire 016C","W01000208","Total",20,7,6,7,1,0,0,1,19,7,6,6
"2011","Denbighshire 016D","W01000209","Total",46,12,14,20,9,2,5,2,37,10,9,18
"2011","Denbighshire 016E","W01000210","Total",28,13,11,4,2,0,1,1,26,13,10,3
"2011","Denbighshire 017E","W01000229","Total",49,18,9,22,5,3,0,2,44,15,9,20
"2011","Denbighshire 017F","W01000230","Total",40,16,12,12,1,0,0,1,39,16,12,11
"2011","Denbighshire 017A","W01000231","Total",56,28,16,12,6,0,5,1,50,28,11,11
"2011","Denbighshire 017B","W01000232","Total",39,11,18,10,4,0,4,0,35,11,14,10
"2011","Denbighshire 017C","W01000233","Total",36,14,11,11,3,0,3,0,33,14,8,11
"2011","Denbighshire 017G","W01000234","Total",86,25,18,43,9,2,3,4,77,23,15,39
"2011","Denbighshire 017D","W01000235","Total",43,13,21,9,3,1,2,0,40,12,19,9
"2011","Flintshire 001A","W01000287","Total",50,14,21,15,12,3,5,4,38,11,16,11
"2011","Flintshire 001B","W01000298","Total",38,5,17,16,8,0,6,2,30,5,11,14
"2011","Flintshire 001C","W01000338","Total",33,9,16,8,7,1,6,0,26,8,10,8
"2011","Flintshire 002A","W01000306","Total",84,31,18,35,14,8,4,2,70,23,14,33
"2011","Flintshire 002B","W01000320","Total",54,14,16,24,6,1,4,1,48,13,12,23
"2011","Flintshire 002C","W01000340","Total",35,13,16,6,3,0,2,1,32,13,14,5
"2011","Flintshire 003A","W01000253","Total",62,22,17,23,7,0,4,3,55,22,13,20
"2011","Flintshire 003B","W01000254","Total",95,35,18,42,7,1,3,3,88,34,15,39
"2011","Flintshire 003C","W01000296","Total",55,17,5,33,3,0,2,1,52,17,3,32
"2011","Flintshire 003D","W01000297","Total",64,18,16,30,1,0,1,0,63,18,15,30
"2011","Flintshire 003E","W01000304","Total",93,25,16,52,11,0,5,6,82,25,11,46
"2011","Flintshire 003F","W01000305","Total",43,10,9,24,4,0,2,2,39,10,7,22
"2011","Flintshire 004A","W01000288","Total",112,48,14,50,7,3,1,3,105,45,13,47
"2011","Flintshire 004B","W01000290","Total",45,18,12,15,6,0,4,2,39,18,8,13
"2011","Flintshire 004C","W01000292","Total",88,24,17,47,8,0,4,4,80,24,13,43
"2011","Flintshire 004D","W01000293","Total",52,24,11,17,7,0,4,3,45,24,7,14
"2011","Flintshire 005A","W01000289","Total",41,14,12,15,4,1,2,1,37,13,10,14
"2011","Flintshire 005B","W01000291","Total",62,22,15,25,6,0,3,3,56,22,12,22
"2011","Flintshire 005C","W01000294","Total",32,11,17,4,6,0,5,1,26,11,12,3
"2011","Flintshire 005D","W01000295","Total",41,19,8,14,3,0,3,0,38,19,5,14
"2011","Flintshire 006A","W01000258","Total",28,12,6,10,5,1,2,2,23,11,4,8
"2011","Flintshire 006B","W01000270","Total",13,1,11,1,4,0,4,0,9,1,7,1
"2011","Flintshire 006C","W01000271","Total",30,8,15,7,1,0,1,0,29,8,14,7
"2011","Flintshire 006D","W01000272","Total",20,6,12,2,5,0,4,1,15,6,8,1
"2011","Flintshire 006E","W01000301","Total",33,13,15,5,6,0,5,1,27,13,10,4
"2011","Flintshire 007A","W01000273","Total",69,13,15,41,9,1,3,5,60,12,12,36
"2011","Flintshire 007B","W01000274","Total",99,31,29,39,9,2,6,1,90,29,23,38
"2011","Flintshire 007C","W01000275","Total",31,10,7,14,4,0,1,3,27,10,6,11
"2011","Flintshire 007D","W01000278","Total",87,27,15,45,5,1,1,3,82,26,14,42
"2011","Flintshire 008A","W01000276","Total",69,22,29,18,11,0,9,2,58,22,20,16
"2011","Flintshire 008B","W01000277","Total",41,6,18,17,5,0,3,2,36,6,15,15
"2011","Flintshire 008C","W01000279","Total",25,9,10,6,2,0,2,0,23,9,8,6
"2011","Flintshire 008D","W01000281","Total",33,6,12,15,2,0,2,0,31,6,10,15
"2011","Flintshire 008E","W01000283","Total",59,23,20,16,4,0,4,0,55,23,16,16
"2011","Flintshire 009A","W01000332","Total",42,14,14,14,4,1,2,1,38,13,12,13
"2011","Flintshire 009B","W01000333","Total",80,22,13,45,8,0,0,8,72,22,13,37
"2011","Flintshire 009C","W01000334","Total",59,16,13,30,7,0,4,3,52,16,9,27
"2011","Flintshire 009D","W01000335","Total",39,13,8,18,4,0,1,3,35,13,7,15
"2011","Flintshire 009E","W01000336","Total",95,22,20,53,6,1,1,4,89,21,19,49
"2011","Flintshire 009F","W01000337","Total",63,28,19,16,8,0,7,1,55,28,12,15
"2011","Flintshire 010A","W01000252","Total",19,9,7,3,6,1,4,1,13,8,3,2
"2011","Flintshire 010B","W01000280","Total",28,12,8,8,1,0,1,0,27,12,7,8
"2011","Flintshire 010C","W01000282","Total",35,15,12,8,5,2,3,0,30,13,9,8
"2011","Flintshire 010D","W01000325","Total",28,15,6,7,0,0,0,0,28,15,6,7
"2011","Flintshire 011A","W01000311","Total",45,24,11,10,0,0,0,0,45,24,11,10
"2011","Flintshire 011B","W01000312","Total",66,21,19,26,6,0,6,0,60,21,13,26
"2011","Flintshire 011C","W01000328","Total",75,19,21,35,6,1,4,1,69,18,17,34
"2011","Flintshire 012A","W01000264","Total",59,25,21,13,10,0,8,2,49,25,13,11
"2011","Flintshire 012B","W01000265","Total",24,13,6,5,0,0,0,0,24,13,6,5
"2011","Flintshire 012C","W01000323","Total",30,15,8,7,2,1,1,0,28,14,7,7
"2011","Flintshire 012D","W01000324","Total",33,12,12,9,3,1,2,0,30,11,10,9
"2011","Flintshire 013A","W01000251","Total",56,18,15,23,7,1,4,2,49,17,11,21
"2011","Flintshire 013B","W01000268","Total",34,13,16,5,4,1,3,0,30,12,13,5
"2011","Flintshire 013C","W01000284","Total",34,12,16,6,0,0,0,0,34,12,16,6
"2011","Flintshire 013D","W01000285","Total",23,10,13,0,5,1,4,0,18,9,9,0
"2011","Flintshire 013E","W01000286","Total",46,15,20,11,5,1,4,0,41,14,16,11
"2011","Flintshire 013F","W01000302","Total",36,17,17,2,7,1,6,0,29,16,11,2
"2011","Flintshire 014A","W01000249","Total",34,16,10,8,1,0,1,0,33,16,9,8
"2011","Flintshire 014B","W01000250","Total",23,9,10,4,5,0,4,1,18,9,6,3
"2011","Flintshire 014C","W01000261","Total",36,15,8,13,4,0,2,2,32,15,6,11
"2011","Flintshire 014D","W01000321","Total",28,12,12,4,3,0,3,0,25,12,9,4
"2011","Flintshire 014E","W01000322","Total",30,6,13,11,7,1,5,1,23,5,8,10
"2011","Flintshire 015A","W01000255","Total",71,34,18,19,7,2,3,2,64,32,15,17
"2011","Flintshire 015B","W01000256","Total",59,27,16,16,8,2,4,2,51,25,12,14
"2011","Flintshire 015C","W01000257","Total",47,20,16,11,4,0,3,1,43,20,13,10
"2011","Flintshire 015D","W01000329","Total",86,41,8,37,9,5,0,4,77,36,8,33
"2011","Flintshire 015E","W01000330","Total",111,44,24,43,7,1,4,2,104,43,20,41
"2011","Flintshire 015F","W01000331","Total",37,12,14,11,3,0,3,0,34,12,11,11
"2011","Flintshire 016A","W01000313","Total",53,21,18,14,2,0,2,0,51,21,16,14
"2011","Flintshire 016B","W01000314","Total",42,15,14,13,6,1,3,2,36,14,11,11
"2011","Flintshire 016C","W01000315","Total",72,29,21,22,11,5,6,0,61,24,15,22
"2011","Flintshire 016D","W01000316","Total",27,5,14,8,3,0,2,1,24,5,12,7
"2011","Flintshire 016E","W01000317","Total",21,8,10,3,5,1,3,1,16,7,7,2
"2011","Flintshire 016F","W01000318","Total",66,26,11,29,12,2,8,2,54,24,3,27
"2011","Flintshire 016G","W01000319","Total",37,12,10,15,8,0,3,5,29,12,7,10
"2011","Flintshire 017A","W01000259","Total",43,13,12,18,7,4,3,0,36,9,9,18
"2011","Flintshire 017B","W01000260","Total",46,16,18,12,5,0,4,1,41,16,14,11
"2011","Flintshire 017C","W01000262","Total",80,27,22,31,9,1,5,3,71,26,17,28
"2011","Flintshire 017D","W01000263","Total",72,32,12,28,6,0,1,5,66,32,11,23
"2011","Flintshire 017E","W01000266","Total",40,12,14,14,4,1,2,1,36,11,12,13
"2011","Flintshire 017F","W01000267","Total",38,9,16,13,2,0,2,0,36,9,14,13
"2011","Flintshire 018A","W01000303","Total",29,14,15,0,5,0,5,0,24,14,10,0
"2011","Flintshire 018B","W01000326","Total",25,14,7,4,2,1,1,0,23,13,6,4
"2011","Flintshire 018C","W01000327","Total",45,22,15,8,4,0,4,0,41,22,11,8
"2011","Flintshire 019A","W01000299","Total",29,9,18,2,3,0,3,0,26,9,15,2
"2011","Flintshire 019B","W01000300","Total",29,13,10,6,4,0,3,1,25,13,7,5
"2011","Flintshire 019C","W01000309","Total",69,26,25,18,10,1,5,4,59,25,20,14
"2011","Flintshire 019D","W01000339","Total",32,13,7,12,3,0,2,1,29,13,5,11
"2011","Flintshire 020A","W01000269","Total",58,23,18,17,8,2,5,1,50,21,13,16
"2011","Flintshire 020B","W01000307","Total",12,3,8,1,2,0,1,1,10,3,7,0
"2011","Flintshire 020C","W01000308","Total",38,13,11,14,4,0,1,3,34,13,10,11
"2011","Flintshire 020D","W01000310","Total",36,21,11,4,4,1,2,1,32,20,9,3
"2011","Wrexham 003A","W01000374","Total",42,21,11,10,3,0,3,0,39,21,8,10
"2011","Wrexham 003B","W01000375","Total",61,23,22,16,7,0,4,3,54,23,18,13
"2011","Wrexham 003C","W01000376","Total",35,10,14,11,4,0,0,4,31,10,14,7
"2011","Wrexham 003D","W01000391","Total",32,15,11,6,4,2,1,1,28,13,10,5
"2011","Wrexham 003E","W01000392","Total",71,25,14,32,7,0,3,4,64,25,11,28
"2011","Wrexham 004A","W01000377","Total",27,14,6,7,5,0,5,0,22,14,1,7
"2011","Wrexham 004B","W01000378","Total",95,32,17,46,6,1,1,4,89,31,16,42
"2011","Wrexham 004C","W01000379","Total",66,27,11,28,5,0,3,2,61,27,8,26
"2011","Wrexham 004D","W01000380","Total",21,6,11,4,3,1,2,0,18,5,9,4
"2011","Wrexham 005A","W01000351","Total",77,26,14,37,6,0,5,1,71,26,9,36
"2011","Wrexham 005B","W01000373","Total",96,28,22,46,15,5,2,8,81,23,20,38
"2011","Wrexham 005C","W01000400","Total",61,25,16,20,3,1,1,1,58,24,15,19
"2011","Wrexham 005D","W01000401","Total",65,19,14,32,6,0,1,5,59,19,13,27
"2011","Wrexham 006A","W01000347","Total",57,24,17,16,7,2,3,2,50,22,14,14
"2011","Wrexham 006B","W01000348","Total",81,29,16,36,6,1,2,3,75,28,14,33
"2011","Wrexham 006C","W01000362","Total",71,28,10,33,7,2,4,1,64,26,6,32
"2011","Wrexham 006D","W01000363","Total",39,16,10,13,9,3,4,2,30,13,6,11
"2011","Wrexham 006E","W01000364","Total",37,15,15,7,10,1,8,1,27,14,7,6
"2011","Wrexham 007A","W01000343","Total",13,6,3,4,3,0,3,0,10,6,0,4
"2011","Wrexham 007B","W01000344","Total",18,7,8,3,5,2,3,0,13,5,5,3
"2011","Wrexham 007C","W01000415","Total",23,9,10,4,4,1,2,1,19,8,8,3
"2011","Wrexham 007D","W01000416","Total",16,1,14,1,4,0,4,0,12,1,10,1
"2011","Wrexham 008A","W01000368","Total",29,14,12,3,2,0,2,0,27,14,10,3
"2011","Wrexham 008B","W01000371","Total",27,11,7,9,5,1,1,3,22,10,6,6
"2011","Wrexham 008C","W01000372","Total",31,11,7,13,2,0,1,1,29,11,6,12
"2011","Wrexham 008D","W01000387","Total",19,5,7,7,0,0,0,0,19,5,7,7
"2011","Wrexham 008E","W01000388","Total",22,10,4,8,1,0,0,1,21,10,4,7
"2011","Wrexham 008F","W01000422","Total",61,31,16,14,6,0,5,1,55,31,11,13
"2011","Wrexham 009A","W01000341","Total",58,18,15,25,6,0,4,2,52,18,11,23
"2011","Wrexham 009B","W01000342","Total",71,26,15,30,10,1,2,7,61,25,13,23
"2011","Wrexham 009C","W01000393","Total",40,14,14,12,3,1,1,1,37,13,13,11
"2011","Wrexham 010A","W01000352","Total",43,14,10,19,4,2,0,2,39,12,10,17
"2011","Wrexham 010B","W01000353","Total",72,28,11,33,5,0,1,4,67,28,10,29
"2011","Wrexham 010C","W01000413","Total",144,39,14,91,11,3,4,4,133,36,10,87
"2011","Wrexham 010D","W01000414","Total",104,20,13,71,10,1,0,9,94,19,13,62
"2011","Wrexham 010E","W01000425","Total",173,35,18,120,20,5,2,13,153,30,16,107
"2011","Wrexham 011A","W01000349","Total",50,23,21,6,8,0,8,0,42,23,13,6
"2011","Wrexham 011B","W01000350","Total",52,19,14,19,8,3,3,2,44,16,11,17
"2011","Wrexham 011C","W01000365","Total",38,18,10,10,3,1,2,0,35,17,8,10
"2011","Wrexham 011D","W01000402","Total",72,28,20,24,7,1,2,4,65,27,18,20
"2011","Wrexham 012A","W01000381","Total",22,7,5,10,4,0,3,1,18,7,2,9
"2011","Wrexham 012B","W01000382","Total",46,5,9,32,2,0,2,0,44,5,7,32
"2011","Wrexham 012D","W01000423","Total",100,34,17,49,7,0,3,4,93,34,14,45
"2011","Wrexham 012E","W01000424","Total",31,13,5,13,6,2,1,3,25,11,4,10
"2011","Wrexham 012F","W01001929","Total",55,20,15,20,8,0,8,0,47,20,7,20
"2011","Wrexham 012G","W01001931","Total",52,14,12,26,9,2,6,1,43,12,6,25
"2011","Wrexham 013A","W01000398","Total",30,11,8,11,4,1,3,0,26,10,5,11
"2011","Wrexham 013B","W01000399","Total",9,3,3,3,0,0,0,0,9,3,3,3
"2011","Wrexham 013C","W01000406","Total",97,28,15,54,11,5,3,3,86,23,12,51
"2011","Wrexham 013D","W01000408","Total",38,14,10,14,2,1,1,0,36,13,9,14
"2011","Wrexham 014A","W01000366","Total",46,18,7,21,2,0,1,1,44,18,6,20
"2011","Wrexham 014B","W01000367","Total",31,10,16,5,7,0,6,1,24,10,10,4
"2011","Wrexham 014C","W01000385","Total",41,13,19,9,4,0,4,0,37,13,15,9
"2011","Wrexham 014D","W01000410","Total",48,17,13,18,6,1,3,2,42,16,10,16
"2011","Wrexham 015A","W01000386","Total",52,15,12,25,3,1,2,0,49,14,10,25
"2011","Wrexham 015B","W01000405","Total",113,37,15,61,10,1,2,7,103,36,13,54
"2011","Wrexham 015C","W01000411","Total",81,23,10,48,7,0,1,6,74,23,9,42
"2011","Wrexham 015D","W01000412","Total",44,10,10,24,9,1,3,5,35,9,7,19
"2011","Wrexham 016A","W01000394","Total",13,7,5,1,0,0,0,0,13,7,5,1
"2011","Wrexham 016B","W01000395","Total",31,15,6,10,3,1,0,2,28,14,6,8
"2011","Wrexham 016C","W01000407","Total",25,13,12,0,3,1,2,0,22,12,10,0
"2011","Wrexham 016D","W01000419","Total",59,23,15,21,5,0,3,2,54,23,12,19
"2011","Wrexham 016E","W01000420","Total",49,18,16,15,6,0,3,3,43,18,13,12
"2011","Wrexham 017A","W01000354","Total",41,18,14,9,5,1,3,1,36,17,11,8
"2011","Wrexham 017B","W01000355","Total",54,20,10,24,9,1,5,3,45,19,5,21
"2011","Wrexham 017C","W01000356","Total",70,23,15,32,11,3,3,5,59,20,12,27
"2011","Wrexham 017D","W01000389","Total",51,16,18,17,7,0,4,3,44,16,14,14
"2011","Wrexham 017E","W01000409","Total",145,38,17,90,13,3,5,5,132,35,12,85
"2011","Wrexham 018A","W01000345","Total",28,10,11,7,3,0,2,1,25,10,9,6
"2011","Wrexham 018B","W01000346","Total",30,15,7,8,1,0,0,1,29,15,7,7
"2011","Wrexham 018C","W01000403","Total",26,9,9,8,4,1,2,1,22,8,7,7
"2011","Wrexham 018D","W01000404","Total",55,21,18,16,10,3,5,2,45,18,13,14
"2011","Wrexham 019C","W01000359","Total",31,11,6,14,3,1,0,2,28,10,6,12
"2011","Wrexham 019D","W01000360","Total",40,11,10,19,6,0,4,2,34,11,6,17
"2011","Wrexham 019E","W01000361","Total",63,14,20,29,5,0,4,1,58,14,16,28
"2011","Wrexham 019F","W01001930","Total",44,14,10,20,9,3,4,2,35,11,6,18
"2011","Wrexham 020F","W01000369","Total",23,10,10,3,2,1,1,0,21,9,9,3
"2011","Wrexham 020G","W01000370","Total",26,10,8,8,0,0,0,0,26,10,8,8
"2011","Wrexham 020A","W01000383","Total",47,17,15,15,1,0,1,0,46,17,14,15
"2011","Wrexham 020B","W01000384","Total",10,2,6,2,2,0,1,1,8,2,5,1
"2011","Wrexham 020C","W01000390","Total",25,11,8,6,7,1,5,1,18,10,3,5
"2011","Wrexham 020H","W01000396","Total",21,11,7,3,1,0,1,0,20,11,6,3
"2011","Wrexham 020I","W01000397","Total",11,7,3,1,1,1,0,0,10,6,3,1
"2011","Wrexham 020D","W01000417","Total",20,9,11,0,4,0,4,0,16,9,7,0
"2011","Wrexham 020E","W01000418","Total",31,7,11,13,2,0,2,0,29,7,9,13
"2011","Powys 001A","W01000461","Total",39,14,8,17,6,0,6,0,33,14,2,17
"2011","Powys 001D","W01000470","Total",36,21,6,9,5,1,3,1,31,20,3,8
"2011","Powys 001E","W01000475","Total",37,13,14,10,7,0,6,1,30,13,8,9
"2011","Powys 001F","W01001906","Total",29,16,7,6,3,0,1,2,26,16,6,4
"2011","Powys 001G","W01001907","Total",22,7,7,8,3,1,2,0,19,6,5,8
"2011","Powys 002A","W01000444","Total",34,11,17,6,8,1,5,2,26,10,12,4
"2011","Powys 002B","W01000457","Total",34,15,14,5,8,2,6,0,26,13,8,5
"2011","Powys 002C","W01000458","Total",31,18,7,6,5,0,3,2,26,18,4,4
"2011","Powys 003A","W01000498","Total",64,24,15,25,10,3,2,5,54,21,13,20
"2011","Powys 003B","W01000499","Total",42,13,11,18,10,3,1,6,32,10,10,12
"2011","Powys 003C","W01000500","Total",42,19,10,13,6,3,2,1,36,16,8,12
"2011","Powys 003D","W01000501","Total",50,23,15,12,2,1,0,1,48,22,15,11
"2011","Powys 004A","W01000442","Total",33,13,15,5,6,0,6,0,27,13,9,5
"2011","Powys 004B","W01000452","Total",26,6,12,8,6,2,4,0,20,4,8,8
"2011","Powys 004C","W01000473","Total",71,36,18,17,14,2,10,2,57,34,8,15
"2011","Powys 005A","W01000428","Total",27,11,14,2,8,1,6,1,19,10,8,1
"2011","Powys 005B","W01000441","Total",21,9,9,3,4,0,3,1,17,9,6,2
"2011","Powys 005C","W01000476","Total",30,12,13,5,5,0,3,2,25,12,10,3
"2011","Powys 005D","W01000497","Total",30,13,7,10,4,0,4,0,26,13,3,10
"2011","Powys 006A","W01000433","Total",49,15,16,18,2,0,1,1,47,15,15,17
"2011","Powys 006B","W01000460","Total",46,10,21,15,14,1,9,4,32,9,12,11
"2011","Powys 006C","W01000488","Total",31,15,12,4,9,5,4,0,22,10,8,4
"2011","Powys 007A","W01000434","Total",25,6,10,9,8,0,6,2,17,6,4,7
"2011","Powys 007B","W01000439","Total",31,14,11,6,8,3,5,0,23,11,6,6
"2011","Powys 007C","W01000447","Total",40,17,17,6,11,3,6,2,29,14,11,4
"2011","Powys 008A","W01000480","Total",98,38,29,31,16,3,8,5,82,35,21,26
"2011","Powys 008B","W01000481","Total",49,18,20,11,9,1,5,3,40,17,15,8
"2011","Powys 008C","W01000482","Total",51,20,17,14,6,1,4,1,45,19,13,13
"2011","Powys 009A","W01000478","Total",116,40,24,52,9,3,4,2,107,37,20,50
"2011","Powys 009B","W01000479","Total",85,36,10,39,9,0,2,7,76,36,8,32
"2011","Powys 009C","W01000483","Total",116,39,20,57,6,1,5,0,110,38,15,57
"2011","Powys 010A","W01000429","Total",40,10,19,11,7,1,5,1,33,9,14,10
"2011","Powys 010B","W01000453","Total",15,5,8,2,4,0,4,0,11,5,4,2
"2011","Powys 010C","W01000466","Total",44,19,14,11,3,2,1,0,41,17,13,11
"2011","Powys 010D","W01000467","Total",52,14,19,19,9,0,8,1,43,14,11,18
"2011","Powys 011A","W01000427","Total",26,5,6,15,4,1,2,1,22,4,4,14
"2011","Powys 011B","W01000448","Total",58,22,11,25,10,3,4,3,48,19,7,22
"2011","Powys 011C","W01000449","Total",40,12,13,15,5,0,4,1,35,12,9,14
"2011","Powys 011D","W01000464","Total",15,4,5,6,1,0,0,1,14,4,5,5
"2011","Powys 011E","W01000484","Total",29,15,7,7,4,1,3,0,25,14,4,7
"2011","Powys 011F","W01000485","Total",23,10,10,3,3,1,2,0,20,9,8,3
"2011","Powys 011G","W01000486","Total",40,17,8,15,6,2,2,2,34,15,6,13
"2011","Powys 012A","W01000438","Total",25,2,5,18,5,0,3,2,20,2,2,16
"2011","Powys 012B","W01000451","Total",17,10,6,1,4,0,4,0,13,10,2,1
"2011","Powys 012C","W01000472","Total",16,9,5,2,4,1,2,1,12,8,3,1
"2011","Powys 012D","W01000477","Total",25,11,7,7,4,1,0,3,21,10,7,4
"2011","Powys 012E","W01000487","Total",72,32,21,19,10,5,4,1,62,27,17,18
"2011","Powys 013A","W01000454","Total",42,11,14,17,9,0,4,5,33,11,10,12
"2011","Powys 013B","W01000455","Total",63,23,12,28,5,1,2,2,58,22,10,26
"2011","Powys 013C","W01000456","Total",63,14,14,35,9,0,5,4,54,14,9,31
"2011","Powys 014A","W01000431","Total",52,23,18,11,7,1,6,0,45,22,12,11
"2011","Powys 014B","W01000432","Total",28,8,12,8,4,1,3,0,24,7,9,8
"2011","Powys 014C","W01000450","Total",25,11,12,2,6,1,4,1,19,10,8,1
"2011","Powys 014D","W01000459","Total",21,7,6,8,4,0,4,0,17,7,2,8
"2011","Powys 014E","W01000471","Total",46,14,17,15,8,1,4,3,38,13,13,12
"2011","Powys 015A","W01000430","Total",30,12,7,11,7,4,1,2,23,8,6,9
"2011","Powys 015B","W01000443","Total",28,12,12,4,3,0,2,1,25,12,10,3
"2011","Powys 015C","W01000445","Total",29,11,12,6,6,2,3,1,23,9,9,5
"2011","Powys 015D","W01000446","Total",71,17,30,24,16,2,10,4,55,15,20,20
"2011","Powys 015E","W01000494","Total",48,13,20,15,8,0,7,1,40,13,13,14
"2011","Powys 017A","W01000489","Total",51,13,24,14,6,0,4,2,45,13,20,12
"2011","Powys 017D","W01000492","Total",55,14,28,13,17,4,11,2,38,10,17,11
"2011","Powys 017E","W01000493","Total",27,7,15,5,3,0,3,0,24,7,12,5
"2011","Powys 017F","W01001901","Total",51,19,17,15,6,0,6,0,45,19,11,15
"2011","Powys 017G","W01001902","Total",97,37,17,43,18,4,7,7,79,33,10,36
"2011","Powys 018E","W01000465","Total",14,2,10,2,2,0,2,0,12,2,8,2
"2011","Powys 018F","W01001903","Total",49,23,19,7,7,2,3,2,42,21,16,5
"2011","Powys 018G","W01001904","Total",40,15,17,8,10,3,7,0,30,12,10,8
"2011","Powys 018H","W01001905","Total",38,15,19,4,15,5,9,1,23,10,10,3
"2011","Powys 020A","W01000440","Total",12,3,5,4,1,1,0,0,11,2,5,4
"2011","Powys 020B","W01000474","Total",29,10,8,11,4,1,3,0,25,9,5,11
"2011","Powys 020C","W01000503","Total",14,8,5,1,3,1,1,1,11,7,4,0
"2011","Powys 020D","W01001897","Total",35,7,22,6,6,0,6,0,29,7,16,6
"2011","Powys 021A","W01000426","Total",33,16,6,11,2,0,2,0,31,16,4,11
"2011","Powys 021B","W01000496","Total",51,21,17,13,9,3,6,0,42,18,11,13
"2011","Powys 021C","W01000502","Total",50,22,13,15,10,2,6,2,40,20,7,13
"2011","Powys 021D","W01000504","Total",76,25,16,35,10,2,4,4,66,23,12,31
"2011","Powys 021E","W01000505","Total",36,14,11,11,6,0,5,1,30,14,6,10
"2011","Powys 021F","W01001899","Total",75,27,26,22,12,2,8,2,63,25,18,20
"2011","Ceredigion 001C","W01000523","Total",45,16,24,5,13,2,11,0,32,14,13,5
"2011","Ceredigion 001D","W01000548","Total",50,21,14,15,8,0,6,2,42,21,8,13
"2011","Ceredigion 001E","W01000549","Total",30,11,16,3,9,1,7,1,21,10,9,2
"2011","Ceredigion 001F","W01001937","Total",52,21,18,13,3,1,2,0,49,20,16,13
"2011","Ceredigion 002A","W01000512","Total",12,7,3,2,1,0,1,0,11,7,2,2
"2011","Ceredigion 002B","W01000513","Total",15,7,3,5,5,2,1,2,10,5,2,3
"2011","Ceredigion 002D","W01000517","Total",12,3,7,2,2,0,2,0,10,3,5,2
"2011","Ceredigion 002F","W01001934","Total",28,11,6,11,5,2,2,1,23,9,4,10
"2011","Ceredigion 003A","W01000515","Total",56,24,13,19,5,3,2,0,51,21,11,19
"2011","Ceredigion 003B","W01000516","Total",64,26,11,27,1,0,1,0,63,26,10,27
"2011","Ceredigion 003C","W01000518","Total",19,5,9,5,2,1,0,1,17,4,9,4
"2011","Ceredigion 003E","W01001935","Total",19,10,7,2,3,1,2,0,16,9,5,2
"2011","Ceredigion 003F","W01001936","Total",28,16,4,8,4,1,2,1,24,15,2,7
"2011","Ceredigion 005A","W01000506","Total",16,11,4,1,2,1,1,0,14,10,3,1
"2011","Ceredigion 005B","W01000524","Total",38,11,17,10,4,0,2,2,34,11,15,8
"2011","Ceredigion 005C","W01000538","Total",28,9,11,8,6,0,4,2,22,9,7,6
"2011","Ceredigion 005D","W01000539","Total",24,10,5,9,2,0,2,0,22,10,3,9
"2011","Ceredigion 005E","W01000540","Total",21,4,9,8,2,0,1,1,19,4,8,7
"2011","Ceredigion 007A","W01000529","Total",38,11,10,17,5,2,2,1,33,9,8,16
"2011","Ceredigion 007B","W01000532","Total",15,6,5,4,3,0,2,1,12,6,3,3
"2011","Ceredigion 007C","W01000544","Total",32,13,9,10,1,0,1,0,31,13,8,10
"2011","Ceredigion 007D","W01000545","Total",33,13,9,11,4,1,2,1,29,12,7,10
"2011","Ceredigion 008A","W01000527","Total",27,8,10,9,9,0,3,6,18,8,7,3
"2011","Ceredigion 008B","W01000528","Total",51,20,9,22,4,3,1,0,47,17,8,22
"2011","Ceredigion 008C","W01000535","Total",38,19,11,8,7,1,4,2,31,18,7,6
"2011","Ceredigion 008D","W01000537","Total",33,9,4,20,7,1,1,5,26,8,3,15
"2011","Ceredigion 008E","W01000541","Total",52,21,24,7,4,0,4,0,48,21,20,7
"2011","Ceredigion 009A","W01000507","Total",19,2,6,11,1,0,1,0,18,2,5,11
"2011","Ceredigion 009B","W01000508","Total",41,13,10,18,4,0,3,1,37,13,7,17
"2011","Ceredigion 009C","W01000509","Total",42,12,5,25,1,0,1,0,41,12,4,25
"2011","Ceredigion 009D","W01000510","Total",45,16,12,17,6,2,3,1,39,14,9,16
"2011","Ceredigion 009E","W01000511","Total",55,14,9,32,8,3,1,4,47,11,8,28
"2011","Ceredigion 009F","W01000546","Total",19,5,6,8,5,0,4,1,14,5,2,7
"2011","Ceredigion 009G","W01000547","Total",19,9,6,4,5,2,3,0,14,7,3,4
"2011","Ceredigion 010A","W01000519","Total",33,11,10,12,6,1,4,1,27,10,6,11
"2011","Ceredigion 010B","W01000522","Total",15,5,8,2,3,0,2,1,12,5,6,1
"2011","Ceredigion 010C","W01000531","Total",51,18,11,22,3,0,1,2,48,18,10,20
"2011","Ceredigion 010D","W01000533","Total",52,18,9,25,6,1,1,4,46,17,8,21
"2011","Ceredigion 010E","W01000551","Total",32,18,8,6,5,2,1,2,27,16,7,4
"2011","Ceredigion 011A","W01000525","Total",15,10,5,0,3,1,2,0,12,9,3,0
"2011","Ceredigion 011B","W01000534","Total",30,10,11,9,2,1,1,0,28,9,10,9
"2011","Ceredigion 011E","W01000536","Total",25,7,9,9,4,0,4,0,21,7,5,9
"2011","Ceredigion 011F","W01000542","Total",39,9,15,15,4,0,2,2,35,9,13,13
"2011","Ceredigion 011C","W01000543","Total",41,10,19,12,8,0,7,1,33,10,12,11
"2011","Ceredigion 011G","W01000550","Total",30,10,6,14,6,1,1,4,24,9,5,10
"2011","Ceredigion 011D","W01000552","Total",35,9,17,9,6,0,5,1,29,9,12,8
"2011","Pembrokeshire 001A","W01000558","Total",75,35,23,17,10,4,4,2,65,31,19,15
"2011","Pembrokeshire 001B","W01000559","Total",17,8,7,2,2,0,2,0,15,8,5,2
"2011","Pembrokeshire 001C","W01000560","Total",32,12,8,12,9,2,5,2,23,10,3,10
"2011","Pembrokeshire 001D","W01000561","Total",33,11,13,9,7,1,5,1,26,10,8,8
"2011","Pembrokeshire 001E","W01000613","Total",75,29,18,28,3,1,1,1,72,28,17,27
"2011","Pembrokeshire 002A","W01000562","Total",40,13,10,17,4,0,1,3,36,13,9,14
"2011","Pembrokeshire 002B","W01000565","Total",53,20,8,25,0,0,0,0,53,20,8,25
"2011","Pembrokeshire 002C","W01000566","Total",54,20,14,20,2,0,2,0,52,20,12,20
"2011","Pembrokeshire 002D","W01000567","Total",72,26,18,28,14,4,6,4,58,22,12,24
"2011","Pembrokeshire 002E","W01000597","Total",41,19,6,16,6,5,0,1,35,14,6,15
"2011","Pembrokeshire 002F","W01000617","Total",38,8,11,19,8,1,3,4,30,7,8,15
"2011","Pembrokeshire 003A","W01000579","Total",55,22,12,21,5,0,3,2,50,22,9,19
"2011","Pembrokeshire 003B","W01000581","Total",26,6,12,8,2,1,0,1,24,5,12,7
"2011","Pembrokeshire 003C","W01000612","Total",37,11,11,15,8,2,3,3,29,9,8,12
"2011","Pembrokeshire 003D","W01000618","Total",49,17,18,14,6,1,5,0,43,16,13,14
"2011","Pembrokeshire 004A","W01000582","Total",38,15,13,10,3,1,2,0,35,14,11,10
"2011","Pembrokeshire 004B","W01000583","Total",42,15,16,11,3,0,3,0,39,15,13,11
"2011","Pembrokeshire 004C","W01000611","Total",19,8,8,3,4,0,4,0,15,8,4,3
"2011","Pembrokeshire 004D","W01000623","Total",48,20,13,15,9,1,7,1,39,19,6,14
"2011","Pembrokeshire 005A","W01000568","Total",103,35,18,50,11,2,5,4,92,33,13,46
"2011","Pembrokeshire 005B","W01000569","Total",50,15,18,17,8,0,7,1,42,15,11,16
"2011","Pembrokeshire 005C","W01000570","Total",156,58,23,75,12,1,6,5,144,57,17,70
"2011","Pembrokeshire 005D","W01000572","Total",38,19,11,8,2,0,2,0,36,19,9,8
"2011","Pembrokeshire 006A","W01000571","Total",83,26,24,33,17,2,9,6,66,24,15,27
"2011","Pembrokeshire 006B","W01000573","Total",97,39,23,35,7,0,5,2,90,39,18,33
"2011","Pembrokeshire 006C","W01000586","Total",82,32,21,29,4,0,1,3,78,32,20,26
"2011","Pembrokeshire 007A","W01000577","Total",34,12,13,9,3,0,3,0,31,12,10,9
"2011","Pembrokeshire 007B","W01000585","Total",25,12,9,4,9,4,3,2,16,8,6,2
"2011","Pembrokeshire 007C","W01000595","Total",78,32,26,20,17,3,11,3,61,29,15,17
"2011","Pembrokeshire 007D","W01000596","Total",40,12,16,12,6,0,4,2,34,12,12,10
"2011","Pembrokeshire 008A","W01000555","Total",29,9,14,6,4,1,3,0,25,8,11,6
"2011","Pembrokeshire 008B","W01000556","Total",25,12,11,2,4,1,3,0,21,11,8,2
"2011","Pembrokeshire 008C","W01000575","Total",63,29,21,13,6,0,4,2,57,29,17,11
"2011","Pembrokeshire 008D","W01000614","Total",35,20,9,6,2,0,2,0,33,20,7,6
"2011","Pembrokeshire 008E","W01000622","Total",38,19,9,10,4,1,3,0,34,18,6,10
"2011","Pembrokeshire 009A","W01000554","Total",31,12,10,9,3,0,1,2,28,12,9,7
"2011","Pembrokeshire 009B","W01000580","Total",51,22,18,11,5,0,3,2,46,22,15,9
"2011","Pembrokeshire 009C","W01000598","Total",73,31,17,25,8,0,5,3,65,31,12,22
"2011","Pembrokeshire 009D","W01000599","Total",82,36,16,30,12,2,7,3,70,34,9,27
"2011","Pembrokeshire 010A","W01000587","Total",61,28,18,15,11,2,6,3,50,26,12,12
"2011","Pembrokeshire 010B","W01000588","Total",118,36,18,64,22,4,7,11,96,32,11,53
"2011","Pembrokeshire 010C","W01000593","Total",76,31,19,26,7,4,3,0,69,27,16,26
"2011","Pembrokeshire 011A","W01000553","Total",24,9,8,7,4,0,1,3,20,9,7,4
"2011","Pembrokeshire 011B","W01000563","Total",31,10,9,12,4,0,4,0,27,10,5,12
"2011","Pembrokeshire 011C","W01000564","Total",37,12,14,11,7,0,5,2,30,12,9,9
"2011","Pembrokeshire 011D","W01000576","Total",53,18,15,20,6,1,2,3,47,17,13,17
"2011","Pembrokeshire 011E","W01000615","Total",39,16,12,11,4,1,1,2,35,15,11,9
"2011","Pembrokeshire 011F","W01000616","Total",27,6,14,7,3,0,3,0,24,6,11,7
"2011","Pembrokeshire 012A","W01000589","Total",54,20,11,23,6,0,1,5,48,20,10,18
"2011","Pembrokeshire 012B","W01000590","Total",24,7,8,9,3,0,2,1,21,7,6,8
"2011","Pembrokeshire 012C","W01000591","Total",45,13,15,17,2,0,1,1,43,13,14,16
"2011","Pembrokeshire 012D","W01000592","Total",56,16,7,33,7,1,2,4,49,15,5,29
"2011","Pembrokeshire 012E","W01000594","Total",109,35,23,51,14,3,10,1,95,32,13,50
"2011","Pembrokeshire 013A","W01000600","Total",68,20,17,31,10,3,7,0,58,17,10,31
"2011","Pembrokeshire 013B","W01000601","Total",101,32,6,63,9,0,1,8,92,32,5,55
"2011","Pembrokeshire 013C","W01000602","Total",61,19,9,33,9,0,1,8,52,19,8,25
"2011","Pembrokeshire 013D","W01000603","Total",97,38,22,37,15,2,5,8,82,36,17,29
"2011","Pembrokeshire 013E","W01000604","Total",75,26,16,33,13,2,8,3,62,24,8,30
"2011","Pembrokeshire 013F","W01000605","Total",50,14,11,25,10,0,5,5,40,14,6,20
"2011","Pembrokeshire 014A","W01000557","Total",34,16,10,8,8,0,5,3,26,16,5,5
"2011","Pembrokeshire 014B","W01000578","Total",24,5,12,7,3,0,2,1,21,5,10,6
"2011","Pembrokeshire 014C","W01000584","Total",57,21,15,21,8,0,7,1,49,21,8,20
"2011","Pembrokeshire 014D","W01000609","Total",49,28,8,13,3,1,0,2,46,27,8,11
"2011","Pembrokeshire 015A","W01000574","Total",32,8,7,17,6,0,2,4,26,8,5,13
"2011","Pembrokeshire 015B","W01000606","Total",128,40,16,72,18,2,7,9,110,38,9,63
"2011","Pembrokeshire 015C","W01000607","Total",116,37,22,57,13,3,6,4,103,34,16,53
"2011","Pembrokeshire 015D","W01000608","Total",69,35,10,24,16,7,4,5,53,28,6,19
"2011","Pembrokeshire 016A","W01000610","Total",44,16,11,17,7,3,3,1,37,13,8,16
"2011","Pembrokeshire 016B","W01000619","Total",64,30,18,16,3,0,2,1,61,30,16,15
"2011","Pembrokeshire 016C","W01000620","Total",36,13,13,10,4,0,4,0,32,13,9,10
"2011","Pembrokeshire 016D","W01000621","Total",74,35,12,27,5,1,3,1,69,34,9,26
"2011","Carmarthenshire 001A","W01000685","Total",54,14,13,27,10,1,6,3,44,13,7,24
"2011","Carmarthenshire 001B","W01000686","Total",28,7,11,10,6,0,5,1,22,7,6,9
"2011","Carmarthenshire 001C","W01000701","Total",59,16,16,27,7,1,1,5,52,15,15,22
"2011","Carmarthenshire 001D","W01000702","Total",47,12,10,25,6,0,4,2,41,12,6,23
"2011","Carmarthenshire 002A","W01000647","Total",34,11,7,16,4,1,1,2,30,10,6,14
"2011","Carmarthenshire 002B","W01000650","Total",34,15,9,10,6,2,2,2,28,13,7,8
"2011","Carmarthenshire 002C","W01000678","Total",36,13,11,12,5,1,3,1,31,12,8,11
"2011","Carmarthenshire 002D","W01000679","Total",42,18,15,9,0,0,0,0,42,18,15,9
"2011","Carmarthenshire 003A","W01000646","Total",72,19,18,35,14,0,5,9,58,19,13,26
"2011","Carmarthenshire 003B","W01000688","Total",70,19,19,32,10,0,6,4,60,19,13,28
"2011","Carmarthenshire 003C","W01000689","Total",27,4,10,13,3,0,2,1,24,4,8,12
"2011","Carmarthenshire 003D","W01000728","Total",25,9,9,7,3,0,3,0,22,9,6,7
"2011","Carmarthenshire 004A","W01000676","Total",33,9,14,10,10,2,8,0,23,7,6,10
"2011","Carmarthenshire 004B","W01000677","Total",79,34,22,23,10,3,4,3,69,31,18,20
"2011","Carmarthenshire 004C","W01000687","Total",30,8,13,9,5,1,4,0,25,7,9,9
"2011","Carmarthenshire 004D","W01000709","Total",51,16,18,17,10,2,7,1,41,14,11,16
"2011","Carmarthenshire 005A","W01000624","Total",45,18,18,9,2,0,2,0,43,18,16,9
"2011","Carmarthenshire 005B","W01000682","Total",21,3,8,10,1,0,1,0,20,3,7,10
"2011","Carmarthenshire 005C","W01000683","Total",21,11,6,4,0,0,0,0,21,11,6,4
"2011","Carmarthenshire 005D","W01000684","Total",51,12,26,13,23,0,18,5,28,12,8,8
"2011","Carmarthenshire 006A","W01000643","Total",69,24,22,23,10,5,5,0,59,19,17,23
"2011","Carmarthenshire 006B","W01000644","Total",66,16,29,21,5,0,3,2,61,16,26,19
"2011","Carmarthenshire 006C","W01000645","Total",68,28,24,16,5,0,4,1,63,28,20,15
"2011","Carmarthenshire 006D","W01000648","Total",17,3,12,2,5,0,5,0,12,3,7,2
"2011","Carmarthenshire 006E","W01000649","Total",14,5,8,1,6,0,5,1,8,5,3,0
"2011","Carmarthenshire 007A","W01000637","Total",71,25,18,28,8,2,3,3,63,23,15,25
"2011","Carmarthenshire 007B","W01000638","Total",56,16,11,29,8,2,2,4,48,14,9,25
"2011","Carmarthenshire 007C","W01000639","Total",63,19,23,21,9,1,6,2,54,18,17,19
"2011","Carmarthenshire 007D","W01000640","Total",18,3,8,7,0,0,0,0,18,3,8,7
"2011","Carmarthenshire 008A","W01000641","Total",75,20,28,27,17,1,9,7,58,19,19,20
"2011","Carmarthenshire 008B","W01000642","Total",41,13,22,6,3,0,2,1,38,13,20,5
"2011","Carmarthenshire 008C","W01000693","Total",44,18,15,11,7,0,4,3,37,18,11,8
"2011","Carmarthenshire 008D","W01000694","Total",28,10,12,6,4,0,3,1,24,10,9,5
"2011","Carmarthenshire 010A","W01000656","Total",87,25,20,42,10,2,0,8,77,23,20,34
"2011","Carmarthenshire 010B","W01000657","Total",43,11,14,18,5,0,3,2,38,11,11,16
"2011","Carmarthenshire 010C","W01000658","Total",52,21,16,15,9,5,1,3,43,16,15,12
"2011","Carmarthenshire 010D","W01000718","Total",69,25,18,26,4,0,4,0,65,25,14,26
"2011","Carmarthenshire 010E","W01000719","Total",39,15,9,15,3,2,1,0,36,13,8,15
"2011","Carmarthenshire 011A","W01000680","Total",41,11,16,14,7,0,2,5,34,11,14,9
"2011","Carmarthenshire 011B","W01000681","Total",81,27,19,35,13,2,4,7,68,25,15,28
"2011","Carmarthenshire 011C","W01000724","Total",51,21,15,15,0,0,0,0,51,21,15,15
"2011","Carmarthenshire 011D","W01000725","Total",46,18,15,13,4,1,2,1,42,17,13,12
"2011","Carmarthenshire 012A","W01000675","Total",27,10,11,6,3,1,2,0,24,9,9,6
"2011","Carmarthenshire 012B","W01000695","Total",45,12,13,20,1,0,0,1,44,12,13,19
"2011","Carmarthenshire 012C","W01000696","Total",37,11,8,18,3,1,1,1,34,10,7,17
"2011","Carmarthenshire 012D","W01000722","Total",11,5,3,3,3,2,1,0,8,3,2,3
"2011","Carmarthenshire 012E","W01000723","Total",30,11,9,10,5,1,3,1,25,10,6,9
"2011","Carmarthenshire 013A","W01000625","Total",68,27,18,23,10,1,7,2,58,26,11,21
"2011","Carmarthenshire 013B","W01000626","Total",49,15,18,16,4,1,3,0,45,14,15,16
"2011","Carmarthenshire 013C","W01000627","Total",83,27,25,31,10,2,3,5,73,25,22,26
"2011","Carmarthenshire 013D","W01000714","Total",57,24,13,20,5,0,1,4,52,24,12,16
"2011","Carmarthenshire 013E","W01000715","Total",36,7,13,16,4,2,1,1,32,5,12,15
"2011","Carmarthenshire 015A","W01000697","Total",68,23,16,29,11,4,1,6,57,19,15,23
"2011","Carmarthenshire 015B","W01000698","Total",64,22,14,28,3,2,0,1,61,20,14,27
"2011","Carmarthenshire 015C","W01000699","Total",16,3,9,4,0,0,0,0,16,3,9,4
"2011","Carmarthenshire 015D","W01000712","Total",35,12,11,12,3,0,3,0,32,12,8,12
"2011","Carmarthenshire 015E","W01000713","Total",39,17,11,11,4,1,2,1,35,16,9,10
"2011","Carmarthenshire 016A","W01000662","Total",57,16,14,27,5,1,2,2,52,15,12,25
"2011","Carmarthenshire 016B","W01000663","Total",58,23,14,21,12,0,4,8,46,23,10,13
"2011","Carmarthenshire 016C","W01000664","Total",45,17,16,12,4,1,3,0,41,16,13,12
"2011","Carmarthenshire 016D","W01000716","Total",36,12,15,9,1,0,1,0,35,12,14,9
"2011","Carmarthenshire 016E","W01000717","Total",40,15,12,13,5,0,5,0,35,15,7,13
"2011","Carmarthenshire 017A","W01000665","Total",26,11,6,9,1,0,1,0,25,11,5,9
"2011","Carmarthenshire 017B","W01000666","Total",51,11,15,25,7,1,4,2,44,10,11,23
"2011","Carmarthenshire 017C","W01000731","Total",86,24,31,31,7,0,7,0,79,24,24,31
"2011","Carmarthenshire 018A","W01000670","Total",72,23,9,40,7,0,2,5,65,23,7,35
"2011","Carmarthenshire 018B","W01000671","Total",60,23,15,22,4,0,3,1,56,23,12,21
"2011","Carmarthenshire 018C","W01000729","Total",46,10,14,22,6,4,2,0,40,6,12,22
"2011","Carmarthenshire 018D","W01000730","Total",27,10,1,16,3,2,0,1,24,8,1,15
"2011","Carmarthenshire 019A","W01000690","Total",52,21,16,15,5,0,2,3,47,21,14,12
"2011","Carmarthenshire 019B","W01000691","Total",47,17,19,11,9,2,5,2,38,15,14,9
"2011","Carmarthenshire 019C","W01000692","Total",45,17,16,12,9,0,7,2,36,17,9,10
"2011","Carmarthenshire 019D","W01000726","Total",23,10,13,0,5,0,5,0,18,10,8,0
"2011","Carmarthenshire 019E","W01000727","Total",21,5,9,7,2,0,2,0,19,5,7,7
"2011","Carmarthenshire 020A","W01000651","Total",52,16,15,21,6,0,5,1,46,16,10,20
"2011","Carmarthenshire 020B","W01000652","Total",98,28,14,56,7,0,2,5,91,28,12,51
"2011","Carmarthenshire 020C","W01000655","Total",101,37,20,44,11,3,4,4,90,34,16,40
"2011","Carmarthenshire 021A","W01000632","Total",54,13,18,23,3,0,2,1,51,13,16,22
"2011","Carmarthenshire 021B","W01000633","Total",52,21,11,20,8,2,2,4,44,19,9,16
"2011","Carmarthenshire 021C","W01000634","Total",29,6,11,12,8,0,5,3,21,6,6,9
"2011","Carmarthenshire 021D","W01000710","Total",44,14,18,12,13,2,9,2,31,12,9,10
"2011","Carmarthenshire 021E","W01000711","Total",78,24,16,38,7,3,3,1,71,21,13,37
"2011","Carmarthenshire 022A","W01000703","Total",98,31,27,40,11,3,3,5,87,28,24,35
"2011","Carmarthenshire 022B","W01000704","Total",39,16,14,9,7,0,4,3,32,16,10,6
"2011","Carmarthenshire 022C","W01000705","Total",108,35,17,56,13,4,5,4,95,31,12,52
"2011","Carmarthenshire 023A","W01000653","Total",45,20,7,18,2,0,0,2,43,20,7,16
"2011","Carmarthenshire 023B","W01000654","Total",76,25,27,24,13,1,5,7,63,24,22,17
"2011","Carmarthenshire 023C","W01000667","Total",41,11,15,15,6,0,5,1,35,11,10,14
"2011","Carmarthenshire 023F","W01001925","Total",78,24,24,30,12,1,4,7,66,23,20,23
"2011","Carmarthenshire 024A","W01000628","Total",39,16,11,12,6,3,3,0,33,13,8,12
"2011","Carmarthenshire 024B","W01000629","Total",73,27,20,26,7,2,2,3,66,25,18,23
"2011","Carmarthenshire 024C","W01000630","Total",74,20,26,28,15,0,12,3,59,20,14,25
"2011","Carmarthenshire 024D","W01000631","Total",105,33,10,62,9,3,6,0,96,30,4,62
"2011","Carmarthenshire 025A","W01000635","Total",52,27,9,16,5,3,2,0,47,24,7,16
"2011","Carmarthenshire 025B","W01000636","Total",91,35,19,37,6,0,3,3,85,35,16,34
"2011","Carmarthenshire 025C","W01000706","Total",77,27,19,31,5,2,3,0,72,25,16,31
"2011","Carmarthenshire 025D","W01000707","Total",87,22,10,55,11,2,2,7,76,20,8,48
"2011","Carmarthenshire 025E","W01000708","Total",98,29,10,59,12,1,5,6,86,28,5,53
"2011","Carmarthenshire 026A","W01000659","Total",97,27,21,49,17,2,7,8,80,25,14,41
"2011","Carmarthenshire 026B","W01000660","Total",78,14,23,41,5,0,3,2,73,14,20,39
"2011","Carmarthenshire 026D","W01000732","Total",59,21,14,24,6,2,3,1,53,19,11,23
"2011","Carmarthenshire 026E","W01000733","Total",62,15,10,37,8,0,3,5,54,15,7,32
"2011","Carmarthenshire 026F","W01000734","Total",88,21,16,51,21,2,11,8,67,19,5,43
"2011","Carmarthenshire 026G","W01001923","Total",52,17,12,23,2,0,1,1,50,17,11,22
"2011","Carmarthenshire 026H","W01001924","Total",81,28,12,41,1,0,1,0,80,28,11,41
"2011","Carmarthenshire 027E","W01000672","Total",30,12,7,11,2,1,0,1,28,11,7,10
"2011","Carmarthenshire 027F","W01000673","Total",34,8,13,13,6,2,4,0,28,6,9,13
"2011","Carmarthenshire 027A","W01000674","Total",40,14,12,14,4,1,3,0,36,13,9,14
"2011","Carmarthenshire 027G","W01000700","Total",38,12,15,11,1,0,1,0,37,12,14,11
"2011","Carmarthenshire 027B","W01000720","Total",22,6,6,10,2,0,2,0,20,6,4,10
"2011","Carmarthenshire 027C","W01000721","Total",46,12,14,20,3,1,1,1,43,11,13,19
"2011","Carmarthenshire 027D","W01000735","Total",68,17,25,26,9,2,4,3,59,15,21,23
"2011","Swansea 001A","W01000845","Total",58,24,24,10,6,1,4,1,52,23,20,9
"2011","Swansea 001B","W01000846","Total",71,21,27,23,5,0,3,2,66,21,24,21
"2011","Swansea 001C","W01000847","Total",38,9,14,15,5,0,4,1,33,9,10,14
"2011","Swansea 001D","W01000848","Total",72,21,11,40,2,0,1,1,70,21,10,39
"2011","Swansea 002A","W01000750","Total",54,21,9,24,5,0,4,1,49,21,5,23
"2011","Swansea 002B","W01000751","Total",26,15,7,4,0,0,0,0,26,15,7,4
"2011","Swansea 002C","W01000752","Total",86,24,12,50,11,3,3,5,75,21,9,45
"2011","Swansea 002D","W01000753","Total",60,16,18,26,7,0,5,2,53,16,13,24
"2011","Swansea 002E","W01000754","Total",49,15,14,20,6,0,3,3,43,15,11,17
"2011","Swansea 002F","W01000803","Total",33,13,9,11,2,1,1,0,31,12,8,11
"2011","Swansea 003A","W01000806","Total",55,20,11,24,3,1,0,2,52,19,11,22
"2011","Swansea 003B","W01000807","Total",27,8,9,10,2,1,1,0,25,7,8,10
"2011","Swansea 003C","W01000808","Total",36,15,10,11,3,0,3,0,33,15,7,11
"2011","Swansea 003D","W01000810","Total",91,21,14,56,6,0,2,4,85,21,12,52
"2011","Swansea 003E","W01000815","Total",37,16,12,9,2,0,2,0,35,16,10,9
"2011","Swansea 003F","W01000816","Total",43,20,11,12,4,0,2,2,39,20,9,10
"2011","Swansea 004A","W01000791","Total",39,16,17,6,5,0,3,2,34,16,14,4
"2011","Swansea 004B","W01000792","Total",29,13,10,6,4,1,3,0,25,12,7,6
"2011","Swansea 004C","W01000793","Total",44,18,16,10,7,3,3,1,37,15,13,9
"2011","Swansea 004D","W01000837","Total",23,8,12,3,2,0,2,0,21,8,10,3
"2011","Swansea 004E","W01000838","Total",63,26,13,24,8,1,4,3,55,25,9,21
"2011","Swansea 005A","W01000773","Total",106,38,34,34,10,3,5,2,96,35,29,32
"2011","Swansea 005B","W01000774","Total",59,16,21,22,8,0,7,1,51,16,14,21
"2011","Swansea 005C","W01000841","Total",41,14,10,17,6,0,3,3,35,14,7,14
"2011","Swansea 005D","W01000842","Total",31,15,6,10,2,0,1,1,29,15,5,9
"2011","Swansea 005E","W01000843","Total",51,13,20,18,6,1,3,2,45,12,17,16
"2011","Swansea 005F","W01000844","Total",83,26,15,42,9,0,4,5,74,26,11,37
"2011","Swansea 006A","W01000795","Total",40,13,22,5,5,1,4,0,35,12,18,5
"2011","Swansea 006B","W01000796","Total",79,33,26,20,8,0,7,1,71,33,19,19
"2011","Swansea 006C","W01000800","Total",22,5,10,7,1,0,1,0,21,5,9,7
"2011","Swansea 006D","W01000801","Total",77,20,23,34,8,0,2,6,69,20,21,28
"2011","Swansea 007A","W01000784","Total",42,20,11,11,6,1,3,2,36,19,8,9
"2011","Swansea 007B","W01000785","Total",25,11,14,0,3,0,3,0,22,11,11,0
"2011","Swansea 007C","W01000786","Total",31,10,17,4,2,0,1,1,29,10,16,3
"2011","Swansea 007D","W01000802","Total",80,28,16,36,8,1,2,5,72,27,14,31
"2011","Swansea 007E","W01000877","Total",33,12,13,8,3,0,3,0,30,12,10,8
"2011","Swansea 007F","W01000878","Total",37,20,9,8,1,0,0,1,36,20,9,7
"2011","Swansea 008A","W01000809","Total",73,24,15,34,4,1,2,1,69,23,13,33
"2011","Swansea 008B","W01000811","Total",106,38,15,53,10,2,3,5,96,36,12,48
"2011","Swansea 008C","W01000812","Total",66,27,8,31,5,0,3,2,61,27,5,29
"2011","Swansea 008D","W01000813","Total",49,18,19,12,6,2,3,1,43,16,16,11
"2011","Swansea 008E","W01000814","Total",102,16,15,71,3,0,0,3,99,16,15,68
"2011","Swansea 009A","W01000817","Total",129,42,11,76,6,1,1,4,123,41,10,72
"2011","Swansea 009B","W01000818","Total",78,30,9,39,4,0,0,4,74,30,9,35
"2011","Swansea 009C","W01000819","Total",18,8,6,4,2,0,2,0,16,8,4,4
"2011","Swansea 009D","W01000820","Total",33,18,5,10,1,0,1,0,32,18,4,10
"2011","Swansea 009E","W01000821","Total",51,23,10,18,7,3,0,4,44,20,10,14
"2011","Swansea 009F","W01000822","Total",27,8,8,11,3,0,3,0,24,8,5,11
"2011","Swansea 010A","W01000794","Total",66,24,21,21,4,0,3,1,62,24,18,20
"2011","Swansea 010B","W01000797","Total",42,16,16,10,5,2,3,0,37,14,13,10
"2011","Swansea 010C","W01000798","Total",31,11,8,12,3,0,3,0,28,11,5,12
"2011","Swansea 010D","W01000799","Total",144,51,15,78,11,5,1,5,133,46,14,73
"2011","Swansea 011A","W01000830","Total",155,33,11,111,16,3,2,11,139,30,9,100
"2011","Swansea 011B","W01000832","Total",73,28,14,31,15,4,5,6,58,24,9,25
"2011","Swansea 011C","W01000833","Total",151,45,17,89,16,0,3,13,135,45,14,76
"2011","Swansea 011D","W01000834","Total",93,27,14,52,12,1,6,5,81,26,8,47
"2011","Swansea 011E","W01000836","Total",130,34,12,84,11,0,3,8,119,34,9,76
"2011","Swansea 012A","W01000759","Total",23,10,6,7,2,0,2,0,21,10,4,7
"2011","Swansea 012B","W01000777","Total",42,14,19,9,9,0,6,3,33,14,13,6
"2011","Swansea 012C","W01000778","Total",77,36,24,17,4,0,3,1,73,36,21,16
"2011","Swansea 012D","W01000779","Total",62,19,15,28,7,1,3,3,55,18,12,25
"2011","Swansea 013A","W01000760","Total",72,22,18,32,7,2,3,2,65,20,15,30
"2011","Swansea 013B","W01000761","Total",61,21,17,23,10,0,6,4,51,21,11,19
"2011","Swansea 013C","W01000762","Total",74,23,9,42,16,1,6,9,58,22,3,33
"2011","Swansea 013D","W01000831","Total",146,37,10,99,11,2,3,6,135,35,7,93
"2011","Swansea 013E","W01000835","Total",78,25,11,42,8,0,1,7,70,25,10,35
"2011","Swansea 014A","W01000738","Total",105,35,12,58,14,2,5,7,91,33,7,51
"2011","Swansea 014B","W01000739","Total",92,25,13,54,6,1,5,0,86,24,8,54
"2011","Swansea 014C","W01000740","Total",28,10,7,11,2,1,1,0,26,9,6,11
"2011","Swansea 014D","W01000741","Total",72,17,9,46,3,0,1,2,69,17,8,44
"2011","Swansea 015A","W01000763","Total",66,27,11,28,0,0,0,0,66,27,11,28
"2011","Swansea 015B","W01000764","Total",59,26,11,22,3,1,2,0,56,25,9,22
"2011","Swansea 015C","W01000765","Total",71,24,19,28,6,1,2,3,65,23,17,25
"2011","Swansea 015D","W01000766","Total",68,20,23,25,7,0,7,0,61,20,16,25
"2011","Swansea 015E","W01000767","Total",49,16,11,22,12,2,4,6,37,14,7,16
"2011","Swansea 016A","W01000742","Total",87,34,10,43,8,0,4,4,79,34,6,39
"2011","Swansea 016B","W01000744","Total",93,38,16,39,9,2,2,5,84,36,14,34
"2011","Swansea 016C","W01000787","Total",69,28,9,32,12,2,5,5,57,26,4,27
"2011","Swansea 016D","W01000788","Total",80,30,17,33,4,0,2,2,76,30,15,31
"2011","Swansea 016E","W01000789","Total",89,36,17,36,8,0,3,5,81,36,14,31
"2011","Swansea 016F","W01000790","Total",73,24,16,33,2,1,1,0,71,23,15,33
"2011","Swansea 017A","W01000755","Total",80,36,16,28,6,1,4,1,74,35,12,27
"2011","Swansea 017B","W01000756","Total",76,28,13,35,10,1,4,5,66,27,9,30
"2011","Swansea 017C","W01000757","Total",39,19,10,10,3,0,3,0,36,19,7,10
"2011","Swansea 017D","W01000758","Total",50,17,13,20,3,1,1,1,47,16,12,19
"2011","Swansea 018A","W01000772","Total",34,15,7,12,2,0,2,0,32,15,5,12
"2011","Swansea 018B","W01000828","Total",25,6,10,9,3,0,2,1,22,6,8,8
"2011","Swansea 018C","W01000829","Total",57,24,15,18,3,0,1,2,54,24,14,16
"2011","Swansea 019A","W01000862","Total",180,49,20,111,20,4,6,10,160,45,14,101
"2011","Swansea 019B","W01000863","Total",159,47,12,100,8,1,0,7,151,46,12,93
"2011","Swansea 019C","W01000864","Total",149,41,18,90,15,3,7,5,134,38,11,85
"2011","Swansea 019D","W01000865","Total",78,44,7,27,1,0,0,1,77,44,7,26
"2011","Swansea 019E","W01000866","Total",97,25,13,59,6,0,3,3,91,25,10,56
"2011","Swansea 019F","W01000867","Total",94,29,15,50,7,0,4,3,87,29,11,47
"2011","Swansea 020A","W01000768","Total",42,17,14,11,5,2,2,1,37,15,12,10
"2011","Swansea 020B","W01000769","Total",39,12,19,8,6,0,4,2,33,12,15,6
"2011","Swansea 020C","W01000770","Total",40,17,18,5,1,0,1,0,39,17,17,5
"2011","Swansea 020D","W01000771","Total",25,7,9,9,8,2,5,1,17,5,4,8
"2011","Swansea 021A","W01000849","Total",120,41,14,65,13,1,6,6,107,40,8,59
"2011","Swansea 021B","W01000850","Total",74,27,11,36,2,0,2,0,72,27,9,36
"2011","Swansea 021C","W01000851","Total",68,30,20,18,3,0,3,0,65,30,17,18
"2011","Swansea 021D","W01000852","Total",57,23,5,29,4,1,1,2,53,22,4,27
"2011","Swansea 022A","W01000853","Total",32,11,14,7,2,0,1,1,30,11,13,6
"2011","Swansea 022B","W01000854","Total",32,12,11,9,3,0,3,0,29,12,8,9
"2011","Swansea 022C","W01000855","Total",21,4,8,9,4,0,2,2,17,4,6,7
"2011","Swansea 022D","W01000856","Total",69,24,10,35,3,2,0,1,66,22,10,34
"2011","Swansea 022E","W01000857","Total",45,18,16,11,7,2,3,2,38,16,13,9
"2011","Swansea 023B","W01000781","Total",20,10,6,4,1,0,1,0,19,10,5,4
"2011","Swansea 023C","W01000782","Total",27,6,14,7,4,0,2,2,23,6,12,5
"2011","Swansea 023E","W01001956","Total",50,18,20,12,6,0,3,3,44,18,17,9
"2011","Swansea 024A","W01000747","Total",22,11,2,9,3,1,0,2,19,10,2,7
"2011","Swansea 024B","W01000868","Total",19,8,6,5,3,1,2,0,16,7,4,5
"2011","Swansea 024C","W01000869","Total",21,5,7,9,3,0,2,1,18,5,5,8
"2011","Swansea 024D","W01000870","Total",29,7,7,15,4,0,3,1,25,7,4,14
"2011","Swansea 024E","W01000872","Total",34,14,12,8,3,0,2,1,31,14,10,7
"2011","Swansea 024F","W01000874","Total",19,3,8,8,3,0,3,0,16,3,5,8
"2011","Swansea 025B","W01000745","Total",35,14,4,17,7,0,2,5,28,14,2,12
"2011","Swansea 025C","W01000746","Total",44,14,11,19,5,0,3,2,39,14,8,17
"2011","Swansea 025E","W01001938","Total",6,3,2,1,3,1,1,1,3,2,1,0
"2011","Swansea 025F","W01001955","Total",10,3,3,4,2,1,1,0,8,2,2,4
"2011","Swansea 025G","W01001957","Total",20,5,7,8,2,0,2,0,18,5,5,8
"2011","Swansea 025H","W01001958","Total",12,3,4,5,1,0,0,1,11,3,4,4
"2011","Swansea 026A","W01000749","Total",39,15,7,17,1,0,1,0,38,15,6,17
"2011","Swansea 026B","W01000871","Total",21,6,5,10,2,0,1,1,19,6,4,9
"2011","Swansea 026C","W01000873","Total",13,5,5,3,3,0,3,0,10,5,2,3
"2011","Swansea 026D","W01000875","Total",9,5,2,2,1,0,1,0,8,5,1,2
"2011","Swansea 026E","W01000876","Total",21,8,9,4,2,0,2,0,19,8,7,4
"2011","Swansea 027A","W01000858","Total",26,12,13,1,2,0,2,0,24,12,11,1
"2011","Swansea 027B","W01000859","Total",9,4,2,3,0,0,0,0,9,4,2,3
"2011","Swansea 027C","W01000860","Total",17,5,8,4,2,0,1,1,15,5,7,3
"2011","Swansea 027D","W01000861","Total",8,4,3,1,1,0,1,0,7,4,2,1
"2011","Swansea 028A","W01000736","Total",28,15,10,3,2,0,2,0,26,15,8,3
"2011","Swansea 028B","W01000737","Total",28,7,18,3,5,0,5,0,23,7,13,3
"2011","Swansea 028C","W01000804","Total",20,7,4,9,0,0,0,0,20,7,4,9
"2011","Swansea 028D","W01000805","Total",15,7,5,3,0,0,0,0,15,7,5,3
"2011","Swansea 029A","W01000879","Total",28,13,9,6,6,1,3,2,22,12,6,4
"2011","Swansea 029B","W01000880","Total",25,7,10,8,1,0,1,0,24,7,9,8
"2011","Swansea 029C","W01000881","Total",47,12,9,26,5,0,1,4,42,12,8,22
"2011","Swansea 029D","W01000882","Total",104,32,25,47,12,5,2,5,92,27,23,42
"2011","Swansea 030A","W01000775","Total",41,17,20,4,6,1,5,0,35,16,15,4
"2011","Swansea 030B","W01000776","Total",21,7,10,4,3,0,3,0,18,7,7,4
"2011","Swansea 030C","W01000839","Total",20,6,11,3,3,0,3,0,17,6,8,3
"2011","Swansea 030D","W01000840","Total",21,8,8,5,5,0,4,1,16,8,4,4
"2011","Swansea 031A","W01000823","Total",19,6,12,1,3,0,3,0,16,6,9,1
"2011","Swansea 031B","W01000824","Total",29,14,8,7,0,0,0,0,29,14,8,7
"2011","Swansea 031C","W01000825","Total",33,14,9,10,1,0,1,0,32,14,8,10
"2011","Swansea 031D","W01000826","Total",20,9,7,4,2,1,1,0,18,8,6,4
"2011","Swansea 031E","W01000827","Total",27,7,13,7,2,0,1,1,25,7,12,6
"2011","Neath Port Talbot 002A","W01000918","Total",51,18,12,21,8,1,5,2,43,17,7,19
"2011","Neath Port Talbot 002B","W01000944","Total",33,14,4,15,1,0,1,0,32,14,3,15
"2011","Neath Port Talbot 002C","W01000965","Total",67,24,12,31,3,0,2,1,64,24,10,30
"2011","Neath Port Talbot 003A","W01000893","Total",67,15,18,34,8,1,4,3,59,14,14,31
"2011","Neath Port Talbot 003B","W01000925","Total",66,20,9,37,14,1,2,11,52,19,7,26
"2011","Neath Port Talbot 003C","W01000926","Total",62,20,16,26,5,1,2,2,57,19,14,24
"2011","Neath Port Talbot 004A","W01000888","Total",64,20,13,31,4,0,0,4,60,20,13,27
"2011","Neath Port Talbot 004B","W01000946","Total",42,13,9,20,5,0,2,3,37,13,7,17
"2011","Neath Port Talbot 004C","W01000947","Total",107,33,15,59,7,0,0,7,100,33,15,52
"2011","Neath Port Talbot 004D","W01000948","Total",39,13,14,12,4,0,2,2,35,13,12,10
"2011","Neath Port Talbot 004E","W01000955","Total",28,13,4,11,1,1,0,0,27,12,4,11
"2011","Neath Port Talbot 004F","W01000956","Total",15,5,8,2,1,0,1,0,14,5,7,2
"2011","Neath Port Talbot 004G","W01000971","Total",61,16,17,28,7,3,2,2,54,13,15,26
"2011","Neath Port Talbot 005A","W01000887","Total",82,34,13,35,5,1,3,1,77,33,10,34
"2011","Neath Port Talbot 005B","W01000953","Total",41,11,7,23,5,1,1,3,36,10,6,20
"2011","Neath Port Talbot 005C","W01000954","Total",38,14,9,15,5,1,2,2,33,13,7,13
"2011","Neath Port Talbot 005D","W01000970","Total",30,4,16,10,4,1,2,1,26,3,14,9
"2011","Neath Port Talbot 006A","W01000902","Total",18,10,3,5,3,0,2,1,15,10,1,4
"2011","Neath Port Talbot 006B","W01000903","Total",7,2,4,1,2,0,2,0,5,2,2,1
"2011","Neath Port Talbot 006C","W01000904","Total",41,16,18,7,4,2,2,0,37,14,16,7
"2011","Neath Port Talbot 006D","W01000905","Total",65,24,16,25,2,0,2,0,63,24,14,25
"2011","Neath Port Talbot 006E","W01000908","Total",24,5,12,7,8,0,6,2,16,5,6,5
"2011","Neath Port Talbot 007A","W01000906","Total",19,5,7,7,3,1,0,2,16,4,7,5
"2011","Neath Port Talbot 007B","W01000907","Total",88,25,26,37,12,2,7,3,76,23,19,34
"2011","Neath Port Talbot 007C","W01000922","Total",65,31,12,22,5,2,2,1,60,29,10,21
"2011","Neath Port Talbot 007D","W01000923","Total",40,15,12,13,7,2,5,0,33,13,7,13
"2011","Neath Port Talbot 008A","W01000934","Total",52,16,6,30,2,0,0,2,50,16,6,28
"2011","Neath Port Talbot 008B","W01000935","Total",55,15,9,31,7,0,1,6,48,15,8,25
"2011","Neath Port Talbot 008C","W01000938","Total",18,6,10,2,1,0,0,1,17,6,10,1
"2011","Neath Port Talbot 008D","W01000939","Total",37,2,15,20,8,0,5,3,29,2,10,17
"2011","Neath Port Talbot 008E","W01000940","Total",69,25,12,32,2,1,1,0,67,24,11,32
"2011","Neath Port Talbot 009A","W01000909","Total",27,10,6,11,1,0,1,0,26,10,5,11
"2011","Neath Port Talbot 009B","W01000910","Total",21,10,7,4,1,0,0,1,20,10,7,3
"2011","Neath Port Talbot 009C","W01000911","Total",25,9,11,5,1,0,1,0,24,9,10,5
"2011","Neath Port Talbot 009D","W01000969","Total",19,12,5,2,0,0,0,0,19,12,5,2
"2011","Neath Port Talbot 010A","W01000912","Total",40,17,15,8,5,0,3,2,35,17,12,6
"2011","Neath Port Talbot 010B","W01000913","Total",26,10,6,10,1,0,0,1,25,10,6,9
"2011","Neath Port Talbot 010C","W01000914","Total",63,14,6,43,8,1,0,7,55,13,6,36
"2011","Neath Port Talbot 010D","W01000915","Total",42,18,11,13,1,0,1,0,41,18,10,13
"2011","Neath Port Talbot 010E","W01000916","Total",27,6,11,10,1,0,0,1,26,6,11,9
"2011","Neath Port Talbot 010F","W01000917","Total",57,13,23,21,6,0,2,4,51,13,21,17
"2011","Neath Port Talbot 011A","W01000920","Total",36,8,9,19,0,0,0,0,36,8,9,19
"2011","Neath Port Talbot 011B","W01000921","Total",81,24,4,53,10,1,2,7,71,23,2,46
"2011","Neath Port Talbot 011C","W01000924","Total",44,9,8,27,6,0,2,4,38,9,6,23
"2011","Neath Port Talbot 011D","W01000930","Total",72,20,11,41,9,1,4,4,63,19,7,37
"2011","Neath Port Talbot 012A","W01000936","Total",77,24,14,39,6,0,2,4,71,24,12,35
"2011","Neath Port Talbot 012B","W01000941","Total",66,17,9,40,10,2,3,5,56,15,6,35
"2011","Neath Port Talbot 012C","W01000942","Total",103,31,24,48,13,1,4,8,90,30,20,40
"2011","Neath Port Talbot 012D","W01000943","Total",26,7,8,11,1,0,0,1,25,7,8,10
"2011","Neath Port Talbot 013A","W01000894","Total",41,11,13,17,5,1,4,0,36,10,9,17
"2011","Neath Port Talbot 013B","W01000895","Total",56,19,12,25,10,2,3,5,46,17,9,20
"2011","Neath Port Talbot 013C","W01000896","Total",106,25,19,62,10,2,5,3,96,23,14,59
"2011","Neath Port Talbot 013D","W01000897","Total",39,14,8,17,1,1,0,0,38,13,8,17
"2011","Neath Port Talbot 013E","W01000937","Total",65,25,16,24,10,1,5,4,55,24,11,20
"2011","Neath Port Talbot 014A","W01000898","Total",43,15,13,15,1,0,0,1,42,15,13,14
"2011","Neath Port Talbot 014B","W01000899","Total",39,15,12,12,2,0,2,0,37,15,10,12
"2011","Neath Port Talbot 014C","W01000900","Total",79,26,15,38,8,0,5,3,71,26,10,35
"2011","Neath Port Talbot 014D","W01000901","Total",73,21,11,41,4,0,1,3,69,21,10,38
"2011","Neath Port Talbot 014E","W01000945","Total",25,11,6,8,0,0,0,0,25,11,6,8
"2011","Neath Port Talbot 015A","W01000889","Total",28,11,7,10,3,1,1,1,25,10,6,9
"2011","Neath Port Talbot 015B","W01000890","Total",24,7,12,5,3,0,3,0,21,7,9,5
"2011","Neath Port Talbot 015C","W01000891","Total",68,33,12,23,5,0,4,1,63,33,8,22
"2011","Neath Port Talbot 015D","W01000892","Total",33,14,11,8,2,1,1,0,31,13,10,8
"2011","Neath Port Talbot 016A","W01000883","Total",23,12,8,3,1,0,1,0,22,12,7,3
"2011","Neath Port Talbot 016B","W01000958","Total",93,23,4,66,11,2,0,9,82,21,4,57
"2011","Neath Port Talbot 016C","W01000961","Total",71,22,22,27,4,0,3,1,67,22,19,26
"2011","Neath Port Talbot 016D","W01000962","Total",94,27,5,62,4,0,0,4,90,27,5,58
"2011","Neath Port Talbot 016E","W01000963","Total",77,25,14,38,6,0,3,3,71,25,11,35
"2011","Neath Port Talbot 016F","W01000964","Total",90,27,13,50,9,0,2,7,81,27,11,43
"2011","Neath Port Talbot 017A","W01000884","Total",57,12,9,36,3,0,2,1,54,12,7,35
"2011","Neath Port Talbot 017B","W01000885","Total",53,11,7,35,3,1,0,2,50,10,7,33
"2011","Neath Port Talbot 017C","W01000886","Total",62,15,8,39,6,0,2,4,56,15,6,35
"2011","Neath Port Talbot 017D","W01000957","Total",71,17,7,47,5,0,2,3,66,17,5,44
"2011","Neath Port Talbot 017E","W01000959","Total",46,14,14,18,6,0,5,1,40,14,9,17
"2011","Neath Port Talbot 017F","W01000960","Total",70,22,10,38,8,2,2,4,62,20,8,34
"2011","Neath Port Talbot 018A","W01000949","Total",29,13,9,7,1,0,0,1,28,13,9,6
"2011","Neath Port Talbot 018B","W01000950","Total",50,6,8,36,6,1,1,4,44,5,7,32
"2011","Neath Port Talbot 018C","W01000951","Total",35,14,9,12,2,0,2,0,33,14,7,12
"2011","Neath Port Talbot 018D","W01000952","Total",21,11,4,6,1,0,1,0,20,11,3,6
"2011","Neath Port Talbot 018E","W01000966","Total",41,12,8,21,6,1,3,2,35,11,5,19
"2011","Neath Port Talbot 019A","W01000932","Total",29,12,8,9,4,0,3,1,25,12,5,8
"2011","Neath Port Talbot 019B","W01000933","Total",38,13,15,10,6,0,5,1,32,13,10,9
"2011","Neath Port Talbot 019C","W01000967","Total",69,20,12,37,4,1,1,2,65,19,11,35
"2011","Neath Port Talbot 019D","W01000968","Total",78,31,16,31,7,1,3,3,71,30,13,28
"2011","Neath Port Talbot 020A","W01000919","Total",23,6,6,11,3,0,3,0,20,6,3,11
"2011","Neath Port Talbot 020B","W01000927","Total",55,14,13,28,2,0,0,2,53,14,13,26
"2011","Neath Port Talbot 020C","W01000928","Total",45,11,16,18,5,1,3,1,40,10,13,17
"2011","Neath Port Talbot 020D","W01000929","Total",57,17,14,26,11,3,3,5,46,14,11,21
"2011","Neath Port Talbot 020E","W01000931","Total",34,13,9,12,6,1,2,3,28,12,7,9
"2011","Neath Port Talbot 020F","W01000973","Total",52,18,13,21,3,1,2,0,49,17,11,21
"2011","Neath Port Talbot 020G","W01001900","Total",65,22,12,31,9,3,2,4,56,19,10,27
"2011","Bridgend 001A","W01000991","Total",66,17,6,43,6,0,5,1,60,17,1,42
"2011","Bridgend 001B","W01000992","Total",72,21,4,47,7,0,1,6,65,21,3,41
"2011","Bridgend 001C","W01000993","Total",73,15,14,44,4,0,2,2,69,15,12,42
"2011","Bridgend 001D","W01000994","Total",69,21,16,32,8,0,1,7,61,21,15,25
"2011","Bridgend 001E","W01000995","Total",54,21,7,26,3,1,0,2,51,20,7,24
"2011","Bridgend 002A","W01001014","Total",56,17,15,24,3,1,1,1,53,16,14,23
"2011","Bridgend 002B","W01001015","Total",62,20,11,31,9,2,3,4,53,18,8,27
"2011","Bridgend 002C","W01001017","Total",38,14,13,11,2,0,1,1,36,14,12,10
"2011","Bridgend 002D","W01001018","Total",55,14,10,31,6,0,3,3,49,14,7,28
"2011","Bridgend 002E","W01001020","Total",68,31,10,27,6,0,2,4,62,31,8,23
"2011","Bridgend 003A","W01000976","Total",52,21,5,26,3,0,2,1,49,21,3,25
"2011","Bridgend 003B","W01000977","Total",32,8,6,18,4,0,1,3,28,8,5,15
"2011","Bridgend 003C","W01001024","Total",39,8,11,20,5,0,2,3,34,8,9,17
"2011","Bridgend 003D","W01001025","Total",40,17,8,15,3,0,3,0,37,17,5,15
"2011","Bridgend 003E","W01001033","Total",58,26,9,23,5,1,2,2,53,25,7,21
"2011","Bridgend 003F","W01001034","Total",44,17,5,22,2,0,1,1,42,17,4,21
"2011","Bridgend 004A","W01000975","Total",111,31,10,70,8,3,1,4,103,28,9,66
"2011","Bridgend 004B","W01000978","Total",60,28,8,24,5,1,2,2,55,27,6,22
"2011","Bridgend 004C","W01001009","Total",33,10,8,15,4,0,2,2,29,10,6,13
"2011","Bridgend 004D","W01001042","Total",61,21,11,29,7,1,1,5,54,20,10,24
"2011","Bridgend 004E","W01001043","Total",35,9,9,17,6,3,1,2,29,6,8,15
"2011","Bridgend 005A","W01001012","Total",27,11,9,7,5,2,2,1,22,9,7,6
"2011","Bridgend 005B","W01001013","Total",39,17,6,16,4,0,2,2,35,17,4,14
"2011","Bridgend 005C","W01001016","Total",41,20,8,13,4,0,2,2,37,20,6,11
"2011","Bridgend 005D","W01001019","Total",55,15,11,29,6,0,5,1,49,15,6,28
"2011","Bridgend 006A","W01000974","Total",71,28,22,21,4,1,1,2,67,27,21,19
"2011","Bridgend 006B","W01001057","Total",58,17,5,36,5,0,3,2,53,17,2,34
"2011","Bridgend 006C","W01001058","Total",59,20,17,22,2,0,2,0,57,20,15,22
"2011","Bridgend 007A","W01000986","Total",50,16,23,11,2,0,1,1,48,16,22,10
"2011","Bridgend 007B","W01000987","Total",111,42,11,58,6,0,0,6,105,42,11,52
"2011","Bridgend 007C","W01001055","Total",47,13,7,27,1,0,0,1,46,13,7,26
"2011","Bridgend 007D","W01001056","Total",20,4,5,11,0,0,0,0,20,4,5,11
"2011","Bridgend 008A","W01000996","Total",43,19,9,15,3,0,3,0,40,19,6,15
"2011","Bridgend 008B","W01001048","Total",39,16,7,16,3,0,2,1,36,16,5,15
"2011","Bridgend 008C","W01001049","Total",62,14,9,39,3,0,2,1,59,14,7,38
"2011","Bridgend 008D","W01001050","Total",64,26,10,28,0,0,0,0,64,26,10,28
"2011","Bridgend 008E","W01001051","Total",99,31,24,44,8,2,3,3,91,29,21,41
"2011","Bridgend 008F","W01001052","Total",47,15,11,21,6,0,3,3,41,15,8,18
"2011","Bridgend 009A","W01001004","Total",21,9,3,9,1,0,0,1,20,9,3,8
"2011","Bridgend 009B","W01001005","Total",42,19,15,8,1,0,1,0,41,19,14,8
"2011","Bridgend 009C","W01001006","Total",46,16,21,9,5,0,5,0,41,16,16,9
"2011","Bridgend 009D","W01001007","Total",65,19,15,31,4,0,2,2,61,19,13,29
"2011","Bridgend 009E","W01001039","Total",32,12,9,11,1,0,1,0,31,12,8,11
"2011","Bridgend 009F","W01001040","Total",27,12,8,7,3,0,3,0,24,12,5,7
"2011","Bridgend 010A","W01000999","Total",68,18,16,34,8,0,2,6,60,18,14,28
"2011","Bridgend 010B","W01001000","Total",53,20,11,22,6,3,0,3,47,17,11,19
"2011","Bridgend 010C","W01001001","Total",54,18,8,28,4,0,1,3,50,18,7,25
"2011","Bridgend 010D","W01001002","Total",154,35,14,105,7,1,3,3,147,34,11,102
"2011","Bridgend 011A","W01000998","Total",29,12,7,10,2,1,1,0,27,11,6,10
"2011","Bridgend 011B","W01001008","Total",37,10,17,10,4,1,1,2,33,9,16,8
"2011","Bridgend 011C","W01001038","Total",63,25,11,27,4,1,1,2,59,24,10,25
"2011","Bridgend 012A","W01000997","Total",31,12,6,13,1,1,0,0,30,11,6,13
"2011","Bridgend 012B","W01001010","Total",59,25,14,20,0,0,0,0,59,25,14,20
"2011","Bridgend 012C","W01001011","Total",44,20,11,13,5,1,3,1,39,19,8,12
"2011","Bridgend 012D","W01001026","Total",73,20,13,40,6,3,1,2,67,17,12,38
"2011","Bridgend 013A","W01000989","Total",21,5,13,3,4,0,4,0,17,5,9,3
"2011","Bridgend 013B","W01001037","Total",28,7,9,12,3,1,2,0,25,6,7,12
"2011","Bridgend 013C","W01001041","Total",55,19,22,14,6,0,4,2,49,19,18,12
"2011","Bridgend 014A","W01001021","Total",34,9,14,11,4,0,3,1,30,9,11,10
"2011","Bridgend 014B","W01001022","Total",73,16,8,49,16,0,2,14,57,16,6,35
"2011","Bridgend 014C","W01001023","Total",53,13,7,33,7,2,2,3,46,11,5,30
"2011","Bridgend 014D","W01001028","Total",38,10,14,14,5,1,3,1,33,9,11,13
"2011","Bridgend 014E","W01001035","Total",68,22,12,34,8,1,3,4,60,21,9,30
"2011","Bridgend 015A","W01000979","Total",86,23,30,33,14,2,5,7,72,21,25,26
"2011","Bridgend 015B","W01000983","Total",53,20,17,16,3,2,1,0,50,18,16,16
"2011","Bridgend 015C","W01000985","Total",24,6,11,7,1,0,0,1,23,6,11,6
"2011","Bridgend 015D","W01001003","Total",13,6,5,2,3,0,2,1,10,6,3,1
"2011","Bridgend 016A","W01000980","Total",55,14,15,26,4,0,2,2,51,14,13,24
"2011","Bridgend 016B","W01000981","Total",106,35,10,61,5,0,1,4,101,35,9,57
"2011","Bridgend 016C","W01000982","Total",42,14,11,17,5,1,4,0,37,13,7,17
"2011","Bridgend 016D","W01000984","Total",84,32,19,33,6,1,2,3,78,31,17,30
"2011","Bridgend 017B","W01000990","Total",58,17,19,22,6,0,5,1,52,17,14,21
"2011","Bridgend 017C","W01001027","Total",33,9,12,12,2,0,1,1,31,9,11,11
"2011","Bridgend 017D","W01001036","Total",25,13,9,3,2,1,0,1,23,12,9,2
"2011","Bridgend 017E","W01001918","Total",33,14,10,9,3,1,2,0,30,13,8,9
"2011","Bridgend 017F","W01001919","Total",39,13,15,11,1,1,0,0,38,12,15,11
"2011","Bridgend 017G","W01001920","Total",27,10,14,3,2,0,2,0,25,10,12,3
"2011","Bridgend 017H","W01001921","Total",70,30,21,19,1,0,1,0,69,30,20,19
"2011","Bridgend 018A","W01001031","Total",16,8,6,2,1,1,0,0,15,7,6,2
"2011","Bridgend 018B","W01001032","Total",41,11,21,9,3,0,3,0,38,11,18,9
"2011","Bridgend 018C","W01001046","Total",79,34,19,26,8,1,4,3,71,33,15,23
"2011","Bridgend 018D","W01001047","Total",33,10,11,12,4,0,3,1,29,10,8,11
"2011","Bridgend 018E","W01001053","Total",11,2,6,3,1,0,0,1,10,2,6,2
"2011","Bridgend 018F","W01001054","Total",11,3,6,2,0,0,0,0,11,3,6,2
"2011","Bridgend 019A","W01001029","Total",22,10,9,3,4,0,4,0,18,10,5,3
"2011","Bridgend 019B","W01001030","Total",32,12,10,10,1,0,0,1,31,12,10,9
"2011","Bridgend 019C","W01001044","Total",58,15,12,31,8,2,5,1,50,13,7,30
"2011","Bridgend 019D","W01001045","Total",59,20,17,22,9,0,4,5,50,20,13,17
"2011","The Vale of Glamorgan 001A","W01001105","Total",41,8,19,14,9,2,5,2,32,6,14,12
"2011","The Vale of Glamorgan 001B","W01001127","Total",21,3,10,8,8,1,5,2,13,2,5,6
"2011","The Vale of Glamorgan 001C","W01001128","Total",23,13,7,3,1,0,1,0,22,13,6,3
"2011","The Vale of Glamorgan 002A","W01001082","Total",29,14,7,8,0,0,0,0,29,14,7,8
"2011","The Vale of Glamorgan 002B","W01001083","Total",6,3,2,1,0,0,0,0,6,3,2,1
"2011","The Vale of Glamorgan 002C","W01001084","Total",27,7,10,10,2,0,2,0,25,7,8,10
"2011","The Vale of Glamorgan 002D","W01001085","Total",11,5,3,3,3,0,2,1,8,5,1,2
"2011","The Vale of Glamorgan 003A","W01001113","Total",32,14,10,8,1,0,1,0,31,14,9,8
"2011","The Vale of Glamorgan 003B","W01001119","Total",28,3,19,6,5,0,4,1,23,3,15,5
"2011","The Vale of Glamorgan 003C","W01001135","Total",19,9,9,1,3,0,3,0,16,9,6,1
"2011","The Vale of Glamorgan 003D","W01001136","Total",9,5,0,4,0,0,0,0,9,5,0,4
"2011","The Vale of Glamorgan 004A","W01001075","Total",26,9,12,5,2,0,2,0,24,9,10,5
"2011","The Vale of Glamorgan 004B","W01001076","Total",73,29,16,28,5,0,2,3,68,29,14,25
"2011","The Vale of Glamorgan 004C","W01001077","Total",34,14,8,12,6,1,2,3,28,13,6,9
"2011","The Vale of Glamorgan 004D","W01001078","Total",36,21,9,6,2,1,0,1,34,20,9,5
"2011","The Vale of Glamorgan 004E","W01001104","Total",50,19,19,12,6,0,5,1,44,19,14,11
"2011","The Vale of Glamorgan 004F","W01001129","Total",50,19,18,13,5,1,4,0,45,18,14,13
"2011","The Vale of Glamorgan 005A","W01001116","Total",23,13,9,1,6,1,5,0,17,12,4,1
"2011","The Vale of Glamorgan 005B","W01001123","Total",41,21,15,5,7,3,4,0,34,18,11,5
"2011","The Vale of Glamorgan 005C","W01001124","Total",37,16,12,9,2,0,1,1,35,16,11,8
"2011","The Vale of Glamorgan 005D","W01001125","Total",42,22,10,10,3,0,2,1,39,22,8,9
"2011","The Vale of Glamorgan 005E","W01001126","Total",51,20,18,13,7,1,5,1,44,19,13,12
"2011","The Vale of Glamorgan 005F","W01001130","Total",30,12,12,6,1,1,0,0,29,11,12,6
"2011","The Vale of Glamorgan 006A","W01001086","Total",22,10,8,4,7,0,6,1,15,10,2,3
"2011","The Vale of Glamorgan 006B","W01001087","Total",38,17,8,13,3,0,2,1,35,17,6,12
"2011","The Vale of Glamorgan 006C","W01001088","Total",76,26,19,31,4,1,2,1,72,25,17,30
"2011","The Vale of Glamorgan 006D","W01001089","Total",29,12,8,9,2,0,1,1,27,12,7,8
"2011","The Vale of Glamorgan 006E","W01001090","Total",34,13,15,6,9,3,6,0,25,10,9,6
"2011","The Vale of Glamorgan 007A","W01001081","Total",96,34,15,47,8,2,2,4,88,32,13,43
"2011","The Vale of Glamorgan 007B","W01001092","Total",81,39,15,27,4,1,3,0,77,38,12,27
"2011","The Vale of Glamorgan 007C","W01001094","Total",102,39,14,49,9,3,3,3,93,36,11,46
"2011","The Vale of Glamorgan 007D","W01001095","Total",130,40,17,73,8,1,4,3,122,39,13,70
"2011","The Vale of Glamorgan 007E","W01001096","Total",47,12,15,20,5,0,3,2,42,12,12,18
"2011","The Vale of Glamorgan 007F","W01001097","Total",102,42,10,50,8,1,1,6,94,41,9,44
"2011","The Vale of Glamorgan 008A","W01001114","Total",17,5,7,5,3,0,2,1,14,5,5,4
"2011","The Vale of Glamorgan 008B","W01001115","Total",58,23,24,11,8,0,6,2,50,23,18,9
"2011","The Vale of Glamorgan 008C","W01001131","Total",63,21,12,30,2,0,1,1,61,21,11,29
"2011","The Vale of Glamorgan 008D","W01001132","Total",39,16,15,8,4,1,2,1,35,15,13,7
"2011","The Vale of Glamorgan 008E","W01001133","Total",27,13,10,4,6,1,3,2,21,12,7,2
"2011","The Vale of Glamorgan 008F","W01001134","Total",21,5,12,4,3,0,3,0,18,5,9,4
"2011","The Vale of Glamorgan 009A","W01001067","Total",55,12,14,29,2,0,0,2,53,12,14,27
"2011","The Vale of Glamorgan 009B","W01001068","Total",84,39,16,29,5,3,1,1,79,36,15,28
"2011","The Vale of Glamorgan 009C","W01001070","Total",50,16,6,28,6,0,1,5,44,16,5,23
"2011","The Vale of Glamorgan 009D","W01001071","Total",75,26,19,30,9,4,1,4,66,22,18,26
"2011","The Vale of Glamorgan 009E","W01001072","Total",79,33,29,17,7,1,5,1,72,32,24,16
"2011","The Vale of Glamorgan 010A","W01001091","Total",37,19,11,7,6,0,4,2,31,19,7,5
"2011","The Vale of Glamorgan 010B","W01001098","Total",28,13,8,7,6,2,3,1,22,11,5,6
"2011","The Vale of Glamorgan 010C","W01001100","Total",20,8,10,2,2,0,2,0,18,8,8,2
"2011","The Vale of Glamorgan 010D","W01001103","Total",32,15,9,8,7,0,6,1,25,15,3,7
"2011","The Vale of Glamorgan 011A","W01001106","Total",24,6,12,6,1,0,1,0,23,6,11,6
"2011","The Vale of Glamorgan 011B","W01001107","Total",24,10,8,6,2,0,1,1,22,10,7,5
"2011","The Vale of Glamorgan 011C","W01001109","Total",34,12,13,9,9,1,6,2,25,11,7,7
"2011","The Vale of Glamorgan 011D","W01001110","Total",26,4,14,8,6,0,5,1,20,4,9,7
"2011","The Vale of Glamorgan 011E","W01001111","Total",65,21,18,26,5,1,2,2,60,20,16,24
"2011","The Vale of Glamorgan 011F","W01001112","Total",57,26,22,9,7,1,6,0,50,25,16,9
"2011","The Vale of Glamorgan 012A","W01001063","Total",79,37,10,32,3,3,0,0,76,34,10,32
"2011","The Vale of Glamorgan 012B","W01001065","Total",73,24,14,35,5,0,2,3,68,24,12,32
"2011","The Vale of Glamorgan 012C","W01001069","Total",87,27,12,48,13,1,1,11,74,26,11,37
"2011","The Vale of Glamorgan 012E","W01001079","Total",100,34,11,55,4,2,0,2,96,32,11,53
"2011","The Vale of Glamorgan 012F","W01001080","Total",79,30,13,36,8,3,2,3,71,27,11,33
"2011","The Vale of Glamorgan 012G","W01001910","Total",95,36,16,43,7,2,4,1,88,34,12,42
"2011","The Vale of Glamorgan 012H","W01001911","Total",72,29,16,27,11,5,6,0,61,24,10,27
"2011","The Vale of Glamorgan 013A","W01001062","Total",37,10,20,7,5,0,4,1,32,10,16,6
"2011","The Vale of Glamorgan 013B","W01001064","Total",92,33,18,41,11,3,4,4,81,30,14,37
"2011","The Vale of Glamorgan 013C","W01001093","Total",82,21,16,45,5,1,3,1,77,20,13,44
"2011","The Vale of Glamorgan 013D","W01001099","Total",54,20,10,24,7,0,3,4,47,20,7,20
"2011","The Vale of Glamorgan 013E","W01001101","Total",71,24,18,29,5,1,4,0,66,23,14,29
"2011","The Vale of Glamorgan 013F","W01001102","Total",71,30,22,19,11,1,10,0,60,29,12,19
"2011","The Vale of Glamorgan 014A","W01001108","Total",47,21,13,13,3,2,1,0,44,19,12,13
"2011","The Vale of Glamorgan 014B","W01001117","Total",35,11,13,11,1,0,1,0,34,11,12,11
"2011","The Vale of Glamorgan 014C","W01001118","Total",55,25,15,15,5,0,5,0,50,25,10,15
"2011","The Vale of Glamorgan 014D","W01001120","Total",38,15,15,8,2,0,1,1,36,15,14,7
"2011","The Vale of Glamorgan 014E","W01001121","Total",35,15,6,14,3,0,1,2,32,15,5,12
"2011","The Vale of Glamorgan 014F","W01001122","Total",99,26,30,43,7,0,5,2,92,26,25,41
"2011","The Vale of Glamorgan 015A","W01001059","Total",23,8,10,5,3,0,3,0,20,8,7,5
"2011","The Vale of Glamorgan 015B","W01001060","Total",17,3,12,2,2,0,1,1,15,3,11,1
"2011","The Vale of Glamorgan 015C","W01001061","Total",100,35,20,45,7,1,3,3,93,34,17,42
"2011","The Vale of Glamorgan 015D","W01001066","Total",74,33,14,27,10,3,3,4,64,30,11,23
"2011","The Vale of Glamorgan 015E","W01001073","Total",92,31,22,39,7,0,4,3,85,31,18,36
"2011","Cardiff 001A","W01001777","Total",14,5,3,6,0,0,0,0,14,5,3,6
"2011","Cardiff 001B","W01001778","Total",21,7,12,2,3,1,2,0,18,6,10,2
"2011","Cardiff 001C","W01001794","Total",58,23,18,17,1,0,1,0,57,23,17,17
"2011","Cardiff 001D","W01001799","Total",10,4,5,1,1,0,1,0,9,4,4,1
"2011","Cardiff 002A","W01001793","Total",44,24,11,9,4,1,3,0,40,23,8,9
"2011","Cardiff 002B","W01001795","Total",36,17,12,7,2,0,2,0,34,17,10,7
"2011","Cardiff 002C","W01001796","Total",44,20,12,12,3,0,1,2,41,20,11,10
"2011","Cardiff 002D","W01001798","Total",35,14,15,6,1,0,1,0,34,14,14,6
"2011","Cardiff 003A","W01001841","Total",63,23,20,20,3,0,3,0,60,23,17,20
"2011","Cardiff 003B","W01001842","Total",61,20,31,10,9,0,7,2,52,20,24,8
"2011","Cardiff 003C","W01001843","Total",42,16,17,9,9,2,7,0,33,14,10,9
"2011","Cardiff 003D","W01001844","Total",91,33,30,28,3,0,2,1,88,33,28,27
"2011","Cardiff 004A","W01001849","Total",21,11,9,1,5,1,4,0,16,10,5,1
"2011","Cardiff 004B","W01001852","Total",17,5,8,4,2,0,2,0,15,5,6,4
"2011","Cardiff 004C","W01001853","Total",27,13,6,8,4,2,1,1,23,11,5,7
"2011","Cardiff 004D","W01001854","Total",26,10,16,0,2,1,1,0,24,9,15,0
"2011","Cardiff 005A","W01001791","Total",40,17,8,15,3,0,3,0,37,17,5,15
"2011","Cardiff 005B","W01001792","Total",66,22,19,25,4,2,2,0,62,20,17,25
"2011","Cardiff 005C","W01001797","Total",26,9,7,10,1,1,0,0,25,8,7,10
"2011","Cardiff 005D","W01001800","Total",76,28,14,34,4,1,1,2,72,27,13,32
"2011","Cardiff 005F","W01001949","Total",40,19,12,9,1,0,1,0,39,19,11,9
"2011","Cardiff 005G","W01001953","Total",55,15,19,21,5,1,4,0,50,14,15,21
"2011","Cardiff 006A","W01001820","Total",40,21,9,10,4,0,1,3,36,21,8,7
"2011","Cardiff 006C","W01001846","Total",60,28,21,11,4,0,2,2,56,28,19,9
"2011","Cardiff 006D","W01001847","Total",18,12,5,1,4,1,3,0,14,11,2,1
"2011","Cardiff 006E","W01001948","Total",66,22,26,18,4,0,2,2,62,22,24,16
"2011","Cardiff 006F","W01001954","Total",16,6,9,1,2,0,2,0,14,6,7,1
"2011","Cardiff 007A","W01001802","Total",49,22,13,14,2,0,2,0,47,22,11,14
"2011","Cardiff 007B","W01001807","Total",112,30,17,65,6,0,4,2,106,30,13,63
"2011","Cardiff 007C","W01001808","Total",136,35,17,84,8,0,2,6,128,35,15,78
"2011","Cardiff 007D","W01001840","Total",47,10,18,19,2,0,2,0,45,10,16,19
"2011","Cardiff 008A","W01001730","Total",9,4,1,4,0,0,0,0,9,4,1,4
"2011","Cardiff 008B","W01001731","Total",18,5,6,7,0,0,0,0,18,5,6,7
"2011","Cardiff 008C","W01001736","Total",15,7,6,2,0,0,0,0,15,7,6,2
"2011","Cardiff 008D","W01001815","Total",42,14,17,11,3,1,1,1,39,13,16,10
"2011","Cardiff 009A","W01001811","Total",113,25,13,75,6,0,1,5,107,25,12,70
"2011","Cardiff 009B","W01001816","Total",155,42,28,85,12,3,3,6,143,39,25,79
"2011","Cardiff 009C","W01001817","Total",61,16,24,21,2,0,0,2,59,16,24,19
"2011","Cardiff 009D","W01001818","Total",60,23,11,26,6,4,0,2,54,19,11,24
"2011","Cardiff 010A","W01001888","Total",58,21,19,18,3,1,1,1,55,20,18,17
"2011","Cardiff 010B","W01001893","Total",63,25,15,23,4,1,2,1,59,24,13,22
"2011","Cardiff 010C","W01001894","Total",27,11,9,7,4,0,3,1,23,11,6,6
"2011","Cardiff 010D","W01001895","Total",48,14,16,18,3,0,2,1,45,14,14,17
"2011","Cardiff 011A","W01001877","Total",36,18,8,10,2,0,1,1,34,18,7,9
"2011","Cardiff 011B","W01001878","Total",69,24,12,33,5,1,1,3,64,23,11,30
"2011","Cardiff 011C","W01001882","Total",93,26,24,43,4,0,4,0,89,26,20,43
"2011","Cardiff 011D","W01001885","Total",106,36,19,51,1,0,0,1,105,36,19,50
"2011","Cardiff 012A","W01001773","Total",55,18,18,19,7,0,5,2,48,18,13,17
"2011","Cardiff 012B","W01001848","Total",29,12,12,5,1,0,1,0,28,12,11,5
"2011","Cardiff 012C","W01001850","Total",15,7,8,0,0,0,0,0,15,7,8,0
"2011","Cardiff 012D","W01001851","Total",18,6,8,4,0,0,0,0,18,6,8,4
"2011","Cardiff 013A","W01001879","Total",121,38,18,65,12,1,3,8,109,37,15,57
"2011","Cardiff 013B","W01001880","Total",147,50,19,78,6,2,0,4,141,48,19,74
"2011","Cardiff 013C","W01001881","Total",83,23,13,47,6,1,3,2,77,22,10,45
"2011","Cardiff 013D","W01001884","Total",180,67,17,96,8,1,1,6,172,66,16,90
"2011","Cardiff 014A","W01001727","Total",26,11,8,7,3,1,1,1,23,10,7,6
"2011","Cardiff 014B","W01001728","Total",28,8,16,4,6,0,6,0,22,8,10,4
"2011","Cardiff 014C","W01001729","Total",64,24,26,14,7,1,5,1,57,23,21,13
"2011","Cardiff 014D","W01001819","Total",45,17,13,15,7,4,1,2,38,13,12,13
"2011","Cardiff 015A","W01001803","Total",63,16,7,40,2,0,1,1,61,16,6,39
"2011","Cardiff 015B","W01001804","Total",67,26,6,35,6,3,0,3,61,23,6,32
"2011","Cardiff 015C","W01001805","Total",84,23,17,44,7,0,5,2,77,23,12,42
"2011","Cardiff 015D","W01001806","Total",46,11,7,28,5,1,1,3,41,10,6,25
"2011","Cardiff 016A","W01001866","Total",53,9,12,32,5,0,0,5,48,9,12,27
"2011","Cardiff 016B","W01001867","Total",91,21,9,61,7,2,1,4,84,19,8,57
"2011","Cardiff 016C","W01001883","Total",77,16,13,48,1,0,0,1,76,16,13,47
"2011","Cardiff 016D","W01001886","Total",101,36,19,46,6,0,4,2,95,36,15,44
"2011","Cardiff 017A","W01001809","Total",34,10,13,11,2,0,2,0,32,10,11,11
"2011","Cardiff 017B","W01001810","Total",92,36,11,45,5,0,3,2,87,36,8,43
"2011","Cardiff 017C","W01001812","Total",70,31,15,24,2,0,1,1,68,31,14,23
"2011","Cardiff 017D","W01001813","Total",84,19,16,49,7,0,2,5,77,19,14,44
"2011","Cardiff 017E","W01001814","Total",55,15,19,21,2,0,2,0,53,15,17,21
"2011","Cardiff 018A","W01001769","Total",11,2,8,1,4,0,3,1,7,2,5,0
"2011","Cardiff 018B","W01001770","Total",6,1,2,3,2,0,2,0,4,1,0,3
"2011","Cardiff 018C","W01001771","Total",27,7,10,10,3,0,1,2,24,7,9,8
"2011","Cardiff 018D","W01001774","Total",7,3,1,3,0,0,0,0,7,3,1,3
"2011","Cardiff 019A","W01001732","Total",29,11,13,5,3,0,3,0,26,11,10,5
"2011","Cardiff 019B","W01001733","Total",23,4,10,9,3,0,3,0,20,4,7,9
"2011","Cardiff 019C","W01001734","Total",19,7,9,3,3,2,1,0,16,5,8,3
"2011","Cardiff 019D","W01001735","Total",31,12,15,4,5,1,4,0,26,11,11,4
"2011","Cardiff 020A","W01001887","Total",7,4,3,0,0,0,0,0,7,4,3,0
"2011","Cardiff 020B","W01001889","Total",38,15,11,12,7,0,5,2,31,15,6,10
"2011","Cardiff 020C","W01001891","Total",40,18,13,9,4,0,4,0,36,18,9,9
"2011","Cardiff 020D","W01001892","Total",16,7,6,3,3,1,2,0,13,6,4,3
"2011","Cardiff 020E","W01001896","Total",18,6,8,4,0,0,0,0,18,6,8,4
"2011","Cardiff 021A","W01001772","Total",17,5,12,0,1,1,0,0,16,4,12,0
"2011","Cardiff 021B","W01001775","Total",30,8,16,6,5,0,5,0,25,8,11,6
"2011","Cardiff 021C","W01001776","Total",12,6,5,1,0,0,0,0,12,6,5,1
"2011","Cardiff 021D","W01001890","Total",38,16,13,9,6,1,4,1,32,15,9,8
"2011","Cardiff 022A","W01001863","Total",44,14,9,21,1,0,0,1,43,14,9,20
"2011","Cardiff 022B","W01001864","Total",29,8,10,11,3,0,3,0,26,8,7,11
"2011","Cardiff 022C","W01001865","Total",29,13,9,7,4,2,2,0,25,11,7,7
"2011","Cardiff 022D","W01001868","Total",81,26,10,45,4,0,1,3,77,26,9,42
"2011","Cardiff 023A","W01001785","Total",77,19,14,44,3,0,2,1,74,19,12,43
"2011","Cardiff 023B","W01001786","Total",64,12,26,26,7,0,5,2,57,12,21,24
"2011","Cardiff 023C","W01001787","Total",58,23,12,23,4,0,1,3,54,23,11,20
"2011","Cardiff 023D","W01001788","Total",60,18,9,33,4,1,0,3,56,17,9,30
"2011","Cardiff 023E","W01001789","Total",53,18,19,16,3,0,3,0,50,18,16,16
"2011","Cardiff 023F","W01001790","Total",58,22,17,19,5,1,3,1,53,21,14,18
"2011","Cardiff 024A","W01001821","Total",17,5,6,6,0,0,0,0,17,5,6,6
"2011","Cardiff 024B","W01001826","Total",24,6,10,8,4,0,3,1,20,6,7,7
"2011","Cardiff 024C","W01001827","Total",34,10,15,9,3,0,3,0,31,10,12,9
"2011","Cardiff 024D","W01001828","Total",18,8,6,4,2,0,2,0,16,8,4,4
"2011","Cardiff 025A","W01001755","Total",16,4,11,1,1,0,1,0,15,4,10,1
"2011","Cardiff 025B","W01001756","Total",49,14,5,30,7,1,1,5,42,13,4,25
"2011","Cardiff 025C","W01001757","Total",24,5,5,14,1,0,1,0,23,5,4,14
"2011","Cardiff 025D","W01001758","Total",14,4,4,6,0,0,0,0,14,4,4,6
"2011","Cardiff 026A","W01001779","Total",23,8,15,0,2,0,2,0,21,8,13,0
"2011","Cardiff 026B","W01001780","Total",26,10,10,6,2,0,1,1,24,10,9,5
"2011","Cardiff 026C","W01001781","Total",25,6,9,10,4,0,2,2,21,6,7,8
"2011","Cardiff 026D","W01001782","Total",19,7,9,3,2,1,1,0,17,6,8,3
"2011","Cardiff 026E","W01001783","Total",25,12,9,4,1,0,1,0,24,12,8,4
"2011","Cardiff 026F","W01001784","Total",31,8,19,4,3,0,3,0,28,8,16,4
"2011","Cardiff 027A","W01001747","Total",56,23,14,19,5,2,2,1,51,21,12,18
"2011","Cardiff 027B","W01001748","Total",76,32,14,30,7,2,4,1,69,30,10,29
"2011","Cardiff 027C","W01001749","Total",64,25,10,29,4,1,2,1,60,24,8,28
"2011","Cardiff 027D","W01001751","Total",124,41,9,74,9,2,2,5,115,39,7,69
"2011","Cardiff 028A","W01001718","Total",17,7,1,9,0,0,0,0,17,7,1,9
"2011","Cardiff 028B","W01001719","Total",8,5,2,1,0,0,0,0,8,5,2,1
"2011","Cardiff 028C","W01001720","Total",14,5,2,7,0,0,0,0,14,5,2,7
"2011","Cardiff 028D","W01001722","Total",12,6,2,4,3,0,1,2,9,6,1,2
"2011","Cardiff 028E","W01001726","Total",7,1,3,3,2,0,1,1,5,1,2,2
"2011","Cardiff 029A","W01001822","Total",38,8,13,17,2,1,1,0,36,7,12,17
"2011","Cardiff 029B","W01001823","Total",20,4,15,1,0,0,0,0,20,4,15,1
"2011","Cardiff 029C","W01001824","Total",17,4,6,7,4,3,1,0,13,1,5,7
"2011","Cardiff 029D","W01001825","Total",43,17,11,15,0,0,0,0,43,17,11,15
"2011","Cardiff 030A","W01001831","Total",24,8,11,5,1,0,1,0,23,8,10,5
"2011","Cardiff 030B","W01001836","Total",26,2,11,13,3,0,3,0,23,2,8,13
"2011","Cardiff 030C","W01001837","Total",18,6,5,7,1,0,1,0,17,6,4,7
"2011","Cardiff 030D","W01001838","Total",20,6,9,5,6,2,2,2,14,4,7,3
"2011","Cardiff 030E","W01001839","Total",25,7,6,12,2,1,0,1,23,6,6,11
"2011","Cardiff 031A","W01001750","Total",66,21,16,29,7,1,3,3,59,20,13,26
"2011","Cardiff 031B","W01001752","Total",44,14,13,17,9,1,5,3,35,13,8,14
"2011","Cardiff 031C","W01001753","Total",117,41,24,52,6,1,4,1,111,40,20,51
"2011","Cardiff 031D","W01001754","Total",36,16,8,12,3,2,1,0,33,14,7,12
"2011","Cardiff 032A","W01001721","Total",19,11,1,7,0,0,0,0,19,11,1,7
"2011","Cardiff 032C","W01001724","Total",12,3,0,9,0,0,0,0,12,3,0,9
"2011","Cardiff 032D","W01001725","Total",11,4,4,3,3,0,3,0,8,4,1,3
"2011","Cardiff 032E","W01001922","Total",14,4,0,10,9,1,0,8,5,3,0,2
"2011","Cardiff 032F","W01001939","Total",1,0,1,0,0,0,0,0,1,0,1,0
"2011","Cardiff 032G","W01001941","Total",3,0,2,1,2,0,2,0,1,0,0,1
"2011","Cardiff 033A","W01001829","Total",23,8,5,10,0,0,0,0,23,8,5,10
"2011","Cardiff 033B","W01001830","Total",30,9,7,14,4,1,2,1,26,8,5,13
"2011","Cardiff 033C","W01001832","Total",18,3,5,10,1,0,0,1,17,3,5,9
"2011","Cardiff 033D","W01001833","Total",43,8,13,22,1,0,1,0,42,8,12,22
"2011","Cardiff 033E","W01001834","Total",32,10,9,13,2,1,1,0,30,9,8,13
"2011","Cardiff 033F","W01001835","Total",20,10,2,8,1,1,0,0,19,9,2,8
"2011","Cardiff 034A","W01001858","Total",30,8,14,8,0,0,0,0,30,8,14,8
"2011","Cardiff 034B","W01001859","Total",31,10,13,8,3,1,2,0,28,9,11,8
"2011","Cardiff 034C","W01001860","Total",33,10,15,8,3,0,0,3,30,10,15,5
"2011","Cardiff 034D","W01001861","Total",15,8,3,4,1,0,1,0,14,8,2,4
"2011","Cardiff 035A","W01001714","Total",23,5,11,7,3,0,2,1,20,5,9,6
"2011","Cardiff 035B","W01001715","Total",22,10,7,5,1,0,1,0,21,10,6,5
"2011","Cardiff 035C","W01001716","Total",37,17,13,7,5,0,4,1,32,17,9,6
"2011","Cardiff 035D","W01001717","Total",56,17,17,22,3,0,3,0,53,17,14,22
"2011","Cardiff 036A","W01001694","Total",75,19,9,47,10,0,2,8,65,19,7,39
"2011","Cardiff 036B","W01001695","Total",75,19,7,49,11,0,0,11,64,19,7,38
"2011","Cardiff 036C","W01001696","Total",90,25,12,53,11,1,2,8,79,24,10,45
"2011","Cardiff 036D","W01001697","Total",35,12,10,13,7,3,3,1,28,9,7,12
"2011","Cardiff 036E","W01001698","Total",49,12,8,29,7,0,0,7,42,12,8,22
"2011","Cardiff 037A","W01001870","Total",56,20,16,20,7,2,4,1,49,18,12,19
"2011","Cardiff 037B","W01001871","Total",120,29,13,78,10,1,3,6,110,28,10,72
"2011","Cardiff 037C","W01001875","Total",164,55,27,82,7,2,1,4,157,53,26,78
"2011","Cardiff 037D","W01001876","Total",111,29,16,66,10,0,3,7,101,29,13,59
"2011","Cardiff 038A","W01001869","Total",54,22,6,26,4,1,1,2,50,21,5,24
"2011","Cardiff 038B","W01001872","Total",61,27,11,23,4,1,2,1,57,26,9,22
"2011","Cardiff 038C","W01001873","Total",79,27,8,44,11,1,5,5,68,26,3,39
"2011","Cardiff 038D","W01001874","Total",93,29,15,49,8,2,3,3,85,27,12,46
"2011","Cardiff 039A","W01001737","Total",114,30,14,70,7,0,2,5,107,30,12,65
"2011","Cardiff 039B","W01001738","Total",121,34,13,74,11,1,3,7,110,33,10,67
"2011","Cardiff 039C","W01001739","Total",126,34,9,83,9,1,1,7,117,33,8,76
"2011","Cardiff 039D","W01001740","Total",117,28,10,79,15,0,2,13,102,28,8,66
"2011","Cardiff 039E","W01001741","Total",197,55,14,128,7,0,2,5,190,55,12,123
"2011","Cardiff 040A","W01001709","Total",55,24,8,23,4,2,1,1,51,22,7,22
"2011","Cardiff 040B","W01001710","Total",34,13,5,16,2,0,1,1,32,13,4,15
"2011","Cardiff 040C","W01001711","Total",77,19,17,41,3,1,0,2,74,18,17,39
"2011","Cardiff 040D","W01001712","Total",36,12,8,16,4,2,1,1,32,10,7,15
"2011","Cardiff 040E","W01001713","Total",35,12,10,13,2,0,1,1,33,12,9,12
"2011","Cardiff 041A","W01001704","Total",119,43,7,69,7,4,0,3,112,39,7,66
"2011","Cardiff 041B","W01001706","Total",53,19,7,27,3,1,0,2,50,18,7,25
"2011","Cardiff 041C","W01001707","Total",139,44,19,76,9,1,2,6,130,43,17,70
"2011","Cardiff 041D","W01001746","Total",105,29,10,66,13,2,1,10,92,27,9,56
"2011","Cardiff 042A","W01001855","Total",53,9,10,34,4,0,2,2,49,9,8,32
"2011","Cardiff 042B","W01001856","Total",23,8,3,12,6,4,1,1,17,4,2,11
"2011","Cardiff 042C","W01001857","Total",72,24,10,38,3,1,1,1,69,23,9,37
"2011","Cardiff 042D","W01001862","Total",34,5,5,24,4,0,0,4,30,5,5,20
"2011","Cardiff 043A","W01001742","Total",153,44,13,96,7,4,1,2,146,40,12,94
"2011","Cardiff 043B","W01001743","Total",35,19,8,8,1,0,0,1,34,19,8,7
"2011","Cardiff 043C","W01001744","Total",121,48,11,62,6,0,3,3,115,48,8,59
"2011","Cardiff 043D","W01001745","Total",36,12,12,12,5,2,3,0,31,10,9,12
"2011","Cardiff 044A","W01001764","Total",64,23,7,34,4,0,2,2,60,23,5,32
"2011","Cardiff 044B","W01001765","Total",36,10,7,19,5,0,3,2,31,10,4,17
"2011","Cardiff 044C","W01001766","Total",84,25,13,46,7,0,1,6,77,25,12,40
"2011","Cardiff 044D","W01001767","Total",75,23,8,44,4,0,0,4,71,23,8,40
"2011","Cardiff 044E","W01001768","Total",52,18,4,30,7,4,2,1,45,14,2,29
"2011","Cardiff 045A","W01001702","Total",86,25,19,42,5,1,3,1,81,24,16,41
"2011","Cardiff 045B","W01001703","Total",79,26,11,42,6,1,0,5,73,25,11,37
"2011","Cardiff 045C","W01001705","Total",111,45,16,50,7,1,3,3,104,44,13,47
"2011","Cardiff 045D","W01001708","Total",96,26,17,53,9,2,4,3,87,24,13,50
"2011","Cardiff 046A","W01001759","Total",49,22,11,16,10,4,4,2,39,18,7,14
"2011","Cardiff 046B","W01001760","Total",54,23,8,23,7,1,5,1,47,22,3,22
"2011","Cardiff 046C","W01001761","Total",59,12,16,31,6,1,3,2,53,11,13,29
"2011","Cardiff 046D","W01001762","Total",69,17,14,38,10,0,2,8,59,17,12,30
"2011","Cardiff 048A","W01001940","Total",7,1,3,3,0,0,0,0,7,1,3,3
"2011","Cardiff 048B","W01001943","Total",14,2,4,8,0,0,0,0,14,2,4,8
"2011","Cardiff 048C","W01001944","Total",16,2,3,11,2,0,1,1,14,2,2,10
"2011","Cardiff 048D","W01001945","Total",13,3,4,6,2,0,1,1,11,3,3,5
"2011","Cardiff 048E","W01001947","Total",27,13,5,9,2,1,0,1,25,12,5,8
"2011","Cardiff 049A","W01001699","Total",55,13,6,36,2,1,1,0,53,12,5,36
"2011","Cardiff 049B","W01001942","Total",37,10,4,23,4,1,2,1,33,9,2,22
"2011","Cardiff 049C","W01001946","Total",55,14,8,33,3,0,2,1,52,14,6,32
"2011","Cardiff 049D","W01001950","Total",5,0,2,3,0,0,0,0,5,0,2,3
"2011","Cardiff 049E","W01001951","Total",24,3,11,10,6,0,6,0,18,3,5,10
"2011","Cardiff 049F","W01001952","Total",27,5,3,19,5,0,1,4,22,5,2,15
"2011","Rhondda Cynon Taf 001A","W01001186","Total",65,13,20,32,7,0,5,2,58,13,15,30
"2011","Rhondda Cynon Taf 001B","W01001187","Total",30,12,4,14,2,0,0,2,28,12,4,12
"2011","Rhondda Cynon Taf 001C","W01001188","Total",51,8,10,33,8,0,4,4,43,8,6,29
"2011","Rhondda Cynon Taf 001D","W01001221","Total",73,14,10,49,6,0,2,4,67,14,8,45
"2011","Rhondda Cynon Taf 001E","W01001222","Total",99,15,10,74,7,1,2,4,92,14,8,70
"2011","Rhondda Cynon Taf 001F","W01001233","Total",44,16,11,17,9,0,6,3,35,16,5,14
"2011","Rhondda Cynon Taf 002A","W01001148","Total",76,23,22,31,9,1,5,3,67,22,17,28
"2011","Rhondda Cynon Taf 002B","W01001152","Total",53,15,15,23,2,0,1,1,51,15,14,22
"2011","Rhondda Cynon Taf 002C","W01001153","Total",85,31,22,32,8,1,7,0,77,30,15,32
"2011","Rhondda Cynon Taf 002D","W01001155","Total",55,18,13,24,4,0,2,2,51,18,11,22
"2011","Rhondda Cynon Taf 003A","W01001149","Total",56,15,13,28,7,1,2,4,49,14,11,24
"2011","Rhondda Cynon Taf 003B","W01001150","Total",77,22,12,43,6,0,4,2,71,22,8,41
"2011","Rhondda Cynon Taf 003C","W01001151","Total",21,8,8,5,2,1,1,0,19,7,7,5
"2011","Rhondda Cynon Taf 003D","W01001154","Total",76,24,17,35,4,2,2,0,72,22,15,35
"2011","Rhondda Cynon Taf 003E","W01001156","Total",24,6,12,6,4,0,3,1,20,6,9,5
"2011","Rhondda Cynon Taf 004A","W01001147","Total",52,18,19,15,4,1,0,3,48,17,19,12
"2011","Rhondda Cynon Taf 004B","W01001168","Total",49,20,13,16,5,0,5,0,44,20,8,16
"2011","Rhondda Cynon Taf 004C","W01001169","Total",91,31,15,45,9,2,4,3,82,29,11,42
"2011","Rhondda Cynon Taf 004D","W01001170","Total",20,7,8,5,0,0,0,0,20,7,8,5
"2011","Rhondda Cynon Taf 005A","W01001137","Total",98,26,14,58,2,0,2,0,96,26,12,58
"2011","Rhondda Cynon Taf 005B","W01001138","Total",77,27,9,41,12,1,4,7,65,26,5,34
"2011","Rhondda Cynon Taf 005C","W01001139","Total",49,21,9,19,6,0,2,4,43,21,7,15
"2011","Rhondda Cynon Taf 005D","W01001140","Total",66,19,19,28,4,0,2,2,62,19,17,26
"2011","Rhondda Cynon Taf 005E","W01001141","Total",77,18,13,46,3,0,1,2,74,18,12,44
"2011","Rhondda Cynon Taf 005F","W01001142","Total",71,15,11,45,2,0,0,2,69,15,11,43
"2011","Rhondda Cynon Taf 006A","W01001204","Total",67,20,22,25,4,0,4,0,63,20,18,25
"2011","Rhondda Cynon Taf 006B","W01001205","Total",68,15,22,31,12,0,6,6,56,15,16,25
"2011","Rhondda Cynon Taf 006C","W01001206","Total",57,14,16,27,6,0,2,4,51,14,14,23
"2011","Rhondda Cynon Taf 006D","W01001207","Total",75,15,12,48,7,1,0,6,68,14,12,42
"2011","Rhondda Cynon Taf 006E","W01001208","Total",74,23,19,32,6,0,6,0,68,23,13,32
"2011","Rhondda Cynon Taf 007A","W01001265","Total",53,12,14,27,5,0,4,1,48,12,10,26
"2011","Rhondda Cynon Taf 007B","W01001266","Total",60,20,4,36,7,0,0,7,53,20,4,29
"2011","Rhondda Cynon Taf 007C","W01001267","Total",60,18,9,33,8,2,3,3,52,16,6,30
"2011","Rhondda Cynon Taf 007D","W01001268","Total",62,11,15,36,8,0,5,3,54,11,10,33
"2011","Rhondda Cynon Taf 008A","W01001209","Total",84,13,13,58,3,0,0,3,81,13,13,55
"2011","Rhondda Cynon Taf 008B","W01001210","Total",73,23,15,35,3,0,1,2,70,23,14,33
"2011","Rhondda Cynon Taf 008C","W01001211","Total",64,21,16,27,10,1,6,3,54,20,10,24
"2011","Rhondda Cynon Taf 008D","W01001212","Total",72,28,8,36,8,5,0,3,64,23,8,33
"2011","Rhondda Cynon Taf 009A","W01001175","Total",43,11,9,23,4,1,1,2,39,10,8,21
"2011","Rhondda Cynon Taf 009B","W01001177","Total",57,20,11,26,8,5,1,2,49,15,10,24
"2011","Rhondda Cynon Taf 009C","W01001202","Total",101,24,18,59,9,1,7,1,92,23,11,58
"2011","Rhondda Cynon Taf 009D","W01001203","Total",77,20,12,45,7,0,3,4,70,20,9,41
"2011","Rhondda Cynon Taf 010A","W01001269","Total",45,15,19,11,5,0,3,2,40,15,16,9
"2011","Rhondda Cynon Taf 010B","W01001270","Total",46,9,18,19,8,1,4,3,38,8,14,16
"2011","Rhondda Cynon Taf 010C","W01001271","Total",82,24,18,40,14,3,6,5,68,21,12,35
"2011","Rhondda Cynon Taf 010D","W01001272","Total",75,25,19,31,7,1,3,3,68,24,16,28
"2011","Rhondda Cynon Taf 010E","W01001273","Total",63,19,12,32,3,1,0,2,60,18,12,30
"2011","Rhondda Cynon Taf 011A","W01001213","Total",60,22,13,25,7,1,2,4,53,21,11,21
"2011","Rhondda Cynon Taf 011B","W01001214","Total",29,9,11,9,5,1,3,1,24,8,8,8
"2011","Rhondda Cynon Taf 011C","W01001215","Total",36,15,6,15,1,0,0,1,35,15,6,14
"2011","Rhondda Cynon Taf 011D","W01001216","Total",67,21,16,30,5,1,2,2,62,20,14,28
"2011","Rhondda Cynon Taf 012A","W01001143","Total",55,10,19,26,8,0,3,5,47,10,16,21
"2011","Rhondda Cynon Taf 012B","W01001144","Total",94,29,14,51,7,1,1,5,87,28,13,46
"2011","Rhondda Cynon Taf 012C","W01001145","Total",73,31,19,23,9,0,7,2,64,31,12,21
"2011","Rhondda Cynon Taf 012D","W01001146","Total",51,19,10,22,1,1,0,0,50,18,10,22
"2011","Rhondda Cynon Taf 013A","W01001176","Total",61,24,20,17,8,1,5,2,53,23,15,15
"2011","Rhondda Cynon Taf 013B","W01001274","Total",107,15,13,79,8,0,1,7,99,15,12,72
"2011","Rhondda Cynon Taf 013C","W01001275","Total",107,31,19,57,11,1,2,8,96,30,17,49
"2011","Rhondda Cynon Taf 013D","W01001276","Total",65,17,10,38,5,0,5,0,60,17,5,38
"2011","Rhondda Cynon Taf 014A","W01001200","Total",37,11,10,16,2,1,1,0,35,10,9,16
"2011","Rhondda Cynon Taf 014B","W01001201","Total",44,15,6,23,1,0,1,0,43,15,5,23
"2011","Rhondda Cynon Taf 014C","W01001260","Total",55,12,7,36,3,1,1,1,52,11,6,35
"2011","Rhondda Cynon Taf 014D","W01001285","Total",35,9,12,14,4,1,3,0,31,8,9,14
"2011","Rhondda Cynon Taf 014E","W01001286","Total",76,25,17,34,7,1,6,0,69,24,11,34
"2011","Rhondda Cynon Taf 014F","W01001287","Total",57,17,14,26,5,0,1,4,52,17,13,22
"2011","Rhondda Cynon Taf 014G","W01001288","Total",62,22,10,30,7,1,2,4,55,21,8,26
"2011","Rhondda Cynon Taf 015A","W01001180","Total",95,18,7,70,5,0,1,4,90,18,6,66
"2011","Rhondda Cynon Taf 015B","W01001181","Total",52,19,11,22,1,0,0,1,51,19,11,21
"2011","Rhondda Cynon Taf 015C","W01001282","Total",92,34,19,39,4,0,2,2,88,34,17,37
"2011","Rhondda Cynon Taf 015D","W01001283","Total",46,17,11,18,1,0,0,1,45,17,11,17
"2011","Rhondda Cynon Taf 015E","W01001284","Total",33,9,15,9,1,0,1,0,32,9,14,9
"2011","Rhondda Cynon Taf 016A","W01001166","Total",52,19,7,26,3,0,1,2,49,19,6,24
"2011","Rhondda Cynon Taf 016B","W01001167","Total",77,31,15,31,8,1,4,3,69,30,11,28
"2011","Rhondda Cynon Taf 016C","W01001247","Total",58,20,11,27,2,0,1,1,56,20,10,26
"2011","Rhondda Cynon Taf 016D","W01001248","Total",76,21,20,35,10,0,9,1,66,21,11,34
"2011","Rhondda Cynon Taf 017A","W01001171","Total",45,16,14,15,4,0,3,1,41,16,11,14
"2011","Rhondda Cynon Taf 017B","W01001229","Total",48,18,13,17,3,1,1,1,45,17,12,16
"2011","Rhondda Cynon Taf 017C","W01001230","Total",36,6,12,18,5,0,3,2,31,6,9,16
"2011","Rhondda Cynon Taf 017D","W01001231","Total",75,29,14,32,4,0,3,1,71,29,11,31
"2011","Rhondda Cynon Taf 017E","W01001280","Total",67,23,12,32,4,2,1,1,63,21,11,31
"2011","Rhondda Cynon Taf 017F","W01001281","Total",61,24,10,27,2,0,0,2,59,24,10,25
"2011","Rhondda Cynon Taf 018A","W01001217","Total",36,13,6,17,1,1,0,0,35,12,6,17
"2011","Rhondda Cynon Taf 018B","W01001218","Total",60,15,12,33,6,1,2,3,54,14,10,30
"2011","Rhondda Cynon Taf 018C","W01001219","Total",69,19,11,39,7,2,3,2,62,17,8,37
"2011","Rhondda Cynon Taf 018D","W01001220","Total",66,33,12,21,2,0,1,1,64,33,11,20
"2011","Rhondda Cynon Taf 018E","W01001259","Total",56,18,8,30,4,1,1,2,52,17,7,28
"2011","Rhondda Cynon Taf 018F","W01001261","Total",40,14,10,16,5,1,2,2,35,13,8,14
"2011","Rhondda Cynon Taf 019A","W01001164","Total",71,27,23,21,5,0,4,1,66,27,19,20
"2011","Rhondda Cynon Taf 019B","W01001165","Total",56,18,15,23,4,0,1,3,52,18,14,20
"2011","Rhondda Cynon Taf 019C","W01001256","Total",44,11,12,21,3,1,1,1,41,10,11,20
"2011","Rhondda Cynon Taf 019D","W01001257","Total",30,8,12,10,4,1,3,0,26,7,9,10
"2011","Rhondda Cynon Taf 019E","W01001258","Total",45,18,12,15,5,0,4,1,40,18,8,14
"2011","Rhondda Cynon Taf 020A","W01001172","Total",64,25,12,27,7,1,2,4,57,24,10,23
"2011","Rhondda Cynon Taf 020B","W01001173","Total",73,25,15,33,10,0,4,6,63,25,11,27
"2011","Rhondda Cynon Taf 020C","W01001174","Total",96,20,18,58,11,1,4,6,85,19,14,52
"2011","Rhondda Cynon Taf 020D","W01001232","Total",50,11,15,24,5,0,3,2,45,11,12,22
"2011","Rhondda Cynon Taf 021A","W01001182","Total",59,17,12,30,4,1,3,0,55,16,9,30
"2011","Rhondda Cynon Taf 021B","W01001183","Total",39,9,6,24,3,0,1,2,36,9,5,22
"2011","Rhondda Cynon Taf 021C","W01001227","Total",33,6,15,12,7,0,6,1,26,6,9,11
"2011","Rhondda Cynon Taf 021D","W01001228","Total",22,7,9,6,6,0,4,2,16,7,5,4
"2011","Rhondda Cynon Taf 021E","W01001234","Total",35,12,12,11,4,0,3,1,31,12,9,10
"2011","Rhondda Cynon Taf 021F","W01001235","Total",83,31,21,31,8,0,6,2,75,31,15,29
"2011","Rhondda Cynon Taf 021G","W01001236","Total",54,20,17,17,3,0,3,0,51,20,14,17
"2011","Rhondda Cynon Taf 022A","W01001185","Total",73,25,15,33,11,2,4,5,62,23,11,28
"2011","Rhondda Cynon Taf 022B","W01001237","Total",58,22,8,28,5,1,1,3,53,21,7,25
"2011","Rhondda Cynon Taf 022C","W01001238","Total",144,35,10,99,13,1,1,11,131,34,9,88
"2011","Rhondda Cynon Taf 022D","W01001262","Total",42,18,10,14,6,1,4,1,36,17,6,13
"2011","Rhondda Cynon Taf 022E","W01001263","Total",31,7,6,18,1,0,0,1,30,7,6,17
"2011","Rhondda Cynon Taf 022F","W01001264","Total",12,4,2,6,1,0,0,1,11,4,2,5
"2011","Rhondda Cynon Taf 023A","W01001178","Total",64,13,15,36,2,0,0,2,62,13,15,34
"2011","Rhondda Cynon Taf 023B","W01001179","Total",96,20,13,63,5,0,1,4,91,20,12,59
"2011","Rhondda Cynon Taf 023C","W01001253","Total",65,23,16,26,6,1,4,1,59,22,12,25
"2011","Rhondda Cynon Taf 023E","W01001255","Total",92,21,21,50,10,0,8,2,82,21,13,48
"2011","Rhondda Cynon Taf 023F","W01001914","Total",32,12,12,8,3,0,3,0,29,12,9,8
"2011","Rhondda Cynon Taf 023G","W01001917","Total",52,15,18,19,5,0,4,1,47,15,14,18
"2011","Rhondda Cynon Taf 024A","W01001249","Total",47,22,9,16,2,0,1,1,45,22,8,15
"2011","Rhondda Cynon Taf 024B","W01001250","Total",32,7,7,18,1,0,1,0,31,7,6,18
"2011","Rhondda Cynon Taf 024C","W01001251","Total",117,36,12,69,6,1,0,5,111,35,12,64
"2011","Rhondda Cynon Taf 024D","W01001252","Total",38,6,17,15,5,0,5,0,33,6,12,15
"2011","Rhondda Cynon Taf 025A","W01001162","Total",88,17,19,52,11,1,3,7,77,16,16,45
"2011","Rhondda Cynon Taf 025B","W01001244","Total",17,7,4,6,1,0,0,1,16,7,4,5
"2011","Rhondda Cynon Taf 025C","W01001245","Total",23,11,10,2,4,1,3,0,19,10,7,2
"2011","Rhondda Cynon Taf 025D","W01001246","Total",40,12,17,11,5,0,5,0,35,12,12,11
"2011","Rhondda Cynon Taf 026A","W01001184","Total",46,18,15,13,5,1,4,0,41,17,11,13
"2011","Rhondda Cynon Taf 026B","W01001239","Total",77,19,12,46,5,0,2,3,72,19,10,43
"2011","Rhondda Cynon Taf 026C","W01001240","Total",49,19,17,13,7,1,4,2,42,18,13,11
"2011","Rhondda Cynon Taf 026D","W01001241","Total",47,21,15,11,5,1,3,1,42,20,12,10
"2011","Rhondda Cynon Taf 027B","W01001196","Total",55,13,19,23,7,0,5,2,48,13,14,21
"2011","Rhondda Cynon Taf 027C","W01001197","Total",9,2,6,1,1,0,1,0,8,2,5,1
"2011","Rhondda Cynon Taf 027D","W01001198","Total",42,15,18,9,7,0,6,1,35,15,12,8
"2011","Rhondda Cynon Taf 027E","W01001199","Total",50,14,17,19,7,1,4,2,43,13,13,17
"2011","Rhondda Cynon Taf 027F","W01001915","Total",30,13,10,7,6,1,5,0,24,12,5,7
"2011","Rhondda Cynon Taf 027G","W01001916","Total",47,13,20,14,4,1,1,2,43,12,19,12
"2011","Rhondda Cynon Taf 028A","W01001157","Total",45,13,15,17,5,0,3,2,40,13,12,15
"2011","Rhondda Cynon Taf 028B","W01001158","Total",54,15,15,24,3,1,1,1,51,14,14,23
"2011","Rhondda Cynon Taf 028C","W01001159","Total",46,12,16,18,5,0,4,1,41,12,12,17
"2011","Rhondda Cynon Taf 028D","W01001277","Total",26,9,9,8,2,0,2,0,24,9,7,8
"2011","Rhondda Cynon Taf 028E","W01001278","Total",49,13,10,26,4,0,2,2,45,13,8,24
"2011","Rhondda Cynon Taf 028F","W01001279","Total",90,26,10,54,7,1,5,1,83,25,5,53
"2011","Rhondda Cynon Taf 029A","W01001160","Total",35,14,8,13,4,1,2,1,31,13,6,12
"2011","Rhondda Cynon Taf 029B","W01001161","Total",58,24,15,19,6,1,4,1,52,23,11,18
"2011","Rhondda Cynon Taf 029C","W01001189","Total",84,26,15,43,5,0,1,4,79,26,14,39
"2011","Rhondda Cynon Taf 029D","W01001190","Total",55,13,23,19,4,0,2,2,51,13,21,17
"2011","Rhondda Cynon Taf 030A","W01001193","Total",21,5,12,4,1,0,1,0,20,5,11,4
"2011","Rhondda Cynon Taf 030B","W01001194","Total",48,19,18,11,5,1,3,1,43,18,15,10
"2011","Rhondda Cynon Taf 030C","W01001195","Total",62,15,27,20,6,1,4,1,56,14,23,19
"2011","Rhondda Cynon Taf 030D","W01001242","Total",24,6,11,7,3,0,2,1,21,6,9,6
"2011","Rhondda Cynon Taf 030E","W01001243","Total",66,24,12,30,3,0,2,1,63,24,10,29
"2011","Rhondda Cynon Taf 031A","W01001191","Total",59,25,18,16,3,0,1,2,56,25,17,14
"2011","Rhondda Cynon Taf 031B","W01001192","Total",70,22,14,34,8,1,4,3,62,21,10,31
"2011","Rhondda Cynon Taf 031C","W01001223","Total",32,13,15,4,3,0,2,1,29,13,13,3
"2011","Rhondda Cynon Taf 031D","W01001224","Total",28,14,9,5,0,0,0,0,28,14,9,5
"2011","Rhondda Cynon Taf 031E","W01001225","Total",17,6,7,4,1,0,0,1,16,6,7,3
"2011","Rhondda Cynon Taf 031F","W01001226","Total",65,25,24,16,5,1,4,0,60,24,20,16
"2011","Merthyr Tydfil 002A","W01001295","Total",98,32,15,51,8,2,3,3,90,30,12,48
"2011","Merthyr Tydfil 002B","W01001296","Total",49,17,10,22,6,0,2,4,43,17,8,18
"2011","Merthyr Tydfil 002C","W01001297","Total",79,31,23,25,7,0,6,1,72,31,17,24
"2011","Merthyr Tydfil 002D","W01001298","Total",99,29,30,40,7,2,2,3,92,27,28,37
"2011","Merthyr Tydfil 002E","W01001310","Total",49,17,12,20,3,0,1,2,46,17,11,18
"2011","Merthyr Tydfil 002F","W01001311","Total",58,24,14,20,5,1,1,3,53,23,13,17
"2011","Merthyr Tydfil 003A","W01001291","Total",67,20,18,29,4,0,2,2,63,20,16,27
"2011","Merthyr Tydfil 003B","W01001294","Total",22,7,12,3,2,0,2,0,20,7,10,3
"2011","Merthyr Tydfil 003C","W01001305","Total",41,11,11,19,7,2,3,2,34,9,8,17
"2011","Merthyr Tydfil 003D","W01001306","Total",46,19,17,10,6,3,1,2,40,16,16,8
"2011","Merthyr Tydfil 003E","W01001324","Total",49,16,16,17,7,1,2,4,42,15,14,13
"2011","Merthyr Tydfil 004A","W01001292","Total",88,26,17,45,6,1,1,4,82,25,16,41
"2011","Merthyr Tydfil 004B","W01001293","Total",72,31,15,26,6,1,3,2,66,30,12,24
"2011","Merthyr Tydfil 004C","W01001307","Total",50,12,12,26,6,0,3,3,44,12,9,23
"2011","Merthyr Tydfil 004D","W01001315","Total",71,27,14,30,7,3,4,0,64,24,10,30
"2011","Merthyr Tydfil 005A","W01001314","Total",71,25,20,26,2,1,1,0,69,24,19,26
"2011","Merthyr Tydfil 005B","W01001316","Total",68,29,24,15,5,2,3,0,63,27,21,15
"2011","Merthyr Tydfil 005C","W01001317","Total",55,16,23,16,5,0,5,0,50,16,18,16
"2011","Merthyr Tydfil 005D","W01001318","Total",39,9,19,11,4,0,4,0,35,9,15,11
"2011","Merthyr Tydfil 006A","W01001289","Total",38,15,10,13,4,1,1,2,34,14,9,11
"2011","Merthyr Tydfil 006B","W01001302","Total",59,22,11,26,4,0,3,1,55,22,8,25
"2011","Merthyr Tydfil 006C","W01001303","Total",82,24,12,46,8,0,4,4,74,24,8,42
"2011","Merthyr Tydfil 006D","W01001304","Total",48,24,11,13,7,1,4,2,41,23,7,11
"2011","Merthyr Tydfil 006E","W01001312","Total",61,21,18,22,3,2,1,0,58,19,17,22
"2011","Merthyr Tydfil 006F","W01001313","Total",50,15,12,23,11,1,5,5,39,14,7,18
"2011","Merthyr Tydfil 007A","W01001290","Total",84,22,21,41,7,1,4,2,77,21,17,39
"2011","Merthyr Tydfil 007B","W01001319","Total",30,11,16,3,5,0,4,1,25,11,12,2
"2011","Merthyr Tydfil 007C","W01001320","Total",49,14,13,22,7,1,3,3,42,13,10,19
"2011","Merthyr Tydfil 007D","W01001321","Total",76,30,10,36,10,1,4,5,66,29,6,31
"2011","Merthyr Tydfil 007E","W01001322","Total",49,12,12,25,5,1,2,2,44,11,10,23
"2011","Merthyr Tydfil 008A","W01001299","Total",117,35,9,73,6,0,2,4,111,35,7,69
"2011","Merthyr Tydfil 008B","W01001300","Total",100,24,10,66,7,1,1,5,93,23,9,61
"2011","Merthyr Tydfil 008C","W01001301","Total",124,40,17,67,9,2,3,4,115,38,14,63
"2011","Merthyr Tydfil 008D","W01001308","Total",88,30,5,53,3,1,1,1,85,29,4,52
"2011","Merthyr Tydfil 008E","W01001309","Total",80,34,16,30,9,1,5,3,71,33,11,27
"2011","Merthyr Tydfil 008F","W01001898","Total",49,15,20,14,5,0,4,1,44,15,16,13
"2011","Caerphilly 001A","W01001374","Total",56,16,13,27,2,0,1,1,54,16,12,26
"2011","Caerphilly 001B","W01001375","Total",58,14,20,24,13,1,9,3,45,13,11,21
"2011","Caerphilly 001C","W01001376","Total",92,23,16,53,8,1,1,6,84,22,15,47
"2011","Caerphilly 001D","W01001406","Total",69,20,18,31,8,0,3,5,61,20,15,26
"2011","Caerphilly 001E","W01001428","Total",105,27,10,68,14,2,1,11,91,25,9,57
"2011","Caerphilly 001F","W01001429","Total",42,12,14,16,4,1,2,1,38,11,12,15
"2011","Caerphilly 002A","W01001360","Total",33,7,13,13,2,0,2,0,31,7,11,13
"2011","Caerphilly 002B","W01001361","Total",51,10,12,29,4,0,0,4,47,10,12,25
"2011","Caerphilly 002C","W01001384","Total",62,22,16,24,1,0,1,0,61,22,15,24
"2011","Caerphilly 002D","W01001385","Total",66,22,12,32,9,1,3,5,57,21,9,27
"2011","Caerphilly 002E","W01001386","Total",77,17,10,50,7,0,1,6,70,17,9,44
"2011","Caerphilly 003A","W01001325","Total",61,22,9,30,2,0,0,2,59,22,9,28
"2011","Caerphilly 003B","W01001326","Total",107,25,27,55,10,1,4,5,97,24,23,50
"2011","Caerphilly 003C","W01001362","Total",60,19,16,25,10,0,4,6,50,19,12,19
"2011","Caerphilly 004A","W01001336","Total",44,12,6,26,3,2,1,0,41,10,5,26
"2011","Caerphilly 004B","W01001337","Total",65,23,15,27,5,0,2,3,60,23,13,24
"2011","Caerphilly 004C","W01001338","Total",81,26,22,33,10,0,8,2,71,26,14,31
"2011","Caerphilly 004D","W01001339","Total",92,20,12,60,11,2,1,8,81,18,11,52
"2011","Caerphilly 005A","W01001334","Total",65,12,16,37,6,0,2,4,59,12,14,33
"2011","Caerphilly 005B","W01001335","Total",42,13,12,17,5,0,2,3,37,13,10,14
"2011","Caerphilly 005C","W01001347","Total",38,8,14,16,3,0,0,3,35,8,14,13
"2011","Caerphilly 005D","W01001351","Total",22,9,11,2,5,0,5,0,17,9,6,2
"2011","Caerphilly 006A","W01001356","Total",28,6,11,11,5,1,3,1,23,5,8,10
"2011","Caerphilly 006B","W01001357","Total",38,16,12,10,4,1,1,2,34,15,11,8
"2011","Caerphilly 006C","W01001358","Total",105,34,24,47,13,2,4,7,92,32,20,40
"2011","Caerphilly 006D","W01001359","Total",40,15,15,10,5,0,4,1,35,15,11,9
"2011","Caerphilly 006E","W01001390","Total",46,19,17,10,2,1,1,0,44,18,16,10
"2011","Caerphilly 006F","W01001391","Total",50,14,20,16,3,0,2,1,47,14,18,15
"2011","Caerphilly 007A","W01001352","Total",79,33,18,28,3,0,1,2,76,33,17,26
"2011","Caerphilly 007B","W01001353","Total",53,15,11,27,8,2,5,1,45,13,6,26
"2011","Caerphilly 007C","W01001387","Total",40,13,9,18,7,0,2,5,33,13,7,13
"2011","Caerphilly 007D","W01001388","Total",110,26,22,62,9,1,4,4,101,25,18,58
"2011","Caerphilly 007E","W01001389","Total",32,14,7,11,2,0,1,1,30,14,6,10
"2011","Caerphilly 008A","W01001414","Total",68,11,20,37,8,0,4,4,60,11,16,33
"2011","Caerphilly 008B","W01001415","Total",67,13,25,29,4,1,0,3,63,12,25,26
"2011","Caerphilly 008C","W01001416","Total",34,7,12,15,3,1,2,0,31,6,10,15
"2011","Caerphilly 008D","W01001417","Total",53,17,22,14,7,1,5,1,46,16,17,13
"2011","Caerphilly 008E","W01001418","Total",49,8,12,29,5,1,2,2,44,7,10,27
"2011","Caerphilly 009A","W01001348","Total",101,32,30,39,4,1,1,2,97,31,29,37
"2011","Caerphilly 009B","W01001349","Total",44,11,21,12,4,0,3,1,40,11,18,11
"2011","Caerphilly 009C","W01001350","Total",71,21,18,32,7,1,2,4,64,20,16,28
"2011","Caerphilly 009D","W01001392","Total",41,15,19,7,5,1,3,1,36,14,16,6
"2011","Caerphilly 010A","W01001380","Total",61,20,18,23,8,1,3,4,53,19,15,19
"2011","Caerphilly 010B","W01001381","Total",72,18,14,40,6,0,1,5,66,18,13,35
"2011","Caerphilly 010C","W01001382","Total",17,3,8,6,1,0,1,0,16,3,7,6
"2011","Caerphilly 010D","W01001383","Total",58,28,7,23,4,2,2,0,54,26,5,23
"2011","Caerphilly 011A","W01001401","Total",62,25,19,18,4,2,2,0,58,23,17,18
"2011","Caerphilly 011B","W01001402","Total",97,30,20,47,9,0,4,5,88,30,16,42
"2011","Caerphilly 011C","W01001403","Total",43,21,10,12,4,1,1,2,39,20,9,10
"2011","Caerphilly 011D","W01001404","Total",22,11,7,4,3,0,2,1,19,11,5,3
"2011","Caerphilly 011E","W01001405","Total",74,19,17,38,9,1,2,6,65,18,15,32
"2011","Caerphilly 012A","W01001363","Total",56,10,18,28,9,0,7,2,47,10,11,26
"2011","Caerphilly 012B","W01001364","Total",93,24,13,56,7,1,2,4,86,23,11,52
"2011","Caerphilly 012C","W01001365","Total",81,21,20,40,14,3,8,3,67,18,12,37
"2011","Caerphilly 012D","W01001369","Total",51,17,14,20,2,0,0,2,49,17,14,18
"2011","Caerphilly 013A","W01001377","Total",47,15,17,15,7,2,1,4,40,13,16,11
"2011","Caerphilly 013B","W01001378","Total",55,18,17,20,3,0,2,1,52,18,15,19
"2011","Caerphilly 013C","W01001379","Total",41,16,14,11,2,1,1,0,39,15,13,11
"2011","Caerphilly 013D","W01001432","Total",88,32,26,30,8,3,2,3,80,29,24,27
"2011","Caerphilly 013E","W01001433","Total",42,17,9,16,5,2,1,2,37,15,8,14
"2011","Caerphilly 013F","W01001434","Total",31,10,15,6,2,0,1,1,29,10,14,5
"2011","Caerphilly 014A","W01001327","Total",68,18,22,28,8,1,4,3,60,17,18,25
"2011","Caerphilly 014B","W01001328","Total",53,14,18,21,8,2,3,3,45,12,15,18
"2011","Caerphilly 014C","W01001329","Total",59,15,20,24,4,2,1,1,55,13,19,23
"2011","Caerphilly 014D","W01001354","Total",49,21,17,11,7,1,4,2,42,20,13,9
"2011","Caerphilly 015A","W01001355","Total",41,12,13,16,6,0,3,3,35,12,10,13
"2011","Caerphilly 015B","W01001430","Total",88,26,23,39,13,3,7,3,75,23,16,36
"2011","Caerphilly 015C","W01001431","Total",44,10,19,15,7,0,6,1,37,10,13,14
"2011","Caerphilly 016A","W01001407","Total",54,14,20,20,8,3,0,5,46,11,20,15
"2011","Caerphilly 016B","W01001408","Total",84,16,27,41,8,1,5,2,76,15,22,39
"2011","Caerphilly 016C","W01001409","Total",47,20,13,14,9,2,5,2,38,18,8,12
"2011","Caerphilly 016D","W01001410","Total",58,25,13,20,4,0,3,1,54,25,10,19
"2011","Caerphilly 017A","W01001411","Total",42,19,10,13,3,0,2,1,39,19,8,12
"2011","Caerphilly 017B","W01001412","Total",48,21,9,18,6,1,2,3,42,20,7,15
"2011","Caerphilly 017C","W01001413","Total",47,18,12,17,2,0,2,0,45,18,10,17
"2011","Caerphilly 018A","W01001330","Total",45,16,15,14,4,2,1,1,41,14,14,13
"2011","Caerphilly 018B","W01001331","Total",76,18,20,38,8,0,4,4,68,18,16,34
"2011","Caerphilly 018C","W01001332","Total",109,34,22,53,16,2,4,10,93,32,18,43
"2011","Caerphilly 018D","W01001333","Total",83,22,18,43,6,0,4,2,77,22,14,41
"2011","Caerphilly 019A","W01001366","Total",42,16,11,15,2,0,2,0,40,16,9,15
"2011","Caerphilly 019B","W01001367","Total",64,22,17,25,7,0,4,3,57,22,13,22
"2011","Caerphilly 019C","W01001368","Total",71,25,16,30,4,0,1,3,67,25,15,27
"2011","Caerphilly 019D","W01001393","Total",50,19,7,24,2,0,1,1,48,19,6,23
"2011","Caerphilly 019E","W01001397","Total",56,16,21,19,4,0,4,0,52,16,17,19
"2011","Caerphilly 019F","W01001400","Total",96,31,16,49,14,3,4,7,82,28,12,42
"2011","Caerphilly 020A","W01001340","Total",30,9,13,8,6,0,5,1,24,9,8,7
"2011","Caerphilly 020B","W01001341","Total",75,22,9,44,4,1,0,3,71,21,9,41
"2011","Caerphilly 020C","W01001344","Total",45,17,9,19,1,0,1,0,44,17,8,19
"2011","Caerphilly 020D","W01001346","Total",53,15,19,19,6,0,4,2,47,15,15,17
"2011","Caerphilly 021A","W01001342","Total",22,5,10,7,10,1,6,3,12,4,4,4
"2011","Caerphilly 021B","W01001343","Total",23,8,4,11,2,0,0,2,21,8,4,9
"2011","Caerphilly 021C","W01001345","Total",124,23,13,88,12,3,2,7,112,20,11,81
"2011","Caerphilly 021D","W01001419","Total",37,18,9,10,5,2,1,2,32,16,8,8
"2011","Caerphilly 022A","W01001371","Total",71,17,16,38,8,0,5,3,63,17,11,35
"2011","Caerphilly 022B","W01001372","Total",70,25,20,25,3,0,2,1,67,25,18,24
"2011","Caerphilly 022C","W01001373","Total",62,19,23,20,10,1,5,4,52,18,18,16
"2011","Caerphilly 022D","W01001420","Total",49,14,15,20,8,0,5,3,41,14,10,17
"2011","Caerphilly 022E","W01001421","Total",142,25,12,105,16,2,2,12,126,23,10,93
"2011","Caerphilly 022F","W01001422","Total",86,21,13,52,9,1,3,5,77,20,10,47
"2011","Caerphilly 023A","W01001370","Total",48,19,18,11,6,0,4,2,42,19,14,9
"2011","Caerphilly 023B","W01001394","Total",31,10,15,6,5,0,5,0,26,10,10,6
"2011","Caerphilly 023C","W01001395","Total",40,14,7,19,4,0,1,3,36,14,6,16
"2011","Caerphilly 023D","W01001396","Total",101,19,16,66,11,1,5,5,90,18,11,61
"2011","Caerphilly 023E","W01001399","Total",29,15,4,10,5,1,2,2,24,14,2,8
"2011","Caerphilly 024A","W01001398","Total",69,15,30,24,14,0,11,3,55,15,19,21
"2011","Caerphilly 024B","W01001423","Total",29,10,15,4,5,1,4,0,24,9,11,4
"2011","Caerphilly 024C","W01001424","Total",50,15,12,23,4,2,1,1,46,13,11,22
"2011","Caerphilly 024D","W01001425","Total",34,11,12,11,9,1,6,2,25,10,6,9
"2011","Caerphilly 024E","W01001426","Total",10,2,6,2,2,0,2,0,8,2,4,2
"2011","Caerphilly 024F","W01001427","Total",46,16,27,3,4,0,4,0,42,16,23,3
"2011","Blaenau Gwent 001A","W01001440","Total",58,21,12,25,9,2,2,5,49,19,10,20
"2011","Blaenau Gwent 001B","W01001441","Total",61,18,9,34,6,1,1,4,55,17,8,30
"2011","Blaenau Gwent 001C","W01001442","Total",31,8,11,12,3,0,3,0,28,8,8,12
"2011","Blaenau Gwent 001D","W01001470","Total",33,8,13,12,3,0,3,0,30,8,10,12
"2011","Blaenau Gwent 001E","W01001471","Total",90,18,17,55,14,1,7,6,76,17,10,49
"2011","Blaenau Gwent 002A","W01001446","Total",26,9,8,9,0,0,0,0,26,9,8,9
"2011","Blaenau Gwent 002B","W01001447","Total",89,19,23,47,9,1,4,4,80,18,19,43
"2011","Blaenau Gwent 002C","W01001448","Total",39,7,15,17,5,0,1,4,34,7,14,13
"2011","Blaenau Gwent 002D","W01001449","Total",49,17,15,17,2,0,1,1,47,17,14,16
"2011","Blaenau Gwent 003A","W01001472","Total",33,11,12,10,6,1,3,2,27,10,9,8
"2011","Blaenau Gwent 003B","W01001473","Total",98,27,11,60,6,0,3,3,92,27,8,57
"2011","Blaenau Gwent 003C","W01001474","Total",52,12,7,33,6,0,0,6,46,12,7,27
"2011","Blaenau Gwent 003D","W01001475","Total",36,12,10,14,6,0,4,2,30,12,6,12
"2011","Blaenau Gwent 003E","W01001480","Total",73,21,10,42,6,0,4,2,67,21,6,40
"2011","Blaenau Gwent 004A","W01001438","Total",46,17,13,16,5,0,3,2,41,17,10,14
"2011","Blaenau Gwent 004B","W01001439","Total",43,24,14,5,11,2,8,1,32,22,6,4
"2011","Blaenau Gwent 004C","W01001456","Total",52,17,9,26,3,0,2,1,49,17,7,25
"2011","Blaenau Gwent 004D","W01001457","Total",96,25,19,52,6,1,1,4,90,24,18,48
"2011","Blaenau Gwent 004E","W01001458","Total",59,14,26,19,7,0,7,0,52,14,19,19
"2011","Blaenau Gwent 005A","W01001443","Total",53,14,9,30,9,2,2,5,44,12,7,25
"2011","Blaenau Gwent 005B","W01001444","Total",75,22,15,38,8,1,4,3,67,21,11,35
"2011","Blaenau Gwent 005C","W01001445","Total",61,23,8,30,6,1,0,5,55,22,8,25
"2011","Blaenau Gwent 005D","W01001467","Total",78,26,15,37,6,0,3,3,72,26,12,34
"2011","Blaenau Gwent 005E","W01001468","Total",53,17,10,26,3,0,1,2,50,17,9,24
"2011","Blaenau Gwent 005F","W01001469","Total",56,7,12,37,7,0,3,4,49,7,9,33
"2011","Blaenau Gwent 006A","W01001462","Total",61,20,22,19,3,1,1,1,58,19,21,18
"2011","Blaenau Gwent 006B","W01001463","Total",74,22,24,28,6,0,2,4,68,22,22,24
"2011","Blaenau Gwent 006C","W01001478","Total",55,21,15,19,9,1,4,4,46,20,11,15
"2011","Blaenau Gwent 006D","W01001479","Total",110,32,14,64,9,0,2,7,101,32,12,57
"2011","Blaenau Gwent 006E","W01001481","Total",56,17,8,31,7,0,1,6,49,17,7,25
"2011","Blaenau Gwent 007A","W01001450","Total",43,10,12,21,4,0,2,2,39,10,10,19
"2011","Blaenau Gwent 007B","W01001451","Total",65,20,13,32,6,0,5,1,59,20,8,31
"2011","Blaenau Gwent 007C","W01001452","Total",26,9,7,10,3,2,1,0,23,7,6,10
"2011","Blaenau Gwent 007D","W01001459","Total",50,10,8,32,4,0,2,2,46,10,6,30
"2011","Blaenau Gwent 007E","W01001460","Total",54,22,12,20,6,0,3,3,48,22,9,17
"2011","Blaenau Gwent 007F","W01001461","Total",51,11,13,27,4,0,2,2,47,11,11,25
"2011","Blaenau Gwent 008A","W01001435","Total",76,17,22,37,13,2,4,7,63,15,18,30
"2011","Blaenau Gwent 008B","W01001436","Total",54,12,13,29,5,0,0,5,49,12,13,24
"2011","Blaenau Gwent 008C","W01001437","Total",57,9,15,33,6,0,2,4,51,9,13,29
"2011","Blaenau Gwent 008D","W01001453","Total",60,21,11,28,5,3,1,1,55,18,10,27
"2011","Blaenau Gwent 008E","W01001454","Total",48,8,12,28,1,0,0,1,47,8,12,27
"2011","Blaenau Gwent 008F","W01001455","Total",70,24,18,28,3,0,3,0,67,24,15,28
"2011","Blaenau Gwent 009A","W01001464","Total",66,14,9,43,5,1,1,3,61,13,8,40
"2011","Blaenau Gwent 009B","W01001465","Total",65,16,15,34,8,0,4,4,57,16,11,30
"2011","Blaenau Gwent 009C","W01001466","Total",76,12,16,48,8,0,3,5,68,12,13,43
"2011","Blaenau Gwent 009D","W01001476","Total",50,13,7,30,6,1,1,4,44,12,6,26
"2011","Blaenau Gwent 009E","W01001477","Total",52,21,12,19,4,1,2,1,48,20,10,18
"2011","Torfaen 001A","W01001487","Total",44,14,13,17,5,2,1,2,39,12,12,15
"2011","Torfaen 001B","W01001488","Total",59,16,8,35,4,0,0,4,55,16,8,31
"2011","Torfaen 001C","W01001489","Total",55,16,14,25,0,0,0,0,55,16,14,25
"2011","Torfaen 001D","W01001490","Total",38,9,12,17,2,0,2,0,36,9,10,17
"2011","Torfaen 002A","W01001482","Total",49,16,6,27,3,0,0,3,46,16,6,24
"2011","Torfaen 002B","W01001483","Total",77,18,22,37,13,0,8,5,64,18,14,32
"2011","Torfaen 002C","W01001484","Total",37,9,10,18,4,0,2,2,33,9,8,16
"2011","Torfaen 002D","W01001485","Total",58,18,18,22,6,0,4,2,52,18,14,20
"2011","Torfaen 002E","W01001486","Total",51,13,14,24,4,3,0,1,47,10,14,23
"2011","Torfaen 003A","W01001525","Total",54,23,7,24,8,0,4,4,46,23,3,20
"2011","Torfaen 003B","W01001529","Total",55,19,9,27,5,0,3,2,50,19,6,25
"2011","Torfaen 003C","W01001530","Total",105,25,13,67,7,1,3,3,98,24,10,64
"2011","Torfaen 003D","W01001531","Total",59,17,9,33,9,2,2,5,50,15,7,28
"2011","Torfaen 004A","W01001491","Total",74,21,19,34,10,1,7,2,64,20,12,32
"2011","Torfaen 004B","W01001496","Total",68,23,11,34,7,2,3,2,61,21,8,32
"2011","Torfaen 004C","W01001523","Total",42,13,5,24,1,0,1,0,41,13,4,24
"2011","Torfaen 004D","W01001524","Total",41,14,9,18,7,0,2,5,34,14,7,13
"2011","Torfaen 004E","W01001540","Total",25,7,10,8,6,2,4,0,19,5,6,8
"2011","Torfaen 004F","W01001541","Total",33,12,8,13,3,0,1,2,30,12,7,11
"2011","Torfaen 005A","W01001510","Total",53,19,18,16,6,2,3,1,47,17,15,15
"2011","Torfaen 005B","W01001511","Total",59,19,20,20,9,2,5,2,50,17,15,18
"2011","Torfaen 005C","W01001512","Total",16,2,10,4,4,0,4,0,12,2,6,4
"2011","Torfaen 005D","W01001513","Total",17,7,3,7,0,0,0,0,17,7,3,7
"2011","Torfaen 006A","W01001514","Total",24,6,11,7,5,1,1,3,19,5,10,4
"2011","Torfaen 006B","W01001515","Total",65,19,22,24,3,0,2,1,62,19,20,23
"2011","Torfaen 006C","W01001516","Total",40,9,10,21,6,0,3,3,34,9,7,18
"2011","Torfaen 006D","W01001517","Total",60,14,24,22,6,1,2,3,54,13,22,19
"2011","Torfaen 006E","W01001518","Total",21,5,5,11,2,0,1,1,19,5,4,10
"2011","Torfaen 007A","W01001519","Total",76,19,23,34,6,1,2,3,70,18,21,31
"2011","Torfaen 007B","W01001520","Total",69,20,22,27,11,2,4,5,58,18,18,22
"2011","Torfaen 007C","W01001521","Total",57,19,13,25,8,1,4,3,49,18,9,22
"2011","Torfaen 007D","W01001522","Total",69,27,20,22,9,3,5,1,60,24,15,21
"2011","Torfaen 007E","W01001537","Total",18,8,7,3,1,0,1,0,17,8,6,3
"2011","Torfaen 008A","W01001493","Total",57,23,22,12,4,0,4,0,53,23,18,12
"2011","Torfaen 008B","W01001494","Total",31,11,12,8,1,0,1,0,30,11,11,8
"2011","Torfaen 008C","W01001495","Total",41,14,18,9,3,1,2,0,38,13,16,9
"2011","Torfaen 008D","W01001507","Total",66,22,21,23,10,1,9,0,56,21,12,23
"2011","Torfaen 009A","W01001501","Total",84,31,10,43,10,1,3,6,74,30,7,37
"2011","Torfaen 009B","W01001503","Total",62,20,11,31,4,1,1,2,58,19,10,29
"2011","Torfaen 009C","W01001536","Total",90,23,19,48,9,2,4,3,81,21,15,45
"2011","Torfaen 009D","W01001538","Total",68,27,11,30,5,0,2,3,63,27,9,27
"2011","Torfaen 009E","W01001539","Total",59,16,18,25,3,0,1,2,56,16,17,23
"2011","Torfaen 010A","W01001506","Total",36,12,9,15,2,0,2,0,34,12,7,15
"2011","Torfaen 010B","W01001526","Total",74,29,9,36,4,0,1,3,70,29,8,33
"2011","Torfaen 010C","W01001527","Total",35,6,8,21,4,0,1,3,31,6,7,18
"2011","Torfaen 010D","W01001528","Total",38,13,6,19,4,0,2,2,34,13,4,17
"2011","Torfaen 010E","W01001532","Total",75,23,20,32,9,0,4,5,66,23,16,27
"2011","Torfaen 011A","W01001497","Total",74,31,17,26,9,4,3,2,65,27,14,24
"2011","Torfaen 011B","W01001498","Total",53,15,10,28,7,0,3,4,46,15,7,24
"2011","Torfaen 011C","W01001499","Total",44,17,16,11,4,1,3,0,40,16,13,11
"2011","Torfaen 011D","W01001500","Total",25,7,14,4,1,0,1,0,24,7,13,4
"2011","Torfaen 011E","W01001502","Total",41,17,13,11,5,0,3,2,36,17,10,9
"2011","Torfaen 012A","W01001492","Total",60,27,14,19,6,0,3,3,54,27,11,16
"2011","Torfaen 012B","W01001533","Total",25,9,11,5,0,0,0,0,25,9,11,5
"2011","Torfaen 012C","W01001534","Total",39,15,10,14,5,2,3,0,34,13,7,14
"2011","Torfaen 012D","W01001535","Total",47,17,9,21,0,0,0,0,47,17,9,21
"2011","Torfaen 013A","W01001504","Total",64,19,24,21,2,0,1,1,62,19,23,20
"2011","Torfaen 013B","W01001505","Total",37,8,15,14,8,2,5,1,29,6,10,13
"2011","Torfaen 013C","W01001508","Total",16,3,8,5,5,2,2,1,11,1,6,4
"2011","Torfaen 013D","W01001509","Total",29,13,13,3,9,0,9,0,20,13,4,3
"2011","Monmouthshire 001A","W01001545","Total",13,3,6,4,3,0,3,0,10,3,3,4
"2011","Monmouthshire 001B","W01001548","Total",31,7,17,7,11,1,8,2,20,6,9,5
"2011","Monmouthshire 001C","W01001557","Total",60,20,17,23,3,0,1,2,57,20,16,21
"2011","Monmouthshire 001D","W01001571","Total",21,7,7,7,2,0,2,0,19,7,5,7
"2011","Monmouthshire 001E","W01001579","Total",33,11,16,6,7,0,7,0,26,11,9,6
"2011","Monmouthshire 002A","W01001546","Total",61,24,19,18,5,1,2,2,56,23,17,16
"2011","Monmouthshire 002C","W01001558","Total",42,12,9,21,3,0,1,2,39,12,8,19
"2011","Monmouthshire 002E","W01001580","Total",35,17,12,6,6,1,5,0,29,16,7,6
"2011","Monmouthshire 002F","W01001909","Total",100,37,15,48,8,1,2,5,92,36,13,43
"2011","Monmouthshire 003A","W01001561","Total",20,11,6,3,2,2,0,0,18,9,6,3
"2011","Monmouthshire 003B","W01001562","Total",34,9,11,14,5,0,2,3,29,9,9,11
"2011","Monmouthshire 003C","W01001563","Total",29,12,3,14,1,0,1,0,28,12,2,14
"2011","Monmouthshire 003D","W01001564","Total",53,17,9,27,2,1,1,0,51,16,8,27
"2011","Monmouthshire 003E","W01001569","Total",29,9,8,12,3,0,2,1,26,9,6,11
"2011","Monmouthshire 004A","W01001552","Total",19,5,11,3,1,1,0,0,18,4,11,3
"2011","Monmouthshire 004B","W01001553","Total",82,30,24,28,10,2,5,3,72,28,19,25
"2011","Monmouthshire 004C","W01001554","Total",54,22,9,23,6,2,3,1,48,20,6,22
"2011","Monmouthshire 004D","W01001576","Total",46,23,12,11,5,1,4,0,41,22,8,11
"2011","Monmouthshire 004E","W01001577","Total",48,24,12,12,3,0,3,0,45,24,9,12
"2011","Monmouthshire 004F","W01001599","Total",45,27,6,12,4,3,0,1,41,24,6,11
"2011","Monmouthshire 005A","W01001566","Total",22,7,11,4,5,2,3,0,17,5,8,4
"2011","Monmouthshire 005B","W01001567","Total",15,6,5,4,3,0,3,0,12,6,2,4
"2011","Monmouthshire 005C","W01001568","Total",22,16,5,1,0,0,0,0,22,16,5,1
"2011","Monmouthshire 005D","W01001575","Total",15,4,9,2,2,0,2,0,13,4,7,2
"2011","Monmouthshire 005E","W01001581","Total",29,7,15,7,5,0,5,0,24,7,10,7
"2011","Monmouthshire 006A","W01001555","Total",12,3,7,2,4,0,4,0,8,3,3,2
"2011","Monmouthshire 006B","W01001556","Total",25,11,7,7,1,0,1,0,24,11,6,7
"2011","Monmouthshire 006C","W01001560","Total",16,3,4,9,3,0,1,2,13,3,3,7
"2011","Monmouthshire 006D","W01001565","Total",26,8,5,13,5,1,3,1,21,7,2,12
"2011","Monmouthshire 006E","W01001596","Total",34,15,8,11,3,2,0,1,31,13,8,10
"2011","Monmouthshire 006F","W01001597","Total",42,21,14,7,8,0,8,0,34,21,6,7
"2011","Monmouthshire 007A","W01001549","Total",12,2,6,4,2,0,1,1,10,2,5,3
"2011","Monmouthshire 007B","W01001583","Total",13,5,7,1,4,1,3,0,9,4,4,1
"2011","Monmouthshire 007C","W01001585","Total",15,8,4,3,1,1,0,0,14,7,4,3
"2011","Monmouthshire 007D","W01001586","Total",43,19,15,9,5,1,4,0,38,18,11,9
"2011","Monmouthshire 007E","W01001594","Total",22,11,7,4,6,0,5,1,16,11,2,3
"2011","Monmouthshire 007F","W01001595","Total",16,7,5,4,5,2,3,0,11,5,2,4
"2011","Monmouthshire 008A","W01001559","Total",31,13,9,9,5,1,4,0,26,12,5,9
"2011","Monmouthshire 008B","W01001584","Total",63,19,19,25,10,1,6,3,53,18,13,22
"2011","Monmouthshire 008C","W01001587","Total",63,24,16,23,9,3,5,1,54,21,11,22
"2011","Monmouthshire 008D","W01001592","Total",95,31,19,45,8,1,2,5,87,30,17,40
"2011","Monmouthshire 008E","W01001593","Total",62,26,17,19,6,1,5,0,56,25,12,19
"2011","Monmouthshire 009A","W01001542","Total",23,8,9,6,4,1,3,0,19,7,6,6
"2011","Monmouthshire 009B","W01001543","Total",20,9,5,6,1,0,1,0,19,9,4,6
"2011","Monmouthshire 009C","W01001578","Total",31,15,10,6,3,2,1,0,28,13,9,6
"2011","Monmouthshire 009D","W01001590","Total",22,9,10,3,4,1,3,0,18,8,7,3
"2011","Monmouthshire 010C","W01001551","Total",39,16,5,18,1,0,1,0,38,16,4,18
"2011","Monmouthshire 010D","W01001588","Total",27,12,9,6,2,1,1,0,25,11,8,6
"2011","Monmouthshire 010E","W01001589","Total",45,12,15,18,9,1,5,3,36,11,10,15
"2011","Monmouthshire 010F","W01001598","Total",59,20,9,30,4,0,2,2,55,20,7,28
"2011","Monmouthshire 010G","W01001908","Total",69,24,16,29,6,1,4,1,63,23,12,28
"2011","Monmouthshire 011A","W01001572","Total",35,14,13,8,3,0,3,0,32,14,10,8
"2011","Monmouthshire 011B","W01001573","Total",19,6,10,3,6,0,6,0,13,6,4,3
"2011","Monmouthshire 011C","W01001574","Total",38,14,15,9,7,2,3,2,31,12,12,7
"2011","Monmouthshire 011D","W01001582","Total",52,19,18,15,5,1,4,0,47,18,14,15
"2011","Monmouthshire 011E","W01001591","Total",30,17,10,3,3,0,3,0,27,17,7,3
"2011","Newport 001A","W01001623","Total",39,10,21,8,2,0,1,1,37,10,20,7
"2011","Newport 001B","W01001624","Total",42,20,15,7,0,0,0,0,42,20,15,7
"2011","Newport 001C","W01001625","Total",33,15,13,5,9,2,5,2,24,13,8,3
"2011","Newport 001D","W01001626","Total",40,12,13,15,6,0,3,3,34,12,10,12
"2011","Newport 001E","W01001627","Total",34,11,16,7,6,0,5,1,28,11,11,6
"2011","Newport 001F","W01001628","Total",51,17,14,20,4,0,4,0,47,17,10,20
"2011","Newport 002A","W01001651","Total",28,13,6,9,5,1,3,1,23,12,3,8
"2011","Newport 002B","W01001652","Total",118,38,15,65,11,0,4,7,107,38,11,58
"2011","Newport 002C","W01001653","Total",33,15,11,7,5,3,2,0,28,12,9,7
"2011","Newport 002D","W01001654","Total",49,17,17,15,2,0,1,1,47,17,16,14
"2011","Newport 002E","W01001655","Total",32,16,8,8,2,1,0,1,30,15,8,7
"2011","Newport 003A","W01001617","Total",85,23,8,54,13,3,2,8,72,20,6,46
"2011","Newport 003B","W01001618","Total",60,14,10,36,7,0,2,5,53,14,8,31
"2011","Newport 003C","W01001619","Total",81,30,10,41,4,2,1,1,77,28,9,40
"2011","Newport 003D","W01001620","Total",70,27,10,33,10,3,2,5,60,24,8,28
"2011","Newport 003E","W01001621","Total",66,22,10,34,6,0,3,3,60,22,7,31
"2011","Newport 003F","W01001622","Total",55,27,8,20,5,1,1,3,50,26,7,17
"2011","Newport 004A","W01001639","Total",51,20,21,10,4,0,4,0,47,20,17,10
"2011","Newport 004B","W01001640","Total",10,7,2,1,1,0,1,0,9,7,1,1
"2011","Newport 004C","W01001641","Total",10,3,4,3,1,0,1,0,9,3,3,3
"2011","Newport 004D","W01001649","Total",44,14,9,21,6,0,5,1,38,14,4,20
"2011","Newport 004E","W01001650","Total",54,21,12,21,2,1,0,1,52,20,12,20
"2011","Newport 005A","W01001614","Total",78,26,15,37,7,1,4,2,71,25,11,35
"2011","Newport 005B","W01001615","Total",73,30,13,30,5,0,3,2,68,30,10,28
"2011","Newport 005C","W01001616","Total",25,8,10,7,2,0,2,0,23,8,8,7
"2011","Newport 005D","W01001678","Total",69,16,17,36,9,0,5,4,60,16,12,32
"2011","Newport 006A","W01001601","Total",106,30,17,59,10,0,5,5,96,30,12,54
"2011","Newport 006B","W01001681","Total",92,29,14,49,8,2,3,3,84,27,11,46
"2011","Newport 006C","W01001682","Total",71,36,12,23,7,1,3,3,64,35,9,20
"2011","Newport 006D","W01001683","Total",55,21,16,18,4,1,2,1,51,20,14,17
"2011","Newport 006E","W01001684","Total",55,19,12,24,4,0,1,3,51,19,11,21
"2011","Newport 007A","W01001675","Total",64,26,20,18,5,0,3,2,59,26,17,16
"2011","Newport 007B","W01001676","Total",94,28,25,41,9,2,3,4,85,26,22,37
"2011","Newport 007C","W01001677","Total",57,22,19,16,9,4,4,1,48,18,15,15
"2011","Newport 007D","W01001679","Total",25,9,12,4,3,1,2,0,22,8,10,4
"2011","Newport 007E","W01001680","Total",63,20,18,25,5,0,3,2,58,20,15,23
"2011","Newport 008A","W01001606","Total",25,13,6,6,1,0,0,1,24,13,6,5
"2011","Newport 008B","W01001608","Total",48,17,15,16,7,1,3,3,41,16,12,13
"2011","Newport 008C","W01001663","Total",66,24,10,32,9,1,6,2,57,23,4,30
"2011","Newport 008D","W01001665","Total",61,27,10,24,7,0,4,3,54,27,6,21
"2011","Newport 009A","W01001669","Total",15,5,8,2,2,0,2,0,13,5,6,2
"2011","Newport 009B","W01001670","Total",45,15,20,10,4,0,4,0,41,15,16,10
"2011","Newport 009C","W01001672","Total",50,20,12,18,4,0,4,0,46,20,8,18
"2011","Newport 009D","W01001673","Total",21,8,8,5,1,0,1,0,20,8,7,5
"2011","Newport 009E","W01001674","Total",58,12,21,25,7,0,5,2,51,12,16,23
"2011","Newport 010A","W01001664","Total",72,25,7,40,8,0,3,5,64,25,4,35
"2011","Newport 010B","W01001666","Total",80,30,10,40,9,1,3,5,71,29,7,35
"2011","Newport 010C","W01001667","Total",88,20,11,57,7,1,2,4,81,19,9,53
"2011","Newport 010D","W01001668","Total",70,21,12,37,12,2,6,4,58,19,6,33
"2011","Newport 011A","W01001611","Total",47,13,11,23,3,1,1,1,44,12,10,22
"2011","Newport 011B","W01001612","Total",37,16,7,14,3,0,2,1,34,16,5,13
"2011","Newport 011C","W01001613","Total",44,18,11,15,3,1,2,0,41,17,9,15
"2011","Newport 011D","W01001691","Total",71,23,11,37,10,0,1,9,61,23,10,28
"2011","Newport 011E","W01001692","Total",90,20,25,45,8,0,4,4,82,20,21,41
"2011","Newport 012A","W01001600","Total",26,13,7,6,8,4,2,2,18,9,5,4
"2011","Newport 012B","W01001602","Total",16,7,9,0,4,0,4,0,12,7,5,0
"2011","Newport 012C","W01001603","Total",15,3,7,5,1,0,1,0,14,3,6,5
"2011","Newport 012D","W01001604","Total",22,10,8,4,4,0,2,2,18,10,6,2
"2011","Newport 013A","W01001642","Total",104,41,7,56,7,1,2,4,97,40,5,52
"2011","Newport 013B","W01001643","Total",123,39,21,63,11,0,6,5,112,39,15,58
"2011","Newport 013C","W01001644","Total",142,38,30,74,14,0,10,4,128,38,20,70
"2011","Newport 013D","W01001690","Total",103,30,22,51,11,0,6,5,92,30,16,46
"2011","Newport 013E","W01001693","Total",30,10,3,17,1,0,1,0,29,10,2,17
"2011","Newport 014A","W01001605","Total",27,12,9,6,4,1,1,2,23,11,8,4
"2011","Newport 014B","W01001685","Total",60,19,12,29,7,3,2,2,53,16,10,27
"2011","Newport 014C","W01001686","Total",37,15,14,8,6,2,3,1,31,13,11,7
"2011","Newport 014D","W01001687","Total",38,11,15,12,6,2,3,1,32,9,12,11
"2011","Newport 015A","W01001607","Total",102,15,16,71,6,1,0,5,96,14,16,66
"2011","Newport 015B","W01001609","Total",138,44,12,82,10,0,3,7,128,44,9,75
"2011","Newport 015C","W01001610","Total",41,13,6,22,6,1,2,3,35,12,4,19
"2011","Newport 015D","W01001645","Total",78,37,17,24,6,2,2,2,72,35,15,22
"2011","Newport 015E","W01001646","Total",97,27,10,60,11,1,2,8,86,26,8,52
"2011","Newport 015F","W01001647","Total",27,13,7,7,5,1,1,3,22,12,6,4
"2011","Newport 015G","W01001648","Total",62,21,13,28,10,2,5,3,52,19,8,25
"2011","Newport 016A","W01001635","Total",24,8,9,7,1,0,1,0,23,8,8,7
"2011","Newport 016B","W01001637","Total",52,17,17,18,7,1,5,1,45,16,12,17
"2011","Newport 016C","W01001638","Total",26,11,11,4,3,1,2,0,23,10,9,4
"2011","Newport 016D","W01001671","Total",78,27,30,21,9,1,8,0,69,26,22,21
"2011","Newport 017A","W01001629","Total",33,18,11,4,1,0,1,0,32,18,10,4
"2011","Newport 017B","W01001630","Total",65,25,19,21,5,0,4,1,60,25,15,20
"2011","Newport 017C","W01001631","Total",35,13,12,10,5,1,2,2,30,12,10,8
"2011","Newport 017D","W01001632","Total",65,23,13,29,3,0,2,1,62,23,11,28
"2011","Newport 018A","W01001659","Total",88,26,11,51,7,0,2,5,81,26,9,46
"2011","Newport 018B","W01001660","Total",55,16,13,26,4,1,1,2,51,15,12,24
"2011","Newport 018C","W01001661","Total",96,22,21,53,13,2,4,7,83,20,17,46
"2011","Newport 018D","W01001662","Total",43,9,4,30,9,1,2,6,34,8,2,24
"2011","Newport 019A","W01001633","Total",109,35,16,58,11,1,5,5,98,34,11,53
"2011","Newport 019B","W01001634","Total",69,28,15,26,3,0,1,2,66,28,14,24
"2011","Newport 019C","W01001688","Total",140,45,27,68,14,0,6,8,126,45,21,60
"2011","Newport 019D","W01001689","Total",117,30,10,77,7,0,0,7,110,30,10,70
"2011","Newport 020A","W01001636","Total",47,20,22,5,8,0,8,0,39,20,14,5
"2011","Newport 020C","W01001657","Total",35,13,14,8,6,0,4,2,29,13,10,6
"2011","Newport 020D","W01001658","Total",43,12,16,15,4,1,1,2,39,11,15,13
"2011","Newport 020E","W01001912","Total",26,16,3,7,2,1,1,0,24,15,2,7
"2011","Newport 020F","W01001913","Total",40,13,17,10,3,0,3,0,37,13,14,10
